old_count	cur_count	occ_diff	node_title	node_key	datasetkey
0	3	3	Plazi	ffb07bec-2d10-492d-9c37-361fe0b79427	0039568a-c692-4e60-9d53-2a08a81f73a2
55	55	0	Atlas of Living Australia	4a6f1b71-969e-4fc5-a693-282b05e1220c	01a6caea-b201-4495-b511-1adf1384e790
3181	3181	0	GBIF Argentina	2426a871-9feb-40a1-96c6-0c593a76b835	023e40d3-1cd2-479c-a166-10c9ec0a2e68
0	12	12	Plazi	ffb07bec-2d10-492d-9c37-361fe0b79427	03a2c74a-880e-47f5-bfd4-f476e092cb11
123	60	-63	GBIF Germany	4f6826f2-4ff6-443d-b966-e6913bd24013	03c01aa9-a13d-4cab-bf85-f59149bf8d9a
0	1	1	Plazi	ffb07bec-2d10-492d-9c37-361fe0b79427	03f1dc7f-91ac-4cd1-a76c-f443327b3b63
0	1	1	Plazi	ffb07bec-2d10-492d-9c37-361fe0b79427	06b9e416-65a8-4d50-a89f-51ae82e46cf7
4	4	0	Plazi	ffb07bec-2d10-492d-9c37-361fe0b79427	089484c7-02f5-446f-9ea5-9412b928d445
43	43	0	Plazi	ffb07bec-2d10-492d-9c37-361fe0b79427	09960718-2a2d-4c3d-aa20-b52192ff97c8
0	203	203	Ocean Biodiversity Information System	ba0670b9-4186-41e6-8e70-f9cb3065551a	0c2781fe-8351-4904-95e5-f6309383b8a6
0	3	3	Plazi	ffb07bec-2d10-492d-9c37-361fe0b79427	0d3127fb-4a68-4a7e-ae88-0e2379df2b11
0	1958	1958	Ocean Biodiversity Information System	ba0670b9-4186-41e6-8e70-f9cb3065551a	0d3a548b-0b12-4294-aeeb-9b7c2abe91b7
897	897	0	GBIF Germany	4f6826f2-4ff6-443d-b966-e6913bd24013	0ebf1f88-0b36-4600-8806-d32c36928b8e
0	1259	1259	Ocean Biodiversity Information System	ba0670b9-4186-41e6-8e70-f9cb3065551a	13e9f818-b526-4fec-ac49-41e9b1477c79
0	218	218	Participant Node Managers Committee	7f48e0c8-5c96-49ec-b972-30748e339115	15131f03-846d-4fcf-9ca7-58c74a489d41
1741	1741	0	U.S. Geological Survey	8618c64a-93e0-4300-b546-7249e5148ed2	155ad75a-6721-4fc5-9c94-4eef447ee650
44332	44332	0	National Biodiversity Network	d897a5b9-35ee-4232-94bd-b0bcaac003c2	1637bc3e-a70e-460a-858b-4013e0bc9837
15866	15871	5	U.S. Geological Survey	8618c64a-93e0-4300-b546-7249e5148ed2	16965647-4120-4e0b-aa57-1eeaf028606e
51	51	0	GBIF France	da44cd31-5901-4687-a106-6d1c7734ee3a	16fc9fb3-bc75-43d5-8fc2-3943a0c0a11f
217	217	0	GBIF France	da44cd31-5901-4687-a106-6d1c7734ee3a	19a61bf8-0273-4221-8614-ebd85ff97267
274291	274291	0	GBIF Sweden	a0b3be64-6525-4387-ac67-a499950f92e1	1b7e83a0-0c61-11dd-84ce-b8a03c50a862
0	3	3	Plazi	ffb07bec-2d10-492d-9c37-361fe0b79427	1f5c0367-f6f8-4aa3-975c-609db7b47393
0	10	10	Plazi	ffb07bec-2d10-492d-9c37-361fe0b79427	206a01fd-06cd-4a0f-aab9-b0fb99ea0ebd
3	3	0	Plazi	ffb07bec-2d10-492d-9c37-361fe0b79427	2073ef0b-1a52-4fd0-afdd-878b4e552f23
48	48	0	GBIF Germany	4f6826f2-4ff6-443d-b966-e6913bd24013	229be5b0-ef0c-48e4-aea2-6f8e9b449692
0	108	108	Plazi	ffb07bec-2d10-492d-9c37-361fe0b79427	24969123-dce4-499a-aa81-55469cf1713a
6	6	0	Plazi	ffb07bec-2d10-492d-9c37-361fe0b79427	26d0aead-2a95-45eb-ba6b-0f908acca2ad
6	6	0	Plazi	ffb07bec-2d10-492d-9c37-361fe0b79427	28289524-0ad1-43c3-bb8d-2b785ff89089
93599	93599	0	GBIF France	da44cd31-5901-4687-a106-6d1c7734ee3a	28646617-3f8e-4910-849e-e3776e3fec78
0	6	6	Plazi	ffb07bec-2d10-492d-9c37-361fe0b79427	289d604f-b447-4be5-871a-588cdd5174c6
1680	1680	0	Biodiversity Information System of Mexico	b324e8e9-9a4c-44fa-8f1a-7f39ea7ab576	2b2c9de5-3484-41f5-8b47-950c093ef205
2778	2778	0	National Biodiversity Network	d897a5b9-35ee-4232-94bd-b0bcaac003c2	2d9b6f1e-1d6b-4b65-8978-23f04b4c349c
0	7000	7000	GBIF Japan	db5705aa-6a6e-42f1-8942-d77b9f4896ea	329dd7e5-9beb-4316-8991-b1fba8b2fa08
619	366	-253	GBIF Germany	4f6826f2-4ff6-443d-b966-e6913bd24013	3399fdfc-72cb-476d-99d1-39b2904e2be1
0	229	229	Plazi	ffb07bec-2d10-492d-9c37-361fe0b79427	34162c15-e5a8-4085-9bfd-be4dc280d20e
0	4	4	Plazi	ffb07bec-2d10-492d-9c37-361fe0b79427	35f10e05-cebc-46cf-9c89-10574eb8142c
3	3	0	Plazi	ffb07bec-2d10-492d-9c37-361fe0b79427	394484e3-2479-4267-a6cb-141cb0825652
0	9	9	Plazi	ffb07bec-2d10-492d-9c37-361fe0b79427	3d530979-f717-4373-98e4-a213341083d3
24	24	0	GBIF Brazil	cdc9736d-5ff7-4ece-9959-3c744360cdb3	3ea36590-9b79-46a8-9300-c9ef0bfed7b8
0	4121	4121	Ocean Biodiversity Information System	ba0670b9-4186-41e6-8e70-f9cb3065551a	3ecdb1fe-ef2d-4a41-b041-cc83e6498900
5	5	0	Plazi	ffb07bec-2d10-492d-9c37-361fe0b79427	3f8690f5-11d3-455e-82ce-79e4cce97fe9
0	1	1	Plazi	ffb07bec-2d10-492d-9c37-361fe0b79427	3fa039aa-54c0-45ae-918f-94615ba7a7d9
1652	1652	0	Belgian Biodiversity Platform	fb11cfe1-ebc3-45af-9159-17d9fddbcdac	40e9743f-8db3-4732-8c85-c4ca96596409
1	1	0	Plazi	ffb07bec-2d10-492d-9c37-361fe0b79427	42b57df3-f00d-4c0f-93cd-7b82649ef59a
1	1	0	Plazi	ffb07bec-2d10-492d-9c37-361fe0b79427	488c906f-a5c1-40cc-a69a-bf4c99f6046b
19171	19171	0	U.S. Geological Survey	8618c64a-93e0-4300-b546-7249e5148ed2	4bc6e742-69ea-4ed5-a6e5-21f674d9f884
2730	1680	-1050	GBIF Germany	4f6826f2-4ff6-443d-b966-e6913bd24013	4c2dd54e-aedb-4fbc-b1c3-72bb4a397b23
23982	27811	3829	U.S. Geological Survey	8618c64a-93e0-4300-b546-7249e5148ed2	4c3b15bd-c98f-448c-9556-810fd82e8e30
1	1	0	Plazi	ffb07bec-2d10-492d-9c37-361fe0b79427	4dbc9b69-b03d-463e-8476-ac370c0d0e08
1	1	0	Plazi	ffb07bec-2d10-492d-9c37-361fe0b79427	4f3f0033-2ed3-46b2-9630-0d1e0851362f
7622	7622	0	National Biodiversity Network	d897a5b9-35ee-4232-94bd-b0bcaac003c2	51de9c85-0337-4c68-9783-f13bc0aac15f
0	1031	1031	Ocean Biodiversity Information System	ba0670b9-4186-41e6-8e70-f9cb3065551a	52b430e7-923e-479a-8cb7-2f875c748d81
198007	257529	59522	BioCASE	d8bbf693-a180-4995-94fe-6130795dcf2f	5445131a-b491-44d8-9974-3ec52bde0c47
660	660	0	GBIF France	da44cd31-5901-4687-a106-6d1c7734ee3a	547be3c6-b0e5-4b28-8ecf-7c5cd6b7c4f0
16	16	0	Plazi	ffb07bec-2d10-492d-9c37-361fe0b79427	556969c4-a01b-4a16-907d-e0e681bbf5f6
1	1	0	Plazi	ffb07bec-2d10-492d-9c37-361fe0b79427	556b96ba-30e1-43c3-96ec-6a2c43943e48
119	119	0	GBIF France	da44cd31-5901-4687-a106-6d1c7734ee3a	561a0884-2a43-421c-bf74-15f7563842dd
2	2	0	Plazi	ffb07bec-2d10-492d-9c37-361fe0b79427	573f6526-d575-47fb-b1b7-31d87c1ef80f
8259	8259	0	GBIF Japan	db5705aa-6a6e-42f1-8942-d77b9f4896ea	5a455e8a-51b2-4ecd-9247-cfd89f9cb768
0	2	2	Plazi	ffb07bec-2d10-492d-9c37-361fe0b79427	5d4cc14a-98d3-449d-ab2e-2b99d25b5e2c
52	52	0	GBIF Germany	4f6826f2-4ff6-443d-b966-e6913bd24013	61558090-f762-11e1-a439-00145eb45e9a
54	54	0	GBIF Germany	4f6826f2-4ff6-443d-b966-e6913bd24013	629eaa80-f762-11e1-a439-00145eb45e9a
1	1	0	Plazi	ffb07bec-2d10-492d-9c37-361fe0b79427	630eb55d-5169-4473-99d6-a93396aeae38
123	123	0	GBIF Germany	4f6826f2-4ff6-443d-b966-e6913bd24013	63e875e2-f762-11e1-a439-00145eb45e9a
98	98	0	Plazi	ffb07bec-2d10-492d-9c37-361fe0b79427	64b27e40-f6d9-403f-8208-2c5058465826
327	327	0	GBIF Germany	4f6826f2-4ff6-443d-b966-e6913bd24013	64f20d7c-f762-11e1-a439-00145eb45e9a
132	131	-1	GBIF Germany	4f6826f2-4ff6-443d-b966-e6913bd24013	6580e39e-f762-11e1-a439-00145eb45e9a
75	69	-6	GBIF Germany	4f6826f2-4ff6-443d-b966-e6913bd24013	65de3198-f762-11e1-a439-00145eb45e9a
129	89	-40	GBIF Germany	4f6826f2-4ff6-443d-b966-e6913bd24013	65ff7222-f762-11e1-a439-00145eb45e9a
22	22	0	GBIF Germany	4f6826f2-4ff6-443d-b966-e6913bd24013	6884c1a0-f762-11e1-a439-00145eb45e9a
24	24	0	GBIF Germany	4f6826f2-4ff6-443d-b966-e6913bd24013	6a0e7e8a-f762-11e1-a439-00145eb45e9a
14	14	0	GBIF Germany	4f6826f2-4ff6-443d-b966-e6913bd24013	6af97e08-f762-11e1-a439-00145eb45e9a
12	12	0	GBIF Germany	4f6826f2-4ff6-443d-b966-e6913bd24013	6bcb0e3c-f762-11e1-a439-00145eb45e9a
0	23	23	Plazi	ffb07bec-2d10-492d-9c37-361fe0b79427	6bedee85-2f44-4799-a7fe-d5ad1e141575
22	22	0	GBIF Germany	4f6826f2-4ff6-443d-b966-e6913bd24013	6bf83c4a-f762-11e1-a439-00145eb45e9a
0	5	5	Plazi	ffb07bec-2d10-492d-9c37-361fe0b79427	6c0730bd-805a-4118-877f-0f6f277bf22f
170	170	0	Plazi	ffb07bec-2d10-492d-9c37-361fe0b79427	6c170c2b-8792-4173-ac41-2aa1fe2b7ab7
72	72	0	GBIF Germany	4f6826f2-4ff6-443d-b966-e6913bd24013	6caec780-f762-11e1-a439-00145eb45e9a
3	3	0	Plazi	ffb07bec-2d10-492d-9c37-361fe0b79427	6dd87e4c-4425-49d4-939e-265b2759830f
224	224	0	GBIF France	da44cd31-5901-4687-a106-6d1c7734ee3a	714e5f9f-03ab-4276-bd35-1c36ce3dda88
215	215	0	GBIF Germany	4f6826f2-4ff6-443d-b966-e6913bd24013	7154ea1c-f762-11e1-a439-00145eb45e9a
54353	54353	0	GBIF France	da44cd31-5901-4687-a106-6d1c7734ee3a	7247dc2e-b862-4555-b533-7701d183271b
11987804	11987804	0	Netherlands Biodiversity Information Facility	0909d601-bda2-42df-9e63-a6d51847ebce	740df67d-5663-41a2-9d12-33ec33876c47
15	15	0	GBIF Germany	4f6826f2-4ff6-443d-b966-e6913bd24013	7440a9c8-f762-11e1-a439-00145eb45e9a
267	267	0	GBIF Germany	4f6826f2-4ff6-443d-b966-e6913bd24013	744c1c7c-f762-11e1-a439-00145eb45e9a
338	338	0	GBIF Germany	4f6826f2-4ff6-443d-b966-e6913bd24013	7563f792-f762-11e1-a439-00145eb45e9a
45	45	0	GBIF Germany	4f6826f2-4ff6-443d-b966-e6913bd24013	760bbc8e-f762-11e1-a439-00145eb45e9a
11	11	0	Plazi	ffb07bec-2d10-492d-9c37-361fe0b79427	768fbdbe-ad7e-415f-8e22-52c0a52c71f6
1081	1081	0	Participant Node Managers Committee	7f48e0c8-5c96-49ec-b972-30748e339115	77482be1-aa51-4db4-bda1-19c9fa31dc44
650	650	0	U.S. Geological Survey	8618c64a-93e0-4300-b546-7249e5148ed2	77ea8edb-7738-4577-a6be-e646b7b24a6e
146	134	-12	GBIF Germany	4f6826f2-4ff6-443d-b966-e6913bd24013	79819adc-f762-11e1-a439-00145eb45e9a
10	10	0	GBIF France	da44cd31-5901-4687-a106-6d1c7734ee3a	7a9dfaf3-3075-45db-a405-4e322dbf7800
256	256	0	GBIF Germany	4f6826f2-4ff6-443d-b966-e6913bd24013	7bc12a10-f762-11e1-a439-00145eb45e9a
2034	2034	0	Polish Biodiversity Information Network	2618bfdf-e194-4911-a241-80db3107bc51	7c01a570-a75e-11dd-b1b2-b8a03c50a862
100	100	0	GBIF Germany	4f6826f2-4ff6-443d-b966-e6913bd24013	7db5cac4-f762-11e1-a439-00145eb45e9a
0	2	2	Plazi	ffb07bec-2d10-492d-9c37-361fe0b79427	7f8866d1-640d-4bf0-8a2c-fdeb935f323b
2191	2191	0	Biodiversity Information System of Mexico	b324e8e9-9a4c-44fa-8f1a-7f39ea7ab576	7fd1d078-f762-11e1-a439-00145eb45e9a
40	22	-18	Biodiversity Information System of Mexico	b324e8e9-9a4c-44fa-8f1a-7f39ea7ab576	802a4c8a-f762-11e1-a439-00145eb45e9a
2781	2781	0	Biodiversity Information System of Mexico	b324e8e9-9a4c-44fa-8f1a-7f39ea7ab576	806bf7d4-f762-11e1-a439-00145eb45e9a
5156	5156	0	National Biodiversity Network	d897a5b9-35ee-4232-94bd-b0bcaac003c2	808aeb00-aefc-449f-a54f-36e4a354463e
38876	38876	0	GBIF Japan	db5705aa-6a6e-42f1-8942-d77b9f4896ea	810bbd3c-f762-11e1-a439-00145eb45e9a
686	686	0	Colombian Biodiversity Information System	7e865cba-7c46-417b-ade5-97f2cf5b7be0	8183e6f8-b995-4266-b9bb-96fb784d353d
47	47	0	Belgian Biodiversity Platform	fb11cfe1-ebc3-45af-9159-17d9fddbcdac	82448a85-e723-4c19-92db-98fe2b1d076e
0	50	50	Plazi	ffb07bec-2d10-492d-9c37-361fe0b79427	8360bd6f-ac7c-45d1-91c9-e3174f33a067
0	2	2	Plazi	ffb07bec-2d10-492d-9c37-361fe0b79427	83dabff4-ab90-4503-bed5-a03f1dfb134d
83	83	0	GBIF Germany	4f6826f2-4ff6-443d-b966-e6913bd24013	85daead6-f762-11e1-a439-00145eb45e9a
677	677	0	GBIF Pakistan	e3715f62-66fe-4ecc-8c9e-7531ed0bd14c	865368a8-f762-11e1-a439-00145eb45e9a
180	135	-45	GBIF Germany	4f6826f2-4ff6-443d-b966-e6913bd24013	876e6724-f762-11e1-a439-00145eb45e9a
128	64	-64	GBIF Germany	4f6826f2-4ff6-443d-b966-e6913bd24013	8780b6b8-f762-11e1-a439-00145eb45e9a
1386	1386	0	GBIF Norway	4f829580-180d-46a9-9c87-ed8ec959b545	8904724a-8de2-41cf-848f-e6af7a80a2d3
395	395	0	GBIF Germany	4f6826f2-4ff6-443d-b966-e6913bd24013	89694f4e-f762-11e1-a439-00145eb45e9a
690	690	0	Scientific Committee on Antarctic Research	51e4e8ff-bff0-4996-8b27-9107d61b3478	89df1c06-1f0f-432a-bae7-c495837317c6
3427	3427	0	GBIF Germany	4f6826f2-4ff6-443d-b966-e6913bd24013	8ea94e2a-118c-4a53-a957-5348d48d61e1
920	788	-132	GBIF Germany	4f6826f2-4ff6-443d-b966-e6913bd24013	8ec5d782-f762-11e1-a439-00145eb45e9a
631	407	-224	GBIF Germany	4f6826f2-4ff6-443d-b966-e6913bd24013	8edeb22a-f762-11e1-a439-00145eb45e9a
75	40	-35	GBIF Germany	4f6826f2-4ff6-443d-b966-e6913bd24013	8fb46eb0-f762-11e1-a439-00145eb45e9a
174	174	0	Plazi	ffb07bec-2d10-492d-9c37-361fe0b79427	90339e7e-e883-4877-8a2c-fdda8d271281
0	2	2	Plazi	ffb07bec-2d10-492d-9c37-361fe0b79427	904598c4-3a08-4bac-9ef9-ef69dc4fa9d2
12	8	-4	GBIF Germany	4f6826f2-4ff6-443d-b966-e6913bd24013	91396d44-f762-11e1-a439-00145eb45e9a
23	23	0	GBIF Germany	4f6826f2-4ff6-443d-b966-e6913bd24013	91e4afa6-f762-11e1-a439-00145eb45e9a
364	364	0	GBIF Germany	4f6826f2-4ff6-443d-b966-e6913bd24013	9232283a-f762-11e1-a439-00145eb45e9a
15	13	-2	GBIF Germany	4f6826f2-4ff6-443d-b966-e6913bd24013	9581277a-f762-11e1-a439-00145eb45e9a
1	1	0	Pacific Biodiversity Information Forum	3b9510fc-5943-45d3-b08d-5b4e1e7c385e	96beb7d8-f762-11e1-a439-00145eb45e9a
12147	12147	0	DanBIF - Danish Biodiversity Information Facility	4ddd294f-02b7-4359-ac33-0806a9ca9c6b	96c4aa76-f762-11e1-a439-00145eb45e9a
290333	290333	0	U.S. Geological Survey	8618c64a-93e0-4300-b546-7249e5148ed2	96ca66b4-f762-11e1-a439-00145eb45e9a
587	587	0	National Biodiversity Network	d897a5b9-35ee-4232-94bd-b0bcaac003c2	9703e992-4050-462f-80f3-18f766af5cf3
26	26	0	GBIF Germany	4f6826f2-4ff6-443d-b966-e6913bd24013	9773cd8a-f762-11e1-a439-00145eb45e9a
381	381	0	GBIF Norway	4f829580-180d-46a9-9c87-ed8ec959b545	986d4f73-db26-4e13-b597-76716b1d4c67
0	13	13	Ocean Biodiversity Information System	ba0670b9-4186-41e6-8e70-f9cb3065551a	9bb4a2d0-118f-41d3-b260-b7574048162e
0	4	4	Plazi	ffb07bec-2d10-492d-9c37-361fe0b79427	9be49976-694a-414b-9003-72ee082a60d9
122038	122038	0	National Biodiversity Network	d897a5b9-35ee-4232-94bd-b0bcaac003c2	a072acef-4ec2-4a2d-8532-cd19ebe5fabc
77637	77637	0	National Biodiversity Network	d897a5b9-35ee-4232-94bd-b0bcaac003c2	a0fd78d0-6805-44ea-a9b9-ee19b710b722
14635	14635	0	Biodiversity Information System of Mexico	b324e8e9-9a4c-44fa-8f1a-7f39ea7ab576	a1229594-2bce-4682-8674-d3db51da9923
128	128	0	GBIF France	da44cd31-5901-4687-a106-6d1c7734ee3a	a1420e99-74ab-4ea6-931d-a0c15d3c0045
136	136	0	Plazi	ffb07bec-2d10-492d-9c37-361fe0b79427	a23fcefa-299b-4695-be53-d3d82b0c7677
429	429	0	GBIF Japan	db5705aa-6a6e-42f1-8942-d77b9f4896ea	a25471c2-44ed-47f6-ad80-b770f388a804
1	1	0	Plazi	ffb07bec-2d10-492d-9c37-361fe0b79427	a2683c3d-07c5-4b79-84e5-cfffd7638d42
0	2	2	Plazi	ffb07bec-2d10-492d-9c37-361fe0b79427	a5dd5d5b-3df7-411e-9259-1133b13c6727
14	14	0	Plazi	ffb07bec-2d10-492d-9c37-361fe0b79427	a7d7e32a-80c5-419e-aa74-75daf4497a88
0	120464	120464	GBIF Estonia	2c11b821-d22b-4c64-8cd3-c1578173b129	a7ef675a-9851-4919-ac77-a0f956e70d2b
0	3	3	Plazi	ffb07bec-2d10-492d-9c37-361fe0b79427	a872dd7b-78ba-4c1b-9b32-0db8fd9e83f4
60202	60202	0	GBIF Andorra	8df8d012-8e64-4c8a-886e-521a3bdfa623	a8adde1c-1d66-4ad0-846f-cdf59fc4cb0f
1	1	0	Plazi	ffb07bec-2d10-492d-9c37-361fe0b79427	aa6c3273-b562-4cbb-94eb-c46158b0cd81
4104	4104	0	Atlas of Living Australia	4a6f1b71-969e-4fc5-a693-282b05e1220c	ac9ccbe6-263f-41a8-a865-7979712bb2b4
2	2	0	Plazi	ffb07bec-2d10-492d-9c37-361fe0b79427	b575c0d4-1c3c-40c3-97bd-f160337a677b
5335	5335	0	National Biodiversity Network	d897a5b9-35ee-4232-94bd-b0bcaac003c2	b73a16c3-d258-469d-a6ea-4a87bcfb9b6c
1	1	0	Plazi	ffb07bec-2d10-492d-9c37-361fe0b79427	bb0a8a5e-6a00-4b09-90e7-e7fc2c73bb2c
342	342	0	National Biodiversity Network	d897a5b9-35ee-4232-94bd-b0bcaac003c2	bd5b2544-6a60-4c1b-b153-c1cc0220eb3f
2751	2751	0	Belgian Biodiversity Platform	fb11cfe1-ebc3-45af-9159-17d9fddbcdac	c19a2731-65c5-4f62-87d0-afbf49d1c7ce
3	3	0	Plazi	ffb07bec-2d10-492d-9c37-361fe0b79427	c8aad5ce-26a3-465d-98bb-71472fc1f737
3	3	0	Plazi	ffb07bec-2d10-492d-9c37-361fe0b79427	cc363d69-1393-4b91-ab56-342ac844a6a1
3	3	0	Plazi	ffb07bec-2d10-492d-9c37-361fe0b79427	cf34e3e4-bf24-4ff5-9fd4-e42a13f7e1fb
6	6	0	Plazi	ffb07bec-2d10-492d-9c37-361fe0b79427	cfb865bd-ba49-471b-92fa-4ee0e8843f11
4	4	0	Plazi	ffb07bec-2d10-492d-9c37-361fe0b79427	d1a82106-496f-4969-88e0-1d4f54e0dbff
1	1	0	Plazi	ffb07bec-2d10-492d-9c37-361fe0b79427	d2c0428c-3e82-4419-b554-e5ad88893140
22	22	0	Plazi	ffb07bec-2d10-492d-9c37-361fe0b79427	d66d482b-416a-461d-a5b2-7c60898c4e67
24	24	0	Plazi	ffb07bec-2d10-492d-9c37-361fe0b79427	d9c9335f-8c7b-4ac9-855f-079fce850cd5
0	4	4	Ocean Biodiversity Information System	ba0670b9-4186-41e6-8e70-f9cb3065551a	db513e18-9178-40ae-a3a3-9159c6705341
0	59	59	Plazi	ffb07bec-2d10-492d-9c37-361fe0b79427	de9c0c06-0e7d-44a6-a582-d41a346233f6
1792	1792	0	Biodiversity Information System of Mexico	b324e8e9-9a4c-44fa-8f1a-7f39ea7ab576	e2f48768-39a3-4fdf-894c-52b9776ead07
0	14	14	Plazi	ffb07bec-2d10-492d-9c37-361fe0b79427	e565126f-f2fd-49ec-a19c-7f95c6673744
409	409	0	Biodiversity Information System of Mexico	b324e8e9-9a4c-44fa-8f1a-7f39ea7ab576	e712edab-eaf9-45df-b576-4dffd043eb0c
0	7	7	Plazi	ffb07bec-2d10-492d-9c37-361fe0b79427	e9e83aca-0ab2-48dc-a701-70be4e456901
12046	12046	0	GBIF Brazil	cdc9736d-5ff7-4ece-9959-3c744360cdb3	eab87e69-2ff6-4a67-9747-962b76fbd7cc
1175	1175	0	GBIF France	da44cd31-5901-4687-a106-6d1c7734ee3a	edd7a106-086a-4c45-9d5f-13cc31d5c781
79	79	0	Plazi	ffb07bec-2d10-492d-9c37-361fe0b79427	edfb4093-4bf9-40ed-9fb4-bf492ccad12e
7056	9128	2072	GBIF Brazil	cdc9736d-5ff7-4ece-9959-3c744360cdb3	eee198af-c61d-489a-84f7-fef567e8c8d0
41	41	0	GBIF Germany	4f6826f2-4ff6-443d-b966-e6913bd24013	f05c6a3d-511c-421b-a9f8-a1bb3381d4b4
334	334	0	Colombian Biodiversity Information System	7e865cba-7c46-417b-ade5-97f2cf5b7be0	f187d1b1-12ba-4a6f-87cc-89537d3f768d
1	1	0	GBIF France	da44cd31-5901-4687-a106-6d1c7734ee3a	f19514ed-e7f5-454f-9b1a-5f2dea3b759e
4004	4004	0	GBIF Viet Nam	7f4b5eab-2edf-4b46-9360-d9574ab0f1d7	f36e1dc7-3c7f-48fa-a4d0-c84546d7309a
140	140	0	GBIF France	da44cd31-5901-4687-a106-6d1c7734ee3a	f3c2f36f-c8c4-40a2-ad34-db94a2bb9045
0	3	3	Plazi	ffb07bec-2d10-492d-9c37-361fe0b79427	f3fe1336-f9be-4f9d-84f6-8713b988de3a
1054	1054	0	Colombian Biodiversity Information System	7e865cba-7c46-417b-ade5-97f2cf5b7be0	f5375a07-ead8-4d26-bd1b-e216187b97a4
26	26	0	Plazi	ffb07bec-2d10-492d-9c37-361fe0b79427	f5660d5f-874f-40ae-b470-0d4b97cccf47
555	555	0	Ocean Biodiversity Information System	ba0670b9-4186-41e6-8e70-f9cb3065551a	f76041b1-53f6-448d-a2e1-4302bf80c93c
711	711	0	GBIF Japan	db5705aa-6a6e-42f1-8942-d77b9f4896ea	f7cba820-766f-4bdb-b202-645e130ab51f
0	3	3	Plazi	ffb07bec-2d10-492d-9c37-361fe0b79427	f96a6057-7cdd-462e-9ea1-19d7255d4816
4	4	0	Plazi	ffb07bec-2d10-492d-9c37-361fe0b79427	fa3e43c1-b578-48ca-bc8a-3f2eed5e8fa8
92	92	0	Secretariat of the Pacific Regional Environment Programme	29c6a139-ea7f-41f5-8d9b-c55af8736182	fade3e7a-82c5-4652-b482-03dbd1510b18
51	51	0	Colombian Biodiversity Information System	7e865cba-7c46-417b-ade5-97f2cf5b7be0	fd5ae2bb-6ee6-4e5c-8428-6284fa385f9a
1185	1185	0	National Biodiversity Network	d897a5b9-35ee-4232-94bd-b0bcaac003c2	fde6738c-0363-4f9e-99c5-4c46ed0d3e78
319	319	0	National Biodiversity Network	d897a5b9-35ee-4232-94bd-b0bcaac003c2	fe17fe38-29d7-48ec-a4f6-bda16a39679f
17	17	0	GBIF France	da44cd31-5901-4687-a106-6d1c7734ee3a	ff4f16f0-a883-480e-9537-7704b70b9929
0	4	4	Plazi	ffb07bec-2d10-492d-9c37-361fe0b79427	00f4d858-4541-4cb8-a271-24f313d19409
0	83	83	Participant Node Managers Committee	7f48e0c8-5c96-49ec-b972-30748e339115	011f965d-d5f5-4f76-af22-b7d051a23b3c
398	398	0	International Centre for Insect Physiology and Ecology	b9628650-eeb8-44e3-80b8-ea6626956793	01e012f0-3bd1-11df-92f0-f27520308d26
2	2	0	Plazi	ffb07bec-2d10-492d-9c37-361fe0b79427	0313c9b7-5656-4c15-8218-3bea41391dbf
16	16	0	Plazi	ffb07bec-2d10-492d-9c37-361fe0b79427	03168ca4-19e8-4ef5-a000-0e23e0c1a0d2
61	61	0	GBIF France	da44cd31-5901-4687-a106-6d1c7734ee3a	05e266bf-bcbd-494c-8426-050c29090fb2
0	1	1	Participant Node Managers Committee	7f48e0c8-5c96-49ec-b972-30748e339115	06af4db8-d7e6-48ee-8211-2c1ed7104225
2	2	0	Plazi	ffb07bec-2d10-492d-9c37-361fe0b79427	0830c7cf-1501-4d09-8b2e-23ad9e138194
285	285	0	Colombian Biodiversity Information System	7e865cba-7c46-417b-ade5-97f2cf5b7be0	086abfe4-f8c7-439c-a462-3f3453fa0a11
3	3	0	GBIF France	da44cd31-5901-4687-a106-6d1c7734ee3a	08fded02-d8ef-4346-a98a-7b5a702fcf73
0	3	3	Ocean Biodiversity Information System	ba0670b9-4186-41e6-8e70-f9cb3065551a	0b25f86b-8aa3-4813-9898-d042b96b1169
0	108	108	Belgian Biodiversity Platform	fb11cfe1-ebc3-45af-9159-17d9fddbcdac	0d1097d8-424c-48d0-b673-7dba8ca78ef7
1648	1648	0	GBIF France	da44cd31-5901-4687-a106-6d1c7734ee3a	0d3f1746-10d6-432a-b3dc-efda6904e198
1297	1297	0	GBIF France	da44cd31-5901-4687-a106-6d1c7734ee3a	0faa80bb-8d05-476c-abe2-007a553cda72
2	2	0	Plazi	ffb07bec-2d10-492d-9c37-361fe0b79427	109af072-400a-43d8-9472-7bf2feaa447e
1	1	0	Plazi	ffb07bec-2d10-492d-9c37-361fe0b79427	10ae4c09-0fbf-4674-a67b-9a3ec7481129
0	69	69	Ocean Biodiversity Information System	ba0670b9-4186-41e6-8e70-f9cb3065551a	10f3539f-de9a-44ba-bfd1-feadb202b2e7
0	24	24	Plazi	ffb07bec-2d10-492d-9c37-361fe0b79427	13966468-dd95-41ee-9647-85edbdaae120
0	10	10	Plazi	ffb07bec-2d10-492d-9c37-361fe0b79427	162b439b-d42e-4ccb-80db-a2205f1d0934
23798	23798	0	Atlas of Living Australia	4a6f1b71-969e-4fc5-a693-282b05e1220c	16e7e918-38c8-4679-a612-22d933d34946
5	5	0	Plazi	ffb07bec-2d10-492d-9c37-361fe0b79427	1744cabf-1739-4cf7-8861-1c71e5987e44
29916	29916	0	National Biodiversity Network	d897a5b9-35ee-4232-94bd-b0bcaac003c2	2150bbfa-51d0-4557-ab15-fb9459881eb7
66	66	0	Colombian Biodiversity Information System	7e865cba-7c46-417b-ade5-97f2cf5b7be0	216f47f0-ce08-429f-a832-df68f6a26a9a
838	838	0	GBIF France	da44cd31-5901-4687-a106-6d1c7734ee3a	2365b65b-7165-40fe-ae47-dc9c0f3fc19e
0	4	4	Plazi	ffb07bec-2d10-492d-9c37-361fe0b79427	25302050-df88-411e-b677-dd356ae202ba
2	2	0	Plazi	ffb07bec-2d10-492d-9c37-361fe0b79427	2610b4ad-6618-4894-b992-fd3f30229ecf
564020	564020	0	U.S. Geological Survey	8618c64a-93e0-4300-b546-7249e5148ed2	262f8270-f9c2-4bc6-a562-8ed71c0790e6
900	900	0	GBIF Germany	4f6826f2-4ff6-443d-b966-e6913bd24013	26b91634-d07a-41a0-9ef2-8c62aa9b20dd
0	24	24	Plazi	ffb07bec-2d10-492d-9c37-361fe0b79427	28190fde-35c3-4e10-b6a0-a45027518be0
149	149	0	Colombian Biodiversity Information System	7e865cba-7c46-417b-ade5-97f2cf5b7be0	28e9f58b-1c27-4f97-9e41-67adec0b556e
1	1	0	Plazi	ffb07bec-2d10-492d-9c37-361fe0b79427	2abd0eee-d141-4b16-a11d-f75a4151aa45
1	1	0	Participant Node Managers Committee	7f48e0c8-5c96-49ec-b972-30748e339115	2ad1e009-c1c5-4004-b5a7-ee77f100a47d
2327	2327	0	National Biodiversity Network	d897a5b9-35ee-4232-94bd-b0bcaac003c2	2b554e59-a523-40d5-975c-f3641189f42f
19	19	0	Plazi	ffb07bec-2d10-492d-9c37-361fe0b79427	2c2cf784-9710-4201-b23e-a7b768af5567
8	8	0	Plazi	ffb07bec-2d10-492d-9c37-361fe0b79427	2d171156-9ab9-4d68-96dc-1480a2517a11
0	18	18	Plazi	ffb07bec-2d10-492d-9c37-361fe0b79427	2f8c7065-6e4b-46b1-89af-809f51afdcf2
3	3	0	Plazi	ffb07bec-2d10-492d-9c37-361fe0b79427	2fba0dbf-ef55-4692-b412-a200299ea727
156	156	0	GBIF Argentina	2426a871-9feb-40a1-96c6-0c593a76b835	31ba5d3c-ce41-45ce-b9f7-08f9b28e3390
72	72	0	GBIF Germany	4f6826f2-4ff6-443d-b966-e6913bd24013	3362bc99-da0a-4537-9f01-d54a0b502aa9
1482	1482	0	GBIF Germany	4f6826f2-4ff6-443d-b966-e6913bd24013	35007d95-03f9-4b1c-9b57-7e92adcc5634
0	2	2	Plazi	ffb07bec-2d10-492d-9c37-361fe0b79427	38cfce7a-e7fc-4c46-9a4b-b7c2deaaef5f
0	24	24	Ocean Biodiversity Information System	ba0670b9-4186-41e6-8e70-f9cb3065551a	39f189da-87ab-40b9-8cfd-116351626a53
6	6	0	Plazi	ffb07bec-2d10-492d-9c37-361fe0b79427	3bc97516-525c-42cb-9828-2313fb2ea2e6
527	527	0	GBIF Madagascar	2dbfc5c5-51b5-4494-9dfc-4d3f013a3b64	3d0fc1a4-9102-4a7d-98f6-563e5252979a
0	1043	1043	GBIF Chile	a8b16421-d80b-4ef3-8f22-098b01a89255	3d7b1df3-9e20-403a-8e42-d3c1e4d5e40c
5	5	0	Plazi	ffb07bec-2d10-492d-9c37-361fe0b79427	3e3123a6-d497-4ef4-afa0-7cf0ef7f9afa
51	31	-20	GBIF Germany	4f6826f2-4ff6-443d-b966-e6913bd24013	3f5c45f3-a80b-41fd-84ba-1f38c88802ba
43	43	0	Plazi	ffb07bec-2d10-492d-9c37-361fe0b79427	4098c432-a6b6-4cbf-9d81-ac29ba03add9
117	117	0	Colombian Biodiversity Information System	7e865cba-7c46-417b-ade5-97f2cf5b7be0	420051c9-a5e7-4f86-8cca-317cc8b51fb3
458	458	0	Participant Node Managers Committee	7f48e0c8-5c96-49ec-b972-30748e339115	438245ee-99e3-4417-bd4f-4ef7ecc16660
2	2	0	Plazi	ffb07bec-2d10-492d-9c37-361fe0b79427	4776896f-493b-4d58-acfb-ddeeb70ec4fc
15616	28512	12896	National Biodiversity Network	d897a5b9-35ee-4232-94bd-b0bcaac003c2	48cd7d66-191b-4896-a2bf-f0665dad7a89
76	76	0	Plazi	ffb07bec-2d10-492d-9c37-361fe0b79427	4a8c93cb-53fb-428d-a836-4ce42b23fd50
60163	60163	0	U.S. Geological Survey	8618c64a-93e0-4300-b546-7249e5148ed2	4d749d70-e2e1-11dd-8102-b8a03c50a862
42	42	0	GBIF Brazil	cdc9736d-5ff7-4ece-9959-3c744360cdb3	4de312bd-27bd-4eae-b599-d7cc206f5860
2	2	0	Plazi	ffb07bec-2d10-492d-9c37-361fe0b79427	4f72c031-e25d-4d53-bd04-0c4418434b07
495	495	0	Atlas of Living Australia	4a6f1b71-969e-4fc5-a693-282b05e1220c	51ffcd3a-f71f-491e-b75a-505657c3770e
0	229	229	GBIF Uganda	71b40829-6a12-4c3d-8fee-5746f5e9cf8c	549a14ba-7a14-4da7-a94a-9b18a3b8f04a
0	21	21	Plazi	ffb07bec-2d10-492d-9c37-361fe0b79427	55d873c4-3641-44e2-98b1-933f6a0266f5
2076	2076	0	GBIF Switzerland	169eb292-376b-4cc6-8e31-9c2c432de0ad	56a8bcc6-abee-44f7-bb9a-24cf3790a681
342	342	0	Biodiversity Information System of Mexico	b324e8e9-9a4c-44fa-8f1a-7f39ea7ab576	56ee8659-8f92-4c86-8bd8-5e5dbe110c61
0	1688	1688	Korean Biodiversity Information Facility	e0a1e772-0177-4800-94b4-2d023fe6cdf4	599532ca-9e98-400c-bbd3-33bc09a0db59
0	141	141	Ocean Biodiversity Information System	ba0670b9-4186-41e6-8e70-f9cb3065551a	5a32e307-49c5-48ee-9190-825ad4cc3c28
0	1	1	Plazi	ffb07bec-2d10-492d-9c37-361fe0b79427	5aa97143-4dff-4a37-8f4b-0bff936ef2bd
113	113	0	GBIF Germany	4f6826f2-4ff6-443d-b966-e6913bd24013	615b4610-f762-11e1-a439-00145eb45e9a
60102	60102	0	GBIF Switzerland	169eb292-376b-4cc6-8e31-9c2c432de0ad	63e9e22d-a649-4087-b39e-acb1651af077
896	896	0	Colombian Biodiversity Information System	7e865cba-7c46-417b-ade5-97f2cf5b7be0	63f1a4ba-4554-4116-a5c2-e14623e9a4f9
51	50	-1	GBIF Germany	4f6826f2-4ff6-443d-b966-e6913bd24013	65aefa2c-f762-11e1-a439-00145eb45e9a
54	54	0	GBIF Germany	4f6826f2-4ff6-443d-b966-e6913bd24013	66864680-f762-11e1-a439-00145eb45e9a
833	833	0	GBIF Germany	4f6826f2-4ff6-443d-b966-e6913bd24013	67b41be9-1473-4d3a-ba6c-40fc4f5cf6e1
109075	295980	186905	National Biodiversity Network	d897a5b9-35ee-4232-94bd-b0bcaac003c2	68ad7ec2-0f89-4d32-9ad2-650c88899eb8
90	90	0	GBIF Germany	4f6826f2-4ff6-443d-b966-e6913bd24013	68b19f2c-f762-11e1-a439-00145eb45e9a
53	53	0	GBIF Germany	4f6826f2-4ff6-443d-b966-e6913bd24013	69b5a5a8-f762-11e1-a439-00145eb45e9a
98	98	0	GBIF France	da44cd31-5901-4687-a106-6d1c7734ee3a	6a7aee01-0215-48df-9aea-5f148b2035fc
18	18	0	GBIF Germany	4f6826f2-4ff6-443d-b966-e6913bd24013	6b30507c-f762-11e1-a439-00145eb45e9a
4	4	0	GBIF Germany	4f6826f2-4ff6-443d-b966-e6913bd24013	6b58bf12-f762-11e1-a439-00145eb45e9a
24	24	0	GBIF Germany	4f6826f2-4ff6-443d-b966-e6913bd24013	6b7e2464-f762-11e1-a439-00145eb45e9a
37	37	0	Atlas of Living Australia	4a6f1b71-969e-4fc5-a693-282b05e1220c	6e4b8bf0-7442-4faf-b94a-2987e89ebd37
0	29	29	Participant Node Managers Committee	7f48e0c8-5c96-49ec-b972-30748e339115	6e526631-5cf0-49cb-8f6c-ede87474b30d
2	2	0	Plazi	ffb07bec-2d10-492d-9c37-361fe0b79427	6f730ed0-cc2b-4cb7-be45-95c15b59df4e
7	7	0	GBIF Germany	4f6826f2-4ff6-443d-b966-e6913bd24013	6f8f4ace-f762-11e1-a439-00145eb45e9a
287	287	0	GBIF Germany	4f6826f2-4ff6-443d-b966-e6913bd24013	6fc88654-f762-11e1-a439-00145eb45e9a
3287	2733	-554	GBIF Germany	4f6826f2-4ff6-443d-b966-e6913bd24013	709ca236-f762-11e1-a439-00145eb45e9a
42	42	0	GBIF Germany	4f6826f2-4ff6-443d-b966-e6913bd24013	71ab2224-f762-11e1-a439-00145eb45e9a
10	10	0	GBIF Germany	4f6826f2-4ff6-443d-b966-e6913bd24013	72c64e04-f762-11e1-a439-00145eb45e9a
10	10	0	Plazi	ffb07bec-2d10-492d-9c37-361fe0b79427	72e24462-21d7-4fd1-9f96-d802aa8817aa
75231	75231	0	GBIF France	da44cd31-5901-4687-a106-6d1c7734ee3a	732b8816-1367-4cb2-80f9-343063ed3442
8	8	0	GBIF Germany	4f6826f2-4ff6-443d-b966-e6913bd24013	73890f66-f762-11e1-a439-00145eb45e9a
3	3	0	GBIF Germany	4f6826f2-4ff6-443d-b966-e6913bd24013	74be99fa-f762-11e1-a439-00145eb45e9a
902	965	63	GBIF Germany	4f6826f2-4ff6-443d-b966-e6913bd24013	74df73b4-f762-11e1-a439-00145eb45e9a
4429	4429	0	GBIF Benin	efb9c00e-f802-45dd-8826-a52ec45b89ff	7582ffb2-2059-450a-96f6-4a7c0cffe6b7
1	1	0	Plazi	ffb07bec-2d10-492d-9c37-361fe0b79427	75cd1a05-1af8-49fd-960c-b1e43def4920
7	7	0	Plazi	ffb07bec-2d10-492d-9c37-361fe0b79427	76344059-eb20-48e7-be95-c7f477a9ae2a
830	830	0	GBIF Germany	4f6826f2-4ff6-443d-b966-e6913bd24013	79361ca6-f762-11e1-a439-00145eb45e9a
233	195	-38	GBIF Germany	4f6826f2-4ff6-443d-b966-e6913bd24013	7965a4e4-f762-11e1-a439-00145eb45e9a
68	58	-10	GBIF Germany	4f6826f2-4ff6-443d-b966-e6913bd24013	797b85c0-f762-11e1-a439-00145eb45e9a
1081	778	-303	GBIF Germany	4f6826f2-4ff6-443d-b966-e6913bd24013	79e2f6f6-f762-11e1-a439-00145eb45e9a
11169	11169	0	GBIF Japan	db5705aa-6a6e-42f1-8942-d77b9f4896ea	7adda6be-f762-11e1-a439-00145eb45e9a
1289	1298	9	Biodiversity Information System of Mexico	b324e8e9-9a4c-44fa-8f1a-7f39ea7ab576	7b4ddcab-3bb1-4c28-a805-b166a550410c
22	22	0	Plazi	ffb07bec-2d10-492d-9c37-361fe0b79427	7db5c952-59b4-4879-a8de-7709dfd725a0
3729	3643	-86	GBIF Germany	4f6826f2-4ff6-443d-b966-e6913bd24013	7dcd24e4-f762-11e1-a439-00145eb45e9a
548	548	0	GBIF Germany	4f6826f2-4ff6-443d-b966-e6913bd24013	7efdebd2-f762-11e1-a439-00145eb45e9a
4	4	0	Plazi	ffb07bec-2d10-492d-9c37-361fe0b79427	7f1df16a-f21e-47c4-837a-58b5d3461a9c
90	90	0	GBIF Germany	4f6826f2-4ff6-443d-b966-e6913bd24013	7f328c52-f762-11e1-a439-00145eb45e9a
0	2	2	Plazi	ffb07bec-2d10-492d-9c37-361fe0b79427	7f4f3d5a-c278-4b4d-88e0-94291e9e0460
3293	3293	0	Biodiversity Information System of Mexico	b324e8e9-9a4c-44fa-8f1a-7f39ea7ab576	7fe6b042-f762-11e1-a439-00145eb45e9a
177	177	0	GBIF Japan	db5705aa-6a6e-42f1-8942-d77b9f4896ea	80fead18-f762-11e1-a439-00145eb45e9a
5	5	0	Plazi	ffb07bec-2d10-492d-9c37-361fe0b79427	8133cb54-f817-4f3f-a4da-986f7475816a
985	1011	26	GBIF Germany	4f6826f2-4ff6-443d-b966-e6913bd24013	81a29c98-f762-11e1-a439-00145eb45e9a
227	227	0	Plazi	ffb07bec-2d10-492d-9c37-361fe0b79427	81a32fc3-9362-4ec2-b507-54859001f1e0
0	47	47	Plazi	ffb07bec-2d10-492d-9c37-361fe0b79427	81a3d76f-698c-4464-8536-77a444e6c272
0	4	4	Plazi	ffb07bec-2d10-492d-9c37-361fe0b79427	823a1d31-9115-4f38-abb7-42eb8e95fadd
1488	1487	-1	National Biodiversity Network	d897a5b9-35ee-4232-94bd-b0bcaac003c2	823a67e8-a485-41a0-a2cd-90686b4d56be
50	50	0	GBIF Germany	4f6826f2-4ff6-443d-b966-e6913bd24013	827d08f2-3b01-4250-bc94-6015cfe80fc7
508	508	0	Colombian Biodiversity Information System	7e865cba-7c46-417b-ade5-97f2cf5b7be0	82c968f1-2399-40ec-9b85-5fe3e02a29a4
8	8	0	Plazi	ffb07bec-2d10-492d-9c37-361fe0b79427	843f9577-1664-4e17-b6a6-aa69fb7665c7
0	1	1	Plazi	ffb07bec-2d10-492d-9c37-361fe0b79427	85a52735-5112-4407-b9bb-61dd3b03962d
898	898	0	GBIF Japan	db5705aa-6a6e-42f1-8942-d77b9f4896ea	861ae8f2-f762-11e1-a439-00145eb45e9a
2841	2372	-469	GBIF Germany	4f6826f2-4ff6-443d-b966-e6913bd24013	870c096c-f762-11e1-a439-00145eb45e9a
838	777	-61	GBIF Germany	4f6826f2-4ff6-443d-b966-e6913bd24013	8724a72e-f762-11e1-a439-00145eb45e9a
15938	11880	-4058	GBIF Germany	4f6826f2-4ff6-443d-b966-e6913bd24013	873d986a-f762-11e1-a439-00145eb45e9a
0	2	2	Plazi	ffb07bec-2d10-492d-9c37-361fe0b79427	87c54939-17f2-4395-bec6-72dd2230e1a6
7	7	0	Plazi	ffb07bec-2d10-492d-9c37-361fe0b79427	87c8264d-d1fc-44fe-98d8-f0ddf16bd0ff
11	11	0	GBIF Germany	4f6826f2-4ff6-443d-b966-e6913bd24013	887fae66-f762-11e1-a439-00145eb45e9a
1	1	0	Plazi	ffb07bec-2d10-492d-9c37-361fe0b79427	89686326-030c-4d79-8ccb-8c2db484c121
0	196	196	Plazi	ffb07bec-2d10-492d-9c37-361fe0b79427	898c476c-0dc8-4925-a3d8-96bb567b6d43
275	275	0	GBIF Germany	4f6826f2-4ff6-443d-b966-e6913bd24013	89b8ee96-f762-11e1-a439-00145eb45e9a
302	302	0	GBIF Germany	4f6826f2-4ff6-443d-b966-e6913bd24013	8a628bd6-f762-11e1-a439-00145eb45e9a
106	106	0	GBIF Germany	4f6826f2-4ff6-443d-b966-e6913bd24013	8ab769e4-f762-11e1-a439-00145eb45e9a
146	146	0	GBIF Germany	4f6826f2-4ff6-443d-b966-e6913bd24013	8acb164c-f762-11e1-a439-00145eb45e9a
7354	7354	0	GBIF France	da44cd31-5901-4687-a106-6d1c7734ee3a	8b467987-27a5-4a44-b01f-5f1192dbf70f
31	26	-5	GBIF Germany	4f6826f2-4ff6-443d-b966-e6913bd24013	8c564b12-f762-11e1-a439-00145eb45e9a
40	29	-11	GBIF Germany	4f6826f2-4ff6-443d-b966-e6913bd24013	8c8f5358-f762-11e1-a439-00145eb45e9a
7	7	0	GBIF Germany	4f6826f2-4ff6-443d-b966-e6913bd24013	8d91c862-f762-11e1-a439-00145eb45e9a
36	36	0	Plazi	ffb07bec-2d10-492d-9c37-361fe0b79427	8fc09650-9046-4bcd-bcbc-86b9ef2c221a
670	670	0	GBIF Japan	db5705aa-6a6e-42f1-8942-d77b9f4896ea	8fe65b53-65c2-4534-9c0a-da36914a0f70
1946	1946	0	GBIF Germany	4f6826f2-4ff6-443d-b966-e6913bd24013	9090f312-f762-11e1-a439-00145eb45e9a
1201	1153	-48	Biodiversity Information System of Mexico	b324e8e9-9a4c-44fa-8f1a-7f39ea7ab576	91fa7d04-42e3-4e7e-b8ec-927a7b52c805
6	6	0	GBIF Germany	4f6826f2-4ff6-443d-b966-e6913bd24013	9280eaa6-f762-11e1-a439-00145eb45e9a
33	33	0	GBIF Germany	4f6826f2-4ff6-443d-b966-e6913bd24013	93899b28-f762-11e1-a439-00145eb45e9a
333	333	0	GBIF Germany	4f6826f2-4ff6-443d-b966-e6913bd24013	9399b440-f762-11e1-a439-00145eb45e9a
19	19	0	GBIF Germany	4f6826f2-4ff6-443d-b966-e6913bd24013	93cb1558-f762-11e1-a439-00145eb45e9a
372	372	0	GBIF Germany	4f6826f2-4ff6-443d-b966-e6913bd24013	9402f4c8-f762-11e1-a439-00145eb45e9a
0	54	54	Plazi	ffb07bec-2d10-492d-9c37-361fe0b79427	94123c77-d2c7-4aa7-9bdb-8367f7851b82
15	15	0	Plazi	ffb07bec-2d10-492d-9c37-361fe0b79427	958ff34b-f5e0-4e8f-903f-2b4473bb69b3
217	217	0	GBIF Germany	4f6826f2-4ff6-443d-b966-e6913bd24013	9591efb0-f762-11e1-a439-00145eb45e9a
25000	28998	3998	GBIF Japan	db5705aa-6a6e-42f1-8942-d77b9f4896ea	95eff7ea-f762-11e1-a439-00145eb45e9a
12558	12557	-1	GBIF Japan	db5705aa-6a6e-42f1-8942-d77b9f4896ea	95f27218-f762-11e1-a439-00145eb45e9a
6651	6651	0	GBIF Brazil	cdc9736d-5ff7-4ece-9959-3c744360cdb3	99944819-a402-4862-a07b-bcb3dd63b59b
0	2	2	Plazi	ffb07bec-2d10-492d-9c37-361fe0b79427	9f5b64dd-ca1a-4c5b-b6fc-60c4020ccb14
15	15	0	Plazi	ffb07bec-2d10-492d-9c37-361fe0b79427	a06f106d-8cbb-4b1b-9021-e337f92446cd
31	31	0	GBIF Togo	c9659a3e-07e9-4fcb-83c6-de8b9009a02e	a0b65e62-ca3e-4330-9344-19c915f12d0f
19874	19874	0	National Biodiversity Network	d897a5b9-35ee-4232-94bd-b0bcaac003c2	a6480411-fc6c-41c9-bc52-6a6380f1d76e
3	3	0	Plazi	ffb07bec-2d10-492d-9c37-361fe0b79427	a7c626e6-097a-486b-80a1-309d02be4506
24767	24767	0	U.S. Geological Survey	8618c64a-93e0-4300-b546-7249e5148ed2	a9ae9ece-e753-4fb9-8595-a37d0f5aa59c
1287	1287	0	Plazi	ffb07bec-2d10-492d-9c37-361fe0b79427	aa238a39-adf8-4b94-8808-c788670d0455
5	5	0	Plazi	ffb07bec-2d10-492d-9c37-361fe0b79427	aa97d560-1969-4b79-93bb-2614b7835c0e
0	4	4	Plazi	ffb07bec-2d10-492d-9c37-361fe0b79427	ad21a7b1-20cd-4f62-9c23-167d9e9783d6
0	39	39	Plazi	ffb07bec-2d10-492d-9c37-361fe0b79427	af0796d2-af76-4e84-baad-859243e59825
61458	61458	0	GBIF Brazil	cdc9736d-5ff7-4ece-9959-3c744360cdb3	afb012a7-e54e-47ee-a631-6c444fe68ba1
4183	4183	0	National Biodiversity Network	d897a5b9-35ee-4232-94bd-b0bcaac003c2	b08600a5-1737-474b-a987-91977c0af258
911	911	0	GBIF France	da44cd31-5901-4687-a106-6d1c7734ee3a	b2bad50f-ae0c-4056-9ca6-18e242ca36d9
0	49	49	Plazi	ffb07bec-2d10-492d-9c37-361fe0b79427	b30067f2-2707-49c3-9908-08f3c4f8beb2
22	22	0	GBIF France	da44cd31-5901-4687-a106-6d1c7734ee3a	b3d7b8a2-a25c-40a5-a406-352f0314af4c
979	979	0	Burkina Faso	086f5148-c0a8-469b-84cc-cce5342f9242	b5dc599c-2c51-4878-a92b-52f601f94335
603	603	0	Belgian Biodiversity Platform	fb11cfe1-ebc3-45af-9159-17d9fddbcdac	b5e4bc1b-ec14-4ff1-8eef-9c15ab6a7b75
0	143	143	Ocean Biodiversity Information System	ba0670b9-4186-41e6-8e70-f9cb3065551a	b6799d52-6c28-4b02-b0dc-56d503858323
0	199	199	Ocean Biodiversity Information System	ba0670b9-4186-41e6-8e70-f9cb3065551a	b8e7e169-5cc1-4be4-baf3-e2747df2b4db
42	42	0	Atlas of Living Australia	4a6f1b71-969e-4fc5-a693-282b05e1220c	b92284e8-cf98-4827-8fa4-7cb764cfaca7
2	2	0	Plazi	ffb07bec-2d10-492d-9c37-361fe0b79427	b92cbe19-c0ed-4a43-bd57-880320dfc269
449	449	0	Belgian Biodiversity Platform	fb11cfe1-ebc3-45af-9159-17d9fddbcdac	bd1c0da1-f98e-43d7-b183-b8fa6e43a528
67	67	0	Colombian Biodiversity Information System	7e865cba-7c46-417b-ade5-97f2cf5b7be0	be2fd297-7a54-4bca-af14-9cd43fa51852
11	11	0	Plazi	ffb07bec-2d10-492d-9c37-361fe0b79427	c026b052-b7ca-498d-b55b-5b3c092d0c84
0	2	2	Plazi	ffb07bec-2d10-492d-9c37-361fe0b79427	c224c07b-2a23-4a59-92a2-9843f4a7e687
18631	18631	0	National Biodiversity Network	d897a5b9-35ee-4232-94bd-b0bcaac003c2	c44436e1-0be5-449c-a782-2a23128274b0
855	855	0	GBIF Brazil	cdc9736d-5ff7-4ece-9959-3c744360cdb3	c53818b5-7d47-4315-a829-f4cdc94d1b83
0	29	29	Plazi	ffb07bec-2d10-492d-9c37-361fe0b79427	c83ed763-9e8d-4913-bd4b-114b6e66707e
0	276	276	Plazi	ffb07bec-2d10-492d-9c37-361fe0b79427	c92006cf-4f1e-42fe-a74e-72128b442fb0
711	711	0	Plazi	ffb07bec-2d10-492d-9c37-361fe0b79427	c95521a8-9ea3-442d-af0a-bc23f790e0f9
208	208	0	Plazi	ffb07bec-2d10-492d-9c37-361fe0b79427	c974b6bd-16f6-4c51-8b4a-6bb874748410
3	3	0	Plazi	ffb07bec-2d10-492d-9c37-361fe0b79427	cad9a73d-be83-4f57-af17-23b747d15cda
35629	35629	0	National Biodiversity Network	d897a5b9-35ee-4232-94bd-b0bcaac003c2	cb3fc082-67f1-44a0-be8e-95d7d4aafbac
0	126	126	Ocean Biodiversity Information System	ba0670b9-4186-41e6-8e70-f9cb3065551a	cedd65f2-e9a6-4669-902e-2a81e8044845
0	148	148	GBIF France	da44cd31-5901-4687-a106-6d1c7734ee3a	cf8f898e-4ae3-4371-a2d9-aef01585fb75
2	2	0	Plazi	ffb07bec-2d10-492d-9c37-361fe0b79427	d16178ec-2278-4c7a-a479-53423c68e52c
0	91141	91141	GBIF France	da44cd31-5901-4687-a106-6d1c7734ee3a	d1d386f4-1c00-48c0-b9b2-5efdec12b159
0	1	1	Plazi	ffb07bec-2d10-492d-9c37-361fe0b79427	d21ee62b-62da-4e85-8c9d-9bae52962a16
625	625	0	GBIF Germany	4f6826f2-4ff6-443d-b966-e6913bd24013	d26e5f24-a070-4a0b-b58c-d6eb84bf54ae
119	119	0	GBIF France	da44cd31-5901-4687-a106-6d1c7734ee3a	d2c1c2d9-4724-4dfc-86c7-1a86608506e6
2	2	0	Plazi	ffb07bec-2d10-492d-9c37-361fe0b79427	d3effb10-fefa-42d2-8443-97124d728fe6
3093	3093	0	Colombian Biodiversity Information System	7e865cba-7c46-417b-ade5-97f2cf5b7be0	d4ba9607-189b-4c35-af5c-0b6ca3a54d50
220	220	0	Plazi	ffb07bec-2d10-492d-9c37-361fe0b79427	d93b2bd2-75e1-467c-89d3-e2faee3b10a4
174	174	0	Ocean Biodiversity Information System	ba0670b9-4186-41e6-8e70-f9cb3065551a	d996f305-c5a7-41d8-8f55-766601ec70f8
11840	11840	0	U.S. Geological Survey	8618c64a-93e0-4300-b546-7249e5148ed2	da09ae86-b126-4780-bc81-58c40b8b927a
10	10	0	Plazi	ffb07bec-2d10-492d-9c37-361fe0b79427	db1a48bf-e5ec-4523-93bf-24af1ebb4a72
5	5	0	Plazi	ffb07bec-2d10-492d-9c37-361fe0b79427	db419a2b-8a4b-48a8-8dc4-d09e8ea12fbf
2031	1882	-149	GBIF Germany	4f6826f2-4ff6-443d-b966-e6913bd24013	dbd9bce5-5405-4e02-b2ce-7f4b0f32a337
9488	9488	0	GBIF Brazil	cdc9736d-5ff7-4ece-9959-3c744360cdb3	df761c30-988d-4ff8-b7d4-b24ff51c0c8d
28	28	0	Plazi	ffb07bec-2d10-492d-9c37-361fe0b79427	e12b1516-6759-4f52-96ac-208050b51a4b
0	61	61	Ocean Biodiversity Information System	ba0670b9-4186-41e6-8e70-f9cb3065551a	e19879fb-f61b-4015-bb09-4dc28e80351d
7008	7008	0	GBIF Germany	4f6826f2-4ff6-443d-b966-e6913bd24013	e210c320-819b-11e2-bad2-00145eb45e9a
0	318	318	Belgian Biodiversity Platform	fb11cfe1-ebc3-45af-9159-17d9fddbcdac	e27487c3-20c8-4307-9d2f-40f9a69f365b
1092	1092	0	Participant Node Managers Committee	7f48e0c8-5c96-49ec-b972-30748e339115	e396bc9e-99f8-4187-85c5-ef2b4e500392
0	13994	13994	Ocean Biodiversity Information System	ba0670b9-4186-41e6-8e70-f9cb3065551a	e58a6887-8ea7-4c34-aeac-bc45e8760789
0	47	47	Plazi	ffb07bec-2d10-492d-9c37-361fe0b79427	e602c4fe-7400-4287-b3f5-62fecf81f369
63	1455	1392	GBIF Germany	4f6826f2-4ff6-443d-b966-e6913bd24013	ee5109f5-a167-4ab4-87c3-176e010292fa
50	1579	1529	GBIF Germany	4f6826f2-4ff6-443d-b966-e6913bd24013	f03fc347-2609-4095-9cb6-0421845cd12c
22	22	0	Plazi	ffb07bec-2d10-492d-9c37-361fe0b79427	f0417544-ffc1-44fa-881d-7a46fc70b421
0	8	8	Plazi	ffb07bec-2d10-492d-9c37-361fe0b79427	f0978062-2685-4097-9e8b-675d7236b071
195	195	0	Biodiversity Information System of Mexico	b324e8e9-9a4c-44fa-8f1a-7f39ea7ab576	f19e9d7a-ee24-40aa-b5ff-0dd4732e835a
0	105	105	Plazi	ffb07bec-2d10-492d-9c37-361fe0b79427	f2daf753-e802-4035-9a1f-6878de66e7ca
0	24	24	Ocean Biodiversity Information System	ba0670b9-4186-41e6-8e70-f9cb3065551a	f44af5b2-ca68-46a9-8a59-5a2d1e233e6c
127	127	0	Ocean Biodiversity Information System	ba0670b9-4186-41e6-8e70-f9cb3065551a	f70aae50-d156-45d8-a0d1-645231732822
0	6	6	Plazi	ffb07bec-2d10-492d-9c37-361fe0b79427	f809f832-ad17-4fdd-9204-e393e373633c
207	207	0	GBIF France	da44cd31-5901-4687-a106-6d1c7734ee3a	fa52d7a4-a137-4200-bbdd-11c61fa1dc18
0	4	4	Plazi	ffb07bec-2d10-492d-9c37-361fe0b79427	fced2bcd-4581-4572-95dc-f2efa8d924de
117	117	0	Colombian Biodiversity Information System	7e865cba-7c46-417b-ade5-97f2cf5b7be0	0590308e-ca1c-461e-ab69-794807f3f113
78686	79964	1278	GBIF Brazil	cdc9736d-5ff7-4ece-9959-3c744360cdb3	09010edb-5e55-4dc0-8a97-a26a3bb89e85
44	44	0	National Biodiversity Network	d897a5b9-35ee-4232-94bd-b0bcaac003c2	0a1d1c78-70e3-451b-870d-72e86792bb0b
0	7	7	Ocean Biodiversity Information System	ba0670b9-4186-41e6-8e70-f9cb3065551a	0ce497fd-8318-4e31-8900-c390abe03fc0
88	88	0	Atlas of Living Australia	4a6f1b71-969e-4fc5-a693-282b05e1220c	0d979703-5f6b-424e-aa10-eb611202fe8e
0	8	8	Ocean Biodiversity Information System	ba0670b9-4186-41e6-8e70-f9cb3065551a	0e6871c9-25c2-4b70-aa0c-668fe5908e8f
0	736	736	GBIF Spain	1f94b3ca-9345-4d65-afe2-4bace93aa0fe	0e6f1c5b-b546-4743-98a5-6b0030ca18f8
0	8	8	Plazi	ffb07bec-2d10-492d-9c37-361fe0b79427	1325ca6e-8ac3-4535-b243-0b5fa6b53c53
5638	5638	0	GBIF Benin	efb9c00e-f802-45dd-8826-a52ec45b89ff	178c8319-35b0-4396-ba6a-4abd38291ea4
97	97	0	Plazi	ffb07bec-2d10-492d-9c37-361fe0b79427	18d263ac-9913-4f11-843c-862ca11a38e6
1	1	0	Plazi	ffb07bec-2d10-492d-9c37-361fe0b79427	19f437c5-bfb5-4223-b662-c45fd7003ebf
155003	158149	3146	GBIF Brazil	cdc9736d-5ff7-4ece-9959-3c744360cdb3	1bb3cae3-b91f-4109-8a2d-a1f05f2d6fd3
21	21	0	National Biodiversity Network	d897a5b9-35ee-4232-94bd-b0bcaac003c2	1ecd4976-5a70-446f-8905-020faf3e2dcf
555	555	0	Colombian Biodiversity Information System	7e865cba-7c46-417b-ade5-97f2cf5b7be0	20d8ad6d-4291-48f1-9eeb-f2ef1283330b
40	40	0	Plazi	ffb07bec-2d10-492d-9c37-361fe0b79427	2737c0d7-97dc-4770-9ec1-d420a668bd4a
22586	22586	0	National Biodiversity Network	d897a5b9-35ee-4232-94bd-b0bcaac003c2	27e416d9-ac57-48a6-ad78-55990f7af998
0	7	7	Plazi	ffb07bec-2d10-492d-9c37-361fe0b79427	281a5531-5083-418f-a98c-5b0be97f1eae
11795	11863	68	GBIF France	da44cd31-5901-4687-a106-6d1c7734ee3a	2cc23bac-e94b-414f-95ab-cc838c03f765
1199	1199	0	National Biodiversity Network	d897a5b9-35ee-4232-94bd-b0bcaac003c2	2eecc049-0955-4231-a615-aa355c3f28b0
15570	15570	0	GBIF France	da44cd31-5901-4687-a106-6d1c7734ee3a	3158875a-b199-4607-9e7d-bdebc0f2f87d
0	19	19	Plazi	ffb07bec-2d10-492d-9c37-361fe0b79427	31ed99a5-9135-40a2-92a4-64217d9de577
1296	1296	0	GBIF Finland	dd514216-5c7c-45f3-910d-797424cb5be6	320d73ed-133a-4c9b-8b02-e75d77662804
45	45	0	Biodiversity Information System of Mexico	b324e8e9-9a4c-44fa-8f1a-7f39ea7ab576	334f20ec-3727-4db3-886b-7280e1f93204
456	406	-50	GBIF Germany	4f6826f2-4ff6-443d-b966-e6913bd24013	35ac8c0d-257e-4ab3-8f0e-57c3db99ca3c
17450	17450	0	National Biodiversity Network	d897a5b9-35ee-4232-94bd-b0bcaac003c2	38a86666-00e8-4e04-82c4-cee2f2e81c52
7	7	0	Plazi	ffb07bec-2d10-492d-9c37-361fe0b79427	3c23a274-5b53-4703-bed7-ce77edbac279
4	4	0	Participant Node Managers Committee	7f48e0c8-5c96-49ec-b972-30748e339115	3d115034-84b5-47d0-a0c4-78722640684c
81	31	-50	GBIF Germany	4f6826f2-4ff6-443d-b966-e6913bd24013	3dbc38be-b2fd-4a53-9abd-b672b566fe6c
7	7	0	Plazi	ffb07bec-2d10-492d-9c37-361fe0b79427	42c47049-fbf9-4db7-af52-dac3c4646b8e
0	10	10	Plazi	ffb07bec-2d10-492d-9c37-361fe0b79427	473473cc-8626-4d14-a9a7-521a7dd6d3ed
0	2	2	Ocean Biodiversity Information System	ba0670b9-4186-41e6-8e70-f9cb3065551a	47ec7348-bfd9-44ba-980d-ecdb241ac21e
0	3	3	Plazi	ffb07bec-2d10-492d-9c37-361fe0b79427	4b2aab50-0bf5-4d8f-b72b-39bf427afa80
8	8	0	Plazi	ffb07bec-2d10-492d-9c37-361fe0b79427	4d9efca0-eb83-4098-a698-3f5b0c1a56b1
7767	7767	0	National Biodiversity Network	d897a5b9-35ee-4232-94bd-b0bcaac003c2	4ef9544b-2b9c-49ae-9c82-195d2866ca01
16	16	0	National Biodiversity Data Centre	422b00b2-6c94-4bb6-976b-c359916efdb8	4fe6eaa0-fe5a-4517-80b3-45590995d2c6
756	756	0	National Biodiversity Network	d897a5b9-35ee-4232-94bd-b0bcaac003c2	55b0ed17-c141-414f-b845-b5196dc30df3
548	548	0	GBIF Germany	4f6826f2-4ff6-443d-b966-e6913bd24013	573f2869-f894-4f0c-95ee-56e9712f5d96
0	3	3	Plazi	ffb07bec-2d10-492d-9c37-361fe0b79427	58b41f29-425b-4471-974d-d6175e54d586
0	11	11	Plazi	ffb07bec-2d10-492d-9c37-361fe0b79427	5a42135d-9f54-44b5-91f3-d7860470cfc1
246	246	0	National Biodiversity Network	d897a5b9-35ee-4232-94bd-b0bcaac003c2	5e7b1db4-97b2-4f51-9071-ef5fa5c24d21
4071	4071	0	National Biodiversity Network	d897a5b9-35ee-4232-94bd-b0bcaac003c2	5fb482a8-6428-45f5-87e0-c39b9375cac2
8	8	0	Plazi	ffb07bec-2d10-492d-9c37-361fe0b79427	6338476f-3747-4cdf-bbd9-2af35edd65d5
0	2	2	Plazi	ffb07bec-2d10-492d-9c37-361fe0b79427	64dc3da2-ee36-4b47-bad3-5c47763359dc
459	459	0	GBIF Germany	4f6826f2-4ff6-443d-b966-e6913bd24013	656e5206-f762-11e1-a439-00145eb45e9a
1337	1337	0	GBIF Germany	4f6826f2-4ff6-443d-b966-e6913bd24013	6605a3c2-f762-11e1-a439-00145eb45e9a
14	14	0	Plazi	ffb07bec-2d10-492d-9c37-361fe0b79427	6719f88c-3178-4197-a692-666ba218d512
134	134	0	GBIF Argentina	2426a871-9feb-40a1-96c6-0c593a76b835	67e266ec-0997-4092-a9a9-ebbf29f0e4a4
103	103	0	GBIF Germany	4f6826f2-4ff6-443d-b966-e6913bd24013	6915c498-f762-11e1-a439-00145eb45e9a
152	144	-8	GBIF Germany	4f6826f2-4ff6-443d-b966-e6913bd24013	6a873906-f762-11e1-a439-00145eb45e9a
16	16	0	GBIF Germany	4f6826f2-4ff6-443d-b966-e6913bd24013	6b02e07e-f762-11e1-a439-00145eb45e9a
3000	3000	0	Colombian Biodiversity Information System	7e865cba-7c46-417b-ade5-97f2cf5b7be0	6cd1212c-66ba-40ee-9295-14aee7339dd0
2	2	0	Plazi	ffb07bec-2d10-492d-9c37-361fe0b79427	70c2f9d7-3d55-4226-8d02-1385064e8076
2	2	0	Plazi	ffb07bec-2d10-492d-9c37-361fe0b79427	72d86f42-b0f8-41e0-8fba-bbd45f41f54a
220	220	0	GBIF Germany	4f6826f2-4ff6-443d-b966-e6913bd24013	73f35f10-f762-11e1-a439-00145eb45e9a
612	612	0	GBIF Germany	4f6826f2-4ff6-443d-b966-e6913bd24013	744adde4-f762-11e1-a439-00145eb45e9a
127	127	0	GBIF France	da44cd31-5901-4687-a106-6d1c7734ee3a	74c1446c-cbe7-485a-9a71-b39ccf4fd9a5
10	10	0	Colombian Biodiversity Information System	7e865cba-7c46-417b-ade5-97f2cf5b7be0	7530ee7d-599c-4b91-8f6f-d4237bec07a9
135	135	0	GBIF Germany	4f6826f2-4ff6-443d-b966-e6913bd24013	7567c854-f762-11e1-a439-00145eb45e9a
372	372	0	GBIF Germany	4f6826f2-4ff6-443d-b966-e6913bd24013	75953a0a-f762-11e1-a439-00145eb45e9a
49	49	0	Plazi	ffb07bec-2d10-492d-9c37-361fe0b79427	75b40ab7-a808-41ed-bb36-727c059c3e05
0	1	1	Ocean Biodiversity Information System	ba0670b9-4186-41e6-8e70-f9cb3065551a	76899775-08a0-46ea-a40f-916d43608b6d
62122	61682	-440	National Biodiversity Network	d897a5b9-35ee-4232-94bd-b0bcaac003c2	7940f474-4cb3-4a49-b4f6-58f8c363dba1
641	549	-92	GBIF Germany	4f6826f2-4ff6-443d-b966-e6913bd24013	79c0edf4-f762-11e1-a439-00145eb45e9a
70	70	0	Korean Biodiversity Information Facility	e0a1e772-0177-4800-94b4-2d023fe6cdf4	7b0a9688-f762-11e1-a439-00145eb45e9a
2330	3135	805	GBIF Spain	1f94b3ca-9345-4d65-afe2-4bace93aa0fe	7bb56d54-b042-46b3-b66d-b7eaaff9c6c4
924	924	0	GBIF Germany	4f6826f2-4ff6-443d-b966-e6913bd24013	7c4e2e60-f762-11e1-a439-00145eb45e9a
314	194	-120	GBIF Germany	4f6826f2-4ff6-443d-b966-e6913bd24013	7ce3e2c0-f762-11e1-a439-00145eb45e9a
259	259	0	GBIF Germany	4f6826f2-4ff6-443d-b966-e6913bd24013	7d31187e-f762-11e1-a439-00145eb45e9a
11710	11710	0	GBIF Germany	4f6826f2-4ff6-443d-b966-e6913bd24013	7e949e52-f762-11e1-a439-00145eb45e9a
494	221	-273	GBIF Germany	4f6826f2-4ff6-443d-b966-e6913bd24013	7ec213dc-f762-11e1-a439-00145eb45e9a
4011	4011	0	GBIF Germany	4f6826f2-4ff6-443d-b966-e6913bd24013	7ed02c60-f762-11e1-a439-00145eb45e9a
1379	964	-415	GBIF Germany	4f6826f2-4ff6-443d-b966-e6913bd24013	7f0c3f84-f762-11e1-a439-00145eb45e9a
569	569	0	Biodiversity Information System of Mexico	b324e8e9-9a4c-44fa-8f1a-7f39ea7ab576	7ff09cba-f762-11e1-a439-00145eb45e9a
0	847	847	Ocean Biodiversity Information System	ba0670b9-4186-41e6-8e70-f9cb3065551a	8007bd94-560d-49bc-931d-96dac74cfa68
4054	4054	0	Biodiversity Information System of Mexico	b324e8e9-9a4c-44fa-8f1a-7f39ea7ab576	803598c4-f762-11e1-a439-00145eb45e9a
354626	367638	13012	U.S. Geological Survey	8618c64a-93e0-4300-b546-7249e5148ed2	8044ee43-c5fe-44da-ad96-cc1a9cfb91ba
49	49	0	Participant Node Managers Committee	7f48e0c8-5c96-49ec-b972-30748e339115	8057ddea-3c4f-40cf-9910-86b25f43d8ed
1864	1848	-16	Biodiversity Information System of Mexico	b324e8e9-9a4c-44fa-8f1a-7f39ea7ab576	807bc380-f762-11e1-a439-00145eb45e9a
0	166	166	National Biodiversity Network	d897a5b9-35ee-4232-94bd-b0bcaac003c2	81d9893e-d07b-46dd-be6c-2e8b6b850d99
6	6	0	Plazi	ffb07bec-2d10-492d-9c37-361fe0b79427	82b52967-5dc6-4d5d-8bb3-b45d9651d55e
1874	1874	0	Ocean Biodiversity Information System	ba0670b9-4186-41e6-8e70-f9cb3065551a	8536acfc-e3d0-4ea6-92a0-f85dff0b6207
1406258	1491865	85607	U.S. Geological Survey	8618c64a-93e0-4300-b546-7249e5148ed2	861e6afe-f762-11e1-a439-00145eb45e9a
7232	7232	0	Society for the Management of Electronic Biodiversity Data	97818ee4-1461-4180-bf1d-b3201050124f	863f25fe-51f8-4081-b8bc-93616b21e500
94	64	-30	GBIF Germany	4f6826f2-4ff6-443d-b966-e6913bd24013	875edcaa-f762-11e1-a439-00145eb45e9a
240	177	-63	GBIF Germany	4f6826f2-4ff6-443d-b966-e6913bd24013	876a9fd6-f762-11e1-a439-00145eb45e9a
7	7	0	GBIF France	da44cd31-5901-4687-a106-6d1c7734ee3a	87e0e030-0e50-49a7-95c3-3309484056fd
14	14	0	GBIF Germany	4f6826f2-4ff6-443d-b966-e6913bd24013	8872617a-f762-11e1-a439-00145eb45e9a
498	498	0	GBIF Germany	4f6826f2-4ff6-443d-b966-e6913bd24013	89f944f0-f762-11e1-a439-00145eb45e9a
226	226	0	GBIF Germany	4f6826f2-4ff6-443d-b966-e6913bd24013	8a9e8a64-f762-11e1-a439-00145eb45e9a
1	1	0	GBIF Germany	4f6826f2-4ff6-443d-b966-e6913bd24013	8cd834ba-f762-11e1-a439-00145eb45e9a
50	50	0	Society for the Management of Electronic Biodiversity Data	97818ee4-1461-4180-bf1d-b3201050124f	8d431c96-9e2f-4249-8b0a-d875e3273908
577	437	-140	GBIF Germany	4f6826f2-4ff6-443d-b966-e6913bd24013	8d8dd7ca-f762-11e1-a439-00145eb45e9a
3199	861	-2338	GBIF Germany	4f6826f2-4ff6-443d-b966-e6913bd24013	8e30bb98-f762-11e1-a439-00145eb45e9a
1623	1623	0	Colombian Biodiversity Information System	7e865cba-7c46-417b-ade5-97f2cf5b7be0	8e60f836-c6cb-4c37-83c5-5966af2428f1
10	2	-8	GBIF Germany	4f6826f2-4ff6-443d-b966-e6913bd24013	8ed678d0-f762-11e1-a439-00145eb45e9a
196	62	-134	GBIF Germany	4f6826f2-4ff6-443d-b966-e6913bd24013	8f27b1f0-f762-11e1-a439-00145eb45e9a
392	247	-145	GBIF Germany	4f6826f2-4ff6-443d-b966-e6913bd24013	8f3aa59e-f762-11e1-a439-00145eb45e9a
288	98	-190	GBIF Germany	4f6826f2-4ff6-443d-b966-e6913bd24013	90f4921e-f762-11e1-a439-00145eb45e9a
0	154	154	Ocean Biodiversity Information System	ba0670b9-4186-41e6-8e70-f9cb3065551a	9103faa2-21a2-44b9-946d-55094489d733
47	31	-16	GBIF Germany	4f6826f2-4ff6-443d-b966-e6913bd24013	92ad9196-f762-11e1-a439-00145eb45e9a
196	148	-48	GBIF Germany	4f6826f2-4ff6-443d-b966-e6913bd24013	92c5cf36-f762-11e1-a439-00145eb45e9a
0	1	1	Plazi	ffb07bec-2d10-492d-9c37-361fe0b79427	92f9825c-9630-4a8e-8f30-12b68c21145a
28711	270901	242190	U.S. Geological Survey	8618c64a-93e0-4300-b546-7249e5148ed2	94a6bf19-40a2-4689-ab0e-53edb30b9d36
0	6	6	Plazi	ffb07bec-2d10-492d-9c37-361fe0b79427	94dced46-9201-4f82-af65-b3dbc8014155
3324	3324	0	GBIF Finland	dd514216-5c7c-45f3-910d-797424cb5be6	96313a17-ea7a-471b-978b-a86d15bd4d6f
3781	4652	871	GBIF Brazil	cdc9736d-5ff7-4ece-9959-3c744360cdb3	97802be9-3e72-4468-8611-0c9cd3a905a7
749	749	0	Polish Biodiversity Information Network	2618bfdf-e194-4911-a241-80db3107bc51	99e1cbb0-30b1-11de-b170-b8a03c50a862
99392	99392	0	Colombian Biodiversity Information System	7e865cba-7c46-417b-ade5-97f2cf5b7be0	9cc67633-537a-4acc-8d37-92feeaddb2cd
2088	1824	-264	Biodiversity Information System of Mexico	b324e8e9-9a4c-44fa-8f1a-7f39ea7ab576	9eb976db-d646-4110-adcf-15e7695a2ca3
3	3	0	Plazi	ffb07bec-2d10-492d-9c37-361fe0b79427	9fe1a18b-9250-4aec-a069-984a105d7d67
12	12	0	Plazi	ffb07bec-2d10-492d-9c37-361fe0b79427	a0784ba6-89d5-454d-8773-35aef16629cf
7052	7052	0	Atlas of Living Australia	4a6f1b71-969e-4fc5-a693-282b05e1220c	a6bed829-846c-4d0f-906b-1761bc1eaa93
931	931	0	GBIF France	da44cd31-5901-4687-a106-6d1c7734ee3a	a82600eb-c2d2-40d9-91cf-ed40220f24a6
457	457	0	National Biodiversity Network	d897a5b9-35ee-4232-94bd-b0bcaac003c2	aa513733-be77-4001-944b-6098818ad631
17	17	0	Plazi	ffb07bec-2d10-492d-9c37-361fe0b79427	ae3383a3-0172-4ba9-adb5-9a27f9e9fff4
1775	1775	0	Belgian Biodiversity Platform	fb11cfe1-ebc3-45af-9159-17d9fddbcdac	b146a93c-657b-4768-aa51-9cabe3dac808
3957	3957	0	GBIF Estonia	2c11b821-d22b-4c64-8cd3-c1578173b129	b157fe6d-31fc-45d9-8f85-c952428af499
3	3	0	Plazi	ffb07bec-2d10-492d-9c37-361fe0b79427	b25560f5-dc00-4dbc-88e4-81c39cf559a5
16476	16476	0	U.S. Geological Survey	8618c64a-93e0-4300-b546-7249e5148ed2	b382b4aa-a63a-4110-8b5e-c45c1340911f
0	10	10	Plazi	ffb07bec-2d10-492d-9c37-361fe0b79427	b80cdc3e-5b33-4b84-a2ec-c35986260a21
0	21	21	Colombian Biodiversity Information System	7e865cba-7c46-417b-ade5-97f2cf5b7be0	b8c76c85-1658-46dc-bfd2-c8dc548c3557
1498	1498	0	National Biodiversity Data Centre	422b00b2-6c94-4bb6-976b-c359916efdb8	b9d76057-87e1-4650-bda6-53a9b3245ba9
319	319	0	Netherlands Biodiversity Information Facility	0909d601-bda2-42df-9e63-a6d51847ebce	bc94931c-4197-42bd-9cac-32c09e3959f3
0	2	2	Plazi	ffb07bec-2d10-492d-9c37-361fe0b79427	c3148490-8f6e-44cd-a74e-09803edae156
0	11	11	Plazi	ffb07bec-2d10-492d-9c37-361fe0b79427	c38a2e7e-fb9a-4dff-b581-970e30e46448
838	838	0	National Biodiversity Network	d897a5b9-35ee-4232-94bd-b0bcaac003c2	c764be05-0bf0-4623-a778-db509ee3e229
9742	9742	0	Colombian Biodiversity Information System	7e865cba-7c46-417b-ade5-97f2cf5b7be0	c847fb48-d604-4a6e-91c9-4df147f43e14
63	63	0	Plazi	ffb07bec-2d10-492d-9c37-361fe0b79427	c8e7f4a7-d89e-4d9b-9fe7-e4938f445e75
2	2	0	Plazi	ffb07bec-2d10-492d-9c37-361fe0b79427	c96d8e67-fec9-4cca-8948-96980073660a
0	1	1	Ocean Biodiversity Information System	ba0670b9-4186-41e6-8e70-f9cb3065551a	cb41c209-9b4b-4776-96a2-000bb4b0b990
1764	1764	0	Costa Rica Biodiversity Facility	3379bb09-1a58-41e7-9c57-e3b66c3eb5a0	d2123780-15e2-4723-b63c-9f9a53643837
3	3	0	Plazi	ffb07bec-2d10-492d-9c37-361fe0b79427	d248336d-bd03-4c14-aed6-7b5b2ee9045f
5148	5148	0	Colombian Biodiversity Information System	7e865cba-7c46-417b-ade5-97f2cf5b7be0	d3ba75d5-1382-440f-8f79-c45d8e3e69be
2052	2052	0	Belgian Biodiversity Platform	fb11cfe1-ebc3-45af-9159-17d9fddbcdac	d4bf0455-39d9-47a1-b0b7-becfc82e7f13
15	15	0	Plazi	ffb07bec-2d10-492d-9c37-361fe0b79427	d50fe08a-7b26-4576-b6c6-ab5df7b9e8d6
13	13	0	Plazi	ffb07bec-2d10-492d-9c37-361fe0b79427	d5943ff0-7675-49f7-a5e8-38a7083302ac
32	32	0	Plazi	ffb07bec-2d10-492d-9c37-361fe0b79427	d6f18411-1a8b-493a-85c8-05e3169222f1
75	75	0	GBIF Spain	1f94b3ca-9345-4d65-afe2-4bace93aa0fe	d95bd926-a74a-498e-9f81-8ee7e1f56b0c
1	1	0	Plazi	ffb07bec-2d10-492d-9c37-361fe0b79427	d9d49c4c-4662-44c9-8da4-63b9e67e32f2
1124	1124	0	GBIF France	da44cd31-5901-4687-a106-6d1c7734ee3a	dbdc77f8-f134-41b6-ac34-7d8d8eec6934
0	42	42	Ocean Biodiversity Information System	ba0670b9-4186-41e6-8e70-f9cb3065551a	dc585fac-c866-4d48-9e61-71831f10ea8b
25	25	0	Plazi	ffb07bec-2d10-492d-9c37-361fe0b79427	dcde82e0-f5ee-44e6-9a6a-9e00349457d6
0	11	11	Plazi	ffb07bec-2d10-492d-9c37-361fe0b79427	df71488b-e5e8-4563-9d8e-d3d90c442349
425	425	0	GBIF Guinea	b1cd2e84-c4ba-47bd-b72a-dfd1f92dce0a	e3bdcd30-55cc-4d79-bbf2-37234e940367
0	3	3	Plazi	ffb07bec-2d10-492d-9c37-361fe0b79427	e4215cb0-f104-4cc2-8d59-4ad9b8bef60d
0	9	9	Plazi	ffb07bec-2d10-492d-9c37-361fe0b79427	e4ccf051-2640-4d8c-9a8f-079406f9e91d
39	39	0	Plazi	ffb07bec-2d10-492d-9c37-361fe0b79427	e86c4fdd-741c-4592-b28b-be4b3a7e4b09
66248	66248	0	Ocean Biodiversity Information System	ba0670b9-4186-41e6-8e70-f9cb3065551a	ec245bc1-4812-438d-8d07-5d74ad0bd496
0	24	24	Plazi	ffb07bec-2d10-492d-9c37-361fe0b79427	efe8862e-8c98-4954-ae3d-7350e7b57823
610	610	0	National Biodiversity Network	d897a5b9-35ee-4232-94bd-b0bcaac003c2	f161ac10-fbcc-4080-92de-61ef19bf326f
35	35	0	Plazi	ffb07bec-2d10-492d-9c37-361fe0b79427	f1fa055d-abbc-4f2d-9006-eb69c365fb66
0	20	20	Plazi	ffb07bec-2d10-492d-9c37-361fe0b79427	f33526c4-a22f-4c32-9fd9-34a1255f44eb
8	8	0	Colombian Biodiversity Information System	7e865cba-7c46-417b-ade5-97f2cf5b7be0	f4c4034f-d25b-43b5-b49d-e7d0c0f01eaa
692143	692143	0	National Biodiversity Network	d897a5b9-35ee-4232-94bd-b0bcaac003c2	f60e31a5-dc12-44c1-8358-098f131cd141
9	9	0	Plazi	ffb07bec-2d10-492d-9c37-361fe0b79427	f657f5e7-128c-4903-98a5-295104771a58
15	15	0	GBIF Finland	dd514216-5c7c-45f3-910d-797424cb5be6	f8510fe7-fd72-44ce-adb5-c2fed5db3f8e
2863	2863	0	Atlas of Living Australia	4a6f1b71-969e-4fc5-a693-282b05e1220c	f900725d-db2f-4771-9330-7960ce68d4b5
5490	5490	0	Participant Node Managers Committee	7f48e0c8-5c96-49ec-b972-30748e339115	fce64d7a-1a84-4b91-84fd-4da5b2e9a946
43	43	0	National Biodiversity Network	d897a5b9-35ee-4232-94bd-b0bcaac003c2	fe730480-cad3-415e-804c-1c2ad80d3859
5	5	0	Plazi	ffb07bec-2d10-492d-9c37-361fe0b79427	00689786-1241-490b-8ccc-c1707861d89f
1166	1166	0	National Biodiversity Network	d897a5b9-35ee-4232-94bd-b0bcaac003c2	00c913d4-7148-46b3-9aa6-b2a158fa721b
50	50	0	Plazi	ffb07bec-2d10-492d-9c37-361fe0b79427	034b7092-7aed-4e50-ace3-1318cb51c6ce
111552	110805	-747	Biodiversity Information System of Mexico	b324e8e9-9a4c-44fa-8f1a-7f39ea7ab576	05da2f31-7301-49f7-b79f-f9e7d12d8b2c
528	537	9	Biodiversity Information System of Mexico	b324e8e9-9a4c-44fa-8f1a-7f39ea7ab576	09d2da7b-4699-4e45-b0da-73c982660c98
0	10	10	Plazi	ffb07bec-2d10-492d-9c37-361fe0b79427	0ed6e9be-9b55-4373-afa6-f29188a8ac56
0	11	11	Plazi	ffb07bec-2d10-492d-9c37-361fe0b79427	0f978355-d6d8-40c8-984b-d0183880c3e0
100	100	0	Canada Biodiversity Information Facility	8f83fc96-c966-4126-83f7-bf044dc49efa	1672a8ae-1e9c-4620-8314-a6da5202eb4e
15981	15981	0	GBIF France	da44cd31-5901-4687-a106-6d1c7734ee3a	17167110-dddf-4c70-adde-2ecc46829521
24121	24183	62	GBIF Brazil	cdc9736d-5ff7-4ece-9959-3c744360cdb3	186605f8-4f62-4e3a-be58-c6b3b0bc47be
1	1	0	Plazi	ffb07bec-2d10-492d-9c37-361fe0b79427	18b634b9-4600-47c6-9c16-fe8dfe65ba7a
291307	297648	6341	Canada Biodiversity Information Facility	8f83fc96-c966-4126-83f7-bf044dc49efa	1e61b812-b2ec-43d0-bdbb-8534a761f74c
74109	74109	0	GBIF Sweden	a0b3be64-6525-4387-ac67-a499950f92e1	20ab8294-5253-46ca-bdb2-eab1b5e75657
2	2	0	Plazi	ffb07bec-2d10-492d-9c37-361fe0b79427	20c0da5d-750b-4af3-89fe-cd149e808483
246	246	0	GBIF France	da44cd31-5901-4687-a106-6d1c7734ee3a	210590a5-decb-4464-9a5f-662cd8db912a
0	800	800	Korean Biodiversity Information Facility	e0a1e772-0177-4800-94b4-2d023fe6cdf4	25989281-872f-4822-aea2-f5ceb4335834
89	89	0	Plazi	ffb07bec-2d10-492d-9c37-361fe0b79427	2845efb7-0c6c-4842-a407-a995f2e77002
1	1	0	Plazi	ffb07bec-2d10-492d-9c37-361fe0b79427	287e7161-50ad-4ba2-83bb-4a458f5e0514
192898	191399	-1499	Biodiversity Information System of Mexico	b324e8e9-9a4c-44fa-8f1a-7f39ea7ab576	33948acc-bfac-4107-92c8-6464de387822
12	12	0	Plazi	ffb07bec-2d10-492d-9c37-361fe0b79427	35184c45-4369-48b4-8b33-0c8b4f5e882a
0	2079	2079	Ocean Biodiversity Information System	ba0670b9-4186-41e6-8e70-f9cb3065551a	3855e887-6d48-43a5-ac36-59efa6e18d7d
0	707	707	Participant Node Managers Committee	7f48e0c8-5c96-49ec-b972-30748e339115	3968921a-e2e4-4d2c-a190-ef6655b8c0a5
5813	8515	2702	GBIF Japan	db5705aa-6a6e-42f1-8942-d77b9f4896ea	3b0df227-5d48-4184-9804-5d9b205026cc
0	193	193	Ocean Biodiversity Information System	ba0670b9-4186-41e6-8e70-f9cb3065551a	3be1c976-f176-4532-9466-90ce1e851844
8738	8738	0	Colombian Biodiversity Information System	7e865cba-7c46-417b-ade5-97f2cf5b7be0	3c715d77-fe53-4332-ae8d-14aca51d4a5b
0	51	51	Plazi	ffb07bec-2d10-492d-9c37-361fe0b79427	3c7c2c9b-5ab5-45aa-92f5-f99f8456a1b4
15	15	0	GBIF Germany	4f6826f2-4ff6-443d-b966-e6913bd24013	3e603477-0c14-4236-bf54-44840c59aba5
768	768	0	GBIF Germany	4f6826f2-4ff6-443d-b966-e6913bd24013	4088e150-058a-4bf2-8484-62f004da392a
4439	4439	0	Participant Node Managers Committee	7f48e0c8-5c96-49ec-b972-30748e339115	424c2bbf-e40b-46e6-a19e-69235d7d29b3
1029	1029	0	GBIF Cameroon	cfe0cad9-2bf4-4d16-ae33-c3dfb0da1ed9	4584c74a-b6e5-46da-958d-662bcb152934
0	7	7	Plazi	ffb07bec-2d10-492d-9c37-361fe0b79427	464e13eb-eedf-4838-9614-d16e1e54f168
2980	9258	6278	Participant Node Managers Committee	7f48e0c8-5c96-49ec-b972-30748e339115	4796b3ec-d572-4f3f-9344-1cd3aa20fc8f
156	156	0	GBIF France	da44cd31-5901-4687-a106-6d1c7734ee3a	4da624f0-6fb5-4158-af7e-ba9fc3431079
4222	4222	0	National Biodiversity Network	d897a5b9-35ee-4232-94bd-b0bcaac003c2	4dc62b03-8f94-4883-93fa-babcba005285
3669	3669	0	GBIF Norway	4f829580-180d-46a9-9c87-ed8ec959b545	520909f1-dbca-411e-996c-448d87c6a700
752	752	0	GBIF Japan	db5705aa-6a6e-42f1-8942-d77b9f4896ea	534abda8-18f5-11e2-98fb-00145eb45e9a
0	25	25	Plazi	ffb07bec-2d10-492d-9c37-361fe0b79427	54419de4-eeba-40b7-85f6-a6e84ebab356
3	3	0	Plazi	ffb07bec-2d10-492d-9c37-361fe0b79427	5855eade-aff4-47f0-8015-c267a07a45ae
8693	8693	0	GBIF Norway	4f829580-180d-46a9-9c87-ed8ec959b545	594e0bf8-d08c-4a69-9c76-1c620554e719
876	853	-23	Biodiversity Information System of Mexico	b324e8e9-9a4c-44fa-8f1a-7f39ea7ab576	5a41b65b-27a3-4e5b-8fd0-72a8ba9d7c68
0	16	16	Plazi	ffb07bec-2d10-492d-9c37-361fe0b79427	5ab5f5c8-481e-4d1a-8643-21e72c367278
294	294	0	Plazi	ffb07bec-2d10-492d-9c37-361fe0b79427	5b53b2fd-98cb-4450-96cc-b8e26c1e093f
0	179	179	Participant Node Managers Committee	7f48e0c8-5c96-49ec-b972-30748e339115	5ee9f4a9-6c63-4a72-80c7-9e674d4b7577
0	2	2	Plazi	ffb07bec-2d10-492d-9c37-361fe0b79427	6071077c-1a51-4841-ba55-24e63c1c651e
170	170	0	GBIF Germany	4f6826f2-4ff6-443d-b966-e6913bd24013	618a60a8-f762-11e1-a439-00145eb45e9a
5	5	0	Plazi	ffb07bec-2d10-492d-9c37-361fe0b79427	643c8d89-d71b-439b-9e1a-792b861f5747
0	11	11	Plazi	ffb07bec-2d10-492d-9c37-361fe0b79427	6456e942-b39b-4899-b2a9-f4deecde44d9
58	58	0	GBIF Germany	4f6826f2-4ff6-443d-b966-e6913bd24013	65847342-f762-11e1-a439-00145eb45e9a
1172	1116	-56	GBIF Germany	4f6826f2-4ff6-443d-b966-e6913bd24013	65a908c4-f762-11e1-a439-00145eb45e9a
39	39	0	GBIF Sweden	a0b3be64-6525-4387-ac67-a499950f92e1	66248f5f-6739-4c40-bc37-a1f2526daed1
201	201	0	GBIF Germany	4f6826f2-4ff6-443d-b966-e6913bd24013	6656f3da-f762-11e1-a439-00145eb45e9a
1808	1808	0	Scientific Committee on Antarctic Research	51e4e8ff-bff0-4996-8b27-9107d61b3478	667e0044-3ff1-4365-8ecf-e637c7b31fa4
136	136	0	GBIF Germany	4f6826f2-4ff6-443d-b966-e6913bd24013	67a62a94-f762-11e1-a439-00145eb45e9a
51	51	0	GBIF Germany	4f6826f2-4ff6-443d-b966-e6913bd24013	67f003e4-f762-11e1-a439-00145eb45e9a
112	112	0	GBIF Germany	4f6826f2-4ff6-443d-b966-e6913bd24013	685b0568-f762-11e1-a439-00145eb45e9a
69	69	0	GBIF Germany	4f6826f2-4ff6-443d-b966-e6913bd24013	68b9526c-f762-11e1-a439-00145eb45e9a
22575	22575	0	Belgian Biodiversity Platform	fb11cfe1-ebc3-45af-9159-17d9fddbcdac	68c91b9a-2322-4f60-8d58-2c696a73a11c
2421	2421	0	GBIF Benin	efb9c00e-f802-45dd-8826-a52ec45b89ff	69608318-64d6-4267-9bc3-ac1aa47866cd
3	3	0	Plazi	ffb07bec-2d10-492d-9c37-361fe0b79427	69de59cb-f44e-4466-bec8-97b77fd60b1c
62	487	425	U.S. Geological Survey	8618c64a-93e0-4300-b546-7249e5148ed2	69f3ca43-ed03-4ed1-92c4-58f9bd0eafc1
22	22	0	GBIF Germany	4f6826f2-4ff6-443d-b966-e6913bd24013	6b734940-f762-11e1-a439-00145eb45e9a
359	359	0	GBIF France	da44cd31-5901-4687-a106-6d1c7734ee3a	6ba74bc9-526c-4039-a21a-f5ac80dead8f
28	28	0	GBIF Germany	4f6826f2-4ff6-443d-b966-e6913bd24013	6cdf5166-f762-11e1-a439-00145eb45e9a
0	6	6	Plazi	ffb07bec-2d10-492d-9c37-361fe0b79427	6d2d1b42-4792-4edc-995a-5e2f0dbed487
0	13	13	Plazi	ffb07bec-2d10-492d-9c37-361fe0b79427	6e2f997e-5d4b-4153-ba58-80893e45257a
2	2	0	Plazi	ffb07bec-2d10-492d-9c37-361fe0b79427	6ff402eb-25ca-4c2f-a0e7-1ac0ea4fd84b
961	961	0	GBIF Germany	4f6826f2-4ff6-443d-b966-e6913bd24013	7052eda8-f762-11e1-a439-00145eb45e9a
1362	1362	0	GBIF France	da44cd31-5901-4687-a106-6d1c7734ee3a	70780d01-15de-4b02-af66-a739e7ccc571
1	1	0	GBIF France	da44cd31-5901-4687-a106-6d1c7734ee3a	70dfc67c-1164-4a23-81d0-a0e2afdd4970
5818	6418	600	GBIF Japan	db5705aa-6a6e-42f1-8942-d77b9f4896ea	71d8eb5a-f762-11e1-a439-00145eb45e9a
24	24	0	GBIF Germany	4f6826f2-4ff6-443d-b966-e6913bd24013	723ae71a-f762-11e1-a439-00145eb45e9a
0	7	7	Plazi	ffb07bec-2d10-492d-9c37-361fe0b79427	72c850ea-1a97-4ad4-a628-f01d32a10444
12	12	0	Plazi	ffb07bec-2d10-492d-9c37-361fe0b79427	76598eec-0e1e-49ec-8851-641649512277
132	132	0	GBIF Germany	4f6826f2-4ff6-443d-b966-e6913bd24013	7785543a-f762-11e1-a439-00145eb45e9a
1	1	0	GBIF Germany	4f6826f2-4ff6-443d-b966-e6913bd24013	78d40e58-f762-11e1-a439-00145eb45e9a
54711	54914	203	GBIF Brazil	cdc9736d-5ff7-4ece-9959-3c744360cdb3	78dcee36-b0a2-4679-802d-bc0b5016518b
1515	1515	0	Participant Node Managers Committee	7f48e0c8-5c96-49ec-b972-30748e339115	7904180c-36c9-40ca-aed2-463e36a04df7
177	173	-4	GBIF Germany	4f6826f2-4ff6-443d-b966-e6913bd24013	794f5fa4-f762-11e1-a439-00145eb45e9a
422	402	-20	GBIF Germany	4f6826f2-4ff6-443d-b966-e6913bd24013	7962038e-f762-11e1-a439-00145eb45e9a
5	5	0	Plazi	ffb07bec-2d10-492d-9c37-361fe0b79427	79d4728e-4ad9-4be2-aca7-5897e201ba35
16	16	0	GBIF Germany	4f6826f2-4ff6-443d-b966-e6913bd24013	7d00e99c-f762-11e1-a439-00145eb45e9a
21	21	0	GBIF Germany	4f6826f2-4ff6-443d-b966-e6913bd24013	7def0be0-f762-11e1-a439-00145eb45e9a
45	45	0	GBIF Germany	4f6826f2-4ff6-443d-b966-e6913bd24013	7dfbee0a-f762-11e1-a439-00145eb45e9a
4277	4277	0	GBIF Spain	1f94b3ca-9345-4d65-afe2-4bace93aa0fe	7f2edc10-f762-11e1-a439-00145eb45e9a
999	999	0	Biodiversity Information System of Mexico	b324e8e9-9a4c-44fa-8f1a-7f39ea7ab576	7f8a1b98-f762-11e1-a439-00145eb45e9a
104	104	0	Colombian Biodiversity Information System	7e865cba-7c46-417b-ade5-97f2cf5b7be0	7fc558b6-19e3-4952-abba-cb8f5f422376
11	11	0	Plazi	ffb07bec-2d10-492d-9c37-361fe0b79427	803e271e-56b9-450c-be51-cf21b5f29a92
8046	8046	0	National Biodiversity Network	d897a5b9-35ee-4232-94bd-b0bcaac003c2	805cba36-132d-44b8-bcb8-b0899c3f1279
683	663	-20	Biodiversity Information System of Mexico	b324e8e9-9a4c-44fa-8f1a-7f39ea7ab576	80647608-f762-11e1-a439-00145eb45e9a
1018	1018	0	Colombian Biodiversity Information System	7e865cba-7c46-417b-ade5-97f2cf5b7be0	80fa944d-85d6-4316-be9a-cb35663cf9ab
0	2	2	Plazi	ffb07bec-2d10-492d-9c37-361fe0b79427	814a6c54-0804-4e1b-96ab-bb2c79aa88f8
7873	7873	0	U.S. Geological Survey	8618c64a-93e0-4300-b546-7249e5148ed2	81a975b3-d86f-434e-ad9e-16bc43f68a36
80	80	0	GBIF Germany	4f6826f2-4ff6-443d-b966-e6913bd24013	822815b2-f762-11e1-a439-00145eb45e9a
26721	26721	0	GBIF Switzerland	169eb292-376b-4cc6-8e31-9c2c432de0ad	82ab0954-f762-11e1-a439-00145eb45e9a
462	462	0	Atlas of Living Australia	4a6f1b71-969e-4fc5-a693-282b05e1220c	82edc37a-f762-11e1-a439-00145eb45e9a
50939	50939	0	GBIF Spain	1f94b3ca-9345-4d65-afe2-4bace93aa0fe	83529de0-f762-11e1-a439-00145eb45e9a
14165	16247	2082	U.S. Geological Survey	8618c64a-93e0-4300-b546-7249e5148ed2	835ff8be-ea5c-45e4-b3f3-126852ac56fe
362	362	0	Canada Biodiversity Information Facility	8f83fc96-c966-4126-83f7-bf044dc49efa	84676332-f762-11e1-a439-00145eb45e9a
0	7	7	Plazi	ffb07bec-2d10-492d-9c37-361fe0b79427	84af31b4-bc61-4698-ab5b-4c577214de4a
146624	146624	0	Atlas of Living Australia	4a6f1b71-969e-4fc5-a693-282b05e1220c	85312280-f762-11e1-a439-00145eb45e9a
0	88	88	Atlas of Living Australia	4a6f1b71-969e-4fc5-a693-282b05e1220c	86d3862e-42c2-4bc3-8315-8d51d8d809a7
4751	4078	-673	GBIF Germany	4f6826f2-4ff6-443d-b966-e6913bd24013	87309b88-f762-11e1-a439-00145eb45e9a
17	17	0	GBIF Germany	4f6826f2-4ff6-443d-b966-e6913bd24013	887515f0-f762-11e1-a439-00145eb45e9a
150	150	0	GBIF Germany	4f6826f2-4ff6-443d-b966-e6913bd24013	89b0c176-f762-11e1-a439-00145eb45e9a
155	155	0	GBIF Germany	4f6826f2-4ff6-443d-b966-e6913bd24013	8a1f625c-f762-11e1-a439-00145eb45e9a
85	85	0	GBIF Germany	4f6826f2-4ff6-443d-b966-e6913bd24013	8a83a802-f762-11e1-a439-00145eb45e9a
270	270	0	Plazi	ffb07bec-2d10-492d-9c37-361fe0b79427	8ada9625-ca3b-4922-a9bc-def85a3cf840
1	1	0	GBIF Germany	4f6826f2-4ff6-443d-b966-e6913bd24013	8d04cdea-f762-11e1-a439-00145eb45e9a
98	28	-70	GBIF Germany	4f6826f2-4ff6-443d-b966-e6913bd24013	8de42bde-f762-11e1-a439-00145eb45e9a
68	14	-54	GBIF Germany	4f6826f2-4ff6-443d-b966-e6913bd24013	8e0e0e7c-f762-11e1-a439-00145eb45e9a
636	241	-395	GBIF Germany	4f6826f2-4ff6-443d-b966-e6913bd24013	8e566262-f762-11e1-a439-00145eb45e9a
29	29	0	National Biodiversity Network	d897a5b9-35ee-4232-94bd-b0bcaac003c2	8e5bc0ec-3fa7-4228-9e73-48eddc452a89
661	541	-120	GBIF Germany	4f6826f2-4ff6-443d-b966-e6913bd24013	90079130-f762-11e1-a439-00145eb45e9a
1	1	0	Plazi	ffb07bec-2d10-492d-9c37-361fe0b79427	9064c84e-aedd-46cd-b739-d46fd59b1154
1440	1440	0	GBIF France	da44cd31-5901-4687-a106-6d1c7734ee3a	90e739fc-3ac2-4f24-b019-f89b4e7b8d6f
50	47	-3	GBIF Germany	4f6826f2-4ff6-443d-b966-e6913bd24013	91d665c2-f762-11e1-a439-00145eb45e9a
178	178	0	GBIF Germany	4f6826f2-4ff6-443d-b966-e6913bd24013	920c2b30-f762-11e1-a439-00145eb45e9a
23	23	0	GBIF Germany	4f6826f2-4ff6-443d-b966-e6913bd24013	92d9eb92-f762-11e1-a439-00145eb45e9a
1	1	0	GBIF Germany	4f6826f2-4ff6-443d-b966-e6913bd24013	96855ace-f762-11e1-a439-00145eb45e9a
207	207	0	GBIF Germany	4f6826f2-4ff6-443d-b966-e6913bd24013	978d3a7c-f762-11e1-a439-00145eb45e9a
181	181	0	GBIF Germany	4f6826f2-4ff6-443d-b966-e6913bd24013	97929cf6-f762-11e1-a439-00145eb45e9a
19070	19070	0	National Biodiversity Network	d897a5b9-35ee-4232-94bd-b0bcaac003c2	97bb9806-a09f-4f64-8ab8-1771d288f89e
9	9	0	Plazi	ffb07bec-2d10-492d-9c37-361fe0b79427	9856d1cb-3656-4444-bc7f-3258c796c1c0
0	1	1	Plazi	ffb07bec-2d10-492d-9c37-361fe0b79427	9a512fdd-9590-4227-bfc2-22050ef48ef8
4067	4067	0	Ocean Biodiversity Information System	ba0670b9-4186-41e6-8e70-f9cb3065551a	9b11f305-fb7a-4a65-826e-7fb97af06e5f
5778	5778	0	GBIF Norway	4f829580-180d-46a9-9c87-ed8ec959b545	a17ad49c-1861-40ab-b571-a15f92793a3f
0	267	267	Ocean Biodiversity Information System	ba0670b9-4186-41e6-8e70-f9cb3065551a	a723cd75-867a-4a4e-be81-aeeaec8733fd
2	2	0	Plazi	ffb07bec-2d10-492d-9c37-361fe0b79427	a892b987-1454-401a-9b37-7d10c0e26be3
377	371	-6	Biodiversity Information System of Mexico	b324e8e9-9a4c-44fa-8f1a-7f39ea7ab576	a98ae4c4-7662-4fec-be45-acb526c624b6
241	241	0	GBIF France	da44cd31-5901-4687-a106-6d1c7734ee3a	a9b64b9a-0d98-41d3-8167-3c4f2538920d
90	90	0	GBIF Sweden	a0b3be64-6525-4387-ac67-a499950f92e1	aa857862-0e1a-47b3-9d02-0a62c37e5c57
7	7	0	Plazi	ffb07bec-2d10-492d-9c37-361fe0b79427	aab5d525-1d70-4a48-9469-43d4e446685d
5	5	0	Plazi	ffb07bec-2d10-492d-9c37-361fe0b79427	adf96c2b-3442-49fc-8acb-5f3a04e6e51e
0	6	6	Plazi	ffb07bec-2d10-492d-9c37-361fe0b79427	b2965e77-0c09-4922-9e0b-df5280332a01
3	3	0	Plazi	ffb07bec-2d10-492d-9c37-361fe0b79427	b31f6b64-6284-47c8-a2ff-f2d027785f92
8328	8328	0	Netherlands Biodiversity Information Facility	0909d601-bda2-42df-9e63-a6d51847ebce	b3a5b200-6167-11de-84c0-b8a03c50a862
16	16	0	Plazi	ffb07bec-2d10-492d-9c37-361fe0b79427	b532ec76-6223-4135-9b6d-db5f2f8360e6
71	71	0	National Biodiversity Network	d897a5b9-35ee-4232-94bd-b0bcaac003c2	b5ae9525-5de3-438c-b4c0-3d3257f4bea2
9	9	0	Plazi	ffb07bec-2d10-492d-9c37-361fe0b79427	b621a553-5624-41a9-b439-0c542c3121e8
1377	1377	0	National Biodiversity Network	d897a5b9-35ee-4232-94bd-b0bcaac003c2	b89b0fc2-e18c-4f0b-9291-20a485824f93
19425	19425	0	U.S. Geological Survey	8618c64a-93e0-4300-b546-7249e5148ed2	b8ed9b7c-5b73-4e6d-a6e1-b0911a09f947
4940	7269	2329	Colombian Biodiversity Information System	7e865cba-7c46-417b-ade5-97f2cf5b7be0	ba1e6e34-8196-422a-ae31-f71717dd1de8
1100	1100	0	GBIF Germany	4f6826f2-4ff6-443d-b966-e6913bd24013	ba55ff3e-5326-4077-8040-d201df6bcacb
0	11	11	Plazi	ffb07bec-2d10-492d-9c37-361fe0b79427	ba789426-0f0d-459a-9d03-830a5d17f633
25	25	0	Plazi	ffb07bec-2d10-492d-9c37-361fe0b79427	bc2ac240-9118-446e-afd2-cbbaa489fb06
37	37	0	GBIF France	da44cd31-5901-4687-a106-6d1c7734ee3a	bf7d3b45-f000-499d-8dc6-e0d8f4c0d5e2
251	251	0	GBIF Germany	4f6826f2-4ff6-443d-b966-e6913bd24013	c07dadbf-f2b9-47b9-8278-bb6f5eb07fbc
0	21	21	Plazi	ffb07bec-2d10-492d-9c37-361fe0b79427	c1e999b5-38b7-4bcf-b284-9031eb8954ef
54246	54246	0	GBIF Sweden	a0b3be64-6525-4387-ac67-a499950f92e1	c2e3081a-ba91-40cf-b2df-9885a24b37dc
8	8	0	Plazi	ffb07bec-2d10-492d-9c37-361fe0b79427	c3cf974f-caa2-49a3-977e-710cbbeb9f11
29	29	0	Plazi	ffb07bec-2d10-492d-9c37-361fe0b79427	c76f145d-543d-48ea-ba43-91b5dc4528e1
11498	12481	983	National Biodiversity Network	d897a5b9-35ee-4232-94bd-b0bcaac003c2	c7919f38-10fd-4806-81e2-4e81135b6af0
0	4	4	Plazi	ffb07bec-2d10-492d-9c37-361fe0b79427	c91dcb2e-e700-4cf6-a244-8796060a9dd1
0	5	5	Plazi	ffb07bec-2d10-492d-9c37-361fe0b79427	caadf902-8d15-473e-829d-999a173ba109
65	65	0	Plazi	ffb07bec-2d10-492d-9c37-361fe0b79427	cd2f6487-8bb2-49b3-818a-f3d60161ab67
0	1	1	Plazi	ffb07bec-2d10-492d-9c37-361fe0b79427	cf3b7445-d324-469d-ae77-59f2015ea58d
1	1	0	Plazi	ffb07bec-2d10-492d-9c37-361fe0b79427	d10a5ca6-6a4f-4fd5-95a6-3874ecc413b6
68939	68939	0	Netherlands Biodiversity Information Facility	0909d601-bda2-42df-9e63-a6d51847ebce	d27aa0d9-dd46-4fa4-b6c8-c7283c67dd1d
2158	2158	0	Participant Node Managers Committee	7f48e0c8-5c96-49ec-b972-30748e339115	d3869e20-0659-49d2-8fc7-f364dda5e5b7
0	4	4	Plazi	ffb07bec-2d10-492d-9c37-361fe0b79427	d3a61246-16c5-48c4-a2e6-b3a4c5127156
112	112	0	Plazi	ffb07bec-2d10-492d-9c37-361fe0b79427	d3e60fb6-636b-4e03-b55a-0e910f9a468e
3	3	0	Plazi	ffb07bec-2d10-492d-9c37-361fe0b79427	d40eb95b-5a98-418a-b607-7c2cbec7c897
0	116	116	Participant Node Managers Committee	7f48e0c8-5c96-49ec-b972-30748e339115	d977d7e3-9831-4d18-b27c-01250561ec70
34	34	0	GBIF Germany	4f6826f2-4ff6-443d-b966-e6913bd24013	da36f9fb-ffdc-4d85-9447-578b63e5fe6a
193	193	0	GBIF France	da44cd31-5901-4687-a106-6d1c7734ee3a	daf0c664-f7b6-4d6f-9461-95ecddc549d5
72927	72931	4	U.S. Geological Survey	8618c64a-93e0-4300-b546-7249e5148ed2	db47a906-257f-40a8-8638-4cb1bf092c2b
0	15	15	Plazi	ffb07bec-2d10-492d-9c37-361fe0b79427	dc4d53ae-2b35-4ee9-a60f-2b3faebd2a9d
0	47	47	Plazi	ffb07bec-2d10-492d-9c37-361fe0b79427	e10a7f88-f51b-431b-87e2-a1b10a1d690f
7574	7574	0	GBIF Brazil	cdc9736d-5ff7-4ece-9959-3c744360cdb3	e169a84f-6726-4039-900c-2804591fcfdf
19	19	0	Plazi	ffb07bec-2d10-492d-9c37-361fe0b79427	e20660e0-f022-4460-8f52-d1b2a4c7cb03
61	61	0	GBIF Viet Nam	7f4b5eab-2edf-4b46-9360-d9574ab0f1d7	e3aab35d-175c-487c-8045-6bbd8d7da025
0	2069	2069	Participant Node Managers Committee	7f48e0c8-5c96-49ec-b972-30748e339115	e4af8f92-af98-4649-93ef-83dc99169614
11967	11967	0	GBIF France	da44cd31-5901-4687-a106-6d1c7734ee3a	e9f5955b-0d3e-4560-b289-d1f26b3875be
0	5	5	Plazi	ffb07bec-2d10-492d-9c37-361fe0b79427	ebe03587-4ff1-444d-a916-b499a382feb8
55816	55816	0	GBIF Sweden	a0b3be64-6525-4387-ac67-a499950f92e1	ed3dff78-fb73-4b77-909a-b78f9ef78d34
5072	5072	0	National Biodiversity Network	d897a5b9-35ee-4232-94bd-b0bcaac003c2	ee3e4241-ae07-4e5d-9966-d432ec0cda79
260	260	0	GBIF France	da44cd31-5901-4687-a106-6d1c7734ee3a	ee539576-1fc3-4c85-8b3d-9200ef69826e
0	3	3	Plazi	ffb07bec-2d10-492d-9c37-361fe0b79427	ef6ea0fd-d08d-455d-9ecf-df84500d1936
323	323	0	GBIF Benin	efb9c00e-f802-45dd-8826-a52ec45b89ff	f0c4c2ef-7b93-4b7b-b77d-51e5aff9baf1
2212	2212	0	Participant Node Managers Committee	7f48e0c8-5c96-49ec-b972-30748e339115	f2fefe8b-58fa-4b2e-9ddd-756664b5ddd3
2	2	0	Plazi	ffb07bec-2d10-492d-9c37-361fe0b79427	f532ec5d-b3cb-4359-b0ac-8e0e396fdfb5
10	10	0	Plazi	ffb07bec-2d10-492d-9c37-361fe0b79427	f7577268-0b42-4983-80f3-c20112f1c7e0
5337	5337	0	GBIF France	da44cd31-5901-4687-a106-6d1c7734ee3a	f76c03f2-c813-430d-ae7a-69f5384b97ad
0	161	161	Ocean Biodiversity Information System	ba0670b9-4186-41e6-8e70-f9cb3065551a	f99b5b78-1695-4c7e-9ab6-9881a23cb981
176	176	0	GBIF Germany	4f6826f2-4ff6-443d-b966-e6913bd24013	fa5bfb2e-e646-4ea1-98da-a688af1ff0e5
2	2	0	Plazi	ffb07bec-2d10-492d-9c37-361fe0b79427	fba7fb43-2d9d-427d-89ea-5dcb73011362
16	16	0	GBIF Argentina	2426a871-9feb-40a1-96c6-0c593a76b835	030905e7-961e-47b0-8301-af77a50dd75e
0	12	12	Plazi	ffb07bec-2d10-492d-9c37-361fe0b79427	04ad03d0-3d05-4a25-9e52-c6b727dc6f02
0	80	80	Plazi	ffb07bec-2d10-492d-9c37-361fe0b79427	0540f87c-c902-4df5-acd4-51801c9531bd
8	8	0	GBIF Germany	4f6826f2-4ff6-443d-b966-e6913bd24013	0640006c-4ab3-4951-b042-8206eb903909
104442	104442	0	U.S. Geological Survey	8618c64a-93e0-4300-b546-7249e5148ed2	076bbcbe-6c76-4c7c-8835-6dd346ef387a
235	235	0	Participant Node Managers Committee	7f48e0c8-5c96-49ec-b972-30748e339115	081f733c-cc33-4dc7-92cf-4a64f4e06351
20	21	1	Plazi	ffb07bec-2d10-492d-9c37-361fe0b79427	08258b2a-72c1-4f13-a965-a986e4939e11
9	9	0	Plazi	ffb07bec-2d10-492d-9c37-361fe0b79427	09639ec6-6fbb-42e3-aab5-9a3ed49c09cd
0	164	164	Ocean Biodiversity Information System	ba0670b9-4186-41e6-8e70-f9cb3065551a	0a0f59e4-46ef-4368-ae6c-032c8e857648
450	450	0	GBIF France	da44cd31-5901-4687-a106-6d1c7734ee3a	0e1a50e9-7367-44af-ad4a-9716afe09a17
1	1	0	National Biodiversity Network	d897a5b9-35ee-4232-94bd-b0bcaac003c2	105d628a-8a6e-40c7-9ca0-2b009109c769
22	22	0	Plazi	ffb07bec-2d10-492d-9c37-361fe0b79427	1184b85a-5699-4722-968e-58834f3c1273
101	101	0	Plazi	ffb07bec-2d10-492d-9c37-361fe0b79427	1234f322-4cef-480a-8db8-7e40290bfd65
0	244	244	Ocean Biodiversity Information System	ba0670b9-4186-41e6-8e70-f9cb3065551a	1c6893fa-6065-4489-835e-b52e9723be7f
3	3	0	Plazi	ffb07bec-2d10-492d-9c37-361fe0b79427	1e41bdf0-e492-4d18-834d-9e718c5453a5
0	92664	92664	Participant Node Managers Committee	7f48e0c8-5c96-49ec-b972-30748e339115	1e738a03-dce9-4bbb-879f-d58c79a24c3c
19	19	0	Plazi	ffb07bec-2d10-492d-9c37-361fe0b79427	1eb14b61-4d68-4458-bd46-8e7b3fe26997
0	315	315	Ocean Biodiversity Information System	ba0670b9-4186-41e6-8e70-f9cb3065551a	1f821639-7911-4ed8-b15f-382dca9e294a
2	2	0	Plazi	ffb07bec-2d10-492d-9c37-361fe0b79427	20191055-4615-43d1-8735-09e21c219a75
1180	1180	0	National Biodiversity Network	d897a5b9-35ee-4232-94bd-b0bcaac003c2	2096917b-82da-42b4-aebd-2373c3f2dbe9
0	3536	3536	U.S. Geological Survey	8618c64a-93e0-4300-b546-7249e5148ed2	248934a5-3a64-4374-a0ba-2065ef420504
47	47	0	Plazi	ffb07bec-2d10-492d-9c37-361fe0b79427	2a9de8f4-231e-4412-b987-f252b5c21cb0
0	21	21	Ocean Biodiversity Information System	ba0670b9-4186-41e6-8e70-f9cb3065551a	2cc54a56-d7dd-4937-ba73-d77163833154
5	5	0	Plazi	ffb07bec-2d10-492d-9c37-361fe0b79427	2d0f6def-9e98-4c10-811e-a13d0568b2bb
5666	5666	0	GBIF Germany	4f6826f2-4ff6-443d-b966-e6913bd24013	2d82d1cc-2709-4640-b22d-811c383b03fc
329	329	0	GBIF Germany	4f6826f2-4ff6-443d-b966-e6913bd24013	2e6b7086-17a9-463c-a355-43738c0ad85b
2344	2344	0	GBIF Benin	efb9c00e-f802-45dd-8826-a52ec45b89ff	2fa46259-69f3-4fe0-946a-b64f3e61d83b
35	35	0	Plazi	ffb07bec-2d10-492d-9c37-361fe0b79427	3079066d-9b85-489d-9eb2-4f95968c9399
0	7	7	Plazi	ffb07bec-2d10-492d-9c37-361fe0b79427	3202c158-e1c4-4cbf-835f-3c1435527f6c
147	147	0	Plazi	ffb07bec-2d10-492d-9c37-361fe0b79427	3722aa65-b935-4294-ac20-0d1179da9015
540	540	0	National Biodiversity Network	d897a5b9-35ee-4232-94bd-b0bcaac003c2	389f99e6-fb55-4d3c-a76d-3f48976c8996
0	8	8	Plazi	ffb07bec-2d10-492d-9c37-361fe0b79427	3f6c02fc-66e9-4ad6-a759-ef23da595c48
0	9	9	Plazi	ffb07bec-2d10-492d-9c37-361fe0b79427	42f12a10-1e46-41ac-9446-9b60f56f6b77
8	8	0	Plazi	ffb07bec-2d10-492d-9c37-361fe0b79427	43b037aa-03cf-441a-8947-ed778b5ccfac
3789	3789	0	Atlas of Living Australia	4a6f1b71-969e-4fc5-a693-282b05e1220c	43db9130-be5c-4d4c-a727-0709379a3fcb
1444	1444	0	GBIF Germany	4f6826f2-4ff6-443d-b966-e6913bd24013	445ee42c-8f4a-4c1d-93f4-c7d95dc8047e
556	556	0	Biodiversity Information System of Mexico	b324e8e9-9a4c-44fa-8f1a-7f39ea7ab576	451ea186-25c7-4839-92d3-fb9f012ffaae
0	1209	1209	Ocean Biodiversity Information System	ba0670b9-4186-41e6-8e70-f9cb3065551a	452c007f-433e-4593-913c-a296851578df
130	130	0	GBIF France	da44cd31-5901-4687-a106-6d1c7734ee3a	4606fa1f-d4ac-48d4-a4bf-99503677d1d4
0	2	2	Plazi	ffb07bec-2d10-492d-9c37-361fe0b79427	4887173a-fc47-483d-8c09-418c8535330b
9	9	0	Plazi	ffb07bec-2d10-492d-9c37-361fe0b79427	496d6a75-b311-4dee-8a90-970a7e5cec2e
122	122	0	Colombian Biodiversity Information System	7e865cba-7c46-417b-ade5-97f2cf5b7be0	4bf6177e-20b9-45fd-ab03-db3a42a53ba3
1667138	1667138	0	GBIF Spain	1f94b3ca-9345-4d65-afe2-4bace93aa0fe	4cf3eec1-b902-40c9-b15b-05c5fe5928b6
57	57	0	Plazi	ffb07bec-2d10-492d-9c37-361fe0b79427	4d55192e-447e-4e98-af18-f8f785eeb855
14	14	0	GBIF France	da44cd31-5901-4687-a106-6d1c7734ee3a	4e30c250-d093-4193-b3f7-3fa8b8c49524
44856	44856	0	National Biodiversity Network	d897a5b9-35ee-4232-94bd-b0bcaac003c2	4f05727d-ba08-44bd-b35d-b1d9d20ca2ef
19	19	0	Plazi	ffb07bec-2d10-492d-9c37-361fe0b79427	50a87a37-7c8b-4bd6-a300-99249c3e0dd6
911	911	0	Taiwan Biodiversity Information Facility	e1b85abc-61f9-430f-ba79-6813dec53a0f	51b39c28-ce6f-4c7f-ba01-261748411e31
16	16	0	GBIF Japan	db5705aa-6a6e-42f1-8942-d77b9f4896ea	533cd788-18f5-11e2-98fb-00145eb45e9a
90	90	0	GBIF France	da44cd31-5901-4687-a106-6d1c7734ee3a	54e190c2-768a-4ed6-a5b8-bfc6f2becb08
3	3	0	Participant Node Managers Committee	7f48e0c8-5c96-49ec-b972-30748e339115	580e5bbd-6f3b-4d9b-a4ba-f3d19b313e1f
61	61	0	GBIF Togo	c9659a3e-07e9-4fcb-83c6-de8b9009a02e	59d134ea-c119-4254-912f-0d0387aac911
10	10	0	Plazi	ffb07bec-2d10-492d-9c37-361fe0b79427	59eaf65b-cdfb-4cdb-899d-c134b38a5ca6
761	761	0	National Biodiversity Network	d897a5b9-35ee-4232-94bd-b0bcaac003c2	5eaed87c-cd79-45db-a488-727967a939d7
3217	3217	0	GBIF Brazil	cdc9736d-5ff7-4ece-9959-3c744360cdb3	5f8fb639-d208-4e1e-b40d-350df9e36cad
636	636	0	GBIF Germany	4f6826f2-4ff6-443d-b966-e6913bd24013	6372948a-f762-11e1-a439-00145eb45e9a
23	23	0	Plazi	ffb07bec-2d10-492d-9c37-361fe0b79427	63b4c615-0ea6-4d4d-95e3-bca4e08c404b
88	88	0	GBIF Germany	4f6826f2-4ff6-443d-b966-e6913bd24013	6446e26c-f762-11e1-a439-00145eb45e9a
57	57	0	GBIF Germany	4f6826f2-4ff6-443d-b966-e6913bd24013	6783ccba-f762-11e1-a439-00145eb45e9a
76	76	0	GBIF Germany	4f6826f2-4ff6-443d-b966-e6913bd24013	678bb11e-f762-11e1-a439-00145eb45e9a
16257	16257	0	GBIF France	da44cd31-5901-4687-a106-6d1c7734ee3a	681481f5-6ea7-4095-a015-f4a5be54765c
31	31	0	GBIF Germany	4f6826f2-4ff6-443d-b966-e6913bd24013	68812464-f762-11e1-a439-00145eb45e9a
131	131	0	GBIF Germany	4f6826f2-4ff6-443d-b966-e6913bd24013	6889b8cc-f762-11e1-a439-00145eb45e9a
86	86	0	Biodiversity Information System of Mexico	b324e8e9-9a4c-44fa-8f1a-7f39ea7ab576	6a15b3c9-de88-4c3c-b25a-82a0ba03c2e5
1529	1529	0	GBIF Germany	4f6826f2-4ff6-443d-b966-e6913bd24013	6a232218-f762-11e1-a439-00145eb45e9a
38	38	0	GBIF Germany	4f6826f2-4ff6-443d-b966-e6913bd24013	6a3ff69a-f762-11e1-a439-00145eb45e9a
16	16	0	GBIF Germany	4f6826f2-4ff6-443d-b966-e6913bd24013	6a95b26a-f762-11e1-a439-00145eb45e9a
6	6	0	GBIF Germany	4f6826f2-4ff6-443d-b966-e6913bd24013	6a983cce-f762-11e1-a439-00145eb45e9a
2	2	0	Plazi	ffb07bec-2d10-492d-9c37-361fe0b79427	6ac0bb0a-790a-44d4-9005-cb65de567377
2	2	0	GBIF Germany	4f6826f2-4ff6-443d-b966-e6913bd24013	6accba3a-f762-11e1-a439-00145eb45e9a
25	25	0	GBIF Germany	4f6826f2-4ff6-443d-b966-e6913bd24013	6c8b12d6-f762-11e1-a439-00145eb45e9a
11	11	0	Plazi	ffb07bec-2d10-492d-9c37-361fe0b79427	70bc86d1-f7e8-48d1-bfb7-1ad323a24b36
4841	4841	0	Atlas of Living Australia	4a6f1b71-969e-4fc5-a693-282b05e1220c	70db426c-f107-4def-ab15-900b33719e7c
6	6	0	Plazi	ffb07bec-2d10-492d-9c37-361fe0b79427	70f148ee-1a74-40d7-a11d-e30eb4f3f5e2
294	245	-49	GBIF Germany	4f6826f2-4ff6-443d-b966-e6913bd24013	711e7f72-f762-11e1-a439-00145eb45e9a
332	332	0	GBIF Germany	4f6826f2-4ff6-443d-b966-e6913bd24013	715fe476-f762-11e1-a439-00145eb45e9a
45374	45374	0	GBIF Spain	1f94b3ca-9345-4d65-afe2-4bace93aa0fe	71d46a30-f762-11e1-a439-00145eb45e9a
1379	1379	0	GBIF Germany	4f6826f2-4ff6-443d-b966-e6913bd24013	72184804-f762-11e1-a439-00145eb45e9a
0	2	2	Plazi	ffb07bec-2d10-492d-9c37-361fe0b79427	723d2e5b-aa7b-4d6f-84ad-bc45531fa175
0	428	428	Biodiversity Information System of Mexico	b324e8e9-9a4c-44fa-8f1a-7f39ea7ab576	72e34bf6-acc4-4187-8cf0-93cc4bea4de5
31	31	0	GBIF Germany	4f6826f2-4ff6-443d-b966-e6913bd24013	72e8e98c-f762-11e1-a439-00145eb45e9a
249	249	0	Ocean Biodiversity Information System	ba0670b9-4186-41e6-8e70-f9cb3065551a	732da5a9-a89a-4764-a2fb-cb19fbb52eb5
12603	12603	0	Atlas of Living Australia	4a6f1b71-969e-4fc5-a693-282b05e1220c	7447a228-a4cf-414b-87e4-3aba15275580
58	58	0	GBIF Germany	4f6826f2-4ff6-443d-b966-e6913bd24013	75feeec8-f762-11e1-a439-00145eb45e9a
0	111	111	Plazi	ffb07bec-2d10-492d-9c37-361fe0b79427	77535c7b-93e9-4e35-8d39-3950ca010edf
325	325	0	GBIF Germany	4f6826f2-4ff6-443d-b966-e6913bd24013	7762cbcc-f762-11e1-a439-00145eb45e9a
17	17	0	GBIF Germany	4f6826f2-4ff6-443d-b966-e6913bd24013	784f18b0-f762-11e1-a439-00145eb45e9a
17	17	0	Plazi	ffb07bec-2d10-492d-9c37-361fe0b79427	7938b142-b373-4e94-878d-03f545809ec4
123054	130054	7000	GBIF Finland	dd514216-5c7c-45f3-910d-797424cb5be6	7afb26e9-aad6-47cb-a5bf-de49dc7597a4
3968	3968	0	Ocean Biodiversity Information System	ba0670b9-4186-41e6-8e70-f9cb3065551a	7b4ac816-f762-11e1-a439-00145eb45e9a
1320	682	-638	GBIF Germany	4f6826f2-4ff6-443d-b966-e6913bd24013	7bd1201e-f762-11e1-a439-00145eb45e9a
272	272	0	GBIF France	da44cd31-5901-4687-a106-6d1c7734ee3a	7e58cd08-a740-4f95-9a0e-702b62a0bbff
2290	1333	-957	GBIF Germany	4f6826f2-4ff6-443d-b966-e6913bd24013	8162610a-f762-11e1-a439-00145eb45e9a
2193	2193	0	GBIF Germany	4f6826f2-4ff6-443d-b966-e6913bd24013	819b3408-f762-11e1-a439-00145eb45e9a
173	126	-47	GBIF Germany	4f6826f2-4ff6-443d-b966-e6913bd24013	826f67d2-f762-11e1-a439-00145eb45e9a
13736	13736	0	GBIF Germany	4f6826f2-4ff6-443d-b966-e6913bd24013	82ba2fce-f762-11e1-a439-00145eb45e9a
49	49	0	Biodiversity Information System of Mexico	b324e8e9-9a4c-44fa-8f1a-7f39ea7ab576	84fe4716-f762-11e1-a439-00145eb45e9a
164233	164233	0	U.S. Geological Survey	8618c64a-93e0-4300-b546-7249e5148ed2	8658262c-f762-11e1-a439-00145eb45e9a
436	394	-42	GBIF Germany	4f6826f2-4ff6-443d-b966-e6913bd24013	86cd7a9e-f762-11e1-a439-00145eb45e9a
525	525	0	GBIF Germany	4f6826f2-4ff6-443d-b966-e6913bd24013	8745862e-f762-11e1-a439-00145eb45e9a
25	25	0	GBIF Germany	4f6826f2-4ff6-443d-b966-e6913bd24013	886d4294-f762-11e1-a439-00145eb45e9a
3690	3690	0	GBIF Germany	4f6826f2-4ff6-443d-b966-e6913bd24013	892b4a50-f762-11e1-a439-00145eb45e9a
206	206	0	GBIF Germany	4f6826f2-4ff6-443d-b966-e6913bd24013	89c91816-9bef-4191-b748-880908506a3e
336	336	0	National Biodiversity Network	d897a5b9-35ee-4232-94bd-b0bcaac003c2	8a2a498a-ec04-45f4-8063-29fc807353e0
234	234	0	GBIF Germany	4f6826f2-4ff6-443d-b966-e6913bd24013	8a718492-f762-11e1-a439-00145eb45e9a
81	81	0	GBIF Germany	4f6826f2-4ff6-443d-b966-e6913bd24013	8bbb4554-f762-11e1-a439-00145eb45e9a
950	950	0	GBIF Germany	4f6826f2-4ff6-443d-b966-e6913bd24013	8dbb71dd-2612-4a91-b97e-386118800a69
136	49	-87	GBIF Germany	4f6826f2-4ff6-443d-b966-e6913bd24013	8df6e2ce-f762-11e1-a439-00145eb45e9a
29	23	-6	GBIF Germany	4f6826f2-4ff6-443d-b966-e6913bd24013	8e361066-f762-11e1-a439-00145eb45e9a
440	400	-40	GBIF Germany	4f6826f2-4ff6-443d-b966-e6913bd24013	8e658cdc-b5f3-42d7-87eb-c660f84caaa3
3869	3869	0	Participant Node Managers Committee	7f48e0c8-5c96-49ec-b972-30748e339115	8e6bce77-f46b-451c-81dc-f0713ce292c2
50	28	-22	GBIF Germany	4f6826f2-4ff6-443d-b966-e6913bd24013	8f4d87c2-f762-11e1-a439-00145eb45e9a
322	254	-68	GBIF Germany	4f6826f2-4ff6-443d-b966-e6913bd24013	8fc4e7ea-f762-11e1-a439-00145eb45e9a
0	3921	3921	Participant Node Managers Committee	7f48e0c8-5c96-49ec-b972-30748e339115	8fc84858-fd52-498a-b035-4a160bc8be1f
129	106	-23	GBIF Germany	4f6826f2-4ff6-443d-b966-e6913bd24013	8fdf3b90-f762-11e1-a439-00145eb45e9a
0	823	823	Ocean Biodiversity Information System	ba0670b9-4186-41e6-8e70-f9cb3065551a	90455ecd-7337-41ff-ba22-948b49d1b43b
204	135	-69	GBIF Germany	4f6826f2-4ff6-443d-b966-e6913bd24013	908907b0-f762-11e1-a439-00145eb45e9a
456	216	-240	GBIF Germany	4f6826f2-4ff6-443d-b966-e6913bd24013	919f8eda-f762-11e1-a439-00145eb45e9a
128	128	0	GBIF Germany	4f6826f2-4ff6-443d-b966-e6913bd24013	91e0cbac-f762-11e1-a439-00145eb45e9a
0	826	826	Colombian Biodiversity Information System	7e865cba-7c46-417b-ade5-97f2cf5b7be0	9b8b786c-9d18-4a6d-bada-fd4d6eec05f5
21	21	0	Belgian Biodiversity Platform	fb11cfe1-ebc3-45af-9159-17d9fddbcdac	9c8c249c-9426-4a03-a5bc-9150966b3c2c
520	520	0	GBIF Germany	4f6826f2-4ff6-443d-b966-e6913bd24013	9d1cee13-635b-426a-8d16-5e1c9f64fdf6
1352	1352	0	Colombian Biodiversity Information System	7e865cba-7c46-417b-ade5-97f2cf5b7be0	9e77576d-8547-44ea-932d-ff4eeda93c60
144	144	0	Atlas of Living Australia	4a6f1b71-969e-4fc5-a693-282b05e1220c	9ecef2f5-217f-4f02-b403-425f2f6ed240
0	2	2	Plazi	ffb07bec-2d10-492d-9c37-361fe0b79427	a53fa3e9-2978-4c8e-93c9-a4f4767f73ad
28	28	0	Plazi	ffb07bec-2d10-492d-9c37-361fe0b79427	a55d4503-ea70-4382-ae8d-e2302f3e90b8
49	49	0	Plazi	ffb07bec-2d10-492d-9c37-361fe0b79427	ab5305e3-707a-4aeb-91d3-eeb530c87adb
47	47	0	Plazi	ffb07bec-2d10-492d-9c37-361fe0b79427	ac7aec7f-d7b5-4ace-8960-d57ff8e34698
24	24	0	Plazi	ffb07bec-2d10-492d-9c37-361fe0b79427	ad74907d-57fc-4ce0-9aab-dc7b6adaf63d
5	5	0	Plazi	ffb07bec-2d10-492d-9c37-361fe0b79427	adc09fda-180a-4ae5-9140-4d1fd6dd6b91
0	213	213	Ocean Biodiversity Information System	ba0670b9-4186-41e6-8e70-f9cb3065551a	ae339d7c-747e-4631-bccf-bfba20836d34
0	943	943	Ocean Biodiversity Information System	ba0670b9-4186-41e6-8e70-f9cb3065551a	ae7dfcab-3fdd-4ee2-88c7-81050a649e83
8	8	0	Plazi	ffb07bec-2d10-492d-9c37-361fe0b79427	b0e533e6-de76-41d7-940a-8550a6b0d89b
0	66	66	Plazi	ffb07bec-2d10-492d-9c37-361fe0b79427	b1e94c98-b066-432e-991a-f82f9728223f
14741	14741	0	Belgian Biodiversity Platform	fb11cfe1-ebc3-45af-9159-17d9fddbcdac	b2d0f29e-4614-4001-93c8-f651878a86d2
25	25	0	Plazi	ffb07bec-2d10-492d-9c37-361fe0b79427	b2e8aead-f52d-4222-a973-3e7b4db41e62
4256	4256	0	Participant Node Managers Committee	7f48e0c8-5c96-49ec-b972-30748e339115	b68784d8-cb51-495a-8a21-a07cc369d5cd
0	11	11	Plazi	ffb07bec-2d10-492d-9c37-361fe0b79427	b8178736-7493-4f74-bc85-0188fc50473d
589	589	0	GBIF France	da44cd31-5901-4687-a106-6d1c7734ee3a	b973f6ca-0e35-4c71-8e70-4a1bc3495245
146	146	0	Belgian Biodiversity Platform	fb11cfe1-ebc3-45af-9159-17d9fddbcdac	bf75ddb7-9498-4f49-99be-82a94b4e0c55
0	17	17	Ocean Biodiversity Information System	ba0670b9-4186-41e6-8e70-f9cb3065551a	c2c21ad6-e416-40a0-81be-6347c685e50e
0	86	86	Plazi	ffb07bec-2d10-492d-9c37-361fe0b79427	c3e2c5f5-a553-4b7b-8b99-fe071d482cba
0	558015	558015	U.S. Geological Survey	8618c64a-93e0-4300-b546-7249e5148ed2	c4e1739b-e225-4773-b2ca-b9dd90846c62
0	99	99	Ocean Biodiversity Information System	ba0670b9-4186-41e6-8e70-f9cb3065551a	c61beb57-ea14-4999-a4c9-2b8a29568542
1	1	0	Colombian Biodiversity Information System	7e865cba-7c46-417b-ade5-97f2cf5b7be0	c76679f2-c9d0-4212-a266-379a206a9b2d
7	7	0	GBIF Germany	4f6826f2-4ff6-443d-b966-e6913bd24013	cc5d5725-ba7a-41a2-aafa-6be13fb4dd69
8	8	0	Plazi	ffb07bec-2d10-492d-9c37-361fe0b79427	cc82edd5-cfe9-4b3b-8359-397ba7f2ef04
703	703	0	GBIF France	da44cd31-5901-4687-a106-6d1c7734ee3a	cef7d8d6-5166-4f94-b7f0-9d54c888eaab
4810	4810	0	Colombian Biodiversity Information System	7e865cba-7c46-417b-ade5-97f2cf5b7be0	d0ae33bb-1c77-453c-9141-9dc1acff4c2c
114	114	0	Plazi	ffb07bec-2d10-492d-9c37-361fe0b79427	d3a56aac-92aa-48f2-b9fe-9576a4c2a0ec
6	6	0	Plazi	ffb07bec-2d10-492d-9c37-361fe0b79427	d3fe7e5b-15ff-43bc-a956-6793842fd7ec
187	187	0	GBIF France	da44cd31-5901-4687-a106-6d1c7734ee3a	d488c794-c2b3-4107-9b02-0c38f285db8d
0	4	4	Plazi	ffb07bec-2d10-492d-9c37-361fe0b79427	d69a4a4f-fbba-436e-b053-4a771735b9a0
0	2	2	Plazi	ffb07bec-2d10-492d-9c37-361fe0b79427	d8402b92-780a-44f3-a808-f11f2fdb64ec
61	61	0	Participant Node Managers Committee	7f48e0c8-5c96-49ec-b972-30748e339115	dbca12a3-a1d0-42bf-8535-c30aa349faa7
0	36	36	Plazi	ffb07bec-2d10-492d-9c37-361fe0b79427	dbf8de20-9c7a-4b66-9130-615b6b42e84e
7	7	0	Plazi	ffb07bec-2d10-492d-9c37-361fe0b79427	dfb7d560-04e5-4eec-9275-a68e9682fb00
358	358	0	Plazi	ffb07bec-2d10-492d-9c37-361fe0b79427	dfbf09a6-f532-41a3-9087-57f8543d71bd
380452	463241	82789	Taiwan Biodiversity Information Facility	e1b85abc-61f9-430f-ba79-6813dec53a0f	e0b8cb67-6667-423d-ab71-08021b6485f3
25	25	0	Plazi	ffb07bec-2d10-492d-9c37-361fe0b79427	e4f989d2-2dcb-4d3a-9886-95a337ff4c31
0	10	10	Plazi	ffb07bec-2d10-492d-9c37-361fe0b79427	e5ce1c5f-5b84-4d35-930a-3425cff529ef
124	124	0	Plazi	ffb07bec-2d10-492d-9c37-361fe0b79427	e603e05f-2054-4965-b14d-4fca45b0891e
963	963	0	National Biodiversity Network	d897a5b9-35ee-4232-94bd-b0bcaac003c2	eff6db44-da62-47af-9625-26f3adedb709
97	97	0	Ocean Biodiversity Information System	ba0670b9-4186-41e6-8e70-f9cb3065551a	f1b65a10-b9be-46a1-9801-87f6f1b05d3a
64	64	0	Colombian Biodiversity Information System	7e865cba-7c46-417b-ade5-97f2cf5b7be0	f2bd0674-2871-4dc7-99e8-917063892368
3	3	0	Plazi	ffb07bec-2d10-492d-9c37-361fe0b79427	f33509ab-7f83-4ac9-97ea-abee10e5c094
983	983	0	GBIF France	da44cd31-5901-4687-a106-6d1c7734ee3a	f6167095-e371-4e71-8841-4d0e45093efe
138	138	0	Plazi	ffb07bec-2d10-492d-9c37-361fe0b79427	f6af87ae-7f5c-482a-8437-cba6bdcf88f5
3	3	0	Plazi	ffb07bec-2d10-492d-9c37-361fe0b79427	fab38ce3-d560-456e-8f87-dcc3f3ef1e9f
1	1	0	Plazi	ffb07bec-2d10-492d-9c37-361fe0b79427	fab96b68-c280-4ced-b0c7-6bb3c325bb50
0	543	543	Ocean Biodiversity Information System	ba0670b9-4186-41e6-8e70-f9cb3065551a	fc1d4529-8a53-4ca4-8338-30bc4aa3318e
3752	3752	0	Polish Biodiversity Information Network	2618bfdf-e194-4911-a241-80db3107bc51	fc5248b0-2fe9-11de-816f-b8a03c50a862
3697	3960	263	U.S. Geological Survey	8618c64a-93e0-4300-b546-7249e5148ed2	044d870e-5718-410a-9450-9c2ceac8e1d9
0	2	2	Plazi	ffb07bec-2d10-492d-9c37-361fe0b79427	04e87e3f-1ee0-4e8e-9562-d53b113bc3aa
0	1079	1079	GBIF Norway	4f829580-180d-46a9-9c87-ed8ec959b545	060eecc9-75b0-4952-bb48-e400d3ad7771
1036	1036	0	Plazi	ffb07bec-2d10-492d-9c37-361fe0b79427	0bb2f033-2b79-4d87-803f-91694067c3f3
18	18	0	Participant Node Managers Committee	7f48e0c8-5c96-49ec-b972-30748e339115	0f791b93-f49e-4500-b803-b97709e03fe2
23316	23316	0	Ocean Biodiversity Information System	ba0670b9-4186-41e6-8e70-f9cb3065551a	1280795f-eb48-4582-a3c8-8aa2544b3f35
0	3	3	Plazi	ffb07bec-2d10-492d-9c37-361fe0b79427	1569e457-eee7-4ab4-818e-6bc95407830f
0	867	867	Ocean Biodiversity Information System	ba0670b9-4186-41e6-8e70-f9cb3065551a	168b9ded-4005-4f9b-b43c-5db0e8bee2ac
56	56	0	GBIF France	da44cd31-5901-4687-a106-6d1c7734ee3a	1b921267-f0a5-48a1-8e53-ee9d9f753792
284290	516893	232603	South African Biodiversity Information Facility	7190b835-4e86-4b6e-85c1-19cc6677c250	1cd0cb6d-d8ab-4e4c-9672-70d22fec96b3
0	29	29	Plazi	ffb07bec-2d10-492d-9c37-361fe0b79427	203d09a7-7760-45ce-96bf-1deb2bf1c66f
0	29938	29938	Participant Node Managers Committee	7f48e0c8-5c96-49ec-b972-30748e339115	20f7dc5e-f6b6-4cba-8db3-4a522b7d08d8
61	61	0	Plazi	ffb07bec-2d10-492d-9c37-361fe0b79427	26503368-66b4-4f4b-9021-03ab2d315782
48	48	0	GBIF Malawi	2a42e4d7-ad4a-41b3-84c4-de4aa7b74d35	275a15fd-1a00-43c4-92c6-f2524ef3ca72
168	168	0	Plazi	ffb07bec-2d10-492d-9c37-361fe0b79427	27ae8f50-d74d-4e8c-8d91-fc44ea5de813
1349	1349	0	Colombian Biodiversity Information System	7e865cba-7c46-417b-ade5-97f2cf5b7be0	2819ce12-fa31-4df2-81e7-296f1ef493d1
3397	3397	0	Participant Node Managers Committee	7f48e0c8-5c96-49ec-b972-30748e339115	28835237-0876-4af5-b6b6-fb9c1945cee7
1	1	0	Plazi	ffb07bec-2d10-492d-9c37-361fe0b79427	2b76d5d9-e069-42c7-b070-da93a26ca6ce
655	655	0	GBIF Benin	efb9c00e-f802-45dd-8826-a52ec45b89ff	2bf5bb6b-0b1d-4881-ba5e-9e0f0d19c9b1
16810	16698	-112	GBIF Germany	4f6826f2-4ff6-443d-b966-e6913bd24013	2f8a1bdb-1ef9-418b-abc7-a5535746f316
7417	7417	0	GBIF Kenya	2a44d626-9f7a-4120-8a7a-4ab5ac15ff2a	3008196f-5ffc-496d-b11d-57f2124ee06b
107	107	0	Plazi	ffb07bec-2d10-492d-9c37-361fe0b79427	3208ca31-041c-4f91-a7d8-eda1c7a6bf00
1591	1591	0	GBIF France	da44cd31-5901-4687-a106-6d1c7734ee3a	3357e981-465f-40c5-8154-ec2672d963c0
64803	64818	15	Canadensys	4db9cfd2-1191-4b9d-b579-0b68ceabd968	34fbcf59-d9bb-47e7-9672-99e13ea8c736
48635	48635	0	GBIF France	da44cd31-5901-4687-a106-6d1c7734ee3a	3a04668f-4201-47f0-8ec2-69c6dbd0d238
0	213	213	Participant Node Managers Committee	7f48e0c8-5c96-49ec-b972-30748e339115	3cc90eba-6de4-4d39-8f9a-8e1770120f10
2	2	0	Plazi	ffb07bec-2d10-492d-9c37-361fe0b79427	3ef0fb21-a62a-44b8-a3da-2e562246927a
373	373	0	Participant Node Managers Committee	7f48e0c8-5c96-49ec-b972-30748e339115	491d9d91-f308-4c05-bf09-1771e15648d9
1033	1033	0	Atlas of Living Australia	4a6f1b71-969e-4fc5-a693-282b05e1220c	49438828-232f-4ea2-84a9-e8e8ba11f7d7
177	177	0	National Biodiversity Network	d897a5b9-35ee-4232-94bd-b0bcaac003c2	4d06d9c0-3c7b-4570-bc7c-35ce74120959
9948	9948	0	Canada Biodiversity Information Facility	8f83fc96-c966-4126-83f7-bf044dc49efa	4d216d91-3754-4121-959b-88fef2947cff
423	423	0	Plazi	ffb07bec-2d10-492d-9c37-361fe0b79427	508504a4-6365-4261-a0d7-e1a69ed91a85
6	6	0	Plazi	ffb07bec-2d10-492d-9c37-361fe0b79427	5135b95d-6ccc-4353-a53d-432a7a081274
5	5	0	Plazi	ffb07bec-2d10-492d-9c37-361fe0b79427	5262dcca-9d29-49b4-bea0-2e93b2bc70b7
0	14	14	Plazi	ffb07bec-2d10-492d-9c37-361fe0b79427	5758176c-96f6-43b9-b9a9-b2fac894dca8
0	2383	2383	Participant Node Managers Committee	7f48e0c8-5c96-49ec-b972-30748e339115	5878bb2f-9156-4958-9d5a-71e648fbbe6e
0	5	5	Plazi	ffb07bec-2d10-492d-9c37-361fe0b79427	5a18cd0e-710c-46e9-9da8-d35b3283e712
1725	1725	0	U.S. Geological Survey	8618c64a-93e0-4300-b546-7249e5148ed2	5a63bc4c-28e8-4d36-9939-979524702c15
0	13	13	Plazi	ffb07bec-2d10-492d-9c37-361fe0b79427	5adf46ff-aa14-4b94-9e2b-73a26f6d2fe1
335	335	0	GBIF Norway	4f829580-180d-46a9-9c87-ed8ec959b545	5af4f4e2-9e95-4374-b4f6-b1f2adf357ff
0	145	145	Participant Node Managers Committee	7f48e0c8-5c96-49ec-b972-30748e339115	5b45c55c-2aaf-472e-9223-65c40436655c
18004	18004	0	GBIF Benin	efb9c00e-f802-45dd-8826-a52ec45b89ff	5e1d2d54-f5db-43ac-87c5-55a9f79ac718
17	17	0	Plazi	ffb07bec-2d10-492d-9c37-361fe0b79427	5f00bbf3-a878-48ca-a795-3f7ef876f299
14	14	0	Plazi	ffb07bec-2d10-492d-9c37-361fe0b79427	6018f4eb-4a5b-4a3e-8d4a-376e1cce81e4
69	69	0	GBIF Germany	4f6826f2-4ff6-443d-b966-e6913bd24013	616584cc-f762-11e1-a439-00145eb45e9a
0	43	43	Plazi	ffb07bec-2d10-492d-9c37-361fe0b79427	62345736-dcf6-4c38-a870-36a90992dabb
1	1	0	Plazi	ffb07bec-2d10-492d-9c37-361fe0b79427	62efff70-444f-443e-a1ad-dc565393a383
1100	1100	0	GBIF Germany	4f6826f2-4ff6-443d-b966-e6913bd24013	637d243a-cd63-4076-b2d7-013210e8a1d0
2314	2314	0	GBIF Portugal	673f7038-4262-4149-b753-5658a4e912f6	651c0bec-bd78-4300-bbb0-5ed172fc82af
88	84	-4	GBIF Germany	4f6826f2-4ff6-443d-b966-e6913bd24013	65d84e72-f762-11e1-a439-00145eb45e9a
141	141	0	GBIF Germany	4f6826f2-4ff6-443d-b966-e6913bd24013	65ec730c-f762-11e1-a439-00145eb45e9a
128	82	-46	GBIF Germany	4f6826f2-4ff6-443d-b966-e6913bd24013	65f981dc-f762-11e1-a439-00145eb45e9a
2	2	0	Plazi	ffb07bec-2d10-492d-9c37-361fe0b79427	6873630c-26b6-487c-84a4-d4605a4ec073
42	42	0	Plazi	ffb07bec-2d10-492d-9c37-361fe0b79427	688e03b4-7031-4dfc-96f3-d5d354e4f8ee
0	5	5	Plazi	ffb07bec-2d10-492d-9c37-361fe0b79427	69fed352-566d-4729-b548-61ad1fa4cb25
26	26	0	GBIF Germany	4f6826f2-4ff6-443d-b966-e6913bd24013	6a0996c8-fc8b-4535-9941-348fb6186d25
54402	54402	0	GBIF Germany	4f6826f2-4ff6-443d-b966-e6913bd24013	6a122346-08b9-11e3-ab1f-00145eb45e9a
419	419	0	GBIF Germany	4f6826f2-4ff6-443d-b966-e6913bd24013	6a2a6320-f762-11e1-a439-00145eb45e9a
3	3	0	Participant Node Managers Committee	7f48e0c8-5c96-49ec-b972-30748e339115	6a647c06-edce-4a36-b8ac-b23593691464
226	226	0	GBIF Germany	4f6826f2-4ff6-443d-b966-e6913bd24013	6c2d9d72-f762-11e1-a439-00145eb45e9a
1	1	0	Plazi	ffb07bec-2d10-492d-9c37-361fe0b79427	6cc9b89a-f33b-4f7d-93e6-e602412db709
177	177	0	Plazi	ffb07bec-2d10-492d-9c37-361fe0b79427	6ddefedb-deb0-4021-b4c7-b3e789bc0651
0	2	2	Plazi	ffb07bec-2d10-492d-9c37-361fe0b79427	6eb56e71-5dbc-49ef-a546-4080335d7e57
0	2	2	Ocean Biodiversity Information System	ba0670b9-4186-41e6-8e70-f9cb3065551a	6f0d52f1-398e-4c95-9022-d45efcf69bf4
2220	2220	0	GBIF Norway	4f829580-180d-46a9-9c87-ed8ec959b545	6fc398fd-ed43-4245-9fea-e89fa4b92938
77	62	-15	GBIF Germany	4f6826f2-4ff6-443d-b966-e6913bd24013	70c5c9c2-f762-11e1-a439-00145eb45e9a
132	132	0	GBIF Germany	4f6826f2-4ff6-443d-b966-e6913bd24013	71014e84-f762-11e1-a439-00145eb45e9a
71	71	0	GBIF Benin	efb9c00e-f802-45dd-8826-a52ec45b89ff	72503a60-ba39-4a93-aba1-1aa5c0ddcee1
273	273	0	GBIF Germany	4f6826f2-4ff6-443d-b966-e6913bd24013	751e7f28-f762-11e1-a439-00145eb45e9a
880	1290	410	GBIF Portugal	673f7038-4262-4149-b753-5658a4e912f6	76e75816-b0dc-4460-9de2-294f3e05ad83
80	80	0	GBIF Germany	4f6826f2-4ff6-443d-b966-e6913bd24013	7793a794-8d97-492a-a426-ce9a193492b8
39	39	0	Plazi	ffb07bec-2d10-492d-9c37-361fe0b79427	7930f3e4-2827-4ebf-91da-4d9517b8512c
1	1	0	Plazi	ffb07bec-2d10-492d-9c37-361fe0b79427	7a9eaff7-7f18-4b98-bd27-6bf638769191
309	309	0	South African Biodiversity Information Facility	7190b835-4e86-4b6e-85c1-19cc6677c250	7abad3fc-068a-4f34-8b3d-bfe03155ccde
106	106	0	Ocean Biodiversity Information System	ba0670b9-4186-41e6-8e70-f9cb3065551a	7b967e82-f762-11e1-a439-00145eb45e9a
3	3	0	National Biodiversity Network	d897a5b9-35ee-4232-94bd-b0bcaac003c2	7c08f95e-a1d6-4d62-804b-d326f2ee1a11
83	83	0	GBIF Germany	4f6826f2-4ff6-443d-b966-e6913bd24013	7cb84548-f762-11e1-a439-00145eb45e9a
325	325	0	GBIF Germany	4f6826f2-4ff6-443d-b966-e6913bd24013	7ccdd822-f762-11e1-a439-00145eb45e9a
1406	1406	0	GBIF Germany	4f6826f2-4ff6-443d-b966-e6913bd24013	7dc1700e-f762-11e1-a439-00145eb45e9a
0	654	654	National Biodiversity Network	d897a5b9-35ee-4232-94bd-b0bcaac003c2	7e8caed5-bf17-43a5-b0f6-bfb71a489336
56	56	0	Plazi	ffb07bec-2d10-492d-9c37-361fe0b79427	7eb2410e-8578-432a-88f8-bc129d0a5b08
3998	3940	-58	Biodiversity Information System of Mexico	b324e8e9-9a4c-44fa-8f1a-7f39ea7ab576	7f7a401a-f762-11e1-a439-00145eb45e9a
0	4	4	Plazi	ffb07bec-2d10-492d-9c37-361fe0b79427	7fb5c19c-0304-457a-aa26-2c43f2556f5d
2543	2543	0	Biodiversity Information System of Mexico	b324e8e9-9a4c-44fa-8f1a-7f39ea7ab576	7fce09c0-f762-11e1-a439-00145eb45e9a
164	164	0	Biodiversity Information System of Mexico	b324e8e9-9a4c-44fa-8f1a-7f39ea7ab576	8040fad4-f762-11e1-a439-00145eb45e9a
581	581	0	Plazi	ffb07bec-2d10-492d-9c37-361fe0b79427	81019b8f-4f98-4843-aed9-5aa4cc506f6f
387	396	9	GBIF Germany	4f6826f2-4ff6-443d-b966-e6913bd24013	81a3cae6-f762-11e1-a439-00145eb45e9a
4065	4065	0	GBIF Spain	1f94b3ca-9345-4d65-afe2-4bace93aa0fe	8385a082-f762-11e1-a439-00145eb45e9a
517	517	0	Korean Biodiversity Information Facility	e0a1e772-0177-4800-94b4-2d023fe6cdf4	8433c45a-f762-11e1-a439-00145eb45e9a
21884	21884	0	U.S. Geological Survey	8618c64a-93e0-4300-b546-7249e5148ed2	84b018de-f762-11e1-a439-00145eb45e9a
223	223	0	Colombian Biodiversity Information System	7e865cba-7c46-417b-ade5-97f2cf5b7be0	877d957a-685e-49e3-ba20-e74b692a0091
510	378	-132	GBIF Germany	4f6826f2-4ff6-443d-b966-e6913bd24013	87eab02c-f762-11e1-a439-00145eb45e9a
201	165	-36	GBIF Germany	4f6826f2-4ff6-443d-b966-e6913bd24013	886158b2-f762-11e1-a439-00145eb45e9a
26	26	0	Plazi	ffb07bec-2d10-492d-9c37-361fe0b79427	88f8a4bb-e660-43e7-b613-bf4befc6d586
168	168	0	GBIF Germany	4f6826f2-4ff6-443d-b966-e6913bd24013	895ee173-1561-4d52-9418-d721748a0942
152	152	0	GBIF Germany	4f6826f2-4ff6-443d-b966-e6913bd24013	8983b7c6-f762-11e1-a439-00145eb45e9a
269	269	0	GBIF Germany	4f6826f2-4ff6-443d-b966-e6913bd24013	8984fb2c-f762-11e1-a439-00145eb45e9a
68	68	0	GBIF Germany	4f6826f2-4ff6-443d-b966-e6913bd24013	89903b7c-f762-11e1-a439-00145eb45e9a
166	166	0	GBIF Germany	4f6826f2-4ff6-443d-b966-e6913bd24013	8a4cb554-f762-11e1-a439-00145eb45e9a
113	113	0	GBIF Germany	4f6826f2-4ff6-443d-b966-e6913bd24013	8b8d6864-f762-11e1-a439-00145eb45e9a
3	3	0	GBIF Germany	4f6826f2-4ff6-443d-b966-e6913bd24013	8c3939d2-f762-11e1-a439-00145eb45e9a
7	4	-3	GBIF Germany	4f6826f2-4ff6-443d-b966-e6913bd24013	8c654e0a-f762-11e1-a439-00145eb45e9a
4	4	0	Plazi	ffb07bec-2d10-492d-9c37-361fe0b79427	8cad015c-b953-4395-ac07-6be165a4b276
1848	1680	-168	GBIF Germany	4f6826f2-4ff6-443d-b966-e6913bd24013	8f0c34de-f762-11e1-a439-00145eb45e9a
993	801	-192	GBIF Germany	4f6826f2-4ff6-443d-b966-e6913bd24013	8f2c0cb4-f762-11e1-a439-00145eb45e9a
751	99	-652	GBIF Germany	4f6826f2-4ff6-443d-b966-e6913bd24013	8f82368e-f762-11e1-a439-00145eb45e9a
169	71	-98	GBIF Germany	4f6826f2-4ff6-443d-b966-e6913bd24013	8fb5b96e-f762-11e1-a439-00145eb45e9a
17	17	0	Plazi	ffb07bec-2d10-492d-9c37-361fe0b79427	8fe9b9f8-e7e7-4a26-9bf6-b8159322ff7d
2124	1351	-773	GBIF Germany	4f6826f2-4ff6-443d-b966-e6913bd24013	901a05e0-f762-11e1-a439-00145eb45e9a
85	85	0	Canada Biodiversity Information Facility	8f83fc96-c966-4126-83f7-bf044dc49efa	90d8babc-685f-449e-a4ec-7275ca7655c7
256	189	-67	GBIF Germany	4f6826f2-4ff6-443d-b966-e6913bd24013	91161bbe-f762-11e1-a439-00145eb45e9a
0	3	3	Plazi	ffb07bec-2d10-492d-9c37-361fe0b79427	9213ee25-a9f3-49f6-bf72-8cb456c14b03
81	81	0	GBIF Germany	4f6826f2-4ff6-443d-b966-e6913bd24013	93aca0a0-f762-11e1-a439-00145eb45e9a
924	924	0	GBIF Germany	4f6826f2-4ff6-443d-b966-e6913bd24013	94056fe6-f762-11e1-a439-00145eb45e9a
508	508	0	GBIF Germany	4f6826f2-4ff6-443d-b966-e6913bd24013	94369fee-f762-11e1-a439-00145eb45e9a
828	828	0	GBIF Germany	4f6826f2-4ff6-443d-b966-e6913bd24013	943a8df2-f762-11e1-a439-00145eb45e9a
1769	1598	-171	GBIF Germany	4f6826f2-4ff6-443d-b966-e6913bd24013	955ae1aa-f762-11e1-a439-00145eb45e9a
66	66	0	GBIF Germany	4f6826f2-4ff6-443d-b966-e6913bd24013	95c3fcc6-f762-11e1-a439-00145eb45e9a
14	14	0	Plazi	ffb07bec-2d10-492d-9c37-361fe0b79427	95e85c6f-dd44-4e59-a165-406dbd9e9564
52171	52171	0	U.S. Geological Survey	8618c64a-93e0-4300-b546-7249e5148ed2	96cb90b6-f762-11e1-a439-00145eb45e9a
145	145	0	GBIF Germany	4f6826f2-4ff6-443d-b966-e6913bd24013	97613c4c-f762-11e1-a439-00145eb45e9a
20	20	0	GBIF Germany	4f6826f2-4ff6-443d-b966-e6913bd24013	977520a4-f762-11e1-a439-00145eb45e9a
451	461	10	Participant Node Managers Committee	7f48e0c8-5c96-49ec-b972-30748e339115	97867fe0-cfe3-470c-877a-06f09c8eb84c
172	172	0	GBIF Malawi	2a42e4d7-ad4a-41b3-84c4-de4aa7b74d35	981e18cc-84bd-40e1-8f92-33b7330b3260
65	65	0	GBIF France	da44cd31-5901-4687-a106-6d1c7734ee3a	99252bbe-c89d-4975-9e68-24ef4cca3276
0	2	2	Plazi	ffb07bec-2d10-492d-9c37-361fe0b79427	9a33ce58-4fbb-4291-aac2-f0fae24f8e1d
5	5	0	Plazi	ffb07bec-2d10-492d-9c37-361fe0b79427	9a682dee-3c74-4ee1-b122-4b12c81fc2d7
23	23	0	Plazi	ffb07bec-2d10-492d-9c37-361fe0b79427	9dfbe7ab-f1ae-49ff-af7b-14dff6879995
1	1	0	Plazi	ffb07bec-2d10-492d-9c37-361fe0b79427	9e84fc17-5ec5-4996-862e-11ba6ea632f9
769	769	0	Plazi	ffb07bec-2d10-492d-9c37-361fe0b79427	9edbf175-04c5-4ed0-bb0d-692af154cc34
3	3	0	Plazi	ffb07bec-2d10-492d-9c37-361fe0b79427	9f63c259-8559-48dc-976f-d304a2aea518
107	107	0	GBIF France	da44cd31-5901-4687-a106-6d1c7734ee3a	a0c6fef8-344d-4bcc-84a3-947dcafad288
3605	3605	0	GBIF Brazil	cdc9736d-5ff7-4ece-9959-3c744360cdb3	a1d395f9-075e-4a41-9782-ad5dc56bcece
3986	3986	0	South African Biodiversity Information Facility	7190b835-4e86-4b6e-85c1-19cc6677c250	a387a0b3-7cf8-4d73-8851-eccbd882e16d
0	28	28	Plazi	ffb07bec-2d10-492d-9c37-361fe0b79427	a60c41ef-ab6a-406c-af1d-a0cf0face281
31	31	0	Plazi	ffb07bec-2d10-492d-9c37-361fe0b79427	a6f58ea7-5377-456b-8386-04784c3776f0
0	69	69	Plazi	ffb07bec-2d10-492d-9c37-361fe0b79427	a6f5f409-8f2f-442a-915a-bbe8129d625a
104	104	0	GBIF Argentina	2426a871-9feb-40a1-96c6-0c593a76b835	a94ee239-af76-4232-8a73-4a68636ca44e
7	7	0	Plazi	ffb07bec-2d10-492d-9c37-361fe0b79427	aa0f0257-37b0-4c89-86f6-ea93040b648f
283	283	0	Biodiversity Information System of Mexico	b324e8e9-9a4c-44fa-8f1a-7f39ea7ab576	aa3fdcd7-49c9-404b-ba60-4c100c4abdfe
0	1	1	Ocean Biodiversity Information System	ba0670b9-4186-41e6-8e70-f9cb3065551a	ab688bd4-f891-464f-8037-aadf2e09c39b
900	900	0	GBIF France	da44cd31-5901-4687-a106-6d1c7734ee3a	ac3c2dd5-ca45-48b9-97fc-ed294172e273
0	4	4	Plazi	ffb07bec-2d10-492d-9c37-361fe0b79427	add9a908-fbfa-457b-947d-24dca1493210
156	156	0	GBIF Germany	4f6826f2-4ff6-443d-b966-e6913bd24013	b2e3ecae-a1c5-49e1-982e-9c2fe918b1f5
532	532	0	Colombian Biodiversity Information System	7e865cba-7c46-417b-ade5-97f2cf5b7be0	b3e9c745-6669-459a-b10e-406e66534cb9
346	346	0	Atlas of Living Australia	4a6f1b71-969e-4fc5-a693-282b05e1220c	b5aaed9c-4f09-4cfc-9259-2dc65536a604
36606	36606	0	Atlas of Living Australia	4a6f1b71-969e-4fc5-a693-282b05e1220c	b6465deb-2071-445a-9ebd-d5722e1ed7e2
0	1	1	Plazi	ffb07bec-2d10-492d-9c37-361fe0b79427	b7b27afe-66c7-4948-823c-aa35f7fff34b
0	30	30	Plazi	ffb07bec-2d10-492d-9c37-361fe0b79427	b9c711ba-146d-447b-ac2d-e1a0fcce0053
38	38	0	Plazi	ffb07bec-2d10-492d-9c37-361fe0b79427	ba2c718f-90ee-42cd-83d8-63c457fb2e76
93	93	0	GBIF Argentina	2426a871-9feb-40a1-96c6-0c593a76b835	bbe02a61-14c8-4035-a3d4-7a748068d729
46	46	0	GBIF France	da44cd31-5901-4687-a106-6d1c7734ee3a	bced188a-b9b6-4cf5-84a4-6f3c86944972
1968	1968	0	Ocean Biodiversity Information System	ba0670b9-4186-41e6-8e70-f9cb3065551a	be31fcc4-19ae-4f80-b496-20f2119d4062
9	9	0	Plazi	ffb07bec-2d10-492d-9c37-361fe0b79427	c11acb12-6a7c-405b-823a-b7317a06df12
5	5	0	GBIF Germany	4f6826f2-4ff6-443d-b966-e6913bd24013	c2acbee4-27c1-4fa6-804a-fce981f16115
120	120	0	GBIF France	da44cd31-5901-4687-a106-6d1c7734ee3a	c41e04f3-83e2-4f70-bd23-a9866a5b4927
18959	18959	0	GBIF Japan	db5705aa-6a6e-42f1-8942-d77b9f4896ea	c4c03087-8d21-48ac-ae64-8ef7cbb9eeb6
0	94	94	Plazi	ffb07bec-2d10-492d-9c37-361fe0b79427	c50f1eed-a142-4d1b-a54b-b92dbb30e458
14	14	0	Plazi	ffb07bec-2d10-492d-9c37-361fe0b79427	c5692ba0-efec-40ee-bdb6-072ec5c8d139
8	8	0	Plazi	ffb07bec-2d10-492d-9c37-361fe0b79427	c7d7ba85-5c89-4c67-958d-877b72cca225
4	4	0	Plazi	ffb07bec-2d10-492d-9c37-361fe0b79427	c867ad97-889c-49fe-8e35-0d0a80051eb9
3980	3980	0	GBIF France	da44cd31-5901-4687-a106-6d1c7734ee3a	c91bd2f9-6862-43fc-8dee-6807b254968b
229	229	0	Participant Node Managers Committee	7f48e0c8-5c96-49ec-b972-30748e339115	cc3fc1cd-0be5-47e0-8d22-96fde8f93f6d
0	1177	1177	Canada Biodiversity Information Facility	8f83fc96-c966-4126-83f7-bf044dc49efa	cee35929-426b-49ba-8355-ebdc91f1c3ca
188	188	0	Plazi	ffb07bec-2d10-492d-9c37-361fe0b79427	cf7fa86d-ae34-4e8d-aa9d-7c15568bc995
0	1003	1003	Ocean Biodiversity Information System	ba0670b9-4186-41e6-8e70-f9cb3065551a	d02fa0b5-6e5e-44e1-bf5d-ae70545b5622
296	296	0	Plazi	ffb07bec-2d10-492d-9c37-361fe0b79427	d11bedcf-0da7-4048-96dd-d074afdfa9ce
2391	5539	3148	GBIF Germany	4f6826f2-4ff6-443d-b966-e6913bd24013	d31840e3-06ed-4ab7-bbed-783d0da5a869
4	4	0	Plazi	ffb07bec-2d10-492d-9c37-361fe0b79427	d3512743-db5f-4bba-b954-e60da16b6c4d
0	94	94	Plazi	ffb07bec-2d10-492d-9c37-361fe0b79427	d4ff05b4-fdac-44e8-8c2e-0733a93169a0
3	3	0	Plazi	ffb07bec-2d10-492d-9c37-361fe0b79427	d550b362-3de5-4cc7-bea3-d3cc77532924
0	8	8	Ocean Biodiversity Information System	ba0670b9-4186-41e6-8e70-f9cb3065551a	d6b01a8f-1d00-42ac-a718-658bfc0ec26c
0	5	5	Plazi	ffb07bec-2d10-492d-9c37-361fe0b79427	d7c5f91d-acf6-44eb-87f3-18fa771050ca
2204	2204	0	GBIF Japan	db5705aa-6a6e-42f1-8942-d77b9f4896ea	da27a3b0-5b28-4e4a-9742-dfc77a1e539f
10905	10903	-2	Biodiversity Information System of Mexico	b324e8e9-9a4c-44fa-8f1a-7f39ea7ab576	dcb23fa1-3f1a-4678-b11d-249787e79cae
167	167	0	Biodiversity Information System of Mexico	b324e8e9-9a4c-44fa-8f1a-7f39ea7ab576	dd1279b0-11cc-4ad2-9872-9d65522cdb08
191603	191603	0	GBIF Germany	4f6826f2-4ff6-443d-b966-e6913bd24013	dfcb0ee8-614f-11e2-897a-00145eb45e9a
60123	75431	15308	BioCASE	d8bbf693-a180-4995-94fe-6130795dcf2f	e49a712e-ec7b-4e7d-b916-8dcabf589979
45	45	0	Plazi	ffb07bec-2d10-492d-9c37-361fe0b79427	e742d32b-6995-490d-8b80-0e21dbc82d02
92	92	0	GBIF France	da44cd31-5901-4687-a106-6d1c7734ee3a	e8626d91-0102-463e-83df-c793b0bfa55f
30912	30912	0	GBIF France	da44cd31-5901-4687-a106-6d1c7734ee3a	eb808ca1-4e48-4a8d-ac9b-676838db5bf0
247	247	0	GBIF France	da44cd31-5901-4687-a106-6d1c7734ee3a	ebab8ef5-b3b3-440e-a79f-cc4cf8a5180c
43	43	0	Atlas of Living Australia	4a6f1b71-969e-4fc5-a693-282b05e1220c	ecadd1f4-5d30-489c-ba85-a47be708005e
253678	253678	0	U.S. Geological Survey	8618c64a-93e0-4300-b546-7249e5148ed2	fa90f202-2921-4dea-a16c-ba9f602e8ffd
268	268	0	National Biodiversity Network	d897a5b9-35ee-4232-94bd-b0bcaac003c2	fbf9d58b-e12d-482e-a1bd-5532cdf39bb3
0	3	3	Plazi	ffb07bec-2d10-492d-9c37-361fe0b79427	fce50ef0-ce7b-4c6f-8e42-84243a879107
0	1	1	Ocean Biodiversity Information System	ba0670b9-4186-41e6-8e70-f9cb3065551a	fe554e3e-b95b-47a8-84e9-d6895d091bc1
0	27	27	Plazi	ffb07bec-2d10-492d-9c37-361fe0b79427	00e3f2f2-a0eb-4491-bb2a-75cd6df31e41
0	1490	1490	Korean Biodiversity Information Facility	e0a1e772-0177-4800-94b4-2d023fe6cdf4	022ad710-0511-4345-8ab7-37c8ae521212
7	5	-2	Plazi	ffb07bec-2d10-492d-9c37-361fe0b79427	03a0789d-7fee-4fbf-8948-c3212116c981
0	11	11	Plazi	ffb07bec-2d10-492d-9c37-361fe0b79427	081f8fb0-0af9-4e5e-8637-0dac4316b719
228	228	0	GBIF France	da44cd31-5901-4687-a106-6d1c7734ee3a	0bd55429-4604-4222-a5c9-a9e811f01260
18	18	0	Plazi	ffb07bec-2d10-492d-9c37-361fe0b79427	0c65dd24-eec6-4584-87ee-b41f9b4e5f44
1262	1262	0	GBIF France	da44cd31-5901-4687-a106-6d1c7734ee3a	0d599fd8-9896-40fa-bbe8-cbb9948c2261
6	6	0	Plazi	ffb07bec-2d10-492d-9c37-361fe0b79427	0df06122-5c83-45e3-848d-33ed148dbbb2
7	7	0	Plazi	ffb07bec-2d10-492d-9c37-361fe0b79427	0fb04293-da23-43c2-a8f0-737637a14663
6329	6329	0	National Biodiversity Network	d897a5b9-35ee-4232-94bd-b0bcaac003c2	120a7bfc-06eb-4a8f-a8f5-0aa4bf0714d9
274	274	0	GBIF Norway	4f829580-180d-46a9-9c87-ed8ec959b545	126340b0-b00e-44df-9702-e6b6bcdabf27
5	5	0	Plazi	ffb07bec-2d10-492d-9c37-361fe0b79427	140b7cbb-b422-42a3-95cb-04062d0453e5
233	233	0	DanBIF - Danish Biodiversity Information Facility	4ddd294f-02b7-4359-ac33-0806a9ca9c6b	1515ac55-d024-4ed6-9785-b90625706f59
0	6	6	Plazi	ffb07bec-2d10-492d-9c37-361fe0b79427	16d0fc06-5327-41ee-bff3-53595c171ec4
54	54	0	Plazi	ffb07bec-2d10-492d-9c37-361fe0b79427	1799076a-ed93-430d-8efb-a6b00f78459e
0	2	2	Ocean Biodiversity Information System	ba0670b9-4186-41e6-8e70-f9cb3065551a	17a9d3c0-c985-46c1-ae36-72a19597a6a6
0	22	22	Plazi	ffb07bec-2d10-492d-9c37-361fe0b79427	1bc67915-8ea0-4864-9d2e-b3e8675a0dea
0	6	6	Plazi	ffb07bec-2d10-492d-9c37-361fe0b79427	1ddcd915-594e-4b9c-8c80-913922c14b26
1671	1671	0	Canada Biodiversity Information Facility	8f83fc96-c966-4126-83f7-bf044dc49efa	22eb589c-f5f2-48f0-9fc4-6dd2ff76f51d
0	29	29	Plazi	ffb07bec-2d10-492d-9c37-361fe0b79427	22ff3b27-62a8-4253-b9f3-76e185b7b35a
0	11	11	Plazi	ffb07bec-2d10-492d-9c37-361fe0b79427	27284a52-a1be-4f4b-b683-b15a3aec1ce0
2	2	0	GBIF France	da44cd31-5901-4687-a106-6d1c7734ee3a	2f605a2d-bd77-4632-a6f8-aa7ffaeb8919
73	73	0	Plazi	ffb07bec-2d10-492d-9c37-361fe0b79427	3270409d-d789-45b8-be3a-cae44026650c
0	656	656	Colombian Biodiversity Information System	7e865cba-7c46-417b-ade5-97f2cf5b7be0	327833d9-356d-4624-8bc4-18f914bfdccb
17301	17301	0	National Biodiversity Network	d897a5b9-35ee-4232-94bd-b0bcaac003c2	327b0708-c220-402e-a1f0-8807965177a5
156	156	0	GBIF Brazil	cdc9736d-5ff7-4ece-9959-3c744360cdb3	32d90382-18b6-4660-ad99-8c4e9a5bdbe5
160	160	0	GBIF Brazil	cdc9736d-5ff7-4ece-9959-3c744360cdb3	377fe452-9ed9-4092-a0fe-55b7d69fb258
13	13	0	Plazi	ffb07bec-2d10-492d-9c37-361fe0b79427	38f686ec-d435-40e6-8d43-58d7e7b8ae70
16	16	0	Plazi	ffb07bec-2d10-492d-9c37-361fe0b79427	3a87b5a3-fcb6-4e5c-8cb9-0d2bd73912e4
14	14	0	Plazi	ffb07bec-2d10-492d-9c37-361fe0b79427	3f0deb47-e96c-4ba2-a5f4-c1aa5cbbf03f
2	2	0	Plazi	ffb07bec-2d10-492d-9c37-361fe0b79427	42ebe7bb-66f5-452e-89ad-81f5caa1c8c4
394	394	0	GBIF Germany	4f6826f2-4ff6-443d-b966-e6913bd24013	436ca51c-3a0c-11e2-b0ce-00145eb45e9a
0	1	1	Ocean Biodiversity Information System	ba0670b9-4186-41e6-8e70-f9cb3065551a	46023bcb-f961-49c9-bbf6-bcd19fd04cfd
2087876	2168579	80703	U.S. Geological Survey	8618c64a-93e0-4300-b546-7249e5148ed2	4bfac3ea-8763-4f4b-a71a-76a6f5f243d3
0	42	42	Participant Node Managers Committee	7f48e0c8-5c96-49ec-b972-30748e339115	4ccfe3a2-81f4-4eb1-a565-de7bf9616a7d
9	9	0	Plazi	ffb07bec-2d10-492d-9c37-361fe0b79427	4d21a6be-57e5-4004-96b2-2894d429c573
111	111	0	Plazi	ffb07bec-2d10-492d-9c37-361fe0b79427	52495730-c12d-43ee-b0d4-8efcc3fec30d
1475	1475	0	Colombian Biodiversity Information System	7e865cba-7c46-417b-ade5-97f2cf5b7be0	54dcd6aa-a154-4d7c-9fc8-4f402cf9963e
1474	1474	0	South African Biodiversity Information Facility	7190b835-4e86-4b6e-85c1-19cc6677c250	5643e170-3ece-4377-abb1-67a7205577d0
0	3	3	Plazi	ffb07bec-2d10-492d-9c37-361fe0b79427	57fb6e48-c07a-46ed-91a7-150614ef477a
302	302	0	GBIF Germany	4f6826f2-4ff6-443d-b966-e6913bd24013	58158c46-8cf9-4190-94ce-270115631fa4
1211	1211	0	Biodiversity Information System of Mexico	b324e8e9-9a4c-44fa-8f1a-7f39ea7ab576	596c299b-fbeb-4166-b2db-09b5d078638e
0	61	61	Ocean Biodiversity Information System	ba0670b9-4186-41e6-8e70-f9cb3065551a	5983eb78-1092-4f3b-8e91-7038111b42c4
0	13	13	Plazi	ffb07bec-2d10-492d-9c37-361fe0b79427	5c33c4cc-66c7-419c-8ea2-74e35a2dd2b1
0	142	142	Plazi	ffb07bec-2d10-492d-9c37-361fe0b79427	5cb57102-4f5e-4d1a-90ce-cbe06dc4b57d
20442	20442	0	GBIF Norway	4f829580-180d-46a9-9c87-ed8ec959b545	5cd671a0-8a45-46ea-848e-d782a529cacb
4	4	0	Plazi	ffb07bec-2d10-492d-9c37-361fe0b79427	5fd376d0-1109-4e23-b6d7-8b856676e1c5
15	15	0	Plazi	ffb07bec-2d10-492d-9c37-361fe0b79427	60ca36d6-4c1f-4050-88e2-38e8b28f3f5c
163	163	0	Participant Node Managers Committee	7f48e0c8-5c96-49ec-b972-30748e339115	614e2719-07fc-4dc2-8f4f-8dd2b8732ce5
122	122	0	GBIF Germany	4f6826f2-4ff6-443d-b966-e6913bd24013	614ec23c-f762-11e1-a439-00145eb45e9a
40	40	0	GBIF Germany	4f6826f2-4ff6-443d-b966-e6913bd24013	6248453c-f762-11e1-a439-00145eb45e9a
10	10	0	GBIF Germany	4f6826f2-4ff6-443d-b966-e6913bd24013	62ebb050-f762-11e1-a439-00145eb45e9a
27	27	0	GBIF Germany	4f6826f2-4ff6-443d-b966-e6913bd24013	64c78b9c-f762-11e1-a439-00145eb45e9a
35	35	0	GBIF Germany	4f6826f2-4ff6-443d-b966-e6913bd24013	65ab4f80-f762-11e1-a439-00145eb45e9a
9	9	0	GBIF Germany	4f6826f2-4ff6-443d-b966-e6913bd24013	666a7e3c-f762-11e1-a439-00145eb45e9a
129	130	1	Indonesian Biodiversity Information Facility	2ebd91f6-f14f-4375-b525-c011a3774f03	6676b3f8-e389-4911-aa09-2e04f964a419
70	70	0	Plazi	ffb07bec-2d10-492d-9c37-361fe0b79427	66a584e7-821e-4a40-851c-397798d57504
42	42	0	GBIF Germany	4f6826f2-4ff6-443d-b966-e6913bd24013	674b234c-f762-11e1-a439-00145eb45e9a
272	272	0	GBIF France	da44cd31-5901-4687-a106-6d1c7734ee3a	67870a06-2e8b-4ad4-bd0f-6a712f468772
144	144	0	GBIF Germany	4f6826f2-4ff6-443d-b966-e6913bd24013	67e201ea-f762-11e1-a439-00145eb45e9a
52545	52545	0	Society for the Management of Electronic Biodiversity Data	97818ee4-1461-4180-bf1d-b3201050124f	685a47f1-95b5-4bc0-b105-3ed0128defbf
8373	8373	0	Polish Biodiversity Information Network	2618bfdf-e194-4911-a241-80db3107bc51	68d15500-0e2d-11de-b8e6-b8a03c50a862
27	27	0	GBIF Germany	4f6826f2-4ff6-443d-b966-e6913bd24013	68f8a3e0-f762-11e1-a439-00145eb45e9a
0	2	2	Plazi	ffb07bec-2d10-492d-9c37-361fe0b79427	69395ec0-ee72-428e-8d0a-f8ebb6634659
106	106	0	GBIF Germany	4f6826f2-4ff6-443d-b966-e6913bd24013	69574526-f762-11e1-a439-00145eb45e9a
2	2	0	GBIF Germany	4f6826f2-4ff6-443d-b966-e6913bd24013	6ad5eb28-f762-11e1-a439-00145eb45e9a
186	186	0	GBIF Germany	4f6826f2-4ff6-443d-b966-e6913bd24013	6c2ef67c-f762-11e1-a439-00145eb45e9a
39	39	0	GBIF Germany	4f6826f2-4ff6-443d-b966-e6913bd24013	6cc16688-f762-11e1-a439-00145eb45e9a
0	75	75	Plazi	ffb07bec-2d10-492d-9c37-361fe0b79427	6f58d4b8-82c0-4431-88b4-f796b392a99e
3	3	0	GBIF Germany	4f6826f2-4ff6-443d-b966-e6913bd24013	6fa6f71e-f762-11e1-a439-00145eb45e9a
14	14	0	GBIF Germany	4f6826f2-4ff6-443d-b966-e6913bd24013	6fdc9cf2-f762-11e1-a439-00145eb45e9a
86	86	0	GBIF Germany	4f6826f2-4ff6-443d-b966-e6913bd24013	6ff64986-f762-11e1-a439-00145eb45e9a
0	1	1	Plazi	ffb07bec-2d10-492d-9c37-361fe0b79427	701507bc-1fcd-4da8-8417-2db50fef5266
17	17	0	Plazi	ffb07bec-2d10-492d-9c37-361fe0b79427	709324d2-fa93-49df-8dec-4cfe5bbff810
17	17	0	GBIF Germany	4f6826f2-4ff6-443d-b966-e6913bd24013	70cf3296-f762-11e1-a439-00145eb45e9a
4	4	0	GBIF Germany	4f6826f2-4ff6-443d-b966-e6913bd24013	714ca5fa-f762-11e1-a439-00145eb45e9a
134	102	-32	GBIF Germany	4f6826f2-4ff6-443d-b966-e6913bd24013	722dd53e-f762-11e1-a439-00145eb45e9a
31	31	0	Plazi	ffb07bec-2d10-492d-9c37-361fe0b79427	7445554c-546c-445c-a8bb-e2a13e41eae3
33	33	0	GBIF Germany	4f6826f2-4ff6-443d-b966-e6913bd24013	7470adda-f762-11e1-a439-00145eb45e9a
1938	1938	0	GBIF Germany	4f6826f2-4ff6-443d-b966-e6913bd24013	74940938-f762-11e1-a439-00145eb45e9a
0	4	4	Plazi	ffb07bec-2d10-492d-9c37-361fe0b79427	752f7ac0-c85b-4a4b-a570-d91def02f162
8	8	0	Plazi	ffb07bec-2d10-492d-9c37-361fe0b79427	754180b8-51a4-4acf-b9f2-4d5abf418945
1057	1057	0	Colombian Biodiversity Information System	7e865cba-7c46-417b-ade5-97f2cf5b7be0	75d2949e-e924-4af5-9b1b-0fd5172e32a8
263	263	0	GBIF Germany	4f6826f2-4ff6-443d-b966-e6913bd24013	75d65062-f762-11e1-a439-00145eb45e9a
391	391	0	Colombian Biodiversity Information System	7e865cba-7c46-417b-ade5-97f2cf5b7be0	778cd54a-cbeb-4584-a594-0c7912f16ff4
464	464	0	Participant Node Managers Committee	7f48e0c8-5c96-49ec-b972-30748e339115	78f68965-9110-4c4c-bae8-cff085ac6b15
45	45	0	Plazi	ffb07bec-2d10-492d-9c37-361fe0b79427	79be0aab-25c7-4277-8a5d-714b5bca404d
0	3	3	Plazi	ffb07bec-2d10-492d-9c37-361fe0b79427	7a4abbc1-d6c8-426c-9a43-be1b551717bb
132	132	0	GBIF Germany	4f6826f2-4ff6-443d-b966-e6913bd24013	7ab62878-f762-11e1-a439-00145eb45e9a
104914	104914	0	GBIF Spain	1f94b3ca-9345-4d65-afe2-4bace93aa0fe	7b74be32-f762-11e1-a439-00145eb45e9a
4079	4079	0	GBIF Brazil	cdc9736d-5ff7-4ece-9959-3c744360cdb3	7bf28b64-f762-11e1-a439-00145eb45e9a
533	533	0	GBIF Germany	4f6826f2-4ff6-443d-b966-e6913bd24013	7c464d4e-f762-11e1-a439-00145eb45e9a
0	3	3	Plazi	ffb07bec-2d10-492d-9c37-361fe0b79427	7cf64209-1d3e-4377-bc01-eaa6b5093f17
270	144	-126	GBIF Germany	4f6826f2-4ff6-443d-b966-e6913bd24013	7d745f44-f762-11e1-a439-00145eb45e9a
123	91	-32	GBIF Germany	4f6826f2-4ff6-443d-b966-e6913bd24013	7edaa7e4-f762-11e1-a439-00145eb45e9a
27	27	0	Plazi	ffb07bec-2d10-492d-9c37-361fe0b79427	7ee3e454-eff3-4ff8-8118-6ee8759e8957
999	917	-82	Biodiversity Information System of Mexico	b324e8e9-9a4c-44fa-8f1a-7f39ea7ab576	7f7b6b0c-f762-11e1-a439-00145eb45e9a
3472	3472	0	Biodiversity Information System of Mexico	b324e8e9-9a4c-44fa-8f1a-7f39ea7ab576	7f915a0c-f762-11e1-a439-00145eb45e9a
1600	1600	0	Biodiversity Information System of Mexico	b324e8e9-9a4c-44fa-8f1a-7f39ea7ab576	7fc1bb5c-f762-11e1-a439-00145eb45e9a
1823	1823	0	Biodiversity Information System of Mexico	b324e8e9-9a4c-44fa-8f1a-7f39ea7ab576	7fe58438-f762-11e1-a439-00145eb45e9a
1032	1032	0	Biodiversity Information System of Mexico	b324e8e9-9a4c-44fa-8f1a-7f39ea7ab576	808f2448-f762-11e1-a439-00145eb45e9a
972	972	0	GBIF Germany	4f6826f2-4ff6-443d-b966-e6913bd24013	813c5dc0-f762-11e1-a439-00145eb45e9a
53	52	-1	GBIF Germany	4f6826f2-4ff6-443d-b966-e6913bd24013	816fbbb6-f762-11e1-a439-00145eb45e9a
30	30	0	Plazi	ffb07bec-2d10-492d-9c37-361fe0b79427	822d86b0-5e24-4601-95d9-807e2ad73497
21	21	0	Plazi	ffb07bec-2d10-492d-9c37-361fe0b79427	8253f751-e408-4e55-b851-13d612f48a79
313162	313162	0	GBIF Iceland	4dbdcae6-9ac9-4005-ac15-4a95a3eb7701	83447e40-f762-11e1-a439-00145eb45e9a
1749	1749	0	GBIF France	da44cd31-5901-4687-a106-6d1c7734ee3a	846d690e-57f5-4bba-80b6-d925679a9da7
357	357	0	GBIF Germany	4f6826f2-4ff6-443d-b966-e6913bd24013	8489ad42-3097-49a4-aeca-efd846aa908d
4114	4112	-2	National Biodiversity Network	d897a5b9-35ee-4232-94bd-b0bcaac003c2	84df82e3-99a3-4150-aea2-e2d2e159c749
151647	151802	155	U.S. Geological Survey	8618c64a-93e0-4300-b546-7249e5148ed2	854cf79e-f762-11e1-a439-00145eb45e9a
1906	1906	0	GBIF Germany	4f6826f2-4ff6-443d-b966-e6913bd24013	85930e96-f762-11e1-a439-00145eb45e9a
0	36	36	Ocean Biodiversity Information System	ba0670b9-4186-41e6-8e70-f9cb3065551a	86108218-3f54-48d5-bd12-f95e7bad7ce5
138	138	0	GBIF Germany	4f6826f2-4ff6-443d-b966-e6913bd24013	863ba0d8-f762-11e1-a439-00145eb45e9a
882	441	-441	GBIF Germany	4f6826f2-4ff6-443d-b966-e6913bd24013	86de1692-f762-11e1-a439-00145eb45e9a
89	89	0	GBIF Germany	4f6826f2-4ff6-443d-b966-e6913bd24013	8829181c-f762-11e1-a439-00145eb45e9a
74	37	-37	GBIF Germany	4f6826f2-4ff6-443d-b966-e6913bd24013	893f059a-f762-11e1-a439-00145eb45e9a
67	67	0	GBIF Germany	4f6826f2-4ff6-443d-b966-e6913bd24013	8b99c08c-f762-11e1-a439-00145eb45e9a
131	86	-45	GBIF Germany	4f6826f2-4ff6-443d-b966-e6913bd24013	8c5a13d2-f762-11e1-a439-00145eb45e9a
1373	786	-587	GBIF Germany	4f6826f2-4ff6-443d-b966-e6913bd24013	8d8b28c2-f762-11e1-a439-00145eb45e9a
190	48	-142	GBIF Germany	4f6826f2-4ff6-443d-b966-e6913bd24013	8de05284-f762-11e1-a439-00145eb45e9a
9	7	-2	GBIF Germany	4f6826f2-4ff6-443d-b966-e6913bd24013	8fe1bb5e-f762-11e1-a439-00145eb45e9a
62	44	-18	GBIF Germany	4f6826f2-4ff6-443d-b966-e6913bd24013	8ffed2c0-f762-11e1-a439-00145eb45e9a
5486	5486	0	National Biodiversity Network	d897a5b9-35ee-4232-94bd-b0bcaac003c2	90599043-45e0-46ed-b521-04140fbdd830
0	900	900	Korean Biodiversity Information Facility	e0a1e772-0177-4800-94b4-2d023fe6cdf4	9075698e-1add-44d9-b2cb-ccc4dae9e62d
308	308	0	GBIF Finland	dd514216-5c7c-45f3-910d-797424cb5be6	909cc61e-2cb6-4f7e-ba5a-ba9a9a3da1d5
0	2	2	Plazi	ffb07bec-2d10-492d-9c37-361fe0b79427	918a87d2-c986-44c3-9cbc-f5b42747fe8a
3	3	0	U.S. Geological Survey	8618c64a-93e0-4300-b546-7249e5148ed2	92499d06-4394-45ee-badb-5a1e3e4f9e33
1	1	0	Plazi	ffb07bec-2d10-492d-9c37-361fe0b79427	92e78463-0b3c-4d79-a904-6bf6b1efc959
0	1	1	Plazi	ffb07bec-2d10-492d-9c37-361fe0b79427	937601c5-65de-4679-8e6a-5d9c034ee253
67	67	0	Plazi	ffb07bec-2d10-492d-9c37-361fe0b79427	940e9590-f4cf-4960-8e23-76a1cfc6f88a
523	523	0	GBIF Germany	4f6826f2-4ff6-443d-b966-e6913bd24013	943e7642-f762-11e1-a439-00145eb45e9a
13292	13292	0	Biodiversity Information System of Mexico	b324e8e9-9a4c-44fa-8f1a-7f39ea7ab576	96ab6f98-f762-11e1-a439-00145eb45e9a
150	150	0	U.S. Geological Survey	8618c64a-93e0-4300-b546-7249e5148ed2	96fa27f1-a35a-4cd1-8b42-f11c42e27fca
0	5	5	Plazi	ffb07bec-2d10-492d-9c37-361fe0b79427	97696f49-5043-4a4a-af51-3380e28133a3
4	4	0	Plazi	ffb07bec-2d10-492d-9c37-361fe0b79427	98807f75-d6ae-495f-a00a-6ecdd1bf7290
142	142	0	Plazi	ffb07bec-2d10-492d-9c37-361fe0b79427	989bd296-ce7e-4cd4-98c9-327d510f0836
0	294	294	Atlas of Living Australia	4a6f1b71-969e-4fc5-a693-282b05e1220c	9aff0198-86c9-4c00-847d-303d7115a4cc
9	9	0	GBIF Finland	dd514216-5c7c-45f3-910d-797424cb5be6	9b17d0c9-4561-4bb3-a2ce-0cdaecad95bf
1000	1000	0	Korean Biodiversity Information Facility	e0a1e772-0177-4800-94b4-2d023fe6cdf4	9bca1aa5-56f2-4ada-bfa2-dc35404ca562
1	1	0	Plazi	ffb07bec-2d10-492d-9c37-361fe0b79427	9ce0c42e-6719-4e5e-9443-c53256ae1a4c
4	4	0	Plazi	ffb07bec-2d10-492d-9c37-361fe0b79427	9f3d818c-295f-42b5-b5ee-e1ea21efd96f
65291	65291	0	National Biodiversity Network	d897a5b9-35ee-4232-94bd-b0bcaac003c2	a2592a93-d6c0-4b16-a76f-b81fa29a7cc6
4334	4334	0	Biodiversity Information System of Mexico	b324e8e9-9a4c-44fa-8f1a-7f39ea7ab576	a3741dfb-964a-4d84-ad4a-cd8cd11f74ea
0	76	76	Plazi	ffb07bec-2d10-492d-9c37-361fe0b79427	a455ec8a-874b-4076-8230-650929700063
181	181	0	Colombian Biodiversity Information System	7e865cba-7c46-417b-ade5-97f2cf5b7be0	a61478d3-148f-4b39-b82b-61ab969e40c8
9	9	0	Plazi	ffb07bec-2d10-492d-9c37-361fe0b79427	a63fbcd8-64c4-4c81-9ea0-c0e45577c7ad
1	1	0	Plazi	ffb07bec-2d10-492d-9c37-361fe0b79427	a76e3280-5714-454e-9759-375c9ff8216a
1318	2605	1287	GBIF Brazil	cdc9736d-5ff7-4ece-9959-3c744360cdb3	a776a61d-f01e-4a8e-8fb0-c69d08795118
20	20	0	GBIF Brazil	cdc9736d-5ff7-4ece-9959-3c744360cdb3	aa02f601-c82e-41bd-9cb4-c8816e702369
20065	20065	0	GBIF New Zealand	4f9fd726-20dd-445e-89a1-8ed93792276f	aad97542-a068-449d-adb3-a8e937f64cb4
0	25	25	Plazi	ffb07bec-2d10-492d-9c37-361fe0b79427	abae667f-9034-4d62-a010-b901ece4a71c
75152	75152	0	U.S. Geological Survey	8618c64a-93e0-4300-b546-7249e5148ed2	b35db347-0fb6-44fa-9d56-2a831695378d
0	1	1	Plazi	ffb07bec-2d10-492d-9c37-361fe0b79427	b4410b20-5a83-4436-83e7-9af0de4219b3
1	1	0	Plazi	ffb07bec-2d10-492d-9c37-361fe0b79427	b6d4774e-80ef-44d6-80ae-ea83e516b9b2
6	6	0	GBIF Portugal	673f7038-4262-4149-b753-5658a4e912f6	b76dc074-73ef-474b-be90-d40a67bde9ba
0	9	9	Plazi	ffb07bec-2d10-492d-9c37-361fe0b79427	b7ba273d-5463-4d71-951a-39929e6c6a05
868	868	0	GBIF France	da44cd31-5901-4687-a106-6d1c7734ee3a	b7e2eb43-48dc-4e34-acf1-2f5b0f875d16
23	23	0	GBIF France	da44cd31-5901-4687-a106-6d1c7734ee3a	b99e163a-59ff-4e3a-b5dd-1fa8ff321f68
7	7	0	Plazi	ffb07bec-2d10-492d-9c37-361fe0b79427	bba05b9e-f544-488d-abf4-222aec8c64e7
2313	2313	0	GBIF France	da44cd31-5901-4687-a106-6d1c7734ee3a	bc3092fb-ccb7-4ba4-8bc3-93e599f341c1
0	4599	4599	National Biodiversity Network	d897a5b9-35ee-4232-94bd-b0bcaac003c2	bd552593-f9c8-4b54-8887-fb00b647c6f9
860613	860613	0	Atlas of Living Australia	4a6f1b71-969e-4fc5-a693-282b05e1220c	bf1feaf4-b23d-4529-9c47-ac6176c70afe
3	3	0	Plazi	ffb07bec-2d10-492d-9c37-361fe0b79427	c149fa4e-75fc-4af6-a83e-3e9fe3e8617f
0	21	21	Plazi	ffb07bec-2d10-492d-9c37-361fe0b79427	c61f691a-529e-40e6-9cfe-33036a7d8efc
4447	4447	0	Colombian Biodiversity Information System	7e865cba-7c46-417b-ade5-97f2cf5b7be0	c816ec3b-ed12-4891-b304-d4e626e43cb3
18	18	0	Biodiversity Information System of Mexico	b324e8e9-9a4c-44fa-8f1a-7f39ea7ab576	c850b2ec-375b-47d8-a8a5-1845792cc981
0	6	6	Plazi	ffb07bec-2d10-492d-9c37-361fe0b79427	c8ff55f5-2c17-4967-9cc6-4ece81f60ebd
196	196	0	GBIF France	da44cd31-5901-4687-a106-6d1c7734ee3a	ca6609c7-703d-4e3c-bac3-6b096371f46c
2	2	0	Plazi	ffb07bec-2d10-492d-9c37-361fe0b79427	ccac3aa8-23c4-4ab2-bcb0-4d32fafdf5d1
20588	20588	0	South African Biodiversity Information Facility	7190b835-4e86-4b6e-85c1-19cc6677c250	cd6fe3a0-eee9-4066-8420-e36313ed833d
0	40	40	Participant Node Managers Committee	7f48e0c8-5c96-49ec-b972-30748e339115	cd89ceb1-1aa5-4c50-a3b2-3d1edab5c49b
2	2	0	Plazi	ffb07bec-2d10-492d-9c37-361fe0b79427	cdb56a45-fea0-46b1-8daf-c6ec35d1b54a
3	3	0	Plazi	ffb07bec-2d10-492d-9c37-361fe0b79427	ce956d22-dae0-4074-9ee7-b734852d8d21
0	2	2	Plazi	ffb07bec-2d10-492d-9c37-361fe0b79427	d514e330-ea0e-4aeb-9462-d0e27d4bc41b
4357	4482	125	Netherlands Biodiversity Information Facility	0909d601-bda2-42df-9e63-a6d51847ebce	d7713b53-c84b-42b6-ab9f-13beab9f4e33
6738	6738	0	Biodiversity Information System of Mexico	b324e8e9-9a4c-44fa-8f1a-7f39ea7ab576	da42f98d-c846-4328-864e-f4018e3326fb
2534	2534	0	Participant Node Managers Committee	7f48e0c8-5c96-49ec-b972-30748e339115	db3c013f-00d0-4146-be65-86e89cbf1436
3	3	0	Plazi	ffb07bec-2d10-492d-9c37-361fe0b79427	e2456c67-d147-4628-b9fb-48e1aa4efaca
244	244	0	GBIF France	da44cd31-5901-4687-a106-6d1c7734ee3a	e3282b1a-6be2-4c7f-b3cd-782eccbff770
9684	9815	131	GBIF Brazil	cdc9736d-5ff7-4ece-9959-3c744360cdb3	e6694e54-1cd6-4527-a26e-387518ea550a
0	20	20	Plazi	ffb07bec-2d10-492d-9c37-361fe0b79427	e6a117e5-8a2c-4218-99be-7f5298370ba4
69	69	0	Plazi	ffb07bec-2d10-492d-9c37-361fe0b79427	e75dd27e-8506-4850-9e05-48101e710bec
50095	50095	0	Costa Rica Biodiversity Facility	3379bb09-1a58-41e7-9c57-e3b66c3eb5a0	ea142d74-1e42-4d7e-a2f0-58b1fae442b5
1	1	0	Plazi	ffb07bec-2d10-492d-9c37-361fe0b79427	eb530d13-70af-4270-8e52-7557cf084ce6
0	3	3	Plazi	ffb07bec-2d10-492d-9c37-361fe0b79427	ec851f49-cfd8-452a-84e4-8834d1830716
2	2	0	Plazi	ffb07bec-2d10-492d-9c37-361fe0b79427	eefa86d1-e8b0-40ca-8e9a-f1f39531632e
0	41	41	Plazi	ffb07bec-2d10-492d-9c37-361fe0b79427	f0ab84e8-4ff4-46a8-a567-a9acd016305c
60653	60653	0	National Biodiversity Network	d897a5b9-35ee-4232-94bd-b0bcaac003c2	f14f3ec9-c54a-477d-82c8-f7ba6925534a
1802	1802	0	GBIF France	da44cd31-5901-4687-a106-6d1c7734ee3a	f217baff-4890-4ecf-aa60-6defdc66731d
0	73	73	Plazi	ffb07bec-2d10-492d-9c37-361fe0b79427	f2c13ed2-062a-43b3-a2e6-fb9a0145d50b
0	2	2	Plazi	ffb07bec-2d10-492d-9c37-361fe0b79427	f3622f53-cf4e-4169-8a60-93b90cf4ba9b
43	43	0	Participant Node Managers Committee	7f48e0c8-5c96-49ec-b972-30748e339115	f39cc8d9-840a-4153-abe3-5a583cc2aca0
1	1	0	Plazi	ffb07bec-2d10-492d-9c37-361fe0b79427	f3ce0f7d-d733-4d0e-92f8-4ac6ecff3091
68	68	0	Plazi	ffb07bec-2d10-492d-9c37-361fe0b79427	f3e2e226-a609-453b-995f-b5bee31a5642
2	2	0	Plazi	ffb07bec-2d10-492d-9c37-361fe0b79427	f4560bb0-0d4d-484e-a195-d31e42f8c5ba
0	21	21	Plazi	ffb07bec-2d10-492d-9c37-361fe0b79427	f5778971-d9e4-4877-b9c3-fa5fbf31bfdf
0	6	6	Plazi	ffb07bec-2d10-492d-9c37-361fe0b79427	f5bc42a3-becd-422f-ad3d-4759a380c7f9
0	5	5	Plazi	ffb07bec-2d10-492d-9c37-361fe0b79427	f5f32432-2f05-409a-868b-e8cba361956b
128	128	0	GBIF Germany	4f6826f2-4ff6-443d-b966-e6913bd24013	f8365074-0172-4ba8-9513-2d8fa31b2a14
886	886	0	GBIF France	da44cd31-5901-4687-a106-6d1c7734ee3a	f952826c-d860-4ea6-b06e-6c40161b62d4
0	57	57	Participant Node Managers Committee	7f48e0c8-5c96-49ec-b972-30748e339115	fa5c70bf-b000-452d-80f9-2fda59824809
648	648	0	GBIF France	da44cd31-5901-4687-a106-6d1c7734ee3a	fe12167f-f6dd-420f-bd95-096da215537e
0	3	3	Plazi	ffb07bec-2d10-492d-9c37-361fe0b79427	fe7ee109-70e7-4809-97e0-cb7cbc9e5ea0
0	392	392	Colombian Biodiversity Information System	7e865cba-7c46-417b-ade5-97f2cf5b7be0	fef0855a-f0b4-4ad1-9916-f2a442077496
11002	11002	0	GBIF Spain	1f94b3ca-9345-4d65-afe2-4bace93aa0fe	ff7d3d4a-6c31-4876-8339-a1794f7d0316
2925	2925	0	GBIF Germany	4f6826f2-4ff6-443d-b966-e6913bd24013	00136a02-fc03-4ee8-9dae-b667b4646ef8
59335	59335	0	U.S. Geological Survey	8618c64a-93e0-4300-b546-7249e5148ed2	014ffcc4-58fc-495f-890c-11eb2dcb62e2
189	189	0	Plazi	ffb07bec-2d10-492d-9c37-361fe0b79427	04dee53a-a8fd-4d0c-a27b-a1c1dc32072e
379	379	0	U.S. Geological Survey	8618c64a-93e0-4300-b546-7249e5148ed2	0b1be9d9-3825-4306-adf0-60551ee0dd31
38683	38683	0	GBIF New Zealand	4f9fd726-20dd-445e-89a1-8ed93792276f	0ed0a394-5276-433e-bf8d-09ceaaee45e9
1679	1679	0	GBIF Kenya	2a44d626-9f7a-4120-8a7a-4ab5ac15ff2a	10a90c7d-6459-45b3-a0f2-a507a54bbc9f
19127	19127	0	National Biodiversity Network	d897a5b9-35ee-4232-94bd-b0bcaac003c2	120b7285-b1e6-4653-ab30-8d4231ccc9bc
4	4	0	Plazi	ffb07bec-2d10-492d-9c37-361fe0b79427	15e03231-79af-472d-8123-89f8bb0a5a63
0	2	2	Plazi	ffb07bec-2d10-492d-9c37-361fe0b79427	179e6499-fcd2-48e6-96b7-55816a2cba22
10000	10000	0	GBIF Benin	efb9c00e-f802-45dd-8826-a52ec45b89ff	19cb2741-a430-4139-8680-e11eba996978
1011	1011	0	GBIF France	da44cd31-5901-4687-a106-6d1c7734ee3a	1a064c30-14e5-4d64-a01f-45bd376ffea1
14	14	0	Plazi	ffb07bec-2d10-492d-9c37-361fe0b79427	1becc3ec-db5b-4d33-af06-04224bc70c96
172	172	0	GBIF Finland	dd514216-5c7c-45f3-910d-797424cb5be6	1cd6aec4-0bf7-436f-8685-84a3485d0f18
2	2	0	Plazi	ffb07bec-2d10-492d-9c37-361fe0b79427	1de8cca0-cd2f-4a31-aaf5-fac570f8cee5
58	58	0	Plazi	ffb07bec-2d10-492d-9c37-361fe0b79427	1e1b6de8-1c4a-4235-9f91-3cd30e1b9777
0	7	7	Ocean Biodiversity Information System	ba0670b9-4186-41e6-8e70-f9cb3065551a	238c1953-21f5-4e51-9cf0-41b74b0bcc33
0	2185	2185	Plazi	ffb07bec-2d10-492d-9c37-361fe0b79427	24d2416a-fe04-45f4-83cd-1db20eff33ad
6	4451	4445	GBIF Japan	db5705aa-6a6e-42f1-8942-d77b9f4896ea	25f69383-baa6-450c-b1ef-407c4244765b
3	3	0	Plazi	ffb07bec-2d10-492d-9c37-361fe0b79427	27d9eba3-a912-4254-83e6-fb71cc6838cd
17	17	0	Participant Node Managers Committee	7f48e0c8-5c96-49ec-b972-30748e339115	292a24a0-c75f-4bb9-beba-d106282a2d92
0	2	2	Plazi	ffb07bec-2d10-492d-9c37-361fe0b79427	2a023a27-c26d-456f-a5af-5448615e02b7
1711	1711	0	Colombian Biodiversity Information System	7e865cba-7c46-417b-ade5-97f2cf5b7be0	2d52d641-da1b-4aeb-844b-32ea3322067e
0	2004	2004	Korean Biodiversity Information Facility	e0a1e772-0177-4800-94b4-2d023fe6cdf4	3260de23-4f3c-4e6a-9492-14ec179fe9a7
10	10	0	Plazi	ffb07bec-2d10-492d-9c37-361fe0b79427	3269bae6-36d8-4c4e-a814-cda94b6aeece
19	19	0	GBIF Germany	4f6826f2-4ff6-443d-b966-e6913bd24013	32c4f314-5e38-4677-a452-d61a5ede4aab
109	109	0	GBIF France	da44cd31-5901-4687-a106-6d1c7734ee3a	342dff57-29e6-4378-91e6-13319b8eaed0
14	14	0	Plazi	ffb07bec-2d10-492d-9c37-361fe0b79427	363faa19-736a-4fd0-993f-2e82f8bb8c3d
127	127	0	GBIF Germany	4f6826f2-4ff6-443d-b966-e6913bd24013	3db3b303-78b8-4cbd-8346-503c6f57045a
4	4	0	Plazi	ffb07bec-2d10-492d-9c37-361fe0b79427	3ddb2f41-50f9-4373-b474-f63dd0c6b3a0
12	12	0	Plazi	ffb07bec-2d10-492d-9c37-361fe0b79427	3ec6d01d-bfeb-4ec3-9024-b374a62305ad
1728	1728	0	Participant Node Managers Committee	7f48e0c8-5c96-49ec-b972-30748e339115	40a08be7-0642-4129-b12a-51d547dc2a74
27	27	0	Plazi	ffb07bec-2d10-492d-9c37-361fe0b79427	40e7f249-38e6-49af-92a6-0d32971cb3d8
9	9	0	Plazi	ffb07bec-2d10-492d-9c37-361fe0b79427	40f5088e-2bc3-474d-a7ed-1a76ac9f23f8
31709	31709	0	GBIF France	da44cd31-5901-4687-a106-6d1c7734ee3a	41f549a6-c7ae-4460-8b2b-3333b1a036cd
8555	8260	-295	GBIF Germany	4f6826f2-4ff6-443d-b966-e6913bd24013	42836bba-b141-41ef-b89a-b877258c82ea
22	22	0	Plazi	ffb07bec-2d10-492d-9c37-361fe0b79427	46e89323-2930-4b98-a26b-4ef7cd978a1f
1017	1017	0	GBIF Sweden	a0b3be64-6525-4387-ac67-a499950f92e1	47de2276-f18a-4c46-b573-addeb32713f1
135	135	0	GBIF France	da44cd31-5901-4687-a106-6d1c7734ee3a	48e313ff-84f7-4208-bd44-925c8e1a7835
0	1	1	Plazi	ffb07bec-2d10-492d-9c37-361fe0b79427	49fea170-00d0-41ad-bedf-7bfb215d7768
0	1	1	Plazi	ffb07bec-2d10-492d-9c37-361fe0b79427	4cd450cf-81b6-48d6-964e-257efdf4a4aa
16998	16998	0	Ocean Biodiversity Information System	ba0670b9-4186-41e6-8e70-f9cb3065551a	4cf57b8c-7308-46fd-9a78-58e8e2d651d4
29412	29412	0	GBIF Portugal	673f7038-4262-4149-b753-5658a4e912f6	4ec8729f-3d65-4974-a912-e409c2453c73
12	12	0	Plazi	ffb07bec-2d10-492d-9c37-361fe0b79427	50e34a24-87c1-416c-8ce5-65f85a0d3999
151	151	0	National Biodiversity Network	d897a5b9-35ee-4232-94bd-b0bcaac003c2	5108c281-71ad-4ad5-bbd8-160272dcd784
84	84	0	Plazi	ffb07bec-2d10-492d-9c37-361fe0b79427	512304b7-b4c5-4f08-9fc0-c09fe44a8d74
487	487	0	GBIF France	da44cd31-5901-4687-a106-6d1c7734ee3a	512eb6db-2d6a-48f3-94e7-0c2715369282
68	68	0	Secretariat of the Pacific Regional Environment Programme	29c6a139-ea7f-41f5-8d9b-c55af8736182	51aff167-af50-46ef-b64c-d8f9087d695c
915	915	0	GBIF Spain	1f94b3ca-9345-4d65-afe2-4bace93aa0fe	528e60ab-0b7d-4395-856a-581cc8b33b71
4728	4728	0	GBIF Brazil	cdc9736d-5ff7-4ece-9959-3c744360cdb3	53287502-980d-41a8-b9f0-0f3a5bcb6555
1	1	0	Plazi	ffb07bec-2d10-492d-9c37-361fe0b79427	533cfe8e-d57f-44d1-943f-3577ccc0c7e9
0	81	81	Ocean Biodiversity Information System	ba0670b9-4186-41e6-8e70-f9cb3065551a	53454e67-0eac-49c0-867a-1d147299aa2a
0	1	1	Plazi	ffb07bec-2d10-492d-9c37-361fe0b79427	57db9888-3492-43e2-83a5-43a44e5c866e
101	101	0	Plazi	ffb07bec-2d10-492d-9c37-361fe0b79427	58e0c7c5-75ec-4b1b-beb0-d01527f710f9
117	117	0	GBIF France	da44cd31-5901-4687-a106-6d1c7734ee3a	59fedb92-51ee-487c-931a-22e7fc1288c3
0	29	29	Plazi	ffb07bec-2d10-492d-9c37-361fe0b79427	5a748e83-7595-48af-bba6-0e6954fcacd1
0	8	8	Plazi	ffb07bec-2d10-492d-9c37-361fe0b79427	5ba59b53-1409-4f01-ab58-a5bf8a2c3c2e
51	51	0	Participant Node Managers Committee	7f48e0c8-5c96-49ec-b972-30748e339115	5ea86452-f10d-4820-b75e-f710c9d8593a
0	12	12	Ocean Biodiversity Information System	ba0670b9-4186-41e6-8e70-f9cb3065551a	5fefe378-7106-49d3-9dd3-545cfdde6486
4	4	0	GBIF Germany	4f6826f2-4ff6-443d-b966-e6913bd24013	62048af4-f762-11e1-a439-00145eb45e9a
22	22	0	GBIF Germany	4f6826f2-4ff6-443d-b966-e6913bd24013	62120d50-f762-11e1-a439-00145eb45e9a
138	138	0	GBIF Germany	4f6826f2-4ff6-443d-b966-e6913bd24013	6377d5bc-f762-11e1-a439-00145eb45e9a
1047	1047	0	Participant Node Managers Committee	7f48e0c8-5c96-49ec-b972-30748e339115	644552cd-458f-4e09-9fc9-08524c773d0d
114	108	-6	GBIF Germany	4f6826f2-4ff6-443d-b966-e6913bd24013	657fcd1a-f762-11e1-a439-00145eb45e9a
126	82	-44	GBIF Germany	4f6826f2-4ff6-443d-b966-e6913bd24013	65fab46c-f762-11e1-a439-00145eb45e9a
292	292	0	GBIF Germany	4f6826f2-4ff6-443d-b966-e6913bd24013	661df59e-f762-11e1-a439-00145eb45e9a
31	31	0	GBIF Germany	4f6826f2-4ff6-443d-b966-e6913bd24013	66755e10-f762-11e1-a439-00145eb45e9a
115	115	0	GBIF Germany	4f6826f2-4ff6-443d-b966-e6913bd24013	6767d96a-f762-11e1-a439-00145eb45e9a
75	75	0	GBIF Germany	4f6826f2-4ff6-443d-b966-e6913bd24013	67c5f838-f762-11e1-a439-00145eb45e9a
44	44	0	GBIF Germany	4f6826f2-4ff6-443d-b966-e6913bd24013	67cc3586-f762-11e1-a439-00145eb45e9a
1	1	0	Plazi	ffb07bec-2d10-492d-9c37-361fe0b79427	67e2ba86-b010-49d8-ba6e-a4845470e725
66	66	0	Plazi	ffb07bec-2d10-492d-9c37-361fe0b79427	681b79dd-bbd6-42ad-ab81-01b1621f2c6a
96	96	0	GBIF Germany	4f6826f2-4ff6-443d-b966-e6913bd24013	685c4f0e-f762-11e1-a439-00145eb45e9a
44	44	0	GBIF Germany	4f6826f2-4ff6-443d-b966-e6913bd24013	6aa7e430-f762-11e1-a439-00145eb45e9a
4	4	0	GBIF Germany	4f6826f2-4ff6-443d-b966-e6913bd24013	6ace093a-f762-11e1-a439-00145eb45e9a
55	55	0	Plazi	ffb07bec-2d10-492d-9c37-361fe0b79427	6b65c744-3a8a-4590-b6d1-bf748172b5c7
14	14	0	GBIF Germany	4f6826f2-4ff6-443d-b966-e6913bd24013	6bf2fc4e-f762-11e1-a439-00145eb45e9a
17	17	0	GBIF Germany	4f6826f2-4ff6-443d-b966-e6913bd24013	6cb76a66-f762-11e1-a439-00145eb45e9a
186	186	0	GBIF Germany	4f6826f2-4ff6-443d-b966-e6913bd24013	6d156bb6-f762-11e1-a439-00145eb45e9a
0	189	189	Korean Biodiversity Information Facility	e0a1e772-0177-4800-94b4-2d023fe6cdf4	6d17b671-ba95-4651-801a-f733151ab642
55374	55372	-2	Biodiversity Information System of Mexico	b324e8e9-9a4c-44fa-8f1a-7f39ea7ab576	6d81e520-7adb-4470-937f-daac38fddf45
19	19	0	Canada Biodiversity Information Facility	8f83fc96-c966-4126-83f7-bf044dc49efa	6eb0c925-06b4-4dec-a153-c4a28cb4eb9d
1861	1861	0	GBIF France	da44cd31-5901-4687-a106-6d1c7734ee3a	6f061e68-f8ee-4194-9836-367a63d5ef07
684	684	0	Participant Node Managers Committee	7f48e0c8-5c96-49ec-b972-30748e339115	6fea7d62-3711-4ccc-af77-7e072a699757
106	106	0	GBIF Germany	4f6826f2-4ff6-443d-b966-e6913bd24013	7104dc98-f762-11e1-a439-00145eb45e9a
521	521	0	GBIF Germany	4f6826f2-4ff6-443d-b966-e6913bd24013	71565a8c-f762-11e1-a439-00145eb45e9a
14	14	0	GBIF Germany	4f6826f2-4ff6-443d-b966-e6913bd24013	73459308-f762-11e1-a439-00145eb45e9a
105	105	0	GBIF Germany	4f6826f2-4ff6-443d-b966-e6913bd24013	7354ab86-f762-11e1-a439-00145eb45e9a
2	2	0	GBIF Germany	4f6826f2-4ff6-443d-b966-e6913bd24013	7392c934-f762-11e1-a439-00145eb45e9a
4	4	0	GBIF Argentina	2426a871-9feb-40a1-96c6-0c593a76b835	74a80706-0e32-4106-9076-eef35f3b8896
35990	22570	-13420	GBIF Germany	4f6826f2-4ff6-443d-b966-e6913bd24013	76821fef-6181-447a-bf7d-33e690be9134
3	3	0	GBIF Germany	4f6826f2-4ff6-443d-b966-e6913bd24013	787c49a2-f762-11e1-a439-00145eb45e9a
197	127	-70	GBIF Germany	4f6826f2-4ff6-443d-b966-e6913bd24013	79ae336c-f762-11e1-a439-00145eb45e9a
31	31	0	GBIF Germany	4f6826f2-4ff6-443d-b966-e6913bd24013	7a73205a-f762-11e1-a439-00145eb45e9a
786	786	0	National Biodiversity Network	d897a5b9-35ee-4232-94bd-b0bcaac003c2	7b1bbce6-6a69-4f7d-b611-79f070d7964e
11	11	0	GBIF Finland	dd514216-5c7c-45f3-910d-797424cb5be6	7ba1771d-f5b3-49cc-af23-5131379a6b2e
220	160	-60	GBIF Germany	4f6826f2-4ff6-443d-b966-e6913bd24013	7c0b446a-f762-11e1-a439-00145eb45e9a
0	7	7	Plazi	ffb07bec-2d10-492d-9c37-361fe0b79427	7c57b5ca-4a8c-4bd4-bfea-01118c21caef
84	84	0	GBIF Germany	4f6826f2-4ff6-443d-b966-e6913bd24013	7e08d08e-f762-11e1-a439-00145eb45e9a
4	4	0	Plazi	ffb07bec-2d10-492d-9c37-361fe0b79427	7e5f3f16-8afa-462b-9924-2e8c0ce95def
0	8	8	Plazi	ffb07bec-2d10-492d-9c37-361fe0b79427	7e69e5d0-b481-4034-bc40-7cd95db92d59
6	6	0	Plazi	ffb07bec-2d10-492d-9c37-361fe0b79427	7f0833da-ed07-48e1-9edf-b45cf7196858
2675	2675	0	GBIF Germany	4f6826f2-4ff6-443d-b966-e6913bd24013	7f38d94a-f762-11e1-a439-00145eb45e9a
635	635	0	Biodiversity Information System of Mexico	b324e8e9-9a4c-44fa-8f1a-7f39ea7ab576	7fccd136-f762-11e1-a439-00145eb45e9a
54	54	0	Atlas of Living Australia	4a6f1b71-969e-4fc5-a693-282b05e1220c	8007b00d-0834-4bea-b02e-eb34a6c937a5
22	22	0	GBIF Germany	4f6826f2-4ff6-443d-b966-e6913bd24013	81451a8c-f762-11e1-a439-00145eb45e9a
50	50	0	GBIF Germany	4f6826f2-4ff6-443d-b966-e6913bd24013	817d4fc4-f762-11e1-a439-00145eb45e9a
271	271	0	Korean Biodiversity Information Facility	e0a1e772-0177-4800-94b4-2d023fe6cdf4	8307da4e-f762-11e1-a439-00145eb45e9a
1405	1405	0	GBIF Spain	1f94b3ca-9345-4d65-afe2-4bace93aa0fe	836d7642-f762-11e1-a439-00145eb45e9a
7880	7880	0	GBIF Germany	4f6826f2-4ff6-443d-b966-e6913bd24013	85685a84-f762-11e1-a439-00145eb45e9a
433463	433463	0	GBIF Israel	8cb55387-7802-40e8-86d6-d357a583c596	8582b50a-f762-11e1-a439-00145eb45e9a
860	860	0	GBIF France	da44cd31-5901-4687-a106-6d1c7734ee3a	866e0a87-5b9b-44c3-ae3a-416e406eab26
792	577	-215	GBIF Germany	4f6826f2-4ff6-443d-b966-e6913bd24013	87ce0224-f762-11e1-a439-00145eb45e9a
34	34	0	Colombian Biodiversity Information System	7e865cba-7c46-417b-ade5-97f2cf5b7be0	8ba39a1f-659e-4be1-8aa1-228f0a013444
148	148	0	GBIF Germany	4f6826f2-4ff6-443d-b966-e6913bd24013	8c9e9f16-f762-11e1-a439-00145eb45e9a
83	36	-47	GBIF Germany	4f6826f2-4ff6-443d-b966-e6913bd24013	8d9c6718-f762-11e1-a439-00145eb45e9a
6	6	0	Plazi	ffb07bec-2d10-492d-9c37-361fe0b79427	8ea14e08-dbcf-400b-b4c2-21af547c3f69
0	40	40	Ocean Biodiversity Information System	ba0670b9-4186-41e6-8e70-f9cb3065551a	8f58741a-3670-49f0-afe4-f57378448928
24	18	-6	GBIF Germany	4f6826f2-4ff6-443d-b966-e6913bd24013	8ff5d9ea-f762-11e1-a439-00145eb45e9a
34	22	-12	GBIF Germany	4f6826f2-4ff6-443d-b966-e6913bd24013	9014a334-f762-11e1-a439-00145eb45e9a
335	177	-158	GBIF Germany	4f6826f2-4ff6-443d-b966-e6913bd24013	90261420-f762-11e1-a439-00145eb45e9a
403	341	-62	GBIF Germany	4f6826f2-4ff6-443d-b966-e6913bd24013	909e3a9a-f762-11e1-a439-00145eb45e9a
84	84	0	Atlas of Living Australia	4a6f1b71-969e-4fc5-a693-282b05e1220c	9236fad5-b80c-4630-86e0-b289812c2016
0	742	742	Colombian Biodiversity Information System	7e865cba-7c46-417b-ade5-97f2cf5b7be0	9252da9a-0dec-4c23-812f-7a3765f59678
6	6	0	GBIF Germany	4f6826f2-4ff6-443d-b966-e6913bd24013	92d1ddb2-f762-11e1-a439-00145eb45e9a
65	51	-14	GBIF Germany	4f6826f2-4ff6-443d-b966-e6913bd24013	92fa7c18-f762-11e1-a439-00145eb45e9a
1	1	0	GBIF Germany	4f6826f2-4ff6-443d-b966-e6913bd24013	937a6392-f762-11e1-a439-00145eb45e9a
4	4	0	GBIF Germany	4f6826f2-4ff6-443d-b966-e6913bd24013	93e58708-f762-11e1-a439-00145eb45e9a
220	220	0	GBIF Germany	4f6826f2-4ff6-443d-b966-e6913bd24013	93f260fe-f762-11e1-a439-00145eb45e9a
847	847	0	GBIF Germany	4f6826f2-4ff6-443d-b966-e6913bd24013	93fa1330-f762-11e1-a439-00145eb45e9a
21	21	0	Plazi	ffb07bec-2d10-492d-9c37-361fe0b79427	94eadef1-6ab1-41c8-aaad-dbb35a16a147
0	166	166	Plazi	ffb07bec-2d10-492d-9c37-361fe0b79427	95a73980-ea3b-47d6-9841-774c62b4d825
0	26	26	Participant Node Managers Committee	7f48e0c8-5c96-49ec-b972-30748e339115	965c3282-d978-40d3-91a1-ef87d80c3bc5
2571	2571	0	National Biodiversity Network	d897a5b9-35ee-4232-94bd-b0bcaac003c2	9671cd3e-9b07-4fb7-a811-918dd02a7b2b
234	234	0	Biodiversity Information System of Mexico	b324e8e9-9a4c-44fa-8f1a-7f39ea7ab576	96b422d2-f762-11e1-a439-00145eb45e9a
468	468	0	Plazi	ffb07bec-2d10-492d-9c37-361fe0b79427	96f134f5-fb01-460c-98a9-57086bad5f87
0	34	34	Plazi	ffb07bec-2d10-492d-9c37-361fe0b79427	981e9b16-22d8-4cd5-b582-c0d1fd5c6957
465	465	0	Colombian Biodiversity Information System	7e865cba-7c46-417b-ade5-97f2cf5b7be0	9966669c-119e-4fa1-b5f0-42af51a69aab
8	8	0	Plazi	ffb07bec-2d10-492d-9c37-361fe0b79427	9cb5ac02-b649-4f04-85d4-f40e86a84798
50902	46843	-4059	Biodiversity Information System of Mexico	b324e8e9-9a4c-44fa-8f1a-7f39ea7ab576	9dc617c0-f3aa-4f6d-b9e8-6d49527f6644
88329	88329	0	GBIF Spain	1f94b3ca-9345-4d65-afe2-4bace93aa0fe	9f6f3c1c-b8b2-4d1d-be3e-36217e1cb9b8
2	2	0	Plazi	ffb07bec-2d10-492d-9c37-361fe0b79427	9fdd2f5b-e519-4131-8f5c-96a3c19e8c58
3	3	0	Plazi	ffb07bec-2d10-492d-9c37-361fe0b79427	a02c7398-98e3-4511-a0de-c960e57336bc
24392	24392	0	U.S. Geological Survey	8618c64a-93e0-4300-b546-7249e5148ed2	a2e652d6-0dfe-4cb9-8198-1dbce4b6ad5d
0	2	2	Plazi	ffb07bec-2d10-492d-9c37-361fe0b79427	a64ab3ef-3b21-48c1-8e2e-79efc837b375
60445	60445	0	Atlas of Living Australia	4a6f1b71-969e-4fc5-a693-282b05e1220c	a81bea66-5d00-4fc7-a8d8-4c873d916f06
3956	3956	0	GBIF Norway	4f829580-180d-46a9-9c87-ed8ec959b545	a8a9eb9b-ce61-421b-98f0-d36cf06dbfbb
8778	12788	4010	GBIF Japan	db5705aa-6a6e-42f1-8942-d77b9f4896ea	a8fca7f7-c5e1-4b99-a13a-e07ad312b5f0
0	4	4	Plazi	ffb07bec-2d10-492d-9c37-361fe0b79427	aaf30d43-a0cf-4f5f-9d7e-f2bbf88ac078
0	4	4	Plazi	ffb07bec-2d10-492d-9c37-361fe0b79427	ac091d94-86ff-45b9-9eb3-a00c8b173096
1191	1191	0	GBIF Germany	4f6826f2-4ff6-443d-b966-e6913bd24013	ac5f88a5-b441-425a-8f3a-8b74d6fc7e5c
0	500	500	Colombian Biodiversity Information System	7e865cba-7c46-417b-ade5-97f2cf5b7be0	acbc7472-6bdc-4bfa-b0b1-2b0cbc7fee24
165	165	0	Ocean Biodiversity Information System	ba0670b9-4186-41e6-8e70-f9cb3065551a	ae6a1b79-c579-4311-a044-2d2e7cc083cd
0	3	3	Plazi	ffb07bec-2d10-492d-9c37-361fe0b79427	b33fec0a-a448-4841-b033-09513989020b
4570	4570	0	Ocean Biodiversity Information System	ba0670b9-4186-41e6-8e70-f9cb3065551a	b347bebc-bdf4-45f8-bed2-79a544f32a9d
6566	6566	0	Participant Node Managers Committee	7f48e0c8-5c96-49ec-b972-30748e339115	b4c773d1-9360-4cf3-a01b-42ecfb98bdd6
0	1	1	Plazi	ffb07bec-2d10-492d-9c37-361fe0b79427	b6d7a8e4-6523-4d45-9772-f9bb57c16853
2	2	0	Plazi	ffb07bec-2d10-492d-9c37-361fe0b79427	b73cb86b-9a7b-41c9-aedd-f6c3ad5ab7a1
336	336	0	U.S. Geological Survey	8618c64a-93e0-4300-b546-7249e5148ed2	bcaf91ed-a49f-4e34-8a20-fe8457986921
2	2	0	Plazi	ffb07bec-2d10-492d-9c37-361fe0b79427	bfa452ac-9145-45e5-83f4-6df0b7be356e
3	3	0	Plazi	ffb07bec-2d10-492d-9c37-361fe0b79427	c1599d41-a20e-4ebf-ba45-f30ab3707356
0	7912	7912	GBIF Portugal	673f7038-4262-4149-b753-5658a4e912f6	c278b645-f229-4319-9676-895577eba6ce
12	12	0	Biodiversity Information System of Mexico	b324e8e9-9a4c-44fa-8f1a-7f39ea7ab576	c2c4acd9-c985-47af-90a7-535b7b8697ae
7895	8277	382	GBIF Norway	4f829580-180d-46a9-9c87-ed8ec959b545	c47f13c1-7427-45a0-9f12-237aad351040
0	25	25	Plazi	ffb07bec-2d10-492d-9c37-361fe0b79427	c4ab39b0-7ded-4e6e-ae61-496887fb12b0
22811	22811	0	South African Biodiversity Information Facility	7190b835-4e86-4b6e-85c1-19cc6677c250	c5843752-6eae-4869-ba5c-b5fe0996cfca
0	52	52	Plazi	ffb07bec-2d10-492d-9c37-361fe0b79427	c61bf90e-165d-4f40-98e5-2cea7a55d453
5	5	0	Biodiversity Information System of Mexico	b324e8e9-9a4c-44fa-8f1a-7f39ea7ab576	c826a893-9be8-41c8-9a22-1cdd0fd8bb47
0	6	6	Plazi	ffb07bec-2d10-492d-9c37-361fe0b79427	cafa2c14-30ee-4b6c-b7f3-7a393c260ca6
0	22	22	Plazi	ffb07bec-2d10-492d-9c37-361fe0b79427	cb4d8e3b-abd4-4a73-b074-8dd9ab59f5a6
5	5	0	GBIF Portugal	673f7038-4262-4149-b753-5658a4e912f6	cd11c12e-1f1c-4ec6-8b28-c57425956915
2318	2318	0	Biodiversity Information System of Mexico	b324e8e9-9a4c-44fa-8f1a-7f39ea7ab576	cd490f80-b095-4ca7-abae-3161b177d6b9
0	2	2	Plazi	ffb07bec-2d10-492d-9c37-361fe0b79427	cdf059b4-657c-4580-98af-a3ae299d13f0
0	2	2	Plazi	ffb07bec-2d10-492d-9c37-361fe0b79427	d03f061f-1a14-4420-86e3-b69f3a484f5a
23593	23593	0	GBIF New Zealand	4f9fd726-20dd-445e-89a1-8ed93792276f	d3484430-8876-11dd-986c-b8a03c50a862
11927	11927	0	National Biodiversity Network	d897a5b9-35ee-4232-94bd-b0bcaac003c2	d4c6d7d2-4274-445f-a6c3-d92630eb81aa
342	342	0	GBIF Germany	4f6826f2-4ff6-443d-b966-e6913bd24013	d58fa822-e315-4dfe-bc01-b6e5bc3d4f1e
219	219	0	Plazi	ffb07bec-2d10-492d-9c37-361fe0b79427	d92dcbf9-8bc1-43a6-8be1-b553a257ca0b
2	2	0	Plazi	ffb07bec-2d10-492d-9c37-361fe0b79427	dcd82625-d3df-4d84-9408-646340c2d0a7
77	77	0	GBIF France	da44cd31-5901-4687-a106-6d1c7734ee3a	df6b335a-a79a-474d-bf68-1389919a6135
4378	4378	0	GBIF Benin	efb9c00e-f802-45dd-8826-a52ec45b89ff	e2385f15-aab0-437f-8793-ac58cbe1ad74
8	8	0	National Biodiversity Network	d897a5b9-35ee-4232-94bd-b0bcaac003c2	e2a7da6f-e289-4bf8-a0d8-657c2b2d38c2
0	6	6	Plazi	ffb07bec-2d10-492d-9c37-361fe0b79427	e2a96f01-0725-480f-b545-ece1d764d3c7
10497	10497	0	Biodiversity Information System of Mexico	b324e8e9-9a4c-44fa-8f1a-7f39ea7ab576	e672066e-0d00-41ec-bd55-5375ae88acf4
0	65	65	Plazi	ffb07bec-2d10-492d-9c37-361fe0b79427	e86f591b-7b3e-4002-a5e1-ddc97b53e744
13	13	0	Plazi	ffb07bec-2d10-492d-9c37-361fe0b79427	ea160d3a-63f4-4a24-b4b1-042ef1508b5c
1	1	0	Plazi	ffb07bec-2d10-492d-9c37-361fe0b79427	ea662faf-3f55-445b-a5b0-7a337060c668
342698	342698	0	GBIF France	da44cd31-5901-4687-a106-6d1c7734ee3a	eb605c7a-a91c-4ab8-a588-85d0ccb2be9e
16257	15738	-519	GBIF Brazil	cdc9736d-5ff7-4ece-9959-3c744360cdb3	ecc2d1d3-031f-4478-8565-3e098e85b33f
0	21	21	Plazi	ffb07bec-2d10-492d-9c37-361fe0b79427	ecc7a688-90c5-4228-a1b7-2dbbecbd8d5f
16818	16818	0	National Biodiversity Network	d897a5b9-35ee-4232-94bd-b0bcaac003c2	ee244f47-faf5-4be4-a26e-5c507725ddd5
3	3	0	Plazi	ffb07bec-2d10-492d-9c37-361fe0b79427	f050b07c-cf53-4ab8-8b39-64a425b160fb
16313	16313	0	U.S. Geological Survey	8618c64a-93e0-4300-b546-7249e5148ed2	f1a4ce9a-97cd-4d35-bf5e-561f2f1c6d91
0	41	41	U.S. Geological Survey	8618c64a-93e0-4300-b546-7249e5148ed2	f1ed0185-5f58-4c58-bfd7-476b44822158
0	3450	3450	GBIF Portugal	673f7038-4262-4149-b753-5658a4e912f6	f353b279-77f7-459a-847e-fcd27e17632e
3	3	0	Plazi	ffb07bec-2d10-492d-9c37-361fe0b79427	f4d3e6de-8d18-48b3-82ce-049420e693f3
3833	3833	0	Biodiversity Information System of Mexico	b324e8e9-9a4c-44fa-8f1a-7f39ea7ab576	f5d41e4b-43ce-4784-8ae4-c7e91257b912
293558	293558	0	GBIF France	da44cd31-5901-4687-a106-6d1c7734ee3a	f5e9bf91-d834-49ed-a58a-78b9cb952b35
0	8	8	Plazi	ffb07bec-2d10-492d-9c37-361fe0b79427	f638455f-2539-4bb0-816f-bafbc0b7c1ac
29	29	0	Atlas of Living Australia	4a6f1b71-969e-4fc5-a693-282b05e1220c	f66a607a-6658-4855-aaa1-291bd31c6d82
17	17	0	Plazi	ffb07bec-2d10-492d-9c37-361fe0b79427	f769c903-5553-4d4e-8e2b-8425c7f635d2
0	592	592	Plazi	ffb07bec-2d10-492d-9c37-361fe0b79427	f7793976-e4e9-4562-a9cd-eda910d77fa0
59	59	0	Plazi	ffb07bec-2d10-492d-9c37-361fe0b79427	f86beed9-5cc5-40cc-96c7-df36295b3e13
0	2	2	Plazi	ffb07bec-2d10-492d-9c37-361fe0b79427	f8acee8d-09a8-4a35-90ae-f6a1c19534c1
34	34	0	Plazi	ffb07bec-2d10-492d-9c37-361fe0b79427	f9abc544-e145-4f3f-95de-fdf9544c5f41
2	2	0	Plazi	ffb07bec-2d10-492d-9c37-361fe0b79427	00adeef2-433c-4791-8406-ff3663bba4fc
0	5	5	Plazi	ffb07bec-2d10-492d-9c37-361fe0b79427	03275eef-7d63-4437-8957-6fa282a71305
0	131	131	Plazi	ffb07bec-2d10-492d-9c37-361fe0b79427	04a53930-f89e-4eff-8909-6a86c9073659
0	16	16	Plazi	ffb07bec-2d10-492d-9c37-361fe0b79427	0a2f0130-5a64-440f-90a9-5de218c0f5ba
0	2	2	Plazi	ffb07bec-2d10-492d-9c37-361fe0b79427	0d788752-b6e2-48ad-a79e-ca955360ed28
13	13	0	Plazi	ffb07bec-2d10-492d-9c37-361fe0b79427	0d908af2-bd95-4e24-9a17-e4bdc8b0340b
36	36	0	Plazi	ffb07bec-2d10-492d-9c37-361fe0b79427	0ef582e8-21d9-4539-85e9-57c93b1d9404
9	9	0	Plazi	ffb07bec-2d10-492d-9c37-361fe0b79427	0f4653c6-d04c-4e97-91df-c10f3b0390bc
0	5	5	Plazi	ffb07bec-2d10-492d-9c37-361fe0b79427	0fb4ca76-d0b3-4a7c-98cc-7305a01813ed
20	20	0	Plazi	ffb07bec-2d10-492d-9c37-361fe0b79427	0fff5f59-ff9d-4f94-ad64-86789f3b041c
0	16	16	Plazi	ffb07bec-2d10-492d-9c37-361fe0b79427	10a760f3-303c-4196-a3ff-ce29c7654408
0	111	111	Ocean Biodiversity Information System	ba0670b9-4186-41e6-8e70-f9cb3065551a	10ce7e6f-6891-4383-be68-33b46b1fa465
2	2	0	Plazi	ffb07bec-2d10-492d-9c37-361fe0b79427	17770afd-8c50-46f3-8b81-e5bc2b93d545
4432	4432	0	Atlas of Living Australia	4a6f1b71-969e-4fc5-a693-282b05e1220c	17812adb-60bb-4feb-b074-46e55eeab4e3
33782	32276	-1506	GBIF France	da44cd31-5901-4687-a106-6d1c7734ee3a	18ae6f32-c82b-4065-a0aa-4167be45c78e
1	1	0	Plazi	ffb07bec-2d10-492d-9c37-361fe0b79427	1962ba25-e139-437a-9a9c-2e487e2bbad2
12	12	0	Plazi	ffb07bec-2d10-492d-9c37-361fe0b79427	1a406121-29f9-4998-ae88-8c1c10529967
609	609	0	Colombian Biodiversity Information System	7e865cba-7c46-417b-ade5-97f2cf5b7be0	1b204ac0-2d29-43fd-b6a2-1ec1c8b92145
1694	1694	0	Participant Node Managers Committee	7f48e0c8-5c96-49ec-b972-30748e339115	1bf568f9-7a67-4825-a187-c2f66ce06f65
145984	178832	32848	National Biodiversity Network	d897a5b9-35ee-4232-94bd-b0bcaac003c2	1c736f5f-18d4-40d3-b25a-ec9d3c3500c7
7509	7509	0	U.S. Geological Survey	8618c64a-93e0-4300-b546-7249e5148ed2	1ebf1564-949e-49ca-9f8b-e11ef68238db
0	558	558	Ocean Biodiversity Information System	ba0670b9-4186-41e6-8e70-f9cb3065551a	1f9cc4e8-b8e7-4fd4-9a62-9d1e2919fecc
4	4	0	Plazi	ffb07bec-2d10-492d-9c37-361fe0b79427	20c77818-0861-4baf-b2d1-317a32a05c45
2	2	0	Plazi	ffb07bec-2d10-492d-9c37-361fe0b79427	2142abc6-bc6a-4cfd-a320-034c3b6add4e
2	2	0	Plazi	ffb07bec-2d10-492d-9c37-361fe0b79427	22111108-7a53-4c63-b53c-f8d140812b63
1	1	0	Plazi	ffb07bec-2d10-492d-9c37-361fe0b79427	22182930-5d11-458a-bb9f-5263a6187d07
1151	1151	0	Atlas of Living Australia	4a6f1b71-969e-4fc5-a693-282b05e1220c	226064ec-8b44-44c5-ae67-b98a9598e58c
4585	4585	0	National Biodiversity Network	d897a5b9-35ee-4232-94bd-b0bcaac003c2	2ae578a7-f80f-45ca-acdc-aa293575018b
223961	223961	0	Atlas of Living Australia	4a6f1b71-969e-4fc5-a693-282b05e1220c	2cc3887f-73f3-4466-97f8-c85011314c2b
23588	23588	0	Atlas of Living Australia	4a6f1b71-969e-4fc5-a693-282b05e1220c	2d38cdfd-8d55-4154-8670-85c1bf9fa39e
37	37	0	Plazi	ffb07bec-2d10-492d-9c37-361fe0b79427	2fd4131b-a97f-49ec-93f2-5e24f4385d14
1086	1086	0	GBIF France	da44cd31-5901-4687-a106-6d1c7734ee3a	3355778a-173a-4887-999c-32dec372fc9e
0	14	14	Plazi	ffb07bec-2d10-492d-9c37-361fe0b79427	365c9903-7e5c-4c4a-a629-ca69c27cc423
146	146	0	GBIF Germany	4f6826f2-4ff6-443d-b966-e6913bd24013	3683792d-0f90-44b3-8794-442a422a0be6
870	870	0	GBIF New Zealand	4f9fd726-20dd-445e-89a1-8ed93792276f	36ae4600-17b1-437c-bdc5-7a3c98b1bff4
16341	16341	0	National Biodiversity Network	d897a5b9-35ee-4232-94bd-b0bcaac003c2	37a1816f-d4fd-4d30-bf74-72ca5bf0eb90
77	77	0	GBIF Germany	4f6826f2-4ff6-443d-b966-e6913bd24013	38129ad3-c6ce-44cf-a85f-f219cd3818f7
3	3	0	Plazi	ffb07bec-2d10-492d-9c37-361fe0b79427	3ae79ae4-cf34-4698-bfdb-6ffb298ab191
217	217	0	GBIF France	da44cd31-5901-4687-a106-6d1c7734ee3a	3bc076c3-38ef-4fe4-abbd-5ea608c65a92
0	2	2	Plazi	ffb07bec-2d10-492d-9c37-361fe0b79427	3c24bf3e-f59a-4590-8382-49e22c73a5cd
22999	22999	0	National Biodiversity Network	d897a5b9-35ee-4232-94bd-b0bcaac003c2	3c3a7955-e23b-45f7-ab29-fe8bc5876585
8497	8497	0	National Biodiversity Network	d897a5b9-35ee-4232-94bd-b0bcaac003c2	3e0b024b-ea38-4e78-a97a-9c7544beeea3
3	3	0	Plazi	ffb07bec-2d10-492d-9c37-361fe0b79427	40ea620b-b107-424b-b9c5-f2f164b7575b
117	117	0	National Biodiversity Network	d897a5b9-35ee-4232-94bd-b0bcaac003c2	40f63a26-45a0-487f-a35a-00d8ba78f042
32109	32109	0	GBIF France	da44cd31-5901-4687-a106-6d1c7734ee3a	4443b1f2-231b-4e60-b343-8c93fba93982
977	977	0	National Biodiversity Network	d897a5b9-35ee-4232-94bd-b0bcaac003c2	44bb50dd-f826-4d07-9668-87160c4f49de
8	8	0	Plazi	ffb07bec-2d10-492d-9c37-361fe0b79427	4a6349ea-1928-45b5-855f-bd13b697bb49
2140	2140	0	GBIF Japan	db5705aa-6a6e-42f1-8942-d77b9f4896ea	4a781c12-de3c-46ee-81f4-c048e078b09b
62	62	0	Plazi	ffb07bec-2d10-492d-9c37-361fe0b79427	4fe222ab-3248-413f-ba51-7dc69ea4c067
0	155	155	Participant Node Managers Committee	7f48e0c8-5c96-49ec-b972-30748e339115	506de6ea-1c7b-4149-b85f-e2a01e3c8d1a
18	18	0	Plazi	ffb07bec-2d10-492d-9c37-361fe0b79427	5160e0c6-d49e-4aa8-a836-3ec6b3b31e65
0	704	704	GBIF New Zealand	4f9fd726-20dd-445e-89a1-8ed93792276f	55ecd075-54bc-48a2-80c3-578b6f329a32
0	12	12	Plazi	ffb07bec-2d10-492d-9c37-361fe0b79427	599c1669-88c0-4f31-8601-f6cf7f215277
106	106	0	Colombian Biodiversity Information System	7e865cba-7c46-417b-ade5-97f2cf5b7be0	5a591798-2d38-41ff-9b00-b1fa0802915e
19	19	0	Biodiversity Information System of Mexico	b324e8e9-9a4c-44fa-8f1a-7f39ea7ab576	5de9ec5a-5e47-4fad-a375-21cd8e1ad406
1376	1376	0	U.S. Geological Survey	8618c64a-93e0-4300-b546-7249e5148ed2	5e932499-e63c-4fc1-89a4-dab7c475c112
70	70	0	Colombian Biodiversity Information System	7e865cba-7c46-417b-ade5-97f2cf5b7be0	5ee9e28d-9bf8-480a-8d5f-14e0e5653cf8
0	7	7	Plazi	ffb07bec-2d10-492d-9c37-361fe0b79427	60b20347-bd1b-438d-b572-79963e90c61b
8818	8818	0	National Biodiversity Network	d897a5b9-35ee-4232-94bd-b0bcaac003c2	616c201e-cac9-4e00-9dc9-0c90fdddb73e
96	96	0	GBIF Germany	4f6826f2-4ff6-443d-b966-e6913bd24013	63bfbfc6-f762-11e1-a439-00145eb45e9a
105	105	0	GBIF Germany	4f6826f2-4ff6-443d-b966-e6913bd24013	63d9841a-f762-11e1-a439-00145eb45e9a
6	6	0	Plazi	ffb07bec-2d10-492d-9c37-361fe0b79427	63f2406a-79b0-42e6-87bd-322f5e8e7285
47	47	0	GBIF Germany	4f6826f2-4ff6-443d-b966-e6913bd24013	64dd0fe4-f762-11e1-a439-00145eb45e9a
0	6	6	Plazi	ffb07bec-2d10-492d-9c37-361fe0b79427	662e22a2-3f0a-4420-9013-43d6c34ab8e2
74	74	0	GBIF Germany	4f6826f2-4ff6-443d-b966-e6913bd24013	6631e5b8-f762-11e1-a439-00145eb45e9a
140	140	0	GBIF Japan	db5705aa-6a6e-42f1-8942-d77b9f4896ea	667455a8-428b-408c-8398-1f21522ff890
41	41	0	GBIF Germany	4f6826f2-4ff6-443d-b966-e6913bd24013	66a59b8e-f762-11e1-a439-00145eb45e9a
81	81	0	GBIF Germany	4f6826f2-4ff6-443d-b966-e6913bd24013	6819997a-f762-11e1-a439-00145eb45e9a
109	109	0	GBIF Germany	4f6826f2-4ff6-443d-b966-e6913bd24013	683974ca-f762-11e1-a439-00145eb45e9a
2353	2353	0	National Biodiversity Network	d897a5b9-35ee-4232-94bd-b0bcaac003c2	68ff0485-b37a-47ca-9016-7054d07e80b9
231	231	0	GBIF France	da44cd31-5901-4687-a106-6d1c7734ee3a	6b9caef0-ebdb-4fbe-8655-095402ae0e69
12	12	0	GBIF Germany	4f6826f2-4ff6-443d-b966-e6913bd24013	6bda0ff4-f762-11e1-a439-00145eb45e9a
4	4	0	Plazi	ffb07bec-2d10-492d-9c37-361fe0b79427	6d701d4e-906b-4f4c-99c3-93a633de58c5
0	33	33	Plazi	ffb07bec-2d10-492d-9c37-361fe0b79427	6da85b06-8386-41bc-9b34-b16eba941eab
39	39	0	GBIF Germany	4f6826f2-4ff6-443d-b966-e6913bd24013	6fc5b8fc-f762-11e1-a439-00145eb45e9a
33	33	0	GBIF Germany	4f6826f2-4ff6-443d-b966-e6913bd24013	7002f028-f762-11e1-a439-00145eb45e9a
11030	11030	0	GBIF Benin	efb9c00e-f802-45dd-8826-a52ec45b89ff	7048dd38-6676-4398-af63-dee3e60941b9
31	31	0	GBIF Germany	4f6826f2-4ff6-443d-b966-e6913bd24013	71369396-f762-11e1-a439-00145eb45e9a
0	13	13	Plazi	ffb07bec-2d10-492d-9c37-361fe0b79427	731f0b79-7e5a-4546-bb64-bf2b5c4c4c0e
5	5	0	Plazi	ffb07bec-2d10-492d-9c37-361fe0b79427	737b3f23-ded0-404c-9c06-13f7ba42c485
0	213	213	Plazi	ffb07bec-2d10-492d-9c37-361fe0b79427	73bc52e8-f82a-4258-94fc-adcbdf637e54
105	105	0	GBIF Germany	4f6826f2-4ff6-443d-b966-e6913bd24013	73dbdfb6-f762-11e1-a439-00145eb45e9a
0	5	5	Plazi	ffb07bec-2d10-492d-9c37-361fe0b79427	751dcf79-63e7-48ef-bc6f-c0120d018fc8
262	262	0	GBIF Germany	4f6826f2-4ff6-443d-b966-e6913bd24013	75cd5c50-f762-11e1-a439-00145eb45e9a
2073	2073	0	GBIF Finland	dd514216-5c7c-45f3-910d-797424cb5be6	7b373b52-f762-11e1-a439-00145eb45e9a
125	125	0	Ocean Biodiversity Information System	ba0670b9-4186-41e6-8e70-f9cb3065551a	7c4f1f09-55bd-49b3-9d7e-3f00f2c5106b
0	22	22	Plazi	ffb07bec-2d10-492d-9c37-361fe0b79427	7d12d6d6-9e0b-4f57-8fd4-c44fe230e531
10498	1991	-8507	GBIF Germany	4f6826f2-4ff6-443d-b966-e6913bd24013	7dca9f62-f762-11e1-a439-00145eb45e9a
11463	11463	0	GBIF Togo	c9659a3e-07e9-4fcb-83c6-de8b9009a02e	7e27d776-24c0-4088-a269-0b49d0afcda6
0	50	50	Plazi	ffb07bec-2d10-492d-9c37-361fe0b79427	7ea5a23c-895c-4eb6-bb3d-9f0f019b3fd8
0	5	5	Plazi	ffb07bec-2d10-492d-9c37-361fe0b79427	7f2a1b52-d478-4f0a-9e03-a5b4bb6cce66
14	14	0	Plazi	ffb07bec-2d10-492d-9c37-361fe0b79427	80344067-e663-4113-a9d6-2c9ba0197314
677	677	0	Biodiversity Information System of Mexico	b324e8e9-9a4c-44fa-8f1a-7f39ea7ab576	8049bed0-f762-11e1-a439-00145eb45e9a
3240	3240	0	Biodiversity Information System of Mexico	b324e8e9-9a4c-44fa-8f1a-7f39ea7ab576	80b01cca-f762-11e1-a439-00145eb45e9a
2000	2859	859	GBIF Japan	db5705aa-6a6e-42f1-8942-d77b9f4896ea	80beb144-b111-4f16-9e71-f759ea7006a2
204	204	0	National Biodiversity Network	d897a5b9-35ee-4232-94bd-b0bcaac003c2	80bfca35-280e-4fcc-8ccb-c871ad81abcb
4991	2417	-2574	GBIF Germany	4f6826f2-4ff6-443d-b966-e6913bd24013	81fa8048-f762-11e1-a439-00145eb45e9a
139730	139730	0	Ocean Biodiversity Information System	ba0670b9-4186-41e6-8e70-f9cb3065551a	83a517aa-f762-11e1-a439-00145eb45e9a
1705	1705	0	Atlas of Living Australia	4a6f1b71-969e-4fc5-a693-282b05e1220c	8442816f-cf5f-4c21-9d3d-5c368b4006d8
25333	25333	0	DanBIF - Danish Biodiversity Information Facility	4ddd294f-02b7-4359-ac33-0806a9ca9c6b	84c58b60-f762-11e1-a439-00145eb45e9a
30141	30141	0	GBIF Spain	1f94b3ca-9345-4d65-afe2-4bace93aa0fe	8655c292-f762-11e1-a439-00145eb45e9a
84	84	0	Plazi	ffb07bec-2d10-492d-9c37-361fe0b79427	865903f4-a866-4708-88df-26f5df06baa2
628	541	-87	GBIF Germany	4f6826f2-4ff6-443d-b966-e6913bd24013	88030686-f762-11e1-a439-00145eb45e9a
1035	1035	0	GBIF Germany	4f6826f2-4ff6-443d-b966-e6913bd24013	88780c34-0f95-4e05-a557-fc8a45a72fa4
10	10	0	GBIF Germany	4f6826f2-4ff6-443d-b966-e6913bd24013	888f6810-f762-11e1-a439-00145eb45e9a
0	1692	1692	Colombian Biodiversity Information System	7e865cba-7c46-417b-ade5-97f2cf5b7be0	8909fd6f-4854-41f7-a4d8-e7da8523e2e5
938	938	0	GBIF France	da44cd31-5901-4687-a106-6d1c7734ee3a	8a119149-9d9e-4f89-9955-e3af3c4ace30
166	166	0	GBIF Germany	4f6826f2-4ff6-443d-b966-e6913bd24013	8a24ddb8-f762-11e1-a439-00145eb45e9a
457	457	0	GBIF France	da44cd31-5901-4687-a106-6d1c7734ee3a	8ab837b0-c271-4549-8698-b16c1561248c
4	4	0	Plazi	ffb07bec-2d10-492d-9c37-361fe0b79427	8af5fc81-469d-4745-9eff-ddcefdcd289e
8	8	0	GBIF Germany	4f6826f2-4ff6-443d-b966-e6913bd24013	8c0fe9a6-f762-11e1-a439-00145eb45e9a
1653	1653	0	Colombian Biodiversity Information System	7e865cba-7c46-417b-ade5-97f2cf5b7be0	8c7b97ad-3d84-4793-ab27-f1faf41e1f20
7	5	-2	GBIF Germany	4f6826f2-4ff6-443d-b966-e6913bd24013	8cfdec46-f762-11e1-a439-00145eb45e9a
45	15	-30	GBIF Germany	4f6826f2-4ff6-443d-b966-e6913bd24013	8df2eb42-f762-11e1-a439-00145eb45e9a
1	1	0	Plazi	ffb07bec-2d10-492d-9c37-361fe0b79427	8e4bae52-8e8a-4ce8-acde-a1134438bcc0
1440	1290	-150	GBIF Germany	4f6826f2-4ff6-443d-b966-e6913bd24013	8f097e38-f762-11e1-a439-00145eb45e9a
221	221	0	GBIF Germany	4f6826f2-4ff6-443d-b966-e6913bd24013	8f3e58ce-f762-11e1-a439-00145eb45e9a
12120	12120	0	National Biodiversity Network	d897a5b9-35ee-4232-94bd-b0bcaac003c2	9143dbde-abbc-4683-b8b3-65c70a8f190f
0	15	15	Ocean Biodiversity Information System	ba0670b9-4186-41e6-8e70-f9cb3065551a	94dc6a44-259c-4d3c-a220-6f58e16a2387
3	3	0	GBIF Finland	dd514216-5c7c-45f3-910d-797424cb5be6	95171a94-f716-4ae3-91db-5de4c0d2cece
0	1	1	Plazi	ffb07bec-2d10-492d-9c37-361fe0b79427	963caafd-cffd-47ba-85d2-3bb469d24dd2
356	356	0	GBIF Spain	1f94b3ca-9345-4d65-afe2-4bace93aa0fe	96c13882-f762-11e1-a439-00145eb45e9a
77	77	0	GBIF Germany	4f6826f2-4ff6-443d-b966-e6913bd24013	98725325-e9da-4256-90a9-0ffe2fc50e6e
1	1	0	Plazi	ffb07bec-2d10-492d-9c37-361fe0b79427	9bae3d9b-2f03-42ee-9a8e-ac6d8a61f7e6
3681	3681	0	GBIF Germany	4f6826f2-4ff6-443d-b966-e6913bd24013	9d514a00-14b0-4f0b-a06e-911bc0b254e3
11	11	0	Plazi	ffb07bec-2d10-492d-9c37-361fe0b79427	9d63a155-ddd8-48a6-8a0a-0fda30cbdc2d
55	55	0	Participant Node Managers Committee	7f48e0c8-5c96-49ec-b972-30748e339115	9fb83517-ecf3-431b-8f76-0ce275c99958
0	1439	1439	GBIF France	da44cd31-5901-4687-a106-6d1c7734ee3a	a1d9fbbf-6c9b-4af4-bd6a-86337c789bb2
160700	160700	0	GBIF France	da44cd31-5901-4687-a106-6d1c7734ee3a	a71c4bb7-139e-4603-aa37-46c5dbcdf17e
2	2	0	Plazi	ffb07bec-2d10-492d-9c37-361fe0b79427	a80fea7f-b2a8-479c-8552-e0dcc4be91c1
246	246	0	Colombian Biodiversity Information System	7e865cba-7c46-417b-ade5-97f2cf5b7be0	ab737ce0-2dab-427d-8806-f4654de1ec50
3	3	0	Plazi	ffb07bec-2d10-492d-9c37-361fe0b79427	acf565ee-29ba-45e7-9ef3-d1e85dec9ae7
658	658	0	GBIF Germany	4f6826f2-4ff6-443d-b966-e6913bd24013	b1d5dc97-d8fa-49ba-99be-4fe857a81005
50592	53075	2483	GBIF France	da44cd31-5901-4687-a106-6d1c7734ee3a	b568aebb-b2c8-4dd2-8a59-ab74d50f8640
0	36	36	Plazi	ffb07bec-2d10-492d-9c37-361fe0b79427	b715a8f1-cf4b-4f80-91bc-9019eb8a3409
24	24	0	Colombian Biodiversity Information System	7e865cba-7c46-417b-ade5-97f2cf5b7be0	b95c5c6e-f65f-49f8-944d-de4fcef25577
0	25692	25692	GBIF Benin	efb9c00e-f802-45dd-8826-a52ec45b89ff	bc5d60dd-d3ff-4928-81e2-8a08ae489f59
3	3	0	Plazi	ffb07bec-2d10-492d-9c37-361fe0b79427	bfc6faaf-9085-47f4-b80f-0cf69eb717d1
69	69	0	Plazi	ffb07bec-2d10-492d-9c37-361fe0b79427	c10aadc6-075e-4252-9623-ac4aad97f00f
51	51	0	GBIF Germany	4f6826f2-4ff6-443d-b966-e6913bd24013	c27673c0-edbf-4861-84fd-77ebfa824470
0	222	222	Plazi	ffb07bec-2d10-492d-9c37-361fe0b79427	c285848a-ccaf-4f48-8e05-7f9cf6acf225
3137	3137	0	National Biodiversity Network	d897a5b9-35ee-4232-94bd-b0bcaac003c2	c3b4e306-d132-4d84-87c1-676cfa47d048
9762	10054	292	GBIF Brazil	cdc9736d-5ff7-4ece-9959-3c744360cdb3	c3cf0200-8818-40cc-bec3-039aad7625c6
3	3	0	Plazi	ffb07bec-2d10-492d-9c37-361fe0b79427	c979b947-9452-4bad-9b60-4d46f84cf853
1419	516	-903	GBIF Germany	4f6826f2-4ff6-443d-b966-e6913bd24013	ca3823cf-955b-47db-9a20-ddc5461448be
539	539	0	Participant Node Managers Committee	7f48e0c8-5c96-49ec-b972-30748e339115	cc2322e2-1a56-4ca3-9d4f-4eee808a1707
0	101203	101203	U.S. Geological Survey	8618c64a-93e0-4300-b546-7249e5148ed2	cc63e998-fe1b-468d-94f1-6afcf494d0e4
597	597	0	Colombian Biodiversity Information System	7e865cba-7c46-417b-ade5-97f2cf5b7be0	d1ce1658-ae7d-446f-99ee-5532d72a02d0
200	200	0	Plazi	ffb07bec-2d10-492d-9c37-361fe0b79427	d2251320-5eef-450d-9703-2d2004e4962b
1222	1222	0	Ocean Biodiversity Information System	ba0670b9-4186-41e6-8e70-f9cb3065551a	d3bb4a63-7277-482c-b1e3-413301720130
4095815	4183277	87462	U.S. Geological Survey	8618c64a-93e0-4300-b546-7249e5148ed2	d415c253-4d61-4459-9d25-4015b9084fb0
3062	3062	0	U.S. Geological Survey	8618c64a-93e0-4300-b546-7249e5148ed2	d6bb34f9-9233-47a1-b109-703c5e274524
3652	3652	0	GBIF Brazil	cdc9736d-5ff7-4ece-9959-3c744360cdb3	d83f8cf4-e174-4f1c-88be-135129d172ba
2444	2444	0	Participant Node Managers Committee	7f48e0c8-5c96-49ec-b972-30748e339115	d9bf2980-8230-4681-9929-dff323aefb58
19	19	0	Plazi	ffb07bec-2d10-492d-9c37-361fe0b79427	da9a5786-f24b-4ca9-a29f-38f0dc3d16ac
127	127	0	Plazi	ffb07bec-2d10-492d-9c37-361fe0b79427	dba66954-1ee1-405d-98d8-4f5eab37a816
9964	9964	0	GBIF Japan	db5705aa-6a6e-42f1-8942-d77b9f4896ea	dcfed86f-a8fe-4219-8f1a-e6a5d9086163
3782	3782	0	National Biodiversity Network	d897a5b9-35ee-4232-94bd-b0bcaac003c2	ddd19157-e22b-4ec9-8e35-6ae2366615a2
23	23	0	Plazi	ffb07bec-2d10-492d-9c37-361fe0b79427	df5ede9f-f7a7-4521-990a-630e08ab7480
29912	29912	0	GBIF France	da44cd31-5901-4687-a106-6d1c7734ee3a	e0524897-c6ff-4dfd-a9f8-398d49590e0a
50682	50682	0	Bioversity International	b8a5be24-9225-4ba5-b664-159308a4b537	e17d9bdc-dc88-401a-bb10-6ef560448480
116640	121733	5093	U.S. Geological Survey	8618c64a-93e0-4300-b546-7249e5148ed2	e36d0997-2f51-4718-b684-16ec092ecd82
0	4	4	Plazi	ffb07bec-2d10-492d-9c37-361fe0b79427	e4df466f-dcdb-4552-8dba-b80338e9a3ea
9373	6695	-2678	GBIF Germany	4f6826f2-4ff6-443d-b966-e6913bd24013	e4ffd426-b065-42b0-916b-bfc2803497f1
3	3	0	Plazi	ffb07bec-2d10-492d-9c37-361fe0b79427	efdb8601-d17e-4bfa-a6d6-bc79575a5d08
0	282219	282219	Canada Biodiversity Information Facility	8f83fc96-c966-4126-83f7-bf044dc49efa	f2189339-9098-4e0e-98d4-9c72e5e5f96d
1	1	0	Plazi	ffb07bec-2d10-492d-9c37-361fe0b79427	f37f98ce-6c5a-4047-941c-a37ba64d1421
407	407	0	Plazi	ffb07bec-2d10-492d-9c37-361fe0b79427	f4033cfe-28b4-434e-a577-bf51193b4df6
2	2	0	Plazi	ffb07bec-2d10-492d-9c37-361fe0b79427	f4429aa8-bc11-41df-bfcc-a01551dfc2d6
0	2572	2572	National Biodiversity Network	d897a5b9-35ee-4232-94bd-b0bcaac003c2	f47f6839-9203-44ee-87f6-7ad047d8430d
518	518	0	Albertine Rift Conservation Society	90a939d3-e99c-4f6d-915f-2616423b3735	f5887278-1493-4ea0-91f6-49d4cbbf5ac7
0	22	22	Plazi	ffb07bec-2d10-492d-9c37-361fe0b79427	f77b3def-1597-45b6-9230-6ce91533f804
2508	2508	0	GBIF Germany	4f6826f2-4ff6-443d-b966-e6913bd24013	f88c8b74-fa35-4f82-bedd-6b6901f4ec36
77	77	0	Belgian Biodiversity Platform	fb11cfe1-ebc3-45af-9159-17d9fddbcdac	f9e195c8-4f0a-4a88-a00e-23db76ef8a1c
23	23	0	Plazi	ffb07bec-2d10-492d-9c37-361fe0b79427	fb13a5e8-08b2-4add-9455-79c2fc1b42bc
3917	3917	0	Participant Node Managers Committee	7f48e0c8-5c96-49ec-b972-30748e339115	fc8a216d-4467-449f-b0c6-84cd905deb6e
24810	24810	0	GBIF France	da44cd31-5901-4687-a106-6d1c7734ee3a	fcce992c-9621-4fb0-9863-2e7eae858ae8
41	41	0	Plazi	ffb07bec-2d10-492d-9c37-361fe0b79427	ff6435ca-1b33-499a-9f10-549fdff776c5
0	12	12	Plazi	ffb07bec-2d10-492d-9c37-361fe0b79427	ffe57499-723a-4ade-a574-215e0e1f8742
5	5	0	Plazi	ffb07bec-2d10-492d-9c37-361fe0b79427	018faaa2-b554-49b9-a832-10294159c715
419	447	28	National Biodiversity Network	d897a5b9-35ee-4232-94bd-b0bcaac003c2	02b3bdaa-07dc-45b3-a761-7580d4bdcdb4
18541	18541	0	Colombian Biodiversity Information System	7e865cba-7c46-417b-ade5-97f2cf5b7be0	047e1bb6-38a3-4d86-a1e3-c9b691805155
713	713	0	GBIF Germany	4f6826f2-4ff6-443d-b966-e6913bd24013	04b0e77b-6bf9-4e50-b309-08d27822b7f1
1	1	0	Plazi	ffb07bec-2d10-492d-9c37-361fe0b79427	08b92fdc-9bba-469a-8382-0d7f0fb89bb7
3200	3200	0	Colombian Biodiversity Information System	7e865cba-7c46-417b-ade5-97f2cf5b7be0	0ad11c37-02d3-46d1-b5bb-3f5d2a65a65d
0	10	10	Plazi	ffb07bec-2d10-492d-9c37-361fe0b79427	0bf9cf31-d66e-4ecd-8cfe-e21f5a9d71f4
2	2	0	Plazi	ffb07bec-2d10-492d-9c37-361fe0b79427	0d9551cf-4f90-4dd9-bc5a-7ba63cd73d33
22	22	0	Plazi	ffb07bec-2d10-492d-9c37-361fe0b79427	0de36645-90d1-4bcb-bb46-3b84c1de037e
0	6	6	Plazi	ffb07bec-2d10-492d-9c37-361fe0b79427	0e0c3943-1eaf-4b2a-87d4-e52581550140
2	2	0	National Biodiversity Network	d897a5b9-35ee-4232-94bd-b0bcaac003c2	13930f68-a676-49bf-8787-fd875b34800d
85	85	0	GBIF France	da44cd31-5901-4687-a106-6d1c7734ee3a	17441b96-eeb1-4624-a912-a71f53af0a1e
0	25691	25691	BioCASE	d8bbf693-a180-4995-94fe-6130795dcf2f	188fcdd5-c16d-4f09-9f76-fed7193ce3ab
1777	1777	0	National Biodiversity Network	d897a5b9-35ee-4232-94bd-b0bcaac003c2	18d357a9-ffd9-4ab4-b453-9945817954bc
341	341	0	Colombian Biodiversity Information System	7e865cba-7c46-417b-ade5-97f2cf5b7be0	1938f3c5-e377-42bd-85b8-888ac0394dea
996	996	0	GBIF France	da44cd31-5901-4687-a106-6d1c7734ee3a	1989e1ee-4a2b-4d18-9dee-e2b765cfdd32
186	186	0	GBIF France	da44cd31-5901-4687-a106-6d1c7734ee3a	1cf5cd3d-788d-4704-82ad-08848e10a18b
1651	1651	0	GBIF Germany	4f6826f2-4ff6-443d-b966-e6913bd24013	1de4d9a0-7430-44ad-8367-cc0298906ad8
57	57	0	GBIF Germany	4f6826f2-4ff6-443d-b966-e6913bd24013	1e2c1514-25da-46dc-9a0d-a5005b34a06f
1	1	0	Plazi	ffb07bec-2d10-492d-9c37-361fe0b79427	1fa3e048-6e17-4084-926c-3c77dabfffc9
0	1842	1842	Ocean Biodiversity Information System	ba0670b9-4186-41e6-8e70-f9cb3065551a	211e36d9-0f59-4a7f-ab7e-683748e97e71
213	213	0	Ocean Biodiversity Information System	ba0670b9-4186-41e6-8e70-f9cb3065551a	2364d136-c8d2-4857-829f-018d23066082
64	64	0	Plazi	ffb07bec-2d10-492d-9c37-361fe0b79427	250c58c3-22d9-4da3-a75b-35d77afd4105
30	30	0	GBIF France	da44cd31-5901-4687-a106-6d1c7734ee3a	2570e45c-63e9-4a6d-a552-4b0bbff1da7b
3	3	0	National Biodiversity Network	d897a5b9-35ee-4232-94bd-b0bcaac003c2	2740900c-ec29-456a-934c-9f9abc55568f
0	128	128	Ocean Biodiversity Information System	ba0670b9-4186-41e6-8e70-f9cb3065551a	281e7575-de2a-406d-ab93-39a59a863ebf
6	6	0	Plazi	ffb07bec-2d10-492d-9c37-361fe0b79427	28e681c4-4f53-4780-ad09-6a7b3b1b60f1
1548	1947	399	National Biodiversity Network	d897a5b9-35ee-4232-94bd-b0bcaac003c2	2b3a8ad6-c040-4105-9eae-cfdf0003cf88
70	70	0	GBIF France	da44cd31-5901-4687-a106-6d1c7734ee3a	2bbd67a9-a347-42e2-b310-df366ffbd30a
0	3	3	Plazi	ffb07bec-2d10-492d-9c37-361fe0b79427	2beffdbf-ef4c-4992-b131-97fba3dd3a8f
1	1	0	Plazi	ffb07bec-2d10-492d-9c37-361fe0b79427	2ca67c74-d7a0-419b-a093-fdab5c06e97a
223486	223486	0	GBIF France	da44cd31-5901-4687-a106-6d1c7734ee3a	2d680d46-d783-4ea7-94b1-2556cd653e36
294	294	0	Colombian Biodiversity Information System	7e865cba-7c46-417b-ade5-97f2cf5b7be0	2db2d1b2-bccc-4c6b-ba35-fc5af9676e76
135998	154833	18835	National Biodiversity Network	d897a5b9-35ee-4232-94bd-b0bcaac003c2	2e3454ce-5b2d-4bf4-bc23-ca5769f58137
2807	2807	0	Atlas of Living Australia	4a6f1b71-969e-4fc5-a693-282b05e1220c	2f5fa57d-1fae-444c-9669-258b7fb918b4
26	26	0	GBIF Germany	4f6826f2-4ff6-443d-b966-e6913bd24013	3a8cfbd8-0e00-4d03-8916-a20e3c162039
661	661	0	Korean Biodiversity Information Facility	e0a1e772-0177-4800-94b4-2d023fe6cdf4	3c56f66d-d47e-43cd-b51d-180f21c619ae
1	1	0	Plazi	ffb07bec-2d10-492d-9c37-361fe0b79427	3cbc5830-b5eb-48c5-ab06-b6af21676fc4
0	732	732	Participant Node Managers Committee	7f48e0c8-5c96-49ec-b972-30748e339115	3de42107-8d0d-416b-ae02-0f0ca038b944
0	1	1	Plazi	ffb07bec-2d10-492d-9c37-361fe0b79427	3e2d862d-2e56-446b-9473-e359a2681f26
0	3	3	Plazi	ffb07bec-2d10-492d-9c37-361fe0b79427	3fbe5fc3-fc17-4b37-b582-647687536e60
238	238	0	Biodiversity Information System of Mexico	b324e8e9-9a4c-44fa-8f1a-7f39ea7ab576	453e9cb5-87e3-4449-a6f0-e9329d6331ea
2	2	0	Plazi	ffb07bec-2d10-492d-9c37-361fe0b79427	45baa47f-f6a0-4a0d-afc3-476b4489b5b5
52	52	0	GBIF Malawi	2a42e4d7-ad4a-41b3-84c4-de4aa7b74d35	46d4f1b8-52fd-478e-aad0-43a933994b61
577	577	0	Plazi	ffb07bec-2d10-492d-9c37-361fe0b79427	4880ad2b-42d6-419d-b115-ecd2f777eea5
211	211	0	GBIF France	da44cd31-5901-4687-a106-6d1c7734ee3a	48939578-9f0f-4a2c-b9d5-e78252fd22ed
0	9	9	Plazi	ffb07bec-2d10-492d-9c37-361fe0b79427	4a28670f-4b90-43a3-a326-5806dbc68563
1017	1017	0	National Biodiversity Network	d897a5b9-35ee-4232-94bd-b0bcaac003c2	4cb30996-cc6a-44b9-b0c6-fce6f109d41f
12	12	0	Plazi	ffb07bec-2d10-492d-9c37-361fe0b79427	5409eeca-e7db-49eb-aa23-6109d273efb4
57928	57928	0	Netherlands Biodiversity Information Facility	0909d601-bda2-42df-9e63-a6d51847ebce	562cf940-6166-11de-84bf-b8a03c50a862
1	1	0	GBIF France	da44cd31-5901-4687-a106-6d1c7734ee3a	588cacee-ef20-415f-aadd-8471626a26e9
3	3	0	Plazi	ffb07bec-2d10-492d-9c37-361fe0b79427	58efa18a-128f-4c5d-897f-99e5c13b660e
3712	3712	0	GBIF Argentina	2426a871-9feb-40a1-96c6-0c593a76b835	595ef834-9352-4d5c-9108-7b6e652f8d19
537	537	0	GBIF France	da44cd31-5901-4687-a106-6d1c7734ee3a	59d46416-34e8-4da6-8d6f-1e3fc7b1b88b
66	66	0	Plazi	ffb07bec-2d10-492d-9c37-361fe0b79427	5a9a5eda-7a2b-43aa-8e8d-40ef25926ec6
10234	10234	0	GBIF France	da44cd31-5901-4687-a106-6d1c7734ee3a	5e783e97-1408-4ea4-9c40-5e39cb9043d3
4702	4702	0	National Biodiversity Network	d897a5b9-35ee-4232-94bd-b0bcaac003c2	5ec079d4-af28-4a9a-98df-8bf8f6baf497
32	32	0	Ocean Biodiversity Information System	ba0670b9-4186-41e6-8e70-f9cb3065551a	5ee1c1e0-52d4-4e96-8421-2128966f6d9f
10	10	0	Plazi	ffb07bec-2d10-492d-9c37-361fe0b79427	60a82b44-0e75-4eac-b8bd-418391013567
22	22	0	GBIF Germany	4f6826f2-4ff6-443d-b966-e6913bd24013	6197ea48-f762-11e1-a439-00145eb45e9a
0	1	1	Plazi	ffb07bec-2d10-492d-9c37-361fe0b79427	61b3f9fe-4cf5-441f-8d25-3d8af7a4b3eb
441	441	0	Colombian Biodiversity Information System	7e865cba-7c46-417b-ade5-97f2cf5b7be0	6273615c-2147-45be-a9c8-35328a707b3c
13	13	0	GBIF Germany	4f6826f2-4ff6-443d-b966-e6913bd24013	62c1af1c-f762-11e1-a439-00145eb45e9a
29	29	0	GBIF Germany	4f6826f2-4ff6-443d-b966-e6913bd24013	62dd9ace-f762-11e1-a439-00145eb45e9a
8	8	0	GBIF Germany	4f6826f2-4ff6-443d-b966-e6913bd24013	630c3c9e-f762-11e1-a439-00145eb45e9a
3216	3216	0	GBIF Kenya	2a44d626-9f7a-4120-8a7a-4ab5ac15ff2a	63cccd67-894b-4901-aed2-8c05ad4ba390
104	104	0	GBIF Germany	4f6826f2-4ff6-443d-b966-e6913bd24013	63d6c5b8-f762-11e1-a439-00145eb45e9a
3	3	0	Plazi	ffb07bec-2d10-492d-9c37-361fe0b79427	63da8126-59a4-44b0-8b73-a3406e51d53f
85	85	0	GBIF Germany	4f6826f2-4ff6-443d-b966-e6913bd24013	642b40f2-f762-11e1-a439-00145eb45e9a
0	2	2	Plazi	ffb07bec-2d10-492d-9c37-361fe0b79427	64acea26-7e13-44f4-906a-c723ec908b22
35	32	-3	GBIF Germany	4f6826f2-4ff6-443d-b966-e6913bd24013	64eb61ac-f762-11e1-a439-00145eb45e9a
9	9	0	GBIF France	da44cd31-5901-4687-a106-6d1c7734ee3a	6504a9f4-ea40-466b-9f58-616fee78893f
0	3635	3635	Ocean Biodiversity Information System	ba0670b9-4186-41e6-8e70-f9cb3065551a	6551a4f8-2034-4c13-bac9-f66a2de02ded
125	122	-3	GBIF Germany	4f6826f2-4ff6-443d-b966-e6913bd24013	65e07a7a-f762-11e1-a439-00145eb45e9a
11	11	0	GBIF Germany	4f6826f2-4ff6-443d-b966-e6913bd24013	66719564-f762-11e1-a439-00145eb45e9a
0	310	310	Colombian Biodiversity Information System	7e865cba-7c46-417b-ade5-97f2cf5b7be0	67e0bb75-1cc1-47d9-bcf2-813dc982a889
73	73	0	GBIF Germany	4f6826f2-4ff6-443d-b966-e6913bd24013	6805398a-f762-11e1-a439-00145eb45e9a
96	96	0	GBIF Germany	4f6826f2-4ff6-443d-b966-e6913bd24013	68a35be2-f762-11e1-a439-00145eb45e9a
24	24	0	GBIF Germany	4f6826f2-4ff6-443d-b966-e6913bd24013	6932c44e-f762-11e1-a439-00145eb45e9a
673	673	0	GBIF Germany	4f6826f2-4ff6-443d-b966-e6913bd24013	696bc62c-f762-11e1-a439-00145eb45e9a
105	105	0	GBIF Germany	4f6826f2-4ff6-443d-b966-e6913bd24013	6986fbae-f762-11e1-a439-00145eb45e9a
108	108	0	GBIF Germany	4f6826f2-4ff6-443d-b966-e6913bd24013	6aa1598a-f762-11e1-a439-00145eb45e9a
6	6	0	GBIF Germany	4f6826f2-4ff6-443d-b966-e6913bd24013	6b6601d6-f762-11e1-a439-00145eb45e9a
0	36	36	Plazi	ffb07bec-2d10-492d-9c37-361fe0b79427	6df093be-7006-4210-a447-bb47a84a7907
40	40	0	Plazi	ffb07bec-2d10-492d-9c37-361fe0b79427	6dfdec5c-2e9d-4e1f-be4c-a120edc779e0
24	24	0	Plazi	ffb07bec-2d10-492d-9c37-361fe0b79427	70488f4e-090b-4d3b-89d9-388bf5513818
61	61	0	GBIF France	da44cd31-5901-4687-a106-6d1c7734ee3a	7072e1e6-cd85-41a1-aeb8-e459cd1d310a
1658	1447	-211	GBIF Germany	4f6826f2-4ff6-443d-b966-e6913bd24013	7094c1e2-f762-11e1-a439-00145eb45e9a
0	3	3	Plazi	ffb07bec-2d10-492d-9c37-361fe0b79427	718a669e-13b9-415b-955a-88d38a19923c
511	511	0	GBIF Germany	4f6826f2-4ff6-443d-b966-e6913bd24013	72030714-f762-11e1-a439-00145eb45e9a
5	4	-1	GBIF Germany	4f6826f2-4ff6-443d-b966-e6913bd24013	7348201e-f762-11e1-a439-00145eb45e9a
8	8	0	Plazi	ffb07bec-2d10-492d-9c37-361fe0b79427	73612697-7a06-47e1-b660-e24b67307e90
49	49	0	GBIF Germany	4f6826f2-4ff6-443d-b966-e6913bd24013	73d15adc-f762-11e1-a439-00145eb45e9a
190	190	0	GBIF Germany	4f6826f2-4ff6-443d-b966-e6913bd24013	74915328-f762-11e1-a439-00145eb45e9a
8898	8898	0	GBIF Germany	4f6826f2-4ff6-443d-b966-e6913bd24013	74e8e097-3104-4ffa-9982-078e0cd5f9a2
24	24	0	GBIF Germany	4f6826f2-4ff6-443d-b966-e6913bd24013	750c00b0-ff76-4a19-836c-294fdc9a8497
263	263	0	GBIF Germany	4f6826f2-4ff6-443d-b966-e6913bd24013	75cc1688-f762-11e1-a439-00145eb45e9a
26	26	0	GBIF France	da44cd31-5901-4687-a106-6d1c7734ee3a	75fdf1b6-7d9f-4cd3-97a4-c94003613cfe
1512	1512	0	GBIF Germany	4f6826f2-4ff6-443d-b966-e6913bd24013	7c48fdb4-f762-11e1-a439-00145eb45e9a
648	648	0	GBIF Germany	4f6826f2-4ff6-443d-b966-e6913bd24013	7d0b7d26-f762-11e1-a439-00145eb45e9a
247	78	-169	GBIF Germany	4f6826f2-4ff6-443d-b966-e6913bd24013	7d4c86d6-f762-11e1-a439-00145eb45e9a
190	190	0	GBIF Germany	4f6826f2-4ff6-443d-b966-e6913bd24013	7ef5469e-f762-11e1-a439-00145eb45e9a
0	78	78	Plazi	ffb07bec-2d10-492d-9c37-361fe0b79427	8012ecbf-5506-404d-82cc-28d2147b3180
841	841	0	Biodiversity Information System of Mexico	b324e8e9-9a4c-44fa-8f1a-7f39ea7ab576	801c8370-f762-11e1-a439-00145eb45e9a
45	45	0	GBIF Japan	db5705aa-6a6e-42f1-8942-d77b9f4896ea	80e91c3c-f762-11e1-a439-00145eb45e9a
312	312	0	GBIF Germany	4f6826f2-4ff6-443d-b966-e6913bd24013	822e592c-f762-11e1-a439-00145eb45e9a
1054	606	-448	GBIF Germany	4f6826f2-4ff6-443d-b966-e6913bd24013	824170c0-f762-11e1-a439-00145eb45e9a
8096	9318	1222	GBIF Spain	1f94b3ca-9345-4d65-afe2-4bace93aa0fe	83459d16-f762-11e1-a439-00145eb45e9a
24286	24286	0	Canada Biodiversity Information Facility	8f83fc96-c966-4126-83f7-bf044dc49efa	845cebe6-f762-11e1-a439-00145eb45e9a
3812	3812	0	National Biodiversity Network	d897a5b9-35ee-4232-94bd-b0bcaac003c2	849bc588-c0ec-4767-86be-48814d9dbcfd
3299	3299	0	DanBIF - Danish Biodiversity Information Facility	4ddd294f-02b7-4359-ac33-0806a9ca9c6b	84d94b5a-f762-11e1-a439-00145eb45e9a
1901	1901	0	BioNet-EASIANET	7f017f1c-d33e-480a-99ed-547ff9bf7abe	84dce260-f762-11e1-a439-00145eb45e9a
45	45	0	GBIF Germany	4f6826f2-4ff6-443d-b966-e6913bd24013	85ca1a94-f762-11e1-a439-00145eb45e9a
4172	4172	0	GBIF Spain	1f94b3ca-9345-4d65-afe2-4bace93aa0fe	8734b6f6-2bf5-439a-833e-0fd25201bcd7
1579	1579	0	Participant Node Managers Committee	7f48e0c8-5c96-49ec-b972-30748e339115	8795ab31-79ae-4a9c-b285-0b76e5c09b9e
29	29	0	GBIF Germany	4f6826f2-4ff6-443d-b966-e6913bd24013	89486c48-f762-11e1-a439-00145eb45e9a
95	95	0	GBIF Germany	4f6826f2-4ff6-443d-b966-e6913bd24013	89fed492-f762-11e1-a439-00145eb45e9a
10	10	0	GBIF Germany	4f6826f2-4ff6-443d-b966-e6913bd24013	8c113e46-f762-11e1-a439-00145eb45e9a
11	7	-4	GBIF Germany	4f6826f2-4ff6-443d-b966-e6913bd24013	8c5defac-f762-11e1-a439-00145eb45e9a
11	10	-1	GBIF Germany	4f6826f2-4ff6-443d-b966-e6913bd24013	8d01d220-f762-11e1-a439-00145eb45e9a
35	35	0	Plazi	ffb07bec-2d10-492d-9c37-361fe0b79427	90053b8a-0247-45b7-a47f-f5785ec36b68
647	546	-101	GBIF Germany	4f6826f2-4ff6-443d-b966-e6913bd24013	900b5dec-f762-11e1-a439-00145eb45e9a
260	143	-117	GBIF Germany	4f6826f2-4ff6-443d-b966-e6913bd24013	9071c140-f762-11e1-a439-00145eb45e9a
0	62	62	Plazi	ffb07bec-2d10-492d-9c37-361fe0b79427	9182a649-923b-4a69-bac0-d41873ded32e
2	1	-1	GBIF Germany	4f6826f2-4ff6-443d-b966-e6913bd24013	9197509e-f762-11e1-a439-00145eb45e9a
27	27	0	GBIF Germany	4f6826f2-4ff6-443d-b966-e6913bd24013	92156e84-f762-11e1-a439-00145eb45e9a
0	4	4	Plazi	ffb07bec-2d10-492d-9c37-361fe0b79427	923c89a5-1e10-46b8-9e7e-657a070cf14d
174	150	-24	GBIF Germany	4f6826f2-4ff6-443d-b966-e6913bd24013	92702d88-f762-11e1-a439-00145eb45e9a
129	129	0	GBIF Germany	4f6826f2-4ff6-443d-b966-e6913bd24013	92b30770-f762-11e1-a439-00145eb45e9a
28	28	0	GBIF Germany	4f6826f2-4ff6-443d-b966-e6913bd24013	93719bf4-f762-11e1-a439-00145eb45e9a
0	4	4	Participant Node Managers Committee	7f48e0c8-5c96-49ec-b972-30748e339115	93bc00a4-9ede-4f30-a6af-c5a6a0c66be3
4957	4447	-510	GBIF Germany	4f6826f2-4ff6-443d-b966-e6913bd24013	94e705f0-f762-11e1-a439-00145eb45e9a
6219	6219	0	GBIF France	da44cd31-5901-4687-a106-6d1c7734ee3a	953634da-13fa-4faa-b302-89f1bf56e61e
13628	13628	0	Atlas of Living Australia	4a6f1b71-969e-4fc5-a693-282b05e1220c	95ddbdfa-f762-11e1-a439-00145eb45e9a
58	58	0	GBIF Germany	4f6826f2-4ff6-443d-b966-e6913bd24013	9679759c-f762-11e1-a439-00145eb45e9a
35	35	0	GBIF France	da44cd31-5901-4687-a106-6d1c7734ee3a	97e29243-d1ee-401c-bcf4-8409619ba9fe
15004	15004	0	U.S. Geological Survey	8618c64a-93e0-4300-b546-7249e5148ed2	9ce52ff6-01b6-44a2-b617-9bc2ee8e8cd1
0	56	56	Colombian Biodiversity Information System	7e865cba-7c46-417b-ade5-97f2cf5b7be0	9d4cb09a-bf7e-4799-9367-2f7e0b9129a9
0	17	17	Plazi	ffb07bec-2d10-492d-9c37-361fe0b79427	9de32fb5-ae5c-4552-afdb-9cfdcad56ce9
7	7	0	Plazi	ffb07bec-2d10-492d-9c37-361fe0b79427	a2b4112f-6381-415c-ba31-1d3fd740247b
0	408	408	Ocean Biodiversity Information System	ba0670b9-4186-41e6-8e70-f9cb3065551a	a355f5b8-8904-4ef0-9e73-a5b2bb7d70b6
2	2	0	Plazi	ffb07bec-2d10-492d-9c37-361fe0b79427	a3c1d3c8-0d88-4727-bdf9-165fce8cea99
47547	48411	864	Netherlands Biodiversity Information Facility	0909d601-bda2-42df-9e63-a6d51847ebce	a4be4c6d-5ce7-47ba-982d-1deb05719133
184252	184252	0	Atlas of Living Australia	4a6f1b71-969e-4fc5-a693-282b05e1220c	a57985ac-a9af-4ccb-803c-f5b803af0318
182	182	0	Plazi	ffb07bec-2d10-492d-9c37-361fe0b79427	a63613b4-e611-42e8-89cd-2d3aae126759
560	560	0	GBIF Germany	4f6826f2-4ff6-443d-b966-e6913bd24013	a660f3a9-e9a9-4e9a-800a-0c1460f8b479
0	4	4	Plazi	ffb07bec-2d10-492d-9c37-361fe0b79427	a91ccd27-7815-42a7-98c7-f39ea52878d6
8	8	0	Plazi	ffb07bec-2d10-492d-9c37-361fe0b79427	aaeff7f4-9d74-4834-ad84-54045b3ab444
34974	34974	0	GBIF France	da44cd31-5901-4687-a106-6d1c7734ee3a	ab3441d1-6e2c-4e39-b2c4-fabf017b45ed
24	24	0	Plazi	ffb07bec-2d10-492d-9c37-361fe0b79427	ab917453-d6be-4c48-89a0-d3876eab96d0
0	10	10	National Biodiversity Network	d897a5b9-35ee-4232-94bd-b0bcaac003c2	abf93ebb-74fa-4f6b-9aba-39bbca9827b5
4	4	0	Plazi	ffb07bec-2d10-492d-9c37-361fe0b79427	ac33ef8c-170d-42b7-83ca-a04b050c980f
0	442	442	Ocean Biodiversity Information System	ba0670b9-4186-41e6-8e70-f9cb3065551a	aceaa4ff-38e7-42cc-a51e-eb109a2d772a
11	11	0	Plazi	ffb07bec-2d10-492d-9c37-361fe0b79427	addd4996-da5d-43d6-bac8-7d031f9234b7
0	590	590	Plazi	ffb07bec-2d10-492d-9c37-361fe0b79427	aff164bb-7a9c-48f5-b7a9-3f4545670f40
1990	1990	0	National Biodiversity Data Centre	422b00b2-6c94-4bb6-976b-c359916efdb8	b22bebf8-8b6b-4a45-949a-e0cc70d4ccd7
15	15	0	Plazi	ffb07bec-2d10-492d-9c37-361fe0b79427	b44266be-2443-4676-abd8-015e1e069156
0	330	330	Colombian Biodiversity Information System	7e865cba-7c46-417b-ade5-97f2cf5b7be0	b887f035-fe85-45e5-9970-e777de3aa0ad
1889	1889	0	Biodiversity Information System of Mexico	b324e8e9-9a4c-44fa-8f1a-7f39ea7ab576	b8e944b9-be01-424b-a557-d40d06a39ae8
7171	7171	0	GBIF France	da44cd31-5901-4687-a106-6d1c7734ee3a	b965f043-6468-481e-9191-dd29c1272158
0	11	11	Participant Node Managers Committee	7f48e0c8-5c96-49ec-b972-30748e339115	ba4a81a6-73d0-43ae-9c1b-4dd14718e9fc
443718	465573	21855	National Biodiversity Network	d897a5b9-35ee-4232-94bd-b0bcaac003c2	bba60198-3eb5-4101-954d-3e2c87df4b73
0	10	10	Plazi	ffb07bec-2d10-492d-9c37-361fe0b79427	bbaf4abe-dd19-4279-98ac-e89b2d9c0e95
53	53	0	Plazi	ffb07bec-2d10-492d-9c37-361fe0b79427	bce2b355-5cd6-426c-a738-0d0000626895
3	3	0	Plazi	ffb07bec-2d10-492d-9c37-361fe0b79427	bf41b1c2-9140-4b00-b714-91e70fff39b4
716	716	0	Colombian Biodiversity Information System	7e865cba-7c46-417b-ade5-97f2cf5b7be0	c205039c-8f06-4829-ae55-2e80e9698ffd
4264	5865	1601	Biodiversity Information System of Mexico	b324e8e9-9a4c-44fa-8f1a-7f39ea7ab576	c734c754-bfe1-4fc7-8a6f-003eca60ffd9
5279	5279	0	U.S. Geological Survey	8618c64a-93e0-4300-b546-7249e5148ed2	ce2eee4e-7f64-4042-a3af-9bcae68dfeda
0	336	336	Plazi	ffb07bec-2d10-492d-9c37-361fe0b79427	d11ec2cc-abb5-4f16-9791-5feedfb4da8c
365	374	9	National Biodiversity Network	d897a5b9-35ee-4232-94bd-b0bcaac003c2	d1d43406-4711-4ed9-a827-38f7b26311ab
1407	1407	0	National Biodiversity Network	d897a5b9-35ee-4232-94bd-b0bcaac003c2	d2910e04-b248-455c-a77e-25f78d2938ab
688	688	0	U.S. Geological Survey	8618c64a-93e0-4300-b546-7249e5148ed2	d433c1e8-c5d7-4c0a-90f8-a0cb3c4faa8b
0	5	5	Plazi	ffb07bec-2d10-492d-9c37-361fe0b79427	d5da1195-742b-41e0-afa8-16814156d6ac
0	51	51	Plazi	ffb07bec-2d10-492d-9c37-361fe0b79427	d7823132-4519-4d6d-b9fb-8031de1b7757
355	355	0	Colombian Biodiversity Information System	7e865cba-7c46-417b-ade5-97f2cf5b7be0	dcdef02e-c93c-4a63-98d3-8f72c5563c0a
7	7	0	Plazi	ffb07bec-2d10-492d-9c37-361fe0b79427	dfb77857-812f-454f-9a70-18f9e3552267
14142	14142	0	U.S. Geological Survey	8618c64a-93e0-4300-b546-7249e5148ed2	e457257e-fa64-4d64-87b1-8876efacd00c
1094	1094	0	Biodiversity Information System of Mexico	b324e8e9-9a4c-44fa-8f1a-7f39ea7ab576	e46233d2-1baf-4aea-9bf7-a2f01c7cc7b0
0	64	64	Participant Node Managers Committee	7f48e0c8-5c96-49ec-b972-30748e339115	e52aacbf-c701-462b-b68f-346502fbc270
0	9	9	Plazi	ffb07bec-2d10-492d-9c37-361fe0b79427	e80cf6ad-d7b3-48a3-9527-5c3e2c4cd83c
0	4	4	Plazi	ffb07bec-2d10-492d-9c37-361fe0b79427	ea90907a-4be6-4ab5-964b-86c1d7975e58
1	1	0	Plazi	ffb07bec-2d10-492d-9c37-361fe0b79427	ebb03d23-8864-4337-b1bf-7f593f687628
0	4	4	Plazi	ffb07bec-2d10-492d-9c37-361fe0b79427	ebbdb3a5-8b13-45db-936a-57c3868e18b7
2	2	0	Plazi	ffb07bec-2d10-492d-9c37-361fe0b79427	ebeabcc6-7268-4e3a-ba18-0bf21f183023
335	335	0	Indonesian Biodiversity Information Facility	2ebd91f6-f14f-4375-b525-c011a3774f03	ed6df385-67ec-4872-ad25-e6e76ca2dcb1
51	51	0	Plazi	ffb07bec-2d10-492d-9c37-361fe0b79427	eee17be5-c4f7-4e12-b9c7-cdf61fd1289b
1046	1046	0	National Biodiversity Network	d897a5b9-35ee-4232-94bd-b0bcaac003c2	ef7d5385-613c-4b3e-905d-e54b67fd36b3
460	460	0	Colombian Biodiversity Information System	7e865cba-7c46-417b-ade5-97f2cf5b7be0	f2de1e78-5d1a-45f0-8879-02a9d94cfe64
7	7	0	Plazi	ffb07bec-2d10-492d-9c37-361fe0b79427	f33668f0-a019-4bcb-ab8b-06d6b8323963
441	441	0	National Biodiversity Network	d897a5b9-35ee-4232-94bd-b0bcaac003c2	f64a523f-1fcf-4d90-bc7f-d36577ea2335
0	6	6	Plazi	ffb07bec-2d10-492d-9c37-361fe0b79427	f80a0e1a-811b-44a1-9929-574b79cfcb95
0	51	51	Ocean Biodiversity Information System	ba0670b9-4186-41e6-8e70-f9cb3065551a	f895d6a5-1132-41db-bc6b-c635ec9a66b4
299	299	0	Participant Node Managers Committee	7f48e0c8-5c96-49ec-b972-30748e339115	f8adda58-4001-4acd-b04c-a416b0c0c4b0
230	230	0	GBIF France	da44cd31-5901-4687-a106-6d1c7734ee3a	fa59b787-f93e-480d-9e85-bbd638ac4d0f
23238	23226	-12	Biodiversity Information System of Mexico	b324e8e9-9a4c-44fa-8f1a-7f39ea7ab576	fcbd4fa6-6e2b-4715-b896-cf117691625d
52564	52564	0	Polish Biodiversity Information Network	2618bfdf-e194-4911-a241-80db3107bc51	ff03d870-9168-11db-9f6c-b8a03c50a862
26952	30344	3392	GBIF Brazil	cdc9736d-5ff7-4ece-9959-3c744360cdb3	ffb63b32-306e-415c-87a3-34c60d157a2a
1	1	0	Plazi	ffb07bec-2d10-492d-9c37-361fe0b79427	0382a784-983c-484d-b72e-fcac3044942c
8332	8332	0	National Biodiversity Network	d897a5b9-35ee-4232-94bd-b0bcaac003c2	03e65043-bb3d-4234-9a9c-ec13da707d9a
6433	6433	0	GBIF France	da44cd31-5901-4687-a106-6d1c7734ee3a	05b22baa-5b85-4212-a93a-2fe81f5254dd
1	1	0	Plazi	ffb07bec-2d10-492d-9c37-361fe0b79427	0612088b-e1ca-4f44-9915-a1745fa2e920
3	3	0	Plazi	ffb07bec-2d10-492d-9c37-361fe0b79427	066cd47e-c6b0-456c-9715-a2713222b973
0	172	172	GBIF Norway	4f829580-180d-46a9-9c87-ed8ec959b545	09e310a9-52d2-4a5b-8c1c-043fe67bdbbf
5	5	0	Plazi	ffb07bec-2d10-492d-9c37-361fe0b79427	0ab8c63b-d9b7-4420-be6e-5455d244e74a
0	12	12	Plazi	ffb07bec-2d10-492d-9c37-361fe0b79427	0b136600-8384-4130-8c2e-94c6678f3dd2
1289	1289	0	National Biodiversity Network	d897a5b9-35ee-4232-94bd-b0bcaac003c2	0c9ced4b-7a69-40ad-b0f8-1de27ffb572a
108	108	0	Colombian Biodiversity Information System	7e865cba-7c46-417b-ade5-97f2cf5b7be0	0e54b436-0dd0-4d4b-932d-4093506cf5ad
0	505	505	Ocean Biodiversity Information System	ba0670b9-4186-41e6-8e70-f9cb3065551a	0f1784e3-b4b2-4022-89f4-73bc94dd1832
1526	1526	0	National Biodiversity Network	d897a5b9-35ee-4232-94bd-b0bcaac003c2	0f5c302d-099c-4ac6-a91c-a8c97ca6b8f3
2534	2534	0	GBIF Benin	efb9c00e-f802-45dd-8826-a52ec45b89ff	1169a8a4-3f47-468a-8666-f0c3c8b383a2
11	11	0	GBIF Finland	dd514216-5c7c-45f3-910d-797424cb5be6	11e9ef77-3328-4d5f-985d-4a6d30b307b8
10910	10910	0	GBIF Spain	1f94b3ca-9345-4d65-afe2-4bace93aa0fe	12dcaf31-c582-4c58-aefd-a8821ab7eb46
0	7	7	Plazi	ffb07bec-2d10-492d-9c37-361fe0b79427	1301c5d5-c84b-441f-a7d5-ab01a02e119b
2	2	0	Plazi	ffb07bec-2d10-492d-9c37-361fe0b79427	13728d81-e938-425e-b951-094320ee4e9f
28934	28934	0	U.S. Geological Survey	8618c64a-93e0-4300-b546-7249e5148ed2	1510ce8d-3184-48db-bc38-592328868181
3	3	0	Plazi	ffb07bec-2d10-492d-9c37-361fe0b79427	16caed36-66c5-4aef-bd68-1d579175a254
6817	6817	0	Biodiversity Information System of Mexico	b324e8e9-9a4c-44fa-8f1a-7f39ea7ab576	173752b8-8da3-433e-b757-2ad48a971225
6	6	0	Plazi	ffb07bec-2d10-492d-9c37-361fe0b79427	1a9205b6-b1c8-4f35-814f-15df27982b4c
3851	3887	36	GBIF Brazil	cdc9736d-5ff7-4ece-9959-3c744360cdb3	2177d641-eeca-41c0-b6ab-0f1b2dcd9a79
3	3	0	Plazi	ffb07bec-2d10-492d-9c37-361fe0b79427	22050756-a0a0-4d70-8fe4-68db6e24a9a4
2	2	0	Plazi	ffb07bec-2d10-492d-9c37-361fe0b79427	22453698-e0bd-47ab-a0d5-b20de618a048
187	187	0	Participant Node Managers Committee	7f48e0c8-5c96-49ec-b972-30748e339115	24a25949-4531-428d-885d-ae402177440c
19	19	0	Plazi	ffb07bec-2d10-492d-9c37-361fe0b79427	286b29e4-4dce-4f68-b57a-9479c0764190
119366	119366	0	Taiwan Biodiversity Information Facility	e1b85abc-61f9-430f-ba79-6813dec53a0f	29d56be4-2b76-4a05-887d-633a3c6a9a83
106	106	0	Colombian Biodiversity Information System	7e865cba-7c46-417b-ade5-97f2cf5b7be0	2a5ffdff-7c1b-4a3d-a201-59ac0c99aab5
71	71	0	Plazi	ffb07bec-2d10-492d-9c37-361fe0b79427	2b205d1c-1ad3-45f3-84a4-d29cef31c5e4
156	156	0	Plazi	ffb07bec-2d10-492d-9c37-361fe0b79427	30220eba-fa3d-4311-84b0-07b0d8ba23d0
2	2	0	Plazi	ffb07bec-2d10-492d-9c37-361fe0b79427	306c5b9a-ae03-48f1-b939-4bbc66ad04c9
154	154	0	Participant Node Managers Committee	7f48e0c8-5c96-49ec-b972-30748e339115	30a29818-d6d2-4116-b59b-1facb9276526
1	1	0	Plazi	ffb07bec-2d10-492d-9c37-361fe0b79427	33a1546e-720b-4435-bc0e-e4ac92f61ace
7	7	0	Plazi	ffb07bec-2d10-492d-9c37-361fe0b79427	3e08c277-6777-4b2d-abbe-ae84c5d5e3bb
13	13	0	Belgian Biodiversity Platform	fb11cfe1-ebc3-45af-9159-17d9fddbcdac	3fd5fe48-2bb9-46f2-97f7-ab27b824ce8e
1	1	0	Plazi	ffb07bec-2d10-492d-9c37-361fe0b79427	404af79b-6be1-426b-b43e-1216cdfcd587
0	107	107	Ocean Biodiversity Information System	ba0670b9-4186-41e6-8e70-f9cb3065551a	41bf9c2f-8536-4b53-8483-e91338f2145f
0	12	12	Plazi	ffb07bec-2d10-492d-9c37-361fe0b79427	41d2a753-a2e7-48cc-bcfa-dc33f2ef1af7
2	2	0	Plazi	ffb07bec-2d10-492d-9c37-361fe0b79427	41df8811-1d93-450e-91ad-3f312805e1d3
1	1	0	Plazi	ffb07bec-2d10-492d-9c37-361fe0b79427	42dcf7ba-9e01-4d50-97f3-e20520ede6f9
102	102	0	National Biodiversity Network	d897a5b9-35ee-4232-94bd-b0bcaac003c2	46e8a416-131d-4fa9-920a-0f30a7b6f041
89	89	0	National Biodiversity Network	d897a5b9-35ee-4232-94bd-b0bcaac003c2	48527336-7ead-4877-8152-55f3e657409c
3	3	0	Plazi	ffb07bec-2d10-492d-9c37-361fe0b79427	4bb0d59c-be0e-441e-9819-3eb381c46808
7444	7444	0	Biodiversity Information System of Mexico	b324e8e9-9a4c-44fa-8f1a-7f39ea7ab576	4c13bc65-b440-45a7-8471-df0a862c6c91
91	81	-10	GBIF Germany	4f6826f2-4ff6-443d-b966-e6913bd24013	4da06075-e131-4c32-a9eb-45073134c84a
99551	99584	33	U.S. Geological Survey	8618c64a-93e0-4300-b546-7249e5148ed2	4f29b6ab-20c0-4479-8795-4915bedcebd1
0	24	24	Plazi	ffb07bec-2d10-492d-9c37-361fe0b79427	514dddd7-980e-4b85-bfbd-bc2ea28bb41b
0	3	3	Plazi	ffb07bec-2d10-492d-9c37-361fe0b79427	52d006e3-496d-4c78-a808-8886a2c58bf4
14	14	0	Plazi	ffb07bec-2d10-492d-9c37-361fe0b79427	54677545-2000-47a2-92ce-a03d614140d1
164	164	0	Atlas of Living Australia	4a6f1b71-969e-4fc5-a693-282b05e1220c	57ea6e10-3b95-4770-ab39-2111a06ddc7c
1052	1052	0	Biodiversity Information System of Mexico	b324e8e9-9a4c-44fa-8f1a-7f39ea7ab576	59a611ea-6ec9-4d9f-84d6-179e8fbade56
374	374	0	DanBIF - Danish Biodiversity Information Facility	4ddd294f-02b7-4359-ac33-0806a9ca9c6b	59d25ddf-355d-47d7-b8a1-c1e2819014c7
0	18849	18849	GBIF Japan	db5705aa-6a6e-42f1-8942-d77b9f4896ea	5c096526-c314-4c3d-8bd3-16bd5415b811
0	1287	1287	Ocean Biodiversity Information System	ba0670b9-4186-41e6-8e70-f9cb3065551a	5c508fe3-b4e3-403f-a8b7-1bee24b0a810
17	17	0	Plazi	ffb07bec-2d10-492d-9c37-361fe0b79427	5c8996dd-81a4-4283-b6bb-682cc7707c1f
1971	1971	0	National Biodiversity Network	d897a5b9-35ee-4232-94bd-b0bcaac003c2	5e2dc29a-a6b2-43ac-9050-3259d7c3bcb3
332	332	0	GBIF Norway	4f829580-180d-46a9-9c87-ed8ec959b545	5f10af1e-3b3a-40c5-b55d-f3bff1243b4c
0	9	9	Plazi	ffb07bec-2d10-492d-9c37-361fe0b79427	61c578ca-75a0-4623-a1e8-e1d64bdd9c4a
1	1	0	GBIF Germany	4f6826f2-4ff6-443d-b966-e6913bd24013	6357d064-f762-11e1-a439-00145eb45e9a
13	13	0	GBIF Germany	4f6826f2-4ff6-443d-b966-e6913bd24013	636d3274-f762-11e1-a439-00145eb45e9a
3	3	0	Plazi	ffb07bec-2d10-492d-9c37-361fe0b79427	64120518-5715-4ee9-b00f-8fe37779b4ad
11	11	0	Plazi	ffb07bec-2d10-492d-9c37-361fe0b79427	641b1d13-226c-4840-b7ab-4dcfbe9a1e2d
7	7	0	GBIF Germany	4f6826f2-4ff6-443d-b966-e6913bd24013	6490a924-f762-11e1-a439-00145eb45e9a
54	54	0	GBIF Germany	4f6826f2-4ff6-443d-b966-e6913bd24013	64ae8368-f762-11e1-a439-00145eb45e9a
147	147	0	GBIF Germany	4f6826f2-4ff6-443d-b966-e6913bd24013	6632fc64-f762-11e1-a439-00145eb45e9a
39	39	0	Plazi	ffb07bec-2d10-492d-9c37-361fe0b79427	66b51a04-a288-4344-8b6b-64dede2f69bf
100	100	0	GBIF Germany	4f6826f2-4ff6-443d-b966-e6913bd24013	6785eae7-0c65-46dd-88a0-22b59346d3c3
123	123	0	GBIF Germany	4f6826f2-4ff6-443d-b966-e6913bd24013	6845565a-f762-11e1-a439-00145eb45e9a
26	26	0	GBIF Germany	4f6826f2-4ff6-443d-b966-e6913bd24013	691d55fa-f762-11e1-a439-00145eb45e9a
825	276	-549	GBIF Germany	4f6826f2-4ff6-443d-b966-e6913bd24013	69edc6ae-f762-11e1-a439-00145eb45e9a
38	38	0	GBIF Germany	4f6826f2-4ff6-443d-b966-e6913bd24013	6abcf528-f762-11e1-a439-00145eb45e9a
106	106	0	GBIF Germany	4f6826f2-4ff6-443d-b966-e6913bd24013	6ccc9d1e-f762-11e1-a439-00145eb45e9a
186	186	0	GBIF Germany	4f6826f2-4ff6-443d-b966-e6913bd24013	6d16ad32-f762-11e1-a439-00145eb45e9a
285	641	356	Colombian Biodiversity Information System	7e865cba-7c46-417b-ade5-97f2cf5b7be0	7041f3d0-3be7-4d45-b836-ab0c36b775ad
1648	1648	0	GBIF Germany	4f6826f2-4ff6-443d-b966-e6913bd24013	70561e42-f762-11e1-a439-00145eb45e9a
896	1149	253	Participant Node Managers Committee	7f48e0c8-5c96-49ec-b972-30748e339115	711e7fcd-4b37-471c-8967-1b3a607d2743
76	76	0	GBIF Germany	4f6826f2-4ff6-443d-b966-e6913bd24013	72410ed8-f762-11e1-a439-00145eb45e9a
160	160	0	GBIF Germany	4f6826f2-4ff6-443d-b966-e6913bd24013	729eb52e-f762-11e1-a439-00145eb45e9a
180	180	0	Biodiversity Information System of Mexico	b324e8e9-9a4c-44fa-8f1a-7f39ea7ab576	72c1ee1f-4303-4ce8-9a5a-07e0130887a4
9	9	0	GBIF Germany	4f6826f2-4ff6-443d-b966-e6913bd24013	738ea5d4-f762-11e1-a439-00145eb45e9a
8853	8853	0	GBIF Japan	db5705aa-6a6e-42f1-8942-d77b9f4896ea	73decd94-06c8-4539-a64e-89f54fb882fc
34	34	0	GBIF Germany	4f6826f2-4ff6-443d-b966-e6913bd24013	743f5460-f762-11e1-a439-00145eb45e9a
0	12	12	Plazi	ffb07bec-2d10-492d-9c37-361fe0b79427	7467763c-a993-408e-83cc-97be1659be71
1755	1755	0	Participant Node Managers Committee	7f48e0c8-5c96-49ec-b972-30748e339115	77929c0a-7506-4b2d-a49d-10fc3312d50d
4	4	0	GBIF Germany	4f6826f2-4ff6-443d-b966-e6913bd24013	788df134-f762-11e1-a439-00145eb45e9a
39139	39139	0	GBIF Portugal	673f7038-4262-4149-b753-5658a4e912f6	79673413-746f-48f2-bd8a-7cf27807317e
239	229	-10	GBIF Germany	4f6826f2-4ff6-443d-b966-e6913bd24013	79940ece-f762-11e1-a439-00145eb45e9a
0	11	11	Plazi	ffb07bec-2d10-492d-9c37-361fe0b79427	7a229f6a-0033-4a8b-9bd0-c1b288f9d8bf
1	1	0	Plazi	ffb07bec-2d10-492d-9c37-361fe0b79427	7a662466-753b-4e40-b713-d8d1041eac0e
2	2	0	Plazi	ffb07bec-2d10-492d-9c37-361fe0b79427	7a7afa36-736c-44a3-b583-e3e53f7467d6
213	213	0	Korean Biodiversity Information Facility	e0a1e772-0177-4800-94b4-2d023fe6cdf4	7af25dc0-f762-11e1-a439-00145eb45e9a
9	9	0	Plazi	ffb07bec-2d10-492d-9c37-361fe0b79427	7b20bc51-26bc-4bd1-8c09-997609952de7
1582	1582	0	GBIF France	da44cd31-5901-4687-a106-6d1c7734ee3a	7b4c1516-8ce0-42ce-a266-ad180bc039e1
45	45	0	GBIF Germany	4f6826f2-4ff6-443d-b966-e6913bd24013	7b796aa4-f762-11e1-a439-00145eb45e9a
889	889	0	GBIF Germany	4f6826f2-4ff6-443d-b966-e6913bd24013	7b7cd8c4-f762-11e1-a439-00145eb45e9a
78	78	0	Plazi	ffb07bec-2d10-492d-9c37-361fe0b79427	7c2f7e33-7079-4db2-be9d-9031a4d92cbd
0	24	24	Plazi	ffb07bec-2d10-492d-9c37-361fe0b79427	7d422574-38c2-4460-9bc4-83502fae57b4
566	566	0	GBIF Guinea	b1cd2e84-c4ba-47bd-b72a-dfd1f92dce0a	7f5391ae-4f6c-43a2-8a66-6ccfd447399a
5	5	0	Plazi	ffb07bec-2d10-492d-9c37-361fe0b79427	7fbb4285-59e7-49e6-a890-df9610e94455
140	140	0	National Biodiversity Network	d897a5b9-35ee-4232-94bd-b0bcaac003c2	80187caf-3e88-4dc1-8ded-6efcdcddaafc
784	784	0	Biodiversity Information System of Mexico	b324e8e9-9a4c-44fa-8f1a-7f39ea7ab576	803962e2-f762-11e1-a439-00145eb45e9a
1883	1883	0	Biodiversity Information System of Mexico	b324e8e9-9a4c-44fa-8f1a-7f39ea7ab576	80b168c8-f762-11e1-a439-00145eb45e9a
3	3	0	Plazi	ffb07bec-2d10-492d-9c37-361fe0b79427	819878a9-e83d-4ae9-b491-c59693d7e135
36	28	-8	GBIF Germany	4f6826f2-4ff6-443d-b966-e6913bd24013	81d6916a-f762-11e1-a439-00145eb45e9a
0	179	179	Plazi	ffb07bec-2d10-492d-9c37-361fe0b79427	83eb3953-aacf-48af-a9fa-0a54375836e2
31082	31082	0	Biodiversity Information System of Mexico	b324e8e9-9a4c-44fa-8f1a-7f39ea7ab576	84ff719a-f762-11e1-a439-00145eb45e9a
3483	3483	0	DanBIF - Danish Biodiversity Information Facility	4ddd294f-02b7-4359-ac33-0806a9ca9c6b	85f12e86-f762-11e1-a439-00145eb45e9a
0	21	21	Plazi	ffb07bec-2d10-492d-9c37-361fe0b79427	8686a37e-4f38-4590-855d-c2795837ebb5
14	4	-10	GBIF Germany	4f6826f2-4ff6-443d-b966-e6913bd24013	878773a4-f762-11e1-a439-00145eb45e9a
440	332	-108	GBIF Germany	4f6826f2-4ff6-443d-b966-e6913bd24013	881150f6-f762-11e1-a439-00145eb45e9a
2255	2255	0	Korean Biodiversity Information Facility	e0a1e772-0177-4800-94b4-2d023fe6cdf4	88dadc8c-f762-11e1-a439-00145eb45e9a
704	704	0	U.S. Geological Survey	8618c64a-93e0-4300-b546-7249e5148ed2	88f5394e-776b-4113-9a4f-0b815d95af57
25	25	0	Ocean Biodiversity Information System	ba0670b9-4186-41e6-8e70-f9cb3065551a	89135558-f762-11e1-a439-00145eb45e9a
31229	31229	0	Belgian Biodiversity Platform	fb11cfe1-ebc3-45af-9159-17d9fddbcdac	8a24888b-36df-4f9d-a1ec-f7f49190d6a7
376	376	0	GBIF Germany	4f6826f2-4ff6-443d-b966-e6913bd24013	8a916226-f762-11e1-a439-00145eb45e9a
257	257	0	National Biodiversity Network	d897a5b9-35ee-4232-94bd-b0bcaac003c2	8b29d662-827a-40e5-b11c-3937cb344bee
0	251	251	Colombian Biodiversity Information System	7e865cba-7c46-417b-ade5-97f2cf5b7be0	8b612bbf-8371-4597-81cb-5ed39254b1e4
1	1	0	Plazi	ffb07bec-2d10-492d-9c37-361fe0b79427	8d92d903-e952-4d57-a9a9-d2ca461df931
2257	1702	-555	GBIF Germany	4f6826f2-4ff6-443d-b966-e6913bd24013	8e97ff1a-f762-11e1-a439-00145eb45e9a
0	3	3	Plazi	ffb07bec-2d10-492d-9c37-361fe0b79427	8f91a52d-de34-47ed-80ac-9dc7c1bf915c
154	94	-60	GBIF Germany	4f6826f2-4ff6-443d-b966-e6913bd24013	9064b78e-f762-11e1-a439-00145eb45e9a
37	23	-14	GBIF Germany	4f6826f2-4ff6-443d-b966-e6913bd24013	90cc8936-f762-11e1-a439-00145eb45e9a
64	60	-4	GBIF Germany	4f6826f2-4ff6-443d-b966-e6913bd24013	9140203a-f762-11e1-a439-00145eb45e9a
1380	1150	-230	GBIF Germany	4f6826f2-4ff6-443d-b966-e6913bd24013	91b363c4-f762-11e1-a439-00145eb45e9a
64	64	0	GBIF Germany	4f6826f2-4ff6-443d-b966-e6913bd24013	964b50d6-f762-11e1-a439-00145eb45e9a
499	54	-445	GBIF Germany	4f6826f2-4ff6-443d-b966-e6913bd24013	96cb14e1-6b19-44e4-a16f-47a51aacdaa1
157	157	0	GBIF France	da44cd31-5901-4687-a106-6d1c7734ee3a	974c7ca7-8ec4-432c-9927-515f339bbdc0
0	2	2	Plazi	ffb07bec-2d10-492d-9c37-361fe0b79427	99c156c3-d785-43ae-a69b-9fde2c3c4d75
1169	1169	0	Biodiversity Information System of Mexico	b324e8e9-9a4c-44fa-8f1a-7f39ea7ab576	9abea2d9-f119-4417-ac63-7cdae087ec00
50	50	0	Plazi	ffb07bec-2d10-492d-9c37-361fe0b79427	a3725c6c-7f06-4453-a08f-3016ddce3f3e
1873	1873	0	National Biodiversity Network	d897a5b9-35ee-4232-94bd-b0bcaac003c2	a47498e6-f8f0-45a5-ac99-6f4571e1e5b2
409	409	0	Participant Node Managers Committee	7f48e0c8-5c96-49ec-b972-30748e339115	a739f783-08c1-4d47-a8cc-2e9e6e874202
6	6	0	Plazi	ffb07bec-2d10-492d-9c37-361fe0b79427	a9e771ea-805a-4a15-ae76-6a7abe79f1af
4	4	0	Plazi	ffb07bec-2d10-492d-9c37-361fe0b79427	ac35cff7-f3e5-4917-b5c5-e20b6462d1f0
5074	5074	0	GBIF Benin	efb9c00e-f802-45dd-8826-a52ec45b89ff	acca8633-d38a-4cd7-a6f8-5a2d4e29832a
0	30	30	Plazi	ffb07bec-2d10-492d-9c37-361fe0b79427	ad4dbfb6-14ce-48e2-8fe9-99fa26a9bcf4
36	36	0	Plazi	ffb07bec-2d10-492d-9c37-361fe0b79427	afcbde84-0f14-4157-aaeb-30da1e8b74c6
171	171	0	GBIF Germany	4f6826f2-4ff6-443d-b966-e6913bd24013	b12ed28a-f3db-4cbb-a975-1619272a74f9
420	420	0	Colombian Biodiversity Information System	7e865cba-7c46-417b-ade5-97f2cf5b7be0	b4ba17bb-057d-460f-9968-ff40333037b9
746	746	0	GBIF France	da44cd31-5901-4687-a106-6d1c7734ee3a	b540b821-bde3-4853-ad49-1646caaec0a4
0	2	2	Plazi	ffb07bec-2d10-492d-9c37-361fe0b79427	b7487199-727e-49a3-bc4d-bc8063e4c8be
4	4	0	Plazi	ffb07bec-2d10-492d-9c37-361fe0b79427	b74e6677-e056-459b-8781-3f3ade783f8c
387	387	0	National Biodiversity Network	d897a5b9-35ee-4232-94bd-b0bcaac003c2	bb1f7dad-4b45-48eb-b4fd-8dd757e46d92
0	20	20	Ocean Biodiversity Information System	ba0670b9-4186-41e6-8e70-f9cb3065551a	c1c87d2f-f66d-46bd-8f1a-5c44c17ddb01
35	35	0	Participant Node Managers Committee	7f48e0c8-5c96-49ec-b972-30748e339115	c257bd77-512e-42d7-b54b-86f8080eafc5
4	4	0	Plazi	ffb07bec-2d10-492d-9c37-361fe0b79427	c6575c6d-4fc0-43ab-bea6-61f13600bbe5
2	2	0	Plazi	ffb07bec-2d10-492d-9c37-361fe0b79427	c8bbfeb0-a1db-41bb-8c65-45e3a4ed0fa1
6	6	0	Plazi	ffb07bec-2d10-492d-9c37-361fe0b79427	cac41953-f4df-4b49-a016-f67e07507479
164994	164994	0	National Biodiversity Network	d897a5b9-35ee-4232-94bd-b0bcaac003c2	cb6a5492-a37b-4b63-846d-6f38ab009065
9	9	0	Colombian Biodiversity Information System	7e865cba-7c46-417b-ade5-97f2cf5b7be0	cb8f8500-7fd0-4471-883a-07672eaa1d2c
6	6	0	Plazi	ffb07bec-2d10-492d-9c37-361fe0b79427	cf715674-c5fb-46c8-bacb-4ab192b77a68
63	63	0	Plazi	ffb07bec-2d10-492d-9c37-361fe0b79427	d070516d-5b58-4186-886c-b2234d056494
163	163	0	Plazi	ffb07bec-2d10-492d-9c37-361fe0b79427	d133a0f6-c491-44b8-a7f3-bc79e2ec0b37
2	2	0	Plazi	ffb07bec-2d10-492d-9c37-361fe0b79427	d281727b-64ea-4ea1-a62e-86196701ad98
7	7	0	Plazi	ffb07bec-2d10-492d-9c37-361fe0b79427	d329726e-6a89-41a8-baba-b26dccac1751
2877	2877	0	GBIF Spain	1f94b3ca-9345-4d65-afe2-4bace93aa0fe	d53ee09e-8458-4130-a337-6071e3a81726
0	5	5	Plazi	ffb07bec-2d10-492d-9c37-361fe0b79427	d747cda9-c33d-43b0-8ec3-e25e822f3a3d
1382	1382	0	GBIF France	da44cd31-5901-4687-a106-6d1c7734ee3a	d851b506-89db-4e3f-bc3c-e15234ec898e
1	1	0	Plazi	ffb07bec-2d10-492d-9c37-361fe0b79427	ddd1be2a-daf6-49fc-a865-b995cbf2f79c
1	1	0	Plazi	ffb07bec-2d10-492d-9c37-361fe0b79427	e165d6e8-c4b6-49ec-9ae0-c0a2bcb2e813
5	5	0	GBIF Argentina	2426a871-9feb-40a1-96c6-0c593a76b835	e2e52a57-7101-41bb-92af-9fedc0f37b93
589	589	0	GBIF Japan	db5705aa-6a6e-42f1-8942-d77b9f4896ea	e32a58dc-deb6-44d2-b4c2-4e5ca7165eeb
332	332	0	Colombian Biodiversity Information System	7e865cba-7c46-417b-ade5-97f2cf5b7be0	e330e2ff-9816-482e-aceb-27f2b3cc05c4
0	1	1	Plazi	ffb07bec-2d10-492d-9c37-361fe0b79427	e38c7725-6d6e-4376-ae4a-a013f02acd71
0	32	32	Plazi	ffb07bec-2d10-492d-9c37-361fe0b79427	e4063d74-38c7-4442-90b9-6d7b929760ae
363	363	0	Colombian Biodiversity Information System	7e865cba-7c46-417b-ade5-97f2cf5b7be0	e4936d74-c4d0-48f0-91ec-e95451091ec5
3	3	0	Plazi	ffb07bec-2d10-492d-9c37-361fe0b79427	e7870764-f2ff-4871-a215-c634cf918141
1444	1444	0	Biodiversity Information System of Mexico	b324e8e9-9a4c-44fa-8f1a-7f39ea7ab576	e7e019c6-5582-47ee-ae97-32e4cd66d4c6
22289	22589	300	GBIF Norway	4f829580-180d-46a9-9c87-ed8ec959b545	e87a12af-fc4c-4315-bff7-c7b827379aca
28	28	0	Plazi	ffb07bec-2d10-492d-9c37-361fe0b79427	ea9316c2-9a82-40ef-9a38-378b376126be
1	1	0	Plazi	ffb07bec-2d10-492d-9c37-361fe0b79427	eaaf3adf-1e6a-42ab-a897-185fee897faf
3	3	0	Plazi	ffb07bec-2d10-492d-9c37-361fe0b79427	eb057bd9-4e07-449c-840f-ca70e70fe493
5	5	0	Plazi	ffb07bec-2d10-492d-9c37-361fe0b79427	f4696c4a-8276-4cda-82df-22fdbe61ba7b
0	3940	3940	Participant Node Managers Committee	7f48e0c8-5c96-49ec-b972-30748e339115	f64f3bb6-52b6-4ad4-a151-ee751644d4ba
0	8	8	Plazi	ffb07bec-2d10-492d-9c37-361fe0b79427	f89b85dd-aca2-48b0-84ef-f35af6ead293
0	47	47	Colombian Biodiversity Information System	7e865cba-7c46-417b-ade5-97f2cf5b7be0	f9481a9f-67c8-4809-85b6-18224b127073
340821	440364	99543	GBIF Switzerland	169eb292-376b-4cc6-8e31-9c2c432de0ad	f9ffbc32-a118-43b3-aee8-69f0776b3161
1	1	0	Plazi	ffb07bec-2d10-492d-9c37-361fe0b79427	fb9fc8a1-b808-46b4-9d41-42fd33c7b0ff
12639	12639	0	GBIF New Zealand	4f9fd726-20dd-445e-89a1-8ed93792276f	fcf464de-3ef3-477d-90a2-6002f3c78143
0	3	3	Plazi	ffb07bec-2d10-492d-9c37-361fe0b79427	00279325-a729-499a-97fb-f13717577c50
15	15	0	Plazi	ffb07bec-2d10-492d-9c37-361fe0b79427	01473823-de33-48b2-8c73-3ab5b98f7e7b
5972	5972	0	GBIF France	da44cd31-5901-4687-a106-6d1c7734ee3a	014f3d14-a409-4090-b690-a10bd18e6e62
97041	97041	0	National Biodiversity Network	d897a5b9-35ee-4232-94bd-b0bcaac003c2	036fc1c5-0e44-46e7-ac71-3303bb997a92
0	5	5	Ocean Biodiversity Information System	ba0670b9-4186-41e6-8e70-f9cb3065551a	03bb7149-03ee-4d4a-9724-993693b89daa
6519	6915	396	GBIF Japan	db5705aa-6a6e-42f1-8942-d77b9f4896ea	04004ee7-4c21-47f7-b55d-267e6b8a1f76
0	3	3	Plazi	ffb07bec-2d10-492d-9c37-361fe0b79427	04f46a41-eb99-4684-a8c3-d45bef85c402
83	83	0	GBIF Argentina	2426a871-9feb-40a1-96c6-0c593a76b835	087b319d-63f6-4ec0-9eb6-8f3f5d07a3b7
964	964	0	GBIF Germany	4f6826f2-4ff6-443d-b966-e6913bd24013	0a2e1330-d2a2-442c-b3a3-6ca07778218d
164	164	0	GBIF France	da44cd31-5901-4687-a106-6d1c7734ee3a	0a662e74-5e9e-46b1-bd26-b7be1b78e0ec
1239	1239	0	Colombian Biodiversity Information System	7e865cba-7c46-417b-ade5-97f2cf5b7be0	0b0bf08e-ab89-4643-ab2f-371f7ed5da2e
0	1	1	Plazi	ffb07bec-2d10-492d-9c37-361fe0b79427	0d005205-2241-4da5-9b00-be4d1a842067
1	1	0	Plazi	ffb07bec-2d10-492d-9c37-361fe0b79427	0d064bf0-d76e-4a7a-8268-de267a536aba
222298	224017	1719	Atlas of Living Australia	4a6f1b71-969e-4fc5-a693-282b05e1220c	0debafd0-6c8a-11de-8225-b8a03c50a862
2	2	0	Plazi	ffb07bec-2d10-492d-9c37-361fe0b79427	107b0d9d-5a78-4cb4-b2a9-0eb76cb5d3c0
617	617	0	GBIF Brazil	cdc9736d-5ff7-4ece-9959-3c744360cdb3	10835e56-3f86-4dc8-8199-6a4302f884bb
0	181	181	Ocean Biodiversity Information System	ba0670b9-4186-41e6-8e70-f9cb3065551a	11c8db07-bb9c-4050-91f1-2b4431774495
2	2	0	Plazi	ffb07bec-2d10-492d-9c37-361fe0b79427	14001e1c-2c80-4446-81c9-a942f7305b9f
1	1	0	Plazi	ffb07bec-2d10-492d-9c37-361fe0b79427	161a482a-fadc-49a1-85fd-4b132a9bb0cd
45	45	0	Colombian Biodiversity Information System	7e865cba-7c46-417b-ade5-97f2cf5b7be0	1880f6ec-f7fe-4e7b-b5f6-89ace46a6430
0	16	16	Ocean Biodiversity Information System	ba0670b9-4186-41e6-8e70-f9cb3065551a	19555b20-05cc-4236-aab5-328110f4f3b8
0	2	2	Plazi	ffb07bec-2d10-492d-9c37-361fe0b79427	1bf05daa-d484-4375-9995-bd1bd6e12800
8	8	0	Plazi	ffb07bec-2d10-492d-9c37-361fe0b79427	1cbc2b44-58df-4cde-8f6a-85b5aa26d1a8
0	707	707	Colombian Biodiversity Information System	7e865cba-7c46-417b-ade5-97f2cf5b7be0	1d0caaa0-0711-47d7-a35a-0169944c76bd
2	2	0	Plazi	ffb07bec-2d10-492d-9c37-361fe0b79427	1ee90c5d-84d2-4e0e-8574-1f466b0bce9d
186	186	0	Plazi	ffb07bec-2d10-492d-9c37-361fe0b79427	20f1fda2-edd7-4624-b888-e44e44d88329
714	714	0	Plazi	ffb07bec-2d10-492d-9c37-361fe0b79427	256591b2-6d7b-465d-a818-9a158017ca09
0	15	15	Plazi	ffb07bec-2d10-492d-9c37-361fe0b79427	2930c6b8-746b-45ac-96c0-1fd19de653bb
1121933	1121933	0	Atlas of Living Australia	4a6f1b71-969e-4fc5-a693-282b05e1220c	2985efd1-45b1-46de-b6db-0465d2834a5a
0	88	88	Plazi	ffb07bec-2d10-492d-9c37-361fe0b79427	2ac5bb58-f2f4-4461-b30e-85e8d755246d
13	13	0	Colombian Biodiversity Information System	7e865cba-7c46-417b-ade5-97f2cf5b7be0	2b586fea-d6e5-4d1f-8b44-59ad46125f62
1	1	0	Plazi	ffb07bec-2d10-492d-9c37-361fe0b79427	2c41f064-7d2e-4df6-bc7d-fa3589520142
4	4	0	Participant Node Managers Committee	7f48e0c8-5c96-49ec-b972-30748e339115	2cafda19-2ab0-45b3-8f5c-05c23d091180
0	21	21	Plazi	ffb07bec-2d10-492d-9c37-361fe0b79427	2e831066-9100-4af1-80a8-ca3ea29bf516
15	15	0	GBIF France	da44cd31-5901-4687-a106-6d1c7734ee3a	2f12ea4f-c836-4658-9dd1-8e53367b0bb9
52	52	0	GBIF Finland	dd514216-5c7c-45f3-910d-797424cb5be6	2f401916-4925-4176-8d60-f436325d137d
276	276	0	Plazi	ffb07bec-2d10-492d-9c37-361fe0b79427	2ff436f0-3e0b-47fd-a4d6-22143699cdda
2334	2334	0	GBIF France	da44cd31-5901-4687-a106-6d1c7734ee3a	30b2cfa9-65a6-4338-8ef3-cf6daa210487
0	9	9	Plazi	ffb07bec-2d10-492d-9c37-361fe0b79427	34e2ec3d-4fec-4e92-8363-f55c0df0aee0
236	236	0	National Biodiversity Network	d897a5b9-35ee-4232-94bd-b0bcaac003c2	36bbd707-c6f6-44a2-b6b0-7e94ced2820c
33	33	0	Plazi	ffb07bec-2d10-492d-9c37-361fe0b79427	37509561-9f24-4dda-8774-4ea35a66db07
579	579	0	GBIF Chile	a8b16421-d80b-4ef3-8f22-098b01a89255	3c75469b-56e0-4b12-a861-b51f1a7e37cf
3405	3405	0	GBIF France	da44cd31-5901-4687-a106-6d1c7734ee3a	3c9e2297-bf20-4827-928e-7c7eefd9432c
84	84	0	National Biodiversity Network	d897a5b9-35ee-4232-94bd-b0bcaac003c2	3dc00daf-4d79-4388-a579-b4567b7ab9ed
2	2	0	Plazi	ffb07bec-2d10-492d-9c37-361fe0b79427	3dfb2433-7b81-45b9-9e7f-bc9dc606ae06
624	624	0	Biodiversity Information System of Mexico	b324e8e9-9a4c-44fa-8f1a-7f39ea7ab576	3e12052a-43b7-45e8-87d1-4939abbaf57c
4	4	0	Plazi	ffb07bec-2d10-492d-9c37-361fe0b79427	445ce82a-c971-4b27-b2a0-f0717756e9e5
20	20	0	Plazi	ffb07bec-2d10-492d-9c37-361fe0b79427	4565f82f-a0ec-49a8-b04f-1499a5ecafd6
0	33	33	Ocean Biodiversity Information System	ba0670b9-4186-41e6-8e70-f9cb3065551a	456f177d-2a60-4651-b9dd-e9f57507a83a
62	62	0	GBIF Germany	4f6826f2-4ff6-443d-b966-e6913bd24013	45a32182-24b0-4d63-93e0-720fe18218ab
94	94	0	Plazi	ffb07bec-2d10-492d-9c37-361fe0b79427	4901bf6e-80d4-45d2-87d7-32ded9dfd277
60	60	0	Colombian Biodiversity Information System	7e865cba-7c46-417b-ade5-97f2cf5b7be0	4bef41c6-daf5-48b0-9868-0548976dead0
0	35	35	Plazi	ffb07bec-2d10-492d-9c37-361fe0b79427	4ef975db-a444-49ec-9e25-7c431059cf03
20957	20957	0	U.S. Geological Survey	8618c64a-93e0-4300-b546-7249e5148ed2	4f2d0b57-2862-4f0b-94c7-d78cc3c58a1d
0	1	1	Plazi	ffb07bec-2d10-492d-9c37-361fe0b79427	4f6a6ead-8c30-41fe-9ab4-68df2b127e83
1320	480	-840	GBIF Germany	4f6826f2-4ff6-443d-b966-e6913bd24013	4faae93c-a1d1-4714-ae37-126eae73da51
103680	103677	-3	National Biodiversity Network	d897a5b9-35ee-4232-94bd-b0bcaac003c2	50804764-9c66-4448-8537-6767167e83c5
0	151139	151139	U.S. Geological Survey	8618c64a-93e0-4300-b546-7249e5148ed2	516eb7c0-3586-4dfc-bc18-c1fc1e765b7f
732	732	0	GBIF France	da44cd31-5901-4687-a106-6d1c7734ee3a	517d5eb7-0559-42e5-8b2f-7b4926decd2d
183	183	0	GBIF France	da44cd31-5901-4687-a106-6d1c7734ee3a	53e44a78-e003-487a-981a-221d94df8555
3	3	0	Plazi	ffb07bec-2d10-492d-9c37-361fe0b79427	550b757f-332d-4fea-a732-45df5e304ce2
347	347	0	GBIF Germany	4f6826f2-4ff6-443d-b966-e6913bd24013	592263fc-2c02-4955-a58e-73a66635d363
595064	595011	-53	National Biodiversity Network	d897a5b9-35ee-4232-94bd-b0bcaac003c2	594e1181-c38a-4f44-b78c-ceab50351cca
19	19	0	Plazi	ffb07bec-2d10-492d-9c37-361fe0b79427	5b436602-7dfa-4336-8dff-24debf9bf16c
0	4	4	Ocean Biodiversity Information System	ba0670b9-4186-41e6-8e70-f9cb3065551a	5c9816ec-249d-4b1e-8b59-4bfa794e7ab5
32	32	0	National Biodiversity Network	d897a5b9-35ee-4232-94bd-b0bcaac003c2	5f7dc9a7-a3c3-4fd9-a984-b7da07b47c47
145	145	0	GBIF Germany	4f6826f2-4ff6-443d-b966-e6913bd24013	5ff3357b-428d-474d-9397-9a5931d74ec7
264	264	0	GBIF Germany	4f6826f2-4ff6-443d-b966-e6913bd24013	61b3454a-f762-11e1-a439-00145eb45e9a
36	36	0	GBIF Germany	4f6826f2-4ff6-443d-b966-e6913bd24013	63033bda-f762-11e1-a439-00145eb45e9a
3	3	0	Plazi	ffb07bec-2d10-492d-9c37-361fe0b79427	64b3fe9c-17d7-42ae-a6d6-06b3cba328ac
2	2	0	Plazi	ffb07bec-2d10-492d-9c37-361fe0b79427	654e049f-83b5-44fb-9c63-5fc940234473
25	25	0	GBIF Germany	4f6826f2-4ff6-443d-b966-e6913bd24013	66818fbe-f762-11e1-a439-00145eb45e9a
41	41	0	GBIF Germany	4f6826f2-4ff6-443d-b966-e6913bd24013	677af55e-f762-11e1-a439-00145eb45e9a
125	125	0	GBIF Germany	4f6826f2-4ff6-443d-b966-e6913bd24013	680aa474-f762-11e1-a439-00145eb45e9a
2	2	0	Plazi	ffb07bec-2d10-492d-9c37-361fe0b79427	6982a298-41a9-4ce7-a7bb-07177b4eaf31
14	14	0	GBIF Germany	4f6826f2-4ff6-443d-b966-e6913bd24013	6a91b354-f762-11e1-a439-00145eb45e9a
0	345	345	Participant Node Managers Committee	7f48e0c8-5c96-49ec-b972-30748e339115	6b6f3121-d1c0-4229-b824-f73ac17695cb
16	16	0	GBIF Germany	4f6826f2-4ff6-443d-b966-e6913bd24013	6beef77a-f762-11e1-a439-00145eb45e9a
59	59	0	GBIF Germany	4f6826f2-4ff6-443d-b966-e6913bd24013	6d4581b6-f762-11e1-a439-00145eb45e9a
0	7	7	Plazi	ffb07bec-2d10-492d-9c37-361fe0b79427	6e96efe4-5c3c-441e-bf2c-aee6f8eb5961
497	497	0	Colombian Biodiversity Information System	7e865cba-7c46-417b-ade5-97f2cf5b7be0	6f06b1ca-b3df-45db-8bbb-4b3066c81158
17	17	0	GBIF Germany	4f6826f2-4ff6-443d-b966-e6913bd24013	6fc9d14e-f762-11e1-a439-00145eb45e9a
59	59	0	GBIF Germany	4f6826f2-4ff6-443d-b966-e6913bd24013	71a02ed2-f762-11e1-a439-00145eb45e9a
149	149	0	GBIF France	da44cd31-5901-4687-a106-6d1c7734ee3a	73951f16-a220-4ac7-a540-cdb2641d28f3
19	19	0	GBIF Germany	4f6826f2-4ff6-443d-b966-e6913bd24013	739595f6-f762-11e1-a439-00145eb45e9a
3	3	0	GBIF Germany	4f6826f2-4ff6-443d-b966-e6913bd24013	73a374d2-f762-11e1-a439-00145eb45e9a
16	16	0	GBIF Germany	4f6826f2-4ff6-443d-b966-e6913bd24013	7433409e-f762-11e1-a439-00145eb45e9a
3	3	0	GBIF Germany	4f6826f2-4ff6-443d-b966-e6913bd24013	745289e0-f762-11e1-a439-00145eb45e9a
476	476	0	GBIF Germany	4f6826f2-4ff6-443d-b966-e6913bd24013	748eaeb6-f762-11e1-a439-00145eb45e9a
56	56	0	GBIF Germany	4f6826f2-4ff6-443d-b966-e6913bd24013	74b153c6-f762-11e1-a439-00145eb45e9a
98	98	0	GBIF Germany	4f6826f2-4ff6-443d-b966-e6913bd24013	75021112-f762-11e1-a439-00145eb45e9a
63	63	0	GBIF Germany	4f6826f2-4ff6-443d-b966-e6913bd24013	7537d0d6-f762-11e1-a439-00145eb45e9a
208	208	0	GBIF Germany	4f6826f2-4ff6-443d-b966-e6913bd24013	75cae9e8-f762-11e1-a439-00145eb45e9a
218	218	0	GBIF Germany	4f6826f2-4ff6-443d-b966-e6913bd24013	75da11e8-f762-11e1-a439-00145eb45e9a
0	13833	13833	Canada Biodiversity Information Facility	8f83fc96-c966-4126-83f7-bf044dc49efa	773930b7-a6fc-4f5c-9eff-c59e2c21403a
329	329	0	GBIF Germany	4f6826f2-4ff6-443d-b966-e6913bd24013	774efc6e-f762-11e1-a439-00145eb45e9a
39	31	-8	GBIF Germany	4f6826f2-4ff6-443d-b966-e6913bd24013	7997e77e-f762-11e1-a439-00145eb45e9a
673	588	-85	GBIF Germany	4f6826f2-4ff6-443d-b966-e6913bd24013	79b089f0-f762-11e1-a439-00145eb45e9a
4233	4233	0	GBIF Germany	4f6826f2-4ff6-443d-b966-e6913bd24013	79f9624c-f762-11e1-a439-00145eb45e9a
61	61	0	GBIF Germany	4f6826f2-4ff6-443d-b966-e6913bd24013	7a678344-f762-11e1-a439-00145eb45e9a
400	400	0	Korean Biodiversity Information Facility	e0a1e772-0177-4800-94b4-2d023fe6cdf4	7afba43e-f762-11e1-a439-00145eb45e9a
43	43	0	Ocean Biodiversity Information System	ba0670b9-4186-41e6-8e70-f9cb3065551a	7b4bec78-f762-11e1-a439-00145eb45e9a
2879	2879	0	GBIF Germany	4f6826f2-4ff6-443d-b966-e6913bd24013	7c7b3856-f762-11e1-a439-00145eb45e9a
16	16	0	GBIF Germany	4f6826f2-4ff6-443d-b966-e6913bd24013	7d023e64-f762-11e1-a439-00145eb45e9a
3	3	0	Plazi	ffb07bec-2d10-492d-9c37-361fe0b79427	7ddec036-fcb1-4703-ada3-670f5fc8f25d
1704	1704	0	GBIF Germany	4f6826f2-4ff6-443d-b966-e6913bd24013	7e0e2976-f762-11e1-a439-00145eb45e9a
81889	81889	0	GBIF Norway	4f829580-180d-46a9-9c87-ed8ec959b545	7ee98521-4558-4edd-b241-edef8e1ebf62
1479	363	-1116	GBIF Germany	4f6826f2-4ff6-443d-b966-e6913bd24013	7f0da482-f762-11e1-a439-00145eb45e9a
4	4	0	Plazi	ffb07bec-2d10-492d-9c37-361fe0b79427	803e4b56-e68a-4f12-8e32-cc2b8d389128
0	4	4	Plazi	ffb07bec-2d10-492d-9c37-361fe0b79427	809cfaae-93e2-4279-a49c-d98141d81982
2056	1759	-297	Biodiversity Information System of Mexico	b324e8e9-9a4c-44fa-8f1a-7f39ea7ab576	80a4cdca-f762-11e1-a439-00145eb45e9a
0	494	494	Ocean Biodiversity Information System	ba0670b9-4186-41e6-8e70-f9cb3065551a	81316c7a-496a-4c1f-a56c-b09cbfdf0ef9
783	783	0	GBIF France	da44cd31-5901-4687-a106-6d1c7734ee3a	81b2954b-f232-46e8-af07-de7fc6e06bf7
2861	2861	0	Korean Biodiversity Information Facility	e0a1e772-0177-4800-94b4-2d023fe6cdf4	82fd496c-f762-11e1-a439-00145eb45e9a
0	331	331	Belgian Biodiversity Platform	fb11cfe1-ebc3-45af-9159-17d9fddbcdac	83bc2140-88b8-4c45-9f9c-3bfc417ec06a
98523	98523	0	U.S. Geological Survey	8618c64a-93e0-4300-b546-7249e5148ed2	84786a2e-f762-11e1-a439-00145eb45e9a
7939	7939	0	DanBIF - Danish Biodiversity Information Facility	4ddd294f-02b7-4359-ac33-0806a9ca9c6b	84c7f198-f762-11e1-a439-00145eb45e9a
338	338	0	DanBIF - Danish Biodiversity Information Facility	4ddd294f-02b7-4359-ac33-0806a9ca9c6b	85f86f01-b572-467e-98c4-6ca2027be5f0
4	4	0	Plazi	ffb07bec-2d10-492d-9c37-361fe0b79427	864c76e6-041f-4d2d-a01e-f57a331e5c2c
118	118	0	National Biodiversity Network	d897a5b9-35ee-4232-94bd-b0bcaac003c2	86b98a19-2d57-423c-b26f-f4fd20d2b9e8
681	522	-159	GBIF Germany	4f6826f2-4ff6-443d-b966-e6913bd24013	87fdbd8e-f762-11e1-a439-00145eb45e9a
63719	63719	0	Taiwan Biodiversity Information Facility	e1b85abc-61f9-430f-ba79-6813dec53a0f	88dc0756-f762-11e1-a439-00145eb45e9a
22950	23755	805	Netherlands Biodiversity Information Facility	0909d601-bda2-42df-9e63-a6d51847ebce	8b42bbf1-b287-40a0-ab3a-88fb7928f8e2
72	72	0	GBIF Germany	4f6826f2-4ff6-443d-b966-e6913bd24013	8b925432-f762-11e1-a439-00145eb45e9a
0	1	1	Plazi	ffb07bec-2d10-492d-9c37-361fe0b79427	8bc2657c-1d54-4780-88d2-7f10c5f868a8
11	6	-5	GBIF Germany	4f6826f2-4ff6-443d-b966-e6913bd24013	8ce98eae-f762-11e1-a439-00145eb45e9a
0	4	4	Plazi	ffb07bec-2d10-492d-9c37-361fe0b79427	8d14d45c-9556-4ca9-a258-0336e4713ee1
60	38	-22	GBIF Germany	4f6826f2-4ff6-443d-b966-e6913bd24013	8e461f9c-f762-11e1-a439-00145eb45e9a
138	96	-42	GBIF Germany	4f6826f2-4ff6-443d-b966-e6913bd24013	8e7e010a-f762-11e1-a439-00145eb45e9a
16	16	0	Plazi	ffb07bec-2d10-492d-9c37-361fe0b79427	8f4d148a-b10f-4a37-a6b5-ccaf230fbbb7
6	5	-1	GBIF Germany	4f6826f2-4ff6-443d-b966-e6913bd24013	90108362-f762-11e1-a439-00145eb45e9a
190	190	0	GBIF Germany	4f6826f2-4ff6-443d-b966-e6913bd24013	90853d12-da4d-4343-9e24-d283e0c56b82
45	45	0	GBIF New Zealand	4f9fd726-20dd-445e-89a1-8ed93792276f	911089de-581a-4bd3-909f-402aa6927959
1	1	0	Plazi	ffb07bec-2d10-492d-9c37-361fe0b79427	91dd00f2-f04e-4733-a06d-5b5952ee3be2
11	10	-1	GBIF Germany	4f6826f2-4ff6-443d-b966-e6913bd24013	91eb3164-f762-11e1-a439-00145eb45e9a
14	12	-2	GBIF Germany	4f6826f2-4ff6-443d-b966-e6913bd24013	92467d44-f762-11e1-a439-00145eb45e9a
162	162	0	GBIF Germany	4f6826f2-4ff6-443d-b966-e6913bd24013	926456ca-f762-11e1-a439-00145eb45e9a
101	109	8	GBIF Germany	4f6826f2-4ff6-443d-b966-e6913bd24013	92cb44a2-f762-11e1-a439-00145eb45e9a
934	827	-107	GBIF Germany	4f6826f2-4ff6-443d-b966-e6913bd24013	94590516-f762-11e1-a439-00145eb45e9a
480819	480819	0	DanBIF - Danish Biodiversity Information Facility	4ddd294f-02b7-4359-ac33-0806a9ca9c6b	96570b1a-f762-11e1-a439-00145eb45e9a
153	153	0	GBIF Germany	4f6826f2-4ff6-443d-b966-e6913bd24013	97914720-f762-11e1-a439-00145eb45e9a
0	1	1	Plazi	ffb07bec-2d10-492d-9c37-361fe0b79427	97b109ab-d5b0-450a-a63a-0cc1c4d76fd4
0	2	2	Plazi	ffb07bec-2d10-492d-9c37-361fe0b79427	98ee39c9-b424-4da7-bfa1-ea47baafc33d
3588	3588	0	GBIF France	da44cd31-5901-4687-a106-6d1c7734ee3a	9b05f8c2-5901-46de-8912-e9ca46155869
0	1	1	Plazi	ffb07bec-2d10-492d-9c37-361fe0b79427	9ce3ef27-c3a8-465a-a6a8-afe4a4475f80
852	852	0	Observation International	ad048418-7cd8-4070-a151-fe1c1f303129	9f1c80ed-aa0f-4c7c-8679-6a31467d8fe4
343063	343063	0	GBIF Japan	db5705aa-6a6e-42f1-8942-d77b9f4896ea	a3478a0c-efee-4bd6-a6a2-9c6d81f9a1ec
29	29	0	Plazi	ffb07bec-2d10-492d-9c37-361fe0b79427	a498fa04-36a2-403f-9014-d3f75231e5e1
256	256	0	GBIF France	da44cd31-5901-4687-a106-6d1c7734ee3a	a7b683a4-5a5f-4549-9a5b-51ac2d2642b3
30	30	0	GBIF France	da44cd31-5901-4687-a106-6d1c7734ee3a	ab9291ab-5ece-4018-8032-0c4cbd33b31a
5	5	0	GBIF France	da44cd31-5901-4687-a106-6d1c7734ee3a	ab997a57-ed78-4a70-ac05-042adff4dada
0	28	28	Plazi	ffb07bec-2d10-492d-9c37-361fe0b79427	ac67dd05-25f4-4848-ba11-e3eb91b004c1
1	1	0	Plazi	ffb07bec-2d10-492d-9c37-361fe0b79427	ac7f4ed5-6afe-4102-94a7-cb3748351403
6	6	0	GBIF France	da44cd31-5901-4687-a106-6d1c7734ee3a	ac89bc2c-22d8-49be-8e42-a6f9cfd23b35
4	4	0	Plazi	ffb07bec-2d10-492d-9c37-361fe0b79427	ac8b7ef1-c4cd-4060-b378-536403cb3b33
0	90	90	Plazi	ffb07bec-2d10-492d-9c37-361fe0b79427	acda30e5-6f57-43bb-81e6-70d3f96762d6
21	21	0	Plazi	ffb07bec-2d10-492d-9c37-361fe0b79427	ad4ab7cf-58d0-4aca-86bd-16ef6ad4db6b
1	1	0	GBIF France	da44cd31-5901-4687-a106-6d1c7734ee3a	adcafc09-a88b-460b-9fee-bc527a5e1b6c
54	54	0	Plazi	ffb07bec-2d10-492d-9c37-361fe0b79427	af204378-fe23-44df-895a-2b259af69479
0	18	18	Plazi	ffb07bec-2d10-492d-9c37-361fe0b79427	afbf84b8-6d1f-4856-82ae-f91e1d19e88e
2203	2203	0	National Biodiversity Network	d897a5b9-35ee-4232-94bd-b0bcaac003c2	b0667eec-40cf-401f-858c-86df1781019b
5	5	0	Plazi	ffb07bec-2d10-492d-9c37-361fe0b79427	b0db8ace-0d46-4ca4-9eea-d4ca5a9f9719
2	2	0	Plazi	ffb07bec-2d10-492d-9c37-361fe0b79427	b192f10d-19f9-4d70-9448-f67e85e858fc
0	2	2	Plazi	ffb07bec-2d10-492d-9c37-361fe0b79427	b5131b8c-8bc5-4806-9555-ba440502605b
257	257	0	U.S. Geological Survey	8618c64a-93e0-4300-b546-7249e5148ed2	b555d382-6b9a-4deb-a6b4-e05f19305c85
3	3	0	Plazi	ffb07bec-2d10-492d-9c37-361fe0b79427	b62507f4-92ae-4f0c-ad05-4146c2915009
0	31	31	Plazi	ffb07bec-2d10-492d-9c37-361fe0b79427	b8016461-1f19-4933-ba48-4cda6241c7a8
244	244	0	GBIF Finland	dd514216-5c7c-45f3-910d-797424cb5be6	b9d65394-1c8d-4df9-8d45-b807af99889d
7	7	0	Plazi	ffb07bec-2d10-492d-9c37-361fe0b79427	bc454ae6-cf07-466b-881b-2a2e80562dfa
62	62	0	Plazi	ffb07bec-2d10-492d-9c37-361fe0b79427	bef88811-0d50-4fd7-90c3-153cfaa6f0e8
1	1	0	Plazi	ffb07bec-2d10-492d-9c37-361fe0b79427	c0651e3d-6fd0-44c8-986f-264a88eb14df
0	5	5	Plazi	ffb07bec-2d10-492d-9c37-361fe0b79427	c06ce14e-6438-463c-afc3-7a7ed39b2845
143	143	0	GBIF Germany	4f6826f2-4ff6-443d-b966-e6913bd24013	c106367a-759e-40bc-9d23-c522c59dbdbe
0	8	8	Participant Node Managers Committee	7f48e0c8-5c96-49ec-b972-30748e339115	c137c84b-d4b6-47fb-9178-7a9808a96359
2300	2300	0	National Biodiversity Network	d897a5b9-35ee-4232-94bd-b0bcaac003c2	c1f2e2ad-d2af-4e1d-816f-6f47615e511a
3740	3740	0	GBIF Finland	dd514216-5c7c-45f3-910d-797424cb5be6	c379500a-39f0-4f69-99d0-b586516f635e
270	270	0	Colombian Biodiversity Information System	7e865cba-7c46-417b-ade5-97f2cf5b7be0	c4694808-b2e1-4ca4-bb08-b5335d893ff0
69111	69111	0	U.S. Geological Survey	8618c64a-93e0-4300-b546-7249e5148ed2	c5126b60-6dc3-428b-b479-15a921199da1
95051	95051	0	GBIF Finland	dd514216-5c7c-45f3-910d-797424cb5be6	c5a7ace8-726a-42e7-9d2f-85952e32b969
6191	6191	0	GBIF France	da44cd31-5901-4687-a106-6d1c7734ee3a	c5e2c6ea-f4dd-43ee-aabf-8cf909fc72c0
2	2	0	Plazi	ffb07bec-2d10-492d-9c37-361fe0b79427	c64b2b9e-2b56-453f-8391-ca6b87bee8da
336	336	0	GBIF Argentina	2426a871-9feb-40a1-96c6-0c593a76b835	c7138670-a82f-4002-8d39-723dee419bd6
14043	14043	0	Indonesian Biodiversity Information Facility	2ebd91f6-f14f-4375-b525-c011a3774f03	ca58433a-3ff8-492f-9d7b-6f6d289eb6d6
31	31	0	Plazi	ffb07bec-2d10-492d-9c37-361fe0b79427	cfb28d09-fb5c-4e53-ae31-c60df5abaea4
0	69	69	Plazi	ffb07bec-2d10-492d-9c37-361fe0b79427	d15c737e-c0cb-4f09-98dd-d707de72a43a
0	485	485	Ocean Biodiversity Information System	ba0670b9-4186-41e6-8e70-f9cb3065551a	d16bb93c-0605-490e-8016-864ca5a5d772
4109	4109	0	Ocean Biodiversity Information System	ba0670b9-4186-41e6-8e70-f9cb3065551a	d2175301-670b-4f99-ad87-f47b190d1e9c
1241	1241	0	GBIF Sweden	a0b3be64-6525-4387-ac67-a499950f92e1	d2ba3b27-692d-48dc-b010-708e59c5ff59
10	10	0	Plazi	ffb07bec-2d10-492d-9c37-361fe0b79427	d3889f97-da04-4e06-b121-0ddcbfc3ea1e
2	2	0	Plazi	ffb07bec-2d10-492d-9c37-361fe0b79427	d56fb8ee-ccf5-4eda-a2f3-855a58915e2f
12	12	0	Plazi	ffb07bec-2d10-492d-9c37-361fe0b79427	d6b4660a-91cb-47ba-bff8-cce8ed83084b
3239	3239	0	GBIF Portugal	673f7038-4262-4149-b753-5658a4e912f6	d90f2b88-71d9-4cc4-bb15-880c4cac8be9
74	74	0	Participant Node Managers Committee	7f48e0c8-5c96-49ec-b972-30748e339115	d9953b25-4b14-437c-aecf-1ccb60e8d698
0	49	49	Plazi	ffb07bec-2d10-492d-9c37-361fe0b79427	ddf1c8ab-ddf2-476d-a319-63046f6d99fa
15	15	0	Plazi	ffb07bec-2d10-492d-9c37-361fe0b79427	e24a04a5-2d8a-4972-b0e8-8741211843e0
0	602	602	Ocean Biodiversity Information System	ba0670b9-4186-41e6-8e70-f9cb3065551a	e3f878c9-d44d-419b-8b4d-4d4a755d8159
1590	1590	0	GBIF Germany	4f6826f2-4ff6-443d-b966-e6913bd24013	e4f625a7-5e24-4117-acf4-7cc59b37b1c1
3	3	0	Plazi	ffb07bec-2d10-492d-9c37-361fe0b79427	e655f2de-3baf-4083-bdc8-1f0f6f828a4d
24315	24315	0	National Biodiversity Network	d897a5b9-35ee-4232-94bd-b0bcaac003c2	e771b0a8-4b27-4284-b9e8-3b7343e631fe
3595	3595	0	DanBIF - Danish Biodiversity Information Facility	4ddd294f-02b7-4359-ac33-0806a9ca9c6b	f1277dd4-84c5-4e84-b300-d5a7ac3c1edd
0	16	16	Plazi	ffb07bec-2d10-492d-9c37-361fe0b79427	f1d90455-01d0-4904-a942-a9ac8ad939ae
3	3	0	Plazi	ffb07bec-2d10-492d-9c37-361fe0b79427	f36ef937-37f3-4288-b442-429dbba25575
2363	2363	0	Colombian Biodiversity Information System	7e865cba-7c46-417b-ade5-97f2cf5b7be0	f3f10afc-257f-47ef-8b0c-4bcaebdc09dc
0	7	7	Plazi	ffb07bec-2d10-492d-9c37-361fe0b79427	f47e77c1-c81a-4cd2-bb1c-1faca1a8aca9
9050	9050	0	GBIF Chile	a8b16421-d80b-4ef3-8f22-098b01a89255	f69687da-edff-43a7-be3a-6ec8a6f80a1d
0	6	6	Plazi	ffb07bec-2d10-492d-9c37-361fe0b79427	f6eccf01-e474-4511-9b26-6bcb87bef357
410	410	0	Colombian Biodiversity Information System	7e865cba-7c46-417b-ade5-97f2cf5b7be0	f8b5f9db-f994-4db0-8870-25fe72b10fea
22640	30207	7567	GBIF Brazil	cdc9736d-5ff7-4ece-9959-3c744360cdb3	f9040e31-ee85-4b92-9963-a0272a44ec96
0	53	53	Plazi	ffb07bec-2d10-492d-9c37-361fe0b79427	fb4551a7-7fbf-4ffe-85d6-32b6a83a27a1
17	17	0	Plazi	ffb07bec-2d10-492d-9c37-361fe0b79427	fb507bc4-0a9b-4caf-8f1e-d9d34aa6cd8e
50	50	0	Ocean Biodiversity Information System	ba0670b9-4186-41e6-8e70-f9cb3065551a	fbb730fe-c1e9-4dcb-ac6a-e5a9d3b65e76
1232	352	-880	GBIF Germany	4f6826f2-4ff6-443d-b966-e6913bd24013	fbc1b15f-d3f9-459a-84fb-89b0037e75dc
3	3	0	National Biodiversity Network	d897a5b9-35ee-4232-94bd-b0bcaac003c2	fdf5da9e-a2a4-4679-ada7-d31781aeb436
0	119	119	Colombian Biodiversity Information System	7e865cba-7c46-417b-ade5-97f2cf5b7be0	003af977-4127-4405-91fb-1356d785db61
871	871	0	GBIF France	da44cd31-5901-4687-a106-6d1c7734ee3a	00928a0b-bc65-4840-9380-082282882fbd
8	8	0	Plazi	ffb07bec-2d10-492d-9c37-361fe0b79427	02ddbbb4-cca3-4f20-bd5b-c70e09b1681f
0	60164	60164	GBIF Portugal	673f7038-4262-4149-b753-5658a4e912f6	05b014e5-186a-48b3-9158-a1d908221a62
0	3	3	Plazi	ffb07bec-2d10-492d-9c37-361fe0b79427	06eb2dc8-dc4c-4db0-934b-4d1d7e0fcded
6	6	0	Plazi	ffb07bec-2d10-492d-9c37-361fe0b79427	08b39b2c-80d7-4294-b5fc-c53d42b27030
48	48	0	Plazi	ffb07bec-2d10-492d-9c37-361fe0b79427	08d3223a-3afc-47e8-ac59-634f4e4b59d1
17	17	0	Plazi	ffb07bec-2d10-492d-9c37-361fe0b79427	08f360b0-c3c1-4717-b5ae-a62384815b03
107	107	0	National Biodiversity Network	d897a5b9-35ee-4232-94bd-b0bcaac003c2	09507097-c901-4434-bd3b-458068c2509f
0	3	3	Plazi	ffb07bec-2d10-492d-9c37-361fe0b79427	09f2bfa5-b0fc-40e7-bbf0-038ef63a0675
7228	7228	0	GBIF France	da44cd31-5901-4687-a106-6d1c7734ee3a	0d417a7f-4900-4246-ab1a-bf55bfdab994
231	231	0	GBIF France	da44cd31-5901-4687-a106-6d1c7734ee3a	0d776c9a-c0b5-45ed-8629-6acb7f7450bb
10075	10075	0	Costa Rica Biodiversity Facility	3379bb09-1a58-41e7-9c57-e3b66c3eb5a0	0dea45e0-6534-4b17-b88a-44a02c5cccaa
0	1	1	Plazi	ffb07bec-2d10-492d-9c37-361fe0b79427	0e0813f4-59e0-489c-be56-6f2bbbe2f89b
149	149	0	Belgian Biodiversity Platform	fb11cfe1-ebc3-45af-9159-17d9fddbcdac	0f138af6-6c18-4be3-ad71-23e18b3505f0
124062	124062	0	Canada Biodiversity Information Facility	8f83fc96-c966-4126-83f7-bf044dc49efa	103fa8e2-5be7-402c-b147-708d0755d9b0
1	1	0	Plazi	ffb07bec-2d10-492d-9c37-361fe0b79427	10f99299-a559-4576-aa1a-97a4e21a594f
18	18	0	Colombian Biodiversity Information System	7e865cba-7c46-417b-ade5-97f2cf5b7be0	127c42eb-f44d-4ae3-9e14-02e2b9770b33
60071	60071	0	U.S. Geological Survey	8618c64a-93e0-4300-b546-7249e5148ed2	17411afb-5543-4d0a-8f36-47cb8322062e
10	10	0	Plazi	ffb07bec-2d10-492d-9c37-361fe0b79427	196c385a-b33d-4f66-9140-c08987fe2347
1	1	0	Plazi	ffb07bec-2d10-492d-9c37-361fe0b79427	19c17ec8-24b4-42e0-b80d-4d262f9beac0
13035	17641	4606	GBIF Japan	db5705aa-6a6e-42f1-8942-d77b9f4896ea	19c94964-189f-45f2-905a-d23747ec9652
794	794	0	GBIF France	da44cd31-5901-4687-a106-6d1c7734ee3a	1c3a0329-df77-43e6-89b7-fc57a5bd7729
444	444	0	Polish Biodiversity Information Network	2618bfdf-e194-4911-a241-80db3107bc51	1e3205f0-9169-11db-9f6d-b8a03c50a862
2	2	0	Plazi	ffb07bec-2d10-492d-9c37-361fe0b79427	1ff7a3fc-e877-40b5-aa80-36b2f6074c49
1	1	0	Participant Node Managers Committee	7f48e0c8-5c96-49ec-b972-30748e339115	21a4ef4f-d25f-428e-be15-03c3ef839942
34517	34517	0	GBIF France	da44cd31-5901-4687-a106-6d1c7734ee3a	27414668-00c5-4479-88ab-2462a3f30cfd
522265	522265	0	National Biodiversity Network	d897a5b9-35ee-4232-94bd-b0bcaac003c2	289f4bfc-4460-43c4-bd43-5248e32f53be
7403	7403	0	GBIF Spain	1f94b3ca-9345-4d65-afe2-4bace93aa0fe	28c1c18b-64d8-4691-acdb-73e5653292f8
4217	4217	0	Colombian Biodiversity Information System	7e865cba-7c46-417b-ade5-97f2cf5b7be0	2be5b645-ed41-4645-8402-7cbaf42cd0ac
87	87	0	U.S. Geological Survey	8618c64a-93e0-4300-b546-7249e5148ed2	2e4f4ed1-77d0-4ee2-a895-6f894d3fcc13
9	9	0	Plazi	ffb07bec-2d10-492d-9c37-361fe0b79427	2e6a7bc5-1cb4-47e3-9628-fe1f1ac0c548
7	7	0	Plazi	ffb07bec-2d10-492d-9c37-361fe0b79427	2fb82473-fc03-4cd0-87ab-4948df6faf23
0	20	20	Plazi	ffb07bec-2d10-492d-9c37-361fe0b79427	311f8acb-781d-4dc3-8d0a-2637317aa691
3	3	0	Plazi	ffb07bec-2d10-492d-9c37-361fe0b79427	359e311b-7999-4184-bf5a-aa732e57d9af
859	859	0	Colombian Biodiversity Information System	7e865cba-7c46-417b-ade5-97f2cf5b7be0	37ce936e-a646-4e74-bcac-fdc19c0b643e
19	19	0	Plazi	ffb07bec-2d10-492d-9c37-361fe0b79427	38fd9281-d8ad-41ff-bcaa-08767819ee43
29034	29033	-1	U.S. Geological Survey	8618c64a-93e0-4300-b546-7249e5148ed2	395dfaad-8b0d-47e2-a2ea-bf8a3fd5c10c
0	796	796	Tanzania Biodiversity Information Facility	abd95ca6-3959-4db9-aaa6-2de1aeecf514	3c3a032d-0127-46a7-98a6-f9ca659f9099
2856	2856	0	Belgian Biodiversity Platform	fb11cfe1-ebc3-45af-9159-17d9fddbcdac	3c428404-893c-44da-bb4a-6c19d8fb676a
554	554	0	DanBIF - Danish Biodiversity Information Facility	4ddd294f-02b7-4359-ac33-0806a9ca9c6b	3eb94dd5-c5d2-4a55-947c-7a4d3535ced8
50	50	0	GBIF France	da44cd31-5901-4687-a106-6d1c7734ee3a	42634bed-ad18-449c-8cba-6559ef073c22
8	8	0	Plazi	ffb07bec-2d10-492d-9c37-361fe0b79427	462ff1ea-f7e9-4324-a29c-2c025bf1405b
1004	1004	0	GBIF France	da44cd31-5901-4687-a106-6d1c7734ee3a	48b7e704-9098-41ed-9f71-33a1b5267cc4
15	15	0	Plazi	ffb07bec-2d10-492d-9c37-361fe0b79427	4a9aa022-c0bc-4027-a278-410e1754471c
621	621	0	Plazi	ffb07bec-2d10-492d-9c37-361fe0b79427	4d93f591-1785-4eea-9b96-49b782137498
6	6	0	Plazi	ffb07bec-2d10-492d-9c37-361fe0b79427	4e5e09e4-b479-4630-91fe-2be8b2e04c7b
2	2	0	Plazi	ffb07bec-2d10-492d-9c37-361fe0b79427	59bd5714-f805-495e-9378-20cd488f6086
0	2	2	Ocean Biodiversity Information System	ba0670b9-4186-41e6-8e70-f9cb3065551a	5b5282e9-fd4b-4714-8c0b-8b7f58f2a9e8
0	1	1	Ocean Biodiversity Information System	ba0670b9-4186-41e6-8e70-f9cb3065551a	5d2b1246-3fb3-4647-995d-95efe4a539b7
3	3	0	Plazi	ffb07bec-2d10-492d-9c37-361fe0b79427	5dd36ea3-7c58-4644-a362-7dcac8e05a15
0	7	7	Plazi	ffb07bec-2d10-492d-9c37-361fe0b79427	5ec2000b-9593-4d6e-a8ad-fa8faf2cea06
85	85	0	National Biodiversity Network	d897a5b9-35ee-4232-94bd-b0bcaac003c2	615b2fcf-bc37-4af0-a11d-254cfa8a5cf2
65	65	0	GBIF Germany	4f6826f2-4ff6-443d-b966-e6913bd24013	6186baa2-f762-11e1-a439-00145eb45e9a
95	95	0	GBIF Germany	4f6826f2-4ff6-443d-b966-e6913bd24013	62220d40-f762-11e1-a439-00145eb45e9a
269	269	0	GBIF Germany	4f6826f2-4ff6-443d-b966-e6913bd24013	63963b6a-f762-11e1-a439-00145eb45e9a
269	269	0	GBIF Germany	4f6826f2-4ff6-443d-b966-e6913bd24013	643baa8c-f762-11e1-a439-00145eb45e9a
77	77	0	GBIF Germany	4f6826f2-4ff6-443d-b966-e6913bd24013	649d01d8-f762-11e1-a439-00145eb45e9a
945	914	-31	GBIF Germany	4f6826f2-4ff6-443d-b966-e6913bd24013	653ee9ee-f762-11e1-a439-00145eb45e9a
17	17	0	GBIF Germany	4f6826f2-4ff6-443d-b966-e6913bd24013	65ba7a78-f762-11e1-a439-00145eb45e9a
299	299	0	GBIF Germany	4f6826f2-4ff6-443d-b966-e6913bd24013	65c24fd9-65fc-4b2e-84bd-eb024e971b3b
6250	6250	0	U.S. Geological Survey	8618c64a-93e0-4300-b546-7249e5148ed2	65dfe059-f1c1-4ec9-9a05-d6877a1d2842
66	66	0	GBIF Germany	4f6826f2-4ff6-443d-b966-e6913bd24013	66ae95b8-f762-11e1-a439-00145eb45e9a
0	12	12	Plazi	ffb07bec-2d10-492d-9c37-361fe0b79427	67bc6a73-4137-4de3-9dc4-ce87972f742d
112	112	0	GBIF Germany	4f6826f2-4ff6-443d-b966-e6913bd24013	685f8a2a-f762-11e1-a439-00145eb45e9a
4585	4582	-3	U.S. Geological Survey	8618c64a-93e0-4300-b546-7249e5148ed2	68bcf659-9aa6-43a3-aed3-4e1140faa1b5
0	4	4	Ocean Biodiversity Information System	ba0670b9-4186-41e6-8e70-f9cb3065551a	699ed351-cd73-4d3a-ab99-3fd6284a0725
15	15	0	GBIF Germany	4f6826f2-4ff6-443d-b966-e6913bd24013	6b114dee-f762-11e1-a439-00145eb45e9a
18	18	0	GBIF Germany	4f6826f2-4ff6-443d-b966-e6913bd24013	6b6f4548-f762-11e1-a439-00145eb45e9a
611	611	0	GBIF Argentina	2426a871-9feb-40a1-96c6-0c593a76b835	6c2eea7c-94c3-4f4f-a631-b322fc387716
0	276	276	Plazi	ffb07bec-2d10-492d-9c37-361fe0b79427	6f85aa0a-0368-41a5-83d3-21c33f40845e
3	3	0	Plazi	ffb07bec-2d10-492d-9c37-361fe0b79427	700b3ea3-7936-400b-afed-40fddef16388
453	453	0	GBIF Germany	4f6826f2-4ff6-443d-b966-e6913bd24013	70ac6c02-f762-11e1-a439-00145eb45e9a
252	252	0	GBIF Germany	4f6826f2-4ff6-443d-b966-e6913bd24013	7186b4de-f762-11e1-a439-00145eb45e9a
18026	18026	0	GBIF Spain	1f94b3ca-9345-4d65-afe2-4bace93aa0fe	71e48eba-f762-11e1-a439-00145eb45e9a
1419	1419	0	GBIF New Zealand	4f9fd726-20dd-445e-89a1-8ed93792276f	72e465f7-3640-40e3-bc30-39f0d375c1dc
17	17	0	GBIF Germany	4f6826f2-4ff6-443d-b966-e6913bd24013	73b82760-f762-11e1-a439-00145eb45e9a
968	968	0	GBIF Germany	4f6826f2-4ff6-443d-b966-e6913bd24013	74071b90-f762-11e1-a439-00145eb45e9a
0	29	29	Ocean Biodiversity Information System	ba0670b9-4186-41e6-8e70-f9cb3065551a	752d6b23-d410-4bfa-8d3b-120c93fa5443
138	138	0	GBIF Germany	4f6826f2-4ff6-443d-b966-e6913bd24013	75c3735c-f762-11e1-a439-00145eb45e9a
214	214	0	GBIF France	da44cd31-5901-4687-a106-6d1c7734ee3a	7b14013a-9a70-44e0-83d3-2550d6739ab0
0	9	9	Plazi	ffb07bec-2d10-492d-9c37-361fe0b79427	7c38765a-9feb-4ff5-910a-96166cb0915b
7598	7598	0	GBIF Germany	4f6826f2-4ff6-443d-b966-e6913bd24013	7c66d50a-f762-11e1-a439-00145eb45e9a
871	860	-11	GBIF Germany	4f6826f2-4ff6-443d-b966-e6913bd24013	7cd2fd02-f762-11e1-a439-00145eb45e9a
2365	2365	0	GBIF Germany	4f6826f2-4ff6-443d-b966-e6913bd24013	7e766ce8-f762-11e1-a439-00145eb45e9a
512	512	0	GBIF Germany	4f6826f2-4ff6-443d-b966-e6913bd24013	7eeab31e-f762-11e1-a439-00145eb45e9a
944	944	0	GBIF Germany	4f6826f2-4ff6-443d-b966-e6913bd24013	7f1ce352-f762-11e1-a439-00145eb45e9a
797	797	0	GBIF Germany	4f6826f2-4ff6-443d-b966-e6913bd24013	7f2ffa0a-f762-11e1-a439-00145eb45e9a
120	120	0	Biodiversity Information System of Mexico	b324e8e9-9a4c-44fa-8f1a-7f39ea7ab576	7f88eb10-f762-11e1-a439-00145eb45e9a
1740	1740	0	Biodiversity Information System of Mexico	b324e8e9-9a4c-44fa-8f1a-7f39ea7ab576	80488236-f762-11e1-a439-00145eb45e9a
2734	2558	-176	Biodiversity Information System of Mexico	b324e8e9-9a4c-44fa-8f1a-7f39ea7ab576	80a10230-f762-11e1-a439-00145eb45e9a
432	432	0	GBIF Germany	4f6826f2-4ff6-443d-b966-e6913bd24013	819c7138-f762-11e1-a439-00145eb45e9a
8579	4949	-3630	GBIF Germany	4f6826f2-4ff6-443d-b966-e6913bd24013	81e0628a-f762-11e1-a439-00145eb45e9a
355	355	0	GBIF Germany	4f6826f2-4ff6-443d-b966-e6913bd24013	8213e344-f762-11e1-a439-00145eb45e9a
22	22	0	GBIF Germany	4f6826f2-4ff6-443d-b966-e6913bd24013	827eaa30-f762-11e1-a439-00145eb45e9a
19125	19125	0	GBIF Spain	1f94b3ca-9345-4d65-afe2-4bace93aa0fe	837381f4-f762-11e1-a439-00145eb45e9a
13	13	0	Plazi	ffb07bec-2d10-492d-9c37-361fe0b79427	84104762-a138-4a64-8840-c166faa8d792
0	1	1	Ocean Biodiversity Information System	ba0670b9-4186-41e6-8e70-f9cb3065551a	8432265c-20b0-4971-9348-1fb25d77c6c4
13427	13427	0	Biodiversity Information System of Mexico	b324e8e9-9a4c-44fa-8f1a-7f39ea7ab576	8502ed8e-f762-11e1-a439-00145eb45e9a
441	441	0	GBIF Guinea	b1cd2e84-c4ba-47bd-b72a-dfd1f92dce0a	8683300c-72bb-4c0c-ae16-a5b2d6761c51
515	276	-239	GBIF Germany	4f6826f2-4ff6-443d-b966-e6913bd24013	86dccb16-f762-11e1-a439-00145eb45e9a
307	130	-177	GBIF Germany	4f6826f2-4ff6-443d-b966-e6913bd24013	86df70be-f762-11e1-a439-00145eb45e9a
79	53	-26	GBIF Germany	4f6826f2-4ff6-443d-b966-e6913bd24013	87641602-f762-11e1-a439-00145eb45e9a
11239	11239	0	Atlas of Living Australia	4a6f1b71-969e-4fc5-a693-282b05e1220c	8810b12b-7a24-403e-8b44-bf3848badb35
0	1	1	Plazi	ffb07bec-2d10-492d-9c37-361fe0b79427	8909cb94-1c61-49d5-8383-93552584819d
111	111	0	GBIF Germany	4f6826f2-4ff6-443d-b966-e6913bd24013	8a50c342-f762-11e1-a439-00145eb45e9a
141	141	0	GBIF Germany	4f6826f2-4ff6-443d-b966-e6913bd24013	8a695c72-f762-11e1-a439-00145eb45e9a
70	56	-14	GBIF Germany	4f6826f2-4ff6-443d-b966-e6913bd24013	8c5f2a2a-f762-11e1-a439-00145eb45e9a
151	30	-121	GBIF Germany	4f6826f2-4ff6-443d-b966-e6913bd24013	8de2e03a-f762-11e1-a439-00145eb45e9a
33	29	-4	GBIF Germany	4f6826f2-4ff6-443d-b966-e6913bd24013	8e139bee-f762-11e1-a439-00145eb45e9a
125	74	-51	GBIF Germany	4f6826f2-4ff6-443d-b966-e6913bd24013	8ea8824a-f762-11e1-a439-00145eb45e9a
0	128	128	Plazi	ffb07bec-2d10-492d-9c37-361fe0b79427	90096587-f239-4a8e-96a6-f7a2e92dc30d
4	4	0	Plazi	ffb07bec-2d10-492d-9c37-361fe0b79427	9032e1fb-864e-48fc-a4b9-de670d73543a
57	31	-26	GBIF Germany	4f6826f2-4ff6-443d-b966-e6913bd24013	924e7efe-f762-11e1-a439-00145eb45e9a
3891	3894	3	GBIF Brazil	cdc9736d-5ff7-4ece-9959-3c744360cdb3	9256fdee-1799-46f5-aec0-bf8b1bb0271e
13126	13126	0	GBIF Brazil	cdc9736d-5ff7-4ece-9959-3c744360cdb3	93304e67-d933-459f-a5fb-3e36986d6c02
1589	1589	0	Ocean Biodiversity Information System	ba0670b9-4186-41e6-8e70-f9cb3065551a	95d1abe6-f762-11e1-a439-00145eb45e9a
10898	10898	0	Biodiversity Information System of Mexico	b324e8e9-9a4c-44fa-8f1a-7f39ea7ab576	9705d67f-9592-4b49-a86f-79ae6bd4d8e7
0	14	14	Plazi	ffb07bec-2d10-492d-9c37-361fe0b79427	9950dbcc-5627-479c-b9e7-abe6b8a0ddd1
16	16	0	GBIF France	da44cd31-5901-4687-a106-6d1c7734ee3a	9b3fb6c5-53f8-4905-825f-6289e782a25b
0	55	55	Ocean Biodiversity Information System	ba0670b9-4186-41e6-8e70-f9cb3065551a	9ede61ec-acd7-465d-a15a-436164908777
0	88	88	Ocean Biodiversity Information System	ba0670b9-4186-41e6-8e70-f9cb3065551a	a5e490a6-4aaf-4f4c-8c67-9f101c130ae7
0	15	15	Plazi	ffb07bec-2d10-492d-9c37-361fe0b79427	a678e684-c00b-442e-b1bd-6b967911ea55
229	229	0	National Biodiversity Network	d897a5b9-35ee-4232-94bd-b0bcaac003c2	a74b4cf0-0076-4823-be22-d7abde85f3ef
0	3	3	Plazi	ffb07bec-2d10-492d-9c37-361fe0b79427	a811a35e-e3f5-493e-ba1a-e425ef384275
11	11	0	Plazi	ffb07bec-2d10-492d-9c37-361fe0b79427	a82678c2-737a-4151-b9f9-2c52e8765689
3	3	0	Plazi	ffb07bec-2d10-492d-9c37-361fe0b79427	a884a6a0-b724-4f40-8e8d-4e17db57dc6c
214	214	0	Colombian Biodiversity Information System	7e865cba-7c46-417b-ade5-97f2cf5b7be0	aa22a917-cb52-496c-a9eb-a663eb5ebeea
63	63	0	Plazi	ffb07bec-2d10-492d-9c37-361fe0b79427	aa446d35-b5ef-4885-8bb8-8ddcc1f2e2da
3	3	0	Plazi	ffb07bec-2d10-492d-9c37-361fe0b79427	ab631904-af4d-4ce1-b767-179001569423
63985	63985	0	National Biodiversity Data Centre	422b00b2-6c94-4bb6-976b-c359916efdb8	ac1a6843-ac40-4073-bfb1-8ffaa4b73b66
41	41	0	Secretariat of the Pacific Regional Environment Programme	29c6a139-ea7f-41f5-8d9b-c55af8736182	ac35ac8a-ef2c-4920-8e93-3f72ed662ce2
31329	31349	20	U.S. Geological Survey	8618c64a-93e0-4300-b546-7249e5148ed2	ad0d4b56-c620-45a5-9152-7a0da3bd48e8
4	4	0	Participant Node Managers Committee	7f48e0c8-5c96-49ec-b972-30748e339115	aefbcae7-fff6-4065-9120-626edcc200b4
0	2	2	Plazi	ffb07bec-2d10-492d-9c37-361fe0b79427	af5b4a79-9368-4ee3-ab5d-9af9fa89ed0e
10	10	0	Plazi	ffb07bec-2d10-492d-9c37-361fe0b79427	b1ea5894-cd8c-4f21-a68f-8bf108fde0ae
536	536	0	Colombian Biodiversity Information System	7e865cba-7c46-417b-ade5-97f2cf5b7be0	b4d54475-fafd-4cd8-a3e4-d47a019d334d
34258	34258	0	GBIF Germany	4f6826f2-4ff6-443d-b966-e6913bd24013	b7ec1bf8-819b-11e2-bad2-00145eb45e9a
137753	137753	0	South African Biodiversity Information Facility	7190b835-4e86-4b6e-85c1-19cc6677c250	b94fcfd1-f3a5-44bc-bc50-d3e5f80a733d
744	744	0	GBIF France	da44cd31-5901-4687-a106-6d1c7734ee3a	bb61b739-cf31-480e-bf77-4b57f1c20ee6
198	198	0	National Biodiversity Network	d897a5b9-35ee-4232-94bd-b0bcaac003c2	bbe026fa-d7c5-4c63-9028-c15fe9771dd4
824	824	0	GBIF Germany	4f6826f2-4ff6-443d-b966-e6913bd24013	bddc2bf8-1dc1-474f-b89f-c1485cde6ae6
1899	1899	0	National Biodiversity Network	d897a5b9-35ee-4232-94bd-b0bcaac003c2	bebb473e-8f75-43b2-bbad-b600e23f502c
513	513	0	National Biodiversity Network	d897a5b9-35ee-4232-94bd-b0bcaac003c2	bf28ab6f-ad1a-4676-8a0a-edbf44e0fdb3
297	297	0	GBIF France	da44cd31-5901-4687-a106-6d1c7734ee3a	c3022102-10cc-41dc-949a-e8f3c7817af1
342	342	0	GBIF Spain	1f94b3ca-9345-4d65-afe2-4bace93aa0fe	c5e5ebd4-6771-4abb-8d1d-b09be1b911e0
46	46	0	Participant Node Managers Committee	7f48e0c8-5c96-49ec-b972-30748e339115	c5f1ca2b-da1a-468a-9b85-f690ef0d4a81
4	4	0	Participant Node Managers Committee	7f48e0c8-5c96-49ec-b972-30748e339115	c847dc2a-049b-442c-85ac-20c27cb4f634
0	1476	1476	Plazi	ffb07bec-2d10-492d-9c37-361fe0b79427	c93b6c76-aaac-4fcd-acca-3dc3e0fd62d4
34	34	0	Plazi	ffb07bec-2d10-492d-9c37-361fe0b79427	cc295ad8-e212-4a55-8edb-a16f08c18479
502065	524442	22377	U.S. Geological Survey	8618c64a-93e0-4300-b546-7249e5148ed2	cd096ec0-a8a0-4c65-92cc-48b00fb934ce
0	13	13	Ocean Biodiversity Information System	ba0670b9-4186-41e6-8e70-f9cb3065551a	ce4ace31-d89c-4bdf-a81f-2dd0d8a74bb7
1	1	0	Plazi	ffb07bec-2d10-492d-9c37-361fe0b79427	d2a94ad1-4982-47c0-8487-5d881e29b324
0	1882	1882	Ocean Biodiversity Information System	ba0670b9-4186-41e6-8e70-f9cb3065551a	d363a174-57b9-4fae-95be-09cbdee5256b
553	553	0	Plazi	ffb07bec-2d10-492d-9c37-361fe0b79427	d37ec798-2cd3-4f94-9a80-808ebf53beaa
1053	1053	0	GBIF Germany	4f6826f2-4ff6-443d-b966-e6913bd24013	d38ad947-5e7f-4f60-b8f4-cea5ac95b791
17	17	0	Plazi	ffb07bec-2d10-492d-9c37-361fe0b79427	d607c042-aa49-426b-a430-ee3a3b27d913
0	131	131	Participant Node Managers Committee	7f48e0c8-5c96-49ec-b972-30748e339115	d74319fc-8c84-4e1f-ab9c-20a60f3d2ba6
15	15	0	Secretariat of the Pacific Regional Environment Programme	29c6a139-ea7f-41f5-8d9b-c55af8736182	d91b392e-bb9d-4fb2-99d8-6053e1ade94f
5	5	0	Plazi	ffb07bec-2d10-492d-9c37-361fe0b79427	dc0fa291-6c9c-4a72-b509-79d26c302e4a
0	4	4	Plazi	ffb07bec-2d10-492d-9c37-361fe0b79427	dd03244d-a241-4d58-9ade-094fafb78310
0	13	13	Plazi	ffb07bec-2d10-492d-9c37-361fe0b79427	dd881f88-41be-4ce3-b673-133d259f836b
11704	11704	0	Biodiversity Information System of Mexico	b324e8e9-9a4c-44fa-8f1a-7f39ea7ab576	e252a933-8a2d-4591-933d-d235e07752d8
50	50	0	Participant Node Managers Committee	7f48e0c8-5c96-49ec-b972-30748e339115	e263d166-a977-4ece-aa46-a177c165bb8c
1	1	0	Atlas of Living Australia	4a6f1b71-969e-4fc5-a693-282b05e1220c	e6e6cdd6-964c-406c-bd9b-b989e95640c5
3	3	0	Korean Biodiversity Information Facility	e0a1e772-0177-4800-94b4-2d023fe6cdf4	e83530dd-2124-4bf9-811a-e8e5a5d666f2
46883	45888	-995	Biodiversity Information System of Mexico	b324e8e9-9a4c-44fa-8f1a-7f39ea7ab576	eb2be3c8-8b4e-4bf6-b989-f4b0c4482c0c
2	2	0	Plazi	ffb07bec-2d10-492d-9c37-361fe0b79427	ebae3f0a-5139-40f6-9a16-f20051e659dc
5922	5922	0	Participant Node Managers Committee	7f48e0c8-5c96-49ec-b972-30748e339115	f0ecd5eb-bc62-40fe-ab53-294cbb34a290
143	143	0	Plazi	ffb07bec-2d10-492d-9c37-361fe0b79427	f1be4566-adeb-4995-83c7-2aebab3c7458
252	189	-63	GBIF Germany	4f6826f2-4ff6-443d-b966-e6913bd24013	f222d028-5d57-4be8-9c93-7227c293a488
1214	1261	47	GBIF Germany	4f6826f2-4ff6-443d-b966-e6913bd24013	f440262c-1d2c-11e2-8fd4-00145eb45e9a
0	8	8	Plazi	ffb07bec-2d10-492d-9c37-361fe0b79427	f4e5d46b-f053-4298-ac30-7902e8e5a8a7
53961	53961	0	National Biodiversity Network	d897a5b9-35ee-4232-94bd-b0bcaac003c2	f674de32-f52a-4e4b-a89b-a7b227f4495a
1350	1350	0	Belgian Biodiversity Platform	fb11cfe1-ebc3-45af-9159-17d9fddbcdac	f6c83992-27ff-11e2-85e3-00145eb45e9a
0	79	79	Participant Node Managers Committee	7f48e0c8-5c96-49ec-b972-30748e339115	f6cf826c-76f1-445c-8373-2743d57051b7
5086	5086	0	National Biodiversity Network	d897a5b9-35ee-4232-94bd-b0bcaac003c2	f84595d5-3b0e-4bfa-a30f-8a1392d6b26a
0	42	42	Plazi	ffb07bec-2d10-492d-9c37-361fe0b79427	f9cb04f2-1462-4073-ad12-390dc28f8710
451	451	0	GBIF Argentina	2426a871-9feb-40a1-96c6-0c593a76b835	fa44bcc6-2ab0-42a6-941a-c5f675ef3845
313	313	0	GBIF Germany	4f6826f2-4ff6-443d-b966-e6913bd24013	fca647e3-4196-41dd-8558-1a417a7f2f4e
0	45	45	Plazi	ffb07bec-2d10-492d-9c37-361fe0b79427	fdb742b9-cb51-4c1d-ac70-947b32ce427d
4847	4847	0	GBIF Spain	1f94b3ca-9345-4d65-afe2-4bace93aa0fe	fe44aa08-0231-46d6-94d9-270673c5aedb
142	142	0	GBIF France	da44cd31-5901-4687-a106-6d1c7734ee3a	01704b54-67d6-4f10-9b4a-87846ad3becc
1260	1260	0	U.S. Geological Survey	8618c64a-93e0-4300-b546-7249e5148ed2	027a987f-7aac-4c86-9354-0f6bffe25408
5	5	0	Plazi	ffb07bec-2d10-492d-9c37-361fe0b79427	048b4397-f4e7-4ba7-97ed-bbe388873f91
0	135	135	Netherlands Biodiversity Information Facility	0909d601-bda2-42df-9e63-a6d51847ebce	054a1513-645b-42e8-9865-4609771f1787
72	72	0	GBIF Brazil	cdc9736d-5ff7-4ece-9959-3c744360cdb3	09937f1d-fea3-4d9f-835e-1a8b64ac1f12
6	6	0	National Biodiversity Network	d897a5b9-35ee-4232-94bd-b0bcaac003c2	0adc639d-6bba-482a-a1d6-168d869b085e
0	2592	2592	Participant Node Managers Committee	7f48e0c8-5c96-49ec-b972-30748e339115	0f17aeea-fe0b-40e4-9e85-0095bbeb5f1f
6	6	0	Plazi	ffb07bec-2d10-492d-9c37-361fe0b79427	10260690-a019-488b-8140-9dfe49189d5c
1	1	0	Plazi	ffb07bec-2d10-492d-9c37-361fe0b79427	1090ebc4-dff7-460a-8230-4b7c04dc9ec3
5	5	0	Plazi	ffb07bec-2d10-492d-9c37-361fe0b79427	11f51a88-bc80-452d-9e87-8860cee0bc31
7	7	0	Plazi	ffb07bec-2d10-492d-9c37-361fe0b79427	181054ca-c2cb-4948-8b53-1ded0f7d4cb8
19058	19058	0	GBIF Brazil	cdc9736d-5ff7-4ece-9959-3c744360cdb3	1aedcdff-24f2-4925-8e55-23eeef236b0d
1924	1924	0	Colombian Biodiversity Information System	7e865cba-7c46-417b-ade5-97f2cf5b7be0	1d215bab-232f-4e0a-add3-c2959815f536
5	5	0	Plazi	ffb07bec-2d10-492d-9c37-361fe0b79427	21486ce5-48a9-4b34-97fc-7892ba053a7e
0	69	69	Ocean Biodiversity Information System	ba0670b9-4186-41e6-8e70-f9cb3065551a	21edac0e-c3ec-43e9-b3ac-1bc919eb72ba
0	50	50	Plazi	ffb07bec-2d10-492d-9c37-361fe0b79427	243a784a-5175-4420-b3ca-9a05b8ca81fe
0	15	15	Plazi	ffb07bec-2d10-492d-9c37-361fe0b79427	262fb324-263e-439c-b053-442bc062a98e
0	3188	3188	U.S. Geological Survey	8618c64a-93e0-4300-b546-7249e5148ed2	2a33d6af-5b18-415f-b324-7f1ce7fae8e2
5	5	0	Plazi	ffb07bec-2d10-492d-9c37-361fe0b79427	2f14f083-5f44-4b37-b4ae-349dce957d07
7	7	0	Plazi	ffb07bec-2d10-492d-9c37-361fe0b79427	30d662e0-eefb-4493-8358-6d5e2c0196dd
4	4	0	Plazi	ffb07bec-2d10-492d-9c37-361fe0b79427	31594dee-8a84-4aa4-9994-b579bbc4bccf
1786	1786	0	GBIF Spain	1f94b3ca-9345-4d65-afe2-4bace93aa0fe	317fd0a9-1bcf-4e94-bc3c-a685c4693c10
0	5	5	Plazi	ffb07bec-2d10-492d-9c37-361fe0b79427	31b2b0f4-7954-4701-8a70-ccf7272da92b
91253	91253	0	U.S. Geological Survey	8618c64a-93e0-4300-b546-7249e5148ed2	3633e0e7-8c25-4c3d-b9c7-078c0be25665
0	39	39	Plazi	ffb07bec-2d10-492d-9c37-361fe0b79427	3a4a35a9-90aa-4c44-a5ed-059a789e2aff
273	273	0	Participant Node Managers Committee	7f48e0c8-5c96-49ec-b972-30748e339115	3e8ead6f-7701-4afa-812b-000cb23481cd
315	132	-183	Biodiversity Information System of Mexico	b324e8e9-9a4c-44fa-8f1a-7f39ea7ab576	3f0ca2d0-5656-4c1c-a33c-df3848d2b6b5
30	30	0	GBIF Norway	4f829580-180d-46a9-9c87-ed8ec959b545	41f8f918-1a6b-4e69-89d3-0f570c38a9cb
35	35	0	Plazi	ffb07bec-2d10-492d-9c37-361fe0b79427	431a0907-2b69-4c52-86c6-6a0eb0c04d2e
1	1	0	GBIF France	da44cd31-5901-4687-a106-6d1c7734ee3a	4386d017-d431-48ec-9921-6aeeaa8bf12e
4	4	0	Plazi	ffb07bec-2d10-492d-9c37-361fe0b79427	448b3c95-c1a5-41d1-910b-57aa2befcba1
2184	2184	0	GBIF Uganda	71b40829-6a12-4c3d-8fee-5746f5e9cf8c	456dd86d-2222-4f3b-83ef-75551cf7e891
0	1	1	Plazi	ffb07bec-2d10-492d-9c37-361fe0b79427	45eddfb9-8e85-4c87-aa39-f88f97912a74
32	32	0	U.S. Geological Survey	8618c64a-93e0-4300-b546-7249e5148ed2	46c2b270-6eef-485d-923d-8394dbcc6a1a
15	15	0	Plazi	ffb07bec-2d10-492d-9c37-361fe0b79427	46e517e7-516b-4810-906b-4b416e4f17e8
6	6	0	Plazi	ffb07bec-2d10-492d-9c37-361fe0b79427	4783ca8e-74d1-44b0-bdc8-caa5ea7c6603
154	154	0	Plazi	ffb07bec-2d10-492d-9c37-361fe0b79427	4913742a-fd61-412c-a4f5-5a38004e713e
7062	7062	0	Ocean Biodiversity Information System	ba0670b9-4186-41e6-8e70-f9cb3065551a	4a2b819f-c539-4362-badc-8a9c85246c26
1	1	0	Plazi	ffb07bec-2d10-492d-9c37-361fe0b79427	4a5f2411-0144-4953-bddf-81af8df6714d
166	166	0	GBIF France	da44cd31-5901-4687-a106-6d1c7734ee3a	4e6dbbe8-767a-43d4-a905-aac8f88b73d0
1075	1075	0	GBIF Germany	4f6826f2-4ff6-443d-b966-e6913bd24013	52f555c3-a335-4b57-bde7-3b11b82de9cc
1	1	0	Plazi	ffb07bec-2d10-492d-9c37-361fe0b79427	532279d4-dac5-475a-a647-5b10e12faca4
10	10	0	Plazi	ffb07bec-2d10-492d-9c37-361fe0b79427	54a11801-d3d3-4b76-9f6c-7a9c27677825
1	1	0	Plazi	ffb07bec-2d10-492d-9c37-361fe0b79427	5940a8ed-5a85-4007-9571-7dcb49c06fed
47677	49298	1621	National Biodiversity Network	d897a5b9-35ee-4232-94bd-b0bcaac003c2	59d85f16-784f-4c9f-be86-23fe130bedcb
0	13	13	Plazi	ffb07bec-2d10-492d-9c37-361fe0b79427	5a33d36a-0067-4d99-8dd4-a7a13e50f87b
17603	17603	0	GBIF France	da44cd31-5901-4687-a106-6d1c7734ee3a	5a75aafc-9ddf-4c43-b30a-af7f80ecee49
73	73	0	GBIF France	da44cd31-5901-4687-a106-6d1c7734ee3a	5cf98942-5cae-40a1-afbe-671d20ac358a
1138	2894	1756	U.S. Geological Survey	8618c64a-93e0-4300-b546-7249e5148ed2	5e4a4046-2946-465d-b15a-29ad9d70238d
23	23	0	Plazi	ffb07bec-2d10-492d-9c37-361fe0b79427	5ee1a7ef-099c-45aa-9881-6d9af6695b95
0	96	96	Plazi	ffb07bec-2d10-492d-9c37-361fe0b79427	5f279ac2-63c6-4bd8-be9e-0e3d82b73ab2
0	5883	5883	GBIF Japan	db5705aa-6a6e-42f1-8942-d77b9f4896ea	5f7aeace-46b9-4516-8b1e-09650aee9024
2	2	0	Plazi	ffb07bec-2d10-492d-9c37-361fe0b79427	6008c127-eb17-4f05-8717-257e97a8f368
47	47	0	GBIF Germany	4f6826f2-4ff6-443d-b966-e6913bd24013	623b45c6-f762-11e1-a439-00145eb45e9a
0	2	2	Plazi	ffb07bec-2d10-492d-9c37-361fe0b79427	6286e4f2-b78c-4fa6-a3ba-e47758c9ff99
83084	83084	0	GBIF France	da44cd31-5901-4687-a106-6d1c7734ee3a	6318161e-024b-4cf5-b08b-1ba1c98a5c51
9	9	0	Plazi	ffb07bec-2d10-492d-9c37-361fe0b79427	636d6b67-0587-4c24-ad05-a5762cc6fd25
18	18	0	Plazi	ffb07bec-2d10-492d-9c37-361fe0b79427	644ee467-9544-4ba4-9871-eeb52b2cdcc4
14	14	0	Plazi	ffb07bec-2d10-492d-9c37-361fe0b79427	6470913c-0ff8-4826-884d-836f1e67aab7
352	352	0	Participant Node Managers Committee	7f48e0c8-5c96-49ec-b972-30748e339115	650c9173-80c4-4583-ac81-97ee14f76590
40	40	0	GBIF Germany	4f6826f2-4ff6-443d-b966-e6913bd24013	6587fc56-f762-11e1-a439-00145eb45e9a
29	29	0	Plazi	ffb07bec-2d10-492d-9c37-361fe0b79427	65a5e6d8-d655-4949-8f4f-f5fc7930f5f4
66	66	0	GBIF Germany	4f6826f2-4ff6-443d-b966-e6913bd24013	66875d9a-f762-11e1-a439-00145eb45e9a
50	50	0	GBIF Germany	4f6826f2-4ff6-443d-b966-e6913bd24013	669a8c08-f762-11e1-a439-00145eb45e9a
71	71	0	GBIF Germany	4f6826f2-4ff6-443d-b966-e6913bd24013	66ad6efe-f762-11e1-a439-00145eb45e9a
142	142	0	GBIF Germany	4f6826f2-4ff6-443d-b966-e6913bd24013	673626e0-f762-11e1-a439-00145eb45e9a
212	212	0	GBIF Germany	4f6826f2-4ff6-443d-b966-e6913bd24013	682b390a-f762-11e1-a439-00145eb45e9a
9	9	0	Plazi	ffb07bec-2d10-492d-9c37-361fe0b79427	69ea9bc8-9500-498e-bc64-cdfc023f82ba
2355	2355	0	GBIF Argentina	2426a871-9feb-40a1-96c6-0c593a76b835	6a1d69f5-961b-4825-8efc-858f80ba3cb1
0	2	2	Plazi	ffb07bec-2d10-492d-9c37-361fe0b79427	6b99872c-396a-4f44-bf40-9a7b50470219
1	1	0	Plazi	ffb07bec-2d10-492d-9c37-361fe0b79427	6cad922f-a8be-4fe9-980d-1f91bc1ffd77
4	4	0	Plazi	ffb07bec-2d10-492d-9c37-361fe0b79427	6fad5a3e-dbba-4232-ae25-515d63e89f81
69	69	0	GBIF Germany	4f6826f2-4ff6-443d-b966-e6913bd24013	73a0ba6c-f762-11e1-a439-00145eb45e9a
0	4	4	Plazi	ffb07bec-2d10-492d-9c37-361fe0b79427	73b00bc2-f347-4f1e-82fb-2cb6d375b973
11	11	0	GBIF Germany	4f6826f2-4ff6-443d-b966-e6913bd24013	73cd8a6a-f762-11e1-a439-00145eb45e9a
505	505	0	National Biodiversity Data Centre	422b00b2-6c94-4bb6-976b-c359916efdb8	74615e5f-2003-4c06-80a3-829d1b2e034d
139	139	0	GBIF Germany	4f6826f2-4ff6-443d-b966-e6913bd24013	74ff4392-f762-11e1-a439-00145eb45e9a
70	49	-21	GBIF Germany	4f6826f2-4ff6-443d-b966-e6913bd24013	77619126-f762-11e1-a439-00145eb45e9a
1480	1480	0	GBIF Germany	4f6826f2-4ff6-443d-b966-e6913bd24013	776b9ffe-f762-11e1-a439-00145eb45e9a
38	38	0	National Biodiversity Network	d897a5b9-35ee-4232-94bd-b0bcaac003c2	777672dd-d6f2-46fc-9ad6-6f5d4a315b4f
14897	14897	0	GBIF Norway	4f829580-180d-46a9-9c87-ed8ec959b545	789d286b-73b7-4d8c-a8c6-7a2cfe84a576
277	277	0	GBIF Germany	4f6826f2-4ff6-443d-b966-e6913bd24013	792a75f4-f762-11e1-a439-00145eb45e9a
0	2	2	Plazi	ffb07bec-2d10-492d-9c37-361fe0b79427	798f1faa-8f10-4529-afc5-0253b37843c2
439	439	0	Colombian Biodiversity Information System	7e865cba-7c46-417b-ade5-97f2cf5b7be0	79f51633-b5e8-47c5-be29-f631b75f8d47
171	188	17	GBIF Germany	4f6826f2-4ff6-443d-b966-e6913bd24013	7a62b3b4-f762-11e1-a439-00145eb45e9a
1	1	0	GBIF Germany	4f6826f2-4ff6-443d-b966-e6913bd24013	7a64f444-f762-11e1-a439-00145eb45e9a
57	57	0	GBIF Germany	4f6826f2-4ff6-443d-b966-e6913bd24013	7a9d6c98-f762-11e1-a439-00145eb45e9a
80	80	0	National Biodiversity Network	d897a5b9-35ee-4232-94bd-b0bcaac003c2	7aa07e6c-20bc-4d81-bf4d-88cc0fc3472c
258397	258397	0	South African Biodiversity Information Facility	7190b835-4e86-4b6e-85c1-19cc6677c250	7b468209-8d5c-477b-b118-cdf04dde9912
157	157	0	GBIF Germany	4f6826f2-4ff6-443d-b966-e6913bd24013	7c1e39a8-f762-11e1-a439-00145eb45e9a
64	64	0	GBIF Germany	4f6826f2-4ff6-443d-b966-e6913bd24013	7cc8c760-f762-11e1-a439-00145eb45e9a
5	5	0	Plazi	ffb07bec-2d10-492d-9c37-361fe0b79427	7de56b9f-14ce-4d82-ba26-6bf06a1a3332
191	191	0	GBIF Germany	4f6826f2-4ff6-443d-b966-e6913bd24013	7f3c7226-f762-11e1-a439-00145eb45e9a
276	662	386	Colombian Biodiversity Information System	7e865cba-7c46-417b-ade5-97f2cf5b7be0	7f9161a5-3d90-4d07-9e95-433f0d9e0afe
181	139	-42	GBIF Germany	4f6826f2-4ff6-443d-b966-e6913bd24013	81c3f4ba-f762-11e1-a439-00145eb45e9a
6	6	0	Plazi	ffb07bec-2d10-492d-9c37-361fe0b79427	81caaacd-6f55-4ffd-aa25-04bd3a032f7d
0	2	2	Plazi	ffb07bec-2d10-492d-9c37-361fe0b79427	82465541-d9bb-4ca7-a823-860f22cc6c71
2410	2410	0	GBIF France	da44cd31-5901-4687-a106-6d1c7734ee3a	8315aecd-b5a6-4b75-af3e-acb8600a7859
0	10	10	Plazi	ffb07bec-2d10-492d-9c37-361fe0b79427	8496290f-a28f-42d5-8b26-dd8d9068a243
39	39	0	GBIF Finland	dd514216-5c7c-45f3-910d-797424cb5be6	84f4df14-f762-11e1-a439-00145eb45e9a
4	4	0	Plazi	ffb07bec-2d10-492d-9c37-361fe0b79427	8547d24d-5ff0-4946-9593-946f24086548
102	65	-37	GBIF Germany	4f6826f2-4ff6-443d-b966-e6913bd24013	87ff1332-f762-11e1-a439-00145eb45e9a
813	813	0	GBIF France	da44cd31-5901-4687-a106-6d1c7734ee3a	8965976d-fb8c-4090-a7b5-7fc4aaf5228e
240	240	0	GBIF Germany	4f6826f2-4ff6-443d-b966-e6913bd24013	8a121656-f762-11e1-a439-00145eb45e9a
1278	1278	0	DanBIF - Danish Biodiversity Information Facility	4ddd294f-02b7-4359-ac33-0806a9ca9c6b	8c3e2fd5-2c7a-4126-a5c0-b6f67c9911db
65	65	0	Plazi	ffb07bec-2d10-492d-9c37-361fe0b79427	8c5ead3e-f39f-46d7-a08a-5b1693d23df8
28	24	-4	GBIF Germany	4f6826f2-4ff6-443d-b966-e6913bd24013	8d3798a6-f762-11e1-a439-00145eb45e9a
166	149	-17	GBIF Germany	4f6826f2-4ff6-443d-b966-e6913bd24013	8d95a7c0-f762-11e1-a439-00145eb45e9a
398	210	-188	GBIF Germany	4f6826f2-4ff6-443d-b966-e6913bd24013	8db9989c-f762-11e1-a439-00145eb45e9a
2268	1215	-1053	GBIF Germany	4f6826f2-4ff6-443d-b966-e6913bd24013	8f0158ca-f762-11e1-a439-00145eb45e9a
585	315	-270	GBIF Germany	4f6826f2-4ff6-443d-b966-e6913bd24013	8f43581a-f762-11e1-a439-00145eb45e9a
20	19	-1	GBIF Germany	4f6826f2-4ff6-443d-b966-e6913bd24013	91675bb4-f762-11e1-a439-00145eb45e9a
368	169	-199	GBIF Germany	4f6826f2-4ff6-443d-b966-e6913bd24013	9191fae0-f762-11e1-a439-00145eb45e9a
0	2	2	Plazi	ffb07bec-2d10-492d-9c37-361fe0b79427	9323e0c4-0d16-4447-9820-027068aa11e6
790	760	-30	GBIF Germany	4f6826f2-4ff6-443d-b966-e6913bd24013	935a1e70-f762-11e1-a439-00145eb45e9a
400	400	0	GBIF Germany	4f6826f2-4ff6-443d-b966-e6913bd24013	935c916e-f762-11e1-a439-00145eb45e9a
372	372	0	Plazi	ffb07bec-2d10-492d-9c37-361fe0b79427	9419bc9b-dbe4-426c-a34e-f0034848ff99
432	432	0	GBIF Germany	4f6826f2-4ff6-443d-b966-e6913bd24013	9437ff6a-f762-11e1-a439-00145eb45e9a
155	159	4	GBIF Germany	4f6826f2-4ff6-443d-b966-e6913bd24013	94f032ec-f762-11e1-a439-00145eb45e9a
0	4	4	Plazi	ffb07bec-2d10-492d-9c37-361fe0b79427	98c87ea8-e73f-4e81-8d08-dbc5fe158982
888	888	0	GBIF Spain	1f94b3ca-9345-4d65-afe2-4bace93aa0fe	9a57e938-3616-4f8c-985a-c9b66e7a1347
42	42	0	Plazi	ffb07bec-2d10-492d-9c37-361fe0b79427	9acf71bc-6414-4878-8af0-a64d3ec1fea6
458	458	0	Colombian Biodiversity Information System	7e865cba-7c46-417b-ade5-97f2cf5b7be0	9e87656d-d76c-4ab0-8222-8666c349650c
0	16	16	Plazi	ffb07bec-2d10-492d-9c37-361fe0b79427	9ea2be6f-f3ef-4d23-955a-8e6c8a52bf9e
2	2	0	Plazi	ffb07bec-2d10-492d-9c37-361fe0b79427	a0c45123-9373-4b1b-adc9-bf6a4796bc23
1	1	0	Plazi	ffb07bec-2d10-492d-9c37-361fe0b79427	a2e5a4b2-6a77-47c9-a881-ee0f614a2c43
0	7	7	Plazi	ffb07bec-2d10-492d-9c37-361fe0b79427	a3402c38-f320-448e-b975-cea28d316c22
51	51	0	Plazi	ffb07bec-2d10-492d-9c37-361fe0b79427	a589fd5f-6ddc-4bbb-8cd1-ea6a5828d52b
1080	1080	0	GBIF Germany	4f6826f2-4ff6-443d-b966-e6913bd24013	a6cfa228-9338-4a83-b971-53c676c9a714
0	16	16	Plazi	ffb07bec-2d10-492d-9c37-361fe0b79427	aa27961b-96fe-4053-9bfb-09edb32f95c1
43260	43260	0	GBIF Brazil	cdc9736d-5ff7-4ece-9959-3c744360cdb3	aa7a8abb-a329-4d0c-88c3-e46065bef558
21224	23315	2091	Canada Biodiversity Information Facility	8f83fc96-c966-4126-83f7-bf044dc49efa	adb7138a-32a2-42ee-a2ff-9f349515786d
0	21	21	Plazi	ffb07bec-2d10-492d-9c37-361fe0b79427	af129ee5-c45e-4f33-bdfc-4c14402580e4
6	6	0	Plazi	ffb07bec-2d10-492d-9c37-361fe0b79427	b21705d8-f93b-420c-a4b3-13f38a3ba0e7
8560	8560	0	National Biodiversity Network	d897a5b9-35ee-4232-94bd-b0bcaac003c2	b42d7c7f-43e5-4e24-abd7-fab3b4fceb09
658	658	0	GBIF Germany	4f6826f2-4ff6-443d-b966-e6913bd24013	b6ae2375-818a-47b9-b8c7-8020e6103e3e
657	657	0	GBIF Germany	4f6826f2-4ff6-443d-b966-e6913bd24013	bc0b60da-c295-4995-9b20-2f838550d241
128	128	0	Plazi	ffb07bec-2d10-492d-9c37-361fe0b79427	bcc0e0fc-b6a5-4d5a-8008-7b714c106a7c
2398	2398	0	National Biodiversity Data Centre	422b00b2-6c94-4bb6-976b-c359916efdb8	c0514295-6c2e-45b1-82d9-d936513a6664
845	845	0	Netherlands Biodiversity Information Facility	0909d601-bda2-42df-9e63-a6d51847ebce	c5fedebf-acd1-4dec-8d04-e24f7564bce6
10907	10907	0	GBIF Benin	efb9c00e-f802-45dd-8826-a52ec45b89ff	c89babc3-4e67-4cdd-84e5-dd62f1193053
699	699	0	Biodiversity Information System of Mexico	b324e8e9-9a4c-44fa-8f1a-7f39ea7ab576	c9cd9370-f5f1-455a-b001-23324a46e034
10776	10776	0	National Biodiversity Network	d897a5b9-35ee-4232-94bd-b0bcaac003c2	cbd37ef7-02ad-41ff-8e18-459c70bf92df
2267	2267	0	GBIF France	da44cd31-5901-4687-a106-6d1c7734ee3a	cc836c63-4d5e-4a58-a52d-7230443ad7ba
3	3	0	Plazi	ffb07bec-2d10-492d-9c37-361fe0b79427	cd8c1df0-d3cd-4d23-804a-54b2ca87f63a
983	983	0	National Biodiversity Network	d897a5b9-35ee-4232-94bd-b0bcaac003c2	cdbffbc6-b548-46ad-9d65-8c924dd9d06f
4	4	0	Plazi	ffb07bec-2d10-492d-9c37-361fe0b79427	d0ed2a63-31e5-4aa5-a359-4a924c96825b
385	385	0	Colombian Biodiversity Information System	7e865cba-7c46-417b-ade5-97f2cf5b7be0	d1cf8e5c-d4c4-42fb-a499-d995ea02ed8c
4399	4399	0	Biodiversity Information System of Mexico	b324e8e9-9a4c-44fa-8f1a-7f39ea7ab576	d9bceb64-0334-43e8-868e-72d4cd506ca1
0	2	2	Plazi	ffb07bec-2d10-492d-9c37-361fe0b79427	dd7b9f65-af28-4d7e-94d3-9e9c9b1be17f
841	841	0	GBIF France	da44cd31-5901-4687-a106-6d1c7734ee3a	ddca6af6-b02a-42d8-867f-ed5103120378
118	118	0	GBIF France	da44cd31-5901-4687-a106-6d1c7734ee3a	df867011-d21b-4f1f-9706-f6c7bad91517
31669	31669	0	GBIF Finland	dd514216-5c7c-45f3-910d-797424cb5be6	e16a9392-b28a-47e9-a92a-f20c240f39a4
1209	1209	0	National Biodiversity Network	d897a5b9-35ee-4232-94bd-b0bcaac003c2	e1f0ae30-ec56-404d-a777-ea6bbb389e2e
495	495	0	Indonesian Biodiversity Information Facility	2ebd91f6-f14f-4375-b525-c011a3774f03	e40070cf-6626-4cd0-8e85-cfe6067aecb0
3	3	0	Plazi	ffb07bec-2d10-492d-9c37-361fe0b79427	e463bdca-f112-4659-a367-056e6df0e902
54	54	0	Colombian Biodiversity Information System	7e865cba-7c46-417b-ade5-97f2cf5b7be0	e567893d-732b-4a2d-b5de-b3632ebc0aaa
0	3928	3928	Ocean Biodiversity Information System	ba0670b9-4186-41e6-8e70-f9cb3065551a	e6646829-acac-4c33-b185-8d40fcb9329c
1327	1327	0	Biodiversity Information System of Mexico	b324e8e9-9a4c-44fa-8f1a-7f39ea7ab576	e8989ab2-94dc-4570-9783-c3ab92300872
211	211	0	Plazi	ffb07bec-2d10-492d-9c37-361fe0b79427	e9339680-76a0-4c9d-90fd-ecab97b50d9e
607	607	0	GBIF Japan	db5705aa-6a6e-42f1-8942-d77b9f4896ea	eb17608f-f047-4742-b079-ea02f94d9521
118848	119360	512	U.S. Geological Survey	8618c64a-93e0-4300-b546-7249e5148ed2	ec0ad39f-3370-4d51-a663-cb27abd2a6bb
63	63	0	GBIF Germany	4f6826f2-4ff6-443d-b966-e6913bd24013	ee739f75-e7b3-4f21-be1f-062b1ff94c78
9	9	0	Plazi	ffb07bec-2d10-492d-9c37-361fe0b79427	f0220db8-239d-4f55-bdeb-4092c878ddbd
2014	1048	-966	GBIF Germany	4f6826f2-4ff6-443d-b966-e6913bd24013	f1c971c3-cb87-4b0c-aa03-b332c0eee41f
3077	3080	3	U.S. Geological Survey	8618c64a-93e0-4300-b546-7249e5148ed2	f85f5c5c-ce02-4337-9317-23fe54769ff2
1	1	0	GBIF France	da44cd31-5901-4687-a106-6d1c7734ee3a	f8e4dbd8-3ef6-4559-a615-c20219ab9022
3529	3529	0	Taiwan Biodiversity Information Facility	e1b85abc-61f9-430f-ba79-6813dec53a0f	f9382ea5-fdd1-4398-a275-75dd880ee876
0	7	7	Plazi	ffb07bec-2d10-492d-9c37-361fe0b79427	fb164ee8-9d7c-4c16-b552-86d57d39343b
19	19	0	Plazi	ffb07bec-2d10-492d-9c37-361fe0b79427	00708987-025c-40f4-b088-eeaf9db21cf0
80	80	0	Plazi	ffb07bec-2d10-492d-9c37-361fe0b79427	01eab137-57cf-4d19-87d9-0427cd4e0862
0	5	5	Plazi	ffb07bec-2d10-492d-9c37-361fe0b79427	02f3688b-c8fb-446b-a79f-ba187f6b2b42
9	9	0	Plazi	ffb07bec-2d10-492d-9c37-361fe0b79427	047625bd-d780-4ec9-b46b-774d07566f94
0	4	4	Plazi	ffb07bec-2d10-492d-9c37-361fe0b79427	08ffd262-ba20-4df7-a7ea-b0e9dc80eedb
149	149	0	Plazi	ffb07bec-2d10-492d-9c37-361fe0b79427	0b803003-244e-4511-aaf4-5e9c3f863861
13	13	0	Plazi	ffb07bec-2d10-492d-9c37-361fe0b79427	0d3a951d-6218-42b7-a6a6-40b518063062
1	1	0	Plazi	ffb07bec-2d10-492d-9c37-361fe0b79427	0d4045a3-6893-4e58-be64-fb51b1c785c4
96	96	0	GBIF France	da44cd31-5901-4687-a106-6d1c7734ee3a	0de7a61d-4355-4d98-92da-728847741f9b
15	15	0	GBIF Germany	4f6826f2-4ff6-443d-b966-e6913bd24013	10c247e8-95c5-4561-b821-993be20ff6b4
1087	1087	0	Belgian Biodiversity Platform	fb11cfe1-ebc3-45af-9159-17d9fddbcdac	197da145-4985-4ff4-81e2-0701a1c47afa
0	3	3	Plazi	ffb07bec-2d10-492d-9c37-361fe0b79427	1993188e-5b86-4dd7-bc06-97c70dadfc90
593	593	0	Plazi	ffb07bec-2d10-492d-9c37-361fe0b79427	1a35d13d-57fb-4944-80b7-c73bb58274e4
357	357	0	Ocean Biodiversity Information System	ba0670b9-4186-41e6-8e70-f9cb3065551a	1a546878-7cf6-47b4-a5c9-350486122d5a
12	12	0	Plazi	ffb07bec-2d10-492d-9c37-361fe0b79427	1b1c291c-29f8-45e0-9f98-f4edb1dbaae6
0	27	27	Plazi	ffb07bec-2d10-492d-9c37-361fe0b79427	1b930930-c0cc-41e6-88dc-b26fe4a89992
0	1	1	Plazi	ffb07bec-2d10-492d-9c37-361fe0b79427	1d24d7bf-7d11-45a1-affa-78b827d9911b
9700	9700	0	National Biodiversity Network	d897a5b9-35ee-4232-94bd-b0bcaac003c2	1d44c7cb-33bb-4198-bdba-9114d10a68f0
0	8	8	Plazi	ffb07bec-2d10-492d-9c37-361fe0b79427	1f50165d-aba3-4f5f-b0c0-6b9dd457e2a4
0	11	11	Plazi	ffb07bec-2d10-492d-9c37-361fe0b79427	2055f347-d478-4d50-aad0-7e78c4b3b9c5
10	10	0	Plazi	ffb07bec-2d10-492d-9c37-361fe0b79427	20785585-7980-4fb6-a3ff-fe09c0e74d08
0	76	76	Plazi	ffb07bec-2d10-492d-9c37-361fe0b79427	25d73144-c90c-45c3-a9a2-2454f87a9aef
312	312	0	National Biodiversity Network	d897a5b9-35ee-4232-94bd-b0bcaac003c2	25e0324b-0cfd-4b70-9a6d-6690de6a56b1
585	585	0	GBIF Finland	dd514216-5c7c-45f3-910d-797424cb5be6	2921929f-1f8c-429e-8be9-ff47bc581078
182	182	0	GBIF Germany	4f6826f2-4ff6-443d-b966-e6913bd24013	2c45d177-79d2-482d-8d52-2d5b0d542421
7	7	0	Plazi	ffb07bec-2d10-492d-9c37-361fe0b79427	2c6b6e14-1bc7-4ee6-9750-11c534af7e7c
21	21	0	Plazi	ffb07bec-2d10-492d-9c37-361fe0b79427	2c77324f-391c-4357-bd85-0dc6c7dcb99d
0	835	835	GBIF Spain	1f94b3ca-9345-4d65-afe2-4bace93aa0fe	2fb0b491-a53a-40ee-98ef-d3e9a377c9b8
188885	188885	0	GBIF Brazil	cdc9736d-5ff7-4ece-9959-3c744360cdb3	318730e8-4140-4297-b03c-4d34d0b6e0bd
1930	1945	15	National Biodiversity Network	d897a5b9-35ee-4232-94bd-b0bcaac003c2	32fc6edb-1636-4ca6-894c-40670484f792
1	1	0	Plazi	ffb07bec-2d10-492d-9c37-361fe0b79427	33840297-d50e-456c-be48-e464c9bed8ab
33614	33614	0	National Biodiversity Network	d897a5b9-35ee-4232-94bd-b0bcaac003c2	344ae7aa-c03d-4330-9450-66c60e5518a8
0	6673	6673	Participant Node Managers Committee	7f48e0c8-5c96-49ec-b972-30748e339115	3dd06b2d-fbe5-4000-9001-5efe3da4aa5f
5	5	0	Plazi	ffb07bec-2d10-492d-9c37-361fe0b79427	3fc67c4b-ac2e-47e9-b7ce-9d7883cd7080
0	6	6	Plazi	ffb07bec-2d10-492d-9c37-361fe0b79427	4288e78b-66b6-42f4-87a8-6e3fab985ddd
24	24	0	Plazi	ffb07bec-2d10-492d-9c37-361fe0b79427	4a3c3d05-da85-48ec-8fa3-1a855dc7121e
43	43	0	Plazi	ffb07bec-2d10-492d-9c37-361fe0b79427	4d48d52e-6505-4f62-909f-5da5c2cfb489
163	163	0	Colombian Biodiversity Information System	7e865cba-7c46-417b-ade5-97f2cf5b7be0	4f0327bb-d1e2-4692-a893-7c09d9f2bf68
297	297	0	National Biodiversity Network	d897a5b9-35ee-4232-94bd-b0bcaac003c2	4f87d016-18ed-4d99-954b-5c84649c02b5
9011	9011	0	GBIF Kenya	2a44d626-9f7a-4120-8a7a-4ab5ac15ff2a	507c5b51-1f83-4c7f-9111-94fb255adfd7
71	71	0	GBIF Portugal	673f7038-4262-4149-b753-5658a4e912f6	50942caf-a62e-44c7-9998-e2a949aa85b2
10	10	0	Biodiversity Information System of Mexico	b324e8e9-9a4c-44fa-8f1a-7f39ea7ab576	510acddb-63e7-4dec-bcf8-e22e4fa60d76
7868	7868	0	GBIF France	da44cd31-5901-4687-a106-6d1c7734ee3a	528ad5f2-b6d4-4ea6-89a1-ddfafee4ec45
0	2	2	Plazi	ffb07bec-2d10-492d-9c37-361fe0b79427	52f7bc82-d4e6-45c3-9c6c-b7af2c0e55f1
205	205	0	Albertine Rift Conservation Society	90a939d3-e99c-4f6d-915f-2616423b3735	569ccbb8-79b7-4fbc-902d-5d295bf10d36
128	128	0	Plazi	ffb07bec-2d10-492d-9c37-361fe0b79427	5920d575-69e3-45ef-bf81-10859e823214
2	2	0	Plazi	ffb07bec-2d10-492d-9c37-361fe0b79427	598c5fbc-c1c6-4139-b614-cabf5565af51
22	22	0	Plazi	ffb07bec-2d10-492d-9c37-361fe0b79427	5b8d9e7d-dcf7-4ff0-b063-4f0843203f7b
0	1	1	Plazi	ffb07bec-2d10-492d-9c37-361fe0b79427	5bdcefe8-9d7e-4200-be1a-8457ab63333c
14052	14052	0	GBIF Japan	db5705aa-6a6e-42f1-8942-d77b9f4896ea	5c8824d5-75de-49f5-be6d-2dc82fca8c4a
11	11	0	Plazi	ffb07bec-2d10-492d-9c37-361fe0b79427	5e4a2df9-66ca-4e41-958c-8570bd384325
0	24	24	Participant Node Managers Committee	7f48e0c8-5c96-49ec-b972-30748e339115	5eb299e8-74df-44b1-88a8-54c1750dba9b
0	13	13	Plazi	ffb07bec-2d10-492d-9c37-361fe0b79427	60f76049-480e-4938-9dee-effac0ef4d64
2	2	0	Plazi	ffb07bec-2d10-492d-9c37-361fe0b79427	6116db9f-6823-4432-98f6-eabc9faa978b
77	77	0	GBIF Germany	4f6826f2-4ff6-443d-b966-e6913bd24013	62686682-f762-11e1-a439-00145eb45e9a
97482	97482	0	GBIF France	da44cd31-5901-4687-a106-6d1c7734ee3a	62b41822-5bdd-4aae-92e5-e013cf3bc8f1
3	3	0	Plazi	ffb07bec-2d10-492d-9c37-361fe0b79427	6753278a-9026-4686-9d40-e056424ce6e3
6	6	0	Plazi	ffb07bec-2d10-492d-9c37-361fe0b79427	67ec1062-d598-4224-af13-7ed64ed86db4
18	18	0	GBIF Germany	4f6826f2-4ff6-443d-b966-e6913bd24013	6824db78-f762-11e1-a439-00145eb45e9a
165	165	0	GBIF Germany	4f6826f2-4ff6-443d-b966-e6913bd24013	69602bdc-f762-11e1-a439-00145eb45e9a
514	514	0	GBIF Germany	4f6826f2-4ff6-443d-b966-e6913bd24013	697787f0-f762-11e1-a439-00145eb45e9a
23	23	0	GBIF Germany	4f6826f2-4ff6-443d-b966-e6913bd24013	6a3bd6c8-f762-11e1-a439-00145eb45e9a
1049	1049	0	GBIF Germany	4f6826f2-4ff6-443d-b966-e6913bd24013	6a849606-f762-11e1-a439-00145eb45e9a
36	36	0	GBIF Germany	4f6826f2-4ff6-443d-b966-e6913bd24013	6ac0de9a-f762-11e1-a439-00145eb45e9a
12	12	0	Plazi	ffb07bec-2d10-492d-9c37-361fe0b79427	6cceabcf-a2f2-4b6b-84f8-e6447683e1a1
84	84	0	GBIF Germany	4f6826f2-4ff6-443d-b966-e6913bd24013	6d5bf73e-f762-11e1-a439-00145eb45e9a
8	8	0	Plazi	ffb07bec-2d10-492d-9c37-361fe0b79427	6e00b0f7-b9e1-4da0-9ee8-1b778758e5f3
0	12	12	Plazi	ffb07bec-2d10-492d-9c37-361fe0b79427	6e06fa93-00dd-4c0e-a921-cf78d027e7e6
6	6	0	Plazi	ffb07bec-2d10-492d-9c37-361fe0b79427	6e84f4d6-64d0-408b-889b-e270ab6be3a7
86	86	0	GBIF Germany	4f6826f2-4ff6-443d-b966-e6913bd24013	6fc6ff32-f762-11e1-a439-00145eb45e9a
0	2548	2548	Korean Biodiversity Information Facility	e0a1e772-0177-4800-94b4-2d023fe6cdf4	707e11ea-e43b-4ee7-bf5b-99ca68dcc792
566	566	0	GBIF Germany	4f6826f2-4ff6-443d-b966-e6913bd24013	708cf674-f762-11e1-a439-00145eb45e9a
0	5	5	Plazi	ffb07bec-2d10-492d-9c37-361fe0b79427	70d143c8-e7c8-40e4-abbd-efc283415cab
6	6	0	Plazi	ffb07bec-2d10-492d-9c37-361fe0b79427	7138d838-3b94-44f6-92ca-fb6c3b42832e
1452	1523	71	GBIF Japan	db5705aa-6a6e-42f1-8942-d77b9f4896ea	721ec3cb-78b5-42b9-9ad1-57fe90b75e6f
226	226	0	GBIF Germany	4f6826f2-4ff6-443d-b966-e6913bd24013	7277696a-f762-11e1-a439-00145eb45e9a
153	153	0	GBIF Germany	4f6826f2-4ff6-443d-b966-e6913bd24013	72d1182a-f762-11e1-a439-00145eb45e9a
18	18	0	Plazi	ffb07bec-2d10-492d-9c37-361fe0b79427	738eb509-6465-42fd-a02f-29b5141de6ca
24	24	0	GBIF Germany	4f6826f2-4ff6-443d-b966-e6913bd24013	73fcc5e6-f762-11e1-a439-00145eb45e9a
159	159	0	GBIF France	da44cd31-5901-4687-a106-6d1c7734ee3a	7435177e-6a89-4b2b-b436-9bcf0d64d4ea
46	46	0	GBIF Germany	4f6826f2-4ff6-443d-b966-e6913bd24013	74e89890-f762-11e1-a439-00145eb45e9a
386	386	0	GBIF Germany	4f6826f2-4ff6-443d-b966-e6913bd24013	75a7862e-f762-11e1-a439-00145eb45e9a
248	248	0	GBIF Germany	4f6826f2-4ff6-443d-b966-e6913bd24013	75cfddea-f762-11e1-a439-00145eb45e9a
3095	3095	0	GBIF France	da44cd31-5901-4687-a106-6d1c7734ee3a	772834c5-700e-46f0-ba25-7c4b6b2e5547
7533	7533	0	Korean Biodiversity Information Facility	e0a1e772-0177-4800-94b4-2d023fe6cdf4	7b165ac2-f762-11e1-a439-00145eb45e9a
4818	4818	0	Korean Biodiversity Information Facility	e0a1e772-0177-4800-94b4-2d023fe6cdf4	7b232644-f762-11e1-a439-00145eb45e9a
4717	4717	0	Ocean Biodiversity Information System	ba0670b9-4186-41e6-8e70-f9cb3065551a	7b52e794-f762-11e1-a439-00145eb45e9a
363	363	0	GBIF Germany	4f6826f2-4ff6-443d-b966-e6913bd24013	7c5de5d0-f762-11e1-a439-00145eb45e9a
22	22	0	Plazi	ffb07bec-2d10-492d-9c37-361fe0b79427	7cf2f2b2-90cc-46f2-a511-9000a6c927ac
213	208	-5	GBIF Germany	4f6826f2-4ff6-443d-b966-e6913bd24013	7d45e4a2-f762-11e1-a439-00145eb45e9a
317	317	0	GBIF Germany	4f6826f2-4ff6-443d-b966-e6913bd24013	7d936272-f762-11e1-a439-00145eb45e9a
396	396	0	GBIF Germany	4f6826f2-4ff6-443d-b966-e6913bd24013	7dc56dda-f762-11e1-a439-00145eb45e9a
38180	40841	2661	GBIF Spain	1f94b3ca-9345-4d65-afe2-4bace93aa0fe	7f591d18-f762-11e1-a439-00145eb45e9a
548	537	-11	Biodiversity Information System of Mexico	b324e8e9-9a4c-44fa-8f1a-7f39ea7ab576	7f707904-f762-11e1-a439-00145eb45e9a
1600	1167	-433	Biodiversity Information System of Mexico	b324e8e9-9a4c-44fa-8f1a-7f39ea7ab576	7f87bdc6-f762-11e1-a439-00145eb45e9a
111529	111529	0	DanBIF - Danish Biodiversity Information Facility	4ddd294f-02b7-4359-ac33-0806a9ca9c6b	833db434-f762-11e1-a439-00145eb45e9a
64	64	0	Plazi	ffb07bec-2d10-492d-9c37-361fe0b79427	836ea572-b61e-446b-b9da-d799553ffc47
5	5	0	Plazi	ffb07bec-2d10-492d-9c37-361fe0b79427	842557a6-9e14-4645-a1b9-b5d0ada50a77
49	49	0	Plazi	ffb07bec-2d10-492d-9c37-361fe0b79427	842ab576-4fbb-4b89-9260-14c7be0ea372
16	16	0	Colombian Biodiversity Information System	7e865cba-7c46-417b-ade5-97f2cf5b7be0	85237056-f9d3-47f6-a59c-c7f6bc27a52c
3	3	0	Plazi	ffb07bec-2d10-492d-9c37-361fe0b79427	865692a2-cc90-4a8d-9edc-a7c42a1d1d87
456083	455641	-442	Biodiversity Information System of Mexico	b324e8e9-9a4c-44fa-8f1a-7f39ea7ab576	871bbe1d-c45f-45cc-b5cd-b79f4eb37485
28461	28461	0	Biodiversity Information System of Mexico	b324e8e9-9a4c-44fa-8f1a-7f39ea7ab576	87213c27-8362-48ee-af75-d636d44eb2f3
153	153	0	Canada Biodiversity Information Facility	8f83fc96-c966-4126-83f7-bf044dc49efa	87360819-f344-4ad8-840e-6f3c3879a46a
320	105	-215	GBIF Germany	4f6826f2-4ff6-443d-b966-e6913bd24013	879370e6-f762-11e1-a439-00145eb45e9a
1055	908	-147	GBIF Germany	4f6826f2-4ff6-443d-b966-e6913bd24013	87efcb20-f762-11e1-a439-00145eb45e9a
786	288	-498	GBIF Germany	4f6826f2-4ff6-443d-b966-e6913bd24013	893c6100-f762-11e1-a439-00145eb45e9a
369	369	0	GBIF France	da44cd31-5901-4687-a106-6d1c7734ee3a	8aebb1b9-b8b9-4ec3-b7fd-f8e8168b38d1
10	10	0	Plazi	ffb07bec-2d10-492d-9c37-361fe0b79427	8b57d1e6-b2b7-4229-912a-c042457efaaf
53	53	0	GBIF Germany	4f6826f2-4ff6-443d-b966-e6913bd24013	8cc6b4d8-f762-11e1-a439-00145eb45e9a
382	139	-243	GBIF Germany	4f6826f2-4ff6-443d-b966-e6913bd24013	8e0af1ba-f762-11e1-a439-00145eb45e9a
2	1	-1	GBIF Germany	4f6826f2-4ff6-443d-b966-e6913bd24013	8ee574d4-f762-11e1-a439-00145eb45e9a
1	1	0	GBIF Germany	4f6826f2-4ff6-443d-b966-e6913bd24013	8eef144e-f762-11e1-a439-00145eb45e9a
299	271	-28	GBIF Germany	4f6826f2-4ff6-443d-b966-e6913bd24013	8fa94daa-f762-11e1-a439-00145eb45e9a
10	7	-3	GBIF Germany	4f6826f2-4ff6-443d-b966-e6913bd24013	8ffffe5c-f762-11e1-a439-00145eb45e9a
16	16	0	Plazi	ffb07bec-2d10-492d-9c37-361fe0b79427	904d97ff-7d79-4253-bc8d-efa08ca5c475
62799	62798	-1	U.S. Geological Survey	8618c64a-93e0-4300-b546-7249e5148ed2	905589dd-1f8f-4aee-95e6-5672466e348d
308	202	-106	GBIF Germany	4f6826f2-4ff6-443d-b966-e6913bd24013	90d98924-f762-11e1-a439-00145eb45e9a
39	39	0	Plazi	ffb07bec-2d10-492d-9c37-361fe0b79427	91a8655a-a935-40ff-b341-68903c630693
5	5	0	Plazi	ffb07bec-2d10-492d-9c37-361fe0b79427	91e73266-88bc-459f-a807-77033bed6596
43253	43253	0	National Biodiversity Network	d897a5b9-35ee-4232-94bd-b0bcaac003c2	9279192d-9d2b-43bb-af15-1eaf95ec4c8e
100	94	-6	GBIF Germany	4f6826f2-4ff6-443d-b966-e6913bd24013	9456781e-f762-11e1-a439-00145eb45e9a
353	329	-24	GBIF Germany	4f6826f2-4ff6-443d-b966-e6913bd24013	9537e6b4-f762-11e1-a439-00145eb45e9a
3	3	0	Plazi	ffb07bec-2d10-492d-9c37-361fe0b79427	958d2d25-ba6f-4878-b174-cb0011611e4d
6806	6806	0	GBIF France	da44cd31-5901-4687-a106-6d1c7734ee3a	9702638f-378a-4a61-afe1-ce521dc9b660
0	4	4	Plazi	ffb07bec-2d10-492d-9c37-361fe0b79427	9abb7f24-4bf4-4ecb-bd0e-50a4fe270d54
24600	24600	0	GBIF Portugal	673f7038-4262-4149-b753-5658a4e912f6	9abba4c6-895e-409a-9b00-44463ac19e8c
0	4871	4871	Ocean Biodiversity Information System	ba0670b9-4186-41e6-8e70-f9cb3065551a	9b73aa44-609b-44e6-a0fc-2df9eb32cee1
0	2	2	Plazi	ffb07bec-2d10-492d-9c37-361fe0b79427	9cd8b6d6-68ba-4b15-8970-29fc967ccfe0
733	733	0	Biodiversity Information System of Mexico	b324e8e9-9a4c-44fa-8f1a-7f39ea7ab576	9f472ac4-5d5a-4767-89e2-cbe02d7cfe2e
5361	5361	0	Colombian Biodiversity Information System	7e865cba-7c46-417b-ade5-97f2cf5b7be0	a0b41a13-be91-4800-b72b-cdd9184bf2eb
2728	2728	0	Biodiversity Information System of Mexico	b324e8e9-9a4c-44fa-8f1a-7f39ea7ab576	a2de0752-d60a-43a3-9ce8-9ef667810804
60	60	0	Plazi	ffb07bec-2d10-492d-9c37-361fe0b79427	a3d43ab3-cddd-4ead-96d4-41ecb7991015
197	197	0	Colombian Biodiversity Information System	7e865cba-7c46-417b-ade5-97f2cf5b7be0	ad3a5009-4f28-4fa5-9661-bc81d2e6c01e
30	30	0	Plazi	ffb07bec-2d10-492d-9c37-361fe0b79427	ae6e6113-7e6f-4fee-82a1-a8a259fcb0da
3	3	0	Plazi	ffb07bec-2d10-492d-9c37-361fe0b79427	ae7c5192-65dd-4ee9-839f-96b7021b42a0
8419	8419	0	Polish Biodiversity Information Network	2618bfdf-e194-4911-a241-80db3107bc51	b0f917c0-a75b-11dd-b1b0-b8a03c50a862
102	102	0	Colombian Biodiversity Information System	7e865cba-7c46-417b-ade5-97f2cf5b7be0	b3e962e6-c1c4-4d52-87d2-7926d06750e7
0	1	1	Plazi	ffb07bec-2d10-492d-9c37-361fe0b79427	b49af0b0-2096-46b2-83f2-d83682585f31
48	48	0	Plazi	ffb07bec-2d10-492d-9c37-361fe0b79427	b4b77777-50c4-4598-b55d-313a5141d3ba
10171	10171	0	U.S. Geological Survey	8618c64a-93e0-4300-b546-7249e5148ed2	b6a04f9b-d449-43a2-9707-36260bdb25de
20808	27907	7099	U.S. Geological Survey	8618c64a-93e0-4300-b546-7249e5148ed2	b6d66b0c-d2eb-44b5-be52-62171411c5ad
4	4	0	Plazi	ffb07bec-2d10-492d-9c37-361fe0b79427	b88513a0-1670-4cd5-8f94-f890d70d16ef
2185	2185	0	GBIF France	da44cd31-5901-4687-a106-6d1c7734ee3a	b94cbceb-76c9-4a0a-a752-caa92d6613cf
66352	69151	2799	GBIF Brazil	cdc9736d-5ff7-4ece-9959-3c744360cdb3	b9a43c60-d2b6-445c-9362-2db65465c963
6	6	0	Plazi	ffb07bec-2d10-492d-9c37-361fe0b79427	baed3194-9bcd-4962-8ee1-af6c32310bd0
0	3	3	Plazi	ffb07bec-2d10-492d-9c37-361fe0b79427	beca05a3-4857-4f22-8686-b73b0d159099
1948	1978	30	National Biodiversity Network	d897a5b9-35ee-4232-94bd-b0bcaac003c2	c0dd4990-1803-4d6b-bc06-2f7eeaba100d
1779	1779	0	National Biodiversity Network	d897a5b9-35ee-4232-94bd-b0bcaac003c2	c1d8da29-9126-4e11-a699-722bd3d7492f
71	71	0	GBIF France	da44cd31-5901-4687-a106-6d1c7734ee3a	c3d90d8b-3909-4930-8739-3e3f7d7d9e04
843	843	0	GBIF Japan	db5705aa-6a6e-42f1-8942-d77b9f4896ea	c671d43f-7fb9-4b5a-a964-630bfbf47dd2
25	25	0	GBIF Germany	4f6826f2-4ff6-443d-b966-e6913bd24013	c849b68a-2617-45c1-8e3e-4dfb57b5ee7e
130371	130455	84	U.S. Geological Survey	8618c64a-93e0-4300-b546-7249e5148ed2	cc09386c-43a4-4a12-8ae4-d25610645250
1	1	0	Plazi	ffb07bec-2d10-492d-9c37-361fe0b79427	cd4e80ba-060e-4df4-8fea-6a56fd765c5b
0	10221	10221	U.S. Geological Survey	8618c64a-93e0-4300-b546-7249e5148ed2	cfbdc726-cd55-4d58-a6db-9aebe037a6d9
0	81	81	Plazi	ffb07bec-2d10-492d-9c37-361fe0b79427	d4278396-ea28-41d5-bbf8-7be81db95c02
768	768	0	GBIF Germany	4f6826f2-4ff6-443d-b966-e6913bd24013	d44ab664-3a78-49fd-85f0-450d6f7b4c03
18	18	0	Plazi	ffb07bec-2d10-492d-9c37-361fe0b79427	d9af17ec-891f-41c3-bd11-8067fc2ef6eb
21	21	0	Plazi	ffb07bec-2d10-492d-9c37-361fe0b79427	db3a10c6-b5b9-4227-92f1-03d8a40c669e
0	12	12	Plazi	ffb07bec-2d10-492d-9c37-361fe0b79427	db69c0c7-2394-4784-824e-d14cf1414707
2327	2327	0	National Biodiversity Network	d897a5b9-35ee-4232-94bd-b0bcaac003c2	dc869deb-9a3d-43d2-acd1-ef7dcff3def8
9851	9851	0	National Biodiversity Network	d897a5b9-35ee-4232-94bd-b0bcaac003c2	dcc129a5-95be-47a7-bed7-226f3143acad
7	7	0	National Biodiversity Network	d897a5b9-35ee-4232-94bd-b0bcaac003c2	de2495cf-bb63-4bc7-a082-4a35f22f0aac
0	373	373	Ocean Biodiversity Information System	ba0670b9-4186-41e6-8e70-f9cb3065551a	de25c221-9c9d-40ea-abed-d3d1e14eebc4
0	48	48	Participant Node Managers Committee	7f48e0c8-5c96-49ec-b972-30748e339115	dfb01d47-5a8d-486a-9e28-6ecc0b03806b
149	149	0	GBIF France	da44cd31-5901-4687-a106-6d1c7734ee3a	e059cb9b-8971-42be-9a68-623f608f68d2
1355	1355	0	National Biodiversity Network	d897a5b9-35ee-4232-94bd-b0bcaac003c2	e0691672-7cc7-48a8-813e-fa69ae7c4ca0
105	105	0	GBIF Germany	4f6826f2-4ff6-443d-b966-e6913bd24013	e62c42d6-753b-4f12-9ab8-8407090bd572
0	114	114	Plazi	ffb07bec-2d10-492d-9c37-361fe0b79427	e77c9c21-21b1-4a10-aebc-2b11c21e8d2f
499	499	0	Participant Node Managers Committee	7f48e0c8-5c96-49ec-b972-30748e339115	e84b1309-3891-498d-a13a-1d3bb3683faf
0	6317	6317	Participant Node Managers Committee	7f48e0c8-5c96-49ec-b972-30748e339115	e94aabf1-9de7-4bea-83c8-31fef8c04d83
298	298	0	Participant Node Managers Committee	7f48e0c8-5c96-49ec-b972-30748e339115	eb1aa29c-65b1-432b-b66c-22e5fdcb52d4
268	268	0	GBIF France	da44cd31-5901-4687-a106-6d1c7734ee3a	ec50c3d8-b301-4da3-8951-335ef68adf46
34	34	0	GBIF Sweden	a0b3be64-6525-4387-ac67-a499950f92e1	efb3a6c0-e35b-4b82-9835-8456f38b712b
32681	32681	0	GBIF Japan	db5705aa-6a6e-42f1-8942-d77b9f4896ea	efdcb567-942c-43d7-9c6c-7260b4d25098
9684	9684	0	GBIF Norway	4f829580-180d-46a9-9c87-ed8ec959b545	f0d00d00-aa57-4209-abaf-be2aed9a71dd
395	395	0	Colombian Biodiversity Information System	7e865cba-7c46-417b-ade5-97f2cf5b7be0	f0fcba94-c8bc-43f1-af8e-f5f4fd910d74
10475	10475	0	Participant Node Managers Committee	7f48e0c8-5c96-49ec-b972-30748e339115	f2e0dd25-5b04-4a90-bc86-3144659d5574
108	108	0	Plazi	ffb07bec-2d10-492d-9c37-361fe0b79427	f31ce7c7-fd74-4fcd-a871-1c9686763142
18	18	0	GBIF Germany	4f6826f2-4ff6-443d-b966-e6913bd24013	fb52aff0-8c06-45b1-abb2-deea9cf8dd6f
1817	1817	0	GBIF France	da44cd31-5901-4687-a106-6d1c7734ee3a	fc7897c8-5dcd-48d4-859d-3ea3d3217c0b
0	142	142	Plazi	ffb07bec-2d10-492d-9c37-361fe0b79427	ff9ddcdc-1340-4533-ae1e-da83b895158c
34	34	0	GBIF Finland	dd514216-5c7c-45f3-910d-797424cb5be6	00156ffd-cd63-464e-9d7e-c597e477b6c6
0	15	15	Plazi	ffb07bec-2d10-492d-9c37-361fe0b79427	00b92c50-6efb-48ba-80f8-048b711ac2b9
127	127	0	National Biodiversity Network	d897a5b9-35ee-4232-94bd-b0bcaac003c2	00f99b22-fd95-4f90-899f-4c5331cfab6c
35493	35493	0	GBIF France	da44cd31-5901-4687-a106-6d1c7734ee3a	0411f349-bbe6-4e47-969e-f06d2d07779d
78	78	0	Colombian Biodiversity Information System	7e865cba-7c46-417b-ade5-97f2cf5b7be0	0428bf13-3fd0-43cb-b2bd-baec72974ab5
2	2	0	Plazi	ffb07bec-2d10-492d-9c37-361fe0b79427	04554432-c5a6-4c7f-8160-1dc299c10647
7	7	0	Plazi	ffb07bec-2d10-492d-9c37-361fe0b79427	0b5cc39e-daaf-4420-9bb1-9faf01f7e34d
1998	1998	0	Colombian Biodiversity Information System	7e865cba-7c46-417b-ade5-97f2cf5b7be0	0b64ff91-ab41-4e5f-9770-f45ddd67c0ca
0	14	14	Plazi	ffb07bec-2d10-492d-9c37-361fe0b79427	0c8b11dc-564b-461b-9cb1-3cd61111f9b2
1205	1205	0	GBIF Benin	efb9c00e-f802-45dd-8826-a52ec45b89ff	0cbde2ee-4dc2-42c6-b345-e63887411199
0	84886	84886	Ocean Biodiversity Information System	ba0670b9-4186-41e6-8e70-f9cb3065551a	0dcd258f-e5fc-4495-ae38-5f02fd910987
0	32	32	Plazi	ffb07bec-2d10-492d-9c37-361fe0b79427	107b6466-5b93-4f17-b091-fe59516596dc
18	18	0	Colombian Biodiversity Information System	7e865cba-7c46-417b-ade5-97f2cf5b7be0	160c7e0b-c7cf-4967-b265-4d977fc64a9a
211	211	0	GBIF France	da44cd31-5901-4687-a106-6d1c7734ee3a	17709cb2-01b4-434f-ae31-6641c67bf223
1	1	0	Plazi	ffb07bec-2d10-492d-9c37-361fe0b79427	1a3dcc8d-1494-49c6-8bf1-7e9020c48de6
11	11	0	Plazi	ffb07bec-2d10-492d-9c37-361fe0b79427	1aef5d69-f56f-4b53-9096-a92bef816c0f
36	36	0	Plazi	ffb07bec-2d10-492d-9c37-361fe0b79427	1c95cd87-fbea-453b-aaa3-0bbfc2fdc398
0	108	108	Colombian Biodiversity Information System	7e865cba-7c46-417b-ade5-97f2cf5b7be0	1d103e73-3daa-4fe8-a5c4-7df522f37800
6	6	0	GBIF France	da44cd31-5901-4687-a106-6d1c7734ee3a	1d67bb42-645d-4458-abec-b48390a563b9
1	1	0	Plazi	ffb07bec-2d10-492d-9c37-361fe0b79427	1d6b011b-6836-4b42-9eb9-5b9055a449a4
10182	10182	0	GBIF France	da44cd31-5901-4687-a106-6d1c7734ee3a	240e848b-47bc-40a3-a44c-6e745901d2d0
26	26	0	Plazi	ffb07bec-2d10-492d-9c37-361fe0b79427	26ac6a51-9d0a-4cb0-8502-230b45cf66e6
21	21	0	GBIF Germany	4f6826f2-4ff6-443d-b966-e6913bd24013	284dbec3-f19e-4c5c-bd43-5c5bf3906f18
4	4	0	Plazi	ffb07bec-2d10-492d-9c37-361fe0b79427	2865be6d-3c52-40e0-ad3f-067ddb904ff5
216	216	0	Plazi	ffb07bec-2d10-492d-9c37-361fe0b79427	2971017f-82c8-404a-8fcf-f95990dbb3cb
1	1	0	Participant Node Managers Committee	7f48e0c8-5c96-49ec-b972-30748e339115	2aab0548-a9f9-4df2-9faf-ef90d2de7369
162	162	0	Biodiversity Information System of Mexico	b324e8e9-9a4c-44fa-8f1a-7f39ea7ab576	2f43d879-902a-41e7-9266-036afc19e9c1
372	372	0	National Biodiversity Network	d897a5b9-35ee-4232-94bd-b0bcaac003c2	313bdea4-4517-4695-aee4-78286689c3b4
0	143	143	Plazi	ffb07bec-2d10-492d-9c37-361fe0b79427	344cf70d-6a17-464b-9a35-40324bcef9d4
0	63	63	Colombian Biodiversity Information System	7e865cba-7c46-417b-ade5-97f2cf5b7be0	349ad021-b578-49a5-9095-c2e443bfc9a3
1894	1894	0	Colombian Biodiversity Information System	7e865cba-7c46-417b-ade5-97f2cf5b7be0	34bcd3c8-5130-46ff-9000-1d4b44087aeb
14	14	0	Plazi	ffb07bec-2d10-492d-9c37-361fe0b79427	361ee2d4-577a-41e7-a953-fe213bca92dd
64	64	0	National Biodiversity Network	d897a5b9-35ee-4232-94bd-b0bcaac003c2	39e66d18-c995-4e77-b3a2-e8d25e3ab070
0	312	312	Ocean Biodiversity Information System	ba0670b9-4186-41e6-8e70-f9cb3065551a	3e7a47cc-f290-48f7-979a-14ecb7791577
18475	18555	80	GBIF Brazil	cdc9736d-5ff7-4ece-9959-3c744360cdb3	4012b76b-7f81-4bd9-b887-6fd3e6a5588c
11351	11351	0	Polish Biodiversity Information Network	2618bfdf-e194-4911-a241-80db3107bc51	405137b0-30b2-11de-b171-b8a03c50a862
87	87	0	Participant Node Managers Committee	7f48e0c8-5c96-49ec-b972-30748e339115	4142ad50-b1a9-44d6-bcc2-03e8c89ec5b7
1	1	0	Plazi	ffb07bec-2d10-492d-9c37-361fe0b79427	41ec9c8f-6b98-4479-807a-fccb105d2459
3	3	0	Plazi	ffb07bec-2d10-492d-9c37-361fe0b79427	426319f0-f361-4222-bf48-b093743b0b96
1	1	0	Plazi	ffb07bec-2d10-492d-9c37-361fe0b79427	43a60c6b-998b-4c9e-8fea-67c2549e4fa5
142	142	0	Plazi	ffb07bec-2d10-492d-9c37-361fe0b79427	43ebda6c-201a-46af-8b54-e7980b8d79e1
0	3	3	Plazi	ffb07bec-2d10-492d-9c37-361fe0b79427	45d7b489-d4c8-4b94-939c-3fadee6678d2
6	6	0	Plazi	ffb07bec-2d10-492d-9c37-361fe0b79427	46d1acfa-471c-4c4f-b5c4-34c676ee4878
0	94	94	Plazi	ffb07bec-2d10-492d-9c37-361fe0b79427	4e2d6f56-fddc-4e28-bfd5-065db656475d
31	31	0	Plazi	ffb07bec-2d10-492d-9c37-361fe0b79427	4f8fb1c3-aea8-4a47-a988-fa9aa08232b1
6	6	0	Plazi	ffb07bec-2d10-492d-9c37-361fe0b79427	517653f4-3021-4d2d-8be4-37285f1460fc
18900	18900	0	U.S. Geological Survey	8618c64a-93e0-4300-b546-7249e5148ed2	51b92d4e-556f-4a05-bc5c-bfe982ee1156
299	251	-48	GBIF Germany	4f6826f2-4ff6-443d-b966-e6913bd24013	532f2890-1d7c-45f1-9a54-f77ca28ba945
0	24	24	Plazi	ffb07bec-2d10-492d-9c37-361fe0b79427	541dcb09-af62-4598-9b4c-bde7fee86a1f
16421	16421	0	U.S. Geological Survey	8618c64a-93e0-4300-b546-7249e5148ed2	544ae945-0a4f-43de-9387-cff775273c77
94	94	0	Plazi	ffb07bec-2d10-492d-9c37-361fe0b79427	59121bf6-137c-498e-be20-d9442ceed16b
24	24	0	GBIF Germany	4f6826f2-4ff6-443d-b966-e6913bd24013	597a644c-587b-48cc-a050-cea2cea62f72
8	8	0	Plazi	ffb07bec-2d10-492d-9c37-361fe0b79427	5b03cb7f-8e8c-476b-a0c6-53bbae6f721c
2023	2023	0	Colombian Biodiversity Information System	7e865cba-7c46-417b-ade5-97f2cf5b7be0	5ccd13d9-c3e2-44b6-b8c4-10b6a6771f83
59	59	0	GBIF Germany	4f6826f2-4ff6-443d-b966-e6913bd24013	613cb4b6-f762-11e1-a439-00145eb45e9a
114	114	0	GBIF Germany	4f6826f2-4ff6-443d-b966-e6913bd24013	614b4cc4-f762-11e1-a439-00145eb45e9a
50805	50805	0	Chinese Academy of Sciences	e760dc6f-dd68-474d-ab41-bd3588571793	614d7304-af7c-4613-81d8-488e81e28229
1715	1715	0	Participant Node Managers Committee	7f48e0c8-5c96-49ec-b972-30748e339115	616e9271-ec06-4df4-99b7-d85a13d841db
147	147	0	GBIF Germany	4f6826f2-4ff6-443d-b966-e6913bd24013	622bf4cc-f762-11e1-a439-00145eb45e9a
23638	23638	0	National Biodiversity Network	d897a5b9-35ee-4232-94bd-b0bcaac003c2	62af450d-0b71-4469-93c1-fc0999aa9807
28	28	0	GBIF Germany	4f6826f2-4ff6-443d-b966-e6913bd24013	62e7be64-f762-11e1-a439-00145eb45e9a
160	1065	905	GBIF Argentina	2426a871-9feb-40a1-96c6-0c593a76b835	62fcd9d4-ecc4-46fb-a7d5-ef350091c163
67	67	0	GBIF Germany	4f6826f2-4ff6-443d-b966-e6913bd24013	64011b92-f762-11e1-a439-00145eb45e9a
99	99	0	GBIF Germany	4f6826f2-4ff6-443d-b966-e6913bd24013	64199e92-f762-11e1-a439-00145eb45e9a
49	49	0	GBIF Germany	4f6826f2-4ff6-443d-b966-e6913bd24013	64379ea6-f762-11e1-a439-00145eb45e9a
103	103	0	GBIF Germany	4f6826f2-4ff6-443d-b966-e6913bd24013	64521b8c-f762-11e1-a439-00145eb45e9a
3	3	0	Plazi	ffb07bec-2d10-492d-9c37-361fe0b79427	64abc078-73d7-4d39-a954-1845eaeb52cc
2098	1489	-609	GBIF Germany	4f6826f2-4ff6-443d-b966-e6913bd24013	660f6c0e-f762-11e1-a439-00145eb45e9a
2877	2877	0	GBIF Slovenia	53e3f6b9-81f8-41e3-9e51-2666a5e0ae6a	66ac14f0-e244-11dd-ab80-b8a03c50a862
113	113	0	GBIF Germany	4f6826f2-4ff6-443d-b966-e6913bd24013	6739e316-f762-11e1-a439-00145eb45e9a
0	3	3	Plazi	ffb07bec-2d10-492d-9c37-361fe0b79427	678764dc-e7ec-4149-9476-684f89880b2a
115	115	0	GBIF Germany	4f6826f2-4ff6-443d-b966-e6913bd24013	67ab9394-f762-11e1-a439-00145eb45e9a
120	120	0	GBIF Germany	4f6826f2-4ff6-443d-b966-e6913bd24013	680bfe64-f762-11e1-a439-00145eb45e9a
39	39	0	GBIF Germany	4f6826f2-4ff6-443d-b966-e6913bd24013	68c49abe-f762-11e1-a439-00145eb45e9a
14	14	0	GBIF Germany	4f6826f2-4ff6-443d-b966-e6913bd24013	6b0eb868-f762-11e1-a439-00145eb45e9a
44	44	0	Plazi	ffb07bec-2d10-492d-9c37-361fe0b79427	6b42915d-82a0-481c-93a3-4092ec630e62
27	27	0	Plazi	ffb07bec-2d10-492d-9c37-361fe0b79427	6c711c6e-5983-41a5-9ba0-133ac3e85f4a
69	69	0	GBIF Germany	4f6826f2-4ff6-443d-b966-e6913bd24013	6d42e12c-f762-11e1-a439-00145eb45e9a
584	584	0	Colombian Biodiversity Information System	7e865cba-7c46-417b-ade5-97f2cf5b7be0	6d9c888a-b651-401a-a59b-edc50be157f1
190956	190956	0	Polish Biodiversity Information Network	2618bfdf-e194-4911-a241-80db3107bc51	6ef3e630-925e-11da-8900-b8a03c50a862
10	10	0	GBIF Germany	4f6826f2-4ff6-443d-b966-e6913bd24013	6fd09c72-f762-11e1-a439-00145eb45e9a
670	670	0	GBIF Germany	4f6826f2-4ff6-443d-b966-e6913bd24013	71712cae-f762-11e1-a439-00145eb45e9a
92	92	0	GBIF Germany	4f6826f2-4ff6-443d-b966-e6913bd24013	7176248e-f762-11e1-a439-00145eb45e9a
0	606	606	Symbiota Support Hub	612b5a0b-908b-4b4e-b9bf-ca15dfdc94fa	7192ec0c-41fd-4acd-bce8-46ee2686125c
109	109	0	GBIF Germany	4f6826f2-4ff6-443d-b966-e6913bd24013	71b747fc-f762-11e1-a439-00145eb45e9a
7	7	0	Plazi	ffb07bec-2d10-492d-9c37-361fe0b79427	71d68fb9-d3c1-4cf7-ad2d-6613c0651e27
646	646	0	GBIF Germany	4f6826f2-4ff6-443d-b966-e6913bd24013	720f849e-f762-11e1-a439-00145eb45e9a
15	15	0	GBIF Germany	4f6826f2-4ff6-443d-b966-e6913bd24013	729478f2-f762-11e1-a439-00145eb45e9a
208	208	0	Participant Node Managers Committee	7f48e0c8-5c96-49ec-b972-30748e339115	72d5be64-7f60-4a3f-ab34-00391c4e3484
149	149	0	GBIF Germany	4f6826f2-4ff6-443d-b966-e6913bd24013	72ea14f6-f762-11e1-a439-00145eb45e9a
105	105	0	GBIF Germany	4f6826f2-4ff6-443d-b966-e6913bd24013	756906c4-f762-11e1-a439-00145eb45e9a
61	61	0	GBIF France	da44cd31-5901-4687-a106-6d1c7734ee3a	7585ddd6-ef34-44c3-b268-f6899dcca7c9
369	369	0	GBIF Germany	4f6826f2-4ff6-443d-b966-e6913bd24013	759be756-f762-11e1-a439-00145eb45e9a
346	346	0	GBIF Germany	4f6826f2-4ff6-443d-b966-e6913bd24013	75a4e4a0-f762-11e1-a439-00145eb45e9a
1	1	0	Plazi	ffb07bec-2d10-492d-9c37-361fe0b79427	761ac261-c7ca-4f96-8c0c-34a1694f620a
1163	1163	0	GBIF Germany	4f6826f2-4ff6-443d-b966-e6913bd24013	79d378a2-f762-11e1-a439-00145eb45e9a
48	48	0	National Biodiversity Network	d897a5b9-35ee-4232-94bd-b0bcaac003c2	7a2ab795-6e71-4aad-bd0a-151d873d7d96
2074	2074	0	Korean Biodiversity Information Facility	e0a1e772-0177-4800-94b4-2d023fe6cdf4	7b1409d4-f762-11e1-a439-00145eb45e9a
214	214	0	GBIF Germany	4f6826f2-4ff6-443d-b966-e6913bd24013	7bbc3640-f762-11e1-a439-00145eb45e9a
1151	1151	0	GBIF Germany	4f6826f2-4ff6-443d-b966-e6913bd24013	7c4f88e6-f762-11e1-a439-00145eb45e9a
384	376	-8	GBIF Germany	4f6826f2-4ff6-443d-b966-e6913bd24013	7cd58dba-f762-11e1-a439-00145eb45e9a
6	6	0	Plazi	ffb07bec-2d10-492d-9c37-361fe0b79427	7dea6dc8-02d6-43f9-a6ec-47c02b36dfe9
4044	4044	0	National Biodiversity Network	d897a5b9-35ee-4232-94bd-b0bcaac003c2	7e2d5b52-f762-11e1-a439-00145eb45e9a
14478	5588	-8890	GBIF Germany	4f6826f2-4ff6-443d-b966-e6913bd24013	7e689ac8-f762-11e1-a439-00145eb45e9a
18	18	0	Plazi	ffb07bec-2d10-492d-9c37-361fe0b79427	7e6ef669-acf2-4b7f-8df0-b08c78f4df74
930	930	0	Biodiversity Information System of Mexico	b324e8e9-9a4c-44fa-8f1a-7f39ea7ab576	7f976ce4-f762-11e1-a439-00145eb45e9a
14	14	0	Biodiversity Information System of Mexico	b324e8e9-9a4c-44fa-8f1a-7f39ea7ab576	7fc57fd0-f762-11e1-a439-00145eb45e9a
2340	13412	11072	Biodiversity Information System of Mexico	b324e8e9-9a4c-44fa-8f1a-7f39ea7ab576	8044d0f0-f762-11e1-a439-00145eb45e9a
52144	52144	0	GBIF Germany	4f6826f2-4ff6-443d-b966-e6913bd24013	80b9fe97-d586-49e0-bb4b-c3cc0c3212cf
510	510	0	National Biodiversity Network	d897a5b9-35ee-4232-94bd-b0bcaac003c2	80d288d5-0900-4522-8969-3344b73ead87
557	557	0	GBIF Germany	4f6826f2-4ff6-443d-b966-e6913bd24013	8182a2bc-f762-11e1-a439-00145eb45e9a
0	1243	1243	GBIF Germany	4f6826f2-4ff6-443d-b966-e6913bd24013	82544e93-afc6-4126-a36f-9abd5bf7e162
421965	442587	20622	Atlas of Living Australia	4a6f1b71-969e-4fc5-a693-282b05e1220c	82ea2cf6-f762-11e1-a439-00145eb45e9a
4865	4872	7	Canada Biodiversity Information Facility	8f83fc96-c966-4126-83f7-bf044dc49efa	8335054b-97cf-4b0d-ab9f-e5fda37cc64d
10	10	0	Plazi	ffb07bec-2d10-492d-9c37-361fe0b79427	839397be-ec67-462e-9095-dd14ea81222f
0	89	89	Plazi	ffb07bec-2d10-492d-9c37-361fe0b79427	83c719d2-7eeb-4ae1-9ebb-6883ebb4f2b5
313949	313949	0	U.S. Geological Survey	8618c64a-93e0-4300-b546-7249e5148ed2	85802736-f762-11e1-a439-00145eb45e9a
23904	23904	0	GBIF Spain	1f94b3ca-9345-4d65-afe2-4bace93aa0fe	85facc5c-f762-11e1-a439-00145eb45e9a
17327	17327	0	Polish Biodiversity Information Network	2618bfdf-e194-4911-a241-80db3107bc51	8641b120-af9d-11db-ad75-b8a03c50a862
489	489	0	DanBIF - Danish Biodiversity Information Facility	4ddd294f-02b7-4359-ac33-0806a9ca9c6b	864ff0ce-f762-11e1-a439-00145eb45e9a
4429	3824	-605	GBIF Germany	4f6826f2-4ff6-443d-b966-e6913bd24013	87274b82-f762-11e1-a439-00145eb45e9a
1679	1403	-276	GBIF Germany	4f6826f2-4ff6-443d-b966-e6913bd24013	878cb332-f762-11e1-a439-00145eb45e9a
1467575	1467575	0	DanBIF - Danish Biodiversity Information Facility	4ddd294f-02b7-4359-ac33-0806a9ca9c6b	87b6acb8-4db2-4769-93ca-e086040dfe14
783	783	0	Netherlands Biodiversity Information Facility	0909d601-bda2-42df-9e63-a6d51847ebce	87fca6a4-11ec-4799-a668-8461a554f86b
167	167	0	GBIF Germany	4f6826f2-4ff6-443d-b966-e6913bd24013	8830eea2-f762-11e1-a439-00145eb45e9a
11	11	0	GBIF Germany	4f6826f2-4ff6-443d-b966-e6913bd24013	887a61b8-f762-11e1-a439-00145eb45e9a
12262	12294	32	U.S. Geological Survey	8618c64a-93e0-4300-b546-7249e5148ed2	89337996-f762-11e1-a439-00145eb45e9a
1325	1311	-14	GBIF Germany	4f6826f2-4ff6-443d-b966-e6913bd24013	89537e1c-f762-11e1-a439-00145eb45e9a
162	162	0	GBIF Germany	4f6826f2-4ff6-443d-b966-e6913bd24013	8a1cb304-f762-11e1-a439-00145eb45e9a
321	321	0	GBIF Germany	4f6826f2-4ff6-443d-b966-e6913bd24013	8a54da4a-f762-11e1-a439-00145eb45e9a
138	138	0	GBIF Germany	4f6826f2-4ff6-443d-b966-e6913bd24013	8acde868-f762-11e1-a439-00145eb45e9a
1371	1371	0	GBIF France	da44cd31-5901-4687-a106-6d1c7734ee3a	8b05a2fa-76ec-4760-bcfd-103d8b0826b9
65	65	0	GBIF Germany	4f6826f2-4ff6-443d-b966-e6913bd24013	8c6f6886-f762-11e1-a439-00145eb45e9a
18	18	0	Indonesian Biodiversity Information Facility	2ebd91f6-f14f-4375-b525-c011a3774f03	8c84840a-955d-471e-9f66-392a7df87ab5
0	50	50	Plazi	ffb07bec-2d10-492d-9c37-361fe0b79427	8d4f4f5d-9573-457d-8224-c2140dac0690
10	2	-8	GBIF Germany	4f6826f2-4ff6-443d-b966-e6913bd24013	8dd57346-f762-11e1-a439-00145eb45e9a
204469	204574	105	U.S. Geological Survey	8618c64a-93e0-4300-b546-7249e5148ed2	8e479b8f-ac16-4bed-a11a-bc7e27c31663
0	12	12	Plazi	ffb07bec-2d10-492d-9c37-361fe0b79427	8e4a8405-fa2a-455c-ab10-3a3329d9b782
1441	1441	0	Biodiversity Information System of Mexico	b324e8e9-9a4c-44fa-8f1a-7f39ea7ab576	9254107a-b15f-42cd-9287-7adce4b4e42d
86	86	0	GBIF Germany	4f6826f2-4ff6-443d-b966-e6913bd24013	925e29a8-f762-11e1-a439-00145eb45e9a
61	62	1	GBIF Germany	4f6826f2-4ff6-443d-b966-e6913bd24013	92c9eefe-f762-11e1-a439-00145eb45e9a
76	51	-25	GBIF Germany	4f6826f2-4ff6-443d-b966-e6913bd24013	933ff5c2-f762-11e1-a439-00145eb45e9a
60	30	-30	GBIF Germany	4f6826f2-4ff6-443d-b966-e6913bd24013	9344fbbc-f762-11e1-a439-00145eb45e9a
357	357	0	GBIF Germany	4f6826f2-4ff6-443d-b966-e6913bd24013	93d6c560-f762-11e1-a439-00145eb45e9a
1098	1098	0	GBIF Germany	4f6826f2-4ff6-443d-b966-e6913bd24013	943d2314-f762-11e1-a439-00145eb45e9a
6	6	0	Plazi	ffb07bec-2d10-492d-9c37-361fe0b79427	9566bd4f-5391-4b65-ae39-9189f68d0f28
3538	3538	0	Tanzania Biodiversity Information Facility	abd95ca6-3959-4db9-aaa6-2de1aeecf514	96879172-f762-11e1-a439-00145eb45e9a
788	788	0	GBIF Malawi	2a42e4d7-ad4a-41b3-84c4-de4aa7b74d35	97fdda72-823d-4109-b9d0-1e3d62e567c2
70	70	0	Korean Biodiversity Information Facility	e0a1e772-0177-4800-94b4-2d023fe6cdf4	9a28a332-27fc-11e2-85e3-00145eb45e9a
29	29	0	Plazi	ffb07bec-2d10-492d-9c37-361fe0b79427	a0dcf616-a4ad-49d4-b35f-dd53a90c8ac7
8	8	0	Plazi	ffb07bec-2d10-492d-9c37-361fe0b79427	a1384ecd-d70a-40ce-a26e-04b03329db4c
844	844	0	GBIF Argentina	2426a871-9feb-40a1-96c6-0c593a76b835	a180b0b4-f527-4da5-81fb-ee085e3ce4f4
578	510	-68	GBIF Germany	4f6826f2-4ff6-443d-b966-e6913bd24013	a2195b17-d587-41c9-a9ad-f25f8fee5250
240	240	0	GBIF France	da44cd31-5901-4687-a106-6d1c7734ee3a	a83f9054-983d-473b-8faf-a8076296f429
0	50	50	Ocean Biodiversity Information System	ba0670b9-4186-41e6-8e70-f9cb3065551a	a854d1d0-ca0d-42b4-b287-1140aa40d391
118	118	0	GBIF France	da44cd31-5901-4687-a106-6d1c7734ee3a	a95f74a3-4e77-45dd-bdc9-9550ae668f14
65	65	0	Plazi	ffb07bec-2d10-492d-9c37-361fe0b79427	a9d84113-654a-4036-8687-cf2758b04af1
876	876	0	GBIF France	da44cd31-5901-4687-a106-6d1c7734ee3a	aa1fab7e-5896-47cd-8549-ede172417a9c
0	183	183	Plazi	ffb07bec-2d10-492d-9c37-361fe0b79427	aae53d4a-e728-4cc3-b8fd-9f4b454f0570
2	2	0	Plazi	ffb07bec-2d10-492d-9c37-361fe0b79427	ae0202d2-49e3-4ff5-a737-fd28ad52a91e
2	2	0	Plazi	ffb07bec-2d10-492d-9c37-361fe0b79427	b2684ea2-eb83-4970-ac22-b443f8382d29
728	728	0	Ocean Biodiversity Information System	ba0670b9-4186-41e6-8e70-f9cb3065551a	b47ec169-415f-48af-8aba-47654e5320c6
7	7	0	Plazi	ffb07bec-2d10-492d-9c37-361fe0b79427	baa4c68d-aca9-4ca8-872b-6f50a172dbf3
0	1	1	Plazi	ffb07bec-2d10-492d-9c37-361fe0b79427	bb09b533-6e96-4ffa-94a6-dc61f2a85810
7047	7047	0	GBIF Brazil	cdc9736d-5ff7-4ece-9959-3c744360cdb3	bc4a914d-6294-4c2a-99a3-0ffee355074a
276	263	-13	GBIF Germany	4f6826f2-4ff6-443d-b966-e6913bd24013	c1f6cdf1-45a5-4624-acaa-556a3b213ab3
182	147	-35	GBIF Germany	4f6826f2-4ff6-443d-b966-e6913bd24013	c2ef607b-5e12-4dae-80ca-979ce557d2a1
30904	31757	853	Atlas of Living Australia	4a6f1b71-969e-4fc5-a693-282b05e1220c	c6ca96bc-7cf5-4fe7-ac44-d01e06394ef3
1560645	1560645	0	GBIF France	da44cd31-5901-4687-a106-6d1c7734ee3a	cb850587-95f8-4ab1-83e4-a20267b3aea8
2	2	0	Plazi	ffb07bec-2d10-492d-9c37-361fe0b79427	cc6e50fb-83ae-4dae-bfac-9a44f2753634
107	107	0	Plazi	ffb07bec-2d10-492d-9c37-361fe0b79427	d0bac44f-47cf-4d75-a32c-7c97c59bf74e
981	981	0	Colombian Biodiversity Information System	7e865cba-7c46-417b-ade5-97f2cf5b7be0	d35934a1-41fc-4628-a919-44d17867adeb
1	1	0	Plazi	ffb07bec-2d10-492d-9c37-361fe0b79427	d52c35d4-a874-49df-90dc-733b81d49f17
26	26	0	Colombian Biodiversity Information System	7e865cba-7c46-417b-ade5-97f2cf5b7be0	d59dceba-c459-40e4-b4ef-fa254dd0fb6d
0	31999	31999	Ocean Biodiversity Information System	ba0670b9-4186-41e6-8e70-f9cb3065551a	d605ecf2-185b-49a8-8d2b-6ce3c417dd2b
0	1322	1322	U.S. Geological Survey	8618c64a-93e0-4300-b546-7249e5148ed2	d6655666-83fc-4959-bc93-56d920238d90
9	9	0	Participant Node Managers Committee	7f48e0c8-5c96-49ec-b972-30748e339115	d67cb7c8-9c55-4034-a3b9-5973efa445b3
105	105	0	GBIF France	da44cd31-5901-4687-a106-6d1c7734ee3a	d72c693c-048a-4980-8e81-b55603060061
0	6	6	Plazi	ffb07bec-2d10-492d-9c37-361fe0b79427	d801b7c5-9027-431a-b2eb-8c2389df5d1b
0	700	700	Korean Biodiversity Information Facility	e0a1e772-0177-4800-94b4-2d023fe6cdf4	d9f4dda5-44ea-451f-bb38-25f758e1e2c9
2592	2592	0	DanBIF - Danish Biodiversity Information Facility	4ddd294f-02b7-4359-ac33-0806a9ca9c6b	db0a80b1-f4cc-4a48-a079-f293acb5a043
0	3	3	Plazi	ffb07bec-2d10-492d-9c37-361fe0b79427	dd01dd00-4e54-4457-8b0b-957f7315c33a
0	76	76	Plazi	ffb07bec-2d10-492d-9c37-361fe0b79427	dd93a9c2-28d2-4ea2-a9be-b7a06fd31459
1	1	0	Plazi	ffb07bec-2d10-492d-9c37-361fe0b79427	ddc0d912-7a93-428e-a987-8eb155da7d02
0	698	698	Tanzania Biodiversity Information Facility	abd95ca6-3959-4db9-aaa6-2de1aeecf514	ddd2906a-5a0e-4df5-8f3b-7b3d651a8c31
0	1	1	Plazi	ffb07bec-2d10-492d-9c37-361fe0b79427	de370c5d-f931-48e0-b4ed-3803bc22f2a4
2	2	0	Plazi	ffb07bec-2d10-492d-9c37-361fe0b79427	de8e73dd-ebec-4674-b9e9-6e7c62bc486b
14589	14589	0	GBIF Germany	4f6826f2-4ff6-443d-b966-e6913bd24013	e08da2eb-f214-42e1-83b1-38909fbe9e6f
0	20	20	Plazi	ffb07bec-2d10-492d-9c37-361fe0b79427	e2620415-3eea-45fa-bd1c-f00690dd62da
6	6	0	Plazi	ffb07bec-2d10-492d-9c37-361fe0b79427	e3007cbb-7ff6-4cd6-9c1c-a7c37c2274cf
582	582	0	GBIF France	da44cd31-5901-4687-a106-6d1c7734ee3a	e37a4841-6b08-4e1e-bef8-063352ea423c
32	32	0	Ocean Biodiversity Information System	ba0670b9-4186-41e6-8e70-f9cb3065551a	e4e19dc5-9d2a-427e-be9f-9632864d67d3
106	106	0	GBIF Finland	dd514216-5c7c-45f3-910d-797424cb5be6	e85170ef-0fe5-4a50-86a1-4d8551ae581e
3	3	0	Plazi	ffb07bec-2d10-492d-9c37-361fe0b79427	ea697764-3953-4089-a7f5-e392e60dd850
0	2	2	Plazi	ffb07bec-2d10-492d-9c37-361fe0b79427	eac39fc8-1a69-438d-9ad3-07e64174f322
0	3	3	Ocean Biodiversity Information System	ba0670b9-4186-41e6-8e70-f9cb3065551a	eb063816-69b3-409f-bd05-88e76c4098e8
2695	2695	0	Participant Node Managers Committee	7f48e0c8-5c96-49ec-b972-30748e339115	efcea49d-6328-447e-aef2-90e2655bbb81
25555	25555	0	GBIF Finland	dd514216-5c7c-45f3-910d-797424cb5be6	f38b3f41-cd27-4e8e-92b9-7f1ecb47e05a
5	5	0	Plazi	ffb07bec-2d10-492d-9c37-361fe0b79427	f3ca71a1-d299-4a43-a88a-53afd6f47142
281	281	0	Colombian Biodiversity Information System	7e865cba-7c46-417b-ade5-97f2cf5b7be0	f422f6fa-2429-4a5d-be7a-9fd716495291
5	5	0	GBIF France	da44cd31-5901-4687-a106-6d1c7734ee3a	f59d6858-8cb6-4fa1-8c87-47489d468eef
7622	7622	0	U.S. Geological Survey	8618c64a-93e0-4300-b546-7249e5148ed2	f7ac806d-112f-4bd3-b7f7-621f5cb6e655
0	4	4	Plazi	ffb07bec-2d10-492d-9c37-361fe0b79427	f94b8e6d-d8c9-4f3d-9460-9a0ffeb21a1a
197	197	0	Colombian Biodiversity Information System	7e865cba-7c46-417b-ade5-97f2cf5b7be0	fc5d68a6-b511-4ccf-bdeb-84c209a4c824
3	3	0	Plazi	ffb07bec-2d10-492d-9c37-361fe0b79427	00194bc1-ea4e-4df1-b462-2bd898aeee0b
9079	9079	0	GBIF Brazil	cdc9736d-5ff7-4ece-9959-3c744360cdb3	03493d8b-d05e-4f4b-9bd8-8b48abe81924
13	13	0	Plazi	ffb07bec-2d10-492d-9c37-361fe0b79427	043feded-ab7a-43de-a74d-15703895e30f
43986	44167	181	U.S. Geological Survey	8618c64a-93e0-4300-b546-7249e5148ed2	06a00852-f764-4fb8-80d4-ca51f0918459
0	9	9	Plazi	ffb07bec-2d10-492d-9c37-361fe0b79427	07baf883-204c-4608-a8b3-924711319ef3
297	373	76	U.S. Geological Survey	8618c64a-93e0-4300-b546-7249e5148ed2	0c0258d8-e503-4d57-9734-92aad4072dd2
51	51	0	Participant Node Managers Committee	7f48e0c8-5c96-49ec-b972-30748e339115	0c5beccc-2e5d-4095-9a6a-92095ecd09d2
5	5	0	Plazi	ffb07bec-2d10-492d-9c37-361fe0b79427	0ebe3437-2c79-4e1b-bf05-0040d399971c
6495	6758	263	GBIF Brazil	cdc9736d-5ff7-4ece-9959-3c744360cdb3	0ec3229f-2b53-484e-817a-de8ceb1fce2b
2	2	0	Plazi	ffb07bec-2d10-492d-9c37-361fe0b79427	0f21db24-8908-4777-9839-ae42884c8707
58	58	0	Plazi	ffb07bec-2d10-492d-9c37-361fe0b79427	14099cc5-ad98-43c3-9d59-1c2a8a6aef7a
9192	9292	100	Colombian Biodiversity Information System	7e865cba-7c46-417b-ade5-97f2cf5b7be0	1560c0d7-8a87-4724-a3f9-6322e08ee8e2
1	1	0	Plazi	ffb07bec-2d10-492d-9c37-361fe0b79427	184367d8-cf7e-4292-94b1-985b8c23b01d
3	3	0	Plazi	ffb07bec-2d10-492d-9c37-361fe0b79427	189ed4fc-dbfd-4692-bb51-faebcdd4f5eb
44680	44678	-2	Atlas of Living Australia	4a6f1b71-969e-4fc5-a693-282b05e1220c	18c93d12-34fb-4d3f-903c-b77215a1dcc9
705	705	0	GBIF France	da44cd31-5901-4687-a106-6d1c7734ee3a	1ba9fcec-441b-44ad-97fc-896240427039
1111	1111	0	GBIF France	da44cd31-5901-4687-a106-6d1c7734ee3a	1edd9107-fcfa-4b3d-abf0-87c5e5f8f1f2
31	31	0	Plazi	ffb07bec-2d10-492d-9c37-361fe0b79427	1f75966c-2b88-4148-814c-ace21e8c0d2b
47	47	0	GBIF France	da44cd31-5901-4687-a106-6d1c7734ee3a	22837241-7706-4eac-8b51-6b124d5e94f0
0	35	35	Plazi	ffb07bec-2d10-492d-9c37-361fe0b79427	2388dabf-f7ba-4edc-883a-505c964aa8d8
634257	634257	0	GBIF Spain	1f94b3ca-9345-4d65-afe2-4bace93aa0fe	23bb2c4c-b027-4eb5-b751-57e5d7ea4af6
16	16	0	Plazi	ffb07bec-2d10-492d-9c37-361fe0b79427	2c57ccb3-b64d-4005-8a17-5cb6094bf131
0	2109	2109	Participant Node Managers Committee	7f48e0c8-5c96-49ec-b972-30748e339115	2e125439-5fc9-4adb-b00a-1a7c51d3c5b5
2	2	0	GBIF France	da44cd31-5901-4687-a106-6d1c7734ee3a	32c59955-2e73-4b5c-817a-70ce525f9b7c
260	260	0	GBIF Germany	4f6826f2-4ff6-443d-b966-e6913bd24013	369913ee-c7a5-4371-a497-643e9d93bdfc
3	3	0	Plazi	ffb07bec-2d10-492d-9c37-361fe0b79427	3701c5d9-55c2-44c4-877a-dfc402af42c3
6	6	0	Plazi	ffb07bec-2d10-492d-9c37-361fe0b79427	38c586cf-821b-46aa-bc86-4e1cb0e6ef16
593	593	0	GBIF Germany	4f6826f2-4ff6-443d-b966-e6913bd24013	3aae5a68-d577-451e-bdcc-0ea84c271ddc
0	399	399	Colombian Biodiversity Information System	7e865cba-7c46-417b-ade5-97f2cf5b7be0	3d40de28-5fc9-495a-86ad-33941c024ba3
16	16	0	Plazi	ffb07bec-2d10-492d-9c37-361fe0b79427	3d6cdea7-79d5-4d75-8ea7-886ce20dd6e3
0	10	10	Plazi	ffb07bec-2d10-492d-9c37-361fe0b79427	3d91b76b-723a-43df-b0b1-ddc8d3dc1a82
0	23	23	Plazi	ffb07bec-2d10-492d-9c37-361fe0b79427	3fb65f60-0e30-4201-b360-72058e04f055
9	9	0	Plazi	ffb07bec-2d10-492d-9c37-361fe0b79427	3ff96650-b8c7-40cb-a557-3f4e7a9d235d
14	14	0	Plazi	ffb07bec-2d10-492d-9c37-361fe0b79427	41dbeab1-09b4-4613-b94d-17f7287e9ae4
147466	147466	0	Atlas of Living Australia	4a6f1b71-969e-4fc5-a693-282b05e1220c	41f52fa4-f22f-4f46-8a8c-9864de450e0f
0	2474	2474	Participant Node Managers Committee	7f48e0c8-5c96-49ec-b972-30748e339115	428a17d8-a980-49e7-a7bb-21687fb5003e
325	325	0	GBIF France	da44cd31-5901-4687-a106-6d1c7734ee3a	46f9c4fc-026f-4e00-bc8c-ee3fee016c1f
5295	5688	393	Biodiversity Information System of Mexico	b324e8e9-9a4c-44fa-8f1a-7f39ea7ab576	4a3421d3-e83f-4d30-b0b9-6658c9f047b6
28	28	0	GBIF Germany	4f6826f2-4ff6-443d-b966-e6913bd24013	4a44b0b0-7c0f-49b8-9933-19ea5f83d2d1
0	15	15	Plazi	ffb07bec-2d10-492d-9c37-361fe0b79427	4a715e82-e510-49f0-8017-a84db46a4827
11635460	11635460	0	Atlas of Living Australia	4a6f1b71-969e-4fc5-a693-282b05e1220c	4bf1cca8-832c-4891-9e17-7e7a65b7cc81
33	33	0	Plazi	ffb07bec-2d10-492d-9c37-361fe0b79427	4f5c4cb2-271c-47b4-8d95-7cc9d5bee766
2	2	0	Participant Node Managers Committee	7f48e0c8-5c96-49ec-b972-30748e339115	52651d36-1437-4a96-b610-b013f75a7133
0	450	450	Korean Biodiversity Information Facility	e0a1e772-0177-4800-94b4-2d023fe6cdf4	527261b3-b6cf-43e8-ae1e-193139dabdf3
120	120	0	Colombian Biodiversity Information System	7e865cba-7c46-417b-ade5-97f2cf5b7be0	536d64c8-eb86-4860-a4f5-1845aa8bfa66
4	4	0	Plazi	ffb07bec-2d10-492d-9c37-361fe0b79427	5381bb71-53ea-4157-b63a-ebee139b5826
251	251	0	Plazi	ffb07bec-2d10-492d-9c37-361fe0b79427	543c4afc-4ffb-4e11-a858-a6d1d9745214
3095	3095	0	Colombian Biodiversity Information System	7e865cba-7c46-417b-ade5-97f2cf5b7be0	550ade26-0e93-4ffe-8467-9942382ba3ed
0	8	8	Plazi	ffb07bec-2d10-492d-9c37-361fe0b79427	551144cb-6c32-41c6-af65-10b37874ce8b
407	495	88	GBIF Spain	1f94b3ca-9345-4d65-afe2-4bace93aa0fe	59bf2c83-1e3c-40c8-9437-39ce3d3d462c
2766	2766	0	National Biodiversity Network	d897a5b9-35ee-4232-94bd-b0bcaac003c2	5a1589d6-f4c1-41cb-8b2e-928ed89182cf
15	15	0	Plazi	ffb07bec-2d10-492d-9c37-361fe0b79427	5a91b4b1-6213-407b-8f3a-a9a71c44189c
2367	2367	0	GBIF Finland	dd514216-5c7c-45f3-910d-797424cb5be6	5adda83a-f217-470a-8756-9e229cfb6685
3	3	0	Plazi	ffb07bec-2d10-492d-9c37-361fe0b79427	5fb91ffb-69b9-4e0f-9626-08d75ab0cba8
12	12	0	Plazi	ffb07bec-2d10-492d-9c37-361fe0b79427	616d8c7b-7f07-4221-bd41-cf730f637d37
1	1	0	Plazi	ffb07bec-2d10-492d-9c37-361fe0b79427	6189a85f-e4e8-43de-9f02-6aa0a3875dfe
0	43	43	Plazi	ffb07bec-2d10-492d-9c37-361fe0b79427	61d6e883-124a-4e2a-9787-1cf1ff9c7ccb
0	2	2	Plazi	ffb07bec-2d10-492d-9c37-361fe0b79427	63cad4b2-6d35-4006-a0cd-dd96c3948042
6325	6325	0	Colombian Biodiversity Information System	7e865cba-7c46-417b-ade5-97f2cf5b7be0	647490ab-72e9-4dd6-ac83-8f771494df36
0	4	4	Plazi	ffb07bec-2d10-492d-9c37-361fe0b79427	64a22fcb-3d6b-466e-bfdc-689a163bf438
461	461	0	GBIF Germany	4f6826f2-4ff6-443d-b966-e6913bd24013	654e5384-f762-11e1-a439-00145eb45e9a
120	120	0	GBIF France	da44cd31-5901-4687-a106-6d1c7734ee3a	6633fe6b-9ee0-492c-878e-f8b4e61b9a00
113	113	0	GBIF Germany	4f6826f2-4ff6-443d-b966-e6913bd24013	6738af1e-f762-11e1-a439-00145eb45e9a
118	118	0	GBIF Germany	4f6826f2-4ff6-443d-b966-e6913bd24013	674d7df4-f762-11e1-a439-00145eb45e9a
46	46	0	GBIF Germany	4f6826f2-4ff6-443d-b966-e6913bd24013	67f506aa-f762-11e1-a439-00145eb45e9a
529	529	0	GBIF Germany	4f6826f2-4ff6-443d-b966-e6913bd24013	69692afc-f762-11e1-a439-00145eb45e9a
102	102	0	GBIF Germany	4f6826f2-4ff6-443d-b966-e6913bd24013	69a3c7ca-f762-11e1-a439-00145eb45e9a
349	349	0	GBIF France	da44cd31-5901-4687-a106-6d1c7734ee3a	6a208b7f-55f1-4b45-9328-98e3a8e8aa1d
2	2	0	Plazi	ffb07bec-2d10-492d-9c37-361fe0b79427	6a50ccdd-4de1-4588-8b9c-8dce67f4fe30
36	36	0	GBIF Germany	4f6826f2-4ff6-443d-b966-e6913bd24013	6b7755e4-f762-11e1-a439-00145eb45e9a
1723	1723	0	GBIF Germany	4f6826f2-4ff6-443d-b966-e6913bd24013	6df65306-f762-11e1-a439-00145eb45e9a
110	110	0	GBIF France	da44cd31-5901-4687-a106-6d1c7734ee3a	71554988-a218-436b-9083-498de768561c
0	14079367	14079367	U.S. Geological Survey	8618c64a-93e0-4300-b546-7249e5148ed2	721a99a4-71f4-4466-b346-83c367889238
24	24	0	GBIF Germany	4f6826f2-4ff6-443d-b966-e6913bd24013	72eb5ce4-f762-11e1-a439-00145eb45e9a
11	11	0	GBIF Germany	4f6826f2-4ff6-443d-b966-e6913bd24013	73bd9088-f762-11e1-a439-00145eb45e9a
36303	36515	212	GBIF Estonia	2c11b821-d22b-4c64-8cd3-c1578173b129	744edc21-8dd2-474e-8a0b-b8c3d56a3c2d
43	39	-4	GBIF Germany	4f6826f2-4ff6-443d-b966-e6913bd24013	79790cdc-f762-11e1-a439-00145eb45e9a
127	127	0	GBIF Germany	4f6826f2-4ff6-443d-b966-e6913bd24013	7a84f118-f762-11e1-a439-00145eb45e9a
767	767	0	GBIF France	da44cd31-5901-4687-a106-6d1c7734ee3a	7b7e3670-42a9-421c-9a52-72849885b798
1602	1602	0	GBIF France	da44cd31-5901-4687-a106-6d1c7734ee3a	7bd8f435-9c4e-465f-9125-a3aeaa4a1e14
5075	4060	-1015	GBIF Germany	4f6826f2-4ff6-443d-b966-e6913bd24013	7c71f1f6-f762-11e1-a439-00145eb45e9a
361	264	-97	GBIF Germany	4f6826f2-4ff6-443d-b966-e6913bd24013	7c82cc38-f762-11e1-a439-00145eb45e9a
567	378	-189	GBIF Germany	4f6826f2-4ff6-443d-b966-e6913bd24013	7ce48766-0e98-47da-8b54-08062a78f839
616	616	0	GBIF Germany	4f6826f2-4ff6-443d-b966-e6913bd24013	7dc012e0-f762-11e1-a439-00145eb45e9a
7	7	0	Plazi	ffb07bec-2d10-492d-9c37-361fe0b79427	7de7bc66-9325-4bb1-b9c3-add255eda671
930	930	0	GBIF Germany	4f6826f2-4ff6-443d-b966-e6913bd24013	7ee8132a-f762-11e1-a439-00145eb45e9a
2049	2049	0	GBIF Germany	4f6826f2-4ff6-443d-b966-e6913bd24013	7f4d9e16-f762-11e1-a439-00145eb45e9a
1	1	0	Plazi	ffb07bec-2d10-492d-9c37-361fe0b79427	807099eb-7dc5-422e-8866-04031d4e00ce
16233	16233	0	GBIF Japan	db5705aa-6a6e-42f1-8942-d77b9f4896ea	80f3e41e-f762-11e1-a439-00145eb45e9a
31	31	0	Colombian Biodiversity Information System	7e865cba-7c46-417b-ade5-97f2cf5b7be0	8347d191-edaa-4ffb-b146-51dd87e4ef32
21593	21593	0	Biodiversity Information System of Mexico	b324e8e9-9a4c-44fa-8f1a-7f39ea7ab576	8507dbf0-f762-11e1-a439-00145eb45e9a
1170628	1024190	-146438	Atlas of Living Australia	4a6f1b71-969e-4fc5-a693-282b05e1220c	8531183a-86b5-459b-a93e-37198f38f8a6
115365	115365	0	U.S. Geological Survey	8618c64a-93e0-4300-b546-7249e5148ed2	854f70cc-55e3-4af2-9417-0f47d6c7902d
2692	2692	0	Atlas of Living Australia	4a6f1b71-969e-4fc5-a693-282b05e1220c	8646a0c8-f762-11e1-a439-00145eb45e9a
35548	35548	0	U.S. Geological Survey	8618c64a-93e0-4300-b546-7249e5148ed2	86594bf6-f762-11e1-a439-00145eb45e9a
11	11	0	GBIF Germany	4f6826f2-4ff6-443d-b966-e6913bd24013	88083bec-f762-11e1-a439-00145eb45e9a
6143	6143	0	National Biodiversity Network	d897a5b9-35ee-4232-94bd-b0bcaac003c2	8814679c-b143-4147-bdf4-026ed58699c8
534	534	0	Atlas of Living Australia	4a6f1b71-969e-4fc5-a693-282b05e1220c	88de7dce-f762-11e1-a439-00145eb45e9a
0	67	67	Plazi	ffb07bec-2d10-492d-9c37-361fe0b79427	89d3c795-198b-4162-8903-9c6cf3f1e665
0	1	1	Plazi	ffb07bec-2d10-492d-9c37-361fe0b79427	89d3f1c9-63c9-4243-aa0e-0e20c9dd8253
29	29	0	GBIF Germany	4f6826f2-4ff6-443d-b966-e6913bd24013	8a7e1036-f762-11e1-a439-00145eb45e9a
2	2	0	Plazi	ffb07bec-2d10-492d-9c37-361fe0b79427	8b17dc9b-12a0-4571-bffe-24d48324f7a0
135	98	-37	GBIF Germany	4f6826f2-4ff6-443d-b966-e6913bd24013	8c73296c-f762-11e1-a439-00145eb45e9a
495	495	0	GBIF Germany	4f6826f2-4ff6-443d-b966-e6913bd24013	8d6eb444-f762-11e1-a439-00145eb45e9a
1016492	1016498	6	National Biodiversity Network	d897a5b9-35ee-4232-94bd-b0bcaac003c2	8ef95309-811f-4c3b-a329-a85368e774c9
3213	3150	-63	GBIF Germany	4f6826f2-4ff6-443d-b966-e6913bd24013	8febdfb0-dd3a-4927-a937-7453840ccbd8
77	77	0	GBIF Germany	4f6826f2-4ff6-443d-b966-e6913bd24013	9206edbe-f762-11e1-a439-00145eb45e9a
1	1	0	Plazi	ffb07bec-2d10-492d-9c37-361fe0b79427	926b74cb-c009-4c03-8dcf-4acf8daf98b5
2379	2379	0	GBIF Germany	4f6826f2-4ff6-443d-b966-e6913bd24013	930ad46e-f762-11e1-a439-00145eb45e9a
249	249	0	GBIF Germany	4f6826f2-4ff6-443d-b966-e6913bd24013	932e5ea2-f762-11e1-a439-00145eb45e9a
0	5	5	Plazi	ffb07bec-2d10-492d-9c37-361fe0b79427	9410bef5-8a16-4b4c-9005-4e49da8c7dec
7367	5282	-2085	GBIF Germany	4f6826f2-4ff6-443d-b966-e6913bd24013	9734fa88-f762-11e1-a439-00145eb45e9a
19	19	0	GBIF Germany	4f6826f2-4ff6-443d-b966-e6913bd24013	976e77c2-f762-11e1-a439-00145eb45e9a
7448	7448	0	National Biodiversity Network	d897a5b9-35ee-4232-94bd-b0bcaac003c2	9a829fb0-427c-4699-812d-9cff5ba8b607
1874	1874	0	Biodiversity Information System of Mexico	b324e8e9-9a4c-44fa-8f1a-7f39ea7ab576	9c69b566-0ef0-49a8-9e55-3d52155ea05a
5221	5221	0	GBIF Japan	db5705aa-6a6e-42f1-8942-d77b9f4896ea	9d386765-384e-45fb-87eb-0c8bb33a4e0a
3	3	0	Plazi	ffb07bec-2d10-492d-9c37-361fe0b79427	9df5d575-9403-4699-b51d-b0f3568d3cd8
13	13	0	Plazi	ffb07bec-2d10-492d-9c37-361fe0b79427	a10328ef-c215-4567-aa60-ff1ac514d175
6	6	0	Plazi	ffb07bec-2d10-492d-9c37-361fe0b79427	a1f8fff2-71f1-4cda-9b90-484ece852445
20	20	0	Plazi	ffb07bec-2d10-492d-9c37-361fe0b79427	a9af5a99-e28b-4c73-8895-1a5a98bb74a8
0	1	1	Plazi	ffb07bec-2d10-492d-9c37-361fe0b79427	ab1bb235-6542-4295-9663-0c77759fd8c5
498	498	0	GBIF France	da44cd31-5901-4687-a106-6d1c7734ee3a	aef9f9ab-2636-4da1-a5bc-ee36511c329d
0	1	1	Plazi	ffb07bec-2d10-492d-9c37-361fe0b79427	b0025fc3-9cbc-4aac-864b-838cebcc1aab
512467	574656	62189	Netherlands Biodiversity Information Facility	0909d601-bda2-42df-9e63-a6d51847ebce	b1047888-ae52-4179-9dd5-5448ea342a24
5	5	0	Plazi	ffb07bec-2d10-492d-9c37-361fe0b79427	b482a1ae-b6cc-480f-bf58-a055ac4b110e
86	86	0	GBIF Togo	c9659a3e-07e9-4fcb-83c6-de8b9009a02e	b5c9049f-88e7-459b-bdc6-1c0854125c83
35	35	0	Plazi	ffb07bec-2d10-492d-9c37-361fe0b79427	b608c682-28c8-4184-8e7a-52bf598d2e94
3	3	0	Atlas of Living Australia	4a6f1b71-969e-4fc5-a693-282b05e1220c	b656aac0-54ae-4091-a5d0-4e8283d293bd
80	80	0	Plazi	ffb07bec-2d10-492d-9c37-361fe0b79427	b833ffda-8b37-48c6-8c6d-23440c36873a
871	871	0	GBIF France	da44cd31-5901-4687-a106-6d1c7734ee3a	ba5a5851-f34e-455b-a6a6-ba8e40a28643
1	1	0	Plazi	ffb07bec-2d10-492d-9c37-361fe0b79427	bcd9d12b-37bd-40b3-a44f-7535e4280883
192	192	0	GBIF France	da44cd31-5901-4687-a106-6d1c7734ee3a	bceabddd-8f6c-43f3-99cc-c924aa0b52c2
0	27	27	Plazi	ffb07bec-2d10-492d-9c37-361fe0b79427	bcf5321d-09cd-4da7-a564-cafd8e000e9d
759	759	0	GBIF Germany	4f6826f2-4ff6-443d-b966-e6913bd24013	be5da7a9-fa11-4a74-8f2f-52198fd06eda
6	6	0	Plazi	ffb07bec-2d10-492d-9c37-361fe0b79427	cafaf235-c129-4ce7-9e7a-0235d3111a50
7	7	0	Plazi	ffb07bec-2d10-492d-9c37-361fe0b79427	cb6b691e-d537-4946-aa19-a9f916bc5350
0	131	131	Colombian Biodiversity Information System	7e865cba-7c46-417b-ade5-97f2cf5b7be0	cb732cc9-c87f-4de4-9125-5b4eae478621
909	909	0	National Biodiversity Network	d897a5b9-35ee-4232-94bd-b0bcaac003c2	cc0f17a4-f591-4c9e-b367-32e972f20c87
174908	175309	401	GBIF Norway	4f829580-180d-46a9-9c87-ed8ec959b545	d0aa984e-c6d3-45ee-8fc0-df1df8f4126b
0	132	132	Ocean Biodiversity Information System	ba0670b9-4186-41e6-8e70-f9cb3065551a	d1e8e98c-54f0-4628-a46a-ab3c8e0221e8
1475	1475	0	GBIF Norway	4f829580-180d-46a9-9c87-ed8ec959b545	d4376e59-65a7-4931-a4aa-7ba2d2f0b514
824	824	0	GBIF Japan	db5705aa-6a6e-42f1-8942-d77b9f4896ea	dbaba076-caa1-46b4-86b7-e7ae1dcb74b7
0	8	8	Participant Node Managers Committee	7f48e0c8-5c96-49ec-b972-30748e339115	dd114614-03cb-4295-8760-b27391185b5a
8	8	0	Plazi	ffb07bec-2d10-492d-9c37-361fe0b79427	ddf48bd8-a9f9-41b8-83ec-c216eddfc282
0	10224	10224	National Biodiversity Network	d897a5b9-35ee-4232-94bd-b0bcaac003c2	e15335ca-65d5-4dab-bd79-f407189e02fe
4	4	0	Plazi	ffb07bec-2d10-492d-9c37-361fe0b79427	e20ddd1a-b2ed-473c-ad39-a8f2bbabba66
0	2	2	Plazi	ffb07bec-2d10-492d-9c37-361fe0b79427	e287764a-7044-4c10-a6d4-0e467845a84e
538	538	0	Colombian Biodiversity Information System	7e865cba-7c46-417b-ade5-97f2cf5b7be0	e30604cb-259d-4820-8eb8-8c7334a541de
0	4	4	Plazi	ffb07bec-2d10-492d-9c37-361fe0b79427	e44d5d0a-d42f-4b00-b034-c52ac8a137f6
0	1997	1997	GBIF Spain	1f94b3ca-9345-4d65-afe2-4bace93aa0fe	e981f12f-c482-4eb9-8e3b-a7f410a5fa39
246	246	0	GBIF France	da44cd31-5901-4687-a106-6d1c7734ee3a	eacb9186-a68f-4f0a-8c32-94e6eb35e194
190	190	0	Plazi	ffb07bec-2d10-492d-9c37-361fe0b79427	ec2c4620-dc5c-4aa2-91b2-f122e35610b3
337	337	0	Colombian Biodiversity Information System	7e865cba-7c46-417b-ade5-97f2cf5b7be0	ecb6ff5d-71c8-4083-b55b-f48979addf7f
1895	1895	0	GBIF France	da44cd31-5901-4687-a106-6d1c7734ee3a	f182531a-67f8-4d54-8b05-69294a7bccb1
311	311	0	Plazi	ffb07bec-2d10-492d-9c37-361fe0b79427	f3ad9b4c-35d8-4a01-a14b-3dd968623358
445	445	0	National Biodiversity Network	d897a5b9-35ee-4232-94bd-b0bcaac003c2	f4f8ed2d-2e77-4319-bc1e-4a75c98d14b3
24	24	0	Plazi	ffb07bec-2d10-492d-9c37-361fe0b79427	f5eec350-3a46-4ed8-b9be-5cbe82d4133b
0	13	13	Plazi	ffb07bec-2d10-492d-9c37-361fe0b79427	f604433c-d7cd-4bc5-bcb9-266d9cfe8691
329	329	0	U.S. Geological Survey	8618c64a-93e0-4300-b546-7249e5148ed2	f62c330c-e9ab-4a4b-8887-67b0e2888a28
0	1	1	Plazi	ffb07bec-2d10-492d-9c37-361fe0b79427	f94c88c7-ef33-4171-a0d2-23832db1e2ba
2228	2228	0	National Biodiversity Network	d897a5b9-35ee-4232-94bd-b0bcaac003c2	f9d0e19e-b367-4603-a82a-66cf6b12d794
75	75	0	Biodiversity Information System of Mexico	b324e8e9-9a4c-44fa-8f1a-7f39ea7ab576	f9f727fb-6356-4282-b39a-f6754424a618
98	98	0	Plazi	ffb07bec-2d10-492d-9c37-361fe0b79427	fa834b57-4293-45a8-8795-aca8bc7885f9
251	251	0	GBIF France	da44cd31-5901-4687-a106-6d1c7734ee3a	fb5af424-df60-44ab-a3b6-2063242152f0
0	589	589	Plazi	ffb07bec-2d10-492d-9c37-361fe0b79427	fc3e4322-9765-42c9-9616-da49dd61cfed
9741	9741	0	National Biodiversity Network	d897a5b9-35ee-4232-94bd-b0bcaac003c2	febfb64e-8f5c-4af6-b61d-a73365e98069
122	122	0	GBIF France	da44cd31-5901-4687-a106-6d1c7734ee3a	00199071-3d3d-41c4-9a77-36fe8d84fa2f
336	336	0	DanBIF - Danish Biodiversity Information Facility	4ddd294f-02b7-4359-ac33-0806a9ca9c6b	033ce57f-20a2-4d58-a1f6-c2f5a1f32c13
0	2	2	Plazi	ffb07bec-2d10-492d-9c37-361fe0b79427	04aaf715-421e-4990-9882-d0a292277b6c
1104	1104	0	National Biodiversity Data Centre	422b00b2-6c94-4bb6-976b-c359916efdb8	07d54123-75b8-4660-9482-e4c665e6f069
248	248	0	GBIF Portugal	673f7038-4262-4149-b753-5658a4e912f6	08516469-1a7c-42fe-800b-f864d4521f71
1460	1460	0	Participant Node Managers Committee	7f48e0c8-5c96-49ec-b972-30748e339115	09641f4f-2ee1-480e-81b2-2449158747a7
125	125	0	Plazi	ffb07bec-2d10-492d-9c37-361fe0b79427	09c3d81e-e5bd-4be9-90d2-c3079db45c5c
290877	293741	2864	U.S. Geological Survey	8618c64a-93e0-4300-b546-7249e5148ed2	09c4287e-e6d5-4552-a07f-bff8a00833d8
4772	4772	0	GBIF Japan	db5705aa-6a6e-42f1-8942-d77b9f4896ea	0c316403-1cfb-4662-b14b-4cadbf3ae745
3	3	0	Plazi	ffb07bec-2d10-492d-9c37-361fe0b79427	0cac7493-a6cc-4a85-90bb-062647e70bb4
167	167	0	National Biodiversity Network	d897a5b9-35ee-4232-94bd-b0bcaac003c2	1014241c-c84b-4cfd-921d-fed9e35e8d88
1099	1099	0	GBIF France	da44cd31-5901-4687-a106-6d1c7734ee3a	11d4e959-bc8e-461b-b633-ef3acfba1a5e
528	528	0	Participant Node Managers Committee	7f48e0c8-5c96-49ec-b972-30748e339115	12a6bf1f-f66e-408c-8c6c-771af210e6a8
0	1624	1624	Plazi	ffb07bec-2d10-492d-9c37-361fe0b79427	188411de-569c-4408-a016-1a04b858c142
19312	19535	223	GBIF France	da44cd31-5901-4687-a106-6d1c7734ee3a	1b2af425-9f6f-4b28-a008-af9757317c4c
0	80	80	Plazi	ffb07bec-2d10-492d-9c37-361fe0b79427	1b7e32c9-b04c-40ce-8dc6-f1979523f8df
1	1	0	Plazi	ffb07bec-2d10-492d-9c37-361fe0b79427	1bdf1fd4-3cdd-42e6-8c51-b7072a7b7e95
0	2	2	Plazi	ffb07bec-2d10-492d-9c37-361fe0b79427	1c5c6755-0fec-4bfe-b6b7-2653e4a30a97
0	4	4	Plazi	ffb07bec-2d10-492d-9c37-361fe0b79427	1c8934f7-7c4c-4df8-bee8-ee00d0690b5a
195	195	0	GBIF Portugal	673f7038-4262-4149-b753-5658a4e912f6	1e6ec67a-0813-4e9b-9c4f-9082d7ed1e6b
439	439	0	National Biodiversity Network	d897a5b9-35ee-4232-94bd-b0bcaac003c2	23cdb7f0-a1e4-4821-9986-10e92c5378e4
0	63	63	Plazi	ffb07bec-2d10-492d-9c37-361fe0b79427	24faf05b-0b84-4a67-ae0c-5b5b0cb9aa81
0	780	780	Ocean Biodiversity Information System	ba0670b9-4186-41e6-8e70-f9cb3065551a	274fc457-3a68-4012-935a-31ca18d87b52
0	27729	27729	Participant Node Managers Committee	7f48e0c8-5c96-49ec-b972-30748e339115	2b00ca94-c839-4a28-8c58-1412523958f1
2675	2675	0	GBIF Benin	efb9c00e-f802-45dd-8826-a52ec45b89ff	2ba30ed2-6f82-480c-a892-4c8749508324
4	4	0	Plazi	ffb07bec-2d10-492d-9c37-361fe0b79427	2ba68a10-0122-4753-86db-82a9fb151c31
501	501	0	GBIF Kenya	2a44d626-9f7a-4120-8a7a-4ab5ac15ff2a	2d0a21e0-0330-4c83-8be3-7234482f138d
9	9	0	Plazi	ffb07bec-2d10-492d-9c37-361fe0b79427	2f33a6d3-e394-43fa-9d52-f5afc8b29ef3
55	55	0	Colombian Biodiversity Information System	7e865cba-7c46-417b-ade5-97f2cf5b7be0	2fdace5f-efaa-4f5c-8680-acb8f7797319
3627	3627	0	GBIF Argentina	2426a871-9feb-40a1-96c6-0c593a76b835	30cb7f3d-58d3-4c21-b2c8-f9d627054db0
373	373	0	Biodiversity Information System of Mexico	b324e8e9-9a4c-44fa-8f1a-7f39ea7ab576	3254bb7f-4b13-444c-846e-33e43276aea0
132	132	0	GBIF Argentina	2426a871-9feb-40a1-96c6-0c593a76b835	32c006db-86c6-46a1-b78e-21be8084b0f7
1	1	0	Plazi	ffb07bec-2d10-492d-9c37-361fe0b79427	33ffa664-76d1-402b-903a-84d024e2873e
2085	2085	0	GBIF France	da44cd31-5901-4687-a106-6d1c7734ee3a	36c73b4b-9b3d-4ba7-8bb9-7177b224aace
0	3	3	Plazi	ffb07bec-2d10-492d-9c37-361fe0b79427	376e9e2d-1bd1-409b-8315-80f911de0593
17	17	0	Plazi	ffb07bec-2d10-492d-9c37-361fe0b79427	38f5b04f-f093-40cf-882b-163b0bf5dba9
0	19	19	Participant Node Managers Committee	7f48e0c8-5c96-49ec-b972-30748e339115	39721886-7865-4d89-a573-9fd6f143ef00
17600	17600	0	Indonesian Biodiversity Information Facility	2ebd91f6-f14f-4375-b525-c011a3774f03	39e85504-1ebe-4671-be65-19ccdc1d7c7d
1	1	0	Plazi	ffb07bec-2d10-492d-9c37-361fe0b79427	3ce5bbaf-515d-4fd6-909a-36d326dbe794
2	2	0	Plazi	ffb07bec-2d10-492d-9c37-361fe0b79427	42e42243-0f6e-4b80-aec6-896661a0770d
9179	9179	0	GBIF Finland	dd514216-5c7c-45f3-910d-797424cb5be6	43a2e77a-5ad9-40b1-bc62-7a964ffa3210
28	28	0	Colombian Biodiversity Information System	7e865cba-7c46-417b-ade5-97f2cf5b7be0	4502c3f2-9c75-47a5-9cbf-8f02eb519438
203	203	0	GBIF Germany	4f6826f2-4ff6-443d-b966-e6913bd24013	45e2913b-9971-4e01-9c68-4d3d054352bb
453	453	0	GBIF Spain	1f94b3ca-9345-4d65-afe2-4bace93aa0fe	4704d25f-7944-4c1b-89bb-ed4a2007085b
0	445	445	Ocean Biodiversity Information System	ba0670b9-4186-41e6-8e70-f9cb3065551a	4882feee-cd07-447e-8203-2d1bcee5811a
908	908	0	Atlas of Living Australia	4a6f1b71-969e-4fc5-a693-282b05e1220c	4a23152b-456e-48e9-9ebb-236e304a6378
6	6	0	Plazi	ffb07bec-2d10-492d-9c37-361fe0b79427	4e317b8d-d4fc-4b89-b4bb-ebfdfd1ec179
0	363	363	Plazi	ffb07bec-2d10-492d-9c37-361fe0b79427	50f2ef69-fec5-45e5-8005-623e2cb991dc
0	40	40	Participant Node Managers Committee	7f48e0c8-5c96-49ec-b972-30748e339115	5445ea4d-9ca9-43b3-9ec0-90d4ff48b43b
2	2	0	Plazi	ffb07bec-2d10-492d-9c37-361fe0b79427	546532ec-56f2-4ec3-b6fb-54fb61b59632
0	1	1	Plazi	ffb07bec-2d10-492d-9c37-361fe0b79427	54b89816-78da-4c00-a693-39524284d971
246	246	0	GBIF France	da44cd31-5901-4687-a106-6d1c7734ee3a	565e1655-fa5a-4449-b595-436df67e6b7b
3256	3744	488	Colombian Biodiversity Information System	7e865cba-7c46-417b-ade5-97f2cf5b7be0	58808668-8f74-4fdf-a628-76a32e60e0ce
0	18003	18003	Participant Node Managers Committee	7f48e0c8-5c96-49ec-b972-30748e339115	598e2f1d-0f35-4bf4-9fa9-3a63fd6912d9
1029	1029	0	Participant Node Managers Committee	7f48e0c8-5c96-49ec-b972-30748e339115	5a12d9c3-9465-4107-bb39-2cb451e6cef6
1	1	0	Plazi	ffb07bec-2d10-492d-9c37-361fe0b79427	5d4c3ec9-1c15-4ce2-9a97-c5e2e5d401a7
22	22	0	Plazi	ffb07bec-2d10-492d-9c37-361fe0b79427	604d73e2-d3e2-4673-a31d-8da79bc6d6c2
161	161	0	GBIF Germany	4f6826f2-4ff6-443d-b966-e6913bd24013	619e1184-f762-11e1-a439-00145eb45e9a
29	29	0	Plazi	ffb07bec-2d10-492d-9c37-361fe0b79427	61d7b90e-5d11-4645-ab2b-fef3887fb56b
601	601	0	Netherlands Biodiversity Information Facility	0909d601-bda2-42df-9e63-a6d51847ebce	62f9b8b0-cdcf-46b4-ade6-fa3083ff3fc0
4	4	0	Plazi	ffb07bec-2d10-492d-9c37-361fe0b79427	638f1823-7037-4d75-9380-b9ce4d9222ed
2828	2828	0	GBIF France	da44cd31-5901-4687-a106-6d1c7734ee3a	63dd162f-2348-4c59-be17-a34a645b6fc3
18	18	0	GBIF Germany	4f6826f2-4ff6-443d-b966-e6913bd24013	64bbdc2a-f762-11e1-a439-00145eb45e9a
211	205	-6	GBIF Germany	4f6826f2-4ff6-443d-b966-e6913bd24013	64f9cc24-f762-11e1-a439-00145eb45e9a
51	50	-1	GBIF Germany	4f6826f2-4ff6-443d-b966-e6913bd24013	6586dbf0-f762-11e1-a439-00145eb45e9a
142	139	-3	GBIF Germany	4f6826f2-4ff6-443d-b966-e6913bd24013	65973b76-f762-11e1-a439-00145eb45e9a
75	64	-11	GBIF Germany	4f6826f2-4ff6-443d-b966-e6913bd24013	65dbd416-f762-11e1-a439-00145eb45e9a
302	295	-7	GBIF Germany	4f6826f2-4ff6-443d-b966-e6913bd24013	6606e8ae-f762-11e1-a439-00145eb45e9a
79	79	0	GBIF Germany	4f6826f2-4ff6-443d-b966-e6913bd24013	67476734-f762-11e1-a439-00145eb45e9a
44	44	0	GBIF Germany	4f6826f2-4ff6-443d-b966-e6913bd24013	67bbe6d6-f762-11e1-a439-00145eb45e9a
66	66	0	GBIF Germany	4f6826f2-4ff6-443d-b966-e6913bd24013	6985b654-f762-11e1-a439-00145eb45e9a
1195	1195	0	GBIF Germany	4f6826f2-4ff6-443d-b966-e6913bd24013	6a61f81c-f762-11e1-a439-00145eb45e9a
2	2	0	Colombian Biodiversity Information System	7e865cba-7c46-417b-ade5-97f2cf5b7be0	6c4aa79a-ceed-41ef-92f0-84d91bb68d26
6	59	53	National Biodiversity Network	d897a5b9-35ee-4232-94bd-b0bcaac003c2	6c7ea09f-a712-4dc5-95c6-59c4687e810d
0	13	13	Ocean Biodiversity Information System	ba0670b9-4186-41e6-8e70-f9cb3065551a	6cb1ae9f-d7ae-47e2-8aba-b7ddc46c24af
188	188	0	GBIF Germany	4f6826f2-4ff6-443d-b966-e6913bd24013	6d20bfd4-f762-11e1-a439-00145eb45e9a
215	215	0	GBIF Germany	4f6826f2-4ff6-443d-b966-e6913bd24013	6d2ea090-f762-11e1-a439-00145eb45e9a
124	124	0	Colombian Biodiversity Information System	7e865cba-7c46-417b-ade5-97f2cf5b7be0	6d306c66-90a9-4a29-8f71-5be70181260d
48	48	0	GBIF Japan	db5705aa-6a6e-42f1-8942-d77b9f4896ea	6fbbd21b-19be-441b-851e-1f395e266050
0	38	38	Plazi	ffb07bec-2d10-492d-9c37-361fe0b79427	6ffd5230-62fe-4c49-922a-9fe3ccd0f77f
585	1053	468	GBIF Japan	db5705aa-6a6e-42f1-8942-d77b9f4896ea	7049cc7d-fadd-483f-bae0-b89c2c6fc52e
2536	2536	0	Ghana Biodiversity Information Facility	b5633b75-6a86-4fdf-9cfc-506047fb9dc7	7120be6f-df47-49e5-aa87-2b982fa78cdf
822	822	0	GBIF France	da44cd31-5901-4687-a106-6d1c7734ee3a	716dc285-7127-471f-9718-cfb75e70c114
371	371	0	GBIF Germany	4f6826f2-4ff6-443d-b966-e6913bd24013	733b6f68-f762-11e1-a439-00145eb45e9a
140	140	0	GBIF Germany	4f6826f2-4ff6-443d-b966-e6913bd24013	74c283da-f762-11e1-a439-00145eb45e9a
99	99	0	GBIF Germany	4f6826f2-4ff6-443d-b966-e6913bd24013	74e21e66-f762-11e1-a439-00145eb45e9a
22638	22638	0	GBIF Brazil	cdc9736d-5ff7-4ece-9959-3c744360cdb3	75ffc475-3a0c-456d-b394-314489709e88
395	395	0	Colombian Biodiversity Information System	7e865cba-7c46-417b-ade5-97f2cf5b7be0	79066b93-8f98-4bc5-9d23-64ec6ee640db
0	2	2	Plazi	ffb07bec-2d10-492d-9c37-361fe0b79427	791e17b1-aeef-45e3-a23e-19196a594b77
29	29	0	Plazi	ffb07bec-2d10-492d-9c37-361fe0b79427	7a0624d4-e72a-4a7f-9bec-a0524014eaec
794369	794369	0	GBIF France	da44cd31-5901-4687-a106-6d1c7734ee3a	7a3679ef-5582-4aaa-81f0-8c2545cafc81
46704	46704	0	Korean Biodiversity Information Facility	e0a1e772-0177-4800-94b4-2d023fe6cdf4	7b21f472-f762-11e1-a439-00145eb45e9a
16	16	0	GBIF Germany	4f6826f2-4ff6-443d-b966-e6913bd24013	7ce91650-f762-11e1-a439-00145eb45e9a
1282	1282	0	GBIF Germany	4f6826f2-4ff6-443d-b966-e6913bd24013	7e96184a-f762-11e1-a439-00145eb45e9a
360	150	-210	GBIF Germany	4f6826f2-4ff6-443d-b966-e6913bd24013	7ecd1a66-f762-11e1-a439-00145eb45e9a
1397	495	-902	GBIF Germany	4f6826f2-4ff6-443d-b966-e6913bd24013	7f0af020-f762-11e1-a439-00145eb45e9a
6653	6417	-236	Biodiversity Information System of Mexico	b324e8e9-9a4c-44fa-8f1a-7f39ea7ab576	80218190-f762-11e1-a439-00145eb45e9a
5185	4164	-1021	Biodiversity Information System of Mexico	b324e8e9-9a4c-44fa-8f1a-7f39ea7ab576	80a9db62-f762-11e1-a439-00145eb45e9a
25	25	0	GBIF Spain	1f94b3ca-9345-4d65-afe2-4bace93aa0fe	80b2ae0b-644d-4216-8a56-0ae52929dd70
0	68292	68292	GBIF Switzerland	169eb292-376b-4cc6-8e31-9c2c432de0ad	81981d98-e27f-4155-9a94-9eae9bbad2be
702	702	0	Korean Biodiversity Information Facility	e0a1e772-0177-4800-94b4-2d023fe6cdf4	8301f44e-f762-11e1-a439-00145eb45e9a
0	2	2	Plazi	ffb07bec-2d10-492d-9c37-361fe0b79427	85099adc-37cc-48df-aaaf-75d96e3cf492
0	508	508	Plazi	ffb07bec-2d10-492d-9c37-361fe0b79427	878bffa3-3f56-4b12-954a-981aeb0ac246
1016	1016	0	GBIF France	da44cd31-5901-4687-a106-6d1c7734ee3a	88b970e7-f7e3-42c0-84ad-fdc02797679d
97	97	0	GBIF Germany	4f6826f2-4ff6-443d-b966-e6913bd24013	89c24fc2-f762-11e1-a439-00145eb45e9a
68	68	0	GBIF Germany	4f6826f2-4ff6-443d-b966-e6913bd24013	8a9ccfee-f762-11e1-a439-00145eb45e9a
2	2	0	Plazi	ffb07bec-2d10-492d-9c37-361fe0b79427	8a9d4178-0040-4793-b8a8-cc0af0993427
17	17	0	GBIF Germany	4f6826f2-4ff6-443d-b966-e6913bd24013	8c31ca58-f762-11e1-a439-00145eb45e9a
10	7	-3	GBIF Germany	4f6826f2-4ff6-443d-b966-e6913bd24013	8d213912-f762-11e1-a439-00145eb45e9a
30	30	0	GBIF Germany	4f6826f2-4ff6-443d-b966-e6913bd24013	8d40eece-f762-11e1-a439-00145eb45e9a
983	983	0	GBIF France	da44cd31-5901-4687-a106-6d1c7734ee3a	8d7bb962-d8ed-4318-8f45-d4b5248802e2
65	46	-19	GBIF Germany	4f6826f2-4ff6-443d-b966-e6913bd24013	8e7cb1ba-f762-11e1-a439-00145eb45e9a
160	131	-29	GBIF Germany	4f6826f2-4ff6-443d-b966-e6913bd24013	8eaf59da-f762-11e1-a439-00145eb45e9a
336	92	-244	GBIF Germany	4f6826f2-4ff6-443d-b966-e6913bd24013	8f2258c2-f762-11e1-a439-00145eb45e9a
133	129	-4	GBIF Germany	4f6826f2-4ff6-443d-b966-e6913bd24013	8f6f26c0-f762-11e1-a439-00145eb45e9a
229	143	-86	GBIF Germany	4f6826f2-4ff6-443d-b966-e6913bd24013	8fbc0eb8-f762-11e1-a439-00145eb45e9a
35	19	-16	GBIF Germany	4f6826f2-4ff6-443d-b966-e6913bd24013	901b4bda-f762-11e1-a439-00145eb45e9a
177	177	0	GBIF France	da44cd31-5901-4687-a106-6d1c7734ee3a	9080669f-257f-4ed0-817c-d2607b6fd4b9
178	178	0	GBIF Germany	4f6826f2-4ff6-443d-b966-e6913bd24013	921ed8e8-f762-11e1-a439-00145eb45e9a
666	261	-405	GBIF Germany	4f6826f2-4ff6-443d-b966-e6913bd24013	93514106-f762-11e1-a439-00145eb45e9a
8	8	0	Plazi	ffb07bec-2d10-492d-9c37-361fe0b79427	93bae98e-6143-4043-8797-d46a856c0ea7
2	2	0	Plazi	ffb07bec-2d10-492d-9c37-361fe0b79427	948a6442-517a-445c-ad6d-a1e80d990e97
372	372	0	GBIF Germany	4f6826f2-4ff6-443d-b966-e6913bd24013	95484054-f762-11e1-a439-00145eb45e9a
69846	69846	0	U.S. Geological Survey	8618c64a-93e0-4300-b546-7249e5148ed2	96b54e8c-f762-11e1-a439-00145eb45e9a
5087	5087	0	National Biodiversity Network	d897a5b9-35ee-4232-94bd-b0bcaac003c2	96da58de-9b38-4f8e-93f7-941ac1adfe35
25	25	0	GBIF Germany	4f6826f2-4ff6-443d-b966-e6913bd24013	976bc446-f762-11e1-a439-00145eb45e9a
6005	6006	1	Netherlands Biodiversity Information Facility	0909d601-bda2-42df-9e63-a6d51847ebce	9a025855-803d-4fa7-8417-ac7142544553
2977	2977	0	Biodiversity Information System of Mexico	b324e8e9-9a4c-44fa-8f1a-7f39ea7ab576	9a2dc5f6-feb1-4ee0-9e04-d83a5ca57bae
6	6	0	Plazi	ffb07bec-2d10-492d-9c37-361fe0b79427	a0cd032c-e3a1-4f69-b7c3-0a20554bb228
27	27	0	Plazi	ffb07bec-2d10-492d-9c37-361fe0b79427	a2afe874-9ec7-4101-8f63-da98506a340b
0	447	447	Colombian Biodiversity Information System	7e865cba-7c46-417b-ade5-97f2cf5b7be0	a3457ea8-7871-4a38-b093-804616f56235
1	1	0	Plazi	ffb07bec-2d10-492d-9c37-361fe0b79427	a4c1ba26-8640-4497-ac37-8a485c3c6462
1349	1349	0	Participant Node Managers Committee	7f48e0c8-5c96-49ec-b972-30748e339115	a6a119bb-abfd-4a94-811c-2a4f0f3ab7e2
100	668	568	GBIF Japan	db5705aa-6a6e-42f1-8942-d77b9f4896ea	a9a51437-b4e1-4e47-a9c4-c51d5e7f2532
70578	70663	85	GBIF Brazil	cdc9736d-5ff7-4ece-9959-3c744360cdb3	ada06364-2436-4f48-ad78-7033f7903fd0
0	61	61	Participant Node Managers Committee	7f48e0c8-5c96-49ec-b972-30748e339115	adec6538-d017-49e0-850c-6b48cb7e6ac7
6	6	0	Plazi	ffb07bec-2d10-492d-9c37-361fe0b79427	adfca13b-42d6-4270-a3dc-e914d3a772dd
185	185	0	Colombian Biodiversity Information System	7e865cba-7c46-417b-ade5-97f2cf5b7be0	b67a5520-2ed0-472b-aeb0-7ce3fa7ef2f9
63	63	0	GBIF France	da44cd31-5901-4687-a106-6d1c7734ee3a	b6fdfc37-c215-4425-89e9-45dd55cb669d
0	1208	1208	Ocean Biodiversity Information System	ba0670b9-4186-41e6-8e70-f9cb3065551a	b703e667-da11-48e3-8e44-41638b040d7d
0	697	697	Plazi	ffb07bec-2d10-492d-9c37-361fe0b79427	b7f231a2-b766-4f47-914c-c7d39518641f
0	4	4	Plazi	ffb07bec-2d10-492d-9c37-361fe0b79427	bc5f7c6e-ffec-4b54-8b61-2371f151bce1
0	230	230	Ocean Biodiversity Information System	ba0670b9-4186-41e6-8e70-f9cb3065551a	bdc2e2f1-58d2-45b8-91f4-6922ddf1a516
1	1	0	Plazi	ffb07bec-2d10-492d-9c37-361fe0b79427	be8d12a6-31b4-4b03-b229-71870ff41c26
166	166	0	GBIF Germany	4f6826f2-4ff6-443d-b966-e6913bd24013	be9bf8ca-92f0-4b72-8504-da2cc753a955
1701	1701	0	Observation International	ad048418-7cd8-4070-a151-fe1c1f303129	c5645d41-0978-4f99-89f5-317351335fef
4	4	0	GBIF France	da44cd31-5901-4687-a106-6d1c7734ee3a	c6bd9c9b-2838-48fc-bccf-2f9ab957364b
58	58	0	Plazi	ffb07bec-2d10-492d-9c37-361fe0b79427	c6ceea2b-a36e-4bda-bc7b-32e66b22a899
73907	73907	0	National Biodiversity Network	d897a5b9-35ee-4232-94bd-b0bcaac003c2	c6eaa8d0-cfbe-461f-b973-458e4f64bff6
552	552	0	GBIF Germany	4f6826f2-4ff6-443d-b966-e6913bd24013	c7432242-863e-4a0f-81d8-9596d3d5930b
0	270	270	GBIF Japan	db5705aa-6a6e-42f1-8942-d77b9f4896ea	c8863f96-639e-4433-beef-c9c5439ed0df
239	239	0	Scientific Committee on Antarctic Research	51e4e8ff-bff0-4996-8b27-9107d61b3478	ccba820a-bc62-4cf4-85f2-e0a991efcc6c
3	3	0	Plazi	ffb07bec-2d10-492d-9c37-361fe0b79427	ccbd7793-81c7-4fec-aa3b-787a6f43bf75
273	273	0	Belgian Biodiversity Platform	fb11cfe1-ebc3-45af-9159-17d9fddbcdac	d4ce1621-8469-49ad-86b8-91143c0e0490
6	6	0	Plazi	ffb07bec-2d10-492d-9c37-361fe0b79427	d633d2f0-31db-4352-804c-e78bfe6d2e9a
86	86	0	National Biodiversity Network	d897a5b9-35ee-4232-94bd-b0bcaac003c2	dcd95336-3633-4c7d-8dd0-f8f37ab09f6d
0	18	18	Ocean Biodiversity Information System	ba0670b9-4186-41e6-8e70-f9cb3065551a	dce19651-54bd-48a6-8975-104430cd44ff
416	416	0	GBIF Germany	4f6826f2-4ff6-443d-b966-e6913bd24013	df76bfc9-0a25-4893-9d85-3e9d70b131d1
0	29	29	Plazi	ffb07bec-2d10-492d-9c37-361fe0b79427	e617ba0d-6329-4481-8c82-15d70cee421c
4160	4160	0	GBIF Spain	1f94b3ca-9345-4d65-afe2-4bace93aa0fe	e893d23b-02d5-4b38-a612-56b75da7d852
1032	1176	144	U.S. Geological Survey	8618c64a-93e0-4300-b546-7249e5148ed2	e8c6d072-2955-4c3e-955c-d9dfb0a2f91d
4874	4874	0	National Biodiversity Network	d897a5b9-35ee-4232-94bd-b0bcaac003c2	ea13f5a7-cc36-48fc-ae53-a7fae2d89c6d
836	682	-154	GBIF Germany	4f6826f2-4ff6-443d-b966-e6913bd24013	ee979618-c526-41ae-ac67-07d8d7960776
6215	4713	-1502	GBIF Germany	4f6826f2-4ff6-443d-b966-e6913bd24013	efe888cb-95a9-4e6e-ae88-7c7f2dfb2bb8
5	5	0	Plazi	ffb07bec-2d10-492d-9c37-361fe0b79427	f0e953e6-155c-4999-b814-7193939340eb
74	74	0	GBIF France	da44cd31-5901-4687-a106-6d1c7734ee3a	f7f2457f-f01d-41dc-b597-18f282f35486
80	80	0	Biodiversity Information System of Mexico	b324e8e9-9a4c-44fa-8f1a-7f39ea7ab576	f8336bdf-b441-4fc3-affd-44b43ceb2c07
0	285	285	GBIF France	da44cd31-5901-4687-a106-6d1c7734ee3a	f83b17e2-fd3e-4456-b55e-e8a06029fce0
0	92	92	Plazi	ffb07bec-2d10-492d-9c37-361fe0b79427	fd5ba21e-09ce-4ac6-b84f-56632ed93917
1994	3983	1989	GBIF Brazil	cdc9736d-5ff7-4ece-9959-3c744360cdb3	0638cd34-da37-48f0-8dbe-2a2999905bc5
0	87	87	Plazi	ffb07bec-2d10-492d-9c37-361fe0b79427	0782b9e6-75e0-4a60-8533-accf528f085a
2	2	0	Plazi	ffb07bec-2d10-492d-9c37-361fe0b79427	0aaba6ec-9b0d-49be-8ffa-36aedb1720b2
0	1	1	Plazi	ffb07bec-2d10-492d-9c37-361fe0b79427	0abcaaa9-5829-412a-ac6c-fbc7a0d819ba
0	20	20	Ocean Biodiversity Information System	ba0670b9-4186-41e6-8e70-f9cb3065551a	0b4c543a-4e3a-454c-b577-0880c926e9de
3340	3340	0	GBIF Germany	4f6826f2-4ff6-443d-b966-e6913bd24013	11a9393f-2fe9-4404-ad1d-3f2f6c1a6376
17	17	0	Plazi	ffb07bec-2d10-492d-9c37-361fe0b79427	11aedfc6-6618-4f16-99d4-2aff0c9c15fa
2	2	0	Plazi	ffb07bec-2d10-492d-9c37-361fe0b79427	1416347f-de37-48cf-b502-5aba87136d92
2911	2911	0	U.S. Geological Survey	8618c64a-93e0-4300-b546-7249e5148ed2	147e1b93-9e2d-43a2-a34d-18738edeaa24
5697	6910	1213	GBIF Japan	db5705aa-6a6e-42f1-8942-d77b9f4896ea	16889455-cf40-4269-a108-77339a42075c
1	1	0	Plazi	ffb07bec-2d10-492d-9c37-361fe0b79427	179c5d36-13f1-4e49-b207-2ab71c406622
5	5	0	Plazi	ffb07bec-2d10-492d-9c37-361fe0b79427	184fc69e-fa6d-4f58-8379-2964618fedd3
828	828	0	U.S. Geological Survey	8618c64a-93e0-4300-b546-7249e5148ed2	19f9e020-221e-4fac-b2af-458fbe4bff91
1426	1426	0	GBIF Germany	4f6826f2-4ff6-443d-b966-e6913bd24013	1a581e5e-546d-4e13-a8e7-fbd509c6a7cd
2	2	0	Plazi	ffb07bec-2d10-492d-9c37-361fe0b79427	1b1643cc-ca0f-4f40-91f8-623751f5d494
27	27	0	GBIF France	da44cd31-5901-4687-a106-6d1c7734ee3a	1daa1622-5942-484f-88e5-25c5a548bed5
0	42	42	Plazi	ffb07bec-2d10-492d-9c37-361fe0b79427	1e6aab98-930d-40c9-9200-0d781640f65c
3	3	0	Plazi	ffb07bec-2d10-492d-9c37-361fe0b79427	1f2a1b96-d37c-461d-b828-dcd9b2f0b8c5
0	6	6	Ocean Biodiversity Information System	ba0670b9-4186-41e6-8e70-f9cb3065551a	1f92cbb4-0e06-43f6-b89e-b1a9da956db9
5646	5646	0	National Biodiversity Network	d897a5b9-35ee-4232-94bd-b0bcaac003c2	222fd799-0041-4067-8d1a-a36e6df1cc72
61	60	-1	Plazi	ffb07bec-2d10-492d-9c37-361fe0b79427	260e27c9-9690-4148-b9a2-36dbfb1d27d6
31	1003	972	GBIF Germany	4f6826f2-4ff6-443d-b966-e6913bd24013	2ba359f4-0524-4a9e-82fb-322b6723f506
0	13684	13684	Participant Node Managers Committee	7f48e0c8-5c96-49ec-b972-30748e339115	2ccf651c-2974-4ac5-807c-dd43cb7de973
0	3148	3148	GBIF Japan	db5705aa-6a6e-42f1-8942-d77b9f4896ea	2fac9c25-36ec-4291-afdb-15674e5b71cc
7	7	0	Plazi	ffb07bec-2d10-492d-9c37-361fe0b79427	308d6e03-c026-4284-87e7-d30bdf6fa553
8	8	0	Plazi	ffb07bec-2d10-492d-9c37-361fe0b79427	3162f881-3550-4b5b-bc50-969f41acc02f
1469	1469	0	National Biodiversity Network	d897a5b9-35ee-4232-94bd-b0bcaac003c2	34f3ec9f-17e2-4b6f-9148-45cbd6b45baf
9877	9877	0	National Biodiversity Network	d897a5b9-35ee-4232-94bd-b0bcaac003c2	35752720-9dc9-40ce-aea5-63915e8aeb0e
0	1	1	Plazi	ffb07bec-2d10-492d-9c37-361fe0b79427	358054e6-cd87-43e4-b7e5-8a5a595491ca
0	8	8	Plazi	ffb07bec-2d10-492d-9c37-361fe0b79427	35f02296-6df2-4250-b16a-a9117c162d85
0	2	2	Plazi	ffb07bec-2d10-492d-9c37-361fe0b79427	386dea4d-2625-4105-93ba-87f4eee7d79c
0	202	202	U.S. Geological Survey	8618c64a-93e0-4300-b546-7249e5148ed2	39af39be-ccd5-4a36-800a-c6ca4a4bb3b5
0	8	8	Plazi	ffb07bec-2d10-492d-9c37-361fe0b79427	3b930803-e9e7-4a9e-ab6c-73cf871469ee
12	12	0	Plazi	ffb07bec-2d10-492d-9c37-361fe0b79427	3ca5cabc-507e-440d-a33e-33a45d441eb5
2	2	0	Plazi	ffb07bec-2d10-492d-9c37-361fe0b79427	3d852dd4-13fe-4139-af6e-dc723772a7ff
44	44	0	Plazi	ffb07bec-2d10-492d-9c37-361fe0b79427	430a96d1-f5cd-4234-a35d-3f324ed63974
3348	3348	0	GBIF Uganda	71b40829-6a12-4c3d-8fee-5746f5e9cf8c	48a18d17-96f2-4a0d-89ad-bbe1ac6ce72c
138	138	0	GBIF France	da44cd31-5901-4687-a106-6d1c7734ee3a	4a1bd1bd-52a0-45db-8830-958ac4df35a5
230	230	0	GBIF France	da44cd31-5901-4687-a106-6d1c7734ee3a	4a9cbc1e-43ad-4cb2-ae60-9751567f0fc5
198	198	0	GBIF Germany	4f6826f2-4ff6-443d-b966-e6913bd24013	4d739993-779f-44f7-a222-8cce3e4237fe
98	98	0	Colombian Biodiversity Information System	7e865cba-7c46-417b-ade5-97f2cf5b7be0	5003df4a-f0a0-45c7-862f-f2ef769eb08e
0	74	74	GBIF Spain	1f94b3ca-9345-4d65-afe2-4bace93aa0fe	527885fc-bae8-48fd-8e13-349bb6dae9b8
272730	348709	75979	National Biodiversity Network	d897a5b9-35ee-4232-94bd-b0bcaac003c2	52827ade-d745-4d26-b45f-6694adaede6f
8058	8058	0	Participant Node Managers Committee	7f48e0c8-5c96-49ec-b972-30748e339115	52855660-ce87-4312-9538-fefde37134b6
0	3	3	Plazi	ffb07bec-2d10-492d-9c37-361fe0b79427	598ea0a7-8800-412c-b62c-b73757407163
0	3	3	Plazi	ffb07bec-2d10-492d-9c37-361fe0b79427	599adce2-d538-44b9-bd10-53bec0ae25d7
0	10	10	Plazi	ffb07bec-2d10-492d-9c37-361fe0b79427	5a347ee5-0d8e-4851-9b8e-f00f37173214
1	1	0	Plazi	ffb07bec-2d10-492d-9c37-361fe0b79427	5adaed8a-c1bb-48b3-bd0e-fd1022bac4fa
0	284	284	International Centre for Integrated Mountain Development	b35cf8f1-748d-467a-adca-4f9170f20a4e	5bab4ce6-b2cf-430c-b659-4076122a6eec
3	3	0	Plazi	ffb07bec-2d10-492d-9c37-361fe0b79427	5ede5d11-05f4-4a80-8f30-347409196e3a
88	88	0	GBIF Germany	4f6826f2-4ff6-443d-b966-e6913bd24013	6134eab0-f762-11e1-a439-00145eb45e9a
313	313	0	GBIF Germany	4f6826f2-4ff6-443d-b966-e6913bd24013	617a519a-f762-11e1-a439-00145eb45e9a
39	39	0	GBIF Germany	4f6826f2-4ff6-443d-b966-e6913bd24013	6185910e-f762-11e1-a439-00145eb45e9a
12	12	0	GBIF Germany	4f6826f2-4ff6-443d-b966-e6913bd24013	61c198ac-f762-11e1-a439-00145eb45e9a
92	92	0	GBIF Germany	4f6826f2-4ff6-443d-b966-e6913bd24013	622e4cae-f762-11e1-a439-00145eb45e9a
65	65	0	Colombian Biodiversity Information System	7e865cba-7c46-417b-ade5-97f2cf5b7be0	64093f43-3f97-456d-b71d-2b75b03ba972
176	176	0	GBIF Germany	4f6826f2-4ff6-443d-b966-e6913bd24013	645631cc-f762-11e1-a439-00145eb45e9a
8	8	0	GBIF Germany	4f6826f2-4ff6-443d-b966-e6913bd24013	64d67846-f762-11e1-a439-00145eb45e9a
28	28	0	GBIF Germany	4f6826f2-4ff6-443d-b966-e6913bd24013	64d79938-f762-11e1-a439-00145eb45e9a
2	2	0	Plazi	ffb07bec-2d10-492d-9c37-361fe0b79427	69341aec-22bb-4407-89b1-4a26e22d16db
126	128	2	GBIF Germany	4f6826f2-4ff6-443d-b966-e6913bd24013	6956c27d-1653-4663-8f24-9d21b60d69ad
3447	3447	0	GBIF Argentina	2426a871-9feb-40a1-96c6-0c593a76b835	69a53df8-4ca0-412c-8691-6cbe90827fad
78	78	0	GBIF Germany	4f6826f2-4ff6-443d-b966-e6913bd24013	69bee230-f762-11e1-a439-00145eb45e9a
24	24	0	GBIF Germany	4f6826f2-4ff6-443d-b966-e6913bd24013	6ba08446-f762-11e1-a439-00145eb45e9a
3	3	0	Plazi	ffb07bec-2d10-492d-9c37-361fe0b79427	6bae9a46-16b5-4022-9046-f404a1f1b745
14	14	0	GBIF Germany	4f6826f2-4ff6-443d-b966-e6913bd24013	6bf98532-f762-11e1-a439-00145eb45e9a
0	3713	3713	GBIF Portugal	673f7038-4262-4149-b753-5658a4e912f6	6ecf46f8-546b-40d2-80a3-8d72fb14d529
267	267	0	GBIF Norway	4f829580-180d-46a9-9c87-ed8ec959b545	6f71c498-3365-4038-979a-562fd0935ace
0	1	1	Plazi	ffb07bec-2d10-492d-9c37-361fe0b79427	71810414-2263-4e2f-b516-7d9f5938d290
57	57	0	Atlas of Living Australia	4a6f1b71-969e-4fc5-a693-282b05e1220c	71d33bce-f762-11e1-a439-00145eb45e9a
200	200	0	GBIF Germany	4f6826f2-4ff6-443d-b966-e6913bd24013	727619c0-f762-11e1-a439-00145eb45e9a
546	546	0	GBIF Germany	4f6826f2-4ff6-443d-b966-e6913bd24013	7278a1c2-f762-11e1-a439-00145eb45e9a
0	3	3	Plazi	ffb07bec-2d10-492d-9c37-361fe0b79427	729cbb60-952c-4f1e-ad96-89c15eed89af
12	12	0	GBIF Germany	4f6826f2-4ff6-443d-b966-e6913bd24013	735db848-f762-11e1-a439-00145eb45e9a
5	5	0	GBIF Germany	4f6826f2-4ff6-443d-b966-e6913bd24013	735ef0e6-f762-11e1-a439-00145eb45e9a
10	10	0	Plazi	ffb07bec-2d10-492d-9c37-361fe0b79427	73ed195b-2e03-4316-ac3d-91b8d6911fc3
79	79	0	GBIF Germany	4f6826f2-4ff6-443d-b966-e6913bd24013	746e11e2-f762-11e1-a439-00145eb45e9a
13	13	0	GBIF Germany	4f6826f2-4ff6-443d-b966-e6913bd24013	74c13020-f762-11e1-a439-00145eb45e9a
111	111	0	GBIF Germany	4f6826f2-4ff6-443d-b966-e6913bd24013	74c90be2-f762-11e1-a439-00145eb45e9a
26	26	0	GBIF Germany	4f6826f2-4ff6-443d-b966-e6913bd24013	75111fa4-f762-11e1-a439-00145eb45e9a
938193	1015862	77669	GBIF Switzerland	169eb292-376b-4cc6-8e31-9c2c432de0ad	754e1720-be12-4ed6-a873-11a6f95aca47
6	6	0	Plazi	ffb07bec-2d10-492d-9c37-361fe0b79427	778b3715-635c-4d46-9d08-8d355fa91d5f
17	17	0	GBIF Germany	4f6826f2-4ff6-443d-b966-e6913bd24013	78a8d918-f762-11e1-a439-00145eb45e9a
0	1338	1338	National Biodiversity Network	d897a5b9-35ee-4232-94bd-b0bcaac003c2	78ffba3f-cbea-4637-b0cd-b51a495fdeec
445	394	-51	GBIF Germany	4f6826f2-4ff6-443d-b966-e6913bd24013	79408bc8-f762-11e1-a439-00145eb45e9a
1	1	0	Plazi	ffb07bec-2d10-492d-9c37-361fe0b79427	7a8f9c70-36cb-40f5-b98c-7b2568da1192
2072	2072	0	GBIF Spain	1f94b3ca-9345-4d65-afe2-4bace93aa0fe	7bad7786-f762-11e1-a439-00145eb45e9a
420	420	0	GBIF Germany	4f6826f2-4ff6-443d-b966-e6913bd24013	7be959b8-f762-11e1-a439-00145eb45e9a
38	38	0	GBIF Germany	4f6826f2-4ff6-443d-b966-e6913bd24013	7c317c2a-f762-11e1-a439-00145eb45e9a
16	16	0	Plazi	ffb07bec-2d10-492d-9c37-361fe0b79427	7c4a5df1-45ab-459e-a37b-de55c5751d3b
6682	6682	0	GBIF Sweden	a0b3be64-6525-4387-ac67-a499950f92e1	7c660871-3c5a-4db6-94d0-a6a646f9e16f
48	52	4	GBIF Germany	4f6826f2-4ff6-443d-b966-e6913bd24013	7d25618c-f762-11e1-a439-00145eb45e9a
4428	4428	0	GBIF Germany	4f6826f2-4ff6-443d-b966-e6913bd24013	7d82d70e-f762-11e1-a439-00145eb45e9a
1364	1364	0	GBIF Germany	4f6826f2-4ff6-443d-b966-e6913bd24013	7d894e4a-f762-11e1-a439-00145eb45e9a
352	288	-64	GBIF Germany	4f6826f2-4ff6-443d-b966-e6913bd24013	7da02ec6-f762-11e1-a439-00145eb45e9a
6	6	0	Plazi	ffb07bec-2d10-492d-9c37-361fe0b79427	7dee8057-ede0-4960-af73-b5a869e7293a
0	2558	2558	Ocean Biodiversity Information System	ba0670b9-4186-41e6-8e70-f9cb3065551a	7e1cc034-8644-4c76-916d-c911232dc835
0	23	23	Plazi	ffb07bec-2d10-492d-9c37-361fe0b79427	7e48f393-1f30-4ca7-98f9-3106358f2a1e
18	18	0	GBIF Germany	4f6826f2-4ff6-443d-b966-e6913bd24013	7e4c62e0-f762-11e1-a439-00145eb45e9a
204	204	0	GBIF Germany	4f6826f2-4ff6-443d-b966-e6913bd24013	7e77e62c-f762-11e1-a439-00145eb45e9a
0	144	144	GBIF Portugal	673f7038-4262-4149-b753-5658a4e912f6	7ead7d79-2a5b-489f-80db-d4826a725edd
102	102	0	GBIF Germany	4f6826f2-4ff6-443d-b966-e6913bd24013	7f1e1e7a-f762-11e1-a439-00145eb45e9a
1	1	0	Plazi	ffb07bec-2d10-492d-9c37-361fe0b79427	7faaa125-e85b-4e6a-839f-369f3baa5964
22181	22181	0	Biodiversity Information System of Mexico	b324e8e9-9a4c-44fa-8f1a-7f39ea7ab576	8052bdc8-f762-11e1-a439-00145eb45e9a
6964	6964	0	Biodiversity Information System of Mexico	b324e8e9-9a4c-44fa-8f1a-7f39ea7ab576	809077e4-f762-11e1-a439-00145eb45e9a
1660	1660	0	Biodiversity Information System of Mexico	b324e8e9-9a4c-44fa-8f1a-7f39ea7ab576	809a9ac6-f762-11e1-a439-00145eb45e9a
35	35	0	GBIF Japan	db5705aa-6a6e-42f1-8942-d77b9f4896ea	80e31fd0-f762-11e1-a439-00145eb45e9a
143	143	0	GBIF Japan	db5705aa-6a6e-42f1-8942-d77b9f4896ea	81070f80-f762-11e1-a439-00145eb45e9a
40481	40481	0	National Biodiversity Network	d897a5b9-35ee-4232-94bd-b0bcaac003c2	824c7e2e-d2fb-466f-bf1b-ee975f1f6956
61	61	0	Plazi	ffb07bec-2d10-492d-9c37-361fe0b79427	82fc2810-05b8-4265-adae-5b21e7d91b00
376	376	0	GBIF Germany	4f6826f2-4ff6-443d-b966-e6913bd24013	86f779d4-f762-11e1-a439-00145eb45e9a
493	170	-323	GBIF Germany	4f6826f2-4ff6-443d-b966-e6913bd24013	8794c522-f762-11e1-a439-00145eb45e9a
1532	1104	-428	GBIF Germany	4f6826f2-4ff6-443d-b966-e6913bd24013	879a1482-f762-11e1-a439-00145eb45e9a
58	58	0	Plazi	ffb07bec-2d10-492d-9c37-361fe0b79427	87d8415f-2b8a-4b1c-b85b-e7417105206a
1325	1325	0	GBIF Germany	4f6826f2-4ff6-443d-b966-e6913bd24013	8945c196-f762-11e1-a439-00145eb45e9a
104	104	0	GBIF Germany	4f6826f2-4ff6-443d-b966-e6913bd24013	8b8e91f8-f762-11e1-a439-00145eb45e9a
65	65	0	Plazi	ffb07bec-2d10-492d-9c37-361fe0b79427	8bd15d85-4cb6-4032-9c82-7bbb95d2f104
10	10	0	GBIF Germany	4f6826f2-4ff6-443d-b966-e6913bd24013	8c0c2d52-f762-11e1-a439-00145eb45e9a
121	121	0	GBIF Germany	4f6826f2-4ff6-443d-b966-e6913bd24013	8c4d8676-f762-11e1-a439-00145eb45e9a
22	17	-5	GBIF Germany	4f6826f2-4ff6-443d-b966-e6913bd24013	8c6685c2-f762-11e1-a439-00145eb45e9a
1033	1033	0	GBIF Germany	4f6826f2-4ff6-443d-b966-e6913bd24013	8d7f7b62-f762-11e1-a439-00145eb45e9a
10	10	0	Plazi	ffb07bec-2d10-492d-9c37-361fe0b79427	8e18452b-1d9d-462e-bac8-8c86eeb4ddc3
477	256	-221	GBIF Germany	4f6826f2-4ff6-443d-b966-e6913bd24013	8f13de64-f762-11e1-a439-00145eb45e9a
48	20	-28	GBIF Germany	4f6826f2-4ff6-443d-b966-e6913bd24013	8fe81b20-f762-11e1-a439-00145eb45e9a
35	23	-12	GBIF Germany	4f6826f2-4ff6-443d-b966-e6913bd24013	8ffc39d4-f762-11e1-a439-00145eb45e9a
4459	3458	-1001	GBIF Germany	4f6826f2-4ff6-443d-b966-e6913bd24013	90ac3316-f762-11e1-a439-00145eb45e9a
3	3	0	GBIF Germany	4f6826f2-4ff6-443d-b966-e6913bd24013	91090398-f762-11e1-a439-00145eb45e9a
109	100	-9	GBIF Germany	4f6826f2-4ff6-443d-b966-e6913bd24013	917e4144-f762-11e1-a439-00145eb45e9a
822	824	2	GBIF Germany	4f6826f2-4ff6-443d-b966-e6913bd24013	91fefa64-f762-11e1-a439-00145eb45e9a
35	33	-2	GBIF Germany	4f6826f2-4ff6-443d-b966-e6913bd24013	932d21ea-f762-11e1-a439-00145eb45e9a
714	714	0	GBIF Germany	4f6826f2-4ff6-443d-b966-e6913bd24013	93af1de4-f762-11e1-a439-00145eb45e9a
66932	66932	0	Colombian Biodiversity Information System	7e865cba-7c46-417b-ade5-97f2cf5b7be0	94281e3c-4518-498a-acd7-529f2cb61541
266	226	-40	GBIF Germany	4f6826f2-4ff6-443d-b966-e6913bd24013	95004632-f762-11e1-a439-00145eb45e9a
432	432	0	GBIF Germany	4f6826f2-4ff6-443d-b966-e6913bd24013	950d903a-f762-11e1-a439-00145eb45e9a
10837	10756	-81	GBIF Germany	4f6826f2-4ff6-443d-b966-e6913bd24013	966092f2-f762-11e1-a439-00145eb45e9a
1137	1137	0	Colombian Biodiversity Information System	7e865cba-7c46-417b-ade5-97f2cf5b7be0	9cffad6e-51b7-45ca-8679-32374a07f884
322	322	0	GBIF France	da44cd31-5901-4687-a106-6d1c7734ee3a	9d9382ce-addf-43bd-b21a-d258988ec5d8
0	14	14	Plazi	ffb07bec-2d10-492d-9c37-361fe0b79427	9e3a5043-5b96-4202-b658-d6bf0d68fe71
15	15	0	Plazi	ffb07bec-2d10-492d-9c37-361fe0b79427	9e3e032c-3c08-4b9f-8763-a45e0f2c79d5
0	7	7	Plazi	ffb07bec-2d10-492d-9c37-361fe0b79427	9f355bf4-4e90-4db3-af0e-c04f11ceb309
14004	14004	0	GBIF France	da44cd31-5901-4687-a106-6d1c7734ee3a	9fbdf377-6d9d-4f71-848b-9a054660cd50
0	2	2	Plazi	ffb07bec-2d10-492d-9c37-361fe0b79427	9ffd0543-6d37-4cec-81d4-75ce55590ec2
289	289	0	GBIF Germany	4f6826f2-4ff6-443d-b966-e6913bd24013	a0eded8f-31e6-4edd-b0b3-fc0b0040e61a
5412	5412	0	Participant Node Managers Committee	7f48e0c8-5c96-49ec-b972-30748e339115	a3f7d0d8-d9e1-42ae-b1f7-d1fc445b931d
483	483	0	U.S. Geological Survey	8618c64a-93e0-4300-b546-7249e5148ed2	a6a1d66f-07aa-4618-becd-98d9efadb592
433024	433024	0	National Biodiversity Network	d897a5b9-35ee-4232-94bd-b0bcaac003c2	a7e947a1-15d4-43ab-a244-b4e7511e5423
286	286	0	Colombian Biodiversity Information System	7e865cba-7c46-417b-ade5-97f2cf5b7be0	a861c55c-c1a4-4fa9-8771-bb68d79b85f9
0	44	44	Plazi	ffb07bec-2d10-492d-9c37-361fe0b79427	a970ee4f-2a7e-4eee-a151-53ea3e2a5e93
1280	1280	0	Plazi	ffb07bec-2d10-492d-9c37-361fe0b79427	aaaa853e-f89e-4090-81d4-a4406eebfc53
387	387	0	Plazi	ffb07bec-2d10-492d-9c37-361fe0b79427	ac866645-a8b9-45a8-8c7d-d3aff74ede70
2	2	0	Plazi	ffb07bec-2d10-492d-9c37-361fe0b79427	acf79d2f-efe9-413f-9109-9e9ef8dc1bb9
3375	3375	0	National Biodiversity Network	d897a5b9-35ee-4232-94bd-b0bcaac003c2	aded4859-38ce-4f88-b6a0-2944eb355232
0	36891	36891	Ocean Biodiversity Information System	ba0670b9-4186-41e6-8e70-f9cb3065551a	b008fb96-9f99-4a2d-badd-7af1bc587479
11	11	0	GBIF France	da44cd31-5901-4687-a106-6d1c7734ee3a	b0d37c31-2bd0-4a3a-8e8a-bacd25ed9bac
0	9242	9242	Korean Biodiversity Information Facility	e0a1e772-0177-4800-94b4-2d023fe6cdf4	b19c5fce-2b1b-4486-b601-f8ddf2ad1e21
0	23	23	Ocean Biodiversity Information System	ba0670b9-4186-41e6-8e70-f9cb3065551a	b294368d-2a68-4903-8c48-7868c14ba1fd
4	4	0	Plazi	ffb07bec-2d10-492d-9c37-361fe0b79427	b3393ae3-99a2-42b5-844e-fa6116706452
0	8	8	Plazi	ffb07bec-2d10-492d-9c37-361fe0b79427	b9f530e5-23c6-4eb7-b5c2-a2a0abeab1cb
27	27	0	Plazi	ffb07bec-2d10-492d-9c37-361fe0b79427	ba4022be-a185-4861-a1f2-25d805023a05
5	5	0	Plazi	ffb07bec-2d10-492d-9c37-361fe0b79427	ba418463-6885-413b-86cd-dc14d280c1a4
5372	5372	0	National Biodiversity Network	d897a5b9-35ee-4232-94bd-b0bcaac003c2	ba9b01b4-eeb6-4489-a774-bcadfb2a177b
3	3	0	Plazi	ffb07bec-2d10-492d-9c37-361fe0b79427	bbf1ea22-1d3a-41c3-b4da-c2b1c4fad0a8
0	37	37	Plazi	ffb07bec-2d10-492d-9c37-361fe0b79427	bc954819-93f2-4896-a1fa-23c0f94ac1b5
903681	1032245	128564	National Biodiversity Network	d897a5b9-35ee-4232-94bd-b0bcaac003c2	bf2a4bf0-5f31-11de-b67e-b8a03c50a862
137	137	0	Plazi	ffb07bec-2d10-492d-9c37-361fe0b79427	bf72ba01-7fc5-46da-81ed-0aabfd051be2
1429	1429	0	GBIF France	da44cd31-5901-4687-a106-6d1c7734ee3a	c050578a-1473-49ed-b7b7-c9a9d5da34fa
342	342	0	GBIF France	da44cd31-5901-4687-a106-6d1c7734ee3a	c213900a-a4d5-484e-aa5a-962f74951ff7
0	24	24	Colombian Biodiversity Information System	7e865cba-7c46-417b-ade5-97f2cf5b7be0	c2484bf0-a0c8-487f-b23e-cce34d89945e
93	93	0	Colombian Biodiversity Information System	7e865cba-7c46-417b-ade5-97f2cf5b7be0	c4c0a52d-d57d-4fa7-870e-8c3f1fea3c67
286	286	0	South African Biodiversity Information Facility	7190b835-4e86-4b6e-85c1-19cc6677c250	c566874c-6163-4098-8778-778fee6fa41f
67	67	0	GBIF Brazil	cdc9736d-5ff7-4ece-9959-3c744360cdb3	c6a35782-e0e3-4309-8f10-dc82f2b4f591
0	96	96	Plazi	ffb07bec-2d10-492d-9c37-361fe0b79427	c6da4c65-81a6-4aa0-9175-97c370049d3e
4	4	0	Plazi	ffb07bec-2d10-492d-9c37-361fe0b79427	c755a855-c47b-4da1-b7e0-7264a5225604
0	341	341	Plazi	ffb07bec-2d10-492d-9c37-361fe0b79427	c76945b8-a204-41fc-9418-0e8fbebd195f
0	3	3	Plazi	ffb07bec-2d10-492d-9c37-361fe0b79427	c9b017b0-202e-4cfc-863d-f3fbd581e2be
2	2	0	Plazi	ffb07bec-2d10-492d-9c37-361fe0b79427	cc1e52b4-d55f-49e8-9a0e-50bd7cc98173
17361	17361	0	Atlas of Living Australia	4a6f1b71-969e-4fc5-a693-282b05e1220c	ce1faba4-d8d9-46ac-ba26-cffe03eadc99
4	4	0	Colombian Biodiversity Information System	7e865cba-7c46-417b-ade5-97f2cf5b7be0	cf9dd398-202d-46ed-9198-9238f06ed719
1957	1957	0	GBIF Israel	8cb55387-7802-40e8-86d6-d357a583c596	cfb98735-6065-42fa-8613-fce70d39cbbe
133	133	0	Plazi	ffb07bec-2d10-492d-9c37-361fe0b79427	d1ca4b58-0fd8-4bcb-8f81-12fc2c106b55
563	563	0	Participant Node Managers Committee	7f48e0c8-5c96-49ec-b972-30748e339115	d53f0526-a5b8-47b7-b42d-4f9bf2c234f6
6	6	0	Plazi	ffb07bec-2d10-492d-9c37-361fe0b79427	d5ce5b6c-1740-4063-8636-f3db97a0aa13
4	4	0	Plazi	ffb07bec-2d10-492d-9c37-361fe0b79427	d698852c-791b-47b6-ac13-056ec833e5f6
86	86	0	GBIF France	da44cd31-5901-4687-a106-6d1c7734ee3a	d78971be-5bd3-4f2b-aefd-16d437d8f0da
0	32	32	Plazi	ffb07bec-2d10-492d-9c37-361fe0b79427	d866af6f-cbcd-47f4-a4f3-1499c1789ae3
11	11	0	Plazi	ffb07bec-2d10-492d-9c37-361fe0b79427	dc004088-b648-4c94-bd4b-81131365cecf
0	45	45	Plazi	ffb07bec-2d10-492d-9c37-361fe0b79427	dc963ed5-f02e-4a8c-b857-2069a8eba165
7911814	7911814	0	GBIF France	da44cd31-5901-4687-a106-6d1c7734ee3a	dd238f50-f594-4e51-82af-033227ccab55
953	953	0	GBIF France	da44cd31-5901-4687-a106-6d1c7734ee3a	df3b8f93-c1f0-4fdb-98f2-bd740ce0200b
70	65	-5	Plazi	ffb07bec-2d10-492d-9c37-361fe0b79427	df72ce47-0978-44ee-ad25-a793ce447827
592	592	0	GBIF France	da44cd31-5901-4687-a106-6d1c7734ee3a	e1cea0b9-cf5e-46bc-ba04-d7406250c932
2	2	0	Plazi	ffb07bec-2d10-492d-9c37-361fe0b79427	e3522865-dc15-4cb0-8496-e371a9544bac
0	425	425	Plazi	ffb07bec-2d10-492d-9c37-361fe0b79427	e4ba7f86-bec3-4bce-bdb4-441437c9764e
0	61	61	Plazi	ffb07bec-2d10-492d-9c37-361fe0b79427	e5e40b8e-a6b7-4d27-b571-d0994d61987d
972	972	0	Colombian Biodiversity Information System	7e865cba-7c46-417b-ade5-97f2cf5b7be0	e61f1cc7-d7cd-4884-a4b8-b41de46d101c
346	346	0	GBIF Sweden	a0b3be64-6525-4387-ac67-a499950f92e1	e893c8ba-036b-440c-9451-96a3361d0368
161	49	-112	GBIF Germany	4f6826f2-4ff6-443d-b966-e6913bd24013	ee26e5d4-a99d-471e-b8d2-7985403e2b66
75	75	0	GBIF Germany	4f6826f2-4ff6-443d-b966-e6913bd24013	f13e3080-e1d5-4d0f-a5e1-d8f2fe9bdb4b
7	7	0	GBIF Malawi	2a42e4d7-ad4a-41b3-84c4-de4aa7b74d35	f1b9d909-2315-49ee-ab86-9bb4118a2a57
1223	845	-378	GBIF Germany	4f6826f2-4ff6-443d-b966-e6913bd24013	f25dac7a-8127-4689-b31a-0fc4896aeeff
7657	7657	0	GBIF New Zealand	4f9fd726-20dd-445e-89a1-8ed93792276f	f2ab6184-eff7-4069-a9bb-e4f366aeefff
38	38	0	GBIF Norway	4f829580-180d-46a9-9c87-ed8ec959b545	f4450b7b-6f75-495f-a18d-d08d1f8d77d0
3989	3989	0	GBIF France	da44cd31-5901-4687-a106-6d1c7734ee3a	f4945f56-d5d5-4b58-886f-c2bf40f17c9a
16	16	0	Plazi	ffb07bec-2d10-492d-9c37-361fe0b79427	f7eb4ca8-8e77-4882-ae27-320290999cea
115	115	0	Plazi	ffb07bec-2d10-492d-9c37-361fe0b79427	f8879d20-c55d-475a-bc21-180c57b0a334
55202	55202	0	National Biodiversity Network	d897a5b9-35ee-4232-94bd-b0bcaac003c2	f9364cd0-4e7d-48de-a5b8-bcaa1e4fd1e4
102	102	0	Belgian Biodiversity Platform	fb11cfe1-ebc3-45af-9159-17d9fddbcdac	fb83157c-53b4-45fc-9468-66402ecfd173
0	33	33	Ocean Biodiversity Information System	ba0670b9-4186-41e6-8e70-f9cb3065551a	fdea3451-9eee-4ed0-8e2a-ae893582a22b
218	218	0	GBIF Norway	4f829580-180d-46a9-9c87-ed8ec959b545	fe7fa086-1b67-4c90-abe1-123048ead530
2	2	0	Plazi	ffb07bec-2d10-492d-9c37-361fe0b79427	fff15576-defd-43f8-8079-7debcb3b45bc
6	6	0	Plazi	ffb07bec-2d10-492d-9c37-361fe0b79427	006bc912-940f-438c-942a-23cd5ad80a26
0	260	260	Ocean Biodiversity Information System	ba0670b9-4186-41e6-8e70-f9cb3065551a	00766494-f1d1-4ab9-8b89-220287d5fdb9
2	2	0	Participant Node Managers Committee	7f48e0c8-5c96-49ec-b972-30748e339115	01231111-0318-4e96-b897-f23269175b03
7	7	0	GBIF France	da44cd31-5901-4687-a106-6d1c7734ee3a	02998021-4e8b-4a84-bc3e-86015b1dc54f
0	1195	1195	Ocean Biodiversity Information System	ba0670b9-4186-41e6-8e70-f9cb3065551a	054cfdf9-ccff-4eb3-a815-ee934cf11e04
17	17	0	Plazi	ffb07bec-2d10-492d-9c37-361fe0b79427	075b21f7-4db1-445f-87da-7e2e1805c4b5
94	94	0	GBIF Germany	4f6826f2-4ff6-443d-b966-e6913bd24013	0810681f-a345-4272-b0c8-475ad737436b
1097	1097	0	National Biodiversity Network	d897a5b9-35ee-4232-94bd-b0bcaac003c2	09d0d38e-7912-44d1-9187-7f9dfa7bb57d
66	66	0	Plazi	ffb07bec-2d10-492d-9c37-361fe0b79427	09fc6938-3ca8-41a8-8c92-898b180df238
1190	1190	0	Colombian Biodiversity Information System	7e865cba-7c46-417b-ade5-97f2cf5b7be0	0a804191-aee4-4d44-99dc-dab5792c6d95
21808	21808	0	Atlas of Living Australia	4a6f1b71-969e-4fc5-a693-282b05e1220c	0b9d46d1-4e57-4114-987a-083815522cf4
12	12	0	Plazi	ffb07bec-2d10-492d-9c37-361fe0b79427	0bf63512-9d52-45d8-9256-45fd2e094799
0	3	3	Plazi	ffb07bec-2d10-492d-9c37-361fe0b79427	0e5b0ed0-ef93-47f1-9ffe-60aaea0f0b40
0	16	16	Plazi	ffb07bec-2d10-492d-9c37-361fe0b79427	0ecaeb51-3fad-4aad-92c6-d6f0bd8eff54
36	36	0	Secretariat of the Pacific Regional Environment Programme	29c6a139-ea7f-41f5-8d9b-c55af8736182	11f7be1d-fdf3-4753-bfb0-c61ddbde3303
22	22	0	GBIF Argentina	2426a871-9feb-40a1-96c6-0c593a76b835	197fd192-af5d-459f-8e15-e40f8f9267a7
247577	247577	0	National Biodiversity Network	d897a5b9-35ee-4232-94bd-b0bcaac003c2	1a200d08-ea10-4774-a41a-ff1f3da92eb1
1012	1012	0	GBIF France	da44cd31-5901-4687-a106-6d1c7734ee3a	1e36f444-b03b-478e-98c4-39339afd3ddc
544	544	0	Netherlands Biodiversity Information Facility	0909d601-bda2-42df-9e63-a6d51847ebce	1eb5e969-4412-4f08-81ec-3de057e559a1
46	46	0	Plazi	ffb07bec-2d10-492d-9c37-361fe0b79427	1f301d41-4842-4f5f-ad27-c52b70c04ab5
8943	8943	0	U.S. Geological Survey	8618c64a-93e0-4300-b546-7249e5148ed2	212a4207-f330-49e7-8c84-51dccf3f1a8b
2174	2174	0	U.S. Geological Survey	8618c64a-93e0-4300-b546-7249e5148ed2	226b536c-25f9-4f6b-b144-edcbdffa3566
17	17	0	Plazi	ffb07bec-2d10-492d-9c37-361fe0b79427	26f58d19-4735-470a-a8c7-f9b5cea8a1d6
227	227	0	GBIF France	da44cd31-5901-4687-a106-6d1c7734ee3a	27f48bf7-11f6-40d8-8c49-69a1064adf3f
71	71	0	Colombian Biodiversity Information System	7e865cba-7c46-417b-ade5-97f2cf5b7be0	29ff4deb-f4dc-4f00-b2fb-b114d21c878c
0	21	21	Plazi	ffb07bec-2d10-492d-9c37-361fe0b79427	2cbeea15-656e-466c-b2d2-23a455cc9428
0	2	2	Participant Node Managers Committee	7f48e0c8-5c96-49ec-b972-30748e339115	2d1e4ee1-620f-4f9a-a355-95c8b1977d6c
12512	12512	0	Belgian Biodiversity Platform	fb11cfe1-ebc3-45af-9159-17d9fddbcdac	2d4aa27f-bacc-4dc2-a692-d25f5d812111
9879	9879	0	GBIF Portugal	673f7038-4262-4149-b753-5658a4e912f6	2fea4042-5aba-4cda-bab9-adcfa2bbe97d
0	48	48	Plazi	ffb07bec-2d10-492d-9c37-361fe0b79427	30ee5d5d-c02a-4239-836e-f921911db9a2
0	8	8	Plazi	ffb07bec-2d10-492d-9c37-361fe0b79427	334e9d74-ee49-46e7-b44f-f98ab1a43af0
30465	31388	923	GBIF Brazil	cdc9736d-5ff7-4ece-9959-3c744360cdb3	339e9de5-ee9a-4718-8837-0bc5b4f933f5
6065	6065	0	GBIF Portugal	673f7038-4262-4149-b753-5658a4e912f6	369a4612-fb43-41fc-9f73-1224391a21d5
35743	36010	267	GBIF Chile	a8b16421-d80b-4ef3-8f22-098b01a89255	3bccb697-4ccc-4d46-848a-79cb06946e5c
0	10	10	Plazi	ffb07bec-2d10-492d-9c37-361fe0b79427	3bce52fd-bcde-4b3d-bdad-f79de986be77
7	7	0	Plazi	ffb07bec-2d10-492d-9c37-361fe0b79427	3e5d2ae9-530e-497f-88e9-d5a38bb90f10
1	1	0	GBIF Germany	4f6826f2-4ff6-443d-b966-e6913bd24013	434383f8-3a0c-11e2-b0ce-00145eb45e9a
6	6	0	Plazi	ffb07bec-2d10-492d-9c37-361fe0b79427	44160079-92a7-419f-91be-9603ee9eb11c
0	400	400	Participant Node Managers Committee	7f48e0c8-5c96-49ec-b972-30748e339115	44c0ab40-55bd-4535-97c2-1810c505964c
61	61	0	Polish Biodiversity Information Network	2618bfdf-e194-4911-a241-80db3107bc51	45b73560-0e2f-11de-b8e7-b8a03c50a862
0	341	341	Plazi	ffb07bec-2d10-492d-9c37-361fe0b79427	462f5a5d-82e9-4ce5-a56f-99eacfec24a5
197	197	0	GBIF France	da44cd31-5901-4687-a106-6d1c7734ee3a	470f6151-6bd3-4421-ba5d-8276350b16f6
97	97	0	GBIF France	da44cd31-5901-4687-a106-6d1c7734ee3a	47f61ef9-2ac9-4f42-86a5-e104cbe16936
5	5	0	Plazi	ffb07bec-2d10-492d-9c37-361fe0b79427	4df4bd85-ef89-4476-8157-187110feba5c
0	37	37	Plazi	ffb07bec-2d10-492d-9c37-361fe0b79427	4e71a093-a172-440d-87bd-273529b6f0f5
0	6	6	Ocean Biodiversity Information System	ba0670b9-4186-41e6-8e70-f9cb3065551a	522077cb-082e-4469-bd8c-6662728c04de
14	14	0	Plazi	ffb07bec-2d10-492d-9c37-361fe0b79427	53dcd252-268b-4b71-b8e1-0c1c35a6a6d8
0	1	1	Plazi	ffb07bec-2d10-492d-9c37-361fe0b79427	565f3f51-7f3f-4e14-aaea-dd817ba0a0b2
396	396	0	GBIF France	da44cd31-5901-4687-a106-6d1c7734ee3a	59e18e06-9b99-48ee-99d9-68fa82d92d11
25	25	0	Plazi	ffb07bec-2d10-492d-9c37-361fe0b79427	59ff2158-34de-495a-b716-56bb9cd628eb
120231	120307	76	GBIF Brazil	cdc9736d-5ff7-4ece-9959-3c744360cdb3	5b5cf455-a448-4c0a-aecd-3e0956f27f10
0	3	3	Plazi	ffb07bec-2d10-492d-9c37-361fe0b79427	5bed6b9f-27d3-4508-b415-136a1dd53b3a
387	387	0	Albertine Rift Conservation Society	90a939d3-e99c-4f6d-915f-2616423b3735	5d17a4fd-7249-46c0-a56b-1924d477b29e
82	82	0	Plazi	ffb07bec-2d10-492d-9c37-361fe0b79427	5dfd4ff4-6c8b-47f4-9aa7-0f6b1b2af967
13388	13825	437	GBIF New Zealand	4f9fd726-20dd-445e-89a1-8ed93792276f	5e2c9b3a-9d7c-4871-af8c-144e4f40e9d2
666	666	0	GBIF New Zealand	4f9fd726-20dd-445e-89a1-8ed93792276f	60b0775d-7564-4fe3-bad2-94b2b11a0adc
7	7	0	Plazi	ffb07bec-2d10-492d-9c37-361fe0b79427	630a550b-71b1-4f8a-9d34-ff116a8529eb
1120	1120	0	GBIF Spain	1f94b3ca-9345-4d65-afe2-4bace93aa0fe	6366a92c-f762-11e1-a439-00145eb45e9a
1319	1319	0	GBIF Germany	4f6826f2-4ff6-443d-b966-e6913bd24013	638110a0-f762-11e1-a439-00145eb45e9a
111	111	0	GBIF Germany	4f6826f2-4ff6-443d-b966-e6913bd24013	63f35aa2-f762-11e1-a439-00145eb45e9a
2	2	0	Plazi	ffb07bec-2d10-492d-9c37-361fe0b79427	64250288-64c3-4913-bd8a-0a1e7161e7f8
104	104	0	GBIF Germany	4f6826f2-4ff6-443d-b966-e6913bd24013	6454dbc4-f762-11e1-a439-00145eb45e9a
52	52	0	GBIF Germany	4f6826f2-4ff6-443d-b966-e6913bd24013	6471efca-f762-11e1-a439-00145eb45e9a
0	2	2	Plazi	ffb07bec-2d10-492d-9c37-361fe0b79427	64c21a8b-3442-49b7-af74-8f7e6932cac9
20807	20807	0	Biodiversity Information System of Mexico	b324e8e9-9a4c-44fa-8f1a-7f39ea7ab576	6555005d-4594-4a3e-be33-c70e587b63d7
7339	6484	-855	Biodiversity Information System of Mexico	b324e8e9-9a4c-44fa-8f1a-7f39ea7ab576	66150eda-ff1f-4dfa-84fa-ca5e57d4b332
472	472	0	National Biodiversity Network	d897a5b9-35ee-4232-94bd-b0bcaac003c2	66ced3df-1d9e-4c90-b950-ddffa0b7ccfe
161	161	0	GBIF Germany	4f6826f2-4ff6-443d-b966-e6913bd24013	67603304-f762-11e1-a439-00145eb45e9a
0	50	50	Participant Node Managers Committee	7f48e0c8-5c96-49ec-b972-30748e339115	679478a3-bb0c-4bb1-81d2-50215704577f
50	50	0	GBIF Germany	4f6826f2-4ff6-443d-b966-e6913bd24013	68860448-f762-11e1-a439-00145eb45e9a
0	7	7	Plazi	ffb07bec-2d10-492d-9c37-361fe0b79427	6925e575-3634-4492-8be6-b422b73fe888
0	10	10	Plazi	ffb07bec-2d10-492d-9c37-361fe0b79427	697a3c72-0781-4ff6-bc92-b44933203079
137	137	0	GBIF Germany	4f6826f2-4ff6-443d-b966-e6913bd24013	69a52d7c-f762-11e1-a439-00145eb45e9a
42	42	0	GBIF Germany	4f6826f2-4ff6-443d-b966-e6913bd24013	6abe4388-f762-11e1-a439-00145eb45e9a
2	2	0	GBIF Germany	4f6826f2-4ff6-443d-b966-e6913bd24013	6ad87a64-f762-11e1-a439-00145eb45e9a
9	9	0	Plazi	ffb07bec-2d10-492d-9c37-361fe0b79427	6cfa4c55-e316-48bc-94bc-6f57589b5cd2
16382	16382	0	GBIF Benin	efb9c00e-f802-45dd-8826-a52ec45b89ff	6fdbad67-9889-460e-ac2e-9731cdc14dd8
31	31	0	GBIF Germany	4f6826f2-4ff6-443d-b966-e6913bd24013	7007f3ca-f762-11e1-a439-00145eb45e9a
0	53	53	Participant Node Managers Committee	7f48e0c8-5c96-49ec-b972-30748e339115	7074ded6-67be-47ef-987c-ebbe314b11ed
10	10	0	GBIF Germany	4f6826f2-4ff6-443d-b966-e6913bd24013	7089bca2-f762-11e1-a439-00145eb45e9a
521	521	0	GBIF Germany	4f6826f2-4ff6-443d-b966-e6913bd24013	7163ec6a-f762-11e1-a439-00145eb45e9a
0	171	171	Participant Node Managers Committee	7f48e0c8-5c96-49ec-b972-30748e339115	718258bd-5004-4fb5-9675-4e333d48c170
13	13	0	GBIF Germany	4f6826f2-4ff6-443d-b966-e6913bd24013	72b94452-f762-11e1-a439-00145eb45e9a
33	33	0	GBIF Germany	4f6826f2-4ff6-443d-b966-e6913bd24013	73b9749e-f762-11e1-a439-00145eb45e9a
130	130	0	GBIF Germany	4f6826f2-4ff6-443d-b966-e6913bd24013	73d3db9a-f762-11e1-a439-00145eb45e9a
79	79	0	GBIF Germany	4f6826f2-4ff6-443d-b966-e6913bd24013	7516785a-f762-11e1-a439-00145eb45e9a
667	661	-6	GBIF Germany	4f6826f2-4ff6-443d-b966-e6913bd24013	757680ce-f762-11e1-a439-00145eb45e9a
0	371	371	Ocean Biodiversity Information System	ba0670b9-4186-41e6-8e70-f9cb3065551a	775ec344-b8d4-41ed-a087-ee2d0637faba
1514	1514	0	Colombian Biodiversity Information System	7e865cba-7c46-417b-ade5-97f2cf5b7be0	785cf038-7b79-4c2f-9e9e-eb940fcd4c0c
45	45	0	GBIF Germany	4f6826f2-4ff6-443d-b966-e6913bd24013	7a662256-f762-11e1-a439-00145eb45e9a
523	523	0	GBIF France	da44cd31-5901-4687-a106-6d1c7734ee3a	7b6fae69-3366-4892-a07d-007ce27d675d
23	23	0	GBIF Germany	4f6826f2-4ff6-443d-b966-e6913bd24013	7ba8437e-f762-11e1-a439-00145eb45e9a
0	105	105	Plazi	ffb07bec-2d10-492d-9c37-361fe0b79427	7d8ff344-bf64-4f75-8aad-22a9d30f4fff
23	23	0	GBIF Germany	4f6826f2-4ff6-443d-b966-e6913bd24013	7e062244-f762-11e1-a439-00145eb45e9a
341	341	0	Atlas of Living Australia	4a6f1b71-969e-4fc5-a693-282b05e1220c	7e231320-9118-42a7-a4d7-39bf182dbc4a
1001	1001	0	GBIF Germany	4f6826f2-4ff6-443d-b966-e6913bd24013	7e285238-f762-11e1-a439-00145eb45e9a
6638	6638	0	GBIF Germany	4f6826f2-4ff6-443d-b966-e6913bd24013	7eae7e08-1387-11e2-bb2e-00145eb45e9a
2734	2707	-27	Biodiversity Information System of Mexico	b324e8e9-9a4c-44fa-8f1a-7f39ea7ab576	80c60602-f762-11e1-a439-00145eb45e9a
42	42	0	GBIF Germany	4f6826f2-4ff6-443d-b966-e6913bd24013	818ce109-dcbb-414d-9073-f4c014fcaa2d
761311	761311	0	GBIF Spain	1f94b3ca-9345-4d65-afe2-4bace93aa0fe	834c9918-f762-11e1-a439-00145eb45e9a
1286	1286	0	DanBIF - Danish Biodiversity Information Facility	4ddd294f-02b7-4359-ac33-0806a9ca9c6b	864eb98e-f762-11e1-a439-00145eb45e9a
1043	1043	0	Participant Node Managers Committee	7f48e0c8-5c96-49ec-b972-30748e339115	868b5ca1-bb27-4d6f-b243-37ad77486a68
3622	3622	0	GBIF Japan	db5705aa-6a6e-42f1-8942-d77b9f4896ea	86955830-f762-11e1-a439-00145eb45e9a
16	16	0	GBIF Germany	4f6826f2-4ff6-443d-b966-e6913bd24013	88920192-f762-11e1-a439-00145eb45e9a
90	90	0	GBIF Germany	4f6826f2-4ff6-443d-b966-e6913bd24013	89a30d92-f762-11e1-a439-00145eb45e9a
0	11	11	Plazi	ffb07bec-2d10-492d-9c37-361fe0b79427	8a644847-43e6-47f5-9cee-582188183ca4
258	258	0	GBIF Germany	4f6826f2-4ff6-443d-b966-e6913bd24013	8bad756e-f762-11e1-a439-00145eb45e9a
128	128	0	GBIF Germany	4f6826f2-4ff6-443d-b966-e6913bd24013	8bb51954-f762-11e1-a439-00145eb45e9a
106	106	0	GBIF Germany	4f6826f2-4ff6-443d-b966-e6913bd24013	8bb65102-f762-11e1-a439-00145eb45e9a
40	33	-7	GBIF Germany	4f6826f2-4ff6-443d-b966-e6913bd24013	8d38df40-f762-11e1-a439-00145eb45e9a
31	31	0	GBIF Germany	4f6826f2-4ff6-443d-b966-e6913bd24013	8d3b6d00-f762-11e1-a439-00145eb45e9a
29	13	-16	GBIF Germany	4f6826f2-4ff6-443d-b966-e6913bd24013	8d56942c-f762-11e1-a439-00145eb45e9a
239	172	-67	GBIF Germany	4f6826f2-4ff6-443d-b966-e6913bd24013	8f6778f8-f762-11e1-a439-00145eb45e9a
0	10	10	Ocean Biodiversity Information System	ba0670b9-4186-41e6-8e70-f9cb3065551a	90480d3f-bc6a-4fcb-9e89-98ff9e793580
5	5	0	Plazi	ffb07bec-2d10-492d-9c37-361fe0b79427	906fad9e-680a-4faa-9e0e-2909ea4575e5
69	57	-12	GBIF Germany	4f6826f2-4ff6-443d-b966-e6913bd24013	90b14e6e-f762-11e1-a439-00145eb45e9a
9	6	-3	GBIF Germany	4f6826f2-4ff6-443d-b966-e6913bd24013	913058ee-f762-11e1-a439-00145eb45e9a
1	1	0	Plazi	ffb07bec-2d10-492d-9c37-361fe0b79427	913127ad-d91a-41d5-adda-e5c4105a9168
363961	386389	22428	GBIF Sweden	a0b3be64-6525-4387-ac67-a499950f92e1	91fa1a0d-a208-40aa-8a6e-f2c0beb9b253
544	544	0	GBIF Germany	4f6826f2-4ff6-443d-b966-e6913bd24013	920ad2bc-f762-11e1-a439-00145eb45e9a
1	1	0	GBIF Germany	4f6826f2-4ff6-443d-b966-e6913bd24013	9296454a-f762-11e1-a439-00145eb45e9a
32581	32581	0	GBIF Spain	1f94b3ca-9345-4d65-afe2-4bace93aa0fe	93082fdb-1a18-40de-a25c-5d1b594a370d
408	408	0	GBIF Germany	4f6826f2-4ff6-443d-b966-e6913bd24013	93f4ee0a-f762-11e1-a439-00145eb45e9a
25242924	27556877	2313953	DanBIF - Danish Biodiversity Information Facility	4ddd294f-02b7-4359-ac33-0806a9ca9c6b	95db4db8-f762-11e1-a439-00145eb45e9a
2	2	0	Plazi	ffb07bec-2d10-492d-9c37-361fe0b79427	960d6773-a64d-4589-8b50-7164775fbc2d
0	3	3	Plazi	ffb07bec-2d10-492d-9c37-361fe0b79427	96aba7fc-0cef-4847-98da-127d9f104a25
9915	9915	0	National Biodiversity Network	d897a5b9-35ee-4232-94bd-b0bcaac003c2	980ca7fb-2ccf-4959-aa1a-26c19df9c6ca
0	6	6	Plazi	ffb07bec-2d10-492d-9c37-361fe0b79427	99b0b251-f697-4ec7-8c96-03b2b20aeb88
147	147	0	GBIF France	da44cd31-5901-4687-a106-6d1c7734ee3a	9d4379b8-743f-4153-9f5f-0b0c84a901aa
18224	18224	0	U.S. Geological Survey	8618c64a-93e0-4300-b546-7249e5148ed2	9e82c117-54f1-4750-a029-2dacc9ef5158
0	5	5	Plazi	ffb07bec-2d10-492d-9c37-361fe0b79427	9fbc50c8-bea0-4bed-a9f6-46148fd7c4a5
300	300	0	U.S. Geological Survey	8618c64a-93e0-4300-b546-7249e5148ed2	a036f960-f24d-4e77-93b5-4c0749e9bf4d
0	1	1	Ocean Biodiversity Information System	ba0670b9-4186-41e6-8e70-f9cb3065551a	a09f5d32-e10f-4c9a-94da-75a64a34a75a
36177	35942	-235	Biodiversity Information System of Mexico	b324e8e9-9a4c-44fa-8f1a-7f39ea7ab576	a2fc0119-703d-42e6-a627-a356433cde9d
8	8	0	Plazi	ffb07bec-2d10-492d-9c37-361fe0b79427	a47da2bf-5a91-4b9b-a68f-dca378cf43d9
249	249	0	Participant Node Managers Committee	7f48e0c8-5c96-49ec-b972-30748e339115	a4b2035f-fa9d-4d80-97dc-f5d58ec4ef51
252	252	0	Ocean Biodiversity Information System	ba0670b9-4186-41e6-8e70-f9cb3065551a	a6ed9633-4efd-45c6-8bc7-41b16cf0b6ea
166	166	0	GBIF France	da44cd31-5901-4687-a106-6d1c7734ee3a	a7a1f4fc-fcc2-4947-bf18-259b0af397ab
205967	205967	0	U.S. Geological Survey	8618c64a-93e0-4300-b546-7249e5148ed2	a82d2421-be5a-4779-babc-da0b634a7ba8
25614	25614	0	National Biodiversity Network	d897a5b9-35ee-4232-94bd-b0bcaac003c2	a8a03b90-806a-4052-b6b7-f71f07ae3aa2
2765	3022	257	U.S. Geological Survey	8618c64a-93e0-4300-b546-7249e5148ed2	a909e61b-b5f6-4592-a699-428619b3dd55
3	3	0	Plazi	ffb07bec-2d10-492d-9c37-361fe0b79427	aa186c6d-6c6f-49f2-94c3-28dee646eebb
9210	9210	0	GBIF Germany	4f6826f2-4ff6-443d-b966-e6913bd24013	aab0f969-6dec-4a18-bc67-669f79633d4b
1972	1972	0	GBIF Benin	efb9c00e-f802-45dd-8826-a52ec45b89ff	aef22888-444e-4cba-bfc5-f709ef15ccf4
12	12	0	Plazi	ffb07bec-2d10-492d-9c37-361fe0b79427	af0a7e60-adc6-4896-8544-63725501fa13
0	12	12	Plazi	ffb07bec-2d10-492d-9c37-361fe0b79427	b19250d7-2550-4b65-b129-ebc226232461
4	4	0	Plazi	ffb07bec-2d10-492d-9c37-361fe0b79427	b2800bf3-5970-45b8-a4fc-d513fc7c111c
406902	406902	0	National Biodiversity Network	d897a5b9-35ee-4232-94bd-b0bcaac003c2	b57c2b3d-4b95-425a-a324-e11e81d4caf3
36	36	0	National Biodiversity Network	d897a5b9-35ee-4232-94bd-b0bcaac003c2	c1577bcc-8119-4817-b605-06c655a0ea01
0	5	5	Plazi	ffb07bec-2d10-492d-9c37-361fe0b79427	c1caabf4-290a-4697-9bfa-9e7ea23c882d
0	1	1	Plazi	ffb07bec-2d10-492d-9c37-361fe0b79427	c246171c-857f-4443-9a9a-5dc1df0a8e71
3247	3247	0	GBIF Spain	1f94b3ca-9345-4d65-afe2-4bace93aa0fe	c3937703-e166-402a-9826-556206aaa1f4
17599	18092	493	National Biodiversity Network	d897a5b9-35ee-4232-94bd-b0bcaac003c2	c45c8530-fd7d-4f30-a9e4-c6d243a4b404
251	251	0	GBIF Germany	4f6826f2-4ff6-443d-b966-e6913bd24013	c7cbfb61-d778-45d0-927f-34720624c20b
0	143	143	Plazi	ffb07bec-2d10-492d-9c37-361fe0b79427	c8d52e0f-8db2-445d-b087-810821e55bf9
14478	14478	0	National Biodiversity Network	d897a5b9-35ee-4232-94bd-b0bcaac003c2	ccf5ea04-f882-46ad-9fcb-462258615135
1	1	0	Plazi	ffb07bec-2d10-492d-9c37-361fe0b79427	cdc50aed-51ca-47e9-adbf-a4f2710c5114
480	480	0	GBIF Germany	4f6826f2-4ff6-443d-b966-e6913bd24013	d148c976-a39e-4dbe-b062-8f6b49a1f00b
675	675	0	GBIF Germany	4f6826f2-4ff6-443d-b966-e6913bd24013	d35754ad-1842-4256-9dc2-1c7c3b960c82
148	148	0	Colombian Biodiversity Information System	7e865cba-7c46-417b-ade5-97f2cf5b7be0	d39b2d99-8595-4f78-954b-22bfaec43e32
30	30	0	U.S. Geological Survey	8618c64a-93e0-4300-b546-7249e5148ed2	d61dc8a1-83f7-4905-8863-d19a5a89a0a4
10102	10102	0	Participant Node Managers Committee	7f48e0c8-5c96-49ec-b972-30748e339115	d69d66b6-880c-436e-91df-a8a8eecddaae
0	7	7	Plazi	ffb07bec-2d10-492d-9c37-361fe0b79427	db0251d3-e12f-4c26-9790-f258857bec8f
0	2	2	Plazi	ffb07bec-2d10-492d-9c37-361fe0b79427	ded12575-14ac-4da2-bd49-20fe3b0d6dfc
420	420	0	National Biodiversity Network	d897a5b9-35ee-4232-94bd-b0bcaac003c2	e04f520e-ac17-4cfd-b2a4-330ed41926a9
0	2	2	Participant Node Managers Committee	7f48e0c8-5c96-49ec-b972-30748e339115	e17762e9-fa09-486b-a4b5-0369e4b178aa
1	1	0	Plazi	ffb07bec-2d10-492d-9c37-361fe0b79427	e2d7288e-2874-4229-a488-d8fb69373f80
0	13	13	Plazi	ffb07bec-2d10-492d-9c37-361fe0b79427	e3c46cee-7d58-44ce-91f1-031dc312cd95
36	36	0	Biodiversity Information System of Mexico	b324e8e9-9a4c-44fa-8f1a-7f39ea7ab576	e44fd81f-025e-4f7c-9f63-28839826e3a5
1132	1132	0	Netherlands Biodiversity Information Facility	0909d601-bda2-42df-9e63-a6d51847ebce	e66ff065-d823-4a4d-b129-569f649ba0eb
7711414	9283055	1571641	GBIF Germany	4f6826f2-4ff6-443d-b966-e6913bd24013	e6fab7b3-c733-40b9-8df3-2a03e49532c1
729	729	0	GBIF Germany	4f6826f2-4ff6-443d-b966-e6913bd24013	e7567a79-12b9-4405-8710-c2ab482915ec
205	1883	1678	U.S. Geological Survey	8618c64a-93e0-4300-b546-7249e5148ed2	e7fa4cc1-52a1-4859-b876-bcb45e9ca809
421	421	0	Colombian Biodiversity Information System	7e865cba-7c46-417b-ade5-97f2cf5b7be0	ec0b2e5f-fd29-4c2e-a2bf-51b69e5045f5
20	20	0	Plazi	ffb07bec-2d10-492d-9c37-361fe0b79427	ed2118ff-0995-455d-a2a8-a25971b4e885
299	299	0	GBIF Benin	efb9c00e-f802-45dd-8826-a52ec45b89ff	f08cb83c-9d50-4de8-aaa4-dd9bbe5cd02a
29	29	0	Plazi	ffb07bec-2d10-492d-9c37-361fe0b79427	f11705d7-1f40-4e74-8619-598a1b2329ab
5273	5273	0	GBIF France	da44cd31-5901-4687-a106-6d1c7734ee3a	f12269f8-2b9e-44a2-81bf-57939270aa6c
265	265	0	Plazi	ffb07bec-2d10-492d-9c37-361fe0b79427	f32a6f5a-0c9f-43c4-a273-4bc325ece96e
8	8	0	Plazi	ffb07bec-2d10-492d-9c37-361fe0b79427	f4fa046d-e0a5-4292-b822-945d94d1f63a
1028	1028	0	U.S. Geological Survey	8618c64a-93e0-4300-b546-7249e5148ed2	f78422ac-4efd-479e-99e2-ce36084d5f20
439	439	0	Colombian Biodiversity Information System	7e865cba-7c46-417b-ade5-97f2cf5b7be0	fabf30b1-75fe-44fe-b386-3c7ea2d94f10
0	51	51	Plazi	ffb07bec-2d10-492d-9c37-361fe0b79427	fd14343d-3a76-420e-90b1-3d07e059130c
0	9	9	Ocean Biodiversity Information System	ba0670b9-4186-41e6-8e70-f9cb3065551a	000f8d2a-ab70-453d-95f2-59791930975c
1563	1563	0	Participant Node Managers Committee	7f48e0c8-5c96-49ec-b972-30748e339115	00bfd17f-4ebe-436a-b35d-4956b18060af
0	6	6	Plazi	ffb07bec-2d10-492d-9c37-361fe0b79427	013b5b50-ab43-4199-89dd-d4996515754b
301	399	98	GBIF Norway	4f829580-180d-46a9-9c87-ed8ec959b545	03f14e6b-3800-40a9-a482-9f5a7003cad5
2937	2937	0	GBIF Norway	4f829580-180d-46a9-9c87-ed8ec959b545	051d8004-3568-4be9-852f-f6dc3413045c
1	1	0	Plazi	ffb07bec-2d10-492d-9c37-361fe0b79427	05947720-4778-49f6-8b0e-e9032614732a
0	24	24	Plazi	ffb07bec-2d10-492d-9c37-361fe0b79427	0918ae2d-f5c3-4b71-bb45-d577c63eb587
0	3	3	Plazi	ffb07bec-2d10-492d-9c37-361fe0b79427	09716139-6d14-4ea9-9bed-11e68c3c0258
3	3	0	Plazi	ffb07bec-2d10-492d-9c37-361fe0b79427	0bc30205-cd3b-488c-9161-e91e0b53ff7d
0	3	3	Plazi	ffb07bec-2d10-492d-9c37-361fe0b79427	0c19af69-567a-4cea-927e-029524ba40da
50	50	0	GBIF Norway	4f829580-180d-46a9-9c87-ed8ec959b545	0c2b68be-1332-4cdc-880a-0c9a835467a0
7	7	0	Plazi	ffb07bec-2d10-492d-9c37-361fe0b79427	10ed3fc6-b691-498e-8ceb-c50c8ed63369
0	33174	33174	Ocean Biodiversity Information System	ba0670b9-4186-41e6-8e70-f9cb3065551a	128a8dcd-490a-4c11-b4d5-4ab307aaadaf
0	9	9	Ocean Biodiversity Information System	ba0670b9-4186-41e6-8e70-f9cb3065551a	1b4c55fd-1dee-46f2-a52e-e59cd0f7ecf4
0	3	3	Plazi	ffb07bec-2d10-492d-9c37-361fe0b79427	1bbcbc7b-56d5-4f1e-b8e9-cb5760c07aae
190	190	0	Plazi	ffb07bec-2d10-492d-9c37-361fe0b79427	1cd473d9-9d96-438f-bab4-29c5e56f82b8
0	9	9	Plazi	ffb07bec-2d10-492d-9c37-361fe0b79427	206cc350-c385-47d0-aa57-548e7fbbd764
0	1	1	National Biodiversity Network	d897a5b9-35ee-4232-94bd-b0bcaac003c2	20c61fa5-80fd-42f8-bf78-c6aec17d229b
203	203	0	GBIF Portugal	673f7038-4262-4149-b753-5658a4e912f6	21feb87f-62f2-4765-8aa6-6953ee5e09d6
0	65	65	Ocean Biodiversity Information System	ba0670b9-4186-41e6-8e70-f9cb3065551a	22115da1-9265-4a55-ab3f-86c561a09dfa
753	753	0	Colombian Biodiversity Information System	7e865cba-7c46-417b-ade5-97f2cf5b7be0	2229752a-7d50-4632-a338-0930a6d792d1
26	26	0	Plazi	ffb07bec-2d10-492d-9c37-361fe0b79427	235382ad-a5c5-4928-a4ee-96247dfc26c3
0	122119	122119	U.S. Geological Survey	8618c64a-93e0-4300-b546-7249e5148ed2	23a34e86-a0da-4119-b675-7077ff6b3808
0	189590	189590	GBIF Sweden	a0b3be64-6525-4387-ac67-a499950f92e1	25ddf425-5004-4a62-9cd1-cc7806f081a8
108	108	0	Plazi	ffb07bec-2d10-492d-9c37-361fe0b79427	25e4c643-3a35-4135-9809-58f25fcca05c
0	287	287	Ocean Biodiversity Information System	ba0670b9-4186-41e6-8e70-f9cb3065551a	27ae99c5-f9ce-4403-a0a9-2f26ef7b7ace
4	4	0	Plazi	ffb07bec-2d10-492d-9c37-361fe0b79427	2909060b-18ed-4804-b76a-75be346b2b1c
4	4	0	Plazi	ffb07bec-2d10-492d-9c37-361fe0b79427	2a673c65-795c-4ad5-948e-2181381a4dbf
0	152	152	Colombian Biodiversity Information System	7e865cba-7c46-417b-ade5-97f2cf5b7be0	2b26670c-18e2-4978-8c7c-a88892a88bb1
0	13	13	Ocean Biodiversity Information System	ba0670b9-4186-41e6-8e70-f9cb3065551a	2b853353-782a-4b00-b2dd-d6fa1ebdf5b9
0	2	2	Plazi	ffb07bec-2d10-492d-9c37-361fe0b79427	2c2b274c-b210-4946-a69d-723bd4e960d6
3	3	0	Plazi	ffb07bec-2d10-492d-9c37-361fe0b79427	2e0a081e-74fb-486b-9bac-9a26b77b9441
26053	26053	0	National Biodiversity Network	d897a5b9-35ee-4232-94bd-b0bcaac003c2	3408da43-1bc4-463f-abae-0f353fc6a070
0	4	4	Plazi	ffb07bec-2d10-492d-9c37-361fe0b79427	34bcfa46-0c07-4a44-ba78-466e6b6dec2b
58	58	0	GBIF France	da44cd31-5901-4687-a106-6d1c7734ee3a	35b4f0d4-da02-4c3f-8ae5-1e4ab69aae9f
60165	60165	0	U.S. Geological Survey	8618c64a-93e0-4300-b546-7249e5148ed2	361d98ca-ba9d-4b85-a64f-7db8fb35c6a9
513	513	0	Atlas of Living Australia	4a6f1b71-969e-4fc5-a693-282b05e1220c	376a2b64-3c48-4b99-a38e-a5e3dd694414
7	7	0	Plazi	ffb07bec-2d10-492d-9c37-361fe0b79427	37cceeca-3603-4d50-ae05-6c71e834434d
62	62	0	GBIF Germany	4f6826f2-4ff6-443d-b966-e6913bd24013	37d67aa4-3c08-41bb-a20c-04831f26a99f
0	79	79	Participant Node Managers Committee	7f48e0c8-5c96-49ec-b972-30748e339115	38311530-b875-4676-b1fc-6a68e06afab0
135009	135009	0	GBIF Sweden	a0b3be64-6525-4387-ac67-a499950f92e1	38c1351d-9cfe-42c0-97da-02d2c8be141c
0	12	12	Plazi	ffb07bec-2d10-492d-9c37-361fe0b79427	38d1a6f9-d07b-4cce-96fc-f542de58e1c2
165	165	0	Plazi	ffb07bec-2d10-492d-9c37-361fe0b79427	3937c7f9-d611-4ce1-be9d-3d615adb919c
10	10	0	Plazi	ffb07bec-2d10-492d-9c37-361fe0b79427	3ad84157-b81b-4cc7-84b0-b5a716f4755e
0	3	3	Plazi	ffb07bec-2d10-492d-9c37-361fe0b79427	3cd6d58d-9b56-43b5-bd0f-a6b02d6d1e0f
7	7	0	Plazi	ffb07bec-2d10-492d-9c37-361fe0b79427	3e20ab5a-f620-4f91-96d8-5a413f383c48
6	6	0	Atlas of Living Australia	4a6f1b71-969e-4fc5-a693-282b05e1220c	402c0a2b-5101-4df7-a066-36af0b190d8f
0	1559	1559	GBIF Argentina	2426a871-9feb-40a1-96c6-0c593a76b835	444016ac-d27c-4c4c-a924-5f9a2a5b4756
14420	14420	0	GBIF Argentina	2426a871-9feb-40a1-96c6-0c593a76b835	463a3bd9-a9bf-4667-ae34-44b023307367
1	1	0	Plazi	ffb07bec-2d10-492d-9c37-361fe0b79427	46bfa412-ec45-4b74-a765-4beb3b9ba7b5
125307	126338	1031	Pacific Biodiversity Information Forum	3b9510fc-5943-45d3-b08d-5b4e1e7c385e	47576eae-c976-4c45-adc2-35d895bb1cbb
19567	26591	7024	U.S. Geological Survey	8618c64a-93e0-4300-b546-7249e5148ed2	49e223ed-ab24-478f-b5e8-4a15af5a8f6c
0	3	3	Plazi	ffb07bec-2d10-492d-9c37-361fe0b79427	49ebafdc-a0b3-4256-9446-42feb4e55ee1
0	38	38	Plazi	ffb07bec-2d10-492d-9c37-361fe0b79427	4adba691-9a63-41ab-9543-e0415a9b18a0
0	2	2	Participant Node Managers Committee	7f48e0c8-5c96-49ec-b972-30748e339115	4d303dd2-d99e-495e-a11d-8a72d5dd0d95
12	12	0	Plazi	ffb07bec-2d10-492d-9c37-361fe0b79427	4e5a28bc-9d7d-4b3f-b526-2fa812aae747
27	27	0	Participant Node Managers Committee	7f48e0c8-5c96-49ec-b972-30748e339115	520fb3d2-59de-481d-80b7-78543754222c
4	4	0	Plazi	ffb07bec-2d10-492d-9c37-361fe0b79427	5403caa2-1d18-4d1b-a872-321698d0abb2
0	477	477	Plazi	ffb07bec-2d10-492d-9c37-361fe0b79427	549ef63a-2c40-4e70-b360-155e111016a3
0	26	26	Plazi	ffb07bec-2d10-492d-9c37-361fe0b79427	557bdb7f-b592-4a14-a6a4-ea253697cf9a
49	49	0	Participant Node Managers Committee	7f48e0c8-5c96-49ec-b972-30748e339115	58fb122e-a1af-4a99-89bc-1d03523c0d8e
0	101	101	Ocean Biodiversity Information System	ba0670b9-4186-41e6-8e70-f9cb3065551a	5a1c8807-a52e-43b4-a7ad-61ffb353391d
73	73	0	GBIF France	da44cd31-5901-4687-a106-6d1c7734ee3a	5c31b54a-bc46-4a0a-8cf5-2ed1d9917e57
923	923	0	GBIF Argentina	2426a871-9feb-40a1-96c6-0c593a76b835	5d731f48-7303-458d-9558-838e60a9010a
0	706	706	Korean Biodiversity Information Facility	e0a1e772-0177-4800-94b4-2d023fe6cdf4	5d76f270-320c-4065-b298-45160509a2e2
108	108	0	GBIF Germany	4f6826f2-4ff6-443d-b966-e6913bd24013	61cd45b2-f762-11e1-a439-00145eb45e9a
53	53	0	GBIF Germany	4f6826f2-4ff6-443d-b966-e6913bd24013	62a271ce-f762-11e1-a439-00145eb45e9a
1	1	0	GBIF Germany	4f6826f2-4ff6-443d-b966-e6913bd24013	634beeac-f762-11e1-a439-00145eb45e9a
910	910	0	GBIF Germany	4f6826f2-4ff6-443d-b966-e6913bd24013	63866404-919c-4c1d-9bff-5f2b56f1d3e8
113	113	0	GBIF Germany	4f6826f2-4ff6-443d-b966-e6913bd24013	64141e18-f762-11e1-a439-00145eb45e9a
312	312	0	GBIF Germany	4f6826f2-4ff6-443d-b966-e6913bd24013	653db3ee-f762-11e1-a439-00145eb45e9a
181715	181715	0	National Biodiversity Network	d897a5b9-35ee-4232-94bd-b0bcaac003c2	653ed711-e58d-465f-95f7-3d9f60442297
0	69	69	Plazi	ffb07bec-2d10-492d-9c37-361fe0b79427	662ace29-83fd-453f-8366-18279d382fb4
38	38	0	Colombian Biodiversity Information System	7e865cba-7c46-417b-ade5-97f2cf5b7be0	6636d1c9-34e8-4a90-ad18-3bb59ecc6590
7638	7638	0	Ocean Biodiversity Information System	ba0670b9-4186-41e6-8e70-f9cb3065551a	6686c610-9d99-459e-b229-fdf3ac35a197
90	90	0	GBIF Germany	4f6826f2-4ff6-443d-b966-e6913bd24013	66b107d0-f762-11e1-a439-00145eb45e9a
117	117	0	GBIF Norway	4f829580-180d-46a9-9c87-ed8ec959b545	66c9903c-5bb2-4b10-a3ac-33c505623f66
135	135	0	GBIF Germany	4f6826f2-4ff6-443d-b966-e6913bd24013	67669b18-f762-11e1-a439-00145eb45e9a
461	492	31	National Biodiversity Network	d897a5b9-35ee-4232-94bd-b0bcaac003c2	688862fc-1545-483b-8349-9d7b4f787877
0	3	3	Plazi	ffb07bec-2d10-492d-9c37-361fe0b79427	68fb2847-2bb9-4293-b1af-ac6d004bc2dc
82	82	0	Plazi	ffb07bec-2d10-492d-9c37-361fe0b79427	6aba63e6-9e5c-45b9-ab89-16fe5ce579ae
16	16	0	GBIF Germany	4f6826f2-4ff6-443d-b966-e6913bd24013	6bf5a7a0-f762-11e1-a439-00145eb45e9a
3090	3090	0	Participant Node Managers Committee	7f48e0c8-5c96-49ec-b972-30748e339115	6f0b3f2b-0659-4bbe-8fd2-ad4cce63d82e
1	1	0	Plazi	ffb07bec-2d10-492d-9c37-361fe0b79427	6f581524-b1b1-45e1-8422-28255d2afad8
132693	132693	0	U.S. Geological Survey	8618c64a-93e0-4300-b546-7249e5148ed2	70f49e1a-f362-45be-9b6b-c45658d0efbf
0	18	18	Ocean Biodiversity Information System	ba0670b9-4186-41e6-8e70-f9cb3065551a	71b455bd-ae17-4917-87b6-d1bac4322002
589	589	0	GBIF Benin	efb9c00e-f802-45dd-8826-a52ec45b89ff	727937b4-473e-4d73-b1c7-975fd2c4a2b5
16	16	0	GBIF Germany	4f6826f2-4ff6-443d-b966-e6913bd24013	72a2e810-f762-11e1-a439-00145eb45e9a
6	6	0	Plazi	ffb07bec-2d10-492d-9c37-361fe0b79427	7321098f-48c7-4bde-93b9-bbeb2b57205c
2382	2382	0	Colombian Biodiversity Information System	7e865cba-7c46-417b-ade5-97f2cf5b7be0	73ee71a2-b43b-4419-a998-9cd42eefbd06
1480	1480	0	GBIF Japan	db5705aa-6a6e-42f1-8942-d77b9f4896ea	74091aa7-9892-4720-bde4-9dbb28cbc276
323	323	0	GBIF Germany	4f6826f2-4ff6-443d-b966-e6913bd24013	7409a216-f762-11e1-a439-00145eb45e9a
5	5	0	GBIF Germany	4f6826f2-4ff6-443d-b966-e6913bd24013	7435f10e-f762-11e1-a439-00145eb45e9a
75	75	0	GBIF Germany	4f6826f2-4ff6-443d-b966-e6913bd24013	75617346-f762-11e1-a439-00145eb45e9a
350	350	0	GBIF Germany	4f6826f2-4ff6-443d-b966-e6913bd24013	75a112c6-f762-11e1-a439-00145eb45e9a
3091	3091	0	National Biodiversity Network	d897a5b9-35ee-4232-94bd-b0bcaac003c2	7601185a-9874-42c9-aa73-41f480585106
1599	1599	0	GBIF Guinea	b1cd2e84-c4ba-47bd-b72a-dfd1f92dce0a	76499ecf-d612-466b-b637-59f414e85b3e
56	56	0	GBIF Germany	4f6826f2-4ff6-443d-b966-e6913bd24013	76798316-fdb4-4dfc-a686-ca214a3fec71
100	100	0	Belgian Biodiversity Platform	fb11cfe1-ebc3-45af-9159-17d9fddbcdac	76805c1e-0691-4d13-ab59-2211efa1a78a
856	856	0	GBIF France	da44cd31-5901-4687-a106-6d1c7734ee3a	79162a8c-a2a3-4c4a-8498-d499bd705ac5
0	1	1	Plazi	ffb07bec-2d10-492d-9c37-361fe0b79427	7934203f-cfdd-4870-80cc-9a752d877ee2
0	2	2	Plazi	ffb07bec-2d10-492d-9c37-361fe0b79427	7a4ac9ad-4d2d-4808-9067-c02edb77fc23
30117	30117	0	GBIF Japan	db5705aa-6a6e-42f1-8942-d77b9f4896ea	7a562d06-f762-11e1-a439-00145eb45e9a
20	20	0	GBIF France	da44cd31-5901-4687-a106-6d1c7734ee3a	7b9593ce-cdf3-4d8f-9049-c9c0f524e259
2	2	0	Plazi	ffb07bec-2d10-492d-9c37-361fe0b79427	7c5be302-4008-4f3b-9c44-df8af6087f66
4	4	0	GBIF Germany	4f6826f2-4ff6-443d-b966-e6913bd24013	7ccf2632-f762-11e1-a439-00145eb45e9a
178	141	-37	GBIF Germany	4f6826f2-4ff6-443d-b966-e6913bd24013	7d0e0988-f762-11e1-a439-00145eb45e9a
4849	4849	0	GBIF France	da44cd31-5901-4687-a106-6d1c7734ee3a	7d2dc1b9-aee3-4097-953b-f755a41132f4
100	100	0	U.S. Geological Survey	8618c64a-93e0-4300-b546-7249e5148ed2	7d4b8ea4-b40f-4382-8b90-6b305a8ca220
1956	1956	0	GBIF Germany	4f6826f2-4ff6-443d-b966-e6913bd24013	7da2a610-f762-11e1-a439-00145eb45e9a
2408	672	-1736	GBIF Germany	4f6826f2-4ff6-443d-b966-e6913bd24013	7e7a9d86-f762-11e1-a439-00145eb45e9a
0	3	3	Plazi	ffb07bec-2d10-492d-9c37-361fe0b79427	7f322784-0ae6-4413-91b8-5c1b82ee0a0a
3455	2888	-567	GBIF Germany	4f6826f2-4ff6-443d-b966-e6913bd24013	7f365c2e-f762-11e1-a439-00145eb45e9a
3054	2965	-89	Biodiversity Information System of Mexico	b324e8e9-9a4c-44fa-8f1a-7f39ea7ab576	7fc43fee-f762-11e1-a439-00145eb45e9a
487	487	0	Biodiversity Information System of Mexico	b324e8e9-9a4c-44fa-8f1a-7f39ea7ab576	7fe92692-f762-11e1-a439-00145eb45e9a
0	32	32	National Biodiversity Network	d897a5b9-35ee-4232-94bd-b0bcaac003c2	8070160d-012b-41fc-80e1-3d6f41acc257
68	68	0	Plazi	ffb07bec-2d10-492d-9c37-361fe0b79427	80959f8f-aa73-499e-93ec-5c07458c7935
4	4	0	GBIF Japan	db5705aa-6a6e-42f1-8942-d77b9f4896ea	80da94fa-f762-11e1-a439-00145eb45e9a
1206	470	-736	GBIF Germany	4f6826f2-4ff6-443d-b966-e6913bd24013	816afca2-f762-11e1-a439-00145eb45e9a
19	19	0	GBIF Germany	4f6826f2-4ff6-443d-b966-e6913bd24013	8192ba94-f762-11e1-a439-00145eb45e9a
10	10	0	Plazi	ffb07bec-2d10-492d-9c37-361fe0b79427	829b4da2-7155-4c66-b7ab-be77a36dba83
1112	1112	0	GBIF Kenya	2a44d626-9f7a-4120-8a7a-4ab5ac15ff2a	829ed5f2-eae7-4c81-98c1-6cb77ef0a17c
14885	14885	0	Canada Biodiversity Information Facility	8f83fc96-c966-4126-83f7-bf044dc49efa	82d43810-f762-11e1-a439-00145eb45e9a
37986	37986	0	Belgian Biodiversity Platform	fb11cfe1-ebc3-45af-9159-17d9fddbcdac	84b04ec8-8c3f-47dc-bf4c-6342519ae67b
11249	11249	0	GBIF Finland	dd514216-5c7c-45f3-910d-797424cb5be6	8529b07c-f762-11e1-a439-00145eb45e9a
2883	2883	0	Atlas of Living Australia	4a6f1b71-969e-4fc5-a693-282b05e1220c	85fe49f4-f762-11e1-a439-00145eb45e9a
976457	976457	0	Bioversity International	b8a5be24-9225-4ba5-b664-159308a4b537	865df020-f762-11e1-a439-00145eb45e9a
2879	2879	0	Biodiversity Information System of Mexico	b324e8e9-9a4c-44fa-8f1a-7f39ea7ab576	86a35cd5-e094-442a-b79d-25cb63f22bb4
10	10	0	Plazi	ffb07bec-2d10-492d-9c37-361fe0b79427	86f614cc-77d9-4286-938b-410c9067c826
247	247	0	Plazi	ffb07bec-2d10-492d-9c37-361fe0b79427	8706a322-fb1f-4689-873a-e03bf02c5a50
0	4	4	Plazi	ffb07bec-2d10-492d-9c37-361fe0b79427	878378ef-d80c-4810-8dc6-1f447a83e764
501	346	-155	GBIF Germany	4f6826f2-4ff6-443d-b966-e6913bd24013	8816a498-f762-11e1-a439-00145eb45e9a
896	333	-563	GBIF Germany	4f6826f2-4ff6-443d-b966-e6913bd24013	894b3284-f762-11e1-a439-00145eb45e9a
112	112	0	GBIF Germany	4f6826f2-4ff6-443d-b966-e6913bd24013	8a264c48-f762-11e1-a439-00145eb45e9a
2148	2148	0	GBIF Germany	4f6826f2-4ff6-443d-b966-e6913bd24013	8a7884fe-f762-11e1-a439-00145eb45e9a
19	19	0	Participant Node Managers Committee	7f48e0c8-5c96-49ec-b972-30748e339115	8c3ff4d6-9230-4ea3-b6c7-2940093961f9
75	75	0	GBIF Germany	4f6826f2-4ff6-443d-b966-e6913bd24013	8c67cf36-f762-11e1-a439-00145eb45e9a
30	30	0	GBIF Germany	4f6826f2-4ff6-443d-b966-e6913bd24013	8cf2a124-f762-11e1-a439-00145eb45e9a
67	67	0	Participant Node Managers Committee	7f48e0c8-5c96-49ec-b972-30748e339115	8d405c5f-d56d-44ca-8eab-3fa680aaea4b
40	40	0	GBIF Germany	4f6826f2-4ff6-443d-b966-e6913bd24013	8d6950d0-f762-11e1-a439-00145eb45e9a
183	39	-144	GBIF Germany	4f6826f2-4ff6-443d-b966-e6913bd24013	8dd17fb6-f762-11e1-a439-00145eb45e9a
0	2	2	Plazi	ffb07bec-2d10-492d-9c37-361fe0b79427	8deb3219-be99-4998-93a6-2768e9b75285
49	49	0	GBIF Germany	4f6826f2-4ff6-443d-b966-e6913bd24013	8e14f368-f762-11e1-a439-00145eb45e9a
1	1	0	GBIF Germany	4f6826f2-4ff6-443d-b966-e6913bd24013	8e2b42c6-f762-11e1-a439-00145eb45e9a
89	89	0	GBIF Japan	db5705aa-6a6e-42f1-8942-d77b9f4896ea	8e45fbf0-d9c5-4527-9980-fa3188387549
346	198	-148	GBIF Germany	4f6826f2-4ff6-443d-b966-e6913bd24013	8fc3665e-f762-11e1-a439-00145eb45e9a
154	119	-35	GBIF Germany	4f6826f2-4ff6-443d-b966-e6913bd24013	8fe4436a-f762-11e1-a439-00145eb45e9a
0	2	2	Plazi	ffb07bec-2d10-492d-9c37-361fe0b79427	91bd2182-4133-458e-ab46-e7e1b5421d29
22	22	0	Plazi	ffb07bec-2d10-492d-9c37-361fe0b79427	9238318c-4409-45cc-96cf-1aa17c4006d0
16	14	-2	GBIF Germany	4f6826f2-4ff6-443d-b966-e6913bd24013	9289563c-f762-11e1-a439-00145eb45e9a
244	244	0	GBIF Germany	4f6826f2-4ff6-443d-b966-e6913bd24013	93c9dbac-f762-11e1-a439-00145eb45e9a
0	9875	9875	Canada Biodiversity Information Facility	8f83fc96-c966-4126-83f7-bf044dc49efa	93efc16a-7eb1-4792-bdec-de1ea69b8c65
644	644	0	GBIF Germany	4f6826f2-4ff6-443d-b966-e6913bd24013	95597842-f762-11e1-a439-00145eb45e9a
1409	1409	0	GBIF Germany	4f6826f2-4ff6-443d-b966-e6913bd24013	960af0c2-f762-11e1-a439-00145eb45e9a
0	2	2	Plazi	ffb07bec-2d10-492d-9c37-361fe0b79427	96a19b33-7139-412a-b9ed-de3c0b91fa88
155	155	0	GBIF Germany	4f6826f2-4ff6-443d-b966-e6913bd24013	97bddc5e-f762-11e1-a439-00145eb45e9a
268	268	0	Plazi	ffb07bec-2d10-492d-9c37-361fe0b79427	98f587bb-3baf-4961-89a0-5679c0dcf731
13	13	0	GBIF Brazil	cdc9736d-5ff7-4ece-9959-3c744360cdb3	99d707ed-e3c2-428e-9afa-997c90a557bf
23	23	0	Plazi	ffb07bec-2d10-492d-9c37-361fe0b79427	9a0d485c-a063-4065-9dd9-348556a9b7fd
0	123546	123546	GBIF Portugal	673f7038-4262-4149-b753-5658a4e912f6	9b6cdc0f-70f6-4d08-8cbb-444dd0001a19
23	23	0	GBIF France	da44cd31-5901-4687-a106-6d1c7734ee3a	9bd028a1-8090-44e7-b21d-f387a4859a6a
266	266	0	Participant Node Managers Committee	7f48e0c8-5c96-49ec-b972-30748e339115	9bfd4499-050e-41b7-93a8-72d9e2490e21
3054	3728	674	Colombian Biodiversity Information System	7e865cba-7c46-417b-ade5-97f2cf5b7be0	9d0f0624-af14-4973-8e06-c552fd68430e
467	467	0	GBIF Argentina	2426a871-9feb-40a1-96c6-0c593a76b835	9dc691a2-f5f0-4688-b750-754038daea42
0	929	929	Biodiversity Information System of Mexico	b324e8e9-9a4c-44fa-8f1a-7f39ea7ab576	9f83a36b-4bff-43f3-9df1-25b5ef53ea18
1	1	0	Plazi	ffb07bec-2d10-492d-9c37-361fe0b79427	a161220f-7db6-4ccc-bfaa-de528dab984c
8	8	0	Plazi	ffb07bec-2d10-492d-9c37-361fe0b79427	a522c79f-2ef5-43a5-990f-8d38fd7a8f89
1	1	0	Participant Node Managers Committee	7f48e0c8-5c96-49ec-b972-30748e339115	a5262686-e9bc-45b4-8b4f-ec2d2321bb3b
0	53	53	Plazi	ffb07bec-2d10-492d-9c37-361fe0b79427	a5e1f244-a812-43da-a18b-05e417571c56
1262	1262	0	Biodiversity Information System of Mexico	b324e8e9-9a4c-44fa-8f1a-7f39ea7ab576	a9576a23-3690-4c27-8d19-0db353957177
4687	4687	0	Korean Biodiversity Information Facility	e0a1e772-0177-4800-94b4-2d023fe6cdf4	ad978cf6-b056-4e1d-a422-d871415dbd8a
77005	77005	0	GBIF France	da44cd31-5901-4687-a106-6d1c7734ee3a	ad9a46cf-9da5-4efb-ad53-f6e2ff7e1e7a
5	5	0	Plazi	ffb07bec-2d10-492d-9c37-361fe0b79427	ae180d87-c93d-4839-bb4d-5d504167601b
0	42192	42192	GBIF Japan	db5705aa-6a6e-42f1-8942-d77b9f4896ea	af0c5d8a-7aca-4cc9-bc9a-2d9495fc1bf2
9	9	0	GBIF France	da44cd31-5901-4687-a106-6d1c7734ee3a	af143cf9-f87a-44ab-ba88-0454e3629232
126	126	0	Belgian Biodiversity Platform	fb11cfe1-ebc3-45af-9159-17d9fddbcdac	b0a42677-76a5-445a-aa5e-d1956f4ab142
4	4	0	Plazi	ffb07bec-2d10-492d-9c37-361fe0b79427	b2a42f1a-eaa3-4383-a5dd-1e9358a546b0
159	159	0	Plazi	ffb07bec-2d10-492d-9c37-361fe0b79427	b32779cc-53a6-49e5-a0ad-2922298771d9
0	1	1	Plazi	ffb07bec-2d10-492d-9c37-361fe0b79427	b4e40d88-f92e-4fa3-a160-29c3a1907495
6	6	0	Plazi	ffb07bec-2d10-492d-9c37-361fe0b79427	b55a24ac-574d-4f21-a34e-eb5c7a51e52f
127	127	0	Participant Node Managers Committee	7f48e0c8-5c96-49ec-b972-30748e339115	b687e282-a7b7-42ca-b9a7-1d46983a42e5
1879	1879	0	GBIF Finland	dd514216-5c7c-45f3-910d-797424cb5be6	ba16c87e-10bd-4530-a258-d451628846d5
0	84	84	GBIF Argentina	2426a871-9feb-40a1-96c6-0c593a76b835	bbb9bd6f-f319-4dc4-8006-21a7161eff38
33415	33415	0	Atlas of Living Australia	4a6f1b71-969e-4fc5-a693-282b05e1220c	be0ae621-f624-4a42-8936-304286bda625
0	106	106	Ocean Biodiversity Information System	ba0670b9-4186-41e6-8e70-f9cb3065551a	c23d8371-ab6f-4ec8-adad-a4661039f4e0
1045	1145	100	GBIF Japan	db5705aa-6a6e-42f1-8942-d77b9f4896ea	c26bed28-1ac2-4c07-a18e-c801f3f188c1
0	1960	1960	Korean Biodiversity Information Facility	e0a1e772-0177-4800-94b4-2d023fe6cdf4	c3fcda80-d4a7-45af-9a55-20a51f2b40a2
1679	1679	0	GBIF France	da44cd31-5901-4687-a106-6d1c7734ee3a	c64d7750-ae5b-44ad-a02a-7d2f34c4f792
0	341	341	GBIF Japan	db5705aa-6a6e-42f1-8942-d77b9f4896ea	c6b1d0b1-5100-423c-8ec2-24b0ac4062c8
9723	9723	0	National Biodiversity Network	d897a5b9-35ee-4232-94bd-b0bcaac003c2	c7593664-8288-4f6f-9583-f51cd00e63e2
0	18	18	Ocean Biodiversity Information System	ba0670b9-4186-41e6-8e70-f9cb3065551a	c7bc1c9c-5c12-40f6-b0c1-a4deb28bc784
0	6	6	Plazi	ffb07bec-2d10-492d-9c37-361fe0b79427	cbaad27d-c53d-4139-a4c8-cc5ae0eb8d1e
106	106	0	Scientific Committee on Antarctic Research	51e4e8ff-bff0-4996-8b27-9107d61b3478	d1aee754-f104-4b45-a42a-728fc3a4815e
0	4	4	Plazi	ffb07bec-2d10-492d-9c37-361fe0b79427	d3e25dc2-708e-4a78-b552-aa1c6d8c6550
623	623	0	Colombian Biodiversity Information System	7e865cba-7c46-417b-ade5-97f2cf5b7be0	d446dd32-a42b-4f52-8c5f-62149b81a268
1	1	0	Plazi	ffb07bec-2d10-492d-9c37-361fe0b79427	d6493b37-f3d9-453c-a987-d893fd76c4d4
0	34137	34137	GBIF Spain	1f94b3ca-9345-4d65-afe2-4bace93aa0fe	d7a3df60-e856-438b-851d-74653ef6c0d2
3	3	0	Plazi	ffb07bec-2d10-492d-9c37-361fe0b79427	db3f902f-4e55-4ed9-9bce-298449111b53
2	2	0	Plazi	ffb07bec-2d10-492d-9c37-361fe0b79427	db45e42b-4353-41f2-9ac7-95c0fec1eb14
0	1993	1993	GBIF Portugal	673f7038-4262-4149-b753-5658a4e912f6	dbce02ed-6841-461b-871d-8f2815ddde8d
0	21	21	Plazi	ffb07bec-2d10-492d-9c37-361fe0b79427	e3ce638b-795b-4279-ad05-c7092e0adae5
120422	120422	0	GBIF Brazil	cdc9736d-5ff7-4ece-9959-3c744360cdb3	e5080aa7-f479-41f0-bb89-278feafd3cda
238	238	0	Plazi	ffb07bec-2d10-492d-9c37-361fe0b79427	e7c7a589-9f74-4546-9a7b-c3192b9659e5
2	2	0	Plazi	ffb07bec-2d10-492d-9c37-361fe0b79427	eb957d89-cee3-4a01-a52e-fc608c433065
0	1	1	Plazi	ffb07bec-2d10-492d-9c37-361fe0b79427	eca0809e-df66-4a14-8211-6d7bd6aecbb6
273	273	0	GBIF France	da44cd31-5901-4687-a106-6d1c7734ee3a	ed1fba28-8548-48ba-8e1b-a331282df518
0	92	92	Plazi	ffb07bec-2d10-492d-9c37-361fe0b79427	eeaf3ce5-baff-4449-8452-5fcbf43c646d
318	318	0	GBIF Germany	4f6826f2-4ff6-443d-b966-e6913bd24013	f3bbfb5a-0392-4e64-a197-3143733b6bc5
22	22	0	National Biodiversity Network	d897a5b9-35ee-4232-94bd-b0bcaac003c2	f4663bcf-9489-4ab3-92bf-9cf783c7132a
0	41	41	Plazi	ffb07bec-2d10-492d-9c37-361fe0b79427	f4c2f80e-4917-4b5b-9415-0ee6377973ce
412	700	288	GBIF Japan	db5705aa-6a6e-42f1-8942-d77b9f4896ea	f5fd4e7a-c977-41b1-b77e-875ad588e5dd
0	9	9	Plazi	ffb07bec-2d10-492d-9c37-361fe0b79427	f7f40d91-4335-461c-b72b-75f298ce9f13
71	71	0	GBIF Germany	4f6826f2-4ff6-443d-b966-e6913bd24013	f9e4b793-b02f-460d-9918-6c127689c99f
106	106	0	Plazi	ffb07bec-2d10-492d-9c37-361fe0b79427	fa3998ad-b087-4167-91a6-7be592813dcc
0	6	6	Plazi	ffb07bec-2d10-492d-9c37-361fe0b79427	fa98f55a-3776-4c2c-b3cc-12d2390d8834
1	1	0	Plazi	ffb07bec-2d10-492d-9c37-361fe0b79427	fac83449-52e6-4326-a5a9-a1c2807d5944
0	19	19	Ocean Biodiversity Information System	ba0670b9-4186-41e6-8e70-f9cb3065551a	fc00a461-3c34-48cd-b0bf-a8029c0d0d5b
10313	10313	0	GBIF France	da44cd31-5901-4687-a106-6d1c7734ee3a	fd77b374-5ad2-4429-afac-670443d22317
0	2	2	Plazi	ffb07bec-2d10-492d-9c37-361fe0b79427	02fb64c3-0755-4e55-8d37-5a5dfcdcfda2
1	1	0	Plazi	ffb07bec-2d10-492d-9c37-361fe0b79427	03b374c1-2626-4fed-86ef-a63ea42248da
15	15	0	Plazi	ffb07bec-2d10-492d-9c37-361fe0b79427	0655bb1f-85b3-4614-91e2-d649e86c5164
1072	1072	0	National Biodiversity Network	d897a5b9-35ee-4232-94bd-b0bcaac003c2	08989235-c693-4c0a-93fb-9d3a22079bdf
36	36	0	Plazi	ffb07bec-2d10-492d-9c37-361fe0b79427	0b5993c1-ce90-4064-8d0b-76cc33c296d7
66	66	0	Plazi	ffb07bec-2d10-492d-9c37-361fe0b79427	0c39972a-457c-453b-b82e-41af3c66ba87
4251	4251	0	Colombian Biodiversity Information System	7e865cba-7c46-417b-ade5-97f2cf5b7be0	0e42cac6-39dd-4f91-a9f6-753ceb66d0ee
0	8	8	Plazi	ffb07bec-2d10-492d-9c37-361fe0b79427	0f83dc4d-1de7-447b-95fb-da7134fd0b2c
5	5	0	Plazi	ffb07bec-2d10-492d-9c37-361fe0b79427	0fd46fac-1a3c-4bb7-ab7a-6b4e66fa72bb
6	6	0	Plazi	ffb07bec-2d10-492d-9c37-361fe0b79427	102b47a9-56fc-443f-a008-de7677ac34a9
3848	3848	0	GBIF Portugal	673f7038-4262-4149-b753-5658a4e912f6	1134ee3f-56a1-4c58-b1ff-d2a8ddb2cbc1
7	7	0	Participant Node Managers Committee	7f48e0c8-5c96-49ec-b972-30748e339115	11f40095-a083-42d0-9976-aebd7e2e9f1a
1	1	0	Participant Node Managers Committee	7f48e0c8-5c96-49ec-b972-30748e339115	12e15126-891a-4b31-935d-99e315dd1c35
66	66	0	Plazi	ffb07bec-2d10-492d-9c37-361fe0b79427	141cb31a-b66d-43ef-a44b-efd0544fe7b3
28	28	0	Colombian Biodiversity Information System	7e865cba-7c46-417b-ade5-97f2cf5b7be0	1afd8fb9-d03f-4b6b-a037-a5a147a1bff4
16	16	0	GBIF Germany	4f6826f2-4ff6-443d-b966-e6913bd24013	1b9f2c56-0719-4ac5-a6c9-b1530e208cb5
458	458	0	Colombian Biodiversity Information System	7e865cba-7c46-417b-ade5-97f2cf5b7be0	1e4c2b5c-fdbf-4764-8357-9dcd01d336f2
42	42	0	GBIF Madagascar	2dbfc5c5-51b5-4494-9dfc-4d3f013a3b64	1fa7b3d9-3261-4014-b360-a8fb9350e4cb
2	2	0	Plazi	ffb07bec-2d10-492d-9c37-361fe0b79427	1ffe5af4-24f3-42bb-be14-c9df7e7f3191
353106	353106	0	U.S. Geological Survey	8618c64a-93e0-4300-b546-7249e5148ed2	20e8d7fb-9b3b-43c6-a81d-8ebcd6c0ab11
21540	21540	0	National Biodiversity Network	d897a5b9-35ee-4232-94bd-b0bcaac003c2	2120e938-254a-4de9-a5d4-2e7b4d7a5493
698	698	0	Colombian Biodiversity Information System	7e865cba-7c46-417b-ade5-97f2cf5b7be0	22aefe37-06a8-410f-8340-1dfaff15dd63
0	1426	1426	Participant Node Managers Committee	7f48e0c8-5c96-49ec-b972-30748e339115	2530a330-a579-4335-aea4-56e3c3fad9b0
358	358	0	GBIF Germany	4f6826f2-4ff6-443d-b966-e6913bd24013	2574dc4f-66c6-4d90-aad4-6c1e918ecb4f
6250	7105	855	Belgian Biodiversity Platform	fb11cfe1-ebc3-45af-9159-17d9fddbcdac	258c9ce5-1bda-4001-a192-347c9e7fb186
0	288	288	Plazi	ffb07bec-2d10-492d-9c37-361fe0b79427	268bc7f0-616a-4457-a839-ad8c508bc981
88	89	1	GBIF Brazil	cdc9736d-5ff7-4ece-9959-3c744360cdb3	29fd74db-4579-4b3d-af95-1d1ab378abfb
0	4	4	Plazi	ffb07bec-2d10-492d-9c37-361fe0b79427	2a0f5d56-445d-40ed-88b7-4ec375648a57
64	64	0	Plazi	ffb07bec-2d10-492d-9c37-361fe0b79427	2add5d6b-8519-4334-bd86-7fe42a85a106
0	54	54	Plazi	ffb07bec-2d10-492d-9c37-361fe0b79427	3034d59c-159d-493f-84f1-54058652b307
4114	4114	0	Colombian Biodiversity Information System	7e865cba-7c46-417b-ade5-97f2cf5b7be0	310714fe-57a1-4cc2-9689-69471bd289ea
70	70	0	Plazi	ffb07bec-2d10-492d-9c37-361fe0b79427	32aee8e6-852f-438e-8bdd-0343ee1ad391
0	32	32	Plazi	ffb07bec-2d10-492d-9c37-361fe0b79427	3521b9ea-1966-43de-9660-e56c258390f3
1785	1785	0	National Biodiversity Network	d897a5b9-35ee-4232-94bd-b0bcaac003c2	3ad913f9-2f86-48c7-b570-3ec9f71acf88
12	12	0	Plazi	ffb07bec-2d10-492d-9c37-361fe0b79427	3c2cf70e-4df3-4eab-a69f-e88ff39f15aa
649	649	0	National Biodiversity Network	d897a5b9-35ee-4232-94bd-b0bcaac003c2	3eeb764b-491c-430d-94d5-bba911cb34fe
6	6	0	Plazi	ffb07bec-2d10-492d-9c37-361fe0b79427	4045d857-f77b-4303-b5cb-ce6ef0e5da01
76	76	0	Ocean Biodiversity Information System	ba0670b9-4186-41e6-8e70-f9cb3065551a	41a45e3f-e1c6-4f8e-9463-26f41620e491
15	15	0	Plazi	ffb07bec-2d10-492d-9c37-361fe0b79427	4246cbf0-d908-4c39-be16-ac5f66610a8c
0	1768	1768	Ocean Biodiversity Information System	ba0670b9-4186-41e6-8e70-f9cb3065551a	44638b52-06f7-4f96-9d1e-ea6df568a1bf
1030	1030	0	GBIF Sweden	a0b3be64-6525-4387-ac67-a499950f92e1	4551218b-8e33-49ae-aec7-93ccec6f28a8
118	118	0	Plazi	ffb07bec-2d10-492d-9c37-361fe0b79427	47a74a3f-6d90-4895-a6b4-cd2cbb6ea4e3
3	3	0	Plazi	ffb07bec-2d10-492d-9c37-361fe0b79427	4c8fd13d-6c68-4e15-bdb6-d87464e18d1f
2	2	0	Plazi	ffb07bec-2d10-492d-9c37-361fe0b79427	4cf2db4a-cbe3-4ffb-a9f9-413043808618
1	1	0	Plazi	ffb07bec-2d10-492d-9c37-361fe0b79427	4d505549-2f45-49c2-b388-8fc8bfdbd5f3
1733	1733	0	GBIF Japan	db5705aa-6a6e-42f1-8942-d77b9f4896ea	5395732a-18f5-11e2-98fb-00145eb45e9a
81	81	0	Tanzania Biodiversity Information Facility	abd95ca6-3959-4db9-aaa6-2de1aeecf514	53ba0073-4eda-44a7-8ebd-b59219b3613a
54	54	0	Plazi	ffb07bec-2d10-492d-9c37-361fe0b79427	54b26814-ef8c-494f-859e-b3b01b305988
1868	1868	0	National Biodiversity Network	d897a5b9-35ee-4232-94bd-b0bcaac003c2	56d78046-6065-480f-ae25-36b2dedd7ad5
0	7	7	Plazi	ffb07bec-2d10-492d-9c37-361fe0b79427	572c4ebb-dade-49fc-a28a-09b540fd0172
321	321	0	Colombian Biodiversity Information System	7e865cba-7c46-417b-ade5-97f2cf5b7be0	5a39c87c-9d97-4282-b3a9-e2c292b4729d
0	7319	7319	Belgian Biodiversity Platform	fb11cfe1-ebc3-45af-9159-17d9fddbcdac	5d06d34c-f74d-461e-8d8b-c3351beb0db8
3	3	0	Plazi	ffb07bec-2d10-492d-9c37-361fe0b79427	5e5c78de-6822-4286-a7bc-2ebb6635657b
2	2	0	Plazi	ffb07bec-2d10-492d-9c37-361fe0b79427	5f164511-c4b1-4d6d-9e14-803d726f7b84
2842040	2851240	9200	GBIF Sweden	a0b3be64-6525-4387-ac67-a499950f92e1	5f501df0-0c61-11dd-84ce-b8a03c50a862
177	177	0	Participant Node Managers Committee	7f48e0c8-5c96-49ec-b972-30748e339115	5ff379c6-80b3-4c10-a154-b0e7fbf35a2f
3	3	0	Plazi	ffb07bec-2d10-492d-9c37-361fe0b79427	61073b76-2847-4a9a-8b22-ae63c9ec8eba
103	103	0	GBIF Germany	4f6826f2-4ff6-443d-b966-e6913bd24013	612050dc-f762-11e1-a439-00145eb45e9a
79	79	0	GBIF Germany	4f6826f2-4ff6-443d-b966-e6913bd24013	61c50f78-f762-11e1-a439-00145eb45e9a
193	193	0	GBIF Germany	4f6826f2-4ff6-443d-b966-e6913bd24013	62412f86-f762-11e1-a439-00145eb45e9a
830	830	0	Biodiversity Information System of Mexico	b324e8e9-9a4c-44fa-8f1a-7f39ea7ab576	62ab4c96-a5a9-4090-b99f-c2308600edca
457	457	0	Biodiversity Information System of Mexico	b324e8e9-9a4c-44fa-8f1a-7f39ea7ab576	6369308c-dc7f-4be6-94f5-a432890d86cf
37	37	0	GBIF Germany	4f6826f2-4ff6-443d-b966-e6913bd24013	640691da-f762-11e1-a439-00145eb45e9a
1418	1418	0	GBIF Germany	4f6826f2-4ff6-443d-b966-e6913bd24013	6412c3c4-f762-11e1-a439-00145eb45e9a
0	79	79	GBIF Argentina	2426a871-9feb-40a1-96c6-0c593a76b835	646d3376-ed35-4f78-9160-457283f57def
2	2	0	Plazi	ffb07bec-2d10-492d-9c37-361fe0b79427	64863a0f-1466-493a-ba6c-67d170c485a2
73	73	0	GBIF Germany	4f6826f2-4ff6-443d-b966-e6913bd24013	64d241fe-f762-11e1-a439-00145eb45e9a
22	22	0	Plazi	ffb07bec-2d10-492d-9c37-361fe0b79427	64fd24bb-ee1d-44d7-ac6a-25e8d5f96777
247	247	0	Plazi	ffb07bec-2d10-492d-9c37-361fe0b79427	653d580d-e1c7-499c-8604-4b5a7b1920ef
3488	3256	-232	GBIF Germany	4f6826f2-4ff6-443d-b966-e6913bd24013	6576627a-f762-11e1-a439-00145eb45e9a
22	21	-1	GBIF Germany	4f6826f2-4ff6-443d-b966-e6913bd24013	65c897f2-f762-11e1-a439-00145eb45e9a
124	124	0	GBIF Germany	4f6826f2-4ff6-443d-b966-e6913bd24013	667c4a70-3baa-4fe4-972b-9d6f91edf0c4
93	93	0	GBIF Germany	4f6826f2-4ff6-443d-b966-e6913bd24013	6690bdea-f762-11e1-a439-00145eb45e9a
6883	6883	0	National Biodiversity Data Centre	422b00b2-6c94-4bb6-976b-c359916efdb8	669ecb52-bfbe-4220-99c7-bafc643df32e
99	99	0	GBIF Germany	4f6826f2-4ff6-443d-b966-e6913bd24013	67566950-f762-11e1-a439-00145eb45e9a
68	68	0	GBIF Germany	4f6826f2-4ff6-443d-b966-e6913bd24013	67c4bb44-f762-11e1-a439-00145eb45e9a
219	219	0	Plazi	ffb07bec-2d10-492d-9c37-361fe0b79427	681a7921-7956-4bdf-96cd-18cd433467e6
84	84	0	GBIF Germany	4f6826f2-4ff6-443d-b966-e6913bd24013	681ad376-f762-11e1-a439-00145eb45e9a
0	2	2	Plazi	ffb07bec-2d10-492d-9c37-361fe0b79427	68c311c5-9d5a-4aba-b736-c404a60b3e07
126	126	0	GBIF Germany	4f6826f2-4ff6-443d-b966-e6913bd24013	690cd964-f762-11e1-a439-00145eb45e9a
39	39	0	GBIF Germany	4f6826f2-4ff6-443d-b966-e6913bd24013	6929aee0-f762-11e1-a439-00145eb45e9a
197	197	0	GBIF Finland	dd514216-5c7c-45f3-910d-797424cb5be6	6c03c4e1-63ee-41d5-b7e1-99409f72a6f7
254	254	0	Colombian Biodiversity Information System	7e865cba-7c46-417b-ade5-97f2cf5b7be0	6c653621-ca42-4a8b-9ca0-0192af0dff55
135326	886902	751576	Netherlands Biodiversity Information Facility	0909d601-bda2-42df-9e63-a6d51847ebce	6db2a74e-98c5-4be3-ae30-3ec8dc68b0f4
1293	1287	-6	GBIF Switzerland	169eb292-376b-4cc6-8e31-9c2c432de0ad	6ee7a8b4-5e12-4c09-8fb4-106f2bd06965
0	125	125	Plazi	ffb07bec-2d10-492d-9c37-361fe0b79427	6f2b8c70-3a9b-4723-aad7-6f30ae75e6c4
1	1	0	Colombian Biodiversity Information System	7e865cba-7c46-417b-ade5-97f2cf5b7be0	6f2b8f8d-4e29-40b8-a022-e3a0e642c89e
0	887	887	Ocean Biodiversity Information System	ba0670b9-4186-41e6-8e70-f9cb3065551a	706f20d9-786a-4355-927b-3b18bac066e5
513	513	0	GBIF Germany	4f6826f2-4ff6-443d-b966-e6913bd24013	70af910c-f762-11e1-a439-00145eb45e9a
177	177	0	GBIF Germany	4f6826f2-4ff6-443d-b966-e6913bd24013	7193365a-f762-11e1-a439-00145eb45e9a
117	117	0	GBIF Germany	4f6826f2-4ff6-443d-b966-e6913bd24013	71945ee0-f762-11e1-a439-00145eb45e9a
0	4	4	Plazi	ffb07bec-2d10-492d-9c37-361fe0b79427	71b1cbb5-3e51-4125-93de-a1af8fc9e2c3
17	17	0	GBIF Germany	4f6826f2-4ff6-443d-b966-e6913bd24013	72af238c-f762-11e1-a439-00145eb45e9a
1	1	0	Plazi	ffb07bec-2d10-492d-9c37-361fe0b79427	72b3e3f3-19a2-4f8d-a398-909969ddb431
1	1	0	Plazi	ffb07bec-2d10-492d-9c37-361fe0b79427	733c94e8-f5bb-41f6-90ca-069b584822bd
75	75	0	Plazi	ffb07bec-2d10-492d-9c37-361fe0b79427	73942cd9-b43b-4610-9506-5da911980691
1017	983	-34	GBIF Germany	4f6826f2-4ff6-443d-b966-e6913bd24013	73d7b5ee-f762-11e1-a439-00145eb45e9a
425	425	0	GBIF France	da44cd31-5901-4687-a106-6d1c7734ee3a	744aee18-3049-495f-b6d1-b2e672b361e0
6768	9794	3026	Participant Node Managers Committee	7f48e0c8-5c96-49ec-b972-30748e339115	7648036d-fdac-4ebe-8861-9a28134adae1
6	6	0	GBIF Germany	4f6826f2-4ff6-443d-b966-e6913bd24013	78ffcf34-f762-11e1-a439-00145eb45e9a
56223	57009	786	GBIF Spain	1f94b3ca-9345-4d65-afe2-4bace93aa0fe	7a498826-f762-11e1-a439-00145eb45e9a
0	41	41	Ocean Biodiversity Information System	ba0670b9-4186-41e6-8e70-f9cb3065551a	7ad9d60b-b46d-482f-b00a-854377e4bfc7
227252	236737	9485	U.S. Geological Survey	8618c64a-93e0-4300-b546-7249e5148ed2	7c5e863f-3f70-4933-b05d-fc57c66dd3f3
0	66	66	Plazi	ffb07bec-2d10-492d-9c37-361fe0b79427	7cbff168-82f5-4432-a4ea-c1e8d731d3c3
1	1	0	Plazi	ffb07bec-2d10-492d-9c37-361fe0b79427	7d9d233b-0c6d-47df-90fe-198e71bd6954
45	45	0	GBIF Germany	4f6826f2-4ff6-443d-b966-e6913bd24013	7df6c182-f762-11e1-a439-00145eb45e9a
1015	1015	0	GBIF France	da44cd31-5901-4687-a106-6d1c7734ee3a	7f30bb49-f823-41af-9d01-1839a871bfa8
211	211	0	GBIF Germany	4f6826f2-4ff6-443d-b966-e6913bd24013	7f415aac-f762-11e1-a439-00145eb45e9a
10368	10368	0	U.S. Geological Survey	8618c64a-93e0-4300-b546-7249e5148ed2	7ffba224-5620-4dfd-a43e-9783fa414933
2123	2123	0	Biodiversity Information System of Mexico	b324e8e9-9a4c-44fa-8f1a-7f39ea7ab576	80540bc4-f762-11e1-a439-00145eb45e9a
8345	8345	0	GBIF Germany	4f6826f2-4ff6-443d-b966-e6913bd24013	816741a2-f762-11e1-a439-00145eb45e9a
18473	17740	-733	Atlas of Living Australia	4a6f1b71-969e-4fc5-a693-282b05e1220c	82e45d26-f762-11e1-a439-00145eb45e9a
549	549	0	Korean Biodiversity Information Facility	e0a1e772-0177-4800-94b4-2d023fe6cdf4	8437dd4c-f762-11e1-a439-00145eb45e9a
372	372	0	Canada Biodiversity Information Facility	8f83fc96-c966-4126-83f7-bf044dc49efa	84498358-f762-11e1-a439-00145eb45e9a
427	427	0	GBIF Germany	4f6826f2-4ff6-443d-b966-e6913bd24013	85cca098-f762-11e1-a439-00145eb45e9a
508	508	0	Biodiversity Information System of Mexico	b324e8e9-9a4c-44fa-8f1a-7f39ea7ab576	85ee162a-190a-43a7-b554-00af46bca726
0	4	4	Plazi	ffb07bec-2d10-492d-9c37-361fe0b79427	86c7a3e1-239c-49dd-b010-176a10c51fea
0	2	2	Plazi	ffb07bec-2d10-492d-9c37-361fe0b79427	8747024a-2028-49f2-af13-12fed1c7e693
0	78	78	Ocean Biodiversity Information System	ba0670b9-4186-41e6-8e70-f9cb3065551a	881b97af-d496-4d66-b4dd-023c5e2cf73c
283	283	0	GBIF Germany	4f6826f2-4ff6-443d-b966-e6913bd24013	8a67f328-f762-11e1-a439-00145eb45e9a
0	1	1	Plazi	ffb07bec-2d10-492d-9c37-361fe0b79427	8aaf523e-7515-4416-9795-d5dde994696b
21	21	0	GBIF Germany	4f6826f2-4ff6-443d-b966-e6913bd24013	8c8ccae8-f762-11e1-a439-00145eb45e9a
105	105	0	GBIF Germany	4f6826f2-4ff6-443d-b966-e6913bd24013	8d0934e8-f762-11e1-a439-00145eb45e9a
5	5	0	GBIF Germany	4f6826f2-4ff6-443d-b966-e6913bd24013	8d5ecbba-f762-11e1-a439-00145eb45e9a
14	9	-5	GBIF Germany	4f6826f2-4ff6-443d-b966-e6913bd24013	8d6411d8-f762-11e1-a439-00145eb45e9a
8	8	0	Plazi	ffb07bec-2d10-492d-9c37-361fe0b79427	8d8f2463-08b8-425f-ae32-139eb62f3056
12	5	-7	GBIF Germany	4f6826f2-4ff6-443d-b966-e6913bd24013	8dc6dd2c-f762-11e1-a439-00145eb45e9a
1254	1254	0	National Biodiversity Network	d897a5b9-35ee-4232-94bd-b0bcaac003c2	8e2961c9-5996-474b-9bfc-90370e04448b
0	8	8	Plazi	ffb07bec-2d10-492d-9c37-361fe0b79427	8e41f2cf-1620-45db-847c-54fc788f51ad
141	106	-35	GBIF Germany	4f6826f2-4ff6-443d-b966-e6913bd24013	8ffd8730-f762-11e1-a439-00145eb45e9a
10430	5960	-4470	GBIF Germany	4f6826f2-4ff6-443d-b966-e6913bd24013	90ad7fd2-f762-11e1-a439-00145eb45e9a
313	207	-106	GBIF Germany	4f6826f2-4ff6-443d-b966-e6913bd24013	9249451a-f762-11e1-a439-00145eb45e9a
0	59	59	Plazi	ffb07bec-2d10-492d-9c37-361fe0b79427	9417b10b-5d16-4f7a-9d9d-86d80f05c38b
204	204	0	National Biodiversity Network	d897a5b9-35ee-4232-94bd-b0bcaac003c2	9566b8fc-3f1d-472b-b037-7ceb5e4e94f9
50	47	-3	GBIF Germany	4f6826f2-4ff6-443d-b966-e6913bd24013	956d65b4-f762-11e1-a439-00145eb45e9a
0	7	7	Plazi	ffb07bec-2d10-492d-9c37-361fe0b79427	9b88e53e-65cd-43f8-9e10-b38bf0653038
0	19	19	Plazi	ffb07bec-2d10-492d-9c37-361fe0b79427	9e5a4897-46e2-4e6f-8dc9-4aad664b979d
188440	188440	0	GBIF France	da44cd31-5901-4687-a106-6d1c7734ee3a	a542665f-1b92-406e-8d92-072fcba576b2
98	98	0	Plazi	ffb07bec-2d10-492d-9c37-361fe0b79427	a7ff59ca-84b3-4132-8a5d-367b14c84cee
11	11	0	Plazi	ffb07bec-2d10-492d-9c37-361fe0b79427	a8f97942-a2c4-4964-a8e3-0188bc119220
13	13	0	Plazi	ffb07bec-2d10-492d-9c37-361fe0b79427	a90e6667-51c0-475a-a367-10ac4ebc9188
150	30	-120	GBIF Germany	4f6826f2-4ff6-443d-b966-e6913bd24013	a965f414-a662-4076-a5e1-16f5b0dc5cbb
2131	2131	0	Belgian Biodiversity Platform	fb11cfe1-ebc3-45af-9159-17d9fddbcdac	ab0b5afd-bef2-4313-ade5-2df7b7844271
94	94	0	Plazi	ffb07bec-2d10-492d-9c37-361fe0b79427	acdadaf7-4543-4f56-bfdc-66a28afe7a13
0	20	20	Plazi	ffb07bec-2d10-492d-9c37-361fe0b79427	aebaa796-9c6d-4502-ac88-614d74778be6
378898	383076	4178	GBIF France	da44cd31-5901-4687-a106-6d1c7734ee3a	b275a4c1-9859-4f3c-8ead-d86dde820fbc
3	3	0	Plazi	ffb07bec-2d10-492d-9c37-361fe0b79427	b2d2e507-f695-4ea7-b2cb-69b28d885d8a
1	1	0	Plazi	ffb07bec-2d10-492d-9c37-361fe0b79427	b38b0281-637d-40ea-bee3-8e16b43081d1
37	37	0	South African Biodiversity Information Facility	7190b835-4e86-4b6e-85c1-19cc6677c250	b5899cfd-0acd-4179-8ca2-bb6fb1873941
0	169	169	GBIF Japan	db5705aa-6a6e-42f1-8942-d77b9f4896ea	b5bfd57a-8453-4484-9945-50afda385a5d
70	70	0	Plazi	ffb07bec-2d10-492d-9c37-361fe0b79427	b6b63f47-67b6-40c8-b6e9-1b7e7b0d698d
10	10	0	Plazi	ffb07bec-2d10-492d-9c37-361fe0b79427	bfd9d911-a63d-435b-b242-250ae7198298
0	13177	13177	Ocean Biodiversity Information System	ba0670b9-4186-41e6-8e70-f9cb3065551a	c167ec9c-6b58-4d48-b1c5-f1c32179d3a3
50	50	0	National Biodiversity Network	d897a5b9-35ee-4232-94bd-b0bcaac003c2	c3f13c00-580c-48a6-b06a-3be5549d29e3
218	218	0	GBIF Germany	4f6826f2-4ff6-443d-b966-e6913bd24013	c7b5c8ab-10f3-4dee-9650-f1fcd24d5f99
188	188	0	Plazi	ffb07bec-2d10-492d-9c37-361fe0b79427	c803bce9-4469-43db-8acd-8291d035b6a2
0	41	41	Plazi	ffb07bec-2d10-492d-9c37-361fe0b79427	c9ee5fe0-60c0-4b08-9dc2-3467b51a997a
292	292	0	Secretariat of the Pacific Regional Environment Programme	29c6a139-ea7f-41f5-8d9b-c55af8736182	cb45ec5b-e2d8-4ccc-ba9f-8caeb8a5c26c
180	180	0	GBIF France	da44cd31-5901-4687-a106-6d1c7734ee3a	cbbc40bb-548b-4f43-bca0-b73e3d0af008
2143	3564	1421	National Biodiversity Network	d897a5b9-35ee-4232-94bd-b0bcaac003c2	ce19985f-1b12-49c7-8859-8d664ef4a5b7
17593	17593	0	National Biodiversity Network	d897a5b9-35ee-4232-94bd-b0bcaac003c2	cee42e4d-41a4-4d75-a052-8d8d12921e3c
7072	6746	-326	National Biodiversity Network	d897a5b9-35ee-4232-94bd-b0bcaac003c2	cf5142d2-bde7-4733-b07a-68bf370d52aa
194	194	0	Participant Node Managers Committee	7f48e0c8-5c96-49ec-b972-30748e339115	d07d09dd-d098-4622-95e2-84799f8d7a20
2845	2845	0	Biodiversity Information System of Mexico	b324e8e9-9a4c-44fa-8f1a-7f39ea7ab576	d0df772d-78f4-4602-acf2-7d768798f632
0	19	19	Plazi	ffb07bec-2d10-492d-9c37-361fe0b79427	d71b4a95-9a4d-40ca-a206-d117fce747bb
9	9	0	Plazi	ffb07bec-2d10-492d-9c37-361fe0b79427	d88184f4-ceef-4392-a444-0ac1552778d3
2887	2887	0	GBIF France	da44cd31-5901-4687-a106-6d1c7734ee3a	d89c884f-0661-4ceb-a531-ceae2374b915
5	5	0	Plazi	ffb07bec-2d10-492d-9c37-361fe0b79427	d8dd77d7-c915-4cbc-9324-07bbf585c234
0	35	35	Colombian Biodiversity Information System	7e865cba-7c46-417b-ade5-97f2cf5b7be0	dc157d89-aa0f-4682-89c1-8d10b4a013ad
1078	1078	0	National Biodiversity Network	d897a5b9-35ee-4232-94bd-b0bcaac003c2	e1a2b828-fdf7-4024-a37c-fba19ce036fa
5	5	0	Plazi	ffb07bec-2d10-492d-9c37-361fe0b79427	e2be27c8-1384-4186-83a6-cc9b52c28d88
8195	11737	3542	GBIF Kenya	2a44d626-9f7a-4120-8a7a-4ab5ac15ff2a	e3a63db5-e90f-4205-bafe-60f5d8fd28a5
2	2	0	Plazi	ffb07bec-2d10-492d-9c37-361fe0b79427	e514e3af-c2a8-47b8-87d9-925b7eb82470
5952	9952	4000	GBIF Japan	db5705aa-6a6e-42f1-8942-d77b9f4896ea	ea408e49-3d43-4514-9d2b-067bb8de6ac5
2134	2134	0	GBIF Germany	4f6826f2-4ff6-443d-b966-e6913bd24013	eb2ab784-63ac-4cbb-bcc8-1738651dd31a
0	3	3	Plazi	ffb07bec-2d10-492d-9c37-361fe0b79427	eb9eb7d7-0463-495e-b95b-a830e87a5cb8
1496	1496	0	National Biodiversity Network	d897a5b9-35ee-4232-94bd-b0bcaac003c2	eb9f8323-02f8-4e10-a9e6-48fca6cb3f72
0	61	61	Ocean Biodiversity Information System	ba0670b9-4186-41e6-8e70-f9cb3065551a	ebdb3b04-c243-4d80-844c-34424f235406
0	19	19	Plazi	ffb07bec-2d10-492d-9c37-361fe0b79427	ec722cbf-1bcc-4175-9a1d-1fe9b77b1409
4696	11734	7038	Colombian Biodiversity Information System	7e865cba-7c46-417b-ade5-97f2cf5b7be0	ec76ce73-e02b-45e6-af0b-b2128f77ac22
216890	216890	0	National Biodiversity Network	d897a5b9-35ee-4232-94bd-b0bcaac003c2	edd017b6-bf00-4b00-93ad-9789c42a36b1
405	405	0	GBIF Germany	4f6826f2-4ff6-443d-b966-e6913bd24013	ef47f9cb-6395-49b1-adef-a3ba9b819234
4575	4575	0	National Biodiversity Network	d897a5b9-35ee-4232-94bd-b0bcaac003c2	efa55264-ff5f-47b4-9ddf-ca5ece656678
109	109	0	GBIF Norway	4f829580-180d-46a9-9c87-ed8ec959b545	f0951f50-c8b7-4043-b5a8-499e580296b9
3195	3195	0	National Biodiversity Network	d897a5b9-35ee-4232-94bd-b0bcaac003c2	f1b28a31-cfe6-49eb-81c3-f071806114f4
0	2	2	Plazi	ffb07bec-2d10-492d-9c37-361fe0b79427	f47bdcab-d78a-4e41-a926-6d8097703ddb
23	23	0	Participant Node Managers Committee	7f48e0c8-5c96-49ec-b972-30748e339115	f4d148fb-d833-470f-b1b1-07d5964ab688
0	64738	64738	DanBIF - Danish Biodiversity Information Facility	4ddd294f-02b7-4359-ac33-0806a9ca9c6b	f506ae89-e503-414a-9e4c-fefee5b5a07b
3	3	0	Plazi	ffb07bec-2d10-492d-9c37-361fe0b79427	fb9c0947-4197-466b-a63c-1568935b46e6
9	9	0	Plazi	ffb07bec-2d10-492d-9c37-361fe0b79427	fbc8059e-55b6-46b1-b18e-8854b042d3fd
0	67	67	Ocean Biodiversity Information System	ba0670b9-4186-41e6-8e70-f9cb3065551a	ff6a218e-2be5-418f-afb9-91b9db354bbc
0	1015	1015	Ocean Biodiversity Information System	ba0670b9-4186-41e6-8e70-f9cb3065551a	00d636a3-e132-44b6-ae77-0b1cadb3e59e
81	81	0	GBIF France	da44cd31-5901-4687-a106-6d1c7734ee3a	04a013bf-c194-476c-9380-eafc7acaf3bc
0	8488	8488	GBIF Benin	efb9c00e-f802-45dd-8826-a52ec45b89ff	0740c09f-5cf6-48f0-8e94-abaa46f4b87b
1843	1843	0	GBIF France	da44cd31-5901-4687-a106-6d1c7734ee3a	08a91271-2da8-48aa-9382-68c724ea852c
36	36	0	Plazi	ffb07bec-2d10-492d-9c37-361fe0b79427	0a20dc7b-5322-4d72-9536-6a80d2d56b22
29	29	0	Colombian Biodiversity Information System	7e865cba-7c46-417b-ade5-97f2cf5b7be0	10327926-1f42-44fa-8cf0-846d70b7533b
7	7	0	Plazi	ffb07bec-2d10-492d-9c37-361fe0b79427	1256e493-607c-447d-a9a4-211c779e469b
1	1	0	Plazi	ffb07bec-2d10-492d-9c37-361fe0b79427	1553f5f6-a304-4295-9bb9-d22a659511c0
1811	1811	0	Participant Node Managers Committee	7f48e0c8-5c96-49ec-b972-30748e339115	19cbf7c0-9d6c-43d5-8f59-f7c6bb66a9f9
2	2	0	Plazi	ffb07bec-2d10-492d-9c37-361fe0b79427	19dd346e-13b7-47ac-96e9-0f5072a6bddc
7508	7508	0	Participant Node Managers Committee	7f48e0c8-5c96-49ec-b972-30748e339115	1c8388f5-5c12-46ba-a486-07d1b4f8b78c
6	6	0	Plazi	ffb07bec-2d10-492d-9c37-361fe0b79427	1f32f399-3fc4-4667-94d7-8a3f29119524
60	60	0	Plazi	ffb07bec-2d10-492d-9c37-361fe0b79427	22b6fd5b-4dbe-4367-9a76-1bee6f5acdf6
0	2	2	Plazi	ffb07bec-2d10-492d-9c37-361fe0b79427	23b91a05-a636-488b-a0f2-236d9cc866c8
1122	1122	0	GBIF France	da44cd31-5901-4687-a106-6d1c7734ee3a	266a6795-fd23-4e59-a58b-989df0b5c9d2
3	3	0	Plazi	ffb07bec-2d10-492d-9c37-361fe0b79427	2a006a58-8ed2-4bda-bf0c-f19c5f5ee672
0	3	3	Participant Node Managers Committee	7f48e0c8-5c96-49ec-b972-30748e339115	2a885626-a693-4be8-9153-e3b5de429d01
194	194	0	Plazi	ffb07bec-2d10-492d-9c37-361fe0b79427	2be13edb-468c-4397-aa8b-845a3ba71a52
17	17	0	Plazi	ffb07bec-2d10-492d-9c37-361fe0b79427	2c890571-4b01-491a-90dc-f20b5372e1e3
1	1	0	Plazi	ffb07bec-2d10-492d-9c37-361fe0b79427	30b16965-3299-4bec-a0c0-2b9aeed10ccc
0	15	15	Ocean Biodiversity Information System	ba0670b9-4186-41e6-8e70-f9cb3065551a	3194bb5f-1cfd-43a7-b9e0-180f224b634b
1	1	0	Plazi	ffb07bec-2d10-492d-9c37-361fe0b79427	3293576f-c395-4c4e-9a01-2394539e146e
0	41	41	Plazi	ffb07bec-2d10-492d-9c37-361fe0b79427	368cc10d-64a0-4f45-afec-9c4036331b2f
3527	3527	0	GBIF France	da44cd31-5901-4687-a106-6d1c7734ee3a	378264b9-9622-4dc0-9b18-b39818c8898e
0	1520	1520	Participant Node Managers Committee	7f48e0c8-5c96-49ec-b972-30748e339115	3c4cb702-a844-42a8-9334-b031e2485740
742	742	0	Biodiversity Information System of Mexico	b324e8e9-9a4c-44fa-8f1a-7f39ea7ab576	3d349fc8-84bc-46f9-b4d7-f1b115a9c9d2
446	446	0	GBIF France	da44cd31-5901-4687-a106-6d1c7734ee3a	3dcd7422-4f6e-4a50-9574-cc6bff7baf82
69	69	0	GBIF Norway	4f829580-180d-46a9-9c87-ed8ec959b545	429b8feb-36ab-43db-94d7-b53b1be85e6d
56	56	0	Plazi	ffb07bec-2d10-492d-9c37-361fe0b79427	42ae9e66-896e-456b-85a1-156825ee9a3e
488	488	0	GBIF France	da44cd31-5901-4687-a106-6d1c7734ee3a	4500364d-299d-4465-a5f1-9a72a4d51878
906	869	-37	Biodiversity Information System of Mexico	b324e8e9-9a4c-44fa-8f1a-7f39ea7ab576	45c814c3-fd17-4f68-ba03-ca95ac8bcc23
20	20	0	Plazi	ffb07bec-2d10-492d-9c37-361fe0b79427	47816d99-6645-43ad-a52d-33cc68a6a7c7
829	829	0	GBIF Argentina	2426a871-9feb-40a1-96c6-0c593a76b835	49ad1b33-d3c7-41da-8188-cb3094e844f7
3313	3313	0	National Biodiversity Network	d897a5b9-35ee-4232-94bd-b0bcaac003c2	4bd64435-fb04-494a-a344-0218ea59a7d4
0	5	5	Plazi	ffb07bec-2d10-492d-9c37-361fe0b79427	4d6a45cb-09a5-4113-8eb2-69810cefda23
2905	2905	0	GBIF Spain	1f94b3ca-9345-4d65-afe2-4bace93aa0fe	4f6d7736-ef4b-4115-a4e4-020b15c0bb28
9	9	0	Plazi	ffb07bec-2d10-492d-9c37-361fe0b79427	558be753-e023-41de-b7e8-dae988b56bb5
0	2	2	Plazi	ffb07bec-2d10-492d-9c37-361fe0b79427	563eaf04-3a2f-4337-b0ca-ba9df8b7b304
0	7	7	Plazi	ffb07bec-2d10-492d-9c37-361fe0b79427	5902f0a7-68e2-4de8-9ef2-9e70a20676be
1	1	0	Plazi	ffb07bec-2d10-492d-9c37-361fe0b79427	5c491f28-2946-495f-a7b9-ad8e85358ad4
11	11	0	Plazi	ffb07bec-2d10-492d-9c37-361fe0b79427	6129714b-d68e-4b5a-a32d-af355c627dbb
248	248	0	GBIF Germany	4f6826f2-4ff6-443d-b966-e6913bd24013	61843a52-f762-11e1-a439-00145eb45e9a
2	2	0	GBIF Germany	4f6826f2-4ff6-443d-b966-e6913bd24013	634a93e0-f762-11e1-a439-00145eb45e9a
410973	410973	0	GBIF Spain	1f94b3ca-9345-4d65-afe2-4bace93aa0fe	635f7b02-f762-11e1-a439-00145eb45e9a
101	101	0	GBIF Germany	4f6826f2-4ff6-443d-b966-e6913bd24013	6454fdd4-b62f-11e2-afcb-00145eb45e9a
3	3	0	Plazi	ffb07bec-2d10-492d-9c37-361fe0b79427	647384bd-cf6a-4546-a70d-1a813f4258cc
23	23	0	GBIF Germany	4f6826f2-4ff6-443d-b966-e6913bd24013	64b417a6-f762-11e1-a439-00145eb45e9a
56	56	0	Participant Node Managers Committee	7f48e0c8-5c96-49ec-b972-30748e339115	651c1377-8d3d-401f-a09d-03b834a989fb
656	620	-36	GBIF Germany	4f6826f2-4ff6-443d-b966-e6913bd24013	6537fcce-f762-11e1-a439-00145eb45e9a
136	136	0	GBIF Germany	4f6826f2-4ff6-443d-b966-e6913bd24013	66277344-f762-11e1-a439-00145eb45e9a
547	547	0	GBIF France	da44cd31-5901-4687-a106-6d1c7734ee3a	67f9f4bd-acfe-49c9-9fb6-124fbb8ec3ee
141	141	0	GBIF Germany	4f6826f2-4ff6-443d-b966-e6913bd24013	69560a9e-f762-11e1-a439-00145eb45e9a
0	3	3	Plazi	ffb07bec-2d10-492d-9c37-361fe0b79427	6bf12332-272d-4c45-8a59-9ac0b899181a
46	46	0	GBIF Argentina	2426a871-9feb-40a1-96c6-0c593a76b835	6c8cdbf6-7abd-40b4-a986-a3f2ce7c3292
4	4	0	GBIF Germany	4f6826f2-4ff6-443d-b966-e6913bd24013	6fc0903e-f762-11e1-a439-00145eb45e9a
828	828	0	GBIF Germany	4f6826f2-4ff6-443d-b966-e6913bd24013	6fcc544a-a983-4d17-addb-d16c3a717947
11344	11344	0	Colombian Biodiversity Information System	7e865cba-7c46-417b-ade5-97f2cf5b7be0	704fd2e5-f071-4836-8f24-2b3da24f7b57
15	15	0	Plazi	ffb07bec-2d10-492d-9c37-361fe0b79427	71084cdc-7df1-4f19-b3f3-4b85f0a3e2c6
64	64	0	GBIF Germany	4f6826f2-4ff6-443d-b966-e6913bd24013	71958ad6-f762-11e1-a439-00145eb45e9a
5	5	0	Plazi	ffb07bec-2d10-492d-9c37-361fe0b79427	71a3f4b4-3e53-486e-9cee-0195fbbfb8e8
904	904	0	GBIF Norway	4f829580-180d-46a9-9c87-ed8ec959b545	72a85a13-37f3-4bbc-92f0-3ba8dbe7c3d0
477	477	0	GBIF Germany	4f6826f2-4ff6-443d-b966-e6913bd24013	73279682-f762-11e1-a439-00145eb45e9a
39	39	0	GBIF Germany	4f6826f2-4ff6-443d-b966-e6913bd24013	7332d420-f762-11e1-a439-00145eb45e9a
38	38	0	GBIF Germany	4f6826f2-4ff6-443d-b966-e6913bd24013	7367cb12-f762-11e1-a439-00145eb45e9a
11	11	0	GBIF Germany	4f6826f2-4ff6-443d-b966-e6913bd24013	743cc0b0-f762-11e1-a439-00145eb45e9a
5	5	0	Plazi	ffb07bec-2d10-492d-9c37-361fe0b79427	74d3e4ec-0fcb-4a81-907a-a471cfd25456
19	19	0	GBIF Germany	4f6826f2-4ff6-443d-b966-e6913bd24013	7552f9c4-f762-11e1-a439-00145eb45e9a
10	10	0	Plazi	ffb07bec-2d10-492d-9c37-361fe0b79427	76b4bccd-9042-4639-acc4-edf0a812c6b2
190733	191400	667	GBIF Brazil	cdc9736d-5ff7-4ece-9959-3c744360cdb3	7741a517-ab3d-4b85-ae58-56322e44c8ce
313	313	0	GBIF Germany	4f6826f2-4ff6-443d-b966-e6913bd24013	774b39d0-f762-11e1-a439-00145eb45e9a
9119	9120	1	U.S. Geological Survey	8618c64a-93e0-4300-b546-7249e5148ed2	78122332-6315-41bd-914b-e9c1342d9093
0	6	6	Plazi	ffb07bec-2d10-492d-9c37-361fe0b79427	78fe07f2-6fe7-4d0f-90ea-7cb3f0880314
261	208	-53	GBIF Germany	4f6826f2-4ff6-443d-b966-e6913bd24013	79b81eb8-f762-11e1-a439-00145eb45e9a
88	88	0	Plazi	ffb07bec-2d10-492d-9c37-361fe0b79427	79d22dc4-916c-4f10-a085-4b796c63dd68
54	54	0	GBIF Germany	4f6826f2-4ff6-443d-b966-e6913bd24013	7ab21fe4-f762-11e1-a439-00145eb45e9a
1309	1309	0	Korean Biodiversity Information Facility	e0a1e772-0177-4800-94b4-2d023fe6cdf4	7b384fce-f762-11e1-a439-00145eb45e9a
30	30	0	Ocean Biodiversity Information System	ba0670b9-4186-41e6-8e70-f9cb3065551a	7b6b50fe-f762-11e1-a439-00145eb45e9a
6077	6077	0	GBIF Japan	db5705aa-6a6e-42f1-8942-d77b9f4896ea	7baea624-f762-11e1-a439-00145eb45e9a
332	332	0	Plazi	ffb07bec-2d10-492d-9c37-361fe0b79427	7ca72f76-4fae-4305-8601-4662f4cd2b96
9	9	0	Plazi	ffb07bec-2d10-492d-9c37-361fe0b79427	7cefc0b8-0126-4022-a865-d2a8c0323c7c
208	208	0	GBIF France	da44cd31-5901-4687-a106-6d1c7734ee3a	7dd21529-ded8-4551-b3fd-3bdb20e7cbc3
299	299	0	GBIF Germany	4f6826f2-4ff6-443d-b966-e6913bd24013	7f3139f6-f762-11e1-a439-00145eb45e9a
43	43	0	GBIF Germany	4f6826f2-4ff6-443d-b966-e6913bd24013	7f451d18-f762-11e1-a439-00145eb45e9a
308	308	0	Biodiversity Information System of Mexico	b324e8e9-9a4c-44fa-8f1a-7f39ea7ab576	80be653c-f762-11e1-a439-00145eb45e9a
143	143	0	GBIF Germany	4f6826f2-4ff6-443d-b966-e6913bd24013	815035ac-f762-11e1-a439-00145eb45e9a
1512	891	-621	GBIF Germany	4f6826f2-4ff6-443d-b966-e6913bd24013	8175f792-f762-11e1-a439-00145eb45e9a
678	678	0	GBIF Germany	4f6826f2-4ff6-443d-b966-e6913bd24013	82037496-f762-11e1-a439-00145eb45e9a
345	345	0	GBIF Argentina	2426a871-9feb-40a1-96c6-0c593a76b835	82a6608d-372b-4663-8ed3-dbe0c2bff883
10270	10270	0	GBIF Spain	1f94b3ca-9345-4d65-afe2-4bace93aa0fe	8374a9a8-f762-11e1-a439-00145eb45e9a
14339	15212	873	GBIF Japan	db5705aa-6a6e-42f1-8942-d77b9f4896ea	84a2fe56-f762-11e1-a439-00145eb45e9a
302208	318606	16398	GBIF Germany	4f6826f2-4ff6-443d-b966-e6913bd24013	85714c48-f762-11e1-a439-00145eb45e9a
187	187	0	GBIF Germany	4f6826f2-4ff6-443d-b966-e6913bd24013	862745a3-40c4-4a5d-88f0-f4e41f0bcb98
1110	1110	0	Biodiversity Information System of Mexico	b324e8e9-9a4c-44fa-8f1a-7f39ea7ab576	86a55fbe-f762-11e1-a439-00145eb45e9a
427	338	-89	GBIF Germany	4f6826f2-4ff6-443d-b966-e6913bd24013	87126f00-f762-11e1-a439-00145eb45e9a
16	16	0	Participant Node Managers Committee	7f48e0c8-5c96-49ec-b972-30748e339115	88ce1fb7-0566-4486-bd63-9c1fbc422b30
251	251	0	GBIF Portugal	673f7038-4262-4149-b753-5658a4e912f6	895b58b2-f762-11e1-a439-00145eb45e9a
0	18	18	Plazi	ffb07bec-2d10-492d-9c37-361fe0b79427	8bc6ac46-a8c5-4e52-809a-6508af4bfdb5
168	168	0	GBIF Germany	4f6826f2-4ff6-443d-b966-e6913bd24013	8be41eac-f762-11e1-a439-00145eb45e9a
109	109	0	GBIF Germany	4f6826f2-4ff6-443d-b966-e6913bd24013	8c779294-1cc4-4257-95db-8f2a4e7e0f8e
278	278	0	GBIF Portugal	673f7038-4262-4149-b753-5658a4e912f6	8d977c3b-adc5-48df-8a0f-3e21fbb25963
106	68	-38	GBIF Germany	4f6826f2-4ff6-443d-b966-e6913bd24013	8e84ebc8-f762-11e1-a439-00145eb45e9a
2559	2559	0	Biodiversity Information System of Mexico	b324e8e9-9a4c-44fa-8f1a-7f39ea7ab576	8f41f7ec-ce11-4275-b87b-907cc466d146
67	54	-13	GBIF Germany	4f6826f2-4ff6-443d-b966-e6913bd24013	9008ccb2-f762-11e1-a439-00145eb45e9a
7	7	0	Plazi	ffb07bec-2d10-492d-9c37-361fe0b79427	908a4bc6-a4e0-404d-83f6-cd1952f89fd5
263	263	0	GBIF France	da44cd31-5901-4687-a106-6d1c7734ee3a	90a8efee-ab8d-4834-9509-7adba5c56c62
0	1	1	Plazi	ffb07bec-2d10-492d-9c37-361fe0b79427	90b5e0a5-efa9-4fb7-8438-d48050dc7dd3
164	80	-84	GBIF Germany	4f6826f2-4ff6-443d-b966-e6913bd24013	90fd7b0e-f762-11e1-a439-00145eb45e9a
148	148	0	GBIF Germany	4f6826f2-4ff6-443d-b966-e6913bd24013	928dc3fc-f762-11e1-a439-00145eb45e9a
34	36	2	GBIF Germany	4f6826f2-4ff6-443d-b966-e6913bd24013	92cf34ae-f762-11e1-a439-00145eb45e9a
176	176	0	GBIF Germany	4f6826f2-4ff6-443d-b966-e6913bd24013	932a9a7e-f762-11e1-a439-00145eb45e9a
4	4	0	GBIF Germany	4f6826f2-4ff6-443d-b966-e6913bd24013	93872ea6-f762-11e1-a439-00145eb45e9a
18	18	0	GBIF Germany	4f6826f2-4ff6-443d-b966-e6913bd24013	93b2fc3e-f762-11e1-a439-00145eb45e9a
102	102	0	GBIF Germany	4f6826f2-4ff6-443d-b966-e6913bd24013	95bfa586-f762-11e1-a439-00145eb45e9a
14742	15211	469	GBIF Germany	4f6826f2-4ff6-443d-b966-e6913bd24013	9669ebc2-f762-11e1-a439-00145eb45e9a
4	4	0	GBIF Germany	4f6826f2-4ff6-443d-b966-e6913bd24013	96bf533b-52de-4e28-9f59-1fdf843e0224
2	2	0	Plazi	ffb07bec-2d10-492d-9c37-361fe0b79427	99c22d63-46bd-474e-9f3b-1ac27984d7dc
82	82	0	GBIF Argentina	2426a871-9feb-40a1-96c6-0c593a76b835	9a8ec774-66ce-4f5c-85b3-553bde269d45
0	2	2	Plazi	ffb07bec-2d10-492d-9c37-361fe0b79427	9aab08cf-1a9c-490c-af50-12978a3a8789
861	397	-464	GBIF Germany	4f6826f2-4ff6-443d-b966-e6913bd24013	9cd5f8e9-1927-44ee-baee-4152aec84adb
228	228	0	Scientific Committee on Antarctic Research	51e4e8ff-bff0-4996-8b27-9107d61b3478	9d9def2d-6ae6-435a-b857-b202954d378a
0	2	2	Plazi	ffb07bec-2d10-492d-9c37-361fe0b79427	9dae40e7-1734-4657-b1d8-e3efbcdaa21b
6	6	0	Plazi	ffb07bec-2d10-492d-9c37-361fe0b79427	9fb480a7-aaf6-402a-b233-0d0ca6057b76
423	423	0	GBIF France	da44cd31-5901-4687-a106-6d1c7734ee3a	a0ad2b0f-fe94-40f1-bb1f-7fde24262c9d
34	34	0	Plazi	ffb07bec-2d10-492d-9c37-361fe0b79427	a2a82814-e7a7-4515-94fd-f8680a471fbe
2	2	0	Plazi	ffb07bec-2d10-492d-9c37-361fe0b79427	a7d204c0-d8e1-431c-87bb-ef955086659c
0	82	82	Plazi	ffb07bec-2d10-492d-9c37-361fe0b79427	a9792973-949f-4327-82ad-8a38612624b4
182	27	-155	Colombian Biodiversity Information System	7e865cba-7c46-417b-ade5-97f2cf5b7be0	aa0b8884-2d52-4c2f-a88c-2e865dab7259
2	2	0	Plazi	ffb07bec-2d10-492d-9c37-361fe0b79427	aabe05d6-dd55-48a2-9cd6-bc2b6b8fea8a
77	77	0	GBIF Germany	4f6826f2-4ff6-443d-b966-e6913bd24013	ab3dc21c-0414-462e-a588-b65a189b18ce
0	39	39	Plazi	ffb07bec-2d10-492d-9c37-361fe0b79427	ad9f7049-4351-4deb-945a-409f9bbb5076
3506580	3917100	410520	GBIF Norway	4f829580-180d-46a9-9c87-ed8ec959b545	aea17af8-5578-4b04-b5d3-7adf0c5a1e60
4180	4180	0	Colombian Biodiversity Information System	7e865cba-7c46-417b-ade5-97f2cf5b7be0	b04c4f58-8207-448f-abdd-3c588a901d42
19	19	0	Plazi	ffb07bec-2d10-492d-9c37-361fe0b79427	b54ec238-e2b8-435b-8ef7-3aed4570b52e
321	321	0	National Biodiversity Network	d897a5b9-35ee-4232-94bd-b0bcaac003c2	b6eae303-f834-41db-8b39-42168d1b0bcd
0	4	4	Plazi	ffb07bec-2d10-492d-9c37-361fe0b79427	bb29c527-5de9-4ef9-874e-2b7b3b9a5348
47	47	0	GBIF France	da44cd31-5901-4687-a106-6d1c7734ee3a	bb5ed4bb-5585-489c-abdd-97a32941f5e1
1	1	0	Plazi	ffb07bec-2d10-492d-9c37-361fe0b79427	bc93a100-df15-48bf-9453-34aafe93d9f0
40	40	0	GBIF Germany	4f6826f2-4ff6-443d-b966-e6913bd24013	bee6fe88-3c47-4e08-aaba-88bd3413e774
0	12739	12739	Participant Node Managers Committee	7f48e0c8-5c96-49ec-b972-30748e339115	bf5bc7f6-71a3-4abd-8abc-861ee3cbf84a
10	10	0	Plazi	ffb07bec-2d10-492d-9c37-361fe0b79427	bf8a3c92-77d6-425b-83ef-f1ab58df49db
46	46	0	Plazi	ffb07bec-2d10-492d-9c37-361fe0b79427	c4647d89-ea08-437d-b0cf-72116f1a3d90
219	219	0	Participant Node Managers Committee	7f48e0c8-5c96-49ec-b972-30748e339115	c65f17da-ddda-4efe-b5c9-264f855f20e1
1968	1968	0	GBIF Germany	4f6826f2-4ff6-443d-b966-e6913bd24013	c8cc0aeb-b615-499b-9508-24a3b3f9eba4
18	18	0	Plazi	ffb07bec-2d10-492d-9c37-361fe0b79427	c9a733db-8465-499c-b4fc-bd29fafbacb8
0	32	32	Plazi	ffb07bec-2d10-492d-9c37-361fe0b79427	cca25fa0-f207-4c9b-bf10-ef715e4f813b
0	185	185	Plazi	ffb07bec-2d10-492d-9c37-361fe0b79427	cd89b152-32bd-42cc-be33-a74a856fb5e4
107	107	0	GBIF France	da44cd31-5901-4687-a106-6d1c7734ee3a	ce10bcd7-7020-4e77-a796-c6e4fe67d772
272	96	-176	GBIF Germany	4f6826f2-4ff6-443d-b966-e6913bd24013	cecda9ad-b542-4f5c-b19b-ea81c4846d80
115	115	0	Participant Node Managers Committee	7f48e0c8-5c96-49ec-b972-30748e339115	d0adfdd0-4c63-45fc-9d32-2b17420027ca
659	659	0	GBIF Argentina	2426a871-9feb-40a1-96c6-0c593a76b835	d4b3cce1-4594-47bb-b1e2-1ace65458a11
5	5	0	Plazi	ffb07bec-2d10-492d-9c37-361fe0b79427	d5bea9d0-842b-4959-a3e5-63fcfffb44ae
6	6	0	Plazi	ffb07bec-2d10-492d-9c37-361fe0b79427	d82952d0-3301-4453-ba9e-07162241f4c4
348	288	-60	GBIF Germany	4f6826f2-4ff6-443d-b966-e6913bd24013	d8711993-cccf-4ec1-9ba5-a1bdd7c094bb
182	182	0	Belgian Biodiversity Platform	fb11cfe1-ebc3-45af-9159-17d9fddbcdac	d8f8115d-9d8a-473a-be44-ae7d34f034d8
240	240	0	Participant Node Managers Committee	7f48e0c8-5c96-49ec-b972-30748e339115	dfc600bf-7410-4aa9-81c2-b3cc9415c989
118	118	0	Plazi	ffb07bec-2d10-492d-9c37-361fe0b79427	e08d625a-f512-45c8-9cd2-a1069798ddab
1116785	724021	-392764	Atlas of Living Australia	4a6f1b71-969e-4fc5-a693-282b05e1220c	e4473544-f4cd-4429-b791-39d6e1fdb0a4
13	13	0	Plazi	ffb07bec-2d10-492d-9c37-361fe0b79427	e49be22e-e744-4f34-abd2-8bc1561a35e3
106	106	0	GBIF France	da44cd31-5901-4687-a106-6d1c7734ee3a	e6664b97-df1d-4d3d-b235-b220e93231fd
344	344	0	GBIF Japan	db5705aa-6a6e-42f1-8942-d77b9f4896ea	e82f2a08-095b-432c-980d-b10e9cd9370f
578	578	0	GBIF Japan	db5705aa-6a6e-42f1-8942-d77b9f4896ea	e8e2aa50-c651-4370-a0b7-46532ec48a5e
0	36	36	Plazi	ffb07bec-2d10-492d-9c37-361fe0b79427	e9b42f19-4de2-451a-a0f5-e1b10e7b6012
699	699	0	Colombian Biodiversity Information System	7e865cba-7c46-417b-ade5-97f2cf5b7be0	ea4f245a-67aa-4dbf-b49c-b4022230648e
65319	79848	14529	GBIF Brazil	cdc9736d-5ff7-4ece-9959-3c744360cdb3	ec20771d-5c61-409f-825c-3eea4118c437
165	165	0	Colombian Biodiversity Information System	7e865cba-7c46-417b-ade5-97f2cf5b7be0	f2cc281f-87cc-4591-8b09-cdb6e3f7c308
3033	3033	0	GBIF France	da44cd31-5901-4687-a106-6d1c7734ee3a	fb77ae34-c5c5-49b9-8510-2d6000f8cf45
384	384	0	Belgian Biodiversity Platform	fb11cfe1-ebc3-45af-9159-17d9fddbcdac	fdf98536-4e0b-4e22-b00d-3c555f37b9e7
1299	311	-988	GBIF Germany	4f6826f2-4ff6-443d-b966-e6913bd24013	00d4fb39-26c2-4eaa-8267-f6e6a12d36e1
7	7	0	Plazi	ffb07bec-2d10-492d-9c37-361fe0b79427	0178c23b-bb7a-4054-acb9-ea10cc9a2801
43	43	0	GBIF Argentina	2426a871-9feb-40a1-96c6-0c593a76b835	04d5f075-af36-4175-9885-8ef976648e10
7	7	0	Plazi	ffb07bec-2d10-492d-9c37-361fe0b79427	05a72d3c-8280-4038-9da2-8a307fb88338
2944	2944	0	National Biodiversity Network	d897a5b9-35ee-4232-94bd-b0bcaac003c2	05ac03e9-5650-4110-a049-b8283976a57a
0	3	3	Plazi	ffb07bec-2d10-492d-9c37-361fe0b79427	0657afbe-a3ef-4f09-9361-95b1871b860a
168	168	0	Colombian Biodiversity Information System	7e865cba-7c46-417b-ade5-97f2cf5b7be0	09b33058-0e27-4608-bff3-ac21555614a3
0	32	32	Plazi	ffb07bec-2d10-492d-9c37-361fe0b79427	09c56e41-a1c0-48e0-acba-543a259ad939
6	6	0	Plazi	ffb07bec-2d10-492d-9c37-361fe0b79427	0a65a841-c4bf-4ac5-89e1-a418036752a3
0	3	3	Plazi	ffb07bec-2d10-492d-9c37-361fe0b79427	0b300793-3b6d-4ee1-9f22-34e2ef553a6a
35	35	0	GBIF Argentina	2426a871-9feb-40a1-96c6-0c593a76b835	13b67b18-b6d4-4693-8f36-711ef071dd62
12	12	0	Plazi	ffb07bec-2d10-492d-9c37-361fe0b79427	18c5b6c1-e7d9-49f5-8f1c-a0dc727b61e4
0	8	8	Plazi	ffb07bec-2d10-492d-9c37-361fe0b79427	1b49a290-1a57-4c5f-9dae-c0b24f52fb28
7	7	0	Plazi	ffb07bec-2d10-492d-9c37-361fe0b79427	1be79fba-188a-48d6-abab-4c02dbef39cc
332	332	0	GBIF Argentina	2426a871-9feb-40a1-96c6-0c593a76b835	1c7e9e74-1541-49ac-b3c0-7265e0d33c3d
2	2	0	Plazi	ffb07bec-2d10-492d-9c37-361fe0b79427	1e38dd21-9a97-4b9a-a522-2e056bba20cc
10965	10965	0	Participant Node Managers Committee	7f48e0c8-5c96-49ec-b972-30748e339115	20b58f3f-f15f-4546-b501-2e19a6a3be0b
189	189	0	National Biodiversity Network	d897a5b9-35ee-4232-94bd-b0bcaac003c2	25487721-3b4c-48d4-945a-210a85ddf693
0	185206	185206	U.S. Geological Survey	8618c64a-93e0-4300-b546-7249e5148ed2	277b6f51-9e44-47f1-8d88-397ac0245d20
125	125	0	Colombian Biodiversity Information System	7e865cba-7c46-417b-ade5-97f2cf5b7be0	27d53f20-d31e-4779-8f16-080f1e4ab2ba
18	12	-6	GBIF Germany	4f6826f2-4ff6-443d-b966-e6913bd24013	29334ea1-9b35-4370-9873-8d85ad56be6e
35	35	0	Plazi	ffb07bec-2d10-492d-9c37-361fe0b79427	2baba477-71d4-48ec-b7c2-e3e3a1671eed
17827	17827	0	Atlas of Living Australia	4a6f1b71-969e-4fc5-a693-282b05e1220c	390dcccc-4ee1-4ee1-8607-3e4f584bcccb
6	6	0	Plazi	ffb07bec-2d10-492d-9c37-361fe0b79427	39aa74aa-cc2d-4792-b96e-20f08476b704
3367	3367	0	GBIF France	da44cd31-5901-4687-a106-6d1c7734ee3a	3cabd0cd-ab6d-4fc2-86e8-10797434d81a
5202	5202	0	South African Biodiversity Information Facility	7190b835-4e86-4b6e-85c1-19cc6677c250	3daf4702-e48a-4d1c-a94a-12f9191ffc9e
2894	2894	0	Colombian Biodiversity Information System	7e865cba-7c46-417b-ade5-97f2cf5b7be0	3e85137e-ac2d-4dac-8531-f54ab62b01a2
119	119	0	GBIF Norway	4f829580-180d-46a9-9c87-ed8ec959b545	40126b48-3511-4fbb-aa79-7d039779c387
0	11	11	Ocean Biodiversity Information System	ba0670b9-4186-41e6-8e70-f9cb3065551a	404ee8d1-ffb2-4e30-bbbb-2f3b82987121
7	7	0	Plazi	ffb07bec-2d10-492d-9c37-361fe0b79427	42d91fbf-7d4f-4439-b0e2-bdbbeffad5cd
0	46	46	Colombian Biodiversity Information System	7e865cba-7c46-417b-ade5-97f2cf5b7be0	438c091a-3f5d-424e-a1fd-bddf3f526faa
0	1319	1319	Ocean Biodiversity Information System	ba0670b9-4186-41e6-8e70-f9cb3065551a	499ecbae-d968-4884-b0c0-7934fdc0579f
756	756	0	GBIF Germany	4f6826f2-4ff6-443d-b966-e6913bd24013	4b1928f9-e7a5-41d8-bd0b-4a65839a5c6e
61692	13001	-48691	Biodiversity Information System of Mexico	b324e8e9-9a4c-44fa-8f1a-7f39ea7ab576	4b215a29-3ff0-4242-be72-77490cc773a8
583	583	0	National Biodiversity Network	d897a5b9-35ee-4232-94bd-b0bcaac003c2	4d173f38-a500-4b59-889e-cfde9438afd0
0	2	2	Plazi	ffb07bec-2d10-492d-9c37-361fe0b79427	4ed57ee8-eef5-49dd-915b-fb0defba0ef9
2442	2442	0	Atlas of Living Australia	4a6f1b71-969e-4fc5-a693-282b05e1220c	514d5f6a-d6ce-4e4a-9097-c014d06f11c9
0	5	5	Plazi	ffb07bec-2d10-492d-9c37-361fe0b79427	52f5fc93-af9c-4a44-80cb-0419a7f7724d
0	4	4	Plazi	ffb07bec-2d10-492d-9c37-361fe0b79427	5383fa36-31d0-4679-9c30-0b6b36d64d4e
4	4	0	Plazi	ffb07bec-2d10-492d-9c37-361fe0b79427	53d0fad9-2fa5-4590-a56b-3dc0ebd6dcb1
7	7	0	Plazi	ffb07bec-2d10-492d-9c37-361fe0b79427	55b16314-91e3-43d4-b50a-1d3fcec44740
328	328	0	GBIF Germany	4f6826f2-4ff6-443d-b966-e6913bd24013	55c65f67-b547-4752-a0cf-a4ef339a020e
17	17	0	Colombian Biodiversity Information System	7e865cba-7c46-417b-ade5-97f2cf5b7be0	59049d09-b331-4b0e-9d56-3bcf8459a7a5
194	194	0	Plazi	ffb07bec-2d10-492d-9c37-361fe0b79427	5de5bda6-9a63-45d9-a039-7b7baa420391
1616	1616	0	GBIF France	da44cd31-5901-4687-a106-6d1c7734ee3a	5f8cf94e-ba98-463a-b94e-dc9df01f02c0
104	104	0	Plazi	ffb07bec-2d10-492d-9c37-361fe0b79427	61a421fd-4e5e-435a-a1c7-5686dbba694a
57	57	0	GBIF Germany	4f6826f2-4ff6-443d-b966-e6913bd24013	627e3f48-f762-11e1-a439-00145eb45e9a
1	1	0	GBIF Germany	4f6826f2-4ff6-443d-b966-e6913bd24013	63567e9e-f762-11e1-a439-00145eb45e9a
33	33	0	Plazi	ffb07bec-2d10-492d-9c37-361fe0b79427	63bce6c3-bb54-4df2-9ee4-ee6917e9b44c
2099	2099	0	GBIF Germany	4f6826f2-4ff6-443d-b966-e6913bd24013	64a6b214-f762-11e1-a439-00145eb45e9a
155	155	0	Plazi	ffb07bec-2d10-492d-9c37-361fe0b79427	65d1b3a0-34d2-41a2-a1de-3207bb3ff615
6278	6277	-1	Belgian Biodiversity Platform	fb11cfe1-ebc3-45af-9159-17d9fddbcdac	66178162-01dc-4133-9b3c-83265481c383
134	134	0	GBIF Germany	4f6826f2-4ff6-443d-b966-e6913bd24013	6628a64c-f762-11e1-a439-00145eb45e9a
26	26	0	GBIF Germany	4f6826f2-4ff6-443d-b966-e6913bd24013	68226bd6-f762-11e1-a439-00145eb45e9a
102	102	0	GBIF Germany	4f6826f2-4ff6-443d-b966-e6913bd24013	68a9ec46-f762-11e1-a439-00145eb45e9a
0	143568	143568	Ocean Biodiversity Information System	ba0670b9-4186-41e6-8e70-f9cb3065551a	698b13ea-c9b5-4f45-9c8f-63f08c695177
42	42	0	GBIF Germany	4f6826f2-4ff6-443d-b966-e6913bd24013	6ac8b0b6-f762-11e1-a439-00145eb45e9a
20	20	0	GBIF Germany	4f6826f2-4ff6-443d-b966-e6913bd24013	6be15002-f762-11e1-a439-00145eb45e9a
22	22	0	GBIF Germany	4f6826f2-4ff6-443d-b966-e6913bd24013	6ca3d848-f762-11e1-a439-00145eb45e9a
74	74	0	GBIF Germany	4f6826f2-4ff6-443d-b966-e6913bd24013	6d443914-f762-11e1-a439-00145eb45e9a
48	48	0	Plazi	ffb07bec-2d10-492d-9c37-361fe0b79427	6dbed4df-4ebb-445a-bb72-27254ed3ca17
308380	308380	0	GBIF France	da44cd31-5901-4687-a106-6d1c7734ee3a	6f0b28dc-60cf-4378-b0c4-c6c6979ffcbc
2	2	0	Plazi	ffb07bec-2d10-492d-9c37-361fe0b79427	6fc3d3c6-eb41-465a-81ad-8fc750d424f0
14	14	0	GBIF Germany	4f6826f2-4ff6-443d-b966-e6913bd24013	6fcb4bbe-f762-11e1-a439-00145eb45e9a
9273	9273	0	National Biodiversity Network	d897a5b9-35ee-4232-94bd-b0bcaac003c2	7118a4ac-2cb2-4c10-b283-c8d2b7c7d5d5
61	61	0	GBIF Germany	4f6826f2-4ff6-443d-b966-e6913bd24013	716d6d62-f762-11e1-a439-00145eb45e9a
16	16	0	GBIF Germany	4f6826f2-4ff6-443d-b966-e6913bd24013	72a009b0-f762-11e1-a439-00145eb45e9a
36	36	0	GBIF Germany	4f6826f2-4ff6-443d-b966-e6913bd24013	744ffc70-f762-11e1-a439-00145eb45e9a
91	91	0	GBIF Germany	4f6826f2-4ff6-443d-b966-e6913bd24013	7504cd76-f762-11e1-a439-00145eb45e9a
367	367	0	GBIF Germany	4f6826f2-4ff6-443d-b966-e6913bd24013	75a62bbc-f762-11e1-a439-00145eb45e9a
5	5	0	Plazi	ffb07bec-2d10-492d-9c37-361fe0b79427	76cc693b-74c4-4797-a4b2-492390acfbac
0	2	2	Plazi	ffb07bec-2d10-492d-9c37-361fe0b79427	79305d7f-0811-4e8d-abe5-f620eaa5ee80
484	484	0	GBIF Germany	4f6826f2-4ff6-443d-b966-e6913bd24013	79d733b6-f762-11e1-a439-00145eb45e9a
170325	174024	3699	GBIF Germany	4f6826f2-4ff6-443d-b966-e6913bd24013	7a2660bc-f762-11e1-a439-00145eb45e9a
79238	79238	0	GBIF France	da44cd31-5901-4687-a106-6d1c7734ee3a	7a8a2ad3-f09f-44b7-b6e6-c8df70030527
0	90	90	Ocean Biodiversity Information System	ba0670b9-4186-41e6-8e70-f9cb3065551a	7b27fa4d-fefe-45a0-a555-8a987f25fcb8
1260	1260	0	GBIF Germany	4f6826f2-4ff6-443d-b966-e6913bd24013	7c1f6c06-f762-11e1-a439-00145eb45e9a
84	84	0	GBIF Germany	4f6826f2-4ff6-443d-b966-e6913bd24013	7caeecd2-f762-11e1-a439-00145eb45e9a
52	52	0	GBIF France	da44cd31-5901-4687-a106-6d1c7734ee3a	7cf28b56-4068-44fd-964e-1f05fe1bd4e3
4702	4702	0	Society for the Management of Electronic Biodiversity Data	97818ee4-1461-4180-bf1d-b3201050124f	7e34ea34-f762-11e1-a439-00145eb45e9a
987	987	0	Biodiversity Information System of Mexico	b324e8e9-9a4c-44fa-8f1a-7f39ea7ab576	7f71a9aa-f762-11e1-a439-00145eb45e9a
0	2	2	Plazi	ffb07bec-2d10-492d-9c37-361fe0b79427	7f87364c-a428-4c51-ace3-20eb8a6c8517
87	87	0	Biodiversity Information System of Mexico	b324e8e9-9a4c-44fa-8f1a-7f39ea7ab576	7fe1bc0e-f762-11e1-a439-00145eb45e9a
813	813	0	Biodiversity Information System of Mexico	b324e8e9-9a4c-44fa-8f1a-7f39ea7ab576	7fe7ef7a-f762-11e1-a439-00145eb45e9a
254	255	1	U.S. Geological Survey	8618c64a-93e0-4300-b546-7249e5148ed2	81a3887e-76be-4f98-b65c-41a43db33951
8725837	8806835	80998	U.S. Geological Survey	8618c64a-93e0-4300-b546-7249e5148ed2	821cc27a-e3bb-4bc5-ac34-89ada245069d
67	67	0	Plazi	ffb07bec-2d10-492d-9c37-361fe0b79427	828c6b9b-3b4c-4887-b5ea-c664de163ee3
35089	35176	87	U.S. Geological Survey	8618c64a-93e0-4300-b546-7249e5148ed2	832a5f06-f762-11e1-a439-00145eb45e9a
12445	12445	0	GBIF Spain	1f94b3ca-9345-4d65-afe2-4bace93aa0fe	83784f5e-f762-11e1-a439-00145eb45e9a
55	55	0	National Biodiversity Network	d897a5b9-35ee-4232-94bd-b0bcaac003c2	843e50de-33af-48f3-9487-2fd2d9d11ba2
28	28	0	Canada Biodiversity Information Facility	8f83fc96-c966-4126-83f7-bf044dc49efa	8453c408-f762-11e1-a439-00145eb45e9a
72399	72399	0	GBIF Japan	db5705aa-6a6e-42f1-8942-d77b9f4896ea	84941b7a-f762-11e1-a439-00145eb45e9a
0	2	2	Plazi	ffb07bec-2d10-492d-9c37-361fe0b79427	859338b8-6ce7-4367-a1cc-3600d55a84cd
60	60	0	GBIF Germany	4f6826f2-4ff6-443d-b966-e6913bd24013	85dd63ba-f762-11e1-a439-00145eb45e9a
934	720	-214	GBIF Germany	4f6826f2-4ff6-443d-b966-e6913bd24013	87fb4392-f762-11e1-a439-00145eb45e9a
944	944	0	Colombian Biodiversity Information System	7e865cba-7c46-417b-ade5-97f2cf5b7be0	882d7a23-109d-4969-b0e4-d97286cf4fb6
215	192	-23	GBIF Germany	4f6826f2-4ff6-443d-b966-e6913bd24013	8866a20e-f762-11e1-a439-00145eb45e9a
1514	1514	0	GBIF Germany	4f6826f2-4ff6-443d-b966-e6913bd24013	89971212-f762-11e1-a439-00145eb45e9a
121	121	0	GBIF Germany	4f6826f2-4ff6-443d-b966-e6913bd24013	8a0df3e6-f762-11e1-a439-00145eb45e9a
3109	3420	311	National Biodiversity Network	d897a5b9-35ee-4232-94bd-b0bcaac003c2	8aacd135-497b-4284-aa8c-bc4f4e8822db
0	93147	93147	Ocean Biodiversity Information System	ba0670b9-4186-41e6-8e70-f9cb3065551a	8bfd90da-4ab9-40a2-8c96-bd7c2c9e9fc5
344	4230	3886	Participant Node Managers Committee	7f48e0c8-5c96-49ec-b972-30748e339115	8cec560d-6f41-456b-b5a7-805f9d861bc5
52	52	0	GBIF Germany	4f6826f2-4ff6-443d-b966-e6913bd24013	8d1c1e32-f762-11e1-a439-00145eb45e9a
2	1	-1	GBIF Germany	4f6826f2-4ff6-443d-b966-e6913bd24013	8ddb01c6-f762-11e1-a439-00145eb45e9a
3	3	0	Plazi	ffb07bec-2d10-492d-9c37-361fe0b79427	8e16f110-bc44-44b8-98a9-b4d06a01cf69
44	24	-20	GBIF Germany	4f6826f2-4ff6-443d-b966-e6913bd24013	8e3f749e-f762-11e1-a439-00145eb45e9a
3363	2679	-684	GBIF Germany	4f6826f2-4ff6-443d-b966-e6913bd24013	8e9c1410-f762-11e1-a439-00145eb45e9a
88	88	0	Plazi	ffb07bec-2d10-492d-9c37-361fe0b79427	8f1510f6-1b79-467f-9e8d-f193ac82cc4b
89	79	-10	GBIF Germany	4f6826f2-4ff6-443d-b966-e6913bd24013	8f60154a-f762-11e1-a439-00145eb45e9a
253	206	-47	GBIF Germany	4f6826f2-4ff6-443d-b966-e6913bd24013	90b6823a-f762-11e1-a439-00145eb45e9a
0	1	1	Ocean Biodiversity Information System	ba0670b9-4186-41e6-8e70-f9cb3065551a	9364d69a-4697-474f-b1e2-dc6d7cc2c476
7	7	0	Plazi	ffb07bec-2d10-492d-9c37-361fe0b79427	95c51ec1-626e-45a6-9351-6fd050ef2abd
1	1	0	Plazi	ffb07bec-2d10-492d-9c37-361fe0b79427	95f9938e-946f-495a-bd6c-71fa002305bc
56	56	0	Plazi	ffb07bec-2d10-492d-9c37-361fe0b79427	96e8808b-a190-471b-89dc-ecf06d898298
112	112	0	Plazi	ffb07bec-2d10-492d-9c37-361fe0b79427	9aaf6711-748d-4067-a759-26d37802b7fc
0	4	4	Plazi	ffb07bec-2d10-492d-9c37-361fe0b79427	9b90e589-a9a7-41c6-a4c6-cf78bea67fc4
27	27	0	Plazi	ffb07bec-2d10-492d-9c37-361fe0b79427	a4a42616-c7d5-4b62-9e44-8c3cf07d2732
0	112	112	Plazi	ffb07bec-2d10-492d-9c37-361fe0b79427	a89f233a-0529-449a-b6c5-070ab02a539a
0	58	58	Plazi	ffb07bec-2d10-492d-9c37-361fe0b79427	a8e60e9b-ceed-4448-b751-9b3d3a5489ff
2	2	0	Plazi	ffb07bec-2d10-492d-9c37-361fe0b79427	a9f3802d-3ecc-4fee-ab04-da83003d9fc7
28	28	0	Plazi	ffb07bec-2d10-492d-9c37-361fe0b79427	ac0009a5-e47c-48d0-9099-51f73b3626af
0	15	15	Plazi	ffb07bec-2d10-492d-9c37-361fe0b79427	acb59eb3-0a71-451b-bb9c-3f761fc35857
2	2	0	Biodiversity Information System of Mexico	b324e8e9-9a4c-44fa-8f1a-7f39ea7ab576	ae298e4a-8274-42f2-ac7a-ba0691099c4e
1	1	0	Plazi	ffb07bec-2d10-492d-9c37-361fe0b79427	aff5b97f-51c0-45ab-ac1c-07ad15b79456
12	12	0	Plazi	ffb07bec-2d10-492d-9c37-361fe0b79427	b2d3cc3b-6448-4235-b74f-b0524bb9f918
7879	7879	0	National Biodiversity Network	d897a5b9-35ee-4232-94bd-b0bcaac003c2	b38b2ce6-9e6f-4cdd-80f0-88f284f6e64a
73	73	0	GBIF Germany	4f6826f2-4ff6-443d-b966-e6913bd24013	b70c95b5-5d03-47e9-9308-07c1cc031c93
0	2	2	Plazi	ffb07bec-2d10-492d-9c37-361fe0b79427	bccf2473-afab-4bf4-87c9-40d119f3fd4c
0	96	96	Plazi	ffb07bec-2d10-492d-9c37-361fe0b79427	bd7cc206-04b6-4226-8174-59d23be65134
71	71	0	Plazi	ffb07bec-2d10-492d-9c37-361fe0b79427	c2731416-bd88-4ba5-8fde-3ab312ea67d3
0	13	13	Plazi	ffb07bec-2d10-492d-9c37-361fe0b79427	c2ee457e-dc5a-499b-9eff-ccefb9fc9cbe
6342	6342	0	Participant Node Managers Committee	7f48e0c8-5c96-49ec-b972-30748e339115	c3bbea68-671c-44be-b676-a2d986d15e9b
4	4	0	Plazi	ffb07bec-2d10-492d-9c37-361fe0b79427	cab7562c-80d6-4c50-be4c-1818403c0c4b
4	4	0	Plazi	ffb07bec-2d10-492d-9c37-361fe0b79427	cd1bb18a-1590-406e-b1ec-31ea2c8b6c54
26	26	0	Plazi	ffb07bec-2d10-492d-9c37-361fe0b79427	cf261dca-6d23-4d65-8096-07d52b073142
314	314	0	Plazi	ffb07bec-2d10-492d-9c37-361fe0b79427	d2e6cfb5-f377-411b-b1be-5b3bb4135c9e
0	11	11	Plazi	ffb07bec-2d10-492d-9c37-361fe0b79427	d48c7b51-c9b4-49e7-8abf-1ecee8db36a1
5	5	0	Plazi	ffb07bec-2d10-492d-9c37-361fe0b79427	d80a3e8d-a3f0-4185-9ee8-2620b18f844c
35	35	0	Plazi	ffb07bec-2d10-492d-9c37-361fe0b79427	dbacda5e-8094-40a9-8f55-1b1d5d7840fb
0	6	6	Plazi	ffb07bec-2d10-492d-9c37-361fe0b79427	dd87a498-2d4d-4766-a05e-adddbd39b085
24	24	0	Plazi	ffb07bec-2d10-492d-9c37-361fe0b79427	de14dab5-2961-423b-867f-5a4a48d8bb3e
47	47	0	GBIF Argentina	2426a871-9feb-40a1-96c6-0c593a76b835	dedd0a3d-9e20-4381-b5e1-bb2909ef50ec
70	70	0	GBIF France	da44cd31-5901-4687-a106-6d1c7734ee3a	e2da0609-01c9-4a51-b72e-3a2e54da4e62
12	12	0	Participant Node Managers Committee	7f48e0c8-5c96-49ec-b972-30748e339115	e3f27685-1974-4cb9-9fb4-0b1f8e9430c4
99	99	0	GBIF India	59d15a9b-ba51-43c3-a53f-304fe6732c04	e456e13a-36fb-434e-afc7-02c5875f3617
46	46	0	GBIF Brazil	cdc9736d-5ff7-4ece-9959-3c744360cdb3	e53ab470-d99a-4ef8-be90-27cfccbfb60d
36227	36227	0	Belgian Biodiversity Platform	fb11cfe1-ebc3-45af-9159-17d9fddbcdac	e5707b52-5222-4b64-8b6d-be7d1b279cb3
8717	8717	0	GBIF France	da44cd31-5901-4687-a106-6d1c7734ee3a	e636f148-49b7-4774-b17e-d41bd3d1b63f
605	605	0	Participant Node Managers Committee	7f48e0c8-5c96-49ec-b972-30748e339115	eab11cae-2961-4c95-b2c4-1fff228c639a
3	3	0	Plazi	ffb07bec-2d10-492d-9c37-361fe0b79427	ed1cd1a2-4fc4-4243-9961-6fec441bff6d
0	1	1	Plazi	ffb07bec-2d10-492d-9c37-361fe0b79427	effef745-ab32-4f2d-9571-fb183d142dfa
39	39	0	GBIF Norway	4f829580-180d-46a9-9c87-ed8ec959b545	f0752414-5da7-4eff-9029-56933963243f
4	4	0	Plazi	ffb07bec-2d10-492d-9c37-361fe0b79427	f09405a9-0a03-41ad-8b58-fd8936870827
2	2	0	Plazi	ffb07bec-2d10-492d-9c37-361fe0b79427	f0b60062-33ae-4461-b3bf-39ec4b82cf26
11390	11390	0	GBIF France	da44cd31-5901-4687-a106-6d1c7734ee3a	f339bf2a-5411-40d5-b4ed-80d0fc28f32d
97593	109653	12060	Taiwan Biodiversity Information Facility	e1b85abc-61f9-430f-ba79-6813dec53a0f	f3f25fcf-2930-4cf1-a495-6b31d7fa0252
4	4	0	Plazi	ffb07bec-2d10-492d-9c37-361fe0b79427	f58f7590-bf8a-4672-8c24-320996f34a7d
45	45	0	Plazi	ffb07bec-2d10-492d-9c37-361fe0b79427	f7e25a30-d0c7-41e1-a4b1-9378d4bd3d93
0	100	100	Participant Node Managers Committee	7f48e0c8-5c96-49ec-b972-30748e339115	f7fe09f7-fd9a-4db7-992a-8f9feb766096
6792	6792	0	GBIF France	da44cd31-5901-4687-a106-6d1c7734ee3a	f97ff554-6da6-43ef-9189-f9b8ef46bce0
6	6	0	Plazi	ffb07bec-2d10-492d-9c37-361fe0b79427	fa36f705-43af-4743-b245-fb0672e6b650
1	1	0	Plazi	ffb07bec-2d10-492d-9c37-361fe0b79427	fca89de6-bdbb-4d85-b695-4fc51fe2c9b2
234	234	0	Plazi	ffb07bec-2d10-492d-9c37-361fe0b79427	02603b90-9879-40a3-99e4-5079e4d50ff8
5	5	0	Plazi	ffb07bec-2d10-492d-9c37-361fe0b79427	02a2505a-59c1-4f33-acbd-0780897041fd
0	3	3	Plazi	ffb07bec-2d10-492d-9c37-361fe0b79427	0385c7af-c1a3-4599-ab2e-1e46e9ecbd90
3082	3082	0	National Biodiversity Network	d897a5b9-35ee-4232-94bd-b0bcaac003c2	05918c76-a3c4-4575-8d20-bee37612a367
0	17	17	Plazi	ffb07bec-2d10-492d-9c37-361fe0b79427	05efa1bd-7787-4f5c-a014-e94b9b9f24fa
2	2	0	Plazi	ffb07bec-2d10-492d-9c37-361fe0b79427	0767428d-0add-4eda-84ba-235584787f0a
9846	9846	0	National Biodiversity Network	d897a5b9-35ee-4232-94bd-b0bcaac003c2	0796d127-83c0-4505-9173-d10144339dbb
166	166	0	GBIF France	da44cd31-5901-4687-a106-6d1c7734ee3a	0a930b5a-91e5-4f53-b84c-6fc2b508c44f
1361	1361	0	Biodiversity Information System of Mexico	b324e8e9-9a4c-44fa-8f1a-7f39ea7ab576	0b81b94a-9761-46e5-a483-df6fcb840cc5
575	575	0	Participant Node Managers Committee	7f48e0c8-5c96-49ec-b972-30748e339115	0f83e46d-1a5a-4d3b-97a4-6156b615f297
54	54	0	GBIF France	da44cd31-5901-4687-a106-6d1c7734ee3a	101196f4-8947-493d-b4ae-d006431fcb59
0	19	19	Plazi	ffb07bec-2d10-492d-9c37-361fe0b79427	10415730-8d4c-4d20-b136-2bab24de103f
0	35	35	Ocean Biodiversity Information System	ba0670b9-4186-41e6-8e70-f9cb3065551a	11729a31-ceab-4946-b6ea-8310a5757524
697	697	0	Colombian Biodiversity Information System	7e865cba-7c46-417b-ade5-97f2cf5b7be0	1339f314-87a1-4893-86ed-68a8c0480c9a
0	4	4	Plazi	ffb07bec-2d10-492d-9c37-361fe0b79427	14317ce1-fcb1-457a-8629-f79559f3cf3e
20	20	0	GBIF Germany	4f6826f2-4ff6-443d-b966-e6913bd24013	14650304-bedc-457d-9668-d0cfb2a1e71e
8007	8007	0	Colombian Biodiversity Information System	7e865cba-7c46-417b-ade5-97f2cf5b7be0	16a22a5e-9f2a-498b-8178-a410c99a5a8c
2	2	0	Plazi	ffb07bec-2d10-492d-9c37-361fe0b79427	19b363fa-0d98-4a5e-a040-fc64da9c2588
116	116	0	Plazi	ffb07bec-2d10-492d-9c37-361fe0b79427	1c1a4f5c-d754-41f9-88ee-0cc4f547dd77
103	103	0	GBIF France	da44cd31-5901-4687-a106-6d1c7734ee3a	1cefbf84-1af2-47d8-9591-f5cfb713a6ac
0	140	140	Plazi	ffb07bec-2d10-492d-9c37-361fe0b79427	20e4b6f8-b40e-4dcd-8fbc-9e7985c7af96
102374	102374	0	GBIF France	da44cd31-5901-4687-a106-6d1c7734ee3a	22a8e7a7-255a-4f63-83bb-f5f888ed3cd8
0	70	70	Plazi	ffb07bec-2d10-492d-9c37-361fe0b79427	24718fff-d17f-44d0-a13e-98bd95596e20
0	8	8	Plazi	ffb07bec-2d10-492d-9c37-361fe0b79427	27843615-9129-46ec-9d65-4e17a285ff62
1440	4112	2672	GBIF Japan	db5705aa-6a6e-42f1-8942-d77b9f4896ea	2856e422-44ab-4499-8a7a-6d9a000463b2
19992	20340	348	U.S. Geological Survey	8618c64a-93e0-4300-b546-7249e5148ed2	2aa02cf8-c402-412c-9ad1-585e1e185bef
24260	24260	0	Biodiversity Information System of Mexico	b324e8e9-9a4c-44fa-8f1a-7f39ea7ab576	2c5b0d56-93bf-43d8-870f-adfd8c4c2c39
0	4	4	Plazi	ffb07bec-2d10-492d-9c37-361fe0b79427	2ea1cd2a-a32c-4fb8-902e-b3150eb9d760
0	65	65	Plazi	ffb07bec-2d10-492d-9c37-361fe0b79427	2eb23bc8-fdf6-422e-afde-a708a845592c
10257	10280	23	U.S. Geological Survey	8618c64a-93e0-4300-b546-7249e5148ed2	2f46fe6f-b9fd-4dba-8ca2-2cb1368ceed8
1	1	0	GBIF Brazil	cdc9736d-5ff7-4ece-9959-3c744360cdb3	2f62b658-b8eb-4d96-a580-3867f9107567
0	2	2	Plazi	ffb07bec-2d10-492d-9c37-361fe0b79427	30471991-67e4-495a-bd59-a7c936bc2e66
0	3	3	Plazi	ffb07bec-2d10-492d-9c37-361fe0b79427	314630f3-a4b6-46cd-aa5e-cfd3acf4817e
475	475	0	GBIF Norway	4f829580-180d-46a9-9c87-ed8ec959b545	339e9664-56f6-4174-a32e-c00ce3e5d60a
0	374	374	Ocean Biodiversity Information System	ba0670b9-4186-41e6-8e70-f9cb3065551a	3b5c599d-8887-44a1-851b-783272f392d0
16	16	0	Secretariat of the Pacific Regional Environment Programme	29c6a139-ea7f-41f5-8d9b-c55af8736182	3b828d90-762e-4f35-9c5f-bed070f98936
0	6	6	Plazi	ffb07bec-2d10-492d-9c37-361fe0b79427	3b98f62b-8461-4005-a418-51cf1e3b44f3
76	76	0	Plazi	ffb07bec-2d10-492d-9c37-361fe0b79427	40bf368d-78aa-4ac7-bc18-a23efd58bfc2
3711	3711	0	National Biodiversity Network	d897a5b9-35ee-4232-94bd-b0bcaac003c2	41c3ea59-4cba-4708-bb9d-2b5ad9a402e7
136	136	0	Colombian Biodiversity Information System	7e865cba-7c46-417b-ade5-97f2cf5b7be0	422d2a36-252e-4849-bf2e-cd69ca1a8f5d
0	1	1	Plazi	ffb07bec-2d10-492d-9c37-361fe0b79427	42d851f6-8e7d-483c-a33f-72ee69ee4f8e
87	87	0	GBIF Norway	4f829580-180d-46a9-9c87-ed8ec959b545	44ef1f04-b01c-4b42-8baa-679e26ce43bc
433	433	0	GBIF New Zealand	4f9fd726-20dd-445e-89a1-8ed93792276f	482d7907-bb01-4c89-b573-1d71f492b16d
0	15	15	Ocean Biodiversity Information System	ba0670b9-4186-41e6-8e70-f9cb3065551a	48373408-ebfd-4f13-8653-516aa6cac700
0	2	2	Plazi	ffb07bec-2d10-492d-9c37-361fe0b79427	48a5e204-fcd9-4d2b-ab85-b3cd77f813dd
1	1	0	Plazi	ffb07bec-2d10-492d-9c37-361fe0b79427	4c35318b-3b9c-40ea-8275-9fb4a6fd9112
111883	111883	0	Ocean Biodiversity Information System	ba0670b9-4186-41e6-8e70-f9cb3065551a	4dea7b5c-36ab-4c09-95d4-ea297d5c5850
1993	1993	0	Biodiversity Information System of Mexico	b324e8e9-9a4c-44fa-8f1a-7f39ea7ab576	4ff48dbe-fe29-47f5-bd8c-0e1b94905ee1
5	5	0	Plazi	ffb07bec-2d10-492d-9c37-361fe0b79427	524036ef-ebb0-4718-8a9b-1bb77b3c3709
1077	1077	0	GBIF Israel	8cb55387-7802-40e8-86d6-d357a583c596	52ff7a75-4354-464c-9765-eca68cf90859
0	1507	1507	Participant Node Managers Committee	7f48e0c8-5c96-49ec-b972-30748e339115	54641290-55dd-48d1-a1a7-25d6eee5d714
16	16	0	GBIF Sweden	a0b3be64-6525-4387-ac67-a499950f92e1	56c3136f-ecb2-404e-aab4-95e8f127920e
151	151	0	Colombian Biodiversity Information System	7e865cba-7c46-417b-ade5-97f2cf5b7be0	5783428b-f8fe-499b-9123-40cff957731b
1	1	0	Plazi	ffb07bec-2d10-492d-9c37-361fe0b79427	5783612d-b9d8-437b-9178-ae5caf8aed13
10	10	0	GBIF Germany	4f6826f2-4ff6-443d-b966-e6913bd24013	57e4cbff-dd5f-4b5d-9950-738cea98a37a
45	45	0	Plazi	ffb07bec-2d10-492d-9c37-361fe0b79427	59664c93-3249-42ea-a642-923c44a238b3
2	2	0	Plazi	ffb07bec-2d10-492d-9c37-361fe0b79427	5e685a24-07b3-4644-96a2-9042b8e4cd19
112	112	0	Plazi	ffb07bec-2d10-492d-9c37-361fe0b79427	5eadba67-d4ee-4eb8-8ec9-bdb75cab1d59
8	8	0	National Biodiversity Network	d897a5b9-35ee-4232-94bd-b0bcaac003c2	5ed324a9-0610-4164-9c09-675919ca976a
2	2	0	Plazi	ffb07bec-2d10-492d-9c37-361fe0b79427	633de642-cdd7-4948-88a8-c3949d374513
12	12	0	GBIF Germany	4f6826f2-4ff6-443d-b966-e6913bd24013	63494206-f762-11e1-a439-00145eb45e9a
20	20	0	Plazi	ffb07bec-2d10-492d-9c37-361fe0b79427	63581fbe-8a77-429f-91d1-54b2f5040a36
8109	8109	0	GBIF Brazil	cdc9736d-5ff7-4ece-9959-3c744360cdb3	64b6ffbc-d21c-4b91-9eef-8431c3d7b046
10	10	0	GBIF Germany	4f6826f2-4ff6-443d-b966-e6913bd24013	64edc384-f762-11e1-a439-00145eb45e9a
19	16	-3	GBIF Germany	4f6826f2-4ff6-443d-b966-e6913bd24013	65d4d8aa-f762-11e1-a439-00145eb45e9a
19	19	0	GBIF Germany	4f6826f2-4ff6-443d-b966-e6913bd24013	6667eea6-f762-11e1-a439-00145eb45e9a
131	131	0	GBIF Germany	4f6826f2-4ff6-443d-b966-e6913bd24013	679aa76e-f762-11e1-a439-00145eb45e9a
40775	34479	-6296	National Biodiversity Network	d897a5b9-35ee-4232-94bd-b0bcaac003c2	67c45ca3-0c6c-4da2-a1e8-621ef52bd559
53460	53460	0	GBIF Brazil	cdc9736d-5ff7-4ece-9959-3c744360cdb3	67f33aea-2c4b-475b-b243-91ca1b9dd29a
178	178	0	Biodiversity Information System of Mexico	b324e8e9-9a4c-44fa-8f1a-7f39ea7ab576	6855e383-3a18-4572-b9b3-f77b05aed076
37	37	0	Plazi	ffb07bec-2d10-492d-9c37-361fe0b79427	68aa6965-5a25-41ac-80ac-9a899e24bc94
19122	19122	0	National Biodiversity Network	d897a5b9-35ee-4232-94bd-b0bcaac003c2	6965a5f6-306a-494f-b7a4-c725f046931e
58	58	0	GBIF Germany	4f6826f2-4ff6-443d-b966-e6913bd24013	698ee440-f762-11e1-a439-00145eb45e9a
96	96	0	GBIF Germany	4f6826f2-4ff6-443d-b966-e6913bd24013	69b8a136-f762-11e1-a439-00145eb45e9a
2	2	0	GBIF Germany	4f6826f2-4ff6-443d-b966-e6913bd24013	6ad33626-f762-11e1-a439-00145eb45e9a
11	11	0	Plazi	ffb07bec-2d10-492d-9c37-361fe0b79427	6b65e801-aa4a-4da1-a63e-d882d8e81524
5786	6117	331	National Biodiversity Network	d897a5b9-35ee-4232-94bd-b0bcaac003c2	6be65214-1a60-4470-8752-9787bb31d3cf
40	40	0	GBIF Germany	4f6826f2-4ff6-443d-b966-e6913bd24013	6c9fca1e-f762-11e1-a439-00145eb45e9a
0	2997	2997	Ocean Biodiversity Information System	ba0670b9-4186-41e6-8e70-f9cb3065551a	6e906545-dc77-425c-ac0d-12287f6aaaf0
4607	4607	0	GBIF France	da44cd31-5901-4687-a106-6d1c7734ee3a	6fec5c9d-6589-4e3a-85ea-c5decaeb49d8
77	77	0	GBIF Germany	4f6826f2-4ff6-443d-b966-e6913bd24013	6ff27c70-f762-11e1-a439-00145eb45e9a
5266	5266	0	GBIF France	da44cd31-5901-4687-a106-6d1c7734ee3a	711ad0c8-5cd2-40be-b10b-c5c84e46d68d
0	20	20	Plazi	ffb07bec-2d10-492d-9c37-361fe0b79427	728940f5-4599-459e-84ad-97215e2ccf2f
7093	7093	0	GBIF France	da44cd31-5901-4687-a106-6d1c7734ee3a	7529822d-40eb-49f6-8137-65cb2f61701f
0	2	2	Plazi	ffb07bec-2d10-492d-9c37-361fe0b79427	752b1463-9089-4fd5-86a5-29b00d958d0b
0	27	27	Plazi	ffb07bec-2d10-492d-9c37-361fe0b79427	77661b3d-321c-46e7-9830-56ce49fbe33c
121	121	0	GBIF Germany	4f6826f2-4ff6-443d-b966-e6913bd24013	783a437c-f762-11e1-a439-00145eb45e9a
40	40	0	GBIF Germany	4f6826f2-4ff6-443d-b966-e6913bd24013	786835ca-f762-11e1-a439-00145eb45e9a
1	1	0	GBIF Germany	4f6826f2-4ff6-443d-b966-e6913bd24013	7891e65e-f762-11e1-a439-00145eb45e9a
69	69	0	GBIF France	da44cd31-5901-4687-a106-6d1c7734ee3a	78e9ddeb-50d2-4306-88e7-5be95faaf2cd
14	14	0	GBIF Germany	4f6826f2-4ff6-443d-b966-e6913bd24013	790d1504-f762-11e1-a439-00145eb45e9a
289	257	-32	GBIF Germany	4f6826f2-4ff6-443d-b966-e6913bd24013	79993b92-f762-11e1-a439-00145eb45e9a
27828	27828	0	GBIF Norway	4f829580-180d-46a9-9c87-ed8ec959b545	7b634023-7bd3-4d64-806a-90f5c0465750
1651	1651	0	GBIF Germany	4f6826f2-4ff6-443d-b966-e6913bd24013	7c425360-f762-11e1-a439-00145eb45e9a
177	177	0	GBIF Germany	4f6826f2-4ff6-443d-b966-e6913bd24013	7d26c5fe-f762-11e1-a439-00145eb45e9a
108186	108186	0	GBIF Portugal	673f7038-4262-4149-b753-5658a4e912f6	7d6b90d2-14c0-4ba6-9e45-449b56bab878
110	90	-20	GBIF Germany	4f6826f2-4ff6-443d-b966-e6913bd24013	7db33502-f762-11e1-a439-00145eb45e9a
432	432	0	GBIF Brazil	cdc9736d-5ff7-4ece-9959-3c744360cdb3	7e26044f-6fb1-47fb-b27c-cd9cd2ef392b
23	18	-5	GBIF Germany	4f6826f2-4ff6-443d-b966-e6913bd24013	7f3eec72-f762-11e1-a439-00145eb45e9a
3430	2548	-882	GBIF Germany	4f6826f2-4ff6-443d-b966-e6913bd24013	7f4655f2-f762-11e1-a439-00145eb45e9a
27	27	0	Plazi	ffb07bec-2d10-492d-9c37-361fe0b79427	80b456bf-37a7-46e1-b810-d5aa962fb2ee
1686	1686	0	Biodiversity Information System of Mexico	b324e8e9-9a4c-44fa-8f1a-7f39ea7ab576	80cc6506-f762-11e1-a439-00145eb45e9a
0	78	78	Colombian Biodiversity Information System	7e865cba-7c46-417b-ade5-97f2cf5b7be0	80de0182-1bce-439a-856a-b5aff2c6def5
187	187	0	GBIF Japan	db5705aa-6a6e-42f1-8942-d77b9f4896ea	80f03652-f762-11e1-a439-00145eb45e9a
44	44	0	Biodiversity Information System of Mexico	b324e8e9-9a4c-44fa-8f1a-7f39ea7ab576	8137cfd2-08a5-452e-b64a-80b9dffa9c26
244	244	0	GBIF Germany	4f6826f2-4ff6-443d-b966-e6913bd24013	81ab1184-f762-11e1-a439-00145eb45e9a
945	945	0	GBIF Germany	4f6826f2-4ff6-443d-b966-e6913bd24013	8204c9c2-f762-11e1-a439-00145eb45e9a
16168	16168	0	GBIF France	da44cd31-5901-4687-a106-6d1c7734ee3a	82239c10-7292-414d-8ce9-37e2b6f96a01
321	321	0	Canada Biodiversity Information Facility	8f83fc96-c966-4126-83f7-bf044dc49efa	8454dd02-f762-11e1-a439-00145eb45e9a
0	3720	3720	Belgian Biodiversity Platform	fb11cfe1-ebc3-45af-9159-17d9fddbcdac	8525b92f-0839-472d-bb55-2e72a08b57f0
3	3	0	Plazi	ffb07bec-2d10-492d-9c37-361fe0b79427	86770077-6608-4807-8732-6545d170af09
137496	137495	-1	National Biodiversity Network	d897a5b9-35ee-4232-94bd-b0bcaac003c2	86ade71a-3894-4f17-bcde-f5894bc5e0f7
0	5	5	Plazi	ffb07bec-2d10-492d-9c37-361fe0b79427	871ea7e5-8005-4c5b-9af9-a247a638aa74
6309	5552	-757	GBIF Germany	4f6826f2-4ff6-443d-b966-e6913bd24013	8729e932-f762-11e1-a439-00145eb45e9a
21	16	-5	GBIF Germany	4f6826f2-4ff6-443d-b966-e6913bd24013	8759a212-f762-11e1-a439-00145eb45e9a
7971	7971	0	U.S. Geological Survey	8618c64a-93e0-4300-b546-7249e5148ed2	87dbda50-7d25-47e9-a7df-e4d4951fe9e6
566	469	-97	GBIF Germany	4f6826f2-4ff6-443d-b966-e6913bd24013	87f4dd72-f762-11e1-a439-00145eb45e9a
13	13	0	Plazi	ffb07bec-2d10-492d-9c37-361fe0b79427	8831760e-e2f2-45b0-976c-890a32c360c1
330	288	-42	GBIF Germany	4f6826f2-4ff6-443d-b966-e6913bd24013	885aa63e-f762-11e1-a439-00145eb45e9a
255	184	-71	GBIF Germany	4f6826f2-4ff6-443d-b966-e6913bd24013	8c5cb54c-f762-11e1-a439-00145eb45e9a
3653	3653	0	Taiwan Biodiversity Information Facility	e1b85abc-61f9-430f-ba79-6813dec53a0f	8c7571ee-8515-4b68-afc0-6f20da6a8a68
72	72	0	GBIF Germany	4f6826f2-4ff6-443d-b966-e6913bd24013	8ca0091e-f762-11e1-a439-00145eb45e9a
359	196	-163	GBIF Germany	4f6826f2-4ff6-443d-b966-e6913bd24013	8de57e94-f762-11e1-a439-00145eb45e9a
188	188	0	GBIF Germany	4f6826f2-4ff6-443d-b966-e6913bd24013	8e259e3e-f762-11e1-a439-00145eb45e9a
24	11	-13	GBIF Germany	4f6826f2-4ff6-443d-b966-e6913bd24013	8e40c074-f762-11e1-a439-00145eb45e9a
58	37	-21	GBIF Germany	4f6826f2-4ff6-443d-b966-e6913bd24013	8e5e7f9c-f762-11e1-a439-00145eb45e9a
1354	1023	-331	GBIF Germany	4f6826f2-4ff6-443d-b966-e6913bd24013	8e9eda10-f762-11e1-a439-00145eb45e9a
6	6	0	Participant Node Managers Committee	7f48e0c8-5c96-49ec-b972-30748e339115	8fafef67-c923-435d-b74f-b5c4d5b4d7d5
10	10	0	GBIF Brazil	cdc9736d-5ff7-4ece-9959-3c744360cdb3	8ffcac7e-5a31-4e4e-bd30-c34e368cd814
36	25	-11	GBIF Germany	4f6826f2-4ff6-443d-b966-e6913bd24013	902d9646-f762-11e1-a439-00145eb45e9a
5	2	-3	GBIF Germany	4f6826f2-4ff6-443d-b966-e6913bd24013	90ebb4aa-f762-11e1-a439-00145eb45e9a
354	331	-23	GBIF Germany	4f6826f2-4ff6-443d-b966-e6913bd24013	916f8f0a-f762-11e1-a439-00145eb45e9a
34	34	0	GBIF Brazil	cdc9736d-5ff7-4ece-9959-3c744360cdb3	920bac74-0b95-49da-9e0a-98bc47c68120
3	3	0	GBIF Germany	4f6826f2-4ff6-443d-b966-e6913bd24013	9229c424-f762-11e1-a439-00145eb45e9a
18	12	-6	GBIF Germany	4f6826f2-4ff6-443d-b966-e6913bd24013	92aaf22e-f762-11e1-a439-00145eb45e9a
5	5	0	Plazi	ffb07bec-2d10-492d-9c37-361fe0b79427	92f14d8c-845d-4410-95e6-ef458099f30f
8	8	0	GBIF Germany	4f6826f2-4ff6-443d-b966-e6913bd24013	93756bd0-f762-11e1-a439-00145eb45e9a
2253	2253	0	National Biodiversity Network	d897a5b9-35ee-4232-94bd-b0bcaac003c2	94b50745-fc4d-4dec-8422-9f4fda5b74b6
318	320	2	GBIF Germany	4f6826f2-4ff6-443d-b966-e6913bd24013	95634b56-f762-11e1-a439-00145eb45e9a
146	146	0	GBIF Germany	4f6826f2-4ff6-443d-b966-e6913bd24013	95690b9a-f762-11e1-a439-00145eb45e9a
35489	35489	0	Biodiversity Information System of Mexico	b324e8e9-9a4c-44fa-8f1a-7f39ea7ab576	9606752e-f762-11e1-a439-00145eb45e9a
2820	2820	0	Biodiversity Information System of Mexico	b324e8e9-9a4c-44fa-8f1a-7f39ea7ab576	969fde9a-7775-4373-8f96-f0e08a70c2d7
186	186	0	GBIF France	da44cd31-5901-4687-a106-6d1c7734ee3a	96fd3f4f-47d4-4124-bf90-cf5070e4b2fd
19918	21262	1344	GBIF Japan	db5705aa-6a6e-42f1-8942-d77b9f4896ea	9939bf2a-5645-4b63-8430-55d55b138228
6	6	0	Plazi	ffb07bec-2d10-492d-9c37-361fe0b79427	9968fc99-c76b-4df9-8244-b557df75a176
68	68	0	GBIF France	da44cd31-5901-4687-a106-6d1c7734ee3a	9a8c42ab-d713-43d3-90a2-ccef866ec8c4
210	210	0	National Biodiversity Network	d897a5b9-35ee-4232-94bd-b0bcaac003c2	9d481c56-ad91-43b1-8726-3e677009746d
0	9	9	Plazi	ffb07bec-2d10-492d-9c37-361fe0b79427	9e258a3c-4a97-4cc4-9c73-bfe4f49394fa
15397	15397	0	GBIF New Zealand	4f9fd726-20dd-445e-89a1-8ed93792276f	9ef059d7-5721-4ffd-a758-ef7a63221905
389	389	0	U.S. Geological Survey	8618c64a-93e0-4300-b546-7249e5148ed2	a28eb0fc-73f3-471e-b927-cc58f576c9e0
6528	6528	0	U.S. Geological Survey	8618c64a-93e0-4300-b546-7249e5148ed2	a4899898-3fb7-4474-85bf-be8975e6ba12
4	4	0	Plazi	ffb07bec-2d10-492d-9c37-361fe0b79427	a5ea67b7-8448-42cf-84fe-76bd16766e7b
343	343	0	GBIF France	da44cd31-5901-4687-a106-6d1c7734ee3a	a6791bf7-0698-45ed-a2a0-a80ad878c068
0	65	65	Colombian Biodiversity Information System	7e865cba-7c46-417b-ade5-97f2cf5b7be0	aa8ef71e-e7a8-4190-b0ff-0eac7e1f55dd
50	50	0	Plazi	ffb07bec-2d10-492d-9c37-361fe0b79427	ae31895b-8dc2-408c-9611-268c6666b7ef
0	3	3	Colombian Biodiversity Information System	7e865cba-7c46-417b-ade5-97f2cf5b7be0	b0a404cc-649b-4f75-8904-05a610929300
89	89	0	Plazi	ffb07bec-2d10-492d-9c37-361fe0b79427	b0a4b75c-af55-4a21-83ff-00782b900cbf
1933	1933	0	Colombian Biodiversity Information System	7e865cba-7c46-417b-ade5-97f2cf5b7be0	b26543dd-d573-480b-b8b0-7f116ef52886
101	101	0	Plazi	ffb07bec-2d10-492d-9c37-361fe0b79427	b52189b5-2b57-474a-86b6-40580b016ecc
374	374	0	GBIF Togo	c9659a3e-07e9-4fcb-83c6-de8b9009a02e	b971493e-dfe2-4945-b9e0-f41ebd6060b2
14	14	0	Plazi	ffb07bec-2d10-492d-9c37-361fe0b79427	ba01376a-155c-43fb-9dc7-d3edae627529
1003	1003	0	Participant Node Managers Committee	7f48e0c8-5c96-49ec-b972-30748e339115	bbd1eb9c-0d6b-45ee-b36a-d94c91abeaef
1069	1069	0	GBIF Germany	4f6826f2-4ff6-443d-b966-e6913bd24013	bc7c19ec-eefd-403b-931a-16a2ea1e71fc
4034	4034	0	Korean Biodiversity Information Facility	e0a1e772-0177-4800-94b4-2d023fe6cdf4	bd322f9d-6cf9-45fd-bee5-9d4315a5d411
17	17	0	Plazi	ffb07bec-2d10-492d-9c37-361fe0b79427	c1fde0e4-3c09-42e5-9b65-8c1d45eda327
3	3	0	Plazi	ffb07bec-2d10-492d-9c37-361fe0b79427	c63399d8-be07-4238-a09e-4fa6ca900445
362	362	0	Plazi	ffb07bec-2d10-492d-9c37-361fe0b79427	c72b2bd7-b6c4-4cb6-ab36-8c0604a85af1
467	467	0	GBIF France	da44cd31-5901-4687-a106-6d1c7734ee3a	c7525c7a-0815-4510-b0db-4150d271cda0
126	126	0	Plazi	ffb07bec-2d10-492d-9c37-361fe0b79427	c79b6327-48fb-47bf-b17b-d20d2de295e3
127874	170809	42935	National Biodiversity Network	d897a5b9-35ee-4232-94bd-b0bcaac003c2	c8ab6260-a5b3-4605-a810-130bc08cf7ea
13	13	0	Plazi	ffb07bec-2d10-492d-9c37-361fe0b79427	c9526b08-4863-471f-bac1-a18527986c22
0	43	43	Plazi	ffb07bec-2d10-492d-9c37-361fe0b79427	cdaae013-f381-41ad-ba16-dffcd889fe4c
279463	279463	0	U.S. Geological Survey	8618c64a-93e0-4300-b546-7249e5148ed2	ce696ea3-4862-4649-a0a7-02fb416bcbab
45	45	0	Plazi	ffb07bec-2d10-492d-9c37-361fe0b79427	cf85a8b3-d8f5-4a29-9a2f-8cfecd370736
69	69	0	Indonesian Biodiversity Information Facility	2ebd91f6-f14f-4375-b525-c011a3774f03	d0122ed5-6ed8-430e-86ee-b4d45a6bc2bb
1	1	0	Plazi	ffb07bec-2d10-492d-9c37-361fe0b79427	d139b940-75c8-4de9-9881-68ae4c1315a9
0	2028	2028	Netherlands Biodiversity Information Facility	0909d601-bda2-42df-9e63-a6d51847ebce	d52b3c92-6103-4297-93e5-705e9054df89
700	700	0	Biodiversity Information System of Mexico	b324e8e9-9a4c-44fa-8f1a-7f39ea7ab576	d59ae05c-bf84-44aa-9753-d4acf40a9bb1
55	55	0	GBIF France	da44cd31-5901-4687-a106-6d1c7734ee3a	d7f4c94f-5aaf-4770-8fa4-498042a8db57
521	406	-115	GBIF Germany	4f6826f2-4ff6-443d-b966-e6913bd24013	d8726c08-deaa-47c7-bb57-17aad22af781
15891	15891	0	National Biodiversity Network	d897a5b9-35ee-4232-94bd-b0bcaac003c2	da721ba0-b47b-4951-90f8-c95f99026ce9
4	4	0	Plazi	ffb07bec-2d10-492d-9c37-361fe0b79427	e1f8ac3d-f514-45e2-8d70-7ffa3430741f
47	47	0	Plazi	ffb07bec-2d10-492d-9c37-361fe0b79427	e3885b72-41b7-4aed-996f-4ad59ae7023d
20	20	0	Plazi	ffb07bec-2d10-492d-9c37-361fe0b79427	e39ad3a0-81d2-4863-9122-f70e43b933cf
302198	321720	19522	Atlas of Living Australia	4a6f1b71-969e-4fc5-a693-282b05e1220c	e3ce628e-9683-4af7-b7a9-47eef785d3bb
6104	8621	2517	GBIF France	da44cd31-5901-4687-a106-6d1c7734ee3a	e4526ee9-1592-4764-8af1-c89621255f82
69	69	0	National Biodiversity Network	d897a5b9-35ee-4232-94bd-b0bcaac003c2	e4db1af9-1e53-4762-a6e8-5a9a3d1a5a2e
0	18	18	Plazi	ffb07bec-2d10-492d-9c37-361fe0b79427	e874c6d1-463e-48b3-8d44-2c45ef752a2b
1550	1550	0	Ocean Biodiversity Information System	ba0670b9-4186-41e6-8e70-f9cb3065551a	e8d1d94b-30b0-4278-aaa4-de9f78723dac
34	34	0	Colombian Biodiversity Information System	7e865cba-7c46-417b-ade5-97f2cf5b7be0	e8f5bcd0-0b6c-480a-b4da-b98c468b4c8b
566	566	0	Atlas of Living Australia	4a6f1b71-969e-4fc5-a693-282b05e1220c	ea00f908-0fa5-469a-b9d3-5eb76136d998
0	2	2	Plazi	ffb07bec-2d10-492d-9c37-361fe0b79427	ed5b6879-02fd-45b6-95c8-cce6f2c29bb9
3	3	0	Plazi	ffb07bec-2d10-492d-9c37-361fe0b79427	ee2beac9-7989-45c1-8c03-88c3c1087cb9
1351	1351	0	GBIF France	da44cd31-5901-4687-a106-6d1c7734ee3a	f13aaa9c-fa41-4659-903b-5869ee294a77
0	5	5	Plazi	ffb07bec-2d10-492d-9c37-361fe0b79427	f1ac74c9-df4b-4402-a43b-e06abb6e8164
0	2637	2637	Participant Node Managers Committee	7f48e0c8-5c96-49ec-b972-30748e339115	f2a23487-a3de-4f7a-a360-a72a815497ff
2	2	0	Plazi	ffb07bec-2d10-492d-9c37-361fe0b79427	f6d1665b-64c0-4e56-b8c8-e9868dade769
0	2	2	Plazi	ffb07bec-2d10-492d-9c37-361fe0b79427	f8afcfeb-4003-4a77-909c-8779e7d2b5f8
0	25	25	Plazi	ffb07bec-2d10-492d-9c37-361fe0b79427	f8c28430-0d81-44c7-a52f-e233420fd824
25	25	0	Plazi	ffb07bec-2d10-492d-9c37-361fe0b79427	f8fcdbf0-801e-4a75-865b-f09046be1d53
0	225	225	Plazi	ffb07bec-2d10-492d-9c37-361fe0b79427	f9dde51c-a2b9-4f3e-abe5-a7a3d7b0002d
55	55	0	Plazi	ffb07bec-2d10-492d-9c37-361fe0b79427	fb772898-fe24-438e-9a4a-1a98c5b393a8
2	2	0	Plazi	ffb07bec-2d10-492d-9c37-361fe0b79427	fd8230ac-6245-4daf-b9d0-02c3d16a403c
1145	1145	0	Biodiversity Information System of Mexico	b324e8e9-9a4c-44fa-8f1a-7f39ea7ab576	fe36fbfa-282a-42ea-abb2-e9995dfa7337
1	1	0	Plazi	ffb07bec-2d10-492d-9c37-361fe0b79427	fe5a480c-ce09-4f69-805a-1797c7a9de7b
64	64	0	GBIF France	da44cd31-5901-4687-a106-6d1c7734ee3a	ffc1c01b-a61b-4d12-ab14-c466ba152d2b
184	184	0	Colombian Biodiversity Information System	7e865cba-7c46-417b-ade5-97f2cf5b7be0	03157f76-382e-432b-bc2a-6163ed82fa99
801	801	0	Participant Node Managers Committee	7f48e0c8-5c96-49ec-b972-30748e339115	06ff6625-79cd-4030-bf12-3b251e93d1bf
0	47	47	Plazi	ffb07bec-2d10-492d-9c37-361fe0b79427	096da033-b9e6-44f4-bb12-ed313d39dd9a
19	19	0	Colombian Biodiversity Information System	7e865cba-7c46-417b-ade5-97f2cf5b7be0	098aa863-335e-42a7-b099-51942aa6adc1
1	1	0	Plazi	ffb07bec-2d10-492d-9c37-361fe0b79427	0a404c7a-1ac5-4c15-83ef-31abe17c4c14
3748	3748	0	National Biodiversity Network	d897a5b9-35ee-4232-94bd-b0bcaac003c2	0f38f73a-55b7-4409-9af2-bffcc1be8523
0	64	64	Ocean Biodiversity Information System	ba0670b9-4186-41e6-8e70-f9cb3065551a	1060d295-dd60-4b13-bd04-891a109d7c8e
5	5	0	Plazi	ffb07bec-2d10-492d-9c37-361fe0b79427	111de084-61dd-4380-afd3-fdc60bf2e389
199278	199278	0	GBIF Sweden	a0b3be64-6525-4387-ac67-a499950f92e1	15b04450-0c60-11dd-84cd-b8a03c50a862
2085	2085	0	Ghana Biodiversity Information Facility	b5633b75-6a86-4fdf-9cfc-506047fb9dc7	16548b76-21d8-40d7-9ee4-d55d755ebbe0
24	24	0	Colombian Biodiversity Information System	7e865cba-7c46-417b-ade5-97f2cf5b7be0	17a867d8-85e6-4333-a29f-8c50e7687ef2
3	3	0	Ocean Biodiversity Information System	ba0670b9-4186-41e6-8e70-f9cb3065551a	17b214d1-f2ff-43ae-a731-4e52bae687fe
29	29	0	GBIF Germany	4f6826f2-4ff6-443d-b966-e6913bd24013	18860448-d749-4129-925e-4631141df79f
0	3	3	Plazi	ffb07bec-2d10-492d-9c37-361fe0b79427	18b68489-7260-4697-942e-f4034183fe70
13	13	0	Plazi	ffb07bec-2d10-492d-9c37-361fe0b79427	1b92ac05-3931-4afa-959e-a52158aafd23
8	8	0	Plazi	ffb07bec-2d10-492d-9c37-361fe0b79427	1c4e2dfe-e755-4103-b920-08370f8f8183
1008	982	-26	GBIF Brazil	cdc9736d-5ff7-4ece-9959-3c744360cdb3	1dfcc7e0-e347-4225-bda1-c48fd8c68a39
28	28	0	Plazi	ffb07bec-2d10-492d-9c37-361fe0b79427	1eb4fa94-4412-4c82-b784-7a2412accc92
36	36	0	Plazi	ffb07bec-2d10-492d-9c37-361fe0b79427	1f01f2d3-43e2-489e-ad31-eef4c71f7da0
0	5	5	Plazi	ffb07bec-2d10-492d-9c37-361fe0b79427	1fb453eb-5827-4a34-90af-297c4a8faae1
0	27702	27702	Ocean Biodiversity Information System	ba0670b9-4186-41e6-8e70-f9cb3065551a	2144434e-9e31-4558-8616-a2a301d02dc8
38	38	0	Plazi	ffb07bec-2d10-492d-9c37-361fe0b79427	2565fffa-2704-4101-8fdf-2b863ef19be5
5	5	0	Plazi	ffb07bec-2d10-492d-9c37-361fe0b79427	25687291-e78a-4f75-8422-b4d1bd04a3fc
146651	319238	172587	GBIF France	da44cd31-5901-4687-a106-6d1c7734ee3a	25e3e8f1-86ee-440c-adfc-8e63759a6505
10	10	0	Participant Node Managers Committee	7f48e0c8-5c96-49ec-b972-30748e339115	27957fd4-1293-4907-be38-8578baca8368
0	2310	2310	Colombian Biodiversity Information System	7e865cba-7c46-417b-ade5-97f2cf5b7be0	27a836ef-08eb-4006-90a4-9accaf174995
9000	9000	0	Biodiversity Information System of Mexico	b324e8e9-9a4c-44fa-8f1a-7f39ea7ab576	2daac733-54d3-41b9-8f4d-f2fd45a68441
0	5	5	Plazi	ffb07bec-2d10-492d-9c37-361fe0b79427	2fc06b8c-bcd1-4d48-9e2a-cffaa5ba5a1d
4	4	0	Plazi	ffb07bec-2d10-492d-9c37-361fe0b79427	2fc3858a-c84a-4b54-9430-df27641a5916
274	274	0	Plazi	ffb07bec-2d10-492d-9c37-361fe0b79427	30d459c8-2b2f-4cdf-8637-460394de28ec
770	770	0	Ocean Biodiversity Information System	ba0670b9-4186-41e6-8e70-f9cb3065551a	324221f2-eb92-419b-88d5-a44e85c9898c
19	19	0	Plazi	ffb07bec-2d10-492d-9c37-361fe0b79427	39cc6284-8ad7-47f0-bf5d-2122174905ed
2141	1633	-508	GBIF Germany	4f6826f2-4ff6-443d-b966-e6913bd24013	3a68981d-33da-433e-9d0d-f7e7837e5767
1822	1822	0	GBIF Germany	4f6826f2-4ff6-443d-b966-e6913bd24013	3a6c8f26-3987-42d0-899f-d1b6699b41b6
1	1	0	GBIF France	da44cd31-5901-4687-a106-6d1c7734ee3a	3abb30ea-21e8-4baf-8e68-bfe99fc9fe88
410	410	0	GBIF France	da44cd31-5901-4687-a106-6d1c7734ee3a	3c9dfc49-713a-4235-ab0a-947b6840fd4d
0	124	124	Colombian Biodiversity Information System	7e865cba-7c46-417b-ade5-97f2cf5b7be0	3e514fac-47c9-4d31-b70f-9e2a72eea81a
8	8	0	Plazi	ffb07bec-2d10-492d-9c37-361fe0b79427	4130aefb-708a-4309-8cbe-ebc4d7cd9cdd
0	407	407	Plazi	ffb07bec-2d10-492d-9c37-361fe0b79427	41b8f51f-1d31-44c0-851e-2697e4e9497f
960	960	0	GBIF Chile	a8b16421-d80b-4ef3-8f22-098b01a89255	4471bab5-1fd0-459d-9815-e1813b249e4f
1302	1302	0	Participant Node Managers Committee	7f48e0c8-5c96-49ec-b972-30748e339115	4760677b-e7fe-4896-a53a-0c426707b178
0	1	1	Plazi	ffb07bec-2d10-492d-9c37-361fe0b79427	47b16375-a4b6-4faa-a92e-bcf3ba4ee889
17	17	0	GBIF France	da44cd31-5901-4687-a106-6d1c7734ee3a	48fa3a27-fe0d-4a95-91ac-3049bb963f97
4	4	0	GBIF France	da44cd31-5901-4687-a106-6d1c7734ee3a	4a7665f7-3b0b-463e-9075-f7d661f5f28a
151	151	0	GBIF Portugal	673f7038-4262-4149-b753-5658a4e912f6	4b448fd9-8257-4e9f-bdeb-ff194c4981ff
75	75	0	GBIF France	da44cd31-5901-4687-a106-6d1c7734ee3a	4bfce808-0808-4778-ac6e-fc9f9b9de300
317	317	0	GBIF France	da44cd31-5901-4687-a106-6d1c7734ee3a	4c6575de-cac0-4bce-a71f-e7f73984717a
78	78	0	GBIF France	da44cd31-5901-4687-a106-6d1c7734ee3a	4cc17b10-85ce-4a88-933d-5743b7f576e1
3	3	0	Plazi	ffb07bec-2d10-492d-9c37-361fe0b79427	4db87df5-5c6e-4849-a36e-db51e177d455
16	16	0	Plazi	ffb07bec-2d10-492d-9c37-361fe0b79427	4fad42ec-a757-4768-9175-5974d144856f
637	637	0	GBIF France	da44cd31-5901-4687-a106-6d1c7734ee3a	50b60046-f76b-4f06-b60e-b0ffae046966
12	12	0	Plazi	ffb07bec-2d10-492d-9c37-361fe0b79427	535730bd-075d-4c51-8cfe-c65af9241742
0	65	65	Plazi	ffb07bec-2d10-492d-9c37-361fe0b79427	538ef1f4-9120-4ba3-a238-15bfa19cb4d9
0	16	16	Plazi	ffb07bec-2d10-492d-9c37-361fe0b79427	5555ed0d-e35c-40fe-8752-208b91837b07
171	171	0	Polish Biodiversity Information Network	2618bfdf-e194-4911-a241-80db3107bc51	56fd9b80-2fe9-11de-816f-b8a03c50a862
3	3	0	Plazi	ffb07bec-2d10-492d-9c37-361fe0b79427	57639aad-66a2-4235-8d6f-86db8f713b38
0	1183	1183	U.S. Geological Survey	8618c64a-93e0-4300-b546-7249e5148ed2	58dfb99f-44d0-4cfb-a08b-8b62cfcf91de
95	95	0	GBIF France	da44cd31-5901-4687-a106-6d1c7734ee3a	5b77cf59-8657-45ec-9b35-6cabcba1f56c
0	193	193	Plazi	ffb07bec-2d10-492d-9c37-361fe0b79427	5f6625c4-e7d2-4ad9-bbfd-489dbb6e60d2
12650	12650	0	GBIF Benin	efb9c00e-f802-45dd-8826-a52ec45b89ff	5fd8c534-856c-4b7a-9e3b-455ea15dc27d
169	169	0	GBIF Germany	4f6826f2-4ff6-443d-b966-e6913bd24013	625ff09c-f762-11e1-a439-00145eb45e9a
49	49	0	GBIF Germany	4f6826f2-4ff6-443d-b966-e6913bd24013	62a8bfac-f762-11e1-a439-00145eb45e9a
65	65	0	GBIF Germany	4f6826f2-4ff6-443d-b966-e6913bd24013	63a78f50-f762-11e1-a439-00145eb45e9a
74	74	0	GBIF Germany	4f6826f2-4ff6-443d-b966-e6913bd24013	64dadf58-f762-11e1-a439-00145eb45e9a
169	169	0	GBIF Germany	4f6826f2-4ff6-443d-b966-e6913bd24013	6622ba3e-f762-11e1-a439-00145eb45e9a
49	49	0	GBIF Germany	4f6826f2-4ff6-443d-b966-e6913bd24013	672003c4-f762-11e1-a439-00145eb45e9a
142	142	0	GBIF Germany	4f6826f2-4ff6-443d-b966-e6913bd24013	6762b3ea-f762-11e1-a439-00145eb45e9a
173044	191337	18293	National Biodiversity Network	d897a5b9-35ee-4232-94bd-b0bcaac003c2	67e2335c-4303-4ee3-9bfe-ecfe65662629
282	184	-98	GBIF Germany	4f6826f2-4ff6-443d-b966-e6913bd24013	68cea61c-f762-11e1-a439-00145eb45e9a
117	79	-38	GBIF Germany	4f6826f2-4ff6-443d-b966-e6913bd24013	69eb0644-f762-11e1-a439-00145eb45e9a
2241	2241	0	National Biodiversity Network	d897a5b9-35ee-4232-94bd-b0bcaac003c2	69f2035c-cec2-45b2-a691-06e914751664
29	29	0	Plazi	ffb07bec-2d10-492d-9c37-361fe0b79427	6a380d2f-38fe-4920-87ca-c45365c91220
31	31	0	Plazi	ffb07bec-2d10-492d-9c37-361fe0b79427	6b090571-aa68-41fc-b802-c650c6c2cb69
6	6	0	GBIF Germany	4f6826f2-4ff6-443d-b966-e6913bd24013	6b486b94-f762-11e1-a439-00145eb45e9a
14	14	0	GBIF Germany	4f6826f2-4ff6-443d-b966-e6913bd24013	6bd074ee-f762-11e1-a439-00145eb45e9a
8	8	0	GBIF Germany	4f6826f2-4ff6-443d-b966-e6913bd24013	6bfd74a8-f762-11e1-a439-00145eb45e9a
0	4	4	Plazi	ffb07bec-2d10-492d-9c37-361fe0b79427	704d014b-82d8-426d-8460-9f9ec81175f0
2041	2041	0	GBIF Germany	4f6826f2-4ff6-443d-b966-e6913bd24013	705b234c-f762-11e1-a439-00145eb45e9a
1357	1360	3	GBIF Germany	4f6826f2-4ff6-443d-b966-e6913bd24013	70b45cf0-f762-11e1-a439-00145eb45e9a
1	1	0	Plazi	ffb07bec-2d10-492d-9c37-361fe0b79427	70c7187e-acbb-483a-972a-c79ec0a1c10d
196	196	0	GBIF Germany	4f6826f2-4ff6-443d-b966-e6913bd24013	72dff980-f762-11e1-a439-00145eb45e9a
0	176	176	Plazi	ffb07bec-2d10-492d-9c37-361fe0b79427	7336298c-86ce-40e7-bab5-e75b0eddfdaa
96	96	0	GBIF Germany	4f6826f2-4ff6-443d-b966-e6913bd24013	742112d4-f762-11e1-a439-00145eb45e9a
432	432	0	GBIF Germany	4f6826f2-4ff6-443d-b966-e6913bd24013	7492b2e0-f762-11e1-a439-00145eb45e9a
4	3	-1	GBIF Germany	4f6826f2-4ff6-443d-b966-e6913bd24013	7585b968-f762-11e1-a439-00145eb45e9a
99	99	0	GBIF France	da44cd31-5901-4687-a106-6d1c7734ee3a	7700b68e-c599-4c96-b7fc-92d6280211cc
54	54	0	Plazi	ffb07bec-2d10-492d-9c37-361fe0b79427	7ad954d2-0a0d-4ad5-934c-62d5437e6c32
0	745	745	Participant Node Managers Committee	7f48e0c8-5c96-49ec-b972-30748e339115	7b1d5f66-b82f-4225-aa27-1245d65f6853
1	1	0	Plazi	ffb07bec-2d10-492d-9c37-361fe0b79427	7b2cc9fc-fca2-4360-9ffa-f58dd62c614e
0	107	107	GBIF France	da44cd31-5901-4687-a106-6d1c7734ee3a	7b43ea63-fcbd-4adf-aaf2-ac1b9d013739
2	2	0	Plazi	ffb07bec-2d10-492d-9c37-361fe0b79427	7ce28a72-7e1d-4649-b27b-fc770c572977
287	287	0	GBIF Germany	4f6826f2-4ff6-443d-b966-e6913bd24013	7dbebb3e-f762-11e1-a439-00145eb45e9a
418	418	0	Participant Node Managers Committee	7f48e0c8-5c96-49ec-b972-30748e339115	7efe1a63-93df-4638-a44e-b503c99e1595
2074	2074	0	Biodiversity Information System of Mexico	b324e8e9-9a4c-44fa-8f1a-7f39ea7ab576	7fcf5474-f762-11e1-a439-00145eb45e9a
3	3	0	Participant Node Managers Committee	7f48e0c8-5c96-49ec-b972-30748e339115	80365675-8ac8-4f77-8969-f5cddc6a7400
7558	7520	-38	GBIF Japan	db5705aa-6a6e-42f1-8942-d77b9f4896ea	81264d96-f762-11e1-a439-00145eb45e9a
3	3	0	Plazi	ffb07bec-2d10-492d-9c37-361fe0b79427	81de09ac-14dd-4144-bf37-e6281c1255bb
0	4	4	Plazi	ffb07bec-2d10-492d-9c37-361fe0b79427	81e52fca-0a62-45ca-a550-f236c969b7d9
330	250	-80	GBIF Germany	4f6826f2-4ff6-443d-b966-e6913bd24013	82388186-f762-11e1-a439-00145eb45e9a
598	598	0	World Federation for Culture Collections	a6bdc523-5368-4e0f-9d2e-de1c262ac092	85586d4a-f762-11e1-a439-00145eb45e9a
0	1	1	Plazi	ffb07bec-2d10-492d-9c37-361fe0b79427	8560f6cd-5727-4914-9620-7569e7e6269b
576	576	0	World Federation for Culture Collections	a6bdc523-5368-4e0f-9d2e-de1c262ac092	8562897e-f762-11e1-a439-00145eb45e9a
0	11	11	Plazi	ffb07bec-2d10-492d-9c37-361fe0b79427	865412bd-5bbe-4d20-9f94-19a8e92f5d80
439	330	-109	GBIF Germany	4f6826f2-4ff6-443d-b966-e6913bd24013	8701b296-f762-11e1-a439-00145eb45e9a
163	79	-84	GBIF Germany	4f6826f2-4ff6-443d-b966-e6913bd24013	8735cd9c-f762-11e1-a439-00145eb45e9a
308	308	0	GBIF Germany	4f6826f2-4ff6-443d-b966-e6913bd24013	874aebd2-f762-11e1-a439-00145eb45e9a
196	196	0	GBIF Germany	4f6826f2-4ff6-443d-b966-e6913bd24013	88502970-f762-11e1-a439-00145eb45e9a
93	93	0	GBIF Germany	4f6826f2-4ff6-443d-b966-e6913bd24013	8b9fdd00-f762-11e1-a439-00145eb45e9a
4	4	0	GBIF Germany	4f6826f2-4ff6-443d-b966-e6913bd24013	8ba87e7e-f762-11e1-a439-00145eb45e9a
18	18	0	GBIF Germany	4f6826f2-4ff6-443d-b966-e6913bd24013	8bbef352-f762-11e1-a439-00145eb45e9a
44	44	0	GBIF Germany	4f6826f2-4ff6-443d-b966-e6913bd24013	8bc3efce-f762-11e1-a439-00145eb45e9a
338	338	0	National Biodiversity Network	d897a5b9-35ee-4232-94bd-b0bcaac003c2	8c1b1f56-0b95-4609-8762-5642c537ac4c
54	54	0	Plazi	ffb07bec-2d10-492d-9c37-361fe0b79427	8da8c5fa-e4e8-494b-a62c-73b67071652b
360	360	0	GBIF Germany	4f6826f2-4ff6-443d-b966-e6913bd24013	8ef5de82-f762-11e1-a439-00145eb45e9a
0	8	8	Plazi	ffb07bec-2d10-492d-9c37-361fe0b79427	8fc4105a-f180-43f5-9141-7964662ef189
176	150	-26	GBIF Germany	4f6826f2-4ff6-443d-b966-e6913bd24013	8fda175a-f762-11e1-a439-00145eb45e9a
410	221	-189	GBIF Germany	4f6826f2-4ff6-443d-b966-e6913bd24013	9076f3b8-f762-11e1-a439-00145eb45e9a
15	15	0	Plazi	ffb07bec-2d10-492d-9c37-361fe0b79427	9122cae7-3158-4800-8748-623fcfe5a680
10551	10551	0	GBIF France	da44cd31-5901-4687-a106-6d1c7734ee3a	913fdc05-687e-4e46-953f-150a7594f340
7	7	0	GBIF Germany	4f6826f2-4ff6-443d-b966-e6913bd24013	92d08b2e-f762-11e1-a439-00145eb45e9a
360	356	-4	GBIF Germany	4f6826f2-4ff6-443d-b966-e6913bd24013	92fe8218-f762-11e1-a439-00145eb45e9a
682	705	23	GBIF Germany	4f6826f2-4ff6-443d-b966-e6913bd24013	9332235c-f762-11e1-a439-00145eb45e9a
51	51	0	GBIF Germany	4f6826f2-4ff6-443d-b966-e6913bd24013	9556d4b6-f762-11e1-a439-00145eb45e9a
10	9	-1	GBIF Germany	4f6826f2-4ff6-443d-b966-e6913bd24013	9571a91c-f762-11e1-a439-00145eb45e9a
4033	4033	0	GBIF Germany	4f6826f2-4ff6-443d-b966-e6913bd24013	965f73a4-f762-11e1-a439-00145eb45e9a
753	753	0	GBIF France	da44cd31-5901-4687-a106-6d1c7734ee3a	97c2d748-f6c2-40af-ab87-eb4231a26733
81	81	0	Plazi	ffb07bec-2d10-492d-9c37-361fe0b79427	9821a4a5-b192-48ac-a98a-86241400cb02
272163	300284	28121	U.S. Geological Survey	8618c64a-93e0-4300-b546-7249e5148ed2	9b12d595-11ea-4128-88ea-ed378eb9ea9a
233	233	0	Plazi	ffb07bec-2d10-492d-9c37-361fe0b79427	9cb3ea96-0ee4-40b4-8006-19b5fed80b46
24325	351960	327635	U.S. Geological Survey	8618c64a-93e0-4300-b546-7249e5148ed2	9dc24de5-be12-44f9-ab75-c4b62492e8da
0	65	65	Plazi	ffb07bec-2d10-492d-9c37-361fe0b79427	a1df68e3-0e4c-4010-9556-cb15d51a5499
1	1	0	Plazi	ffb07bec-2d10-492d-9c37-361fe0b79427	a2011761-a094-47b2-a465-03264fc21ba2
942	942	0	GBIF France	da44cd31-5901-4687-a106-6d1c7734ee3a	a2384c57-5b8a-4ddb-bb30-909bac448e9f
74	74	0	Biodiversity Information System of Mexico	b324e8e9-9a4c-44fa-8f1a-7f39ea7ab576	a9147b92-3932-4514-bacd-1cfdafb36699
350	349	-1	Plazi	ffb07bec-2d10-492d-9c37-361fe0b79427	ac55c1cd-0227-47c0-a130-15d18759b313
6	6	0	Plazi	ffb07bec-2d10-492d-9c37-361fe0b79427	aeb6b624-fa15-4767-9d42-7963502cd209
2	2	0	Plazi	ffb07bec-2d10-492d-9c37-361fe0b79427	aec74048-8ee5-45c7-83fb-c7a73baf0b71
0	18	18	Plazi	ffb07bec-2d10-492d-9c37-361fe0b79427	af600829-34a8-4c58-b5af-adaac0d1a78e
23877	24224	347	GBIF Brazil	cdc9736d-5ff7-4ece-9959-3c744360cdb3	b18aa640-0367-4956-a6a4-5f07141127f1
0	7	7	Plazi	ffb07bec-2d10-492d-9c37-361fe0b79427	b6e551eb-5615-4804-ba64-fa35f97b8e41
582	548	-34	Biodiversity Information System of Mexico	b324e8e9-9a4c-44fa-8f1a-7f39ea7ab576	b7010c1b-8013-4a3c-a43b-4309a91f9629
0	140	140	Colombian Biodiversity Information System	7e865cba-7c46-417b-ade5-97f2cf5b7be0	b9f72c3d-498b-4df9-9222-9d0ce486926d
2	2	0	GBIF France	da44cd31-5901-4687-a106-6d1c7734ee3a	ba395ddc-c1fe-43e6-988f-f841cbcda0eb
0	7	7	Plazi	ffb07bec-2d10-492d-9c37-361fe0b79427	bcde5d36-2c05-46bf-849d-1715c64aea39
48	48	0	Participant Node Managers Committee	7f48e0c8-5c96-49ec-b972-30748e339115	bd702991-e1e7-4770-b8ba-aecd8bdf9e63
1265	1264	-1	National Biodiversity Network	d897a5b9-35ee-4232-94bd-b0bcaac003c2	be212283-072e-4e50-b938-689e3c82f5c6
1	1	0	Plazi	ffb07bec-2d10-492d-9c37-361fe0b79427	bfd8c288-0821-4893-8200-de2a460e659c
0	65	65	Plazi	ffb07bec-2d10-492d-9c37-361fe0b79427	c6acb498-2734-4f43-a464-05fda951ecc3
702	702	0	GBIF Germany	4f6826f2-4ff6-443d-b966-e6913bd24013	c6bc8e34-779c-4c6b-a20b-34daf4795b7c
3324	3324	0	National Biodiversity Network	d897a5b9-35ee-4232-94bd-b0bcaac003c2	c706122e-1372-4534-8434-4ac817d0fbf0
0	205	205	Ocean Biodiversity Information System	ba0670b9-4186-41e6-8e70-f9cb3065551a	c78a1673-6473-4728-b054-1825e0a9c183
2	2	0	Plazi	ffb07bec-2d10-492d-9c37-361fe0b79427	c7e122ef-09e5-4aec-9bda-44f2cde3620d
0	219	219	GBIF Portugal	673f7038-4262-4149-b753-5658a4e912f6	ca96a661-f979-4e4a-9b96-5ac511601384
0	4	4	Plazi	ffb07bec-2d10-492d-9c37-361fe0b79427	cc461ce1-8e44-4862-9ff2-9c9ef7f73cd9
4	4	0	Plazi	ffb07bec-2d10-492d-9c37-361fe0b79427	cd6aa158-9bb5-4815-b864-6cc4c6e37915
36	36	0	GBIF Germany	4f6826f2-4ff6-443d-b966-e6913bd24013	cdaa15fc-b10b-4c0a-9684-ca4dc497441b
0	2	2	Plazi	ffb07bec-2d10-492d-9c37-361fe0b79427	cf30730f-9aef-4d9d-a86e-b110e928b1c7
38	38	0	National Biodiversity Network	d897a5b9-35ee-4232-94bd-b0bcaac003c2	d02e2f00-f839-44d1-a59e-bbf2a0c16c6e
194	194	0	GBIF Germany	4f6826f2-4ff6-443d-b966-e6913bd24013	d0cd94e8-4f4b-48ca-8c1d-cc9e47830ec8
51	51	0	Plazi	ffb07bec-2d10-492d-9c37-361fe0b79427	d2f6f62c-9c3c-4951-9409-01bf33f2f027
0	367	367	Participant Node Managers Committee	7f48e0c8-5c96-49ec-b972-30748e339115	d2fa65c0-4e89-4763-af31-29bf09183a5d
0	7	7	Plazi	ffb07bec-2d10-492d-9c37-361fe0b79427	d4debc2b-ae1d-44ab-9f8d-9339cfb94729
91951	91951	0	National Biodiversity Network	d897a5b9-35ee-4232-94bd-b0bcaac003c2	d5ffc321-09f2-48f0-95a8-9aeefc2145d2
36568	36568	0	National Biodiversity Network	d897a5b9-35ee-4232-94bd-b0bcaac003c2	d89b6e7f-9b86-442b-99a8-60053b40bfeb
7	7	0	Plazi	ffb07bec-2d10-492d-9c37-361fe0b79427	dcb6e6f0-da73-4034-be66-85bad65ee092
118	118	0	Plazi	ffb07bec-2d10-492d-9c37-361fe0b79427	e2bc9990-e5da-4185-bb22-8ac100ac0bf4
104	104	0	GBIF Malawi	2a42e4d7-ad4a-41b3-84c4-de4aa7b74d35	e33da771-c8b6-4e8a-a0fa-7430e3af00a1
422150	422150	0	U.S. Geological Survey	8618c64a-93e0-4300-b546-7249e5148ed2	e3e34e67-86ad-4d16-ae51-856c8896390a
769	769	0	Colombian Biodiversity Information System	7e865cba-7c46-417b-ade5-97f2cf5b7be0	e5b506dc-0582-44bd-9893-afd0c29e9ad0
1	1	0	Plazi	ffb07bec-2d10-492d-9c37-361fe0b79427	e6953ab9-3d5f-4992-a783-73666a7f8286
3558	3558	0	GBIF France	da44cd31-5901-4687-a106-6d1c7734ee3a	e6c891bc-f7fa-48f0-9e6d-aa8364097f52
5	5	0	Atlas of Living Australia	4a6f1b71-969e-4fc5-a693-282b05e1220c	e774b35d-60af-4063-9f40-b22695a1e3dc
128915	128915	0	GBIF France	da44cd31-5901-4687-a106-6d1c7734ee3a	e7c5a179-b6d7-497e-8fb9-41e0ef1bb21e
25	25	0	Colombian Biodiversity Information System	7e865cba-7c46-417b-ade5-97f2cf5b7be0	e8d21cd1-dc0b-4ac7-98e2-1ec9659a5299
0	13	13	National Biodiversity Network	d897a5b9-35ee-4232-94bd-b0bcaac003c2	ecae8848-bc90-499e-bf2d-9bcee74fb2f3
1	1	0	Participant Node Managers Committee	7f48e0c8-5c96-49ec-b972-30748e339115	f20127d1-663b-4a06-9c68-dc11c5af307e
0	153	153	Plazi	ffb07bec-2d10-492d-9c37-361fe0b79427	f5a054cf-41c7-40cd-bac9-63e1ea8d1b8e
4	4	0	Plazi	ffb07bec-2d10-492d-9c37-361fe0b79427	f6d2b418-2f09-49cf-b78e-4b1ef484799b
0	1	1	Plazi	ffb07bec-2d10-492d-9c37-361fe0b79427	f8a2c7ea-0501-4755-91b6-bee9762b7d98
3	3	0	Plazi	ffb07bec-2d10-492d-9c37-361fe0b79427	fa3aaa8e-3e9c-4082-89b8-44854e4354b1
31251	31251	0	Netherlands Biodiversity Information Facility	0909d601-bda2-42df-9e63-a6d51847ebce	fa87d03e-4959-451d-865f-ff03bb798339
110	110	0	GBIF France	da44cd31-5901-4687-a106-6d1c7734ee3a	fe852975-f692-4aeb-8297-7b030d4d960a
57	57	0	GBIF Germany	4f6826f2-4ff6-443d-b966-e6913bd24013	00d88e7e-7f49-498e-9166-b93405ca1461
2814	2814	0	National Biodiversity Network	d897a5b9-35ee-4232-94bd-b0bcaac003c2	0ad8b66e-b6df-4670-acfc-a807b6b34380
0	10	10	Plazi	ffb07bec-2d10-492d-9c37-361fe0b79427	0aefbb53-9ec0-4661-a091-59d9d37d9bd0
102	102	0	Atlas of Living Australia	4a6f1b71-969e-4fc5-a693-282b05e1220c	0ec475b6-11e4-41b4-904c-3d6a951b28eb
4298	4298	0	GBIF Germany	4f6826f2-4ff6-443d-b966-e6913bd24013	13748f8d-9122-4af4-a28a-a2736dbdc4f6
0	103	103	Ocean Biodiversity Information System	ba0670b9-4186-41e6-8e70-f9cb3065551a	152a1868-1dfd-47a0-8651-e82af5fcba90
19	19	0	Plazi	ffb07bec-2d10-492d-9c37-361fe0b79427	16e6592c-5bca-43e5-b018-2f02a9400a5a
66620	66620	0	Belgian Biodiversity Platform	fb11cfe1-ebc3-45af-9159-17d9fddbcdac	182ddb9b-6cb7-4544-8469-c52d186064c5
4	4	0	Plazi	ffb07bec-2d10-492d-9c37-361fe0b79427	1a5706c9-b98b-4b87-9d33-8f85e6164a0a
0	49	49	Colombian Biodiversity Information System	7e865cba-7c46-417b-ade5-97f2cf5b7be0	1a6dce45-47c1-409f-907a-04a66c164be3
2	2	0	Plazi	ffb07bec-2d10-492d-9c37-361fe0b79427	1b0ff0a8-8ed1-4739-b65b-d3328f346b1f
10	10	0	GBIF Germany	4f6826f2-4ff6-443d-b966-e6913bd24013	1c35c0a2-819a-11e2-bad2-00145eb45e9a
26800	26800	0	GBIF France	da44cd31-5901-4687-a106-6d1c7734ee3a	1da1b76c-2a46-4a5a-b4f2-e883b0cc1240
0	22	22	Plazi	ffb07bec-2d10-492d-9c37-361fe0b79427	20ca0274-c6b2-44eb-a7a5-ba94f23d8dd1
238	238	0	GBIF France	da44cd31-5901-4687-a106-6d1c7734ee3a	2141aa2e-d57a-45cb-8463-f8f6c177dcc6
0	19	19	Plazi	ffb07bec-2d10-492d-9c37-361fe0b79427	21705181-9868-4ddf-9874-f7b8c48d273e
0	57	57	Plazi	ffb07bec-2d10-492d-9c37-361fe0b79427	22eb6faf-0090-415e-9649-2d822e0fd12d
0	4	4	Plazi	ffb07bec-2d10-492d-9c37-361fe0b79427	2353e2f9-d826-40d7-b2b3-fb41f1d26173
248	248	0	Belgian Biodiversity Platform	fb11cfe1-ebc3-45af-9159-17d9fddbcdac	2c3a72c1-4a51-4598-9763-69b7efb9a8d2
3251	3251	0	U.S. Geological Survey	8618c64a-93e0-4300-b546-7249e5148ed2	2d2f6ae8-e640-4c56-b45f-5f69583b81ad
422	422	0	GBIF France	da44cd31-5901-4687-a106-6d1c7734ee3a	2dda5e94-bf56-4321-9787-7438c479a504
37910	37910	0	National Biodiversity Network	d897a5b9-35ee-4232-94bd-b0bcaac003c2	2f79cc6e-6b14-4162-a4b5-e7415f0716ea
13	13	0	Plazi	ffb07bec-2d10-492d-9c37-361fe0b79427	30c89eb0-738f-4697-8f3b-1e7eadf169ee
0	19	19	Plazi	ffb07bec-2d10-492d-9c37-361fe0b79427	31121f39-9d25-4da6-a574-b46c649d3fe7
78	78	0	GBIF France	da44cd31-5901-4687-a106-6d1c7734ee3a	3289de2c-d2e5-434e-8ad3-6c9a8ff5d8e2
1	1	0	Plazi	ffb07bec-2d10-492d-9c37-361fe0b79427	332240b6-5d47-4caa-a1e9-8d4eebc42ef9
873	873	0	GBIF Norway	4f829580-180d-46a9-9c87-ed8ec959b545	354aeeea-31ba-4806-a3c4-1a0ec4ed4b51
0	2	2	Plazi	ffb07bec-2d10-492d-9c37-361fe0b79427	35f89364-e3eb-40f8-989e-5358a9f09637
10	10	0	Plazi	ffb07bec-2d10-492d-9c37-361fe0b79427	36935fa7-a68c-4fd7-bfb3-afd9737f18b6
291	291	0	Belgian Biodiversity Platform	fb11cfe1-ebc3-45af-9159-17d9fddbcdac	3b0f7ee6-1e31-474b-b466-5b02c7852619
1216807	1216807	0	GBIF Finland	dd514216-5c7c-45f3-910d-797424cb5be6	3d2619bf-9cb3-4c0e-8f2c-84e8a0586aac
22	22	0	Plazi	ffb07bec-2d10-492d-9c37-361fe0b79427	3ea193ef-75a7-46ea-88a2-7477d4e325da
23	23	0	Plazi	ffb07bec-2d10-492d-9c37-361fe0b79427	3ebb3cb7-3b8f-4c4d-8858-d37185292c28
1161071	1161071	0	Atlas of Living Australia	4a6f1b71-969e-4fc5-a693-282b05e1220c	3f4d4bf1-5f9a-43f2-a0d8-ff6ed5952796
0	4	4	Plazi	ffb07bec-2d10-492d-9c37-361fe0b79427	40e98280-1cc8-4daa-8771-7f1b2d584875
65535	65535	0	Participant Node Managers Committee	7f48e0c8-5c96-49ec-b972-30748e339115	40feadfa-94ea-4af3-90e1-5dffd0fb61df
35	35	0	Colombian Biodiversity Information System	7e865cba-7c46-417b-ade5-97f2cf5b7be0	422df941-9e26-46e0-9612-76d244d35b5a
17	17	0	Plazi	ffb07bec-2d10-492d-9c37-361fe0b79427	44ccbd1d-7792-480f-a014-9bd3dbc0349f
717	717	0	Atlas of Living Australia	4a6f1b71-969e-4fc5-a693-282b05e1220c	465e33dd-59ec-4e55-b2c0-1edde45d757e
5	5	0	Plazi	ffb07bec-2d10-492d-9c37-361fe0b79427	46d54dd7-903b-43d8-b612-e66fdc713843
2430	2403	-27	Biodiversity Information System of Mexico	b324e8e9-9a4c-44fa-8f1a-7f39ea7ab576	46d6da49-179c-49c6-bb62-b237c7ec5c3b
67	67	0	Plazi	ffb07bec-2d10-492d-9c37-361fe0b79427	47b43e12-37bc-4b2c-b654-0e668351cc97
16	16	0	Plazi	ffb07bec-2d10-492d-9c37-361fe0b79427	48399650-4520-4f8c-b95e-3ed010ce1c95
0	95364	95364	GBIF Norway	4f829580-180d-46a9-9c87-ed8ec959b545	4a00502d-6342-4294-aad1-9727e5c24041
0	164	164	Plazi	ffb07bec-2d10-492d-9c37-361fe0b79427	4a04aefc-725d-4b41-ba61-d4e26132ac16
4	4	0	Plazi	ffb07bec-2d10-492d-9c37-361fe0b79427	4f1de92f-8559-4562-a5ee-98350a45ba05
368	368	0	National Biodiversity Network	d897a5b9-35ee-4232-94bd-b0bcaac003c2	52ccc841-ec67-4dc3-8788-945d6bd9bac1
1095	1245	150	GBIF Japan	db5705aa-6a6e-42f1-8942-d77b9f4896ea	52f07273-4a94-4f5c-af01-f6dfe42c6ee3
177	177	0	GBIF France	da44cd31-5901-4687-a106-6d1c7734ee3a	533cc1b0-b7c7-4410-8c3d-93fa46457f78
2695	3450	755	GBIF Brazil	cdc9736d-5ff7-4ece-9959-3c744360cdb3	54e9fbce-ed69-49b8-b240-c7450fb449e0
1480	1480	0	Participant Node Managers Committee	7f48e0c8-5c96-49ec-b972-30748e339115	55bd456d-4836-4d20-9861-9cd574a32654
0	5	5	Plazi	ffb07bec-2d10-492d-9c37-361fe0b79427	55cefca3-a009-4af5-96c1-2c7d51f265a1
0	5	5	Plazi	ffb07bec-2d10-492d-9c37-361fe0b79427	55d1acb1-e0c8-4555-8925-f1de1007eb8c
690	690	0	Netherlands Biodiversity Information Facility	0909d601-bda2-42df-9e63-a6d51847ebce	5ba69a5d-a3f6-4e4e-bbf6-52ebf7dc47b3
0	1313	1313	Ocean Biodiversity Information System	ba0670b9-4186-41e6-8e70-f9cb3065551a	5d89b3ba-fad9-4481-9a4e-d1303f776a65
506	506	0	Biodiversity Information System of Mexico	b324e8e9-9a4c-44fa-8f1a-7f39ea7ab576	5dd971a0-a9f6-4ee0-b07f-9ad51e8f41c1
0	396	396	Atlas of Living Australia	4a6f1b71-969e-4fc5-a693-282b05e1220c	5e20f500-632f-4df0-92b5-f7e0d54ac9f6
21	21	0	Plazi	ffb07bec-2d10-492d-9c37-361fe0b79427	5e685989-e589-4f52-a0ab-2a5e967a8d95
4	4	0	Plazi	ffb07bec-2d10-492d-9c37-361fe0b79427	5f28b289-e16d-4f8e-ac20-72fa1a06a20b
0	1	1	Plazi	ffb07bec-2d10-492d-9c37-361fe0b79427	5fc30ab2-a55d-49fc-8e7f-2c0abaee239e
93	93	0	GBIF Germany	4f6826f2-4ff6-443d-b966-e6913bd24013	6231d02c-f762-11e1-a439-00145eb45e9a
121	121	0	GBIF Germany	4f6826f2-4ff6-443d-b966-e6913bd24013	63f77ba0-f762-11e1-a439-00145eb45e9a
143	143	0	GBIF Germany	4f6826f2-4ff6-443d-b966-e6913bd24013	64483eb4-f762-11e1-a439-00145eb45e9a
1402	1402	0	GBIF France	da44cd31-5901-4687-a106-6d1c7734ee3a	64a9021f-a45d-4823-8ad8-f9bacc984f29
0	13	13	Plazi	ffb07bec-2d10-492d-9c37-361fe0b79427	65b99b7c-26bc-47ed-9978-aa64599181c1
104	104	0	GBIF Germany	4f6826f2-4ff6-443d-b966-e6913bd24013	68580dcc-f762-11e1-a439-00145eb45e9a
1	1	0	Plazi	ffb07bec-2d10-492d-9c37-361fe0b79427	68f2e86e-3760-4c9e-bff2-47baad473bee
1	1	0	Plazi	ffb07bec-2d10-492d-9c37-361fe0b79427	6921ca7f-2057-41e1-86ee-b9ca833e63aa
17	17	0	GBIF Germany	4f6826f2-4ff6-443d-b966-e6913bd24013	6a14dadc-f762-11e1-a439-00145eb45e9a
10	10	0	GBIF Germany	4f6826f2-4ff6-443d-b966-e6913bd24013	6a8b17a6-f762-11e1-a439-00145eb45e9a
6	6	0	GBIF Germany	4f6826f2-4ff6-443d-b966-e6913bd24013	6a8db77c-f762-11e1-a439-00145eb45e9a
510	510	0	Netherlands Biodiversity Information Facility	0909d601-bda2-42df-9e63-a6d51847ebce	6baf2807-2cb4-48cd-aede-da0503b13003
180	180	0	GBIF Germany	4f6826f2-4ff6-443d-b966-e6913bd24013	6c376e6a-f762-11e1-a439-00145eb45e9a
49	49	0	GBIF Germany	4f6826f2-4ff6-443d-b966-e6913bd24013	6cb15766-f762-11e1-a439-00145eb45e9a
55	55	0	GBIF Germany	4f6826f2-4ff6-443d-b966-e6913bd24013	6ce7f2b2-f762-11e1-a439-00145eb45e9a
169	169	0	GBIF Germany	4f6826f2-4ff6-443d-b966-e6913bd24013	6d1a5d1a-f762-11e1-a439-00145eb45e9a
0	4	4	Plazi	ffb07bec-2d10-492d-9c37-361fe0b79427	6de29b2a-96a0-4e7c-ac0c-b266a0ef32a4
2	2	0	Plazi	ffb07bec-2d10-492d-9c37-361fe0b79427	6f5b17d0-c944-428a-a52e-c09287d5d02d
68	45	-23	GBIF Germany	4f6826f2-4ff6-443d-b966-e6913bd24013	71085274-f762-11e1-a439-00145eb45e9a
0	6	6	Plazi	ffb07bec-2d10-492d-9c37-361fe0b79427	71654a01-69b1-4d2b-af14-64189351bef9
2	2	0	Plazi	ffb07bec-2d10-492d-9c37-361fe0b79427	723888a4-8994-48a0-8f4e-5c2999dcf653
493	493	0	Plazi	ffb07bec-2d10-492d-9c37-361fe0b79427	72a80b13-e18f-4dc3-bec2-bb20d17f0e5f
6	6	0	GBIF Germany	4f6826f2-4ff6-443d-b966-e6913bd24013	735c3b12-f762-11e1-a439-00145eb45e9a
0	39	39	Plazi	ffb07bec-2d10-492d-9c37-361fe0b79427	74e2adbc-dfb4-4a43-b6b8-63cf650b7aa8
3018	3018	0	Colombian Biodiversity Information System	7e865cba-7c46-417b-ade5-97f2cf5b7be0	751cac02-cee1-4712-ab40-da02d972a60c
107	107	0	Plazi	ffb07bec-2d10-492d-9c37-361fe0b79427	7647a84a-e30c-4b0b-a87f-8996ff7e92df
57	57	0	GBIF Germany	4f6826f2-4ff6-443d-b966-e6913bd24013	7865a1fc-f762-11e1-a439-00145eb45e9a
18	18	0	GBIF Germany	4f6826f2-4ff6-443d-b966-e6913bd24013	78acb5f6-f762-11e1-a439-00145eb45e9a
37	26	-11	GBIF Germany	4f6826f2-4ff6-443d-b966-e6913bd24013	795bdd38-f762-11e1-a439-00145eb45e9a
419	322	-97	GBIF Germany	4f6826f2-4ff6-443d-b966-e6913bd24013	799bafb2-f762-11e1-a439-00145eb45e9a
0	35	35	Plazi	ffb07bec-2d10-492d-9c37-361fe0b79427	7b2437dc-af23-4f18-a2de-8604d0626989
23	23	0	GBIF Germany	4f6826f2-4ff6-443d-b966-e6913bd24013	7c32cef4-f762-11e1-a439-00145eb45e9a
2905	2324	-581	GBIF Germany	4f6826f2-4ff6-443d-b966-e6913bd24013	7c6f6c60-f762-11e1-a439-00145eb45e9a
61	61	0	Biodiversity Information System of Mexico	b324e8e9-9a4c-44fa-8f1a-7f39ea7ab576	7dac4665-d412-475e-81b3-85b94387b0ee
3359	2881	-478	GBIF Germany	4f6826f2-4ff6-443d-b966-e6913bd24013	7e37748c-36c7-49a2-85b9-4c02c3066cf6
848	848	0	Biodiversity Information System of Mexico	b324e8e9-9a4c-44fa-8f1a-7f39ea7ab576	7f805040-f762-11e1-a439-00145eb45e9a
840	840	0	Biodiversity Information System of Mexico	b324e8e9-9a4c-44fa-8f1a-7f39ea7ab576	8036e65c-f762-11e1-a439-00145eb45e9a
2053	2053	0	GBIF Germany	4f6826f2-4ff6-443d-b966-e6913bd24013	8205fbda-f762-11e1-a439-00145eb45e9a
351	351	0	GBIF Germany	4f6826f2-4ff6-443d-b966-e6913bd24013	8218c8c8-f762-11e1-a439-00145eb45e9a
111684	114225	2541	GBIF Germany	4f6826f2-4ff6-443d-b966-e6913bd24013	828a3d8c-f762-11e1-a439-00145eb45e9a
25526	25526	0	Canada Biodiversity Information Facility	8f83fc96-c966-4126-83f7-bf044dc49efa	82cfd6c6-f762-11e1-a439-00145eb45e9a
263	263	0	National Biodiversity Network	d897a5b9-35ee-4232-94bd-b0bcaac003c2	833951d4-633b-49b4-b06c-85d00396ea9e
0	2	2	Plazi	ffb07bec-2d10-492d-9c37-361fe0b79427	835e86fe-e9c6-4511-8d61-6e1a6dd723c6
18058	18058	0	GBIF Japan	db5705aa-6a6e-42f1-8942-d77b9f4896ea	84899ff6-f762-11e1-a439-00145eb45e9a
71514	71529	15	U.S. Geological Survey	8618c64a-93e0-4300-b546-7249e5148ed2	84b69033-f9de-40bc-8d5f-8ee41987d6cc
8977	8977	0	GBIF Benin	efb9c00e-f802-45dd-8826-a52ec45b89ff	85f35a07-0adc-463d-8a3f-cab80d1fdb61
8158	8158	0	National Biodiversity Network	d897a5b9-35ee-4232-94bd-b0bcaac003c2	85fd82b7-9c48-40a9-a667-3a946884d7ce
19	19	0	Plazi	ffb07bec-2d10-492d-9c37-361fe0b79427	86e5ed78-467d-41d4-b9fa-7512c03e7b67
2950	2045	-905	GBIF Germany	4f6826f2-4ff6-443d-b966-e6913bd24013	86ef3c9c-f762-11e1-a439-00145eb45e9a
582	582	0	GBIF Germany	4f6826f2-4ff6-443d-b966-e6913bd24013	874990b6-f762-11e1-a439-00145eb45e9a
704	520	-184	GBIF Germany	4f6826f2-4ff6-443d-b966-e6913bd24013	87f39296-f762-11e1-a439-00145eb45e9a
226	226	0	GBIF Germany	4f6826f2-4ff6-443d-b966-e6913bd24013	8834d292-f762-11e1-a439-00145eb45e9a
125	105	-20	GBIF Germany	4f6826f2-4ff6-443d-b966-e6913bd24013	884ed764-f762-11e1-a439-00145eb45e9a
14	14	0	GBIF Germany	4f6826f2-4ff6-443d-b966-e6913bd24013	88850064-f762-11e1-a439-00145eb45e9a
465	331	-134	GBIF Germany	4f6826f2-4ff6-443d-b966-e6913bd24013	88bbd36e-f762-11e1-a439-00145eb45e9a
888	888	0	GBIF France	da44cd31-5901-4687-a106-6d1c7734ee3a	88e55995-7daf-4280-9fb6-6a54e56d9407
7	7	0	Plazi	ffb07bec-2d10-492d-9c37-361fe0b79427	8928f1a2-2ef1-4127-9ebc-3a3704d90650
180	180	0	GBIF Germany	4f6826f2-4ff6-443d-b966-e6913bd24013	89e60958-f762-11e1-a439-00145eb45e9a
77074	77074	0	U.S. Geological Survey	8618c64a-93e0-4300-b546-7249e5148ed2	8a6232d7-f93e-45a3-8b16-556aa732cd39
196	196	0	GBIF Germany	4f6826f2-4ff6-443d-b966-e6913bd24013	8a702052-f762-11e1-a439-00145eb45e9a
19	19	0	GBIF Germany	4f6826f2-4ff6-443d-b966-e6913bd24013	8b1e9556-f762-11e1-a439-00145eb45e9a
4	2	-2	GBIF Germany	4f6826f2-4ff6-443d-b966-e6913bd24013	8e2f533e-f762-11e1-a439-00145eb45e9a
212	131	-81	GBIF Germany	4f6826f2-4ff6-443d-b966-e6913bd24013	8e38c4c8-f762-11e1-a439-00145eb45e9a
0	4	4	Plazi	ffb07bec-2d10-492d-9c37-361fe0b79427	8e61eca8-4bf7-4fba-80e9-adad7179d4f3
336	336	0	GBIF Germany	4f6826f2-4ff6-443d-b966-e6913bd24013	8ef484d8-f762-11e1-a439-00145eb45e9a
76	76	0	GBIF Brazil	cdc9736d-5ff7-4ece-9959-3c744360cdb3	8f1519e8-6244-42c4-a775-68f31d3a6feb
42	37	-5	GBIF Germany	4f6826f2-4ff6-443d-b966-e6913bd24013	8f359d7e-f762-11e1-a439-00145eb45e9a
105	103	-2	GBIF Germany	4f6826f2-4ff6-443d-b966-e6913bd24013	8f7aaaf4-f762-11e1-a439-00145eb45e9a
346	188	-158	GBIF Germany	4f6826f2-4ff6-443d-b966-e6913bd24013	8fb706ca-f762-11e1-a439-00145eb45e9a
162	113	-49	GBIF Germany	4f6826f2-4ff6-443d-b966-e6913bd24013	8fee653e-f762-11e1-a439-00145eb45e9a
89	72	-17	GBIF Germany	4f6826f2-4ff6-443d-b966-e6913bd24013	90ba5f86-f762-11e1-a439-00145eb45e9a
3301	3301	0	National Biodiversity Network	d897a5b9-35ee-4232-94bd-b0bcaac003c2	92c4bdc5-6993-4c76-aba7-1d98c49fa9fd
0	36	36	Ocean Biodiversity Information System	ba0670b9-4186-41e6-8e70-f9cb3065551a	93df8bc0-5a51-45b8-826c-b65d1873ad16
6980	6814	-166	GBIF Germany	4f6826f2-4ff6-443d-b966-e6913bd24013	94c46888-f762-11e1-a439-00145eb45e9a
855	766	-89	GBIF Germany	4f6826f2-4ff6-443d-b966-e6913bd24013	94e5ad86-f762-11e1-a439-00145eb45e9a
721	721	0	GBIF Germany	4f6826f2-4ff6-443d-b966-e6913bd24013	9649d058-f762-11e1-a439-00145eb45e9a
0	6	6	Plazi	ffb07bec-2d10-492d-9c37-361fe0b79427	9b7f4bcc-4771-4c2d-8b3a-6f1bd6e398ef
0	18	18	Plazi	ffb07bec-2d10-492d-9c37-361fe0b79427	9bb1c943-b8b4-47d6-b4d8-ae1d8d59043b
83	83	0	GBIF Finland	dd514216-5c7c-45f3-910d-797424cb5be6	a1ca690a-d28f-44b9-bc60-9366d22ab72a
0	3	3	Plazi	ffb07bec-2d10-492d-9c37-361fe0b79427	a1e7d840-efdc-4f93-857c-2ccf6cd2680d
51	51	0	Secretariat of the Pacific Regional Environment Programme	29c6a139-ea7f-41f5-8d9b-c55af8736182	a38c7d49-5a5d-4aa6-a64e-421178bd06d7
0	1	1	Plazi	ffb07bec-2d10-492d-9c37-361fe0b79427	a402e118-9c07-463b-9281-fcb13c7745a8
4255	4255	0	National Biodiversity Network	d897a5b9-35ee-4232-94bd-b0bcaac003c2	a6ab3f74-b667-4423-9df6-af18d73783f0
0	173	173	Ocean Biodiversity Information System	ba0670b9-4186-41e6-8e70-f9cb3065551a	a6dc4252-d17c-4afc-9fcb-99b12eac04fd
0	10	10	Ocean Biodiversity Information System	ba0670b9-4186-41e6-8e70-f9cb3065551a	a775c037-ed00-404a-9041-ce567e8aa9e7
5	5	0	Plazi	ffb07bec-2d10-492d-9c37-361fe0b79427	a78a0732-20ac-49e9-b42c-4b602b150f2f
760	760	0	Biodiversity Information System of Mexico	b324e8e9-9a4c-44fa-8f1a-7f39ea7ab576	a7ac0110-c78f-42df-8c12-bc13492ad03a
421	2660	2239	National Biodiversity Network	d897a5b9-35ee-4232-94bd-b0bcaac003c2	aba10cb3-e79b-45f8-91a7-ef79d2133af9
0	5	5	Plazi	ffb07bec-2d10-492d-9c37-361fe0b79427	b2ad3a17-73c3-4663-8d67-9b88e0a0f266
27264	27264	0	Belgian Biodiversity Platform	fb11cfe1-ebc3-45af-9159-17d9fddbcdac	b528799a-2d52-4023-aa02-9ce081e3ca5f
0	2	2	Plazi	ffb07bec-2d10-492d-9c37-361fe0b79427	c035a54d-2db6-4a88-be01-0d2a21144bd7
2	2	0	GBIF France	da44cd31-5901-4687-a106-6d1c7734ee3a	c3485ee6-256f-48ba-84d8-1f5529911133
63	63	0	GBIF Brazil	cdc9736d-5ff7-4ece-9959-3c744360cdb3	c48b7df4-2af9-4f4d-85e9-dfea0d5a28e7
50940	50940	0	U.S. Geological Survey	8618c64a-93e0-4300-b546-7249e5148ed2	c684b43a-0147-459b-ae97-0e3d9757fb92
39475	39475	0	GBIF Germany	4f6826f2-4ff6-443d-b966-e6913bd24013	c692cb7e-46f9-4d3a-8d5f-e9fcd41e5ee0
12	12	0	GBIF Germany	4f6826f2-4ff6-443d-b966-e6913bd24013	c8ec4cc4-c9cf-431e-9390-d41ad30cb1ff
2691	2691	0	U.S. Geological Survey	8618c64a-93e0-4300-b546-7249e5148ed2	cca6b165-92c6-4111-a074-99ee8d2c6b60
8	8	0	Plazi	ffb07bec-2d10-492d-9c37-361fe0b79427	cd6c9596-e375-448a-8f2c-7b50685baab9
122	122	0	Participant Node Managers Committee	7f48e0c8-5c96-49ec-b972-30748e339115	d30a4943-1366-49eb-b781-9429528d5929
0	39	39	Ocean Biodiversity Information System	ba0670b9-4186-41e6-8e70-f9cb3065551a	d4baa50c-5b2d-4163-a76d-4ce8f437bdab
2256	2256	0	National Biodiversity Network	d897a5b9-35ee-4232-94bd-b0bcaac003c2	d9527ee9-03fa-4a97-a4bf-12f5a5a54b61
9	9	0	Ocean Biodiversity Information System	ba0670b9-4186-41e6-8e70-f9cb3065551a	d9fb9220-89d3-4ee4-b96b-a63f35f3b702
8	8	0	Plazi	ffb07bec-2d10-492d-9c37-361fe0b79427	df954581-e9a9-46ba-bf7d-6c552faea404
0	13	13	Plazi	ffb07bec-2d10-492d-9c37-361fe0b79427	e0da9034-33f3-4508-aae5-c5dbeb2ee4c3
84417	84416	-1	National Biodiversity Network	d897a5b9-35ee-4232-94bd-b0bcaac003c2	e2413993-3e6c-4519-abe5-02b75cb645c6
46	46	0	Plazi	ffb07bec-2d10-492d-9c37-361fe0b79427	e42a2d2a-7828-4072-9062-42699a949956
0	351	351	Plazi	ffb07bec-2d10-492d-9c37-361fe0b79427	e5bb465f-e713-45c1-8e0f-2c6125494b44
50917	50917	0	National Biodiversity Network	d897a5b9-35ee-4232-94bd-b0bcaac003c2	e88349c3-9bb8-4268-bccb-d43e581553da
1283	1283	0	National Biodiversity Network	d897a5b9-35ee-4232-94bd-b0bcaac003c2	ea37f132-212f-4d07-88d1-b77e9131ded7
1	1	0	Plazi	ffb07bec-2d10-492d-9c37-361fe0b79427	eb7a601a-378f-46d6-bd6f-c2fcc62f2f69
74	74	0	Plazi	ffb07bec-2d10-492d-9c37-361fe0b79427	ec3e13ba-b3ea-4f5f-b9bc-9816967a8561
5471	5471	0	Canada Biodiversity Information Facility	8f83fc96-c966-4126-83f7-bf044dc49efa	efc3aee4-0153-4a6a-9815-4e1bb51f786a
2	2	0	Plazi	ffb07bec-2d10-492d-9c37-361fe0b79427	f0735593-cbcb-48b1-82ae-9e85178b2756
11	11	0	GBIF Portugal	673f7038-4262-4149-b753-5658a4e912f6	f1f1225f-4247-43a3-83de-7fbd2dca7e92
3	3	0	Plazi	ffb07bec-2d10-492d-9c37-361fe0b79427	f553d534-ba8b-4fd4-abed-a2d6958550e8
6	6	0	Plazi	ffb07bec-2d10-492d-9c37-361fe0b79427	f729f4b3-07bf-4097-82a8-174dd2dfffdc
36375	36374	-1	U.S. Geological Survey	8618c64a-93e0-4300-b546-7249e5148ed2	fda98c16-b94a-46b5-872e-b011d2c08384
0	23	23	National Biodiversity Network	d897a5b9-35ee-4232-94bd-b0bcaac003c2	fdc42d8b-9c6b-4559-a706-a8130eb0d034
0	4	4	Plazi	ffb07bec-2d10-492d-9c37-361fe0b79427	ff06869b-5933-4bfd-a781-51c864788a77
215623	231066	15443	GBIF France	da44cd31-5901-4687-a106-6d1c7734ee3a	0214a6a7-898f-4ee8-b888-0be60ecde81f
3	3	0	Plazi	ffb07bec-2d10-492d-9c37-361fe0b79427	059d48b1-7ed5-4d58-9183-f851e0389a94
36896	36896	0	National Biodiversity Network	d897a5b9-35ee-4232-94bd-b0bcaac003c2	061d01b9-ea07-4176-aaf0-125a8ad97bb8
0	4	4	Plazi	ffb07bec-2d10-492d-9c37-361fe0b79427	0639e493-81c0-4825-960e-163612c3519f
2	2	0	Plazi	ffb07bec-2d10-492d-9c37-361fe0b79427	08a78a86-2d0c-41ff-935b-3722f98f37aa
57478	57534	56	GBIF Brazil	cdc9736d-5ff7-4ece-9959-3c744360cdb3	1064b787-c882-493e-b17d-4ffba363b776
0	2	2	Plazi	ffb07bec-2d10-492d-9c37-361fe0b79427	11a4efe9-83ec-450e-9361-9657cfe342bd
0	143	143	Colombian Biodiversity Information System	7e865cba-7c46-417b-ade5-97f2cf5b7be0	11b05f56-3f42-49e3-950a-5defb7f3e367
858	858	0	GBIF Germany	4f6826f2-4ff6-443d-b966-e6913bd24013	13233e41-eed2-455e-b416-9656632929b5
692	692	0	GBIF France	da44cd31-5901-4687-a106-6d1c7734ee3a	13cc33ab-c1b2-491f-b4e1-6d07b59be814
0	10	10	Plazi	ffb07bec-2d10-492d-9c37-361fe0b79427	168685a6-5bad-4fe1-9a63-ce464dfec698
1258	1258	0	Colombian Biodiversity Information System	7e865cba-7c46-417b-ade5-97f2cf5b7be0	1acafd29-11ba-47c3-a84a-8ad7cb6e42b9
0	696	696	Colombian Biodiversity Information System	7e865cba-7c46-417b-ade5-97f2cf5b7be0	1d4371c4-af34-42e7-83f6-b9f50bd0c5a0
5	5	0	Plazi	ffb07bec-2d10-492d-9c37-361fe0b79427	1e2996e2-e31f-45e3-9149-60ebce934708
1901	1901	0	GBIF France	da44cd31-5901-4687-a106-6d1c7734ee3a	1eb279ab-17ff-4df8-9315-6428f6ec8401
23	23	0	Plazi	ffb07bec-2d10-492d-9c37-361fe0b79427	1fa78a19-6a9c-498b-89b5-a0d6ceb58080
0	11	11	Ocean Biodiversity Information System	ba0670b9-4186-41e6-8e70-f9cb3065551a	1fe622d7-0c36-4591-b2c6-1af9e41daf87
80000	80000	0	Colombian Biodiversity Information System	7e865cba-7c46-417b-ade5-97f2cf5b7be0	23243164-c132-444d-a3a4-34662abb8305
1	1	0	Plazi	ffb07bec-2d10-492d-9c37-361fe0b79427	263411cd-949d-406b-bc6f-4a8394338263
0	11	11	Plazi	ffb07bec-2d10-492d-9c37-361fe0b79427	2867208b-d5fd-44da-a48b-5f6d6747dc5a
198	198	0	GBIF Benin	efb9c00e-f802-45dd-8826-a52ec45b89ff	2cc10a76-a0f4-4c6d-8703-3a62dc7f356f
36896	42078	5182	GBIF France	da44cd31-5901-4687-a106-6d1c7734ee3a	2e102194-f384-4712-89a4-5db7a3fc409a
166	166	0	National Biodiversity Network	d897a5b9-35ee-4232-94bd-b0bcaac003c2	2eafa2ef-7b0b-46e8-bae9-9907dacefcf5
25	25	0	Plazi	ffb07bec-2d10-492d-9c37-361fe0b79427	2fc5fa89-0438-4096-b785-78d14b6bfb76
795	795	0	GBIF Argentina	2426a871-9feb-40a1-96c6-0c593a76b835	3191907d-0dc6-4c34-823e-440d30e52ca8
168	168	0	Plazi	ffb07bec-2d10-492d-9c37-361fe0b79427	347a4cd6-19e4-4116-9429-0d2796f033b5
37	37	0	GBIF Finland	dd514216-5c7c-45f3-910d-797424cb5be6	37e97070-1d18-4cc8-a004-0add44cebbe2
3	3	0	Plazi	ffb07bec-2d10-492d-9c37-361fe0b79427	39031e6f-c6e2-4bdc-9a21-1000bdc1d443
269	269	0	National Biodiversity Network	d897a5b9-35ee-4232-94bd-b0bcaac003c2	3b34778b-7b0d-4f83-9b3d-c978a50f7199
314	314	0	Colombian Biodiversity Information System	7e865cba-7c46-417b-ade5-97f2cf5b7be0	3b8f8089-0261-4ec1-829c-1f17828fbd96
0	1	1	Ocean Biodiversity Information System	ba0670b9-4186-41e6-8e70-f9cb3065551a	3c075cc4-ccc4-4502-a8e9-5e40cc154ee7
6010	6010	0	Biodiversity Information System of Mexico	b324e8e9-9a4c-44fa-8f1a-7f39ea7ab576	3d05b094-6ab4-4d47-8ba8-0d6fc51655e0
275591	275591	0	U.S. Geological Survey	8618c64a-93e0-4300-b546-7249e5148ed2	40bfac0e-a1b5-4c9e-862e-64327195f210
4	4	0	Plazi	ffb07bec-2d10-492d-9c37-361fe0b79427	46336955-d4b7-4364-96ef-3b1894930f4b
0	239	239	Colombian Biodiversity Information System	7e865cba-7c46-417b-ade5-97f2cf5b7be0	488872a4-574f-416b-91ff-09cae2364724
0	18	18	Ocean Biodiversity Information System	ba0670b9-4186-41e6-8e70-f9cb3065551a	492fbc7a-90e6-4d72-a372-a70289ce5e32
0	9	9	Plazi	ffb07bec-2d10-492d-9c37-361fe0b79427	494f44af-7086-49e3-876e-a84a8bb83381
59	59	0	Plazi	ffb07bec-2d10-492d-9c37-361fe0b79427	4a65facc-ae9e-4379-a86f-0d8d34f58096
3	3	0	Plazi	ffb07bec-2d10-492d-9c37-361fe0b79427	4b9fed80-8bb0-49eb-af85-7dbdbaf0d181
159	159	0	GBIF Brazil	cdc9736d-5ff7-4ece-9959-3c744360cdb3	4d73eb02-92ec-41a2-898e-acf8344cee2e
1	1	0	Plazi	ffb07bec-2d10-492d-9c37-361fe0b79427	4e5ccdcf-3e60-4338-921f-c3522c65a514
4	4	0	Plazi	ffb07bec-2d10-492d-9c37-361fe0b79427	53062325-189a-47f1-9a85-d87864dab6aa
11	11	0	Plazi	ffb07bec-2d10-492d-9c37-361fe0b79427	543c2b3e-ded2-4af3-a7bb-ff803ef3e93a
2	2	0	Plazi	ffb07bec-2d10-492d-9c37-361fe0b79427	55b50021-fbe1-43f5-a83c-ad5137b1b4d6
0	3	3	Plazi	ffb07bec-2d10-492d-9c37-361fe0b79427	5943fafe-d9fb-48b9-b4bf-5890fb8be2b4
0	1858	1858	GBIF France	da44cd31-5901-4687-a106-6d1c7734ee3a	59c09090-7c74-43a7-8d90-d81ab2691eec
558	558	0	GBIF Germany	4f6826f2-4ff6-443d-b966-e6913bd24013	5a0d5dea-dcdd-437e-a1c4-ac87dc05726a
0	2874	2874	National Biodiversity Network	d897a5b9-35ee-4232-94bd-b0bcaac003c2	5a6b7b21-27ec-4698-a3ea-3b29e0111f6d
7	7	0	Plazi	ffb07bec-2d10-492d-9c37-361fe0b79427	5fdc4404-5ff8-4f3d-8d9e-036fb9e739ff
0	57	57	Plazi	ffb07bec-2d10-492d-9c37-361fe0b79427	60a46419-793d-4cae-a0bc-a086fc235849
40339	40339	0	GBIF Argentina	2426a871-9feb-40a1-96c6-0c593a76b835	6197c830-d9c7-11de-b793-b8a03c50a862
172	172	0	GBIF Germany	4f6826f2-4ff6-443d-b966-e6913bd24013	6230a436-f762-11e1-a439-00145eb45e9a
57	57	0	GBIF Germany	4f6826f2-4ff6-443d-b966-e6913bd24013	62a12648-f762-11e1-a439-00145eb45e9a
0	1	1	Plazi	ffb07bec-2d10-492d-9c37-361fe0b79427	62f11d41-5d2f-43d1-9afb-fb5485935958
7	7	0	GBIF Germany	4f6826f2-4ff6-443d-b966-e6913bd24013	633ff8cc-f762-11e1-a439-00145eb45e9a
0	36	36	Plazi	ffb07bec-2d10-492d-9c37-361fe0b79427	65098dcc-047c-4076-b910-4f42bc5d005a
110	110	0	GBIF Germany	4f6826f2-4ff6-443d-b966-e6913bd24013	675dc3da-f762-11e1-a439-00145eb45e9a
9	9	0	GBIF Germany	4f6826f2-4ff6-443d-b966-e6913bd24013	6828038d-6ec3-43ac-9caf-2c74dc2d7aba
153	153	0	GBIF Germany	4f6826f2-4ff6-443d-b966-e6913bd24013	68417030-f762-11e1-a439-00145eb45e9a
1	1	0	National Biodiversity Network	d897a5b9-35ee-4232-94bd-b0bcaac003c2	6912d0e9-6398-44ce-866e-486cc0908a82
65	65	0	GBIF Germany	4f6826f2-4ff6-443d-b966-e6913bd24013	69ae3160-f762-11e1-a439-00145eb45e9a
53264	53428	164	Netherlands Biodiversity Information Facility	0909d601-bda2-42df-9e63-a6d51847ebce	6a0a95c6-c07a-4c35-9e9f-f776e8730fd4
66	65	-1	GBIF Germany	4f6826f2-4ff6-443d-b966-e6913bd24013	6a418744-f762-11e1-a439-00145eb45e9a
53	53	0	GBIF Germany	4f6826f2-4ff6-443d-b966-e6913bd24013	6ccf2a48-f762-11e1-a439-00145eb45e9a
117	117	0	GBIF Germany	4f6826f2-4ff6-443d-b966-e6913bd24013	70c46b04-f762-11e1-a439-00145eb45e9a
5	5	0	GBIF Germany	4f6826f2-4ff6-443d-b966-e6913bd24013	7179fd0c-f762-11e1-a439-00145eb45e9a
99	99	0	GBIF Germany	4f6826f2-4ff6-443d-b966-e6913bd24013	71c8964c-f762-11e1-a439-00145eb45e9a
1518	1518	0	U.S. Geological Survey	8618c64a-93e0-4300-b546-7249e5148ed2	720025b1-ea3c-44ce-9501-5dcefa67a36e
258	258	0	Atlas of Living Australia	4a6f1b71-969e-4fc5-a693-282b05e1220c	75a06b5c-c16e-448f-9f7c-5d92be6667b6
54	53	-1	GBIF Germany	4f6826f2-4ff6-443d-b966-e6913bd24013	76019b96-f762-11e1-a439-00145eb45e9a
0	6	6	Plazi	ffb07bec-2d10-492d-9c37-361fe0b79427	76dae7ea-c409-487b-8177-3a3cf450486f
0	2	2	Plazi	ffb07bec-2d10-492d-9c37-361fe0b79427	7755c971-0da0-42cb-bd12-550602e5d75c
18	18	0	GBIF Japan	db5705aa-6a6e-42f1-8942-d77b9f4896ea	77b01b3f-8d47-4e97-b719-91a983893c84
11359	11359	0	Colombian Biodiversity Information System	7e865cba-7c46-417b-ade5-97f2cf5b7be0	78ac9712-00ef-4ac3-a9de-737b7263c1b1
6	6	0	GBIF Germany	4f6826f2-4ff6-443d-b966-e6913bd24013	79027cfc-f762-11e1-a439-00145eb45e9a
47	47	0	GBIF Spain	1f94b3ca-9345-4d65-afe2-4bace93aa0fe	792a2342-1dbb-459b-84cd-e6eb1f9ba6c9
7	7	0	Plazi	ffb07bec-2d10-492d-9c37-361fe0b79427	7936be55-10e8-45fb-8a2d-ad6d37a5bade
8848	8848	0	Atlas of Living Australia	4a6f1b71-969e-4fc5-a693-282b05e1220c	79b52ea9-6834-4822-90f8-b4497c259783
1000	1000	0	Korean Biodiversity Information Facility	e0a1e772-0177-4800-94b4-2d023fe6cdf4	7ae9537e-f762-11e1-a439-00145eb45e9a
230	93	-137	GBIF Germany	4f6826f2-4ff6-443d-b966-e6913bd24013	7c8fa7a0-f762-11e1-a439-00145eb45e9a
1	1	0	GBIF Germany	4f6826f2-4ff6-443d-b966-e6913bd24013	7cc36c84-1387-11e2-bb2e-00145eb45e9a
103	103	0	GBIF Germany	4f6826f2-4ff6-443d-b966-e6913bd24013	7cf83221-8426-4fa3-8ba5-098beb81a559
847	847	0	GBIF Germany	4f6826f2-4ff6-443d-b966-e6913bd24013	7db1f05c-f762-11e1-a439-00145eb45e9a
1491	567	-924	GBIF Germany	4f6826f2-4ff6-443d-b966-e6913bd24013	7eebf10c-f762-11e1-a439-00145eb45e9a
0	136	136	Plazi	ffb07bec-2d10-492d-9c37-361fe0b79427	7f186eae-74d4-47c0-9c83-ab52a424e016
3	3	0	Plazi	ffb07bec-2d10-492d-9c37-361fe0b79427	7f34a626-f4fc-4484-83cf-ea8a2fdc963c
648	637	-11	Biodiversity Information System of Mexico	b324e8e9-9a4c-44fa-8f1a-7f39ea7ab576	7fb46f10-f762-11e1-a439-00145eb45e9a
16	16	0	GBIF Germany	4f6826f2-4ff6-443d-b966-e6913bd24013	8263e376-f762-11e1-a439-00145eb45e9a
9	9	0	Plazi	ffb07bec-2d10-492d-9c37-361fe0b79427	84971505-988e-4047-adaa-3673ed0e99df
770	770	0	DanBIF - Danish Biodiversity Information Facility	4ddd294f-02b7-4359-ac33-0806a9ca9c6b	84ca3ea8-f762-11e1-a439-00145eb45e9a
6957	6957	0	DanBIF - Danish Biodiversity Information Facility	4ddd294f-02b7-4359-ac33-0806a9ca9c6b	84cdd6d0-f762-11e1-a439-00145eb45e9a
0	103	103	U.S. Geological Survey	8618c64a-93e0-4300-b546-7249e5148ed2	86f5947b-b728-4021-8075-1da02bd8893f
25	18	-7	GBIF Germany	4f6826f2-4ff6-443d-b966-e6913bd24013	8762c702-f762-11e1-a439-00145eb45e9a
2497	2497	0	GBIF France	da44cd31-5901-4687-a106-6d1c7734ee3a	87c7eb83-74e2-4c02-89b4-6895596c509b
659	483	-176	GBIF Germany	4f6826f2-4ff6-443d-b966-e6913bd24013	87d9ccc6-f762-11e1-a439-00145eb45e9a
0	27	27	Plazi	ffb07bec-2d10-492d-9c37-361fe0b79427	88ead712-988a-46c8-88e2-99f6ae4c6191
0	26	26	Plazi	ffb07bec-2d10-492d-9c37-361fe0b79427	89e0593b-e95d-4f75-bbef-eb3f17f61a61
3	3	0	GBIF France	da44cd31-5901-4687-a106-6d1c7734ee3a	8a10978f-fa99-4fc8-a63d-5e0aeefd98b6
2790	2790	0	National Biodiversity Network	d897a5b9-35ee-4232-94bd-b0bcaac003c2	8a994fe2-de7b-449e-acc9-2e6051ad870c
11	11	0	Plazi	ffb07bec-2d10-492d-9c37-361fe0b79427	8c18255f-0cb3-45f7-a763-5eba38606f83
11	11	0	GBIF Germany	4f6826f2-4ff6-443d-b966-e6913bd24013	8d250bf0-f762-11e1-a439-00145eb45e9a
1757	1454	-303	GBIF Germany	4f6826f2-4ff6-443d-b966-e6913bd24013	8e043cb2-f762-11e1-a439-00145eb45e9a
150	150	0	GBIF France	da44cd31-5901-4687-a106-6d1c7734ee3a	8e7b1108-29c4-4af6-8109-d02a00610c1c
316	176	-140	GBIF Germany	4f6826f2-4ff6-443d-b966-e6913bd24013	8e8380ee-f762-11e1-a439-00145eb45e9a
0	202	202	Ocean Biodiversity Information System	ba0670b9-4186-41e6-8e70-f9cb3065551a	907219f3-d0cf-4573-8db5-ca2b99a21127
1	1	0	GBIF Germany	4f6826f2-4ff6-443d-b966-e6913bd24013	922ca770-f762-11e1-a439-00145eb45e9a
601	596	-5	GBIF Germany	4f6826f2-4ff6-443d-b966-e6913bd24013	93013c74-f762-11e1-a439-00145eb45e9a
0	19	19	Plazi	ffb07bec-2d10-492d-9c37-361fe0b79427	933de798-383e-46d7-ac1c-2607a36d7f10
33	33	0	GBIF Germany	4f6826f2-4ff6-443d-b966-e6913bd24013	93690a16-f762-11e1-a439-00145eb45e9a
1241	1241	0	Ghana Biodiversity Information Facility	b5633b75-6a86-4fdf-9cfc-506047fb9dc7	9ac8503c-5163-4910-a4e4-c17887995c59
100	100	0	Colombian Biodiversity Information System	7e865cba-7c46-417b-ade5-97f2cf5b7be0	9e2bc3ae-7363-4421-8928-9b551749998a
0	7986	7986	Participant Node Managers Committee	7f48e0c8-5c96-49ec-b972-30748e339115	9fc96854-7fb4-4d4e-8fd2-e7cbf88915a6
2525	2613	88	Plazi	ffb07bec-2d10-492d-9c37-361fe0b79427	a0df9cba-eef0-43b8-af7d-51780a293ec3
743	743	0	Polish Biodiversity Information Network	2618bfdf-e194-4911-a241-80db3107bc51	a2e88fb0-328a-11df-855a-b8a03c50a862
177831	213433	35602	National Biodiversity Network	d897a5b9-35ee-4232-94bd-b0bcaac003c2	a451e2eb-f70f-49c4-b1ca-fe78e65bacbe
26019	26019	0	Participant Node Managers Committee	7f48e0c8-5c96-49ec-b972-30748e339115	a557f069-a10a-4558-ada5-dc67324fe839
513	513	0	GBIF Germany	4f6826f2-4ff6-443d-b966-e6913bd24013	a5681b60-d301-48b5-aba2-b8c1618a21a2
690	690	0	Atlas of Living Australia	4a6f1b71-969e-4fc5-a693-282b05e1220c	a5e2a5e4-c8c7-47f5-9f8a-1b7716dc3cd2
0	4	4	Plazi	ffb07bec-2d10-492d-9c37-361fe0b79427	a66db357-bbbe-4aaf-a6c8-1aa97a5e380e
0	256	256	Colombian Biodiversity Information System	7e865cba-7c46-417b-ade5-97f2cf5b7be0	a7a1f90b-f8ee-4b94-ac41-507098fc64a4
0	6	6	Plazi	ffb07bec-2d10-492d-9c37-361fe0b79427	a898db92-1916-47b9-9bee-5b7a1a0682a4
50944	50944	0	Canada Biodiversity Information Facility	8f83fc96-c966-4126-83f7-bf044dc49efa	ada5d0b1-07de-4dc0-83d4-e312f0fb81cb
29	29	0	Participant Node Managers Committee	7f48e0c8-5c96-49ec-b972-30748e339115	b086427c-bf5b-49a4-8bf9-20aee512af41
95	129	34	GBIF Japan	db5705aa-6a6e-42f1-8942-d77b9f4896ea	b1c50b31-0ede-4a35-9030-1aae35a0c8d5
0	2	2	Plazi	ffb07bec-2d10-492d-9c37-361fe0b79427	b26607e6-b33f-4b70-b6ef-97bba98a97fb
0	2	2	Plazi	ffb07bec-2d10-492d-9c37-361fe0b79427	b26a573e-6dc9-49ec-9f53-c47d3c4b337d
0	2	2	Plazi	ffb07bec-2d10-492d-9c37-361fe0b79427	b32a6a54-8293-489f-b190-cc87980234df
15	15	0	Plazi	ffb07bec-2d10-492d-9c37-361fe0b79427	b4cbbd00-4001-41ef-bd90-464e870bd1f9
415	8	-407	GBIF Germany	4f6826f2-4ff6-443d-b966-e6913bd24013	b52c6c91-2892-4749-9872-7e65cff658a0
0	372	372	Colombian Biodiversity Information System	7e865cba-7c46-417b-ade5-97f2cf5b7be0	b5726307-bfc3-468f-a2b6-aed4af7d2c83
2561	2561	0	National Biodiversity Network	d897a5b9-35ee-4232-94bd-b0bcaac003c2	b66c629e-b878-4b26-960d-7c0103b025c7
0	9	9	Plazi	ffb07bec-2d10-492d-9c37-361fe0b79427	b906215d-602b-49d5-9d97-a9be35964505
92	92	0	GBIF Germany	4f6826f2-4ff6-443d-b966-e6913bd24013	bcea7deb-a882-48fe-8f81-f15ef9f5e44a
24	24	0	Plazi	ffb07bec-2d10-492d-9c37-361fe0b79427	bd04f2d1-6de5-43f6-9fca-16a5482835fd
26	26	0	Plazi	ffb07bec-2d10-492d-9c37-361fe0b79427	be9cb25c-5039-4f85-aad6-0a46bc659fb5
885	885	0	GBIF France	da44cd31-5901-4687-a106-6d1c7734ee3a	bf45efa7-ebc7-49f9-ae8c-80266c031bdf
5583	5583	0	Belgian Biodiversity Platform	fb11cfe1-ebc3-45af-9159-17d9fddbcdac	bfaa049a-90cd-412d-9660-5380591ba4a5
8	8	0	Participant Node Managers Committee	7f48e0c8-5c96-49ec-b972-30748e339115	c39a06fe-b5fd-42ed-9fde-312b590bab52
0	3	3	Plazi	ffb07bec-2d10-492d-9c37-361fe0b79427	c5f8a0a6-2e93-498b-ac93-5f8467dba578
5	5	0	Plazi	ffb07bec-2d10-492d-9c37-361fe0b79427	c60ae4d1-3799-4569-a862-b7dca347808d
0	724	724	Ocean Biodiversity Information System	ba0670b9-4186-41e6-8e70-f9cb3065551a	c6479c48-1bf2-4130-98ba-e6f492bbd1a9
0	237179	237179	National Biodiversity Network	d897a5b9-35ee-4232-94bd-b0bcaac003c2	c665b271-454b-4844-a039-426dac634908
3	3	0	Plazi	ffb07bec-2d10-492d-9c37-361fe0b79427	c67b86d2-89d6-4df1-a412-b4372dc6eb2b
50	50	0	Plazi	ffb07bec-2d10-492d-9c37-361fe0b79427	c6d0d802-2934-45b6-8561-bf4ff9930444
0	1599	1599	Colombian Biodiversity Information System	7e865cba-7c46-417b-ade5-97f2cf5b7be0	c70764ce-5d79-4bdc-9bd0-274693918fe9
0	1401	1401	GBIF Ecuador	2dc472f1-c3d9-486d-b3c1-12ca7ba1ed22	cc6854e9-f045-4dab-ab7b-75fbf2e98717
922	922	0	GBIF Norway	4f829580-180d-46a9-9c87-ed8ec959b545	cf999616-58f0-43af-8dba-164c0323f19d
0	117	117	GBIF France	da44cd31-5901-4687-a106-6d1c7734ee3a	cfda3b8f-7fb0-42f6-a425-f07d67fac143
26	26	0	GBIF Norway	4f829580-180d-46a9-9c87-ed8ec959b545	d16df2ba-0a5f-4d5f-8107-ff4074c844b3
0	6	6	Ocean Biodiversity Information System	ba0670b9-4186-41e6-8e70-f9cb3065551a	d57e4de6-27ee-4090-9bbc-34c838f4e1af
4753	4753	0	Netherlands Biodiversity Information Facility	0909d601-bda2-42df-9e63-a6d51847ebce	d5ba9c82-ee3d-4987-84de-363abbda870b
46	46	0	Plazi	ffb07bec-2d10-492d-9c37-361fe0b79427	d807f185-5391-4c8c-84c6-2550370b3cd3
1534	1534	0	GBIF France	da44cd31-5901-4687-a106-6d1c7734ee3a	db911c59-3894-47df-99bd-e2f1af48a739
18	18	0	Plazi	ffb07bec-2d10-492d-9c37-361fe0b79427	e114acb7-3683-4094-a53f-c9bc7ed84353
95	95	0	GBIF Germany	4f6826f2-4ff6-443d-b966-e6913bd24013	e3e7d484-ce24-4836-b4a2-c2d92d5bf193
404	404	0	National Biodiversity Network	d897a5b9-35ee-4232-94bd-b0bcaac003c2	e3f3ab09-4275-499e-b556-e90e7702ba28
4	4	0	Plazi	ffb07bec-2d10-492d-9c37-361fe0b79427	e5c1bd7b-a4cc-47b1-ae2d-34d2892faf28
6242	6242	0	Canada Biodiversity Information Facility	8f83fc96-c966-4126-83f7-bf044dc49efa	eaf9401e-a5e3-4a27-89ad-2d6ac6559167
188	188	0	Korean Biodiversity Information Facility	e0a1e772-0177-4800-94b4-2d023fe6cdf4	eb47a0de-862f-44c0-be42-0e300abaaab4
1701	1701	0	GBIF Benin	efb9c00e-f802-45dd-8826-a52ec45b89ff	ebb766c1-6036-4b58-a0cb-ad8c35c03850
5	5	0	Belgian Biodiversity Platform	fb11cfe1-ebc3-45af-9159-17d9fddbcdac	ec06e9e4-af77-4a50-ad21-6fc47fcf56c9
281	281	0	Participant Node Managers Committee	7f48e0c8-5c96-49ec-b972-30748e339115	ec5f88f7-7b04-4c4a-84a0-7898759a224f
1	1	0	Plazi	ffb07bec-2d10-492d-9c37-361fe0b79427	ef166e01-240e-4c35-a6b5-79da690f5d24
60	60	0	Plazi	ffb07bec-2d10-492d-9c37-361fe0b79427	f0dbd255-e584-4fa3-aacc-d1025ff7227f
13	13	0	Plazi	ffb07bec-2d10-492d-9c37-361fe0b79427	f23459ba-cdaa-4604-874c-beac8b3b3ee2
228947	228664	-283	Biodiversity Information System of Mexico	b324e8e9-9a4c-44fa-8f1a-7f39ea7ab576	f2fa6ed4-b488-4628-9818-3599facca32f
0	9	9	Plazi	ffb07bec-2d10-492d-9c37-361fe0b79427	f4246026-f48b-4fe0-8555-4faf0639bd35
1	1	0	Plazi	ffb07bec-2d10-492d-9c37-361fe0b79427	f691de76-fa3a-4219-9842-b3bded574880
0	2	2	Plazi	ffb07bec-2d10-492d-9c37-361fe0b79427	f6f58ec8-a19c-4373-9721-ca59a251bbe6
9225	9225	0	National Biodiversity Network	d897a5b9-35ee-4232-94bd-b0bcaac003c2	fa9f0f83-6a27-4260-8476-d2b97847a8a4
23	23	0	Plazi	ffb07bec-2d10-492d-9c37-361fe0b79427	fabea953-b6ff-4750-9d2d-231297c3b88a
0	36	36	Plazi	ffb07bec-2d10-492d-9c37-361fe0b79427	fbf65a8a-582e-4515-8e4e-0a6e58801e8f
789	789	0	GBIF France	da44cd31-5901-4687-a106-6d1c7734ee3a	fc5a952b-20dd-461e-b427-43c018f0d800
2	2	0	Plazi	ffb07bec-2d10-492d-9c37-361fe0b79427	01404481-90f6-4c48-9e93-b76cd29c9beb
0	1	1	Plazi	ffb07bec-2d10-492d-9c37-361fe0b79427	0419c779-3058-48fe-96f5-ce0add146a26
468533	468533	0	Netherlands Biodiversity Information Facility	0909d601-bda2-42df-9e63-a6d51847ebce	045593aa-0ac2-4ffa-8d96-9d669b27f03c
0	7	7	Plazi	ffb07bec-2d10-492d-9c37-361fe0b79427	0523575c-6bd2-4bd6-b0d3-7e5cc71537ee
20	20	0	Participant Node Managers Committee	7f48e0c8-5c96-49ec-b972-30748e339115	056e7790-1313-45bf-b14b-1f8b16b574ca
0	3	3	Ocean Biodiversity Information System	ba0670b9-4186-41e6-8e70-f9cb3065551a	0616a388-532c-4c6d-bed9-86e5aa1a8020
612	612	0	National Biodiversity Network	d897a5b9-35ee-4232-94bd-b0bcaac003c2	07f6c820-16ba-49a8-81af-72f7028b6d04
116	116	0	GBIF France	da44cd31-5901-4687-a106-6d1c7734ee3a	0962ca17-57f0-430d-88bf-af3876dd6cf7
0	1	1	Plazi	ffb07bec-2d10-492d-9c37-361fe0b79427	0aa71e12-5a8b-4cec-bf19-e872ae31468d
344	344	0	Plazi	ffb07bec-2d10-492d-9c37-361fe0b79427	0cd61b23-1089-4c1b-bfc0-487887abad84
0	71	71	Plazi	ffb07bec-2d10-492d-9c37-361fe0b79427	0cda6c92-3cdc-48ed-84a9-5627107d2823
0	4	4	Plazi	ffb07bec-2d10-492d-9c37-361fe0b79427	129edbf2-2a5a-4c7f-84eb-13334fca6c19
0	3	3	Plazi	ffb07bec-2d10-492d-9c37-361fe0b79427	17a2bac5-bf97-4266-af70-8a8bd4d23f64
8089	8089	0	National Biodiversity Network	d897a5b9-35ee-4232-94bd-b0bcaac003c2	17ebeb27-ff77-46a3-883d-fc89035da1a1
61	61	0	GBIF France	da44cd31-5901-4687-a106-6d1c7734ee3a	18fee42d-ccfc-4b57-b940-867b8386ac10
59799	59799	0	Chinese Academy of Sciences	e760dc6f-dd68-474d-ab41-bd3588571793	196ac794-b2c2-40d4-8e6a-649d0abc324d
2	2	0	Plazi	ffb07bec-2d10-492d-9c37-361fe0b79427	1b4513e3-05f7-4765-b9fb-95a9d83413c9
0	5	5	Plazi	ffb07bec-2d10-492d-9c37-361fe0b79427	1c3dab5f-6ac0-4f70-937e-8e57ea720521
9	9	0	Plazi	ffb07bec-2d10-492d-9c37-361fe0b79427	1ef17fa7-58ce-462d-b26b-0e957c86a59a
0	15	15	Plazi	ffb07bec-2d10-492d-9c37-361fe0b79427	1f4cc518-5213-43d8-ba98-ee53e5271d9b
1	1	0	GBIF France	da44cd31-5901-4687-a106-6d1c7734ee3a	1f524871-4341-48a6-9415-a5ce935f9278
3	3	0	Plazi	ffb07bec-2d10-492d-9c37-361fe0b79427	226b65ae-c038-4bd6-9cd8-e52b63672813
17	16	-1	Plazi	ffb07bec-2d10-492d-9c37-361fe0b79427	246dae96-99ed-4bb9-9ae7-b0223b873cf6
0	794	794	Ocean Biodiversity Information System	ba0670b9-4186-41e6-8e70-f9cb3065551a	278e4f81-19c0-4eb8-8e81-af2b0705c587
497	497	0	GBIF France	da44cd31-5901-4687-a106-6d1c7734ee3a	2cce80fb-852f-4e14-b78e-034c4ae3f7fb
9	9	0	Plazi	ffb07bec-2d10-492d-9c37-361fe0b79427	2ebd9c29-a4b0-4b92-ad7b-a3e37582f934
0	33816	33816	Canada Biodiversity Information Facility	8f83fc96-c966-4126-83f7-bf044dc49efa	2fc9577f-1fa8-45e3-b4b5-0c46c3cad692
5	5	0	Plazi	ffb07bec-2d10-492d-9c37-361fe0b79427	3041710b-7086-4d82-b50f-88a69663c8e4
0	16	16	Plazi	ffb07bec-2d10-492d-9c37-361fe0b79427	309aa70b-92fb-4bab-b382-c69c01e1259e
3	3	0	Participant Node Managers Committee	7f48e0c8-5c96-49ec-b972-30748e339115	30b86898-b660-417f-b68d-7330b440cd2f
2	2	0	Plazi	ffb07bec-2d10-492d-9c37-361fe0b79427	356457a9-fa5b-434a-aef7-df83bd2bb47d
0	3	3	Plazi	ffb07bec-2d10-492d-9c37-361fe0b79427	35b75c67-816f-44fa-9aa8-db362300cd3f
30084	1214	-28870	Biodiversity Information System of Mexico	b324e8e9-9a4c-44fa-8f1a-7f39ea7ab576	374a9e84-fd75-425e-b0a5-20f2646a872f
866	866	0	Biodiversity Information System of Mexico	b324e8e9-9a4c-44fa-8f1a-7f39ea7ab576	37e95be3-cbba-480e-b120-3da7014b38ae
0	1	1	Ocean Biodiversity Information System	ba0670b9-4186-41e6-8e70-f9cb3065551a	38e81490-2a06-4b0e-9274-609bd7c65bc6
449	449	0	Biodiversity Information System of Mexico	b324e8e9-9a4c-44fa-8f1a-7f39ea7ab576	39424411-12e2-46c0-ac1f-086fa430aa53
341	341	0	Biodiversity Information System of Mexico	b324e8e9-9a4c-44fa-8f1a-7f39ea7ab576	3b0c24f6-faa0-4f3c-b3c2-89a73bf9cb48
87	87	0	Plazi	ffb07bec-2d10-492d-9c37-361fe0b79427	3bad6762-1788-4f94-9cfd-1281b8619c55
12	12	0	Plazi	ffb07bec-2d10-492d-9c37-361fe0b79427	437cdaa8-9da8-4db4-8163-7d063db0be9e
9	9	0	Plazi	ffb07bec-2d10-492d-9c37-361fe0b79427	505a896d-74bc-473f-8ee6-52d68ca29665
8	8	0	Plazi	ffb07bec-2d10-492d-9c37-361fe0b79427	52381685-6651-42d8-b555-a9b56f9c37a5
6	6	0	Plazi	ffb07bec-2d10-492d-9c37-361fe0b79427	53d85962-2a5e-4cb4-8a07-16a02a4ea72a
0	2	2	Plazi	ffb07bec-2d10-492d-9c37-361fe0b79427	56038e63-758e-436f-98f2-06e761a51ea8
19	19	0	Plazi	ffb07bec-2d10-492d-9c37-361fe0b79427	58fe9824-63d2-4915-a61a-315b8c8bb678
368853	368853	0	Netherlands Biodiversity Information Facility	0909d601-bda2-42df-9e63-a6d51847ebce	62d82928-dc6f-40dc-85b3-f2be47e7b49a
0	61	61	Ocean Biodiversity Information System	ba0670b9-4186-41e6-8e70-f9cb3065551a	64283d8d-a645-475e-ab21-2fd63e7fa20c
49	49	0	Plazi	ffb07bec-2d10-492d-9c37-361fe0b79427	64322e57-d626-4eb7-91cb-c4d22ce1515e
2	2	0	Plazi	ffb07bec-2d10-492d-9c37-361fe0b79427	64649807-7fea-43a4-8424-1382eab006fe
129	86	-43	GBIF Germany	4f6826f2-4ff6-443d-b966-e6913bd24013	660212fc-f762-11e1-a439-00145eb45e9a
137	137	0	GBIF Germany	4f6826f2-4ff6-443d-b966-e6913bd24013	6635656c-f762-11e1-a439-00145eb45e9a
117	117	0	GBIF Germany	4f6826f2-4ff6-443d-b966-e6913bd24013	67ae346e-f762-11e1-a439-00145eb45e9a
1	1	0	Plazi	ffb07bec-2d10-492d-9c37-361fe0b79427	67c01d3c-1ef0-40f0-b7cb-d9684ee67840
113	113	0	GBIF Germany	4f6826f2-4ff6-443d-b966-e6913bd24013	67e5ff52-f762-11e1-a439-00145eb45e9a
138	138	0	GBIF Germany	4f6826f2-4ff6-443d-b966-e6913bd24013	67fb29a4-f762-11e1-a439-00145eb45e9a
100	100	0	GBIF Germany	4f6826f2-4ff6-443d-b966-e6913bd24013	6842c4b2-f762-11e1-a439-00145eb45e9a
125	125	0	GBIF Germany	4f6826f2-4ff6-443d-b966-e6913bd24013	68485684-f762-11e1-a439-00145eb45e9a
182	182	0	GBIF Germany	4f6826f2-4ff6-443d-b966-e6913bd24013	684cc1ec-f762-11e1-a439-00145eb45e9a
0	5	5	Plazi	ffb07bec-2d10-492d-9c37-361fe0b79427	68b7a9c6-756c-4365-a5fa-8945be8b6dac
106	106	0	GBIF Germany	4f6826f2-4ff6-443d-b966-e6913bd24013	68be5c8a-f762-11e1-a439-00145eb45e9a
0	19	19	Plazi	ffb07bec-2d10-492d-9c37-361fe0b79427	6925a6b3-ffa9-4c58-a22f-e48d8d2519d6
0	5	5	Plazi	ffb07bec-2d10-492d-9c37-361fe0b79427	698874a5-ca24-4aac-a827-003226816fb0
4207	4207	0	Participant Node Managers Committee	7f48e0c8-5c96-49ec-b972-30748e339115	6a31497b-234c-4d24-a3aa-e56d8655f57b
7959	7959	0	Colombian Biodiversity Information System	7e865cba-7c46-417b-ade5-97f2cf5b7be0	6a9fa73b-bc65-49ed-be8a-30955b0ef679
20	20	0	Plazi	ffb07bec-2d10-492d-9c37-361fe0b79427	6ab5cadd-8428-4e3f-a5c6-b909cee2f89f
8	8	0	GBIF Germany	4f6826f2-4ff6-443d-b966-e6913bd24013	6ae46f90-f762-11e1-a439-00145eb45e9a
1219	1113	-106	GBIF Germany	4f6826f2-4ff6-443d-b966-e6913bd24013	6b1303cd-f6c8-47f7-bd9e-b6cc59a18d3c
18	18	0	GBIF Germany	4f6826f2-4ff6-443d-b966-e6913bd24013	6baf1614-f762-11e1-a439-00145eb45e9a
14	14	0	GBIF Germany	4f6826f2-4ff6-443d-b966-e6913bd24013	6bb5a6a0-f762-11e1-a439-00145eb45e9a
2691	2691	0	U.S. Geological Survey	8618c64a-93e0-4300-b546-7249e5148ed2	6bb8dff2-1c80-4f64-9cf0-9dda185d5bca
207	207	0	GBIF Germany	4f6826f2-4ff6-443d-b966-e6913bd24013	6c33843a-f762-11e1-a439-00145eb45e9a
140	140	0	GBIF Finland	dd514216-5c7c-45f3-910d-797424cb5be6	6cb80484-b9cd-4e83-b81e-70416f61f5ed
0	11126	11126	International Centre for Integrated Mountain Development	b35cf8f1-748d-467a-adca-4f9170f20a4e	6dad136b-1cb9-46b8-bcb4-9f89d77b47d6
756	27	-729	Biodiversity Information System of Mexico	b324e8e9-9a4c-44fa-8f1a-7f39ea7ab576	6ed8e6dc-1e4d-49d8-872b-fdd87a8ee99d
3	3	0	Plazi	ffb07bec-2d10-492d-9c37-361fe0b79427	70ba4983-81a0-4e19-8943-29a2ea0ed509
0	313	313	GBIF Argentina	2426a871-9feb-40a1-96c6-0c593a76b835	71a2678e-eea7-49db-bc5a-e7e9ec0b9d98
67	67	0	Canada Biodiversity Information Facility	8f83fc96-c966-4126-83f7-bf044dc49efa	7248a2da-65b9-48f4-ada8-6eaab245ba84
1247	1247	0	Atlas of Living Australia	4a6f1b71-969e-4fc5-a693-282b05e1220c	72fde3a9-f64a-46f2-a9ee-7994b53038f3
560	560	0	GBIF Germany	4f6826f2-4ff6-443d-b966-e6913bd24013	7542b780-f762-11e1-a439-00145eb45e9a
31	31	0	GBIF France	da44cd31-5901-4687-a106-6d1c7734ee3a	7701fb9b-9c34-49f9-b883-d5c65f649183
46	46	0	GBIF Germany	4f6826f2-4ff6-443d-b966-e6913bd24013	784ca4a4-f762-11e1-a439-00145eb45e9a
12	12	0	GBIF Germany	4f6826f2-4ff6-443d-b966-e6913bd24013	78e431f2-f762-11e1-a439-00145eb45e9a
0	34	34	Plazi	ffb07bec-2d10-492d-9c37-361fe0b79427	78efc8a8-333c-4847-aad9-d9f7943b8da8
516	475	-41	GBIF Germany	4f6826f2-4ff6-443d-b966-e6913bd24013	7950c6fa-f762-11e1-a439-00145eb45e9a
44	40	-4	GBIF Germany	4f6826f2-4ff6-443d-b966-e6913bd24013	79bd15da-f762-11e1-a439-00145eb45e9a
8564	8564	0	GBIF Japan	db5705aa-6a6e-42f1-8942-d77b9f4896ea	7aff155c-1c15-44d8-adf3-4d2ecb842bb9
9059	9059	0	GBIF Germany	4f6826f2-4ff6-443d-b966-e6913bd24013	7b91859e-f762-11e1-a439-00145eb45e9a
0	1060	1060	Chinese Academy of Sciences	e760dc6f-dd68-474d-ab41-bd3588571793	7ba1318c-04ed-4521-8369-63731e2867f7
2365	2365	0	GBIF Germany	4f6826f2-4ff6-443d-b966-e6913bd24013	7c04ba5a-f762-11e1-a439-00145eb45e9a
3691	3441	-250	GBIF Germany	4f6826f2-4ff6-443d-b966-e6913bd24013	7c804738-f762-11e1-a439-00145eb45e9a
2090	2090	0	GBIF Uganda	71b40829-6a12-4c3d-8fee-5746f5e9cf8c	7d0726ee-f3f7-4c08-bd46-a1360abb3803
361	361	0	GBIF Finland	dd514216-5c7c-45f3-910d-797424cb5be6	7d503632-f762-11e1-a439-00145eb45e9a
1118	1118	0	GBIF Spain	1f94b3ca-9345-4d65-afe2-4bace93aa0fe	7d628ed3-9ba5-4df9-9251-0972d9a5d3b3
39	39	0	GBIF Germany	4f6826f2-4ff6-443d-b966-e6913bd24013	7d857950-f762-11e1-a439-00145eb45e9a
95	95	0	GBIF Germany	4f6826f2-4ff6-443d-b966-e6913bd24013	7dffc2b4-f762-11e1-a439-00145eb45e9a
507	507	0	Colombian Biodiversity Information System	7e865cba-7c46-417b-ade5-97f2cf5b7be0	7f32012e-8cb5-4215-b428-ac0cfede7ca2
195	195	0	Atlas of Living Australia	4a6f1b71-969e-4fc5-a693-282b05e1220c	7f5b699c-f762-11e1-a439-00145eb45e9a
0	11	11	Plazi	ffb07bec-2d10-492d-9c37-361fe0b79427	8142c48d-90d2-4bc7-911e-787c685c697c
58039	58039	0	National Biodiversity Network	d897a5b9-35ee-4232-94bd-b0bcaac003c2	814e2048-71fb-4345-b739-ff28ef86afb9
1627	1659	32	GBIF Germany	4f6826f2-4ff6-443d-b966-e6913bd24013	815d6eca-f762-11e1-a439-00145eb45e9a
239829	248963	9134	GBIF Germany	4f6826f2-4ff6-443d-b966-e6913bd24013	82a421d4-f762-11e1-a439-00145eb45e9a
7122	7122	0	Atlas of Living Australia	4a6f1b71-969e-4fc5-a693-282b05e1220c	82e33d42-f762-11e1-a439-00145eb45e9a
3	3	0	Plazi	ffb07bec-2d10-492d-9c37-361fe0b79427	843f7d92-be55-4919-9f51-9bd189cf25ae
116417	116417	0	U.S. Geological Survey	8618c64a-93e0-4300-b546-7249e5148ed2	84797ee6-f762-11e1-a439-00145eb45e9a
0	3	3	Plazi	ffb07bec-2d10-492d-9c37-361fe0b79427	84e02cb7-fb1c-4698-9115-0e09b1bfda35
0	1	1	Plazi	ffb07bec-2d10-492d-9c37-361fe0b79427	850b9074-8702-429f-824d-b534c9fbd70f
93	93	0	World Federation for Culture Collections	a6bdc523-5368-4e0f-9d2e-de1c262ac092	85550114-f762-11e1-a439-00145eb45e9a
127	127	0	GBIF Germany	4f6826f2-4ff6-443d-b966-e6913bd24013	85d61e48-f762-11e1-a439-00145eb45e9a
0	2	2	Plazi	ffb07bec-2d10-492d-9c37-361fe0b79427	85e4b1e2-ea3a-4e86-b9fa-fd0039d847b7
558	558	0	GBIF France	da44cd31-5901-4687-a106-6d1c7734ee3a	8636578d-7f36-458b-bc0a-ef2b9f5b7b6c
4240	4240	0	U.S. Geological Survey	8618c64a-93e0-4300-b546-7249e5148ed2	865ba536-f762-11e1-a439-00145eb45e9a
6790	5354	-1436	GBIF Germany	4f6826f2-4ff6-443d-b966-e6913bd24013	86c75830-f762-11e1-a439-00145eb45e9a
101	101	0	Plazi	ffb07bec-2d10-492d-9c37-361fe0b79427	87eb604f-b0c5-49cc-bc27-d1abb238b819
41	41	0	GBIF Germany	4f6826f2-4ff6-443d-b966-e6913bd24013	89a1c2c0-f762-11e1-a439-00145eb45e9a
7	7	0	GBIF Germany	4f6826f2-4ff6-443d-b966-e6913bd24013	8a0313ea-f762-11e1-a439-00145eb45e9a
5518	5518	0	GBIF France	da44cd31-5901-4687-a106-6d1c7734ee3a	8a0b1f23-f912-4b35-828b-83d3a7aa28bb
368	368	0	GBIF Germany	4f6826f2-4ff6-443d-b966-e6913bd24013	8a3c5fa6-f762-11e1-a439-00145eb45e9a
85	85	0	Plazi	ffb07bec-2d10-492d-9c37-361fe0b79427	8bc1819c-b047-44a1-86f1-eb7ae63b94ec
748	748	0	Taiwan Biodiversity Information Facility	e1b85abc-61f9-430f-ba79-6813dec53a0f	8bed2129-8839-4141-a06f-455b5ce654cc
0	5	5	Plazi	ffb07bec-2d10-492d-9c37-361fe0b79427	8e434587-b145-47ef-9b35-fa3a130798a3
29	21	-8	GBIF Germany	4f6826f2-4ff6-443d-b966-e6913bd24013	8f3be5da-f762-11e1-a439-00145eb45e9a
23	13	-10	GBIF Germany	4f6826f2-4ff6-443d-b966-e6913bd24013	90014e06-f762-11e1-a439-00145eb45e9a
174	104	-70	GBIF Germany	4f6826f2-4ff6-443d-b966-e6913bd24013	905f7bb6-f762-11e1-a439-00145eb45e9a
1120	826	-294	GBIF Germany	4f6826f2-4ff6-443d-b966-e6913bd24013	9068c5c2-f762-11e1-a439-00145eb45e9a
675	675	0	GBIF Germany	4f6826f2-4ff6-443d-b966-e6913bd24013	909b2742-f762-11e1-a439-00145eb45e9a
157	139	-18	GBIF Germany	4f6826f2-4ff6-443d-b966-e6913bd24013	90b3d012-f762-11e1-a439-00145eb45e9a
139	123	-16	GBIF Germany	4f6826f2-4ff6-443d-b966-e6913bd24013	90de89ec-f762-11e1-a439-00145eb45e9a
10	10	0	Plazi	ffb07bec-2d10-492d-9c37-361fe0b79427	910324ed-fea3-40bd-afa2-fdd11875813b
34	31	-3	GBIF Germany	4f6826f2-4ff6-443d-b966-e6913bd24013	910f8416-f762-11e1-a439-00145eb45e9a
83	78	-5	GBIF Germany	4f6826f2-4ff6-443d-b966-e6913bd24013	93113926-f762-11e1-a439-00145eb45e9a
40	40	0	Ocean Biodiversity Information System	ba0670b9-4186-41e6-8e70-f9cb3065551a	94111134-ee88-449f-a86f-e940943b5516
6084	6084	0	National Biodiversity Network	d897a5b9-35ee-4232-94bd-b0bcaac003c2	942c4e36-624d-4054-a6cd-b7db0b24926a
383	368	-15	GBIF Germany	4f6826f2-4ff6-443d-b966-e6913bd24013	945525fe-f762-11e1-a439-00145eb45e9a
168	151	-17	GBIF Germany	4f6826f2-4ff6-443d-b966-e6913bd24013	945a450c-f762-11e1-a439-00145eb45e9a
274350	274350	0	National Biodiversity Network	d897a5b9-35ee-4232-94bd-b0bcaac003c2	952538f5-e8cc-4f95-a01a-919db91ae6ae
229	229	0	GBIF Germany	4f6826f2-4ff6-443d-b966-e6913bd24013	955043ee-f762-11e1-a439-00145eb45e9a
78	78	0	GBIF Germany	4f6826f2-4ff6-443d-b966-e6913bd24013	958f1862-f762-11e1-a439-00145eb45e9a
534	534	0	Atlas of Living Australia	4a6f1b71-969e-4fc5-a693-282b05e1220c	95deedf6-f762-11e1-a439-00145eb45e9a
78930	78930	0	GBIF Spain	1f94b3ca-9345-4d65-afe2-4bace93aa0fe	962cceea-f762-11e1-a439-00145eb45e9a
157	157	0	Biodiversity Information System of Mexico	b324e8e9-9a4c-44fa-8f1a-7f39ea7ab576	965dc6eb-5ce6-4b8f-9bb8-29dcdc768198
20222	21100	878	GBIF Germany	4f6826f2-4ff6-443d-b966-e6913bd24013	965e401a-f762-11e1-a439-00145eb45e9a
0	147	147	Colombian Biodiversity Information System	7e865cba-7c46-417b-ade5-97f2cf5b7be0	994fdb1f-7d55-4ad2-92f2-86b7c61acdbe
4470	4470	0	Atlas of Living Australia	4a6f1b71-969e-4fc5-a693-282b05e1220c	9a10be01-3d0c-4f6e-9811-0627bd7a210d
7	7	0	Plazi	ffb07bec-2d10-492d-9c37-361fe0b79427	9b248674-2a60-4494-b821-08de7b338098
38	38	0	Plazi	ffb07bec-2d10-492d-9c37-361fe0b79427	9be44e7f-6ff4-4cf9-ab42-18418ebc28e5
0	156	156	GBIF Japan	db5705aa-6a6e-42f1-8942-d77b9f4896ea	9d9cbfe0-7d01-4e98-8135-6a2027d91c6e
31	31	0	Colombian Biodiversity Information System	7e865cba-7c46-417b-ade5-97f2cf5b7be0	9ed54dc7-3a1a-438c-882f-2ff8efbab9b4
289	289	0	Plazi	ffb07bec-2d10-492d-9c37-361fe0b79427	9f63aafe-4b6d-402b-aae1-602c2c83c1f4
2366	2366	0	GBIF Argentina	2426a871-9feb-40a1-96c6-0c593a76b835	a0d072fc-e6be-45d7-9fa8-afa4b38b788a
5	5	0	Plazi	ffb07bec-2d10-492d-9c37-361fe0b79427	a2552251-a095-4c67-88f7-c8ddcda76f91
205	205	0	Colombian Biodiversity Information System	7e865cba-7c46-417b-ade5-97f2cf5b7be0	a38c4b7c-4f02-4891-9655-607391a9288b
2	2	0	Plazi	ffb07bec-2d10-492d-9c37-361fe0b79427	aa402c82-b500-429a-966f-f297120019b6
135	135	0	GBIF Norway	4f829580-180d-46a9-9c87-ed8ec959b545	aa49854a-c4bb-49b3-baec-3f5f2cf57f49
8	8	0	Participant Node Managers Committee	7f48e0c8-5c96-49ec-b972-30748e339115	abc084cd-d0b4-420a-98f9-4df66c867326
1960	2668	708	GBIF Japan	db5705aa-6a6e-42f1-8942-d77b9f4896ea	aebd3dab-0a7c-4bd7-b08c-397a462cbd67
0	6	6	Plazi	ffb07bec-2d10-492d-9c37-361fe0b79427	b59531a3-ea4c-4324-a410-314f4cc5e56a
70	70	0	U.S. Geological Survey	8618c64a-93e0-4300-b546-7249e5148ed2	b670713e-c880-4d23-86d3-f689a207c5a1
644	644	0	GBIF Germany	4f6826f2-4ff6-443d-b966-e6913bd24013	bb43a3f3-afaf-427e-8b6b-2d37633bfa72
0	4	4	Plazi	ffb07bec-2d10-492d-9c37-361fe0b79427	bfd25ea4-72d4-4089-b954-6ba5755638e8
0	109	109	Plazi	ffb07bec-2d10-492d-9c37-361fe0b79427	c19d6b36-e361-4626-b48c-da9c7ff654ff
1402	1402	0	GBIF Madagascar	2dbfc5c5-51b5-4494-9dfc-4d3f013a3b64	c3caca74-616b-4bad-b795-b13adff022de
12897	12897	0	GBIF France	da44cd31-5901-4687-a106-6d1c7734ee3a	c50e8f9e-a554-4e94-a015-bc1e8556a56e
0	60	60	Ocean Biodiversity Information System	ba0670b9-4186-41e6-8e70-f9cb3065551a	c5d418cd-e8b4-4a8f-af5e-3ed71e4954db
6081	6081	0	U.S. Geological Survey	8618c64a-93e0-4300-b546-7249e5148ed2	c62f7574-d65a-4018-87a2-b96d6df5231b
59	59	0	Plazi	ffb07bec-2d10-492d-9c37-361fe0b79427	cafdc21f-367c-4abc-b93c-bf4338483003
15866	15866	0	Biodiversity Information System of Mexico	b324e8e9-9a4c-44fa-8f1a-7f39ea7ab576	cb7133d4-79c5-4f74-88f5-ada473019c89
13372	25229	11857	National Biodiversity Network	d897a5b9-35ee-4232-94bd-b0bcaac003c2	cb7c2913-e387-4fbe-9e57-a2f24ed3d88c
656	654	-2	Atlas of Living Australia	4a6f1b71-969e-4fc5-a693-282b05e1220c	d1b99d30-ca95-4c1e-8acf-47d4059941c5
873	873	0	GBIF France	da44cd31-5901-4687-a106-6d1c7734ee3a	d1ba242f-41dd-4395-b658-7e899a795290
41	41	0	Plazi	ffb07bec-2d10-492d-9c37-361fe0b79427	d437a359-127b-4cdd-b62f-f206bb09a0d4
2	2	0	Plazi	ffb07bec-2d10-492d-9c37-361fe0b79427	d4412f0d-14ed-453b-92c7-6a2728b77622
0	11	11	Plazi	ffb07bec-2d10-492d-9c37-361fe0b79427	d53f1487-c241-4344-ad32-06d99e7fafa4
0	5	5	Ocean Biodiversity Information System	ba0670b9-4186-41e6-8e70-f9cb3065551a	d8a9c34a-28bc-4960-ad71-ac779a059192
3415	3415	0	GBIF Germany	4f6826f2-4ff6-443d-b966-e6913bd24013	d8ee1839-f1f6-40e0-9326-5388018ee1e0
618	618	0	National Biodiversity Network	d897a5b9-35ee-4232-94bd-b0bcaac003c2	dbfff627-d667-4757-92a4-467738829091
812	812	0	GBIF Togo	c9659a3e-07e9-4fcb-83c6-de8b9009a02e	dc71de84-18ce-4518-b8ce-f946a5683abe
0	2	2	Plazi	ffb07bec-2d10-492d-9c37-361fe0b79427	ddaa8e80-1a10-4d76-827f-41c99f1f8ac1
6	6	0	Plazi	ffb07bec-2d10-492d-9c37-361fe0b79427	de0475aa-454d-4810-92c8-0c1ac9b3e4b4
192	78	-114	GBIF Germany	4f6826f2-4ff6-443d-b966-e6913bd24013	df24614a-3947-4ef4-bc6b-9f7a3ed98a2d
157077	157077	0	GBIF France	da44cd31-5901-4687-a106-6d1c7734ee3a	e0916f8b-b9ed-401a-8353-064a3859871a
4	4	0	Plazi	ffb07bec-2d10-492d-9c37-361fe0b79427	e097ed46-4a65-48d6-82c1-59ac4ec12856
397	397	0	Atlas of Living Australia	4a6f1b71-969e-4fc5-a693-282b05e1220c	e1480c09-abba-450f-a251-e7f298c9ef0c
113037	117017	3980	GBIF Brazil	cdc9736d-5ff7-4ece-9959-3c744360cdb3	e38d4c95-3a1d-4594-9ae9-883b48042e6d
421	421	0	GBIF Germany	4f6826f2-4ff6-443d-b966-e6913bd24013	e907c7f8-92ad-429b-bf5b-75b27dc638c9
3487	3487	0	Netherlands Biodiversity Information Facility	0909d601-bda2-42df-9e63-a6d51847ebce	ea752618-a6b7-43da-a5f2-a49bf9cca447
0	4	4	Plazi	ffb07bec-2d10-492d-9c37-361fe0b79427	ee7b97d6-8540-44e8-a014-43f00dc25421
14998	14998	0	National Biodiversity Network	d897a5b9-35ee-4232-94bd-b0bcaac003c2	ef5a720b-7e4b-4f3e-b73c-dd248cb09ae6
1652	1652	0	Participant Node Managers Committee	7f48e0c8-5c96-49ec-b972-30748e339115	f35e8bd6-f9fa-45b5-b78c-981bc13cb452
671	671	0	Participant Node Managers Committee	7f48e0c8-5c96-49ec-b972-30748e339115	f7fddf02-6238-4a44-bb5f-5f375e879396
15	15	0	Colombian Biodiversity Information System	7e865cba-7c46-417b-ade5-97f2cf5b7be0	fa63de55-7e0e-4783-b8e3-02f4d04c460f
34	34	0	Plazi	ffb07bec-2d10-492d-9c37-361fe0b79427	fcc67b83-24e3-4169-868c-070b670a1633
2	2	0	Plazi	ffb07bec-2d10-492d-9c37-361fe0b79427	fe597a14-c52d-475b-b151-d9fda89fd971
142	142	0	Colombian Biodiversity Information System	7e865cba-7c46-417b-ade5-97f2cf5b7be0	02aeca0a-7e26-416d-b6d6-924807d0112c
14	13	-1	Plazi	ffb07bec-2d10-492d-9c37-361fe0b79427	05d283a0-be09-4d7f-9665-d58c2f1dd17f
0	844	844	U.S. Geological Survey	8618c64a-93e0-4300-b546-7249e5148ed2	08ed4a7c-2948-48d1-98f1-8e395d8a5626
0	1	1	Plazi	ffb07bec-2d10-492d-9c37-361fe0b79427	097b313e-80f9-422d-9d47-e5117fcc8cd0
4	4	0	Plazi	ffb07bec-2d10-492d-9c37-361fe0b79427	0b4a8b73-a169-422d-ba3d-f729c8908393
0	108	108	Colombian Biodiversity Information System	7e865cba-7c46-417b-ade5-97f2cf5b7be0	0d055e8f-d1be-43dd-be4b-f44b53605554
49	49	0	Plazi	ffb07bec-2d10-492d-9c37-361fe0b79427	0d57ca15-640d-4d6f-82ef-b1429e8b5d30
49302	49302	0	U.S. Geological Survey	8618c64a-93e0-4300-b546-7249e5148ed2	0df1ebee-0ce6-4fe1-9cd7-ee959670a880
9105	9105	0	GBIF Japan	db5705aa-6a6e-42f1-8942-d77b9f4896ea	0e65f3e6-a632-435f-b188-0001c2a4eeed
25	25	0	Colombian Biodiversity Information System	7e865cba-7c46-417b-ade5-97f2cf5b7be0	0f5e6928-1fd2-4856-9c40-e800fe93fb05
2	2	0	Plazi	ffb07bec-2d10-492d-9c37-361fe0b79427	10e32262-231f-4c42-b49d-0e5102296aad
27	27	0	Plazi	ffb07bec-2d10-492d-9c37-361fe0b79427	11072bc9-3aee-4d3b-872c-20d43a79fd14
60	60	0	Plazi	ffb07bec-2d10-492d-9c37-361fe0b79427	16138ece-e897-47f9-a3e7-7bece81dde92
0	38	38	Plazi	ffb07bec-2d10-492d-9c37-361fe0b79427	1669cf22-caeb-4a3f-9a49-1c96af9f70cd
1925	1925	0	Colombian Biodiversity Information System	7e865cba-7c46-417b-ade5-97f2cf5b7be0	17a8203e-9d1b-4d70-86e0-f55ea53148b1
84	84	0	GBIF Brazil	cdc9736d-5ff7-4ece-9959-3c744360cdb3	19e4a33b-f5bd-48d7-9b14-c256c33ef622
2931	2931	0	Colombian Biodiversity Information System	7e865cba-7c46-417b-ade5-97f2cf5b7be0	1b5afc19-0494-486b-bbb1-334cc575cd8c
0	3	3	Plazi	ffb07bec-2d10-492d-9c37-361fe0b79427	1d17a387-d55f-4a0d-8a98-e66b817981d8
0	214	214	Participant Node Managers Committee	7f48e0c8-5c96-49ec-b972-30748e339115	1db99bb6-d0b2-48b3-aab9-ed9ff95736c4
0	4	4	Plazi	ffb07bec-2d10-492d-9c37-361fe0b79427	1dbdaf6f-38fa-4b3d-8cb0-b265a5793b53
58	59	1	GBIF Japan	db5705aa-6a6e-42f1-8942-d77b9f4896ea	1ec5afb1-f680-4a4e-8a21-ac0cbe7b8555
0	154	154	Colombian Biodiversity Information System	7e865cba-7c46-417b-ade5-97f2cf5b7be0	1f0d880e-6bb1-4db4-a5aa-5b6af9be6917
0	9	9	Ocean Biodiversity Information System	ba0670b9-4186-41e6-8e70-f9cb3065551a	1ffd6c47-a814-43e6-b4d5-7eabf86c6a6f
46	46	0	GBIF France	da44cd31-5901-4687-a106-6d1c7734ee3a	2171763b-4d77-44d0-9a15-55a1e5075ac3
588	588	0	National Biodiversity Network	d897a5b9-35ee-4232-94bd-b0bcaac003c2	241f9bd4-613e-4050-9fe0-2ff44b526c84
46	46	0	Colombian Biodiversity Information System	7e865cba-7c46-417b-ade5-97f2cf5b7be0	24809ee9-fb7b-4063-b456-de15ceb0f6cc
153	153	0	GBIF France	da44cd31-5901-4687-a106-6d1c7734ee3a	24ccf6cd-06d8-479b-8f5a-e0d04ccf357b
0	2	2	Plazi	ffb07bec-2d10-492d-9c37-361fe0b79427	2593a8b2-8a13-4fe0-b5b8-58ea4834527a
0	15	15	Plazi	ffb07bec-2d10-492d-9c37-361fe0b79427	27192ddf-c776-48d7-946d-f070ac745b16
96	96	0	Plazi	ffb07bec-2d10-492d-9c37-361fe0b79427	2719d968-2e75-4336-8e59-4c9563abdda2
6253	6253	0	South African Biodiversity Information Facility	7190b835-4e86-4b6e-85c1-19cc6677c250	2a47dd25-4813-4d3c-99c1-1bc1aeb774e7
7	7	0	Plazi	ffb07bec-2d10-492d-9c37-361fe0b79427	2bb49461-0000-4c5b-990a-87be06e6b326
0	870	870	Ocean Biodiversity Information System	ba0670b9-4186-41e6-8e70-f9cb3065551a	2c308770-2fa2-4c66-b037-ae9fa541d6e1
0	3	3	Colombian Biodiversity Information System	7e865cba-7c46-417b-ade5-97f2cf5b7be0	2e7202d8-1ce3-4804-a71d-21146b307f1b
1343	1343	0	Belgian Biodiversity Platform	fb11cfe1-ebc3-45af-9159-17d9fddbcdac	2f0949ed-75b5-4f87-9f4a-d9334e626cc7
14	14	0	Plazi	ffb07bec-2d10-492d-9c37-361fe0b79427	30956fae-db23-4a2e-bd80-198d2d318ce1
420	420	0	GBIF Germany	4f6826f2-4ff6-443d-b966-e6913bd24013	34978c2e-283e-4b97-bfaa-4cce35b8e755
0	159	159	Plazi	ffb07bec-2d10-492d-9c37-361fe0b79427	35e4955b-cf10-4af1-8725-044f94ecbbee
0	750	750	Ocean Biodiversity Information System	ba0670b9-4186-41e6-8e70-f9cb3065551a	374e0dc1-7127-4fda-9cc8-3a8defb8a46e
0	2	2	Plazi	ffb07bec-2d10-492d-9c37-361fe0b79427	385bfd7f-81ee-4812-b8a8-19dc9febd42a
0	1301	1301	Ocean Biodiversity Information System	ba0670b9-4186-41e6-8e70-f9cb3065551a	38def95c-1358-4645-a4af-b27dc32e974c
892	892	0	GBIF France	da44cd31-5901-4687-a106-6d1c7734ee3a	3aa0e2d9-e615-46fe-8868-0f7a938f5f6d
0	3	3	Plazi	ffb07bec-2d10-492d-9c37-361fe0b79427	3b373ab6-428a-447d-85ec-b132dd0c4104
780	780	0	National Biodiversity Network	d897a5b9-35ee-4232-94bd-b0bcaac003c2	3d2df5ad-fd25-4613-8643-fb5a47f96ff2
1	1	0	Plazi	ffb07bec-2d10-492d-9c37-361fe0b79427	3f408745-c0ca-4466-b094-2aed542e6adf
0	180	180	Ocean Biodiversity Information System	ba0670b9-4186-41e6-8e70-f9cb3065551a	3f737eb2-4d36-4614-9dc9-6b0ef3483cec
101	101	0	GBIF France	da44cd31-5901-4687-a106-6d1c7734ee3a	4023704c-4363-4064-9ce7-fff06176e15d
2789	2789	0	GBIF Brazil	cdc9736d-5ff7-4ece-9959-3c744360cdb3	4140cabb-6d7d-4155-8a00-9dfb0bfde61d
17	17	0	Participant Node Managers Committee	7f48e0c8-5c96-49ec-b972-30748e339115	44d7b5dd-7543-4b62-b816-393ce983e0db
244	244	0	GBIF Guinea	b1cd2e84-c4ba-47bd-b72a-dfd1f92dce0a	45147e3c-564b-437f-8d8b-b19bbcda1ac0
38	38	0	Ocean Biodiversity Information System	ba0670b9-4186-41e6-8e70-f9cb3065551a	45adf020-a40b-4530-bbc0-0242daa4bd6c
231	231	0	GBIF France	da44cd31-5901-4687-a106-6d1c7734ee3a	4c1d3973-898b-40ca-ac5a-4bf87e19d4cc
0	1073	1073	GBIF Madagascar	2dbfc5c5-51b5-4494-9dfc-4d3f013a3b64	4e11d715-c5ac-4669-a901-86e3852b11ed
0	37	37	Ocean Biodiversity Information System	ba0670b9-4186-41e6-8e70-f9cb3065551a	4e45d544-1d1a-4b13-8770-3c6ef6715a2e
11712	11712	0	Participant Node Managers Committee	7f48e0c8-5c96-49ec-b972-30748e339115	50676f2a-d7d7-4aad-b455-b8d96c76f810
0	15	15	Plazi	ffb07bec-2d10-492d-9c37-361fe0b79427	534707d0-b2c5-4ea8-9e31-e20740837249
66346	33173	-33173	Belgian Biodiversity Platform	fb11cfe1-ebc3-45af-9159-17d9fddbcdac	570489ac-e114-4a17-9340-2e01ee7d9ee3
3998	3998	0	Biodiversity Information System of Mexico	b324e8e9-9a4c-44fa-8f1a-7f39ea7ab576	5719db5a-b15f-4dad-9a11-6cde70b5ed0e
1	1	0	Plazi	ffb07bec-2d10-492d-9c37-361fe0b79427	5777827c-bb53-4ce8-9a08-061a7a08c53c
3636	3636	0	National Biodiversity Network	d897a5b9-35ee-4232-94bd-b0bcaac003c2	58aa0748-bdac-458f-99f6-cf39f2e15bc5
0	5	5	Plazi	ffb07bec-2d10-492d-9c37-361fe0b79427	5939adb6-7a25-4db8-a4b4-b2bb5604e0a2
17943	17943	0	Participant Node Managers Committee	7f48e0c8-5c96-49ec-b972-30748e339115	5a0e9dc9-d2b0-489e-91b6-c1e2aca0d62c
0	3	3	Plazi	ffb07bec-2d10-492d-9c37-361fe0b79427	5cb7a045-bc5c-4a69-a56b-f31fcb30b9fa
66	66	0	GBIF Germany	4f6826f2-4ff6-443d-b966-e6913bd24013	5d5fe7b9-62b6-4781-91a2-64b0c8a733e6
3677	3677	0	National Biodiversity Network	d897a5b9-35ee-4232-94bd-b0bcaac003c2	613a29fb-deb0-40af-b579-3613d108cbe5
183	183	0	GBIF Germany	4f6826f2-4ff6-443d-b966-e6913bd24013	61aec72c-f762-11e1-a439-00145eb45e9a
0	3	3	Plazi	ffb07bec-2d10-492d-9c37-361fe0b79427	62fcaba7-8713-4730-b59b-cf7043f6fb87
13	13	0	GBIF Germany	4f6826f2-4ff6-443d-b966-e6913bd24013	630af5a0-f762-11e1-a439-00145eb45e9a
17	17	0	GBIF Germany	4f6826f2-4ff6-443d-b966-e6913bd24013	632b49ae-f762-11e1-a439-00145eb45e9a
5	5	0	GBIF Germany	4f6826f2-4ff6-443d-b966-e6913bd24013	634e9e18-f762-11e1-a439-00145eb45e9a
0	71	71	Ocean Biodiversity Information System	ba0670b9-4186-41e6-8e70-f9cb3065551a	63e5ff69-2c02-4857-994e-53c6e3856b69
0	2554	2554	U.S. Geological Survey	8618c64a-93e0-4300-b546-7249e5148ed2	63e94464-7907-423e-b5f1-8b1147c7f23d
106	106	0	GBIF Germany	4f6826f2-4ff6-443d-b966-e6913bd24013	640eab72-f762-11e1-a439-00145eb45e9a
146	146	0	GBIF Germany	4f6826f2-4ff6-443d-b966-e6913bd24013	647e92fc-f762-11e1-a439-00145eb45e9a
35	35	0	Plazi	ffb07bec-2d10-492d-9c37-361fe0b79427	64b46fbc-ecdd-4dde-96cf-548d9d74b08c
5	5	0	Plazi	ffb07bec-2d10-492d-9c37-361fe0b79427	64ecf750-0843-4e43-9400-2f9a3f37ce9b
290	290	0	GBIF France	da44cd31-5901-4687-a106-6d1c7734ee3a	64fa4bd3-555f-4b9d-a5be-6e4dd8ccdd34
1696	1696	0	GBIF Germany	4f6826f2-4ff6-443d-b966-e6913bd24013	655f2056-f762-11e1-a439-00145eb45e9a
109	91	-18	GBIF Germany	4f6826f2-4ff6-443d-b966-e6913bd24013	65dd0282-f762-11e1-a439-00145eb45e9a
115	115	0	GBIF Germany	4f6826f2-4ff6-443d-b966-e6913bd24013	671b07fc-f762-11e1-a439-00145eb45e9a
6969	6969	0	GBIF Norway	4f829580-180d-46a9-9c87-ed8ec959b545	67780c67-2157-4809-8b51-0b47a7ae8d3b
160	160	0	GBIF Germany	4f6826f2-4ff6-443d-b966-e6913bd24013	67932d40-f762-11e1-a439-00145eb45e9a
1	1	0	Plazi	ffb07bec-2d10-492d-9c37-361fe0b79427	67d90a4f-f853-4561-ae9a-c0f596d948ca
110	110	0	GBIF Japan	db5705aa-6a6e-42f1-8942-d77b9f4896ea	67eb5744-0b46-4fb3-96e3-4528ea9eca87
101	101	0	GBIF Germany	4f6826f2-4ff6-443d-b966-e6913bd24013	689f60c8-f762-11e1-a439-00145eb45e9a
49	49	0	GBIF Germany	4f6826f2-4ff6-443d-b966-e6913bd24013	69430246-f762-11e1-a439-00145eb45e9a
3	3	0	Plazi	ffb07bec-2d10-492d-9c37-361fe0b79427	6994309f-b9aa-4a68-a050-f8fa43a63ada
12869	12869	0	Biodiversity Information System of Mexico	b324e8e9-9a4c-44fa-8f1a-7f39ea7ab576	6a3354dd-636d-4ac4-ab34-b5fb3912c9d3
16	16	0	Plazi	ffb07bec-2d10-492d-9c37-361fe0b79427	6a994e4b-2dd0-455f-8380-f7bfdcbaae68
8	8	0	GBIF Germany	4f6826f2-4ff6-443d-b966-e6913bd24013	6bfac492-f762-11e1-a439-00145eb45e9a
201	201	0	GBIF Germany	4f6826f2-4ff6-443d-b966-e6913bd24013	6c30efae-f762-11e1-a439-00145eb45e9a
29	29	0	GBIF Germany	4f6826f2-4ff6-443d-b966-e6913bd24013	6cb89b7a-f762-11e1-a439-00145eb45e9a
237	237	0	GBIF Germany	4f6826f2-4ff6-443d-b966-e6913bd24013	6ddcf9f6-f762-11e1-a439-00145eb45e9a
7	7	0	Plazi	ffb07bec-2d10-492d-9c37-361fe0b79427	6fd99cca-afd1-4289-9fce-2e4e43e33a1b
3	3	0	Plazi	ffb07bec-2d10-492d-9c37-361fe0b79427	707b0d75-86cc-4ddf-a776-608137fc4745
39	38	-1	GBIF Germany	4f6826f2-4ff6-443d-b966-e6913bd24013	7114a1b4-f762-11e1-a439-00145eb45e9a
77	77	0	GBIF Germany	4f6826f2-4ff6-443d-b966-e6913bd24013	714e00c6-f762-11e1-a439-00145eb45e9a
319	319	0	Plazi	ffb07bec-2d10-492d-9c37-361fe0b79427	7158d7e5-8d0c-4e38-a630-30e42571efa2
13	13	0	GBIF Germany	4f6826f2-4ff6-443d-b966-e6913bd24013	72997f64-f762-11e1-a439-00145eb45e9a
17	17	0	GBIF Germany	4f6826f2-4ff6-443d-b966-e6913bd24013	7396fb62-f762-11e1-a439-00145eb45e9a
27	27	0	GBIF Germany	4f6826f2-4ff6-443d-b966-e6913bd24013	73c84f96-f762-11e1-a439-00145eb45e9a
2331	2331	0	GBIF France	da44cd31-5901-4687-a106-6d1c7734ee3a	73e53bc1-e503-4d9f-9b51-c2444159e77e
11	11	0	GBIF Germany	4f6826f2-4ff6-443d-b966-e6913bd24013	7413f356-f762-11e1-a439-00145eb45e9a
43	43	0	GBIF Germany	4f6826f2-4ff6-443d-b966-e6913bd24013	749d5966-f762-11e1-a439-00145eb45e9a
0	72	72	Plazi	ffb07bec-2d10-492d-9c37-361fe0b79427	7520142c-7997-4b4b-ab12-f0513787c5cf
112	104	-8	GBIF Germany	4f6826f2-4ff6-443d-b966-e6913bd24013	756b8520-f762-11e1-a439-00145eb45e9a
149	149	0	GBIF Germany	4f6826f2-4ff6-443d-b966-e6913bd24013	75b8701a-f762-11e1-a439-00145eb45e9a
8	8	0	Participant Node Managers Committee	7f48e0c8-5c96-49ec-b972-30748e339115	75f62205-c7bb-40ac-9a90-3e3d696e2c7f
19	19	0	GBIF Germany	4f6826f2-4ff6-443d-b966-e6913bd24013	7847a67a-f762-11e1-a439-00145eb45e9a
486	486	0	GBIF Germany	4f6826f2-4ff6-443d-b966-e6913bd24013	786ac330-f762-11e1-a439-00145eb45e9a
39	33	-6	GBIF Germany	4f6826f2-4ff6-443d-b966-e6913bd24013	796cda8e-f762-11e1-a439-00145eb45e9a
3	3	0	GBIF Germany	4f6826f2-4ff6-443d-b966-e6913bd24013	7a8f4f64-f762-11e1-a439-00145eb45e9a
5995	5995	0	Korean Biodiversity Information Facility	e0a1e772-0177-4800-94b4-2d023fe6cdf4	7afddff6-f762-11e1-a439-00145eb45e9a
0	1	1	Plazi	ffb07bec-2d10-492d-9c37-361fe0b79427	7b02580f-2b80-42c7-b656-d95f4529e4e6
1026	1026	0	Biodiversity Information System of Mexico	b324e8e9-9a4c-44fa-8f1a-7f39ea7ab576	7ba21217-49f0-40be-8f6c-cdee8916e50d
5074	5078	4	GBIF Germany	4f6826f2-4ff6-443d-b966-e6913bd24013	7e74fb2e-f762-11e1-a439-00145eb45e9a
833	715	-118	Biodiversity Information System of Mexico	b324e8e9-9a4c-44fa-8f1a-7f39ea7ab576	803aa7c4-f762-11e1-a439-00145eb45e9a
46933	46933	0	DanBIF - Danish Biodiversity Information Facility	4ddd294f-02b7-4359-ac33-0806a9ca9c6b	84d13eba-f762-11e1-a439-00145eb45e9a
2243034	2239149	-3885	GBIF Austria	1e789bc9-79fc-4e60-a49e-89dfc45a7188	857bce66-f762-11e1-a439-00145eb45e9a
0	2	2	Plazi	ffb07bec-2d10-492d-9c37-361fe0b79427	86d71572-9cbe-48f8-a19f-dd61822d21d8
6118	6118	0	National Biodiversity Data Centre	422b00b2-6c94-4bb6-976b-c359916efdb8	871e534e-561d-4b32-93cf-c5ae0c5542c4
6	6	0	Plazi	ffb07bec-2d10-492d-9c37-361fe0b79427	884a65c3-a7f0-46bb-8018-8f930c0e73d0
126031	126031	0	U.S. Geological Survey	8618c64a-93e0-4300-b546-7249e5148ed2	88e38292-f762-11e1-a439-00145eb45e9a
10	10	0	GBIF Germany	4f6826f2-4ff6-443d-b966-e6913bd24013	8c6b953a-f762-11e1-a439-00145eb45e9a
29675	29675	0	Atlas of Living Australia	4a6f1b71-969e-4fc5-a693-282b05e1220c	8c748691-6253-43fc-a851-86da40fa0021
25	20	-5	GBIF Germany	4f6826f2-4ff6-443d-b966-e6913bd24013	8cb05698-f762-11e1-a439-00145eb45e9a
91	57	-34	GBIF Germany	4f6826f2-4ff6-443d-b966-e6913bd24013	90352ce4-f762-11e1-a439-00145eb45e9a
0	2	2	Ocean Biodiversity Information System	ba0670b9-4186-41e6-8e70-f9cb3065551a	9047d4f5-5bfc-4125-8961-1d6e68d5d85b
2	2	0	Plazi	ffb07bec-2d10-492d-9c37-361fe0b79427	909beb46-0ff4-4acd-8efa-539ec08d1f98
132	107	-25	GBIF Germany	4f6826f2-4ff6-443d-b966-e6913bd24013	90b52b74-f762-11e1-a439-00145eb45e9a
13590	13590	0	GBIF Argentina	2426a871-9feb-40a1-96c6-0c593a76b835	911d5a2c-7959-425d-a066-ff0816af4f58
19	17	-2	GBIF Germany	4f6826f2-4ff6-443d-b966-e6913bd24013	91547d96-f762-11e1-a439-00145eb45e9a
238	174	-64	GBIF Germany	4f6826f2-4ff6-443d-b966-e6913bd24013	915729f6-f762-11e1-a439-00145eb45e9a
132	132	0	GBIF Germany	4f6826f2-4ff6-443d-b966-e6913bd24013	92bdd61e-f762-11e1-a439-00145eb45e9a
3	3	0	Plazi	ffb07bec-2d10-492d-9c37-361fe0b79427	94987553-aa5d-4444-a739-c8ff9bf54d30
116	116	0	GBIF Germany	4f6826f2-4ff6-443d-b966-e6913bd24013	94fdab98-f762-11e1-a439-00145eb45e9a
359952	379748	19796	U.S. Geological Survey	8618c64a-93e0-4300-b546-7249e5148ed2	96404cc2-f762-11e1-a439-00145eb45e9a
1349	1349	0	Atlas of Living Australia	4a6f1b71-969e-4fc5-a693-282b05e1220c	96d36be8-f65b-4bce-ac40-05ad8cadc9a1
299	299	0	GBIF Portugal	673f7038-4262-4149-b753-5658a4e912f6	975ffa13-5bd1-4f35-8e76-558da425c50a
10	10	0	Atlas of Living Australia	4a6f1b71-969e-4fc5-a693-282b05e1220c	9940b3a6-32a4-4f00-815e-f8492bd64a0e
0	10	10	Plazi	ffb07bec-2d10-492d-9c37-361fe0b79427	9a3c7406-d4a1-4480-af4b-413daed3c500
2	2	0	Plazi	ffb07bec-2d10-492d-9c37-361fe0b79427	9a9d34ed-1eea-499b-b688-432e911e9ecc
0	35	35	Plazi	ffb07bec-2d10-492d-9c37-361fe0b79427	9cac9b98-c0aa-4d24-924f-d4c97c9ca3f0
1298	1298	0	U.S. Geological Survey	8618c64a-93e0-4300-b546-7249e5148ed2	9d943d7e-f74c-464d-a723-7d20266191ce
13382	13382	0	GBIF France	da44cd31-5901-4687-a106-6d1c7734ee3a	a578b33b-72f6-4833-a3eb-45d61f79f091
46316	46316	0	National Biodiversity Network	d897a5b9-35ee-4232-94bd-b0bcaac003c2	a6237568-a96b-4518-b474-6d8d23c02a33
3	3	0	Plazi	ffb07bec-2d10-492d-9c37-361fe0b79427	a66914d6-580e-4a78-9ff5-ce9cf1849d38
0	24	24	Ocean Biodiversity Information System	ba0670b9-4186-41e6-8e70-f9cb3065551a	a69d774c-30b4-40e0-bc01-26f93250db36
24348	24348	0	U.S. Geological Survey	8618c64a-93e0-4300-b546-7249e5148ed2	aa1d8785-b68f-4000-8b5c-f3545b3132bc
411	411	0	GBIF Spain	1f94b3ca-9345-4d65-afe2-4bace93aa0fe	ae1de9ab-5578-47ef-93ae-f9df824930d3
0	1	1	Plazi	ffb07bec-2d10-492d-9c37-361fe0b79427	ae6d3266-5931-47bf-8faa-87f527891cf2
10189	10189	0	Belgian Biodiversity Platform	fb11cfe1-ebc3-45af-9159-17d9fddbcdac	b0cb000d-9381-4881-98d9-1594acf59c89
30	30	0	Plazi	ffb07bec-2d10-492d-9c37-361fe0b79427	b6585cfc-c17a-44de-be3e-2b79c16eb073
5	5	0	Plazi	ffb07bec-2d10-492d-9c37-361fe0b79427	b73ebab8-3acc-4900-b261-bbf713145f24
626	626	0	GBIF Norway	4f829580-180d-46a9-9c87-ed8ec959b545	b80a8d39-2e0e-4ae4-91e4-03ee6dc9d1bc
0	2331595	2331595	Ocean Biodiversity Information System	ba0670b9-4186-41e6-8e70-f9cb3065551a	b86fe411-8e62-4cd0-aab2-914d75401598
17	17	0	Plazi	ffb07bec-2d10-492d-9c37-361fe0b79427	bccd45b6-bfa1-4c38-8ce7-51c16e870016
0	3	3	Plazi	ffb07bec-2d10-492d-9c37-361fe0b79427	bcdef727-af04-485e-af57-83d0c95ca7b8
2	2	0	Plazi	ffb07bec-2d10-492d-9c37-361fe0b79427	c16b18d9-fad7-4700-8f8e-a0e59272069c
0	380	380	Belgian Biodiversity Platform	fb11cfe1-ebc3-45af-9159-17d9fddbcdac	c2f595ea-eb1b-4c92-b059-fed7c925343c
426	426	0	GBIF Benin	efb9c00e-f802-45dd-8826-a52ec45b89ff	c58954ee-dd85-406a-a328-2cfe60c65145
0	11	11	Ocean Biodiversity Information System	ba0670b9-4186-41e6-8e70-f9cb3065551a	c842b054-639f-4257-b5d8-59c854eb9d09
896	896	0	GBIF Brazil	cdc9736d-5ff7-4ece-9959-3c744360cdb3	ca5ece39-358c-4dcf-8bb8-fa28601f1be6
14491	14491	0	National Biodiversity Network	d897a5b9-35ee-4232-94bd-b0bcaac003c2	cfdc396e-e414-4b4a-ac37-0909bbcaaf07
6187	6187	0	Atlas of Living Australia	4a6f1b71-969e-4fc5-a693-282b05e1220c	d073b090-c76b-4d0b-81db-874298cd7181
17	17	0	Plazi	ffb07bec-2d10-492d-9c37-361fe0b79427	d16134f0-f849-4630-9ac6-47abfdf3b4c9
13269	13269	0	GBIF France	da44cd31-5901-4687-a106-6d1c7734ee3a	d18935d7-260c-4633-af39-7eb7ee6f1e14
6757	6757	0	Colombian Biodiversity Information System	7e865cba-7c46-417b-ade5-97f2cf5b7be0	d21209bf-b1e0-4a97-9861-9868cb461786
8913	8913	0	Costa Rica Biodiversity Facility	3379bb09-1a58-41e7-9c57-e3b66c3eb5a0	d6fa86b9-8906-4622-9ebc-24d393c9ac12
115	115	0	Atlas of Living Australia	4a6f1b71-969e-4fc5-a693-282b05e1220c	d8d0c8e6-acc5-43cc-a694-1d69b610bc5b
170	170	0	GBIF Germany	4f6826f2-4ff6-443d-b966-e6913bd24013	d9c45240-9ebf-4c26-a15a-98006e553e63
170543	170588	45	GBIF Norway	4f829580-180d-46a9-9c87-ed8ec959b545	de2875e4-6f69-460a-b8c4-ead427afd53e
279	279	0	GBIF France	da44cd31-5901-4687-a106-6d1c7734ee3a	df589977-b6e4-4d5a-aae7-f90694d229ac
18	18	0	Plazi	ffb07bec-2d10-492d-9c37-361fe0b79427	e0032566-49ad-484b-a550-f38a2ac0a38a
0	2	2	Plazi	ffb07bec-2d10-492d-9c37-361fe0b79427	e2bcff06-8cc8-4b48-a493-647df31ce62f
16	16	0	GBIF France	da44cd31-5901-4687-a106-6d1c7734ee3a	e2fa8c75-4a07-4a8a-be2c-665996c53681
185	185	0	GBIF Japan	db5705aa-6a6e-42f1-8942-d77b9f4896ea	e314f3fc-ffd0-4a43-baa0-73d7a271e5f9
1	1	0	Plazi	ffb07bec-2d10-492d-9c37-361fe0b79427	e3f32e7c-45a7-458e-a3f0-81489f1c0eb7
14	14	0	Plazi	ffb07bec-2d10-492d-9c37-361fe0b79427	e59dba21-0be7-4025-b90c-4119d97b7ee0
5453	5453	0	GBIF France	da44cd31-5901-4687-a106-6d1c7734ee3a	e68f3119-bddd-4df6-849a-60aed2d76287
6	6	0	Plazi	ffb07bec-2d10-492d-9c37-361fe0b79427	e707b3fb-b235-4fca-94a0-ea0e1585d52a
0	1	1	Plazi	ffb07bec-2d10-492d-9c37-361fe0b79427	edf58463-0cf4-4326-b957-d9c93278b5fb
2	2	0	Plazi	ffb07bec-2d10-492d-9c37-361fe0b79427	f24b4ebb-c309-431f-996d-c677b5582202
6	6	0	Plazi	ffb07bec-2d10-492d-9c37-361fe0b79427	f2bcafba-1939-4b8c-88df-df99fd1b1323
0	215	215	Plazi	ffb07bec-2d10-492d-9c37-361fe0b79427	f4c5df5c-bfc2-427a-933a-59bd8530b0a7
0	11	11	Plazi	ffb07bec-2d10-492d-9c37-361fe0b79427	f8e774a8-36c4-482c-8d53-adc4612ea281
90	90	0	Plazi	ffb07bec-2d10-492d-9c37-361fe0b79427	f9a091cb-1b60-4347-b8ea-01e97f5ea7d6
260	260	0	GBIF Benin	efb9c00e-f802-45dd-8826-a52ec45b89ff	fa92b09f-207c-41bf-967f-1a50d5f2167d
540150	540150	0	GBIF Spain	1f94b3ca-9345-4d65-afe2-4bace93aa0fe	fab4c599-802a-4bfc-8a59-fc7515001bfa
169600	169600	0	National Biodiversity Network	d897a5b9-35ee-4232-94bd-b0bcaac003c2	fbfe8e20-e8dd-4b4e-9618-1c30ac5baccd
1	1	0	Plazi	ffb07bec-2d10-492d-9c37-361fe0b79427	002cd12b-2ea1-445f-b6de-701cc133bb00
0	12	12	Plazi	ffb07bec-2d10-492d-9c37-361fe0b79427	0273e3ed-5dd5-4df5-b34e-23fa713fde28
22	22	0	Plazi	ffb07bec-2d10-492d-9c37-361fe0b79427	03652de6-0e70-42f0-82b4-f581ad8b826f
165	165	0	Ocean Biodiversity Information System	ba0670b9-4186-41e6-8e70-f9cb3065551a	0428bd0e-3066-4e48-b65d-52cbbff24b73
457	457	0	National Biodiversity Network	d897a5b9-35ee-4232-94bd-b0bcaac003c2	04c4143f-1b12-44c1-a81d-1ef5fb3ea175
4	4	0	Plazi	ffb07bec-2d10-492d-9c37-361fe0b79427	04e6abad-7a2d-42f7-8fa0-f1f9fe589d90
1769	1769	0	Plazi	ffb07bec-2d10-492d-9c37-361fe0b79427	081ac4b3-8ae0-45e9-a851-8889a7654463
0	3	3	Plazi	ffb07bec-2d10-492d-9c37-361fe0b79427	08352714-1e98-42d5-9f93-e638394549c3
205	205	0	GBIF France	da44cd31-5901-4687-a106-6d1c7734ee3a	09d66ac8-a0d2-419b-a566-e36d2d33a44a
4	4	0	Plazi	ffb07bec-2d10-492d-9c37-361fe0b79427	0b0cf968-955f-4872-951e-fab60e0cad10
834	834	0	Plazi	ffb07bec-2d10-492d-9c37-361fe0b79427	0ce95227-0383-471e-9cac-4cab7c0e34f0
6695	6695	0	National Biodiversity Network	d897a5b9-35ee-4232-94bd-b0bcaac003c2	121378f4-4f4a-4889-bd97-e907e51ca227
0	52	52	Ocean Biodiversity Information System	ba0670b9-4186-41e6-8e70-f9cb3065551a	13dab30d-eb57-4377-a817-fd5ce26bb4a5
0	13	13	Plazi	ffb07bec-2d10-492d-9c37-361fe0b79427	14e1ca82-522d-4b37-9b04-26d545ef354f
0	65	65	Plazi	ffb07bec-2d10-492d-9c37-361fe0b79427	15d9cc85-4968-4b16-9752-55c63984dc4d
0	146903	146903	GBIF New Zealand	4f9fd726-20dd-445e-89a1-8ed93792276f	1671ddfb-1f8a-4d24-ab4d-50adb89af001
128	128	0	Ocean Biodiversity Information System	ba0670b9-4186-41e6-8e70-f9cb3065551a	16dfc271-9bae-4d87-8f67-fe6ff90e3aff
0	11	11	Plazi	ffb07bec-2d10-492d-9c37-361fe0b79427	173dc190-81d6-4d10-9967-f2b677e2258e
1	1	0	Plazi	ffb07bec-2d10-492d-9c37-361fe0b79427	18476f38-04a0-48aa-8eaa-2e8a38681237
2731	2731	0	GBIF France	da44cd31-5901-4687-a106-6d1c7734ee3a	1c403d2c-5c37-4237-9746-8ed539b9ba15
10	10	0	Participant Node Managers Committee	7f48e0c8-5c96-49ec-b972-30748e339115	1e343fa3-d1cc-435b-b40b-ccbd7cfaa2cb
30071	30071	0	Canada Biodiversity Information Facility	8f83fc96-c966-4126-83f7-bf044dc49efa	210babc8-5723-41ac-bb13-c834590dbb15
283	283	0	National Biodiversity Network	d897a5b9-35ee-4232-94bd-b0bcaac003c2	211e7c8a-7bdd-4bcc-87c5-07ac5791edbd
588	588	0	GBIF Norway	4f829580-180d-46a9-9c87-ed8ec959b545	212cf6fc-825b-47cd-9d78-3e2e0db56330
3070	3070	0	Biodiversity Information System of Mexico	b324e8e9-9a4c-44fa-8f1a-7f39ea7ab576	21bd91d5-4179-4af6-8427-6630e32e2ffe
0	232787	232787	U.S. Geological Survey	8618c64a-93e0-4300-b546-7249e5148ed2	26098c25-8f7f-4c71-97ac-1d3db181c65e
27273	27273	0	Belgian Biodiversity Platform	fb11cfe1-ebc3-45af-9159-17d9fddbcdac	27e9e069-2862-4183-bcec-1e1a7f74d3e7
191	191	0	National Biodiversity Network	d897a5b9-35ee-4232-94bd-b0bcaac003c2	2854277b-8617-4a4e-b301-08422a8ea408
3744	3744	0	Biodiversity Information System of Mexico	b324e8e9-9a4c-44fa-8f1a-7f39ea7ab576	2d0a94b6-fca2-4630-9683-e37756440de0
357	357	0	South African Biodiversity Information Facility	7190b835-4e86-4b6e-85c1-19cc6677c250	2dd5d605-ce02-4496-bbba-b4723a3709c0
2	2	0	Plazi	ffb07bec-2d10-492d-9c37-361fe0b79427	3405832b-e9db-408e-9c75-efc041610d4f
0	2	2	Plazi	ffb07bec-2d10-492d-9c37-361fe0b79427	38880cb5-5fc0-4e6a-a688-5e21006f9a10
534	534	0	GBIF Kenya	2a44d626-9f7a-4120-8a7a-4ab5ac15ff2a	3905dc29-1f06-4ec8-a704-c8f951f78522
7	7	0	Plazi	ffb07bec-2d10-492d-9c37-361fe0b79427	3a9ffce3-41d1-4495-b9ec-e8c9ad11a0d2
60394	60394	0	GBIF France	da44cd31-5901-4687-a106-6d1c7734ee3a	3b6501fe-b73c-4f74-bd36-106ef7d790d0
46	46	0	GBIF France	da44cd31-5901-4687-a106-6d1c7734ee3a	3c22cbde-5f40-4173-a9d3-f068547b660f
158	158	0	GBIF France	da44cd31-5901-4687-a106-6d1c7734ee3a	3e22940a-cb87-4405-86f9-7a6e195a89d3
1	1	0	Plazi	ffb07bec-2d10-492d-9c37-361fe0b79427	415968b0-07bb-40da-930a-da12e85837bf
11	11	0	Plazi	ffb07bec-2d10-492d-9c37-361fe0b79427	41bd81a8-8d16-41cb-950f-8fab1660f845
0	18	18	Plazi	ffb07bec-2d10-492d-9c37-361fe0b79427	42ba4cd6-f726-42ee-832c-b96c599879eb
15169	22793	7624	U.S. Geological Survey	8618c64a-93e0-4300-b546-7249e5148ed2	44ae3412-2854-4021-8ac4-8e898ba656be
0	5	5	Plazi	ffb07bec-2d10-492d-9c37-361fe0b79427	45f90dbd-db02-4a3f-b01b-a3cd23b4f7d7
0	5	5	Plazi	ffb07bec-2d10-492d-9c37-361fe0b79427	47a5d23f-46d7-430d-87d9-1179994d7d4f
0	2000	2000	GBIF Chile	a8b16421-d80b-4ef3-8f22-098b01a89255	48842b1d-411a-4721-8cb4-5bff6c5b489a
47	47	0	GBIF France	da44cd31-5901-4687-a106-6d1c7734ee3a	490060bb-1365-431e-bb54-bb2c94e6d405
12	12	0	Plazi	ffb07bec-2d10-492d-9c37-361fe0b79427	4970b5e1-5255-4586-ab23-1040e3e4f384
1	1	0	Plazi	ffb07bec-2d10-492d-9c37-361fe0b79427	4d81f086-ca57-47f2-a960-73dfb55a8868
11	11	0	Plazi	ffb07bec-2d10-492d-9c37-361fe0b79427	521cb733-cb6c-4b74-8c94-957e2ad22336
0	127	127	Plazi	ffb07bec-2d10-492d-9c37-361fe0b79427	52c17d8b-7a5a-4f54-9375-2512105d1ea4
10	10	0	GBIF France	da44cd31-5901-4687-a106-6d1c7734ee3a	5334e794-d74b-48a9-9f92-2af4d7ac6fc1
0	5	5	Plazi	ffb07bec-2d10-492d-9c37-361fe0b79427	5ed275c3-20dd-4e1f-8aad-298b24314a5f
1752	1752	0	GBIF Malawi	2a42e4d7-ad4a-41b3-84c4-de4aa7b74d35	5ee6244a-a09f-4e5d-9a5f-4fbaada7bac0
1	1	0	Plazi	ffb07bec-2d10-492d-9c37-361fe0b79427	603bcfce-491e-4f44-9925-e15e308d0d79
69	69	0	GBIF Germany	4f6826f2-4ff6-443d-b966-e6913bd24013	616a1dfc-f762-11e1-a439-00145eb45e9a
98	98	0	GBIF Germany	4f6826f2-4ff6-443d-b966-e6913bd24013	63c285ee-f762-11e1-a439-00145eb45e9a
264	264	0	GBIF Germany	4f6826f2-4ff6-443d-b966-e6913bd24013	64273d68-f762-11e1-a439-00145eb45e9a
0	146	146	GBIF Japan	db5705aa-6a6e-42f1-8942-d77b9f4896ea	64b231d8-cf9b-4a64-be42-8f46ef0ba042
87	87	0	GBIF Germany	4f6826f2-4ff6-443d-b966-e6913bd24013	64e39526-f762-11e1-a439-00145eb45e9a
134	134	0	GBIF Germany	4f6826f2-4ff6-443d-b966-e6913bd24013	6650c244-f762-11e1-a439-00145eb45e9a
4	4	0	Plazi	ffb07bec-2d10-492d-9c37-361fe0b79427	6688af4f-a096-476e-afbd-77a15285c16c
50	50	0	GBIF Germany	4f6826f2-4ff6-443d-b966-e6913bd24013	68b04384-f762-11e1-a439-00145eb45e9a
98	98	0	GBIF Germany	4f6826f2-4ff6-443d-b966-e6913bd24013	69bd4db2-f762-11e1-a439-00145eb45e9a
2028	2028	0	GBIF Sweden	a0b3be64-6525-4387-ac67-a499950f92e1	69dc4356-0067-48db-9a66-3ff734a5380f
24	24	0	GBIF Germany	4f6826f2-4ff6-443d-b966-e6913bd24013	6a6ac9ec-f762-11e1-a439-00145eb45e9a
14	14	0	GBIF Germany	4f6826f2-4ff6-443d-b966-e6913bd24013	6b0ad9fa-f762-11e1-a439-00145eb45e9a
18	18	0	GBIF Germany	4f6826f2-4ff6-443d-b966-e6913bd24013	6b962992-f762-11e1-a439-00145eb45e9a
0	19	19	Plazi	ffb07bec-2d10-492d-9c37-361fe0b79427	6bb77067-0860-413d-a018-eab590cae615
126703	126703	0	U.S. Geological Survey	8618c64a-93e0-4300-b546-7249e5148ed2	6c032b27-e4fe-4bc9-8f11-6b5f864910ce
16	16	0	GBIF Germany	4f6826f2-4ff6-443d-b966-e6913bd24013	6c069682-f762-11e1-a439-00145eb45e9a
3438	3438	0	Participant Node Managers Committee	7f48e0c8-5c96-49ec-b972-30748e339115	6c88e116-15ea-4b6c-9fc3-edaded7e919a
117	117	0	GBIF Germany	4f6826f2-4ff6-443d-b966-e6913bd24013	70ee91d6-f762-11e1-a439-00145eb45e9a
29930	29930	0	GBIF Spain	1f94b3ca-9345-4d65-afe2-4bace93aa0fe	71d58564-f762-11e1-a439-00145eb45e9a
6107	6107	0	GBIF Japan	db5705aa-6a6e-42f1-8942-d77b9f4896ea	71dec9a8-f762-11e1-a439-00145eb45e9a
190	190	0	GBIF Germany	4f6826f2-4ff6-443d-b966-e6913bd24013	72d4bef8-f762-11e1-a439-00145eb45e9a
211	211	0	GBIF Germany	4f6826f2-4ff6-443d-b966-e6913bd24013	72deb1d8-f762-11e1-a439-00145eb45e9a
7	7	0	GBIF Germany	4f6826f2-4ff6-443d-b966-e6913bd24013	73616060-f762-11e1-a439-00145eb45e9a
5708	3722	-1986	GBIF Germany	4f6826f2-4ff6-443d-b966-e6913bd24013	739766b7-d53d-4f2c-9858-9dc1aabf46cd
1129	1129	0	Biodiversity Information System of Mexico	b324e8e9-9a4c-44fa-8f1a-7f39ea7ab576	73cd098a-9479-4c4a-b8b7-679958eba892
10046	10046	0	National Biodiversity Network	d897a5b9-35ee-4232-94bd-b0bcaac003c2	741655eb-fd10-4dc8-b26b-e86c6411c442
191	191	0	GBIF Germany	4f6826f2-4ff6-443d-b966-e6913bd24013	74773178-f762-11e1-a439-00145eb45e9a
150	150	0	GBIF Germany	4f6826f2-4ff6-443d-b966-e6913bd24013	755971f0-f762-11e1-a439-00145eb45e9a
68	68	0	GBIF Germany	4f6826f2-4ff6-443d-b966-e6913bd24013	755f0bd8-f762-11e1-a439-00145eb45e9a
0	136	136	Plazi	ffb07bec-2d10-492d-9c37-361fe0b79427	77d9653e-4e5b-4a9f-9e64-20dc913f264a
3	3	0	GBIF Germany	4f6826f2-4ff6-443d-b966-e6913bd24013	789ac9ae-f762-11e1-a439-00145eb45e9a
2	2	0	GBIF Germany	4f6826f2-4ff6-443d-b966-e6913bd24013	78a00f04-f762-11e1-a439-00145eb45e9a
47	36	-11	GBIF Germany	4f6826f2-4ff6-443d-b966-e6913bd24013	79a6cfb4-f762-11e1-a439-00145eb45e9a
30	30	0	GBIF Germany	4f6826f2-4ff6-443d-b966-e6913bd24013	79cc56c6-f762-11e1-a439-00145eb45e9a
908	908	0	Korean Biodiversity Information Facility	e0a1e772-0177-4800-94b4-2d023fe6cdf4	7b0399aa-f762-11e1-a439-00145eb45e9a
276	276	0	Ocean Biodiversity Information System	ba0670b9-4186-41e6-8e70-f9cb3065551a	7b5b300c-f762-11e1-a439-00145eb45e9a
0	11	11	Plazi	ffb07bec-2d10-492d-9c37-361fe0b79427	7beb4c6c-3524-4dcd-b349-f814be79781a
160	93	-67	GBIF Germany	4f6826f2-4ff6-443d-b966-e6913bd24013	7df431a6-f762-11e1-a439-00145eb45e9a
46	46	0	Plazi	ffb07bec-2d10-492d-9c37-361fe0b79427	7e02577f-b34c-4260-a14a-8c901e39d6b1
0	32	32	Plazi	ffb07bec-2d10-492d-9c37-361fe0b79427	7f96d3fe-5c9e-46bc-ac7b-644806c582eb
26433	26433	0	Biodiversity Information System of Mexico	b324e8e9-9a4c-44fa-8f1a-7f39ea7ab576	7fb208ec-f762-11e1-a439-00145eb45e9a
6780	6780	0	Biodiversity Information System of Mexico	b324e8e9-9a4c-44fa-8f1a-7f39ea7ab576	7ff48302-f762-11e1-a439-00145eb45e9a
8072	8072	0	Biodiversity Information System of Mexico	b324e8e9-9a4c-44fa-8f1a-7f39ea7ab576	8000dada-f762-11e1-a439-00145eb45e9a
1718	1664	-54	Biodiversity Information System of Mexico	b324e8e9-9a4c-44fa-8f1a-7f39ea7ab576	80241018-f762-11e1-a439-00145eb45e9a
764	764	0	GBIF Spain	1f94b3ca-9345-4d65-afe2-4bace93aa0fe	811076f6-f762-11e1-a439-00145eb45e9a
8	8	0	GBIF Germany	4f6826f2-4ff6-443d-b966-e6913bd24013	8151815a-f762-11e1-a439-00145eb45e9a
0	14867	14867	GBIF Sweden	a0b3be64-6525-4387-ac67-a499950f92e1	825e65f7-dc00-421f-b12b-a93f58ceb06f
0	2	2	Plazi	ffb07bec-2d10-492d-9c37-361fe0b79427	835cdd49-c45d-433e-a0c2-6422c3167ff4
388	388	0	GBIF Germany	4f6826f2-4ff6-443d-b966-e6913bd24013	8527159b-c920-45a3-9d4e-5f3313448e00
93631	94873	1242	U.S. Geological Survey	8618c64a-93e0-4300-b546-7249e5148ed2	85378a64-2fbc-4a48-a6b4-9f421ad48f8a
28647	28647	0	Ocean Biodiversity Information System	ba0670b9-4186-41e6-8e70-f9cb3065551a	8598edb6-f762-11e1-a439-00145eb45e9a
0	6	6	Plazi	ffb07bec-2d10-492d-9c37-361fe0b79427	8683b51f-249f-40f8-80dd-5aa6f539b7c4
20	20	0	GBIF Germany	4f6826f2-4ff6-443d-b966-e6913bd24013	8876758a-f762-11e1-a439-00145eb45e9a
4	4	0	Plazi	ffb07bec-2d10-492d-9c37-361fe0b79427	88906c77-3ad7-4b24-9efc-bdd9d96cf24b
16	16	0	GBIF Germany	4f6826f2-4ff6-443d-b966-e6913bd24013	88a9f388-f762-11e1-a439-00145eb45e9a
8	8	0	Plazi	ffb07bec-2d10-492d-9c37-361fe0b79427	893f65e2-1231-4f39-8e86-533208a42f80
160757	160757	0	GBIF Slovenia	53e3f6b9-81f8-41e3-9e51-2666a5e0ae6a	8959f58a-f762-11e1-a439-00145eb45e9a
3	3	0	GBIF Argentina	2426a871-9feb-40a1-96c6-0c593a76b835	898b6289-00e8-4006-8309-015d2e8f217c
977	977	0	Biodiversity Information System of Mexico	b324e8e9-9a4c-44fa-8f1a-7f39ea7ab576	89957a4f-8f2c-4db0-b48b-4eb497960dff
2628	2628	0	GBIF Germany	4f6826f2-4ff6-443d-b966-e6913bd24013	89a5e170-f762-11e1-a439-00145eb45e9a
99	99	0	GBIF Germany	4f6826f2-4ff6-443d-b966-e6913bd24013	89cff67c-f762-11e1-a439-00145eb45e9a
0	2	2	Plazi	ffb07bec-2d10-492d-9c37-361fe0b79427	8a115b28-99ef-4210-8729-c7cc6afad14d
378	378	0	GBIF Germany	4f6826f2-4ff6-443d-b966-e6913bd24013	8a3f1c5a-f762-11e1-a439-00145eb45e9a
4	4	0	Plazi	ffb07bec-2d10-492d-9c37-361fe0b79427	8b940c06-8521-4e81-be69-9ad4ea1c95bb
60	44	-16	GBIF Germany	4f6826f2-4ff6-443d-b966-e6913bd24013	8c62dfc6-f762-11e1-a439-00145eb45e9a
1	1	0	GBIF Germany	4f6826f2-4ff6-443d-b966-e6913bd24013	8c8534a4-f762-11e1-a439-00145eb45e9a
1	1	0	Plazi	ffb07bec-2d10-492d-9c37-361fe0b79427	8cd4b29f-5d06-4ef2-b980-ecea17cd048d
19	16	-3	GBIF Germany	4f6826f2-4ff6-443d-b966-e6913bd24013	8d0dddf4-f762-11e1-a439-00145eb45e9a
0	27	27	Plazi	ffb07bec-2d10-492d-9c37-361fe0b79427	8f0353b0-9acd-4630-9d46-7a2d45cf1774
15214	15214	0	National Biodiversity Network	d897a5b9-35ee-4232-94bd-b0bcaac003c2	8f53eb9d-c069-4f48-baee-4f96e00a1d2b
10	7	-3	GBIF Germany	4f6826f2-4ff6-443d-b966-e6913bd24013	910284aa-f762-11e1-a439-00145eb45e9a
0	16593	16593	Ocean Biodiversity Information System	ba0670b9-4186-41e6-8e70-f9cb3065551a	921ce33a-b150-41e4-8cb1-2086313aee25
528	240	-288	GBIF Germany	4f6826f2-4ff6-443d-b966-e6913bd24013	934d8372-f762-11e1-a439-00145eb45e9a
34563	36407	1844	U.S. Geological Survey	8618c64a-93e0-4300-b546-7249e5148ed2	95c80a78-f762-11e1-a439-00145eb45e9a
404842	999991	595149	U.S. Geological Survey	8618c64a-93e0-4300-b546-7249e5148ed2	96193ea2-f762-11e1-a439-00145eb45e9a
0	18	18	GBIF Benin	efb9c00e-f802-45dd-8826-a52ec45b89ff	96f0c3f3-e86a-4b4a-90cc-76bc873c5dd8
487	487	0	GBIF France	da44cd31-5901-4687-a106-6d1c7734ee3a	972a3391-e9b4-4781-b62a-ef58111a50f2
366	366	0	GBIF Guinea	b1cd2e84-c4ba-47bd-b72a-dfd1f92dce0a	973bb1e2-8ddd-49a5-b304-16528cb364f1
2861	2861	0	Korean Biodiversity Information Facility	e0a1e772-0177-4800-94b4-2d023fe6cdf4	991a1a20-27fc-11e2-85e3-00145eb45e9a
0	11	11	Plazi	ffb07bec-2d10-492d-9c37-361fe0b79427	9a61341d-0ca0-4375-b56d-aec53688d420
0	6	6	Plazi	ffb07bec-2d10-492d-9c37-361fe0b79427	9b2056ec-f71b-4ff8-b642-e7aed6aa0eeb
2	2	0	Plazi	ffb07bec-2d10-492d-9c37-361fe0b79427	9d2b00be-244a-4203-962b-1144b3a728ea
1	1	0	Plazi	ffb07bec-2d10-492d-9c37-361fe0b79427	9eca2868-5d64-414e-9905-29f3725d5ae9
2269	2269	0	GBIF France	da44cd31-5901-4687-a106-6d1c7734ee3a	9f6914e6-ec6f-405d-80aa-8ec8fb98ed32
1715	1763	48	GBIF France	da44cd31-5901-4687-a106-6d1c7734ee3a	9ffdd244-3e59-40a8-b064-cfdd84d40231
8778	8778	0	Atlas of Living Australia	4a6f1b71-969e-4fc5-a693-282b05e1220c	a1e87da3-fe4b-44a3-a1d4-23923aab526d
0	42	42	Plazi	ffb07bec-2d10-492d-9c37-361fe0b79427	a3f528b0-9dd1-4059-9e1f-0a88c23f1e46
0	102	102	Plazi	ffb07bec-2d10-492d-9c37-361fe0b79427	a760312c-6096-4683-8365-49893b8853e0
250	250	0	GBIF Germany	4f6826f2-4ff6-443d-b966-e6913bd24013	a909d890-6f6e-445e-99b7-32d92c51e1d6
0	3	3	Plazi	ffb07bec-2d10-492d-9c37-361fe0b79427	aa8c55a1-6677-45d7-ba29-7541231b7a77
285	285	0	Colombian Biodiversity Information System	7e865cba-7c46-417b-ade5-97f2cf5b7be0	aac672c4-0109-4e0c-aa6e-36c790db9030
0	321	321	Plazi	ffb07bec-2d10-492d-9c37-361fe0b79427	aca67cc8-96ca-4f24-b8af-2b532ecd355c
56	56	0	GBIF France	da44cd31-5901-4687-a106-6d1c7734ee3a	af6ea09d-0453-4787-b950-6aaf97f1be3d
2	2	0	Plazi	ffb07bec-2d10-492d-9c37-361fe0b79427	b0d1deb0-6c39-4239-85fa-16a2283d4801
39134	39293	159	GBIF Norway	4f829580-180d-46a9-9c87-ed8ec959b545	b2824629-9acc-4c49-827e-e560ab438758
0	10	10	Plazi	ffb07bec-2d10-492d-9c37-361fe0b79427	b4c650a9-c917-4f03-aeed-e63058aaade7
4	4	0	GBIF France	da44cd31-5901-4687-a106-6d1c7734ee3a	b4eb3547-09a7-4028-9cf3-c26257908c42
87	87	0	GBIF France	da44cd31-5901-4687-a106-6d1c7734ee3a	b6f2de76-d624-460d-bc8c-2b74c73a749c
4343	1388	-2955	Biodiversity Information System of Mexico	b324e8e9-9a4c-44fa-8f1a-7f39ea7ab576	b79971eb-bd50-4ec3-a922-778ac3f02e0c
343	183	-160	GBIF Germany	4f6826f2-4ff6-443d-b966-e6913bd24013	b9cdfde8-e9b0-4f0e-b1ee-780722389390
77	77	0	Plazi	ffb07bec-2d10-492d-9c37-361fe0b79427	b9d1e2a0-a79c-497d-9161-c18471ebf00d
70	70	0	GBIF Germany	4f6826f2-4ff6-443d-b966-e6913bd24013	ba62038d-53af-4a94-a27b-196eee2df917
0	3330	3330	Participant Node Managers Committee	7f48e0c8-5c96-49ec-b972-30748e339115	bdb67a65-a026-442f-86cf-4ab2fe34ffb7
1310	1310	0	GBIF France	da44cd31-5901-4687-a106-6d1c7734ee3a	c0273881-4e07-4301-bf2d-e2236d1a71a7
11	11	0	Plazi	ffb07bec-2d10-492d-9c37-361fe0b79427	c05afdbe-5c00-406f-abf5-69a53d227a8b
702	702	0	GBIF France	da44cd31-5901-4687-a106-6d1c7734ee3a	c0668e14-652c-4744-b776-ab9beb8d5d1b
1	1	0	Plazi	ffb07bec-2d10-492d-9c37-361fe0b79427	c135cb7f-a208-40e1-8fb6-911058b4394a
0	72	72	Plazi	ffb07bec-2d10-492d-9c37-361fe0b79427	c7f661c7-03d5-4969-b19e-6ef1dde8e306
5232	5232	0	GBIF Portugal	673f7038-4262-4149-b753-5658a4e912f6	c9a57648-87fa-477e-a72c-9db3eeb95e44
52	52	0	GBIF Argentina	2426a871-9feb-40a1-96c6-0c593a76b835	c9aab34e-cae8-467a-b024-ad427ad93d1b
2	2	0	Plazi	ffb07bec-2d10-492d-9c37-361fe0b79427	cd51d797-0ad0-42aa-8a72-0e27a7d9392d
55	55	0	Colombian Biodiversity Information System	7e865cba-7c46-417b-ade5-97f2cf5b7be0	cda2f7df-8cc7-47ff-b7d1-44592bb4b688
15	15	0	Plazi	ffb07bec-2d10-492d-9c37-361fe0b79427	cde14b22-b68c-4f01-8312-98d648dec51c
9	9	0	Plazi	ffb07bec-2d10-492d-9c37-361fe0b79427	ce8a437c-9f4f-4539-891a-790b0aae0000
572	572	0	Biodiversity Information System of Mexico	b324e8e9-9a4c-44fa-8f1a-7f39ea7ab576	cf6ee0a4-cde8-4983-882c-a6e4d2f7de7e
35559	35559	0	GBIF Japan	db5705aa-6a6e-42f1-8942-d77b9f4896ea	cfbe2e7b-6e3f-4b40-96f9-07bc23a3f822
0	78	78	Ocean Biodiversity Information System	ba0670b9-4186-41e6-8e70-f9cb3065551a	d1e71736-59b7-4e35-84dc-eb0ebc577646
0	18	18	Plazi	ffb07bec-2d10-492d-9c37-361fe0b79427	d27bf4eb-f8ec-4151-add7-5ab7ec447687
0	13	13	Plazi	ffb07bec-2d10-492d-9c37-361fe0b79427	d37b25f7-6746-4dee-9a0c-dc690e951707
0	45	45	Ocean Biodiversity Information System	ba0670b9-4186-41e6-8e70-f9cb3065551a	dac7ede0-8b98-4b85-8825-cd72ea07ae62
1416	531	-885	GBIF Germany	4f6826f2-4ff6-443d-b966-e6913bd24013	db3e4342-b4f0-46bb-9e2b-0fdf0566d67c
1	1	0	Participant Node Managers Committee	7f48e0c8-5c96-49ec-b972-30748e339115	dca8f64a-9e26-417c-b08b-c08644ab28f2
0	3	3	Plazi	ffb07bec-2d10-492d-9c37-361fe0b79427	ddede268-9e9f-473e-8310-fe8722874b79
0	2	2	Plazi	ffb07bec-2d10-492d-9c37-361fe0b79427	de350b7a-a9d1-4c88-b759-6532c1b4a958
5	5	0	Plazi	ffb07bec-2d10-492d-9c37-361fe0b79427	e0e97feb-5a82-4ff0-9a41-db5e3efa8c4e
2	2	0	Plazi	ffb07bec-2d10-492d-9c37-361fe0b79427	e13b422a-b2cb-4622-bc80-065c002669f6
3	3	0	Plazi	ffb07bec-2d10-492d-9c37-361fe0b79427	e1ec4acf-3db4-4cd9-97fa-5645a0685e5b
108	108	0	GBIF Sweden	a0b3be64-6525-4387-ac67-a499950f92e1	e73886a6-15e6-462d-b81e-bafcd858b07e
0	7	7	Plazi	ffb07bec-2d10-492d-9c37-361fe0b79427	e8d58fbd-20df-48a2-95e7-165b3ddfc7ef
0	60	60	Colombian Biodiversity Information System	7e865cba-7c46-417b-ade5-97f2cf5b7be0	ea1d1177-4feb-411a-9783-495c6d5d3dc6
1	1	0	Plazi	ffb07bec-2d10-492d-9c37-361fe0b79427	ec14c625-39c9-4544-9af2-c219627e0e8f
7	7	0	Plazi	ffb07bec-2d10-492d-9c37-361fe0b79427	eeb768c6-8a27-46e6-9412-edd7e2f857db
850	850	0	GBIF Chile	a8b16421-d80b-4ef3-8f22-098b01a89255	ef2497c9-3b6b-4468-905d-430c87bd45ca
5	5	0	Plazi	ffb07bec-2d10-492d-9c37-361fe0b79427	efe1ee0e-b68a-48de-b724-a83fe398b940
0	67103	67103	GBIF Portugal	673f7038-4262-4149-b753-5658a4e912f6	f282d216-3029-490e-8dfd-6341325a882c
2	2	0	Plazi	ffb07bec-2d10-492d-9c37-361fe0b79427	f2fbdc01-4a1f-4043-b4aa-8458fc490f04
10769	10769	0	U.S. Geological Survey	8618c64a-93e0-4300-b546-7249e5148ed2	f387a2f0-6f4f-47ec-82dd-9cc24914dd53
0	3	3	Plazi	ffb07bec-2d10-492d-9c37-361fe0b79427	f559cdff-946c-4dcb-966e-15a5d7f7a334
662	662	0	Participant Node Managers Committee	7f48e0c8-5c96-49ec-b972-30748e339115	f86af1b5-257b-49c5-9ce9-9f1f986a4eb3
9	9	0	Plazi	ffb07bec-2d10-492d-9c37-361fe0b79427	fedf2d91-58b2-4398-820e-8bff74010f83
442	442	0	GBIF New Zealand	4f9fd726-20dd-445e-89a1-8ed93792276f	001248bd-d32c-45c4-add3-dfb17ab4e27c
55	55	0	Plazi	ffb07bec-2d10-492d-9c37-361fe0b79427	02866e62-ab61-4cf4-9d98-0248e251084e
436	436	0	GBIF Benin	efb9c00e-f802-45dd-8826-a52ec45b89ff	038a8818-af12-4a9f-a6bd-772d8d79d68f
5838	5838	0	GBIF France	da44cd31-5901-4687-a106-6d1c7734ee3a	03da4c68-c923-4ff0-9529-77889e0a1ffe
0	26	26	Ocean Biodiversity Information System	ba0670b9-4186-41e6-8e70-f9cb3065551a	06b0c4bf-710a-4655-a295-e5d1e7212a75
2	2	0	Plazi	ffb07bec-2d10-492d-9c37-361fe0b79427	0dd520de-6344-47ed-b7b6-a11fb767ec35
0	1	1	Plazi	ffb07bec-2d10-492d-9c37-361fe0b79427	0e2179c4-a1e3-4a5a-be33-e4b9a094037d
16	16	0	Plazi	ffb07bec-2d10-492d-9c37-361fe0b79427	0ef40b53-d24b-4032-bff6-a66512599336
0	1	1	Plazi	ffb07bec-2d10-492d-9c37-361fe0b79427	0f748ffa-8d63-4130-b55e-114b829f816a
420	420	0	Polish Biodiversity Information Network	2618bfdf-e194-4911-a241-80db3107bc51	0faf7500-9fcd-11da-a90c-b8a03c50a862
13621	13621	0	GBIF Germany	4f6826f2-4ff6-443d-b966-e6913bd24013	0fd66c58-0ef4-45b3-b5a0-14ea85d37c0a
0	11	11	Plazi	ffb07bec-2d10-492d-9c37-361fe0b79427	137cdaec-de44-48ae-be6b-fc9982803086
0	3	3	Plazi	ffb07bec-2d10-492d-9c37-361fe0b79427	155c80a2-f345-4a43-9ff9-770f5c7ab81c
115	115	0	National Biodiversity Network	d897a5b9-35ee-4232-94bd-b0bcaac003c2	19016860-06e5-4bd9-ae82-4eed1b39007e
1519	1519	0	GBIF Germany	4f6826f2-4ff6-443d-b966-e6913bd24013	19017225-526b-46d4-9036-39c398295efd
0	445	445	Ocean Biodiversity Information System	ba0670b9-4186-41e6-8e70-f9cb3065551a	1cd95b59-6836-4d9e-8947-5e2f8e7b1e07
0	121632	121632	GBIF Estonia	2c11b821-d22b-4c64-8cd3-c1578173b129	1f917113-dd55-4000-9f80-6266fab1af03
1976	1976	0	GBIF Togo	c9659a3e-07e9-4fcb-83c6-de8b9009a02e	1ff18fb4-468e-4d1d-85b2-8c13876efcb7
148939	151945	3006	U.S. Geological Survey	8618c64a-93e0-4300-b546-7249e5148ed2	219cedbf-462b-42e6-957b-c4b6087c452b
6	6	0	Plazi	ffb07bec-2d10-492d-9c37-361fe0b79427	224d4fb3-3226-41a9-9391-7b4799e62f01
0	6826	6826	Ocean Biodiversity Information System	ba0670b9-4186-41e6-8e70-f9cb3065551a	25b245eb-8fa4-40f4-a56b-dbfa6ab42fc5
91	91	0	Colombian Biodiversity Information System	7e865cba-7c46-417b-ade5-97f2cf5b7be0	29579dca-e296-4724-8f4f-ae39b3f6da14
13	13	0	GBIF France	da44cd31-5901-4687-a106-6d1c7734ee3a	2b41cace-39fb-4466-8609-3120f5b9aa89
7395	7395	0	Participant Node Managers Committee	7f48e0c8-5c96-49ec-b972-30748e339115	2bbdfd35-4881-4ce2-a0e5-6d457f01f3cc
3	3	0	Plazi	ffb07bec-2d10-492d-9c37-361fe0b79427	2f176714-1f94-4dc7-82d2-c12e95fe9dfe
0	15	15	Plazi	ffb07bec-2d10-492d-9c37-361fe0b79427	31ab6eda-41d2-48e7-84d2-96914c7b3688
0	2	2	Plazi	ffb07bec-2d10-492d-9c37-361fe0b79427	325d1b05-f970-44b3-b10f-b2db9c5e9da7
8	8	0	Plazi	ffb07bec-2d10-492d-9c37-361fe0b79427	36ebc3e6-df1e-4993-a8c8-6b4cc679e888
21	21	0	Plazi	ffb07bec-2d10-492d-9c37-361fe0b79427	3a6b4cb7-b97f-443e-9aec-f5be22e0d320
576	576	0	GBIF Germany	4f6826f2-4ff6-443d-b966-e6913bd24013	3ab12f1d-fa57-4bf5-9aa7-309bc5ca51f9
1	1	0	Plazi	ffb07bec-2d10-492d-9c37-361fe0b79427	3db81a55-2bb2-4704-9b72-0408212f3cde
0	11	11	Plazi	ffb07bec-2d10-492d-9c37-361fe0b79427	3e393985-bf0f-47ac-9ec2-677957e703d2
3120	3120	0	GBIF France	da44cd31-5901-4687-a106-6d1c7734ee3a	3f613fa3-be9e-4eee-9f88-2636b34d54d0
8	9	1	Plazi	ffb07bec-2d10-492d-9c37-361fe0b79427	40966a99-5bdf-4603-8384-85f6c66b2390
16	16	0	Plazi	ffb07bec-2d10-492d-9c37-361fe0b79427	41bc332d-a485-4b35-8faf-1e117df93ff8
177	177	0	Plazi	ffb07bec-2d10-492d-9c37-361fe0b79427	4622feb8-93b3-4a09-8527-4f71d6cda3cf
3740	3740	0	ASEAN Centre for Biodiversity	af2a0fa1-4c8e-4bdc-8954-b1a55e32b0f1	478e52db-0450-47f0-a763-ad3bcdaba6d9
14208	14208	0	National Biodiversity Network	d897a5b9-35ee-4232-94bd-b0bcaac003c2	481360ed-3ba8-4af8-89b8-8a3162f73e41
176	176	0	Participant Node Managers Committee	7f48e0c8-5c96-49ec-b972-30748e339115	481fd878-0284-4dd4-86a0-86b0e3d02cbd
0	6	6	Plazi	ffb07bec-2d10-492d-9c37-361fe0b79427	4998fb07-2499-40cf-b984-400aa9bceb34
1115	1116	1	GBIF Germany	4f6826f2-4ff6-443d-b966-e6913bd24013	4d9b4100-23d4-48a4-a2a3-3322070ebc55
14	14	0	Plazi	ffb07bec-2d10-492d-9c37-361fe0b79427	4fe433da-c832-45c2-a5e7-7e0657cae038
2	2	0	Plazi	ffb07bec-2d10-492d-9c37-361fe0b79427	51ca1b67-97b0-401f-8bb8-f15d39ca88cf
314	314	0	GBIF Japan	db5705aa-6a6e-42f1-8942-d77b9f4896ea	532df8ee-18f5-11e2-98fb-00145eb45e9a
6	6	0	Plazi	ffb07bec-2d10-492d-9c37-361fe0b79427	533b6aa5-1906-45e5-b36b-e5f32cf6bbf6
1369	1369	0	GBIF Japan	db5705aa-6a6e-42f1-8942-d77b9f4896ea	53849852-18f5-11e2-98fb-00145eb45e9a
661	661	0	Plazi	ffb07bec-2d10-492d-9c37-361fe0b79427	5644b1e6-649e-4bdb-9c2f-9547055eeb6f
5040	3360	-1680	GBIF Germany	4f6826f2-4ff6-443d-b966-e6913bd24013	567fd2b5-68ed-4d4c-9000-87c69e437503
41	41	0	Plazi	ffb07bec-2d10-492d-9c37-361fe0b79427	56bbd0fa-f867-4423-87b6-3853bda6ecef
0	289	289	Ocean Biodiversity Information System	ba0670b9-4186-41e6-8e70-f9cb3065551a	56dde455-657c-4e32-b1f1-c0eda47d7d70
3	3	0	Plazi	ffb07bec-2d10-492d-9c37-361fe0b79427	573d672e-1b0a-4864-ab2e-a11f440518e2
1230	1230	0	Taiwan Biodiversity Information Facility	e1b85abc-61f9-430f-ba79-6813dec53a0f	5767f180-98a1-11de-b4da-b8a03c50a862
0	6	6	Plazi	ffb07bec-2d10-492d-9c37-361fe0b79427	5937c51f-34b1-4c98-8c57-41f8943abe82
486	486	0	National Biodiversity Network	d897a5b9-35ee-4232-94bd-b0bcaac003c2	59800e53-187b-44b6-9add-76a975e304cc
4	4	0	Plazi	ffb07bec-2d10-492d-9c37-361fe0b79427	5d898c9f-4cb8-435e-945a-bcf8dcedd3a8
7	7	0	Plazi	ffb07bec-2d10-492d-9c37-361fe0b79427	5e9eb1f2-7311-4771-95eb-5332438d5417
98	98	0	GBIF Germany	4f6826f2-4ff6-443d-b966-e6913bd24013	602bdcc7-f9ce-4377-8fbc-e4ee20ed657a
0	1	1	Plazi	ffb07bec-2d10-492d-9c37-361fe0b79427	60632de4-c9c1-48b3-9e8f-eae761d2801a
1529	1529	0	GBIF Viet Nam	7f4b5eab-2edf-4b46-9360-d9574ab0f1d7	6086a401-4ea7-4f8e-8709-91b53fcfd44a
0	79559	79559	National Biodiversity Network	d897a5b9-35ee-4232-94bd-b0bcaac003c2	60de59a4-c428-4d49-873d-b117bea1fcc9
118	118	0	GBIF Germany	4f6826f2-4ff6-443d-b966-e6913bd24013	610fde00-f762-11e1-a439-00145eb45e9a
67	67	0	GBIF Germany	4f6826f2-4ff6-443d-b966-e6913bd24013	613a860a-f762-11e1-a439-00145eb45e9a
630	630	0	Plazi	ffb07bec-2d10-492d-9c37-361fe0b79427	615d5c4a-3b8d-4ba6-a05d-f37e432a862b
155	155	0	GBIF Germany	4f6826f2-4ff6-443d-b966-e6913bd24013	622811f4-f762-11e1-a439-00145eb45e9a
64	64	0	GBIF Germany	4f6826f2-4ff6-443d-b966-e6913bd24013	62ce8b92-f762-11e1-a439-00145eb45e9a
498	498	0	Participant Node Managers Committee	7f48e0c8-5c96-49ec-b972-30748e339115	6331c28e-9bc0-4f42-9721-9d5b85b591a9
160	160	0	GBIF France	da44cd31-5901-4687-a106-6d1c7734ee3a	64f79862-fc4b-4a22-b509-cf9105eefd5f
107	107	0	GBIF Germany	4f6826f2-4ff6-443d-b966-e6913bd24013	664f8532-f762-11e1-a439-00145eb45e9a
2382	2382	0	Belgian Biodiversity Platform	fb11cfe1-ebc3-45af-9159-17d9fddbcdac	6679952f-649b-4888-bd97-00daca4b8cc1
57	57	0	GBIF Germany	4f6826f2-4ff6-443d-b966-e6913bd24013	66bdab98-f762-11e1-a439-00145eb45e9a
3	3	0	GBIF Germany	4f6826f2-4ff6-443d-b966-e6913bd24013	66c030c0-f762-11e1-a439-00145eb45e9a
138	138	0	GBIF Germany	4f6826f2-4ff6-443d-b966-e6913bd24013	688aec88-f762-11e1-a439-00145eb45e9a
136	136	0	GBIF Germany	4f6826f2-4ff6-443d-b966-e6913bd24013	6a3a6086-f762-11e1-a439-00145eb45e9a
0	3832	3832	Participant Node Managers Committee	7f48e0c8-5c96-49ec-b972-30748e339115	6b1b75f7-4fa2-4f7e-b5bb-e77ffe86dbd1
12	12	0	GBIF Germany	4f6826f2-4ff6-443d-b966-e6913bd24013	6b8638d4-f762-11e1-a439-00145eb45e9a
0	124	124	Plazi	ffb07bec-2d10-492d-9c37-361fe0b79427	6cadad22-abf2-4abe-9165-156d5c63ece3
70	70	0	Plazi	ffb07bec-2d10-492d-9c37-361fe0b79427	6ed001bf-fde7-40c4-a23b-41c23aaf4e3f
138	138	0	Colombian Biodiversity Information System	7e865cba-7c46-417b-ade5-97f2cf5b7be0	707f7459-0461-4de7-93af-2a417841b5e5
103	103	0	GBIF Germany	4f6826f2-4ff6-443d-b966-e6913bd24013	70b95e58-f762-11e1-a439-00145eb45e9a
1370	1370	0	GBIF Norway	4f829580-180d-46a9-9c87-ed8ec959b545	7273112b-bf23-4dce-a603-3ab074867ac2
0	7	7	Plazi	ffb07bec-2d10-492d-9c37-361fe0b79427	72f6fdb3-a9cb-4823-ada5-233a4510b0db
10	10	0	GBIF Germany	4f6826f2-4ff6-443d-b966-e6913bd24013	7330449e-f762-11e1-a439-00145eb45e9a
13	13	0	GBIF Germany	4f6826f2-4ff6-443d-b966-e6913bd24013	738c0a4a-f762-11e1-a439-00145eb45e9a
53	53	0	GBIF Germany	4f6826f2-4ff6-443d-b966-e6913bd24013	74388aa4-f762-11e1-a439-00145eb45e9a
10	10	0	GBIF Germany	4f6826f2-4ff6-443d-b966-e6913bd24013	74c3ce3e-f762-11e1-a439-00145eb45e9a
151	151	0	GBIF Germany	4f6826f2-4ff6-443d-b966-e6913bd24013	75b5f7a4-f762-11e1-a439-00145eb45e9a
255	255	0	GBIF Germany	4f6826f2-4ff6-443d-b966-e6913bd24013	75d13d8e-f762-11e1-a439-00145eb45e9a
13	13	0	GBIF Germany	4f6826f2-4ff6-443d-b966-e6913bd24013	78e03624-f762-11e1-a439-00145eb45e9a
11	11	0	GBIF Germany	4f6826f2-4ff6-443d-b966-e6913bd24013	7945389e-f762-11e1-a439-00145eb45e9a
104	104	0	Ocean Biodiversity Information System	ba0670b9-4186-41e6-8e70-f9cb3065551a	7b6322ee-f762-11e1-a439-00145eb45e9a
65	52	-13	GBIF Germany	4f6826f2-4ff6-443d-b966-e6913bd24013	7be3be54-f762-11e1-a439-00145eb45e9a
437	46	-391	GBIF Germany	4f6826f2-4ff6-443d-b966-e6913bd24013	7c356e52-f762-11e1-a439-00145eb45e9a
12	12	0	Secretariat of the Pacific Regional Environment Programme	29c6a139-ea7f-41f5-8d9b-c55af8736182	7cd55c2e-3eed-4006-bc4f-233cbe05a822
0	80	80	Korean Biodiversity Information Facility	e0a1e772-0177-4800-94b4-2d023fe6cdf4	7cd90515-4e27-4b7e-b793-48d4dbd96ec0
22	22	0	Plazi	ffb07bec-2d10-492d-9c37-361fe0b79427	7db30792-ae52-4647-becb-e06616230ae9
1504	1504	0	Biodiversity Information System of Mexico	b324e8e9-9a4c-44fa-8f1a-7f39ea7ab576	80580a08-f762-11e1-a439-00145eb45e9a
560	560	0	Biodiversity Information System of Mexico	b324e8e9-9a4c-44fa-8f1a-7f39ea7ab576	809463fe-f762-11e1-a439-00145eb45e9a
1614	1614	0	Canada Biodiversity Information Facility	8f83fc96-c966-4126-83f7-bf044dc49efa	8452a816-f762-11e1-a439-00145eb45e9a
0	1	1	Plazi	ffb07bec-2d10-492d-9c37-361fe0b79427	84de505a-5c7f-4d47-bdc5-66741acc2476
1	1	0	Plazi	ffb07bec-2d10-492d-9c37-361fe0b79427	85cec0f0-ef48-4001-bfe2-581905d6fd82
144	144	0	GBIF Germany	4f6826f2-4ff6-443d-b966-e6913bd24013	87c488ac-f762-11e1-a439-00145eb45e9a
1178	1151	-27	GBIF Germany	4f6826f2-4ff6-443d-b966-e6913bd24013	8954deba-f762-11e1-a439-00145eb45e9a
60	60	0	National Biodiversity Network	d897a5b9-35ee-4232-94bd-b0bcaac003c2	8a1511d1-c551-4a16-83a4-1d88f74a9e77
0	2	2	Plazi	ffb07bec-2d10-492d-9c37-361fe0b79427	8b15385e-73ff-4e17-aa18-4ab5bd25713b
23559	33814	10255	U.S. Geological Survey	8618c64a-93e0-4300-b546-7249e5148ed2	8cb7c449-ba11-4464-865e-8029b8d772e8
5	3	-2	GBIF Germany	4f6826f2-4ff6-443d-b966-e6913bd24013	8d4900f0-f762-11e1-a439-00145eb45e9a
5	4	-1	GBIF Germany	4f6826f2-4ff6-443d-b966-e6913bd24013	8d4f9bae-f762-11e1-a439-00145eb45e9a
699	244	-455	GBIF Germany	4f6826f2-4ff6-443d-b966-e6913bd24013	8df83dea-f762-11e1-a439-00145eb45e9a
37	27	-10	GBIF Germany	4f6826f2-4ff6-443d-b966-e6913bd24013	8e6ef034-f762-11e1-a439-00145eb45e9a
8	3	-5	GBIF Germany	4f6826f2-4ff6-443d-b966-e6913bd24013	8ee2d472-f762-11e1-a439-00145eb45e9a
549	549	0	GBIF Germany	4f6826f2-4ff6-443d-b966-e6913bd24013	8efd05e0-f762-11e1-a439-00145eb45e9a
5	4	-1	GBIF Germany	4f6826f2-4ff6-443d-b966-e6913bd24013	8ff8571a-f762-11e1-a439-00145eb45e9a
29	19	-10	GBIF Germany	4f6826f2-4ff6-443d-b966-e6913bd24013	903298b2-f762-11e1-a439-00145eb45e9a
378	207	-171	GBIF Germany	4f6826f2-4ff6-443d-b966-e6913bd24013	906b5dd2-f762-11e1-a439-00145eb45e9a
3119	3119	0	Colombian Biodiversity Information System	7e865cba-7c46-417b-ade5-97f2cf5b7be0	90e99b1e-6ae4-4577-9679-ba4603e24f5c
198	198	0	GBIF Germany	4f6826f2-4ff6-443d-b966-e6913bd24013	91ae15c2-f762-11e1-a439-00145eb45e9a
756	756	0	GBIF Germany	4f6826f2-4ff6-443d-b966-e6913bd24013	92082f58-f762-11e1-a439-00145eb45e9a
7	5	-2	GBIF Germany	4f6826f2-4ff6-443d-b966-e6913bd24013	92241f4c-f762-11e1-a439-00145eb45e9a
2	2	0	Plazi	ffb07bec-2d10-492d-9c37-361fe0b79427	92cd7f44-119e-4667-867c-e458d12ab547
12	10	-2	GBIF Germany	4f6826f2-4ff6-443d-b966-e6913bd24013	92df497a-f762-11e1-a439-00145eb45e9a
466	466	0	ASEAN Centre for Biodiversity	af2a0fa1-4c8e-4bdc-8954-b1a55e32b0f1	9315c874-84a1-4248-a939-3c573b7c6d3f
234	132	-102	GBIF Germany	4f6826f2-4ff6-443d-b966-e6913bd24013	935286b0-f762-11e1-a439-00145eb45e9a
2400	2400	0	National Biodiversity Network	d897a5b9-35ee-4232-94bd-b0bcaac003c2	937b75cd-cec5-43d7-a782-f546678908f9
877	819	-58	GBIF Germany	4f6826f2-4ff6-443d-b966-e6913bd24013	945cf194-f762-11e1-a439-00145eb45e9a
106	106	0	GBIF Germany	4f6826f2-4ff6-443d-b966-e6913bd24013	952156d8-f762-11e1-a439-00145eb45e9a
477	448	-29	GBIF Germany	4f6826f2-4ff6-443d-b966-e6913bd24013	9536ac18-f762-11e1-a439-00145eb45e9a
11	10	-1	GBIF Germany	4f6826f2-4ff6-443d-b966-e6913bd24013	9573060e-f762-11e1-a439-00145eb45e9a
1036	777	-259	GBIF Germany	4f6826f2-4ff6-443d-b966-e6913bd24013	9730ee16-f762-11e1-a439-00145eb45e9a
1241	1241	0	GBIF Norway	4f829580-180d-46a9-9c87-ed8ec959b545	97ab7d4c-bd4d-4f07-97fe-07c5c9328531
3172	3172	0	GBIF Japan	db5705aa-6a6e-42f1-8942-d77b9f4896ea	9aa6637a-237d-4d00-9ade-4d55117e131f
109	109	0	GBIF France	da44cd31-5901-4687-a106-6d1c7734ee3a	9aecd7c9-f4c9-43ee-9c78-1e0611ab87f5
0	4	4	Plazi	ffb07bec-2d10-492d-9c37-361fe0b79427	a01fefdd-5d54-470e-a0de-d309fd8ef2f8
414	414	0	GBIF Germany	4f6826f2-4ff6-443d-b966-e6913bd24013	a26da383-ee36-49dd-955f-1980c054c389
21	21	0	Participant Node Managers Committee	7f48e0c8-5c96-49ec-b972-30748e339115	a2ea79be-bb29-4ec8-8aea-166dbeebfbe5
213	208	-5	Colombian Biodiversity Information System	7e865cba-7c46-417b-ade5-97f2cf5b7be0	a4f7acd2-5a05-4875-8a4d-6dba1eb84e1a
1	1	0	Plazi	ffb07bec-2d10-492d-9c37-361fe0b79427	a8e9f6a6-8e63-4edc-b479-57383f972b74
162	161	-1	Plazi	ffb07bec-2d10-492d-9c37-361fe0b79427	a9286570-20d6-4a5b-af31-d4717ed26de9
147	147	0	GBIF Germany	4f6826f2-4ff6-443d-b966-e6913bd24013	aaf01eba-1bbd-43bb-b0b9-a1f6641051e2
0	12	12	Plazi	ffb07bec-2d10-492d-9c37-361fe0b79427	abcf7f75-3b3a-41c3-a712-68d9d0f92fad
90	90	0	Plazi	ffb07bec-2d10-492d-9c37-361fe0b79427	ad05fb6a-3087-433c-a1d7-ef8ab0ab966d
3	3	0	Plazi	ffb07bec-2d10-492d-9c37-361fe0b79427	aeb4d1c4-ce18-459a-9339-75944398c276
0	4	4	Plazi	ffb07bec-2d10-492d-9c37-361fe0b79427	b4333e51-45f4-472e-ac99-2f095816f254
778	778	0	National Biodiversity Network	d897a5b9-35ee-4232-94bd-b0bcaac003c2	b58e9847-900a-413d-90e2-712bb7006db6
93	93	0	Colombian Biodiversity Information System	7e865cba-7c46-417b-ade5-97f2cf5b7be0	b7d0a3e1-df1e-4ed8-9e5a-22344b08e2e7
1817	1817	0	GBIF France	da44cd31-5901-4687-a106-6d1c7734ee3a	bcadbe1a-e837-4134-a321-80c3744fc763
0	10	10	Plazi	ffb07bec-2d10-492d-9c37-361fe0b79427	bea046e7-8c01-4094-ad01-925da949d73c
0	11	11	Plazi	ffb07bec-2d10-492d-9c37-361fe0b79427	bea5b1ca-d5b3-4576-ac4b-5362ce08bb7d
3	3	0	Plazi	ffb07bec-2d10-492d-9c37-361fe0b79427	bf522066-d756-4fe2-be4d-d2b6b170562e
0	20	20	Plazi	ffb07bec-2d10-492d-9c37-361fe0b79427	c217be46-2ab9-4c1a-8fea-8e8ece467cdb
48	48	0	GBIF Germany	4f6826f2-4ff6-443d-b966-e6913bd24013	c587c998-fcbb-4d70-aa0a-c35ed69366b8
52876	52876	0	National Biodiversity Network	d897a5b9-35ee-4232-94bd-b0bcaac003c2	c837369b-06d6-4366-bb67-13b50f513025
0	16	16	Plazi	ffb07bec-2d10-492d-9c37-361fe0b79427	c95839c4-68cc-4953-84ad-fc6bbd02d753
124	124	0	Plazi	ffb07bec-2d10-492d-9c37-361fe0b79427	d087447e-0326-4c36-9281-eb561de35057
2	2	0	Plazi	ffb07bec-2d10-492d-9c37-361fe0b79427	d107f2af-cb45-4fd2-9627-3d38037e2412
15	15	0	Plazi	ffb07bec-2d10-492d-9c37-361fe0b79427	d2fbe633-0542-4a0c-b4f1-43a5f4b79189
0	3	3	Plazi	ffb07bec-2d10-492d-9c37-361fe0b79427	d62c6391-034f-4c3f-b2b4-89081547870b
0	64	64	Ocean Biodiversity Information System	ba0670b9-4186-41e6-8e70-f9cb3065551a	d6e89771-825a-41ab-801e-3170c6d33f91
26	26	0	Plazi	ffb07bec-2d10-492d-9c37-361fe0b79427	d81354de-a914-4582-98be-811adbff11df
148664	140188	-8476	National Biodiversity Network	d897a5b9-35ee-4232-94bd-b0bcaac003c2	db1abc39-7b60-4103-815d-820fa37cb62b
2	2	0	Plazi	ffb07bec-2d10-492d-9c37-361fe0b79427	dc7ad875-1852-4d00-955d-f8e78f3715bd
861	861	0	Plazi	ffb07bec-2d10-492d-9c37-361fe0b79427	dc853cca-9ba5-4842-8037-a49765063314
0	9	9	Participant Node Managers Committee	7f48e0c8-5c96-49ec-b972-30748e339115	dde87667-2d51-491d-96d2-1b0e64e209d2
6	6	0	Plazi	ffb07bec-2d10-492d-9c37-361fe0b79427	df69e9a0-206e-4422-9ffa-91c915d01ebf
761	761	0	Biodiversity Information System of Mexico	b324e8e9-9a4c-44fa-8f1a-7f39ea7ab576	e56a116e-0cfc-4382-a772-162ac2a44a7c
38	38	0	Plazi	ffb07bec-2d10-492d-9c37-361fe0b79427	e6194d20-a67b-4815-bda6-548c4066d051
0	1	1	Plazi	ffb07bec-2d10-492d-9c37-361fe0b79427	e65a53a5-150a-4a96-8b75-ade7f44030e9
86	86	0	Participant Node Managers Committee	7f48e0c8-5c96-49ec-b972-30748e339115	e78330b9-9502-46d9-a0f5-677abc4885ed
24	24	0	GBIF France	da44cd31-5901-4687-a106-6d1c7734ee3a	e7dcf36a-f1f2-455d-9305-6f44e3d571f7
7	7	0	Plazi	ffb07bec-2d10-492d-9c37-361fe0b79427	e82cebbb-f29b-47ec-9c64-4a60a5bf1630
5	5	0	Plazi	ffb07bec-2d10-492d-9c37-361fe0b79427	e87c55e7-9682-4559-97dc-8983fdd65250
12	12	0	Plazi	ffb07bec-2d10-492d-9c37-361fe0b79427	e93836ab-fc18-4d62-9531-9bf44c472883
480	480	0	GBIF Germany	4f6826f2-4ff6-443d-b966-e6913bd24013	ea4de299-0b86-49dc-a4e3-2c5bd422efe0
14565	15415	850	GBIF Brazil	cdc9736d-5ff7-4ece-9959-3c744360cdb3	ecfe949a-8443-4f14-8c32-d36074ff21e7
3	3	0	Plazi	ffb07bec-2d10-492d-9c37-361fe0b79427	f0779c03-8e65-424d-b680-ff8f219fd345
42979	42979	0	GBIF Benin	efb9c00e-f802-45dd-8826-a52ec45b89ff	f184506e-9dbd-4361-8f33-278b9cd2710d
0	6	6	Plazi	ffb07bec-2d10-492d-9c37-361fe0b79427	f1b1f134-4076-46ce-b6df-cab9ca983101
0	1	1	Ocean Biodiversity Information System	ba0670b9-4186-41e6-8e70-f9cb3065551a	f5c82343-6746-49a1-98a9-026d3045ada3
0	6	6	Plazi	ffb07bec-2d10-492d-9c37-361fe0b79427	f6126738-3f2b-4b1a-9a57-3fc654231838
0	22	22	Plazi	ffb07bec-2d10-492d-9c37-361fe0b79427	f66611f8-2316-488a-9e5f-f1ac1cc2bd91
73	73	0	Korean Biodiversity Information Facility	e0a1e772-0177-4800-94b4-2d023fe6cdf4	f70cf9ff-f560-4984-9ec8-79c2a4e31036
16	16	0	Plazi	ffb07bec-2d10-492d-9c37-361fe0b79427	f8f43b16-9b08-446f-b4dd-e8e1fe8b78e9
0	11	11	Plazi	ffb07bec-2d10-492d-9c37-361fe0b79427	fcdfcc2b-e857-429d-a533-b33421a689e2
5	5	0	Plazi	ffb07bec-2d10-492d-9c37-361fe0b79427	ff3b0833-b49c-4681-9edf-566cfe3cebdb
7248	7248	0	National Biodiversity Network	d897a5b9-35ee-4232-94bd-b0bcaac003c2	ff8ccd90-5f18-47ce-af29-c2d8bcfb8dc7
35	35	0	Plazi	ffb07bec-2d10-492d-9c37-361fe0b79427	01c8fc9d-2504-4b57-9791-d44804074437
2	2	0	Plazi	ffb07bec-2d10-492d-9c37-361fe0b79427	03e7fa30-bb18-4ff2-8429-a0b139871289
290	290	0	Colombian Biodiversity Information System	7e865cba-7c46-417b-ade5-97f2cf5b7be0	06246ede-c3b2-4f35-9967-c285eaf35987
2	2	0	Plazi	ffb07bec-2d10-492d-9c37-361fe0b79427	084c9b17-438a-46b5-8d03-eb856087d518
31936	31936	0	GBIF India	59d15a9b-ba51-43c3-a53f-304fe6732c04	0868d77b-102e-4d0d-ab9a-7855464b606a
382	382	0	GBIF Norway	4f829580-180d-46a9-9c87-ed8ec959b545	0d9bfb0c-5b22-42aa-a7b4-1c96a47c7c86
4	4	0	Plazi	ffb07bec-2d10-492d-9c37-361fe0b79427	0e910557-d5f9-40de-b4b1-48e96a9b3c3d
0	5	5	Plazi	ffb07bec-2d10-492d-9c37-361fe0b79427	117d9718-a23c-4f80-8b5f-a77c6500dee8
174871	176885	2014	U.S. Geological Survey	8618c64a-93e0-4300-b546-7249e5148ed2	13fdfab7-e281-428d-8c1f-e72eb7398e97
4600	4600	0	GBIF Brazil	cdc9736d-5ff7-4ece-9959-3c744360cdb3	1412d4de-9982-4f96-8393-3dc9fe1df74f
3	3	0	Plazi	ffb07bec-2d10-492d-9c37-361fe0b79427	14c5653c-a351-4e02-aeed-a88be4487b71
1335	1335	0	GBIF Portugal	673f7038-4262-4149-b753-5658a4e912f6	17f6f3d0-b5ef-434b-95a8-cc32d8e5236f
23	23	0	Plazi	ffb07bec-2d10-492d-9c37-361fe0b79427	1b25d91d-c28e-48fa-aee7-f7a9d26c61cd
1	1	0	Plazi	ffb07bec-2d10-492d-9c37-361fe0b79427	1b817812-78e4-4871-a70f-73abc507e914
9	9	0	Plazi	ffb07bec-2d10-492d-9c37-361fe0b79427	1f224900-83b8-4929-82cd-8cb454b83d19
101	101	0	GBIF Germany	4f6826f2-4ff6-443d-b966-e6913bd24013	1f45504c-460b-446d-a10d-c6841e98cb67
141	141	0	Plazi	ffb07bec-2d10-492d-9c37-361fe0b79427	1f954e21-5266-43a5-a509-0911df30ac03
14	14	0	Colombian Biodiversity Information System	7e865cba-7c46-417b-ade5-97f2cf5b7be0	22c54de7-f9ab-485c-8870-9a874a38326f
1	1	0	Plazi	ffb07bec-2d10-492d-9c37-361fe0b79427	2307bc47-81c1-41b7-833d-db09a1675d3f
12	12	0	Plazi	ffb07bec-2d10-492d-9c37-361fe0b79427	2464661b-4e9e-4102-9b3d-5dbd75fc2b37
44038	44038	0	National Biodiversity Network	d897a5b9-35ee-4232-94bd-b0bcaac003c2	24769f9b-7b12-4a54-ae9b-0d3d07813202
100	100	0	GBIF Germany	4f6826f2-4ff6-443d-b966-e6913bd24013	25a660ef-eea2-4d26-a57f-6c95f2c115d4
550	550	0	GBIF France	da44cd31-5901-4687-a106-6d1c7734ee3a	27268afd-83c0-4299-bb5e-7748e037c196
9535	9535	0	Participant Node Managers Committee	7f48e0c8-5c96-49ec-b972-30748e339115	276faef3-acd9-40a8-805f-9db8d30f9095
762	762	0	Participant Node Managers Committee	7f48e0c8-5c96-49ec-b972-30748e339115	278feab4-2bb0-4f76-8754-fef92d0cb1f1
1429	1429	0	Atlas of Living Australia	4a6f1b71-969e-4fc5-a693-282b05e1220c	2c0eeb7f-5c59-4e12-8aa2-d02c88bcf5c5
0	4	4	Plazi	ffb07bec-2d10-492d-9c37-361fe0b79427	2c5fd541-5477-4a08-89cb-3624819bce0c
490	490	0	National Biodiversity Network	d897a5b9-35ee-4232-94bd-b0bcaac003c2	2c702d81-6faa-4977-b6f5-64f5a550a660
16	16	0	Plazi	ffb07bec-2d10-492d-9c37-361fe0b79427	2f76ac68-86e8-4862-a6a5-ccb7274f606b
78	78	0	GBIF Chile	a8b16421-d80b-4ef3-8f22-098b01a89255	30c49fbf-4e2e-482e-bb49-4d294bc332cb
0	5	5	Plazi	ffb07bec-2d10-492d-9c37-361fe0b79427	30cfeeeb-5d7b-47ee-9cf9-4b8ee2f29852
38	38	0	Plazi	ffb07bec-2d10-492d-9c37-361fe0b79427	34edffff-49a3-4399-9eb8-f277e190b6a7
0	13	13	Plazi	ffb07bec-2d10-492d-9c37-361fe0b79427	35cc56cd-f4b3-404b-b773-977054676495
0	10	10	Plazi	ffb07bec-2d10-492d-9c37-361fe0b79427	395ff3f5-2cd9-483b-a0bf-f484b57561e1
92	92	0	Plazi	ffb07bec-2d10-492d-9c37-361fe0b79427	39d89261-8d8c-478d-92fe-1841bec00e5a
0	3	3	Plazi	ffb07bec-2d10-492d-9c37-361fe0b79427	3af52a88-d8ac-4def-805e-56225b3db803
45455	45455	0	GBIF Brazil	cdc9736d-5ff7-4ece-9959-3c744360cdb3	3b8a9502-9fed-4b72-8ccf-97ded9c458be
8	8	0	Plazi	ffb07bec-2d10-492d-9c37-361fe0b79427	3f438ffd-0acb-4805-85cb-096bf46c56f7
6	6	0	Plazi	ffb07bec-2d10-492d-9c37-361fe0b79427	47ecfcdf-b9e4-4117-b720-92b64dfe50a9
35	35	0	Plazi	ffb07bec-2d10-492d-9c37-361fe0b79427	4a0c9ed4-01bb-401d-9921-377dcc91e543
9	9	0	GBIF France	da44cd31-5901-4687-a106-6d1c7734ee3a	4b889f2a-ccdf-404a-8ac1-77fe32a42b3a
29	29	0	Plazi	ffb07bec-2d10-492d-9c37-361fe0b79427	50b5779a-b481-4824-a13b-666572e28edc
2	2	0	Plazi	ffb07bec-2d10-492d-9c37-361fe0b79427	50eb973f-78aa-472a-bae2-0e9d28279a14
8	8	0	Plazi	ffb07bec-2d10-492d-9c37-361fe0b79427	514194f0-154c-4ca9-8a21-b66aea36e1bc
63	63	0	Colombian Biodiversity Information System	7e865cba-7c46-417b-ade5-97f2cf5b7be0	519e3a4a-707a-4702-8e84-dca1d636e54b
23	23	0	Plazi	ffb07bec-2d10-492d-9c37-361fe0b79427	5435bf92-28a6-410c-9aa4-8319ea42c49d
2	2	0	National Biodiversity Network	d897a5b9-35ee-4232-94bd-b0bcaac003c2	56b84446-cf9d-49bc-9655-eb5d151eae23
34344	34344	0	U.S. Geological Survey	8618c64a-93e0-4300-b546-7249e5148ed2	577a17c0-b6fa-41cb-b14b-86180bab41f9
58	58	0	Plazi	ffb07bec-2d10-492d-9c37-361fe0b79427	58a72175-61a8-4abe-9322-ad9dd78c34c9
216	216	0	Colombian Biodiversity Information System	7e865cba-7c46-417b-ade5-97f2cf5b7be0	58d5d838-816f-48d6-beab-444d531d01c7
0	31	31	Plazi	ffb07bec-2d10-492d-9c37-361fe0b79427	5a5b8a5d-7350-4319-aa04-381e28290f43
9	9	0	Plazi	ffb07bec-2d10-492d-9c37-361fe0b79427	5b394088-b9b6-4639-8d7c-dfbd52c2f26a
0	2	2	Plazi	ffb07bec-2d10-492d-9c37-361fe0b79427	5d3a53cd-7ddd-4497-b15c-a63e46ae9eed
68	68	0	U.S. Geological Survey	8618c64a-93e0-4300-b546-7249e5148ed2	5e6acf4c-e913-45fd-8466-5c0b92c322dd
741	741	0	GBIF Brazil	cdc9736d-5ff7-4ece-9959-3c744360cdb3	5fc21358-01ab-4e2d-a1b6-7c1705f0ee7f
0	349	349	Plazi	ffb07bec-2d10-492d-9c37-361fe0b79427	5fc76459-f4aa-40ee-811f-35639caad705
12	12	0	Plazi	ffb07bec-2d10-492d-9c37-361fe0b79427	608c704f-2121-4240-8c50-ad6ed7fec186
5375	5375	0	National Biodiversity Network	d897a5b9-35ee-4232-94bd-b0bcaac003c2	61f82781-c827-4ac9-98e9-e854d4ab013f
369	369	0	GBIF Germany	4f6826f2-4ff6-443d-b966-e6913bd24013	63939b62-f762-11e1-a439-00145eb45e9a
104	104	0	GBIF Germany	4f6826f2-4ff6-443d-b966-e6913bd24013	64536dde-f762-11e1-a439-00145eb45e9a
125	125	0	GBIF Germany	4f6826f2-4ff6-443d-b966-e6913bd24013	6645fdbe-f762-11e1-a439-00145eb45e9a
13	13	0	U.S. Geological Survey	8618c64a-93e0-4300-b546-7249e5148ed2	689651c6-00ff-416a-b496-34d2630df7f9
109	109	0	GBIF Germany	4f6826f2-4ff6-443d-b966-e6913bd24013	689b844e-f762-11e1-a439-00145eb45e9a
127	95	-32	GBIF Germany	4f6826f2-4ff6-443d-b966-e6913bd24013	68cfe428-f762-11e1-a439-00145eb45e9a
80	80	0	GBIF Germany	4f6826f2-4ff6-443d-b966-e6913bd24013	699b3d08-f762-11e1-a439-00145eb45e9a
415	415	0	GBIF Germany	4f6826f2-4ff6-443d-b966-e6913bd24013	6a7b1428-f762-11e1-a439-00145eb45e9a
14	14	0	GBIF Germany	4f6826f2-4ff6-443d-b966-e6913bd24013	6a96e892-f762-11e1-a439-00145eb45e9a
18	18	0	GBIF Germany	4f6826f2-4ff6-443d-b966-e6913bd24013	6b1fe692-f762-11e1-a439-00145eb45e9a
2067	2067	0	National Biodiversity Network	d897a5b9-35ee-4232-94bd-b0bcaac003c2	6c5978f7-a390-480a-a302-c1f99df72ab9
204	204	0	GBIF Germany	4f6826f2-4ff6-443d-b966-e6913bd24013	6d298970-f762-11e1-a439-00145eb45e9a
40	40	0	GBIF Germany	4f6826f2-4ff6-443d-b966-e6913bd24013	6d3c7242-f762-11e1-a439-00145eb45e9a
44	44	0	GBIF Germany	4f6826f2-4ff6-443d-b966-e6913bd24013	6d4d3154-f762-11e1-a439-00145eb45e9a
100	100	0	GBIF Germany	4f6826f2-4ff6-443d-b966-e6913bd24013	6ffa1c14-f762-11e1-a439-00145eb45e9a
159	47	-112	GBIF Germany	4f6826f2-4ff6-443d-b966-e6913bd24013	70e43a10-f762-11e1-a439-00145eb45e9a
0	3314	3314	Colombian Biodiversity Information System	7e865cba-7c46-417b-ade5-97f2cf5b7be0	714759d6-bf38-496e-a025-c2fc975db0a0
82	82	0	Biodiversity Information System of Mexico	b324e8e9-9a4c-44fa-8f1a-7f39ea7ab576	7162b803-bde2-4196-9383-263ba6dc9ad3
1259	1259	0	National Biodiversity Network	d897a5b9-35ee-4232-94bd-b0bcaac003c2	71aa529b-c4ac-484a-a169-a925b9b8fdda
15382	15382	0	GBIF Japan	db5705aa-6a6e-42f1-8942-d77b9f4896ea	71db3522-f762-11e1-a439-00145eb45e9a
14	14	0	GBIF Germany	4f6826f2-4ff6-443d-b966-e6913bd24013	73b18cc0-f762-11e1-a439-00145eb45e9a
431	431	0	GBIF Germany	4f6826f2-4ff6-443d-b966-e6913bd24013	748adaca-f762-11e1-a439-00145eb45e9a
118	118	0	GBIF Germany	4f6826f2-4ff6-443d-b966-e6913bd24013	74f722ac-f762-11e1-a439-00145eb45e9a
44879	44879	0	South African Biodiversity Information Facility	7190b835-4e86-4b6e-85c1-19cc6677c250	753f49f5-6ac2-4e88-8abe-f2be9518542e
255	255	0	GBIF Germany	4f6826f2-4ff6-443d-b966-e6913bd24013	75c9a628-f762-11e1-a439-00145eb45e9a
46830	46830	0	Belgian Biodiversity Platform	fb11cfe1-ebc3-45af-9159-17d9fddbcdac	76cc7230-76b6-4763-9caf-22626b29c0a6
10	10	0	GBIF Germany	4f6826f2-4ff6-443d-b966-e6913bd24013	78e92fcc-f762-11e1-a439-00145eb45e9a
0	9	9	Plazi	ffb07bec-2d10-492d-9c37-361fe0b79427	7aaad606-9dd4-47fd-b5bc-e75c8ba2bbb5
22870	22870	0	National Biodiversity Network	d897a5b9-35ee-4232-94bd-b0bcaac003c2	7b30dd11-75c6-4b1b-8ddc-62a07154a760
109	109	0	Ocean Biodiversity Information System	ba0670b9-4186-41e6-8e70-f9cb3065551a	7b6c8226-f762-11e1-a439-00145eb45e9a
753	753	0	GBIF Spain	1f94b3ca-9345-4d65-afe2-4bace93aa0fe	7b75fe0a-f762-11e1-a439-00145eb45e9a
478	478	0	GBIF Germany	4f6826f2-4ff6-443d-b966-e6913bd24013	7c21eaee-f762-11e1-a439-00145eb45e9a
1530	1530	0	GBIF Germany	4f6826f2-4ff6-443d-b966-e6913bd24013	7c67f39a-f762-11e1-a439-00145eb45e9a
0	1	1	Plazi	ffb07bec-2d10-492d-9c37-361fe0b79427	7d1bf0ba-5bf5-4ec0-9b70-e8c6cfe92ec7
0	1155	1155	Participant Node Managers Committee	7f48e0c8-5c96-49ec-b972-30748e339115	7ec930c6-f238-47cd-9807-a2940fe40135
2424	2424	0	Biodiversity Information System of Mexico	b324e8e9-9a4c-44fa-8f1a-7f39ea7ab576	80c74ca6-f762-11e1-a439-00145eb45e9a
255	255	0	Belgian Biodiversity Platform	fb11cfe1-ebc3-45af-9159-17d9fddbcdac	8294e09b-b09e-44da-8264-f77bdd3ac6f6
1659	1659	0	GBIF Finland	dd514216-5c7c-45f3-910d-797424cb5be6	85288d1e-f762-11e1-a439-00145eb45e9a
0	75	75	Ocean Biodiversity Information System	ba0670b9-4186-41e6-8e70-f9cb3065551a	87d6ccf7-b8d5-4daf-8b6e-9ebb07d06344
143	143	0	GBIF Germany	4f6826f2-4ff6-443d-b966-e6913bd24013	885171b8-f762-11e1-a439-00145eb45e9a
625	156	-469	GBIF Germany	4f6826f2-4ff6-443d-b966-e6913bd24013	886407e2-f762-11e1-a439-00145eb45e9a
1188	1151	-37	GBIF Germany	4f6826f2-4ff6-443d-b966-e6913bd24013	88d1635a-f762-11e1-a439-00145eb45e9a
667	667	0	Ocean Biodiversity Information System	ba0670b9-4186-41e6-8e70-f9cb3065551a	89121440-f762-11e1-a439-00145eb45e9a
668	668	0	GBIF Germany	4f6826f2-4ff6-443d-b966-e6913bd24013	89826254-f762-11e1-a439-00145eb45e9a
10	10	0	GBIF Germany	4f6826f2-4ff6-443d-b966-e6913bd24013	8c20488c-f762-11e1-a439-00145eb45e9a
80	70	-10	GBIF Germany	4f6826f2-4ff6-443d-b966-e6913bd24013	8d23c27c-f762-11e1-a439-00145eb45e9a
590	590	0	GBIF Germany	4f6826f2-4ff6-443d-b966-e6913bd24013	8f1be7a8-f762-11e1-a439-00145eb45e9a
1997	1754	-243	GBIF Germany	4f6826f2-4ff6-443d-b966-e6913bd24013	8f77fe8a-f762-11e1-a439-00145eb45e9a
9	5	-4	GBIF Germany	4f6826f2-4ff6-443d-b966-e6913bd24013	904af1aa-f762-11e1-a439-00145eb45e9a
568	406	-162	GBIF Germany	4f6826f2-4ff6-443d-b966-e6913bd24013	9230bdf6-f762-11e1-a439-00145eb45e9a
0	4	4	Plazi	ffb07bec-2d10-492d-9c37-361fe0b79427	92abbb95-c258-449c-bf8f-7386d3e3e015
20	20	0	GBIF France	da44cd31-5901-4687-a106-6d1c7734ee3a	930a3876-8c30-44c6-b9cb-90e554872234
80364	80364	0	GBIF France	da44cd31-5901-4687-a106-6d1c7734ee3a	93773ae8-f7c4-44b3-8793-761bb0561050
7	7	0	GBIF Germany	4f6826f2-4ff6-443d-b966-e6913bd24013	9575f080-f762-11e1-a439-00145eb45e9a
21152	21562	410	GBIF Germany	4f6826f2-4ff6-443d-b966-e6913bd24013	96653d3e-f762-11e1-a439-00145eb45e9a
754	754	0	GBIF Argentina	2426a871-9feb-40a1-96c6-0c593a76b835	96ae4c36-73e0-42cb-bc9e-0441fbd0044b
10	10	0	GBIF Germany	4f6826f2-4ff6-443d-b966-e6913bd24013	975fe6b2-f762-11e1-a439-00145eb45e9a
0	14	14	Plazi	ffb07bec-2d10-492d-9c37-361fe0b79427	98065579-72ac-418e-a262-4f0c9bbd6047
39	39	0	Plazi	ffb07bec-2d10-492d-9c37-361fe0b79427	992e5970-537b-440f-b570-873a2169a74a
19336	19336	0	Colombian Biodiversity Information System	7e865cba-7c46-417b-ade5-97f2cf5b7be0	9a25dd5f-eb12-47f3-8a7e-51b8e3824600
14062	16005	1943	GBIF Norway	4f829580-180d-46a9-9c87-ed8ec959b545	9ea87732-b88e-488d-a02b-3dc6e9b885e0
74	74	0	Biodiversity Information System of Mexico	b324e8e9-9a4c-44fa-8f1a-7f39ea7ab576	a0ae8151-43d1-4ae0-a2a1-9e4ab9624d72
763	763	0	GBIF Andorra	8df8d012-8e64-4c8a-886e-521a3bdfa623	a284215e-fa58-4459-8195-07ec433d6fca
12	12	0	Plazi	ffb07bec-2d10-492d-9c37-361fe0b79427	a3835af5-d8ea-48a7-a3c4-559b9f66f45d
0	35	35	Plazi	ffb07bec-2d10-492d-9c37-361fe0b79427	a4a24d7e-754a-4fd9-9bb4-7248b2f56b1b
600	600	0	Colombian Biodiversity Information System	7e865cba-7c46-417b-ade5-97f2cf5b7be0	a5a24963-86c7-46d0-88bd-f3641528beec
1154	1154	0	GBIF Benin	efb9c00e-f802-45dd-8826-a52ec45b89ff	a5a93c20-5100-413f-a181-382850354c1f
94842	94842	0	National Biodiversity Network	d897a5b9-35ee-4232-94bd-b0bcaac003c2	a814f323-ccc0-44b7-b188-4c155867deb7
2252	2252	0	DanBIF - Danish Biodiversity Information Facility	4ddd294f-02b7-4359-ac33-0806a9ca9c6b	a968d7e9-5391-482d-8927-4b34b9863d56
0	15130	15130	Ocean Biodiversity Information System	ba0670b9-4186-41e6-8e70-f9cb3065551a	a9ab5b7d-a8d1-44b7-8ade-851f3ce6fa54
0	141813	141813	National Biodiversity Network	d897a5b9-35ee-4232-94bd-b0bcaac003c2	b0d83536-9102-4aa6-ad8f-570b9db6c77e
441	441	0	Colombian Biodiversity Information System	7e865cba-7c46-417b-ade5-97f2cf5b7be0	b2334c74-b73f-4cfb-b088-683119fa3c6e
0	278	278	Ocean Biodiversity Information System	ba0670b9-4186-41e6-8e70-f9cb3065551a	b47c35d2-c359-434c-82f1-16eac06825c8
249	254	5	GBIF Germany	4f6826f2-4ff6-443d-b966-e6913bd24013	b5ad2e48-9c05-4c7a-8650-c38621b1f794
0	100	100	Plazi	ffb07bec-2d10-492d-9c37-361fe0b79427	b60c12cf-1c90-462e-87f7-85fa52dcadfe
0	61049	61049	Ocean Biodiversity Information System	ba0670b9-4186-41e6-8e70-f9cb3065551a	b6825775-b59a-4f8a-af17-a4ab5569c35f
100	100	0	U.S. Geological Survey	8618c64a-93e0-4300-b546-7249e5148ed2	b7dfced8-d4ec-476d-b21d-2dfb53fe2be3
51	51	0	Plazi	ffb07bec-2d10-492d-9c37-361fe0b79427	baaab7b7-20ad-48fe-881d-2d96d8536110
0	471	471	Ocean Biodiversity Information System	ba0670b9-4186-41e6-8e70-f9cb3065551a	bdc846be-45eb-43b4-aa1e-31aa418a4ab4
34	34	0	GBIF Japan	db5705aa-6a6e-42f1-8942-d77b9f4896ea	becc070e-edd1-4415-b819-6ad037bbb5a4
1671	1671	0	GBIF France	da44cd31-5901-4687-a106-6d1c7734ee3a	c12c9ab6-c4f0-4e23-9f1c-a38070ba3d42
141	141	0	GBIF France	da44cd31-5901-4687-a106-6d1c7734ee3a	c978d07e-ba09-4ca1-808c-b352f791a06f
0	9	9	Plazi	ffb07bec-2d10-492d-9c37-361fe0b79427	ca0fbe5d-f1d6-4290-b22d-2eae88d76ec5
0	4	4	Plazi	ffb07bec-2d10-492d-9c37-361fe0b79427	cafcbd6e-17e3-4a02-9577-a07538dffba8
771	771	0	GBIF Brazil	cdc9736d-5ff7-4ece-9959-3c744360cdb3	cb43df0e-a35a-4a2f-8493-24f11cd51feb
26	26	0	Plazi	ffb07bec-2d10-492d-9c37-361fe0b79427	cbbb6660-6e76-4c05-8311-b79bc9a65b29
2613	2613	0	Participant Node Managers Committee	7f48e0c8-5c96-49ec-b972-30748e339115	cc353435-511d-4ba2-b88d-b874d22c7a0a
93	93	0	GBIF France	da44cd31-5901-4687-a106-6d1c7734ee3a	cda3bb07-8f7c-442a-b8a7-2dfdf540861c
0	2685	2685	Colombian Biodiversity Information System	7e865cba-7c46-417b-ade5-97f2cf5b7be0	d72d958f-e0c5-4c25-a3fe-771bfaecddb7
0	69151	69151	GBIF Portugal	673f7038-4262-4149-b753-5658a4e912f6	d836d73a-5686-44ff-9cc4-86fffa53bac2
1929	1929	0	GBIF Brazil	cdc9736d-5ff7-4ece-9959-3c744360cdb3	db44543f-c1f5-4241-b9ab-1ed1c1b4ece1
600	600	0	Atlas of Living Australia	4a6f1b71-969e-4fc5-a693-282b05e1220c	dce0d7ca-50b5-4d61-9a0f-dad4b55fb94d
0	60	60	Plazi	ffb07bec-2d10-492d-9c37-361fe0b79427	ddbdc4ea-a921-4961-b58d-4b28fed11e68
0	21	21	Plazi	ffb07bec-2d10-492d-9c37-361fe0b79427	de38fd7a-7600-4012-aa85-7a8fb64d41df
49576	49576	0	South African Biodiversity Information Facility	7190b835-4e86-4b6e-85c1-19cc6677c250	df14ad14-c42d-4527-af3d-204892b6de43
2517	2517	0	GBIF France	da44cd31-5901-4687-a106-6d1c7734ee3a	e28d75be-56a1-4eb2-988e-cb560d44141b
0	33709	33709	DanBIF - Danish Biodiversity Information Facility	4ddd294f-02b7-4359-ac33-0806a9ca9c6b	e5c5cad9-b987-4bb4-b07b-85488c5fdd80
0	32	32	Plazi	ffb07bec-2d10-492d-9c37-361fe0b79427	e6e68116-fbef-4ce3-a454-ad98875b9fe4
104	104	0	Plazi	ffb07bec-2d10-492d-9c37-361fe0b79427	eb673df4-addc-4ff1-a244-12940e61c6ac
0	4	4	Plazi	ffb07bec-2d10-492d-9c37-361fe0b79427	ec416347-a1e4-4ced-9cae-25f01ae8295c
422	422	0	Colombian Biodiversity Information System	7e865cba-7c46-417b-ade5-97f2cf5b7be0	efedb425-09ae-4220-831b-51f7b1ab48eb
156	156	0	U.S. Geological Survey	8618c64a-93e0-4300-b546-7249e5148ed2	f4b56e69-4ff5-4cd2-bc48-ec273232d9e0
4	4	0	Plazi	ffb07bec-2d10-492d-9c37-361fe0b79427	f91be13d-b3c2-4843-b2c5-f6fbc2d34b96
0	13	13	Plazi	ffb07bec-2d10-492d-9c37-361fe0b79427	f9d8d8e6-7a13-411e-a6ee-8f156ac817cf
31	31	0	Plazi	ffb07bec-2d10-492d-9c37-361fe0b79427	fa1491f3-0298-4189-ab75-a4cc0391fe89
3	3	0	Plazi	ffb07bec-2d10-492d-9c37-361fe0b79427	fda8a42c-e690-401b-b536-861cf6b13d61
8857	8857	0	GBIF Andorra	8df8d012-8e64-4c8a-886e-521a3bdfa623	01ebc7a6-18ad-4755-a619-dfeccba0eb57
572	572	0	GBIF Germany	4f6826f2-4ff6-443d-b966-e6913bd24013	06877c9c-7226-416f-9ed6-c829f74cde97
80	80	0	Plazi	ffb07bec-2d10-492d-9c37-361fe0b79427	07592748-1046-4033-86f6-385de81795d7
7	7	0	Plazi	ffb07bec-2d10-492d-9c37-361fe0b79427	0860c42c-a07f-452f-873f-7ec6178e355b
4	4	0	Plazi	ffb07bec-2d10-492d-9c37-361fe0b79427	08eb2543-8ce6-4fc9-8225-edffaaa77bd0
0	20	20	Ocean Biodiversity Information System	ba0670b9-4186-41e6-8e70-f9cb3065551a	0b216a5f-ac3c-4510-8c70-9c706ff1a745
0	2	2	Plazi	ffb07bec-2d10-492d-9c37-361fe0b79427	0d052643-2b38-4a53-be4b-6038931ee4eb
8	8	0	Plazi	ffb07bec-2d10-492d-9c37-361fe0b79427	0e78be95-ea62-4470-8f90-d17ce4ffd47e
10358	10358	0	GBIF Benin	efb9c00e-f802-45dd-8826-a52ec45b89ff	0eac2479-e5d8-4e9d-bc7d-9dc689c159d5
85	85	0	GBIF Portugal	673f7038-4262-4149-b753-5658a4e912f6	1938622a-61a3-4ee0-869f-3d115f9ffd29
35	35	0	Plazi	ffb07bec-2d10-492d-9c37-361fe0b79427	1c5e0132-a83c-400e-bd2c-23cf881b28ff
0	17	17	Plazi	ffb07bec-2d10-492d-9c37-361fe0b79427	200464b2-9835-4512-8208-17d8668c20b1
0	3	3	Plazi	ffb07bec-2d10-492d-9c37-361fe0b79427	21a70b55-7a6c-429a-a2fa-b7c2bb46778a
1344	1344	0	GBIF Germany	4f6826f2-4ff6-443d-b966-e6913bd24013	2397e566-062d-4dd9-96cb-f65d9d5ad757
1657	1657	0	GBIF France	da44cd31-5901-4687-a106-6d1c7734ee3a	26b38a0b-adb7-4b2b-a55b-ad632b5a7777
1437	1437	0	Colombian Biodiversity Information System	7e865cba-7c46-417b-ade5-97f2cf5b7be0	2791b3c1-f3cb-40f1-a157-6df1d8b76872
0	4	4	Plazi	ffb07bec-2d10-492d-9c37-361fe0b79427	28281727-c376-48b8-a172-f28a6eb627b4
68	68	0	GBIF France	da44cd31-5901-4687-a106-6d1c7734ee3a	2c09f6f8-8026-4564-9ffd-ba394f537bb7
0	140	140	GBIF Benin	efb9c00e-f802-45dd-8826-a52ec45b89ff	2cdaf7dd-a722-4ede-96c6-b51e92cc52d2
0	103	103	Ocean Biodiversity Information System	ba0670b9-4186-41e6-8e70-f9cb3065551a	2e13fd45-8e7a-4165-abac-77b3d3c759a1
102	102	0	GBIF Japan	db5705aa-6a6e-42f1-8942-d77b9f4896ea	3150a0db-309a-4d10-82bc-f54b99a57050
0	1	1	Plazi	ffb07bec-2d10-492d-9c37-361fe0b79427	32c2be6d-7884-4ee9-a08d-bf3b5e0d7bd4
7	7	0	Plazi	ffb07bec-2d10-492d-9c37-361fe0b79427	360cc693-b339-4e55-944a-b5d9bf74640b
160	160	0	GBIF Germany	4f6826f2-4ff6-443d-b966-e6913bd24013	361c9e2f-95ec-49fc-bc90-8fb59c660bce
2	2	0	Plazi	ffb07bec-2d10-492d-9c37-361fe0b79427	36788779-1419-4327-9055-08f19a73c4c1
0	20	20	Plazi	ffb07bec-2d10-492d-9c37-361fe0b79427	38bb3ec2-51c6-4ffe-bf28-6f28266c2eaa
0	6	6	Plazi	ffb07bec-2d10-492d-9c37-361fe0b79427	3937388b-098b-4c3f-a4e9-f7b412dfe891
3301	3301	0	GBIF France	da44cd31-5901-4687-a106-6d1c7734ee3a	3971bca0-8a36-48b0-850f-886eb89e527a
26256	26256	0	GBIF France	da44cd31-5901-4687-a106-6d1c7734ee3a	3b5f32ff-46d0-4c9b-a247-100afd96f331
45	45	0	Plazi	ffb07bec-2d10-492d-9c37-361fe0b79427	3db2d6f0-b1cd-4085-91b7-df07ea93e7c7
25934	25934	0	Biodiversity Information System of Mexico	b324e8e9-9a4c-44fa-8f1a-7f39ea7ab576	4101e9c9-d157-4f84-83f7-7a1702f1160d
220	220	0	Biodiversity Information System of Mexico	b324e8e9-9a4c-44fa-8f1a-7f39ea7ab576	4522ce7f-1aeb-46d8-8fc6-dd076386166c
5	5	0	Plazi	ffb07bec-2d10-492d-9c37-361fe0b79427	46c214c0-1edb-462c-9bdd-4dc47b942ccf
1	1	0	Plazi	ffb07bec-2d10-492d-9c37-361fe0b79427	48001044-ef9a-4dbc-b3e9-ad047a03d9d0
24	24	0	Biodiversity Information System of Mexico	b324e8e9-9a4c-44fa-8f1a-7f39ea7ab576	4dd50bab-4ec5-4be7-8e04-4eb4af70024e
0	5	5	Plazi	ffb07bec-2d10-492d-9c37-361fe0b79427	51ced6da-6898-4989-86fe-b815d9eedc09
0	14502	14502	Biodiversity Information System of Mexico	b324e8e9-9a4c-44fa-8f1a-7f39ea7ab576	52b626a0-20c9-42fa-8f0e-c3447504c428
0	2	2	Plazi	ffb07bec-2d10-492d-9c37-361fe0b79427	5563e143-2e65-4e35-bbc8-bd4c99608364
855	855	0	GBIF Norway	4f829580-180d-46a9-9c87-ed8ec959b545	58483402-e918-4fbd-9d6d-66975a34262b
122	122	0	GBIF France	da44cd31-5901-4687-a106-6d1c7734ee3a	593f5a48-a687-4c93-a5b1-778c93b85d48
45	45	0	Plazi	ffb07bec-2d10-492d-9c37-361fe0b79427	5973e41e-4808-4a2f-a220-7afe5c899cff
112	112	0	GBIF Norway	4f829580-180d-46a9-9c87-ed8ec959b545	5a8d4f46-ff7c-442b-a8da-1e312cbaafb5
253	253	0	Albertine Rift Conservation Society	90a939d3-e99c-4f6d-915f-2616423b3735	5e756c82-e503-438c-8caf-63a8f8fa1725
832	832	0	GBIF France	da44cd31-5901-4687-a106-6d1c7734ee3a	5f6ec4b7-a2e6-4f78-b529-a824bbb3ddf3
104	104	0	GBIF Germany	4f6826f2-4ff6-443d-b966-e6913bd24013	607c2a1e-8352-4152-ad87-e848da2bc302
28	28	0	GBIF Germany	4f6826f2-4ff6-443d-b966-e6913bd24013	621c1d4a-f762-11e1-a439-00145eb45e9a
134	134	0	GBIF Germany	4f6826f2-4ff6-443d-b966-e6913bd24013	624d1ad0-f762-11e1-a439-00145eb45e9a
678	678	0	Polish Biodiversity Information Network	2618bfdf-e194-4911-a241-80db3107bc51	62f49c30-925e-11da-8900-b8a03c50a862
3	3	0	GBIF Germany	4f6826f2-4ff6-443d-b966-e6913bd24013	630846b6-f762-11e1-a439-00145eb45e9a
106	106	0	GBIF Germany	4f6826f2-4ff6-443d-b966-e6913bd24013	63dc21e8-f762-11e1-a439-00145eb45e9a
4	4	0	Plazi	ffb07bec-2d10-492d-9c37-361fe0b79427	67dbf573-5358-4a7f-80a6-fd07df93fdb1
94	94	0	GBIF Germany	4f6826f2-4ff6-443d-b966-e6913bd24013	68624efe-f762-11e1-a439-00145eb45e9a
2346	2032	-314	GBIF Germany	4f6826f2-4ff6-443d-b966-e6913bd24013	691fc380-f762-11e1-a439-00145eb45e9a
26	26	0	GBIF Germany	4f6826f2-4ff6-443d-b966-e6913bd24013	6924c326-f762-11e1-a439-00145eb45e9a
443	443	0	National Biodiversity Network	d897a5b9-35ee-4232-94bd-b0bcaac003c2	6926a608-d969-49f2-a800-1ad44b41893c
506	506	0	GBIF Germany	4f6826f2-4ff6-443d-b966-e6913bd24013	6972591a-f762-11e1-a439-00145eb45e9a
102	102	0	GBIF Germany	4f6826f2-4ff6-443d-b966-e6913bd24013	69a69964-f762-11e1-a439-00145eb45e9a
42	42	0	GBIF Germany	4f6826f2-4ff6-443d-b966-e6913bd24013	6ab7a6f4-f762-11e1-a439-00145eb45e9a
16	16	0	GBIF Germany	4f6826f2-4ff6-443d-b966-e6913bd24013	6b0c190a-f762-11e1-a439-00145eb45e9a
28637	28637	0	GBIF France	da44cd31-5901-4687-a106-6d1c7734ee3a	6bbd9c2d-bde0-4f31-8aa2-287192c5c11b
22	22	0	GBIF Germany	4f6826f2-4ff6-443d-b966-e6913bd24013	6be67e88-f762-11e1-a439-00145eb45e9a
5	5	0	Plazi	ffb07bec-2d10-492d-9c37-361fe0b79427	6ca65215-39b7-4597-b3b8-ea64b1a99fb0
161	161	0	GBIF Germany	4f6826f2-4ff6-443d-b966-e6913bd24013	6d1ba378-f762-11e1-a439-00145eb45e9a
1674	1674	0	Colombian Biodiversity Information System	7e865cba-7c46-417b-ade5-97f2cf5b7be0	6ef4f828-093b-48a0-9215-d09e44ce9de7
5	5	0	GBIF Germany	4f6826f2-4ff6-443d-b966-e6913bd24013	716c3046-f762-11e1-a439-00145eb45e9a
82	82	0	GBIF Germany	4f6826f2-4ff6-443d-b966-e6913bd24013	7196b35c-f762-11e1-a439-00145eb45e9a
50	50	0	GBIF Germany	4f6826f2-4ff6-443d-b966-e6913bd24013	71b61918-f762-11e1-a439-00145eb45e9a
30	30	0	GBIF Germany	4f6826f2-4ff6-443d-b966-e6913bd24013	73cec8c6-f762-11e1-a439-00145eb45e9a
252	252	0	GBIF France	da44cd31-5901-4687-a106-6d1c7734ee3a	757c4616-2201-4c9a-bff9-d1cf7d173ff0
307	307	0	GBIF Norway	4f829580-180d-46a9-9c87-ed8ec959b545	75969a1c-4ab3-4cd5-b44b-a9650f177fe9
24	24	0	Plazi	ffb07bec-2d10-492d-9c37-361fe0b79427	76ef5b8e-a344-4fee-b58c-5072d2a7f577
3	3	0	Plazi	ffb07bec-2d10-492d-9c37-361fe0b79427	775d8166-02ea-49c5-a526-c7dd6a387744
20406	20406	0	Korean Biodiversity Information Facility	e0a1e772-0177-4800-94b4-2d023fe6cdf4	7b12d910-f762-11e1-a439-00145eb45e9a
1541	1382	-159	GBIF Germany	4f6826f2-4ff6-443d-b966-e6913bd24013	7d84328e-f762-11e1-a439-00145eb45e9a
890	890	0	GBIF Germany	4f6826f2-4ff6-443d-b966-e6913bd24013	7de0a0d2-f762-11e1-a439-00145eb45e9a
63	63	0	GBIF Germany	4f6826f2-4ff6-443d-b966-e6913bd24013	7e1393e8-f762-11e1-a439-00145eb45e9a
4961	4961	0	GBIF Germany	4f6826f2-4ff6-443d-b966-e6913bd24013	7e40ea6e-f762-11e1-a439-00145eb45e9a
105	105	0	GBIF Germany	4f6826f2-4ff6-443d-b966-e6913bd24013	7edea7cc-f762-11e1-a439-00145eb45e9a
3560	3339	-221	Biodiversity Information System of Mexico	b324e8e9-9a4c-44fa-8f1a-7f39ea7ab576	809bcf86-f762-11e1-a439-00145eb45e9a
15	15	0	Plazi	ffb07bec-2d10-492d-9c37-361fe0b79427	8170a936-9977-4b4a-9627-6f69bdecfed2
32603	32976	373	GBIF Germany	4f6826f2-4ff6-443d-b966-e6913bd24013	829277c2-f762-11e1-a439-00145eb45e9a
1952	1952	0	Biodiversity Information System of Mexico	b324e8e9-9a4c-44fa-8f1a-7f39ea7ab576	84236384-8c74-4129-b9d7-31d163d8d18b
66743	66743	0	GBIF Japan	db5705aa-6a6e-42f1-8942-d77b9f4896ea	848e55dc-f762-11e1-a439-00145eb45e9a
7290	7290	0	GBIF Finland	dd514216-5c7c-45f3-910d-797424cb5be6	85275ce6-f762-11e1-a439-00145eb45e9a
39	39	0	Colombian Biodiversity Information System	7e865cba-7c46-417b-ade5-97f2cf5b7be0	86374c71-160f-41bb-97aa-e5e8be6a7400
0	29	29	Participant Node Managers Committee	7f48e0c8-5c96-49ec-b972-30748e339115	86e38041-e004-4696-b551-f8597a9f4032
403	403	0	Colombian Biodiversity Information System	7e865cba-7c46-417b-ade5-97f2cf5b7be0	872e35ba-6308-4ea0-8780-0827bd1f091d
152	122	-30	GBIF Germany	4f6826f2-4ff6-443d-b966-e6913bd24013	8752d5ae-f762-11e1-a439-00145eb45e9a
642	481	-161	GBIF Germany	4f6826f2-4ff6-443d-b966-e6913bd24013	8768015e-f762-11e1-a439-00145eb45e9a
36376	36376	0	Colombian Biodiversity Information System	7e865cba-7c46-417b-ade5-97f2cf5b7be0	88ef77c2-a7eb-4849-93e0-74dd409d7a15
2	2	0	Plazi	ffb07bec-2d10-492d-9c37-361fe0b79427	89e7414f-89c1-4b23-a74d-bc298c2f8617
122590	129519	6929	U.S. Geological Survey	8618c64a-93e0-4300-b546-7249e5148ed2	8a43c2b7-5976-457d-9f35-a232655efdcc
121	121	0	GBIF Germany	4f6826f2-4ff6-443d-b966-e6913bd24013	8ba12e58-f762-11e1-a439-00145eb45e9a
0	4	4	Plazi	ffb07bec-2d10-492d-9c37-361fe0b79427	8c4edd5d-da39-4e7c-bb38-277fe7aa7131
0	25	25	Plazi	ffb07bec-2d10-492d-9c37-361fe0b79427	8d93af91-9490-40ee-8585-797b2accd9ce
10	10	0	Plazi	ffb07bec-2d10-492d-9c37-361fe0b79427	8e909fbd-090e-4d8e-8f37-0b6d91b3da67
110	56	-54	GBIF Germany	4f6826f2-4ff6-443d-b966-e6913bd24013	9022097a-f762-11e1-a439-00145eb45e9a
115	65	-50	GBIF Germany	4f6826f2-4ff6-443d-b966-e6913bd24013	90621c04-f762-11e1-a439-00145eb45e9a
1632	1632	0	GBIF Germany	4f6826f2-4ff6-443d-b966-e6913bd24013	9406b478-f762-11e1-a439-00145eb45e9a
208	208	0	GBIF Germany	4f6826f2-4ff6-443d-b966-e6913bd24013	942acd66-1cd3-47e7-b4e3-865f22b22cdc
31468	31468	0	National Biodiversity Data Centre	422b00b2-6c94-4bb6-976b-c359916efdb8	94c821bd-28bf-4571-a97e-e696ba2f3425
369	369	0	GBIF Germany	4f6826f2-4ff6-443d-b966-e6913bd24013	952ce3c6-0fc2-41f2-85e4-c04162997103
0	14	14	Plazi	ffb07bec-2d10-492d-9c37-361fe0b79427	9538fac8-39c0-4fe6-90d5-4b86b118d0d9
15	15	0	GBIF Germany	4f6826f2-4ff6-443d-b966-e6913bd24013	9616ab92-f762-11e1-a439-00145eb45e9a
818	813	-5	GBIF Germany	4f6826f2-4ff6-443d-b966-e6913bd24013	9674e612-f762-11e1-a439-00145eb45e9a
65	65	0	Plazi	ffb07bec-2d10-492d-9c37-361fe0b79427	a039fb3d-4834-4a9a-a868-d7a8b312ecf7
0	302	302	Ocean Biodiversity Information System	ba0670b9-4186-41e6-8e70-f9cb3065551a	a24a4603-c368-4b95-9764-c2521ba90674
5	5	0	Plazi	ffb07bec-2d10-492d-9c37-361fe0b79427	a4391bbb-b0ae-4ea4-91b1-c3d8660ca183
0	30	30	Plazi	ffb07bec-2d10-492d-9c37-361fe0b79427	a43d0118-9df5-4970-a316-0dae5c9caebf
2	2	0	Plazi	ffb07bec-2d10-492d-9c37-361fe0b79427	a7a97942-217c-4e0e-8563-969409805c6e
760	180	-580	GBIF Germany	4f6826f2-4ff6-443d-b966-e6913bd24013	aa183b19-e13c-4771-8e55-e047de2befa9
4	4	0	Plazi	ffb07bec-2d10-492d-9c37-361fe0b79427	aa771087-bb54-442a-9aa4-dcabd00e5dfc
35	35	0	Plazi	ffb07bec-2d10-492d-9c37-361fe0b79427	ab7d8c5f-f732-4f73-9e1f-5fe2bae6c9a7
1132	1132	0	National Biodiversity Network	d897a5b9-35ee-4232-94bd-b0bcaac003c2	ae0fcc70-dcee-4e26-9a35-eebe0c612d2b
418	418	0	GBIF Portugal	673f7038-4262-4149-b753-5658a4e912f6	b03dce75-cbc2-457b-8725-33885d766a05
0	368	368	Ocean Biodiversity Information System	ba0670b9-4186-41e6-8e70-f9cb3065551a	b28ab171-d7bd-4778-a3ba-ba2561599616
6965	6965	0	Ocean Biodiversity Information System	ba0670b9-4186-41e6-8e70-f9cb3065551a	b52cb0c3-c024-46c4-b7b2-d635400ff6d1
0	2168	2168	GBIF Norway	4f829580-180d-46a9-9c87-ed8ec959b545	b581fcfa-9f31-431a-8431-1800ef8a554b
0	4	4	Plazi	ffb07bec-2d10-492d-9c37-361fe0b79427	b85906d7-309b-4476-980d-10d60e5d2c09
2	2	0	Plazi	ffb07bec-2d10-492d-9c37-361fe0b79427	b8846aeb-1cfb-4366-9274-1161f36b04ce
1	1	0	Plazi	ffb07bec-2d10-492d-9c37-361fe0b79427	bacbb157-079b-4a5e-8888-3f7b51d33d7e
1339	1339	0	U.S. Geological Survey	8618c64a-93e0-4300-b546-7249e5148ed2	bdce0b4b-9ec3-481b-9f44-683ac1844d1d
34	34	0	National Biodiversity Network	d897a5b9-35ee-4232-94bd-b0bcaac003c2	c153014a-4a66-4d0d-a4ec-944f0f1f6778
60	60	0	Plazi	ffb07bec-2d10-492d-9c37-361fe0b79427	c4300524-16b4-47bb-a6ea-68dbc2cc871f
2	2	0	Plazi	ffb07bec-2d10-492d-9c37-361fe0b79427	c43f2005-b621-40dd-a1bf-bc66a4dcb49c
0	7022	7022	National Biodiversity Network	d897a5b9-35ee-4232-94bd-b0bcaac003c2	c4633561-102a-4ff6-bb7d-d615119c45b6
16522	16522	0	Colombian Biodiversity Information System	7e865cba-7c46-417b-ade5-97f2cf5b7be0	cb8eee02-f83e-4591-bec3-87cdbfee0f59
59	59	0	Plazi	ffb07bec-2d10-492d-9c37-361fe0b79427	ccef5905-96d5-4ea8-b438-168afd46d3fc
32	32	0	National Biodiversity Network	d897a5b9-35ee-4232-94bd-b0bcaac003c2	ce24c1cc-05c1-4555-b0dd-723720f6598b
0	1	1	Plazi	ffb07bec-2d10-492d-9c37-361fe0b79427	cf6c12db-754f-4139-acab-eb6ce69ef0a4
38	38	0	Plazi	ffb07bec-2d10-492d-9c37-361fe0b79427	cffb097a-824a-4a4d-9e24-1962e7e14021
6	6	0	Plazi	ffb07bec-2d10-492d-9c37-361fe0b79427	d486e2bd-99a1-43e0-b18e-56406d8c24ee
4982	4982	0	Colombian Biodiversity Information System	7e865cba-7c46-417b-ade5-97f2cf5b7be0	db0fb078-4134-4dbd-893a-cf7749d33929
3	3	0	Plazi	ffb07bec-2d10-492d-9c37-361fe0b79427	dc6e9f91-90ac-4923-b539-996619048bf6
817	817	0	GBIF France	da44cd31-5901-4687-a106-6d1c7734ee3a	dd53cde6-5f08-4753-866f-3fec2afde6a2
2	2	0	Taiwan Biodiversity Information Facility	e1b85abc-61f9-430f-ba79-6813dec53a0f	e4c1a4c5-42b2-4c1d-9908-c405fe5cd637
8520	8520	0	Biodiversity Information System of Mexico	b324e8e9-9a4c-44fa-8f1a-7f39ea7ab576	e9b9f9d0-bd86-49a2-9695-d72f92ed7548
11	11	0	GBIF Malawi	2a42e4d7-ad4a-41b3-84c4-de4aa7b74d35	ed225529-9908-4670-a359-4165f245b963
0	29	29	Plazi	ffb07bec-2d10-492d-9c37-361fe0b79427	eefc7c47-f381-48f8-a0e3-5cce6761ee76
137	137	0	GBIF France	da44cd31-5901-4687-a106-6d1c7734ee3a	efa0d4fa-f940-40a5-ad85-2a81cba1cd88
0	2	2	Plazi	ffb07bec-2d10-492d-9c37-361fe0b79427	f03264ab-ea94-41d9-b0b2-bc422b490500
62	62	0	Plazi	ffb07bec-2d10-492d-9c37-361fe0b79427	f0eefc2e-cf78-4041-ba3d-61601146871b
864	864	0	GBIF Germany	4f6826f2-4ff6-443d-b966-e6913bd24013	f1090eb9-af73-422f-a508-8308c741eafe
245	245	0	GBIF Germany	4f6826f2-4ff6-443d-b966-e6913bd24013	f1775be9-65a7-46d0-add3-93d06ed95840
2161	2161	0	Biodiversity Information System of Mexico	b324e8e9-9a4c-44fa-8f1a-7f39ea7ab576	f1f0c522-d352-4409-8aeb-99b71bc2370b
6	6	0	Plazi	ffb07bec-2d10-492d-9c37-361fe0b79427	f22444c6-bda4-4c23-9f4b-aa33cc05ae0f
0	11	11	Plazi	ffb07bec-2d10-492d-9c37-361fe0b79427	f34e9863-9f62-4f2a-8819-7e6e8fc09403
0	114	114	Plazi	ffb07bec-2d10-492d-9c37-361fe0b79427	f36e1c1f-1bfa-4fbc-b2dd-5edf6c7173af
419063	419063	0	U.S. Geological Survey	8618c64a-93e0-4300-b546-7249e5148ed2	f519367d-6b9d-411c-b319-99424741e7de
91	91	0	GBIF France	da44cd31-5901-4687-a106-6d1c7734ee3a	f5f8f4ea-d1b0-43d7-82e4-08375e399146
220	220	0	GBIF Germany	4f6826f2-4ff6-443d-b966-e6913bd24013	f738a892-2b88-476f-bfc2-dce4b9c0ffa5
28	28	0	Plazi	ffb07bec-2d10-492d-9c37-361fe0b79427	f7dfd7e8-238c-432a-9eec-0929f785f747
192	192	0	GBIF Germany	4f6826f2-4ff6-443d-b966-e6913bd24013	fa775828-b7e9-11e2-9aa5-00145eb45e9a
12	12	0	Plazi	ffb07bec-2d10-492d-9c37-361fe0b79427	fafa6a01-f171-4ad3-a6e6-f8f8904effde
11	11	0	Plazi	ffb07bec-2d10-492d-9c37-361fe0b79427	fbd4967b-53b2-4b88-be1f-ded133d86a07
13662	13662	0	U.S. Geological Survey	8618c64a-93e0-4300-b546-7249e5148ed2	fc53a503-d180-4a63-b8a2-868d56da5420
0	348	348	Ocean Biodiversity Information System	ba0670b9-4186-41e6-8e70-f9cb3065551a	fcc25f03-8437-4ea3-859e-67866de5cb80
14205	14205	0	GBIF Brazil	cdc9736d-5ff7-4ece-9959-3c744360cdb3	fdce6e69-a78c-409c-8d66-dd79ad3fc4e9
259616	259616	0	GBIF France	da44cd31-5901-4687-a106-6d1c7734ee3a	fe4baa57-8f75-472b-982a-7711e3739873
42	42	0	GBIF Germany	4f6826f2-4ff6-443d-b966-e6913bd24013	fecf1a22-ff40-48ec-8135-77262d6317ef
157	157	0	Plazi	ffb07bec-2d10-492d-9c37-361fe0b79427	ff443bfb-3a36-450a-8390-d1bd6be7bdfd
0	10	10	Plazi	ffb07bec-2d10-492d-9c37-361fe0b79427	032dd4c8-e40e-42f5-887f-57c3987ffe2d
0	5	5	Plazi	ffb07bec-2d10-492d-9c37-361fe0b79427	04b26a24-f804-4aa2-b2c5-bd442c63053f
31	31	0	Plazi	ffb07bec-2d10-492d-9c37-361fe0b79427	06cecd47-5575-4d7d-afee-739e71b0e8c8
1	1	0	Plazi	ffb07bec-2d10-492d-9c37-361fe0b79427	0b724b15-f372-4bee-aee4-72b66679e3da
0	6	6	Plazi	ffb07bec-2d10-492d-9c37-361fe0b79427	0b9ff3db-773c-49b9-8d34-8c7a9b041dd2
0	18	18	Ocean Biodiversity Information System	ba0670b9-4186-41e6-8e70-f9cb3065551a	0dc8ef00-c08f-4d3f-bc0a-358e3505cc33
0	21	21	Plazi	ffb07bec-2d10-492d-9c37-361fe0b79427	0eae86d0-3ba1-436c-8e3e-5f7db258cdcf
211	211	0	Plazi	ffb07bec-2d10-492d-9c37-361fe0b79427	10dbb315-5662-4069-a1ae-9692fdf99499
0	84	84	Plazi	ffb07bec-2d10-492d-9c37-361fe0b79427	120db7ca-e885-4d5e-bc3d-83af0671f8d1
953	953	0	National Biodiversity Network	d897a5b9-35ee-4232-94bd-b0bcaac003c2	142f4df0-126e-4926-b4d3-bc5a73e22ce8
0	5	5	Plazi	ffb07bec-2d10-492d-9c37-361fe0b79427	1451533a-1819-4fed-aa53-c45a8f594844
4	4	0	Plazi	ffb07bec-2d10-492d-9c37-361fe0b79427	1527dfee-85c3-4d7e-a13e-82869d9d9017
1219	1219	0	Netherlands Biodiversity Information Facility	0909d601-bda2-42df-9e63-a6d51847ebce	1897eef5-1e10-4842-97f7-cad98925b59d
5163	5163	0	GBIF Germany	4f6826f2-4ff6-443d-b966-e6913bd24013	1aecc602-8847-4980-b493-bb21bb4aace5
3	3	0	Plazi	ffb07bec-2d10-492d-9c37-361fe0b79427	1b360105-050e-4952-b964-04d9d17c2aa1
30	30	0	Plazi	ffb07bec-2d10-492d-9c37-361fe0b79427	1c378233-1a46-406d-8343-a1a6cf6fc028
0	2	2	Plazi	ffb07bec-2d10-492d-9c37-361fe0b79427	1eaf1a12-f1ac-48c7-aedf-3f77a5691765
224	224	0	National Biodiversity Network	d897a5b9-35ee-4232-94bd-b0bcaac003c2	231d282a-de73-484e-bd71-89ef3b177652
1005	1005	0	GBIF Germany	4f6826f2-4ff6-443d-b966-e6913bd24013	24c263e0-2f74-4b46-af0e-4b676b805878
103	103	0	GBIF Germany	4f6826f2-4ff6-443d-b966-e6913bd24013	28037e14-f612-4751-a571-3485bb1a8237
1	1	0	Plazi	ffb07bec-2d10-492d-9c37-361fe0b79427	2844b319-2329-4c41-9513-dec46d91dc35
7329	7329	0	GBIF France	da44cd31-5901-4687-a106-6d1c7734ee3a	2aabb824-abeb-447d-9715-1a5a9cf71ea3
0	481	481	Ocean Biodiversity Information System	ba0670b9-4186-41e6-8e70-f9cb3065551a	2cb88e4b-48f2-4706-804c-4707f4e4fbdd
0	2	2	Plazi	ffb07bec-2d10-492d-9c37-361fe0b79427	2e94ed98-4145-4233-904e-d78772edfb1f
60	60	0	Plazi	ffb07bec-2d10-492d-9c37-361fe0b79427	31d8ae9c-f528-4f75-a558-65cbf715d338
10274	12681	2407	GBIF Brazil	cdc9736d-5ff7-4ece-9959-3c744360cdb3	33082168-ab2e-4e27-b304-8e722a6f5403
1	1	0	Plazi	ffb07bec-2d10-492d-9c37-361fe0b79427	34cf7a53-a4ad-41de-93a1-b061be666ed1
35	35	0	Plazi	ffb07bec-2d10-492d-9c37-361fe0b79427	35b13416-1715-4a8a-a3fb-e03876d9f101
0	41	41	Plazi	ffb07bec-2d10-492d-9c37-361fe0b79427	37bbbcdd-7455-4fd2-854c-49f010b3b27c
17	17	0	Plazi	ffb07bec-2d10-492d-9c37-361fe0b79427	38fa93d4-a7aa-45dc-8959-8b32070d950f
39	39	0	Plazi	ffb07bec-2d10-492d-9c37-361fe0b79427	397c12d8-3d5b-4b84-9e7a-c7159104143c
6543	6866	323	U.S. Geological Survey	8618c64a-93e0-4300-b546-7249e5148ed2	3b64407b-12fd-406e-a996-4a87994fcfc9
2	2	0	Plazi	ffb07bec-2d10-492d-9c37-361fe0b79427	3e683ef4-68f0-4189-8578-e3ae30d0a56d
8190	8190	0	GBIF France	da44cd31-5901-4687-a106-6d1c7734ee3a	420fbdce-1d9c-470a-84da-24664f33e670
71	71	0	GBIF France	da44cd31-5901-4687-a106-6d1c7734ee3a	442f9f26-ded6-4a72-918e-a0391201ec87
362	362	0	GBIF France	da44cd31-5901-4687-a106-6d1c7734ee3a	44641a4b-3b97-4043-ab59-98fb8bcf2548
0	2	2	Plazi	ffb07bec-2d10-492d-9c37-361fe0b79427	45ebb61b-259d-4ac3-bd7c-3a7da0f644f5
0	1	1	Ocean Biodiversity Information System	ba0670b9-4186-41e6-8e70-f9cb3065551a	47ab379d-5a6d-43fd-9c93-7ffca64526ef
0	4	4	Plazi	ffb07bec-2d10-492d-9c37-361fe0b79427	49c5c1ed-1177-495b-8d87-e691bb53d032
910	910	0	National Biodiversity Network	d897a5b9-35ee-4232-94bd-b0bcaac003c2	4ba955bf-646f-47bf-86cc-e47655bb3542
518	518	0	GBIF Spain	1f94b3ca-9345-4d65-afe2-4bace93aa0fe	4edced35-92e1-423d-a873-eb1b68ee2f0f
79	79	0	Plazi	ffb07bec-2d10-492d-9c37-361fe0b79427	4ef66fbb-8da7-4b66-98f3-32d7ea09d712
6	6	0	Participant Node Managers Committee	7f48e0c8-5c96-49ec-b972-30748e339115	4ff601bc-be1c-4328-90bb-a93acb554f09
4158	4158	0	GBIF France	da44cd31-5901-4687-a106-6d1c7734ee3a	4fff018a-40b9-4260-b977-f3b699981217
0	104	104	Plazi	ffb07bec-2d10-492d-9c37-361fe0b79427	5009ea8f-be86-4a45-82cf-0731cb8cca73
1458	1458	0	Observation International	ad048418-7cd8-4070-a151-fe1c1f303129	5024b47d-c401-4543-9780-8890ae6d1e13
48410	52613	4203	National Biodiversity Network	d897a5b9-35ee-4232-94bd-b0bcaac003c2	5180805a-a528-40ea-a03b-4911ef4e4ef6
4	4	0	Plazi	ffb07bec-2d10-492d-9c37-361fe0b79427	55bca41f-c7d6-4433-a820-05861eee5cce
50	50	0	Colombian Biodiversity Information System	7e865cba-7c46-417b-ade5-97f2cf5b7be0	5a04eaa5-f5cd-46c6-a316-b2b12894b380
9035	9035	0	GBIF France	da44cd31-5901-4687-a106-6d1c7734ee3a	5b102996-823d-45a8-9fc4-451172e33856
16	16	0	Plazi	ffb07bec-2d10-492d-9c37-361fe0b79427	5ce64fce-8f34-40f2-ac57-f7b712005538
2202	2202	0	National Biodiversity Network	d897a5b9-35ee-4232-94bd-b0bcaac003c2	5d06e33b-e884-4369-9a1a-fdc8bfa9471c
3621	3621	0	GBIF Finland	dd514216-5c7c-45f3-910d-797424cb5be6	5d324121-3c3c-429b-85f5-5f61a967d8c0
28	30	2	Plazi	ffb07bec-2d10-492d-9c37-361fe0b79427	5ee79342-4297-4a26-ab31-cc2a48e6c2ba
21	21	0	Plazi	ffb07bec-2d10-492d-9c37-361fe0b79427	5fcc010d-8df1-418f-87b1-b29e649ed604
1	1	0	Plazi	ffb07bec-2d10-492d-9c37-361fe0b79427	619e0b96-ba2b-4552-98a7-cdacb88d03e3
25	25	0	GBIF Germany	4f6826f2-4ff6-443d-b966-e6913bd24013	61feb70a-f762-11e1-a439-00145eb45e9a
98	98	0	GBIF Germany	4f6826f2-4ff6-443d-b966-e6913bd24013	6206db60-f762-11e1-a439-00145eb45e9a
3187	3187	0	GBIF Nigeria	6529bcb5-a542-4fda-be87-54a624515335	6297efc0-4442-4e8e-be58-1e0ca7729dac
15	15	0	GBIF Germany	4f6826f2-4ff6-443d-b966-e6913bd24013	62b40e70-f762-11e1-a439-00145eb45e9a
62	62	0	GBIF Germany	4f6826f2-4ff6-443d-b966-e6913bd24013	641f23bc-f762-11e1-a439-00145eb45e9a
20	20	0	GBIF Germany	4f6826f2-4ff6-443d-b966-e6913bd24013	65ac8616-f762-11e1-a439-00145eb45e9a
94	94	0	GBIF Germany	4f6826f2-4ff6-443d-b966-e6913bd24013	65f4e672-f762-11e1-a439-00145eb45e9a
80	80	0	GBIF Germany	4f6826f2-4ff6-443d-b966-e6913bd24013	673b23f2-f762-11e1-a439-00145eb45e9a
34	34	0	Plazi	ffb07bec-2d10-492d-9c37-361fe0b79427	694f85ad-7913-43ea-89b9-8eb4e20f0821
555	555	0	GBIF Germany	4f6826f2-4ff6-443d-b966-e6913bd24013	69763d64-f762-11e1-a439-00145eb45e9a
1827	1827	0	Participant Node Managers Committee	7f48e0c8-5c96-49ec-b972-30748e339115	69bbc9fb-a432-4945-bb4f-654bff3bc2de
161	161	0	GBIF Germany	4f6826f2-4ff6-443d-b966-e6913bd24013	69e21c3c-f762-11e1-a439-00145eb45e9a
759	759	0	Biodiversity Information System of Mexico	b324e8e9-9a4c-44fa-8f1a-7f39ea7ab576	6b39bfe3-0823-4940-b991-32f6ea95bb8b
12	12	0	GBIF Germany	4f6826f2-4ff6-443d-b966-e6913bd24013	6bb06456-f762-11e1-a439-00145eb45e9a
24	24	0	GBIF Germany	4f6826f2-4ff6-443d-b966-e6913bd24013	6bf044ea-f762-11e1-a439-00145eb45e9a
47	47	0	GBIF Germany	4f6826f2-4ff6-443d-b966-e6913bd24013	6d377512-f762-11e1-a439-00145eb45e9a
69	69	0	Plazi	ffb07bec-2d10-492d-9c37-361fe0b79427	6f2821f1-571e-4048-9b33-a1978632386f
110079	110087	8	U.S. Geological Survey	8618c64a-93e0-4300-b546-7249e5148ed2	707e1918-0999-4f2f-9ad1-22c0be104861
5	5	0	Plazi	ffb07bec-2d10-492d-9c37-361fe0b79427	7139708e-922d-41d4-ad42-a5d5f7076f1a
15	15	0	Plazi	ffb07bec-2d10-492d-9c37-361fe0b79427	717a739c-08f8-43a7-9d49-0770b72a9b44
1	1	0	GBIF Germany	4f6826f2-4ff6-443d-b966-e6913bd24013	71a633cc-f762-11e1-a439-00145eb45e9a
804	804	0	GBIF Germany	4f6826f2-4ff6-443d-b966-e6913bd24013	721aacf2-f762-11e1-a439-00145eb45e9a
23	23	0	GBIF Germany	4f6826f2-4ff6-443d-b966-e6913bd24013	74085dac-f762-11e1-a439-00145eb45e9a
68	68	0	Colombian Biodiversity Information System	7e865cba-7c46-417b-ade5-97f2cf5b7be0	74280cbf-dcd9-4155-b462-a6f257ba1484
49	49	0	GBIF Germany	4f6826f2-4ff6-443d-b966-e6913bd24013	7468a144-f762-11e1-a439-00145eb45e9a
90	96	6	Belgian Biodiversity Platform	fb11cfe1-ebc3-45af-9159-17d9fddbcdac	7522721f-4d97-4984-8231-c9e061ef46df
52	52	0	GBIF Germany	4f6826f2-4ff6-443d-b966-e6913bd24013	753ea5be-f762-11e1-a439-00145eb45e9a
30	30	0	GBIF Germany	4f6826f2-4ff6-443d-b966-e6913bd24013	786c0f6a-f762-11e1-a439-00145eb45e9a
10710	10710	0	Korean Biodiversity Information Facility	e0a1e772-0177-4800-94b4-2d023fe6cdf4	7b256e5e-f762-11e1-a439-00145eb45e9a
499	499	0	National Biodiversity Network	d897a5b9-35ee-4232-94bd-b0bcaac003c2	7b917bb4-69cb-47cf-a40e-841a03789130
794	794	0	GBIF Germany	4f6826f2-4ff6-443d-b966-e6913bd24013	7bb8587c-f762-11e1-a439-00145eb45e9a
32	32	0	GBIF Germany	4f6826f2-4ff6-443d-b966-e6913bd24013	7d27e70e-1387-11e2-bb2e-00145eb45e9a
70	70	0	GBIF Guinea	b1cd2e84-c4ba-47bd-b72a-dfd1f92dce0a	7d749af4-fb08-48ab-be14-b5d72894c426
2670	2670	0	GBIF Germany	4f6826f2-4ff6-443d-b966-e6913bd24013	7d7ef4a4-f762-11e1-a439-00145eb45e9a
52	52	0	Plazi	ffb07bec-2d10-492d-9c37-361fe0b79427	7dfb506d-672d-40e4-862a-1d9e2b9bc564
1224	480	-744	GBIF Germany	4f6826f2-4ff6-443d-b966-e6913bd24013	7ef295e8-f762-11e1-a439-00145eb45e9a
2255	2255	0	Biodiversity Information System of Mexico	b324e8e9-9a4c-44fa-8f1a-7f39ea7ab576	803fc628-f762-11e1-a439-00145eb45e9a
14	14	0	Plazi	ffb07bec-2d10-492d-9c37-361fe0b79427	80ac4e38-c93f-48de-8a60-946ecb534703
15389	15389	0	U.S. Geological Survey	8618c64a-93e0-4300-b546-7249e5148ed2	84e823d2-f762-11e1-a439-00145eb45e9a
103	103	0	Atlas of Living Australia	4a6f1b71-969e-4fc5-a693-282b05e1220c	85afbe6b-163d-4a81-ba18-d0a552e8c1f2
262	70	-192	GBIF Germany	4f6826f2-4ff6-443d-b966-e6913bd24013	87111c9a-f762-11e1-a439-00145eb45e9a
9	9	0	Plazi	ffb07bec-2d10-492d-9c37-361fe0b79427	88402877-27ce-47aa-ac95-5e7eafea13a0
2	2	0	Plazi	ffb07bec-2d10-492d-9c37-361fe0b79427	8a1c03a7-f099-446f-bb34-5f7cdb8d5412
3	3	0	GBIF Germany	4f6826f2-4ff6-443d-b966-e6913bd24013	8c3d1854-f762-11e1-a439-00145eb45e9a
1106	756	-350	GBIF Germany	4f6826f2-4ff6-443d-b966-e6913bd24013	8f72f48a-f762-11e1-a439-00145eb45e9a
52211	126930	74719	GBIF Brazil	cdc9736d-5ff7-4ece-9959-3c744360cdb3	90288ac6-ae3b-4c4e-8d15-a66744d2cc66
831	831	0	GBIF Germany	4f6826f2-4ff6-443d-b966-e6913bd24013	9221690a-f762-11e1-a439-00145eb45e9a
1122	1122	0	Participant Node Managers Committee	7f48e0c8-5c96-49ec-b972-30748e339115	94d4af26-7196-4476-9d6d-8f9db1a77ea3
1375	1332	-43	GBIF Germany	4f6826f2-4ff6-443d-b966-e6913bd24013	95085246-f762-11e1-a439-00145eb45e9a
92413	94209	1796	GBIF Germany	4f6826f2-4ff6-443d-b966-e6913bd24013	9666593a-f762-11e1-a439-00145eb45e9a
0	250	250	Ocean Biodiversity Information System	ba0670b9-4186-41e6-8e70-f9cb3065551a	9698a904-278c-4e11-a579-65222550f39d
1015	1015	0	U.S. Geological Survey	8618c64a-93e0-4300-b546-7249e5148ed2	969d55f6-ed52-4be9-a6dd-7afeccdfde76
31	31	0	GBIF Germany	4f6826f2-4ff6-443d-b966-e6913bd24013	977feb74-f762-11e1-a439-00145eb45e9a
4	4	0	Plazi	ffb07bec-2d10-492d-9c37-361fe0b79427	988774fb-6409-499f-87d4-f687dc30bf54
0	62	62	Plazi	ffb07bec-2d10-492d-9c37-361fe0b79427	9aa31524-722b-493e-99ed-305df59cb9f4
0	810	810	Atlas of Living Australia	4a6f1b71-969e-4fc5-a693-282b05e1220c	9c42048d-db20-4a13-9748-71f103227c7d
3786	3786	0	GBIF Israel	8cb55387-7802-40e8-86d6-d357a583c596	9c76ffd1-36b0-47ab-baf9-d4ec14202872
146	146	0	Plazi	ffb07bec-2d10-492d-9c37-361fe0b79427	9ffb3429-ba6c-4d23-a88e-781dde361e56
3583	3583	0	National Biodiversity Network	d897a5b9-35ee-4232-94bd-b0bcaac003c2	a8fa6060-ed0e-41e6-b21c-708d6ee7994b
39	39	0	Colombian Biodiversity Information System	7e865cba-7c46-417b-ade5-97f2cf5b7be0	ab2684cf-62e5-4f87-b57b-6cd68b048606
440906	420532	-20374	National Biodiversity Network	d897a5b9-35ee-4232-94bd-b0bcaac003c2	abd3521c-f459-468e-9039-f989786147d4
199	199	0	Plazi	ffb07bec-2d10-492d-9c37-361fe0b79427	ad30d622-f82a-4e32-a0c3-2ef0e40cc64d
9605	9605	0	DanBIF - Danish Biodiversity Information Facility	4ddd294f-02b7-4359-ac33-0806a9ca9c6b	af3bce08-0599-45a6-9bfc-08188bcd868e
50	50	0	National Biodiversity Network	d897a5b9-35ee-4232-94bd-b0bcaac003c2	b31e54e9-dcd9-48f8-8e9a-36c20db9ffa5
416	416	0	GBIF Germany	4f6826f2-4ff6-443d-b966-e6913bd24013	b6566511-b807-470f-9f68-ce4f3d03174b
115	115	0	Plazi	ffb07bec-2d10-492d-9c37-361fe0b79427	b8147d5e-955a-4e04-8862-0a30cbfc084b
24380	24380	0	GBIF Brazil	cdc9736d-5ff7-4ece-9959-3c744360cdb3	b84edffc-c606-47c7-813f-feed4f761e06
0	22	22	Plazi	ffb07bec-2d10-492d-9c37-361fe0b79427	b90b7900-6947-4283-ba02-4086fb76aa2b
0	6	6	Korean Biodiversity Information Facility	e0a1e772-0177-4800-94b4-2d023fe6cdf4	b99427f8-27f0-4f5d-a1c5-a6ef7128af64
0	24	24	Ocean Biodiversity Information System	ba0670b9-4186-41e6-8e70-f9cb3065551a	ba0a9603-aeab-4361-806d-8fd7e20c9792
125	125	0	Plazi	ffb07bec-2d10-492d-9c37-361fe0b79427	badce69d-f6a1-43ef-81e8-775c9c4fe4fa
13807	14404	597	GBIF Brazil	cdc9736d-5ff7-4ece-9959-3c744360cdb3	bb080d40-c63b-4529-bf21-d1782a81e024
274	274	0	Korean Biodiversity Information Facility	e0a1e772-0177-4800-94b4-2d023fe6cdf4	bc1530cd-1cca-4c30-b956-1b533fc87baf
0	1365	1365	GBIF Germany	4f6826f2-4ff6-443d-b966-e6913bd24013	bda70a9c-635a-4bb8-a4d0-8a185daf1f5b
0	54	54	Plazi	ffb07bec-2d10-492d-9c37-361fe0b79427	bff05bfd-3c82-4fdb-b873-50f234f60d30
0	48	48	GBIF Japan	db5705aa-6a6e-42f1-8942-d77b9f4896ea	c0809391-6cdd-4b1e-b282-05c46deea330
140	140	0	Participant Node Managers Committee	7f48e0c8-5c96-49ec-b972-30748e339115	c0d54145-f7de-49e0-979f-6139b97977ad
0	3917	3917	Ocean Biodiversity Information System	ba0670b9-4186-41e6-8e70-f9cb3065551a	c536c5eb-0b96-4cba-98dc-b232355f2fe3
7	7	0	Plazi	ffb07bec-2d10-492d-9c37-361fe0b79427	c5e3cbba-fe50-4977-b4ee-06cc0eb619a2
156	156	0	GBIF Norway	4f829580-180d-46a9-9c87-ed8ec959b545	c7f2dc21-44ab-4389-9184-a9aeb3c97db0
0	8	8	Plazi	ffb07bec-2d10-492d-9c37-361fe0b79427	c816a1ea-8b00-42c0-b5de-f2d47ef0409f
49	49	0	Plazi	ffb07bec-2d10-492d-9c37-361fe0b79427	c821bd51-052e-4057-9c21-063c616208d0
5	5	0	Plazi	ffb07bec-2d10-492d-9c37-361fe0b79427	c958120b-cf83-4dd6-9560-1f783c6c9680
158	158	0	Plazi	ffb07bec-2d10-492d-9c37-361fe0b79427	ca35c50f-b0c5-4032-b06d-f71b00710c8d
3	3	0	Plazi	ffb07bec-2d10-492d-9c37-361fe0b79427	cb2462c6-4b1e-4029-bbca-f674131179bd
0	1504	1504	National Biodiversity Network	d897a5b9-35ee-4232-94bd-b0bcaac003c2	ceac4558-4a9a-4cb4-917a-f2c99a112f35
21849	21849	0	GBIF France	da44cd31-5901-4687-a106-6d1c7734ee3a	cf6753c5-0af6-45d3-bc90-ee1078dca8c4
7044	446	-6598	Biodiversity Information System of Mexico	b324e8e9-9a4c-44fa-8f1a-7f39ea7ab576	d03374b7-5a72-4a55-b350-0856007078a4
0	108	108	Plazi	ffb07bec-2d10-492d-9c37-361fe0b79427	d8633ec0-3077-456d-9f3c-cfb0494ba33e
6	6	0	GBIF Germany	4f6826f2-4ff6-443d-b966-e6913bd24013	ddf089e1-1b70-433d-8d78-3a6f426539a0
1134	1134	0	Netherlands Biodiversity Information Facility	0909d601-bda2-42df-9e63-a6d51847ebce	e0e99707-eb75-416d-9f1f-1fa369fa2a3b
2	2	0	Plazi	ffb07bec-2d10-492d-9c37-361fe0b79427	e10cb8d7-cf2d-4b2f-9758-76dbead48965
55	55	0	Plazi	ffb07bec-2d10-492d-9c37-361fe0b79427	e75c913b-d6ce-48b6-b5c4-dd09034b4547
4	4	0	Plazi	ffb07bec-2d10-492d-9c37-361fe0b79427	e98be1e7-35ba-4f9d-877f-0c9f7f5514e8
49	49	0	Belgian Biodiversity Platform	fb11cfe1-ebc3-45af-9159-17d9fddbcdac	eb900aab-9b13-42bd-ae0f-a10bb93536b5
41	41	0	Plazi	ffb07bec-2d10-492d-9c37-361fe0b79427	ec4670c2-e626-4b1c-a374-ebed549624ac
4	4	0	GBIF Sweden	a0b3be64-6525-4387-ac67-a499950f92e1	ed91f33f-2843-44ba-993c-9890219b7fa4
811	811	0	GBIF France	da44cd31-5901-4687-a106-6d1c7734ee3a	ede153cc-3e9c-4a9d-8445-50f265d74330
22933	22933	0	GBIF France	da44cd31-5901-4687-a106-6d1c7734ee3a	ef4bd28b-4a8f-49a1-aea6-85973c073f2c
9	9	0	Plazi	ffb07bec-2d10-492d-9c37-361fe0b79427	f1c5d605-7034-4f05-bea5-f9b28f5de6e7
94	94	0	Netherlands Biodiversity Information Facility	0909d601-bda2-42df-9e63-a6d51847ebce	f2836770-6166-11de-84bf-b8a03c50a862
985	985	0	National Biodiversity Network	d897a5b9-35ee-4232-94bd-b0bcaac003c2	f2c49f4c-dbca-42fd-9540-8fa817c8a4ad
2	2	0	Plazi	ffb07bec-2d10-492d-9c37-361fe0b79427	f35d20b5-cfb2-416e-8174-906af4b518f0
2	2	0	Plazi	ffb07bec-2d10-492d-9c37-361fe0b79427	fc0b08d0-717e-47c5-9a61-8dd4db874da2
241	241	0	Biodiversity Information System of Mexico	b324e8e9-9a4c-44fa-8f1a-7f39ea7ab576	0073c33b-ba79-43fc-8336-fd1f5d3d483b
7	7	0	Plazi	ffb07bec-2d10-492d-9c37-361fe0b79427	05a09bb1-52c8-409c-aba7-760bdab7fbe3
0	7063	7063	U.S. Geological Survey	8618c64a-93e0-4300-b546-7249e5148ed2	09045f56-4565-4a15-99db-4641154e6f9b
739	739	0	GBIF Germany	4f6826f2-4ff6-443d-b966-e6913bd24013	0db1837b-0125-4242-a018-9913da96e68b
0	530	530	Ocean Biodiversity Information System	ba0670b9-4186-41e6-8e70-f9cb3065551a	0ec2458e-e412-47d0-9a61-b6e70acf6b1c
2740	2740	0	GBIF Japan	db5705aa-6a6e-42f1-8942-d77b9f4896ea	0ece0e1d-ab8c-48fd-aaff-b2811cb090bc
98	98	0	Plazi	ffb07bec-2d10-492d-9c37-361fe0b79427	12915dc1-36ef-408d-8963-345f97add79a
282	282	0	GBIF France	da44cd31-5901-4687-a106-6d1c7734ee3a	1513f888-8fed-4df7-9f3f-e464ef943fdc
16	16	0	Plazi	ffb07bec-2d10-492d-9c37-361fe0b79427	16a6ee56-b77b-4bf3-91c0-5368b5f21787
630	630	0	Ocean Biodiversity Information System	ba0670b9-4186-41e6-8e70-f9cb3065551a	1721ed9b-a664-4756-ba19-07d471abcf62
706	706	0	GBIF France	da44cd31-5901-4687-a106-6d1c7734ee3a	1a142fd3-f456-46bb-8906-96bb02a4a92d
27	27	0	Colombian Biodiversity Information System	7e865cba-7c46-417b-ade5-97f2cf5b7be0	1d0f6e54-c1a9-48c4-bdb8-381fe2220b44
99	99	0	GBIF France	da44cd31-5901-4687-a106-6d1c7734ee3a	1fa7b6d4-01c7-4fcb-a67d-f245854ebb5e
9489	9489	0	U.S. Geological Survey	8618c64a-93e0-4300-b546-7249e5148ed2	20bc0626-ebd6-4949-bf04-b80d960a6961
5	5	0	Plazi	ffb07bec-2d10-492d-9c37-361fe0b79427	24d2faef-3835-413e-a306-b1d39b801fd3
1006	1006	0	GBIF France	da44cd31-5901-4687-a106-6d1c7734ee3a	27b264ff-3095-44ab-8c29-9b9ccbe8ee74
504	504	0	Plazi	ffb07bec-2d10-492d-9c37-361fe0b79427	28f94b79-38d7-4c25-ac76-cf64809114fc
7	7	0	Plazi	ffb07bec-2d10-492d-9c37-361fe0b79427	2981a6d7-93b4-40e0-888a-f0d82eee9ba3
7	7	0	Plazi	ffb07bec-2d10-492d-9c37-361fe0b79427	2a63a00e-1ef1-43a7-ba95-3ca4b689052c
939	939	0	GBIF France	da44cd31-5901-4687-a106-6d1c7734ee3a	2a8478b2-2f41-4f00-af42-f55020de7942
57919	57919	0	GBIF France	da44cd31-5901-4687-a106-6d1c7734ee3a	2c4fc27a-8868-4e95-b02d-86302e4ece38
2	2	0	Plazi	ffb07bec-2d10-492d-9c37-361fe0b79427	2d3e2277-8164-4ee0-b382-56a0eb38dd32
1	1	0	Plazi	ffb07bec-2d10-492d-9c37-361fe0b79427	2f76d377-f137-4382-bfde-5e81a4dd7fa6
0	27717	27717	Netherlands Biodiversity Information Facility	0909d601-bda2-42df-9e63-a6d51847ebce	3046db3b-b18d-410b-8ad8-22e662873986
2	2	0	Plazi	ffb07bec-2d10-492d-9c37-361fe0b79427	32bc8193-4779-4255-8766-8a34e0888442
2	2	0	Plazi	ffb07bec-2d10-492d-9c37-361fe0b79427	362bb186-b3f4-4a0b-b446-9557d9de44fb
1583	1583	0	National Biodiversity Network	d897a5b9-35ee-4232-94bd-b0bcaac003c2	375a4d7d-9a87-49bc-a038-11d41f0fc9a1
637	637	0	GBIF France	da44cd31-5901-4687-a106-6d1c7734ee3a	37849fa3-28f5-43b4-9cb9-a773f996b1db
412	412	0	GBIF Germany	4f6826f2-4ff6-443d-b966-e6913bd24013	382f0a14-4678-4ae7-859b-8b3b9d2eb36e
90	90	0	Netherlands Biodiversity Information Facility	0909d601-bda2-42df-9e63-a6d51847ebce	3953ab4f-958f-4943-8608-ca5da345447c
173	173	0	Plazi	ffb07bec-2d10-492d-9c37-361fe0b79427	3bc8450f-5fcf-44f0-8466-f81e1dd992ed
0	8	8	Plazi	ffb07bec-2d10-492d-9c37-361fe0b79427	3bce40b0-fd50-42b6-ad1c-cd4c8feca0a0
7044	7044	0	Netherlands Biodiversity Information Facility	0909d601-bda2-42df-9e63-a6d51847ebce	3e6ba6e2-88f4-48b5-b346-e8aed305f41d
6500	9500	3000	GBIF Japan	db5705aa-6a6e-42f1-8942-d77b9f4896ea	4005c523-b315-46cc-bf57-f54dd3a28b93
0	5	5	Plazi	ffb07bec-2d10-492d-9c37-361fe0b79427	403b033a-1b01-4599-894e-b4d67d889cee
5999	5924	-75	Biodiversity Information System of Mexico	b324e8e9-9a4c-44fa-8f1a-7f39ea7ab576	41c4b3e1-0a28-45f4-9f6c-09a7f77c184a
95	95	0	Atlas of Living Australia	4a6f1b71-969e-4fc5-a693-282b05e1220c	4287ce1e-b34e-48d4-b7aa-7fbfb9111607
2	2	0	Plazi	ffb07bec-2d10-492d-9c37-361fe0b79427	43c26769-524b-4232-accd-246b4027d1bb
0	1484	1484	Ocean Biodiversity Information System	ba0670b9-4186-41e6-8e70-f9cb3065551a	44ead6c2-6006-4f45-b785-87fa81c9ecbd
6	6	0	Plazi	ffb07bec-2d10-492d-9c37-361fe0b79427	45774b39-c0fb-4ed4-8114-02f8b154a6d3
0	92	92	Plazi	ffb07bec-2d10-492d-9c37-361fe0b79427	4577eacc-752d-4eb7-bf1b-6585f03d7d6a
18	18	0	Plazi	ffb07bec-2d10-492d-9c37-361fe0b79427	4c0ff88a-11ad-4d8c-baef-4af31cc90eea
17	17	0	GBIF Sweden	a0b3be64-6525-4387-ac67-a499950f92e1	4c5d224c-81a1-428b-8fef-3e0e85ba1984
0	19390	19390	Canada Biodiversity Information Facility	8f83fc96-c966-4126-83f7-bf044dc49efa	4c9174a6-77db-4e94-bc41-478ccf5a09c1
17	17	0	GBIF Spain	1f94b3ca-9345-4d65-afe2-4bace93aa0fe	4f8355f0-07b5-4b0b-a08c-34b719fc3ad5
5244	5244	0	National Biodiversity Network	d897a5b9-35ee-4232-94bd-b0bcaac003c2	4f9fbd78-e69c-40a3-882f-c00266eab4f8
22	22	0	Plazi	ffb07bec-2d10-492d-9c37-361fe0b79427	506d11e3-029a-482b-ad11-cff65e539fa9
0	173	173	Colombian Biodiversity Information System	7e865cba-7c46-417b-ade5-97f2cf5b7be0	5229fe90-db5c-48f3-84f5-42872be565c4
2	2	0	Plazi	ffb07bec-2d10-492d-9c37-361fe0b79427	5261cc77-1af6-4a2f-956d-6ddc7816f509
10	10	0	Plazi	ffb07bec-2d10-492d-9c37-361fe0b79427	5554c3ea-e0c9-46f7-a9e0-39c559e0c390
24	24	0	Plazi	ffb07bec-2d10-492d-9c37-361fe0b79427	56b4f2d9-8e62-4782-b61b-c1044fde7e9c
0	2	2	Plazi	ffb07bec-2d10-492d-9c37-361fe0b79427	5728a9af-6e4a-46e1-a28e-5e4aa1cb9a6f
27	27	0	Biodiversity Information System of Mexico	b324e8e9-9a4c-44fa-8f1a-7f39ea7ab576	57bc4619-f450-4786-b80f-f656c78e72bb
4534	4534	0	GBIF Germany	4f6826f2-4ff6-443d-b966-e6913bd24013	596cf56d-f47c-46df-84e7-7ef5aa47508d
46	46	0	Plazi	ffb07bec-2d10-492d-9c37-361fe0b79427	5a6ece22-47cb-49ec-b8c2-5b3f370ac6de
0	2	2	Ocean Biodiversity Information System	ba0670b9-4186-41e6-8e70-f9cb3065551a	5b0034ea-8127-404e-a39e-2a4e9c927504
1017	1017	0	National Biodiversity Network	d897a5b9-35ee-4232-94bd-b0bcaac003c2	5cda20ad-d9f9-4592-bb33-503a336b20c4
14	14	0	Plazi	ffb07bec-2d10-492d-9c37-361fe0b79427	5dc95ae5-6e65-46d7-b300-266a2279d568
0	9	9	Plazi	ffb07bec-2d10-492d-9c37-361fe0b79427	5e4daa87-3723-4ecf-94f8-8f1a9e65cff7
119	119	0	Biodiversity Information System of Mexico	b324e8e9-9a4c-44fa-8f1a-7f39ea7ab576	5fba1aca-44ae-4a4f-a508-6a599d29d1cd
8	8	0	Plazi	ffb07bec-2d10-492d-9c37-361fe0b79427	6061bcf6-281c-4b97-8a98-e77103097977
50	50	0	GBIF Germany	4f6826f2-4ff6-443d-b966-e6913bd24013	61b81f0c-f762-11e1-a439-00145eb45e9a
21	21	0	Plazi	ffb07bec-2d10-492d-9c37-361fe0b79427	62759ea5-0210-4c30-aee0-1d1bd46b4470
3	3	0	Plazi	ffb07bec-2d10-492d-9c37-361fe0b79427	630312e3-112f-4c35-b9a8-db01d271a1ea
249	249	0	GBIF Germany	4f6826f2-4ff6-443d-b966-e6913bd24013	638e431a-f762-11e1-a439-00145eb45e9a
188	188	0	National Biodiversity Network	d897a5b9-35ee-4232-94bd-b0bcaac003c2	63dfbbc1-3540-4f21-a209-63dcb682c8c2
80	80	0	Plazi	ffb07bec-2d10-492d-9c37-361fe0b79427	64d9dc01-5c7b-4812-952d-4ac02724ea40
0	14	14	Plazi	ffb07bec-2d10-492d-9c37-361fe0b79427	65c505cc-fbae-4ce1-b4f0-bbee7a546c42
56	56	0	GBIF Germany	4f6826f2-4ff6-443d-b966-e6913bd24013	675b5a6e-f762-11e1-a439-00145eb45e9a
738	738	0	Colombian Biodiversity Information System	7e865cba-7c46-417b-ade5-97f2cf5b7be0	6951400f-fdaa-4505-8f97-7d45bd3cd34b
148	148	0	GBIF Germany	4f6826f2-4ff6-443d-b966-e6913bd24013	69d5e39a-f762-11e1-a439-00145eb45e9a
18	18	0	GBIF Germany	4f6826f2-4ff6-443d-b966-e6913bd24013	6b151bf4-f762-11e1-a439-00145eb45e9a
157	157	0	Plazi	ffb07bec-2d10-492d-9c37-361fe0b79427	6ea2cc5c-857b-4b47-8135-8bff7efbd1fc
15	15	0	GBIF Germany	4f6826f2-4ff6-443d-b966-e6913bd24013	70291e9c-f762-11e1-a439-00145eb45e9a
23048	23048	0	U.S. Geological Survey	8618c64a-93e0-4300-b546-7249e5148ed2	7131ac32-f762-11e1-a439-00145eb45e9a
11	11	0	Plazi	ffb07bec-2d10-492d-9c37-361fe0b79427	71c5d7ea-1e09-491f-a9d7-cef6a57cda85
15	15	0	GBIF Germany	4f6826f2-4ff6-443d-b966-e6913bd24013	72a90416-f762-11e1-a439-00145eb45e9a
0	18	18	Plazi	ffb07bec-2d10-492d-9c37-361fe0b79427	72de4826-5443-4bd5-8cd0-d3691749c0bf
71	71	0	GBIF Germany	4f6826f2-4ff6-443d-b966-e6913bd24013	73ad4aa2-f762-11e1-a439-00145eb45e9a
1430	1430	0	Biodiversity Information System of Mexico	b324e8e9-9a4c-44fa-8f1a-7f39ea7ab576	74e7db69-c1fc-4265-ad5d-abdb07912463
91	91	0	GBIF Germany	4f6826f2-4ff6-443d-b966-e6913bd24013	7848f160-f762-11e1-a439-00145eb45e9a
15	15	0	GBIF Germany	4f6826f2-4ff6-443d-b966-e6913bd24013	78adfc04-f762-11e1-a439-00145eb45e9a
0	4	4	Plazi	ffb07bec-2d10-492d-9c37-361fe0b79427	79c219a1-c427-4eac-9051-b30543eabdc5
27554	30554	3000	GBIF Japan	db5705aa-6a6e-42f1-8942-d77b9f4896ea	7a518c06-f762-11e1-a439-00145eb45e9a
104	104	0	GBIF Germany	4f6826f2-4ff6-443d-b966-e6913bd24013	7ce13b6a-f762-11e1-a439-00145eb45e9a
384	132	-252	GBIF Germany	4f6826f2-4ff6-443d-b966-e6913bd24013	7d28239a-f762-11e1-a439-00145eb45e9a
3	3	0	Plazi	ffb07bec-2d10-492d-9c37-361fe0b79427	7d3e1d74-95bf-4a81-95f8-3b12d44cc2c0
735	735	0	GBIF Germany	4f6826f2-4ff6-443d-b966-e6913bd24013	7d4f1a7c-f762-11e1-a439-00145eb45e9a
180	144	-36	GBIF Germany	4f6826f2-4ff6-443d-b966-e6913bd24013	7d5bb8cc-f762-11e1-a439-00145eb45e9a
7	7	0	Plazi	ffb07bec-2d10-492d-9c37-361fe0b79427	7d8b4f76-7575-4d7a-974e-0a438296197b
9	9	0	Plazi	ffb07bec-2d10-492d-9c37-361fe0b79427	7df6de8f-ad39-4865-95a7-4b2d53687a21
8	8	0	Plazi	ffb07bec-2d10-492d-9c37-361fe0b79427	7e041cd7-75f6-4285-a8b0-d4aa85967ca0
986	374	-612	GBIF Germany	4f6826f2-4ff6-443d-b966-e6913bd24013	7e0b86bc-f762-11e1-a439-00145eb45e9a
3961	3961	0	GBIF Uganda	71b40829-6a12-4c3d-8fee-5746f5e9cf8c	7eedbc1e-d362-4c8b-805f-37a7e2c21198
448	117	-331	Biodiversity Information System of Mexico	b324e8e9-9a4c-44fa-8f1a-7f39ea7ab576	7f6a0d8a-f762-11e1-a439-00145eb45e9a
1340	1268	-72	Biodiversity Information System of Mexico	b324e8e9-9a4c-44fa-8f1a-7f39ea7ab576	7fa2233c-f762-11e1-a439-00145eb45e9a
55	55	0	Biodiversity Information System of Mexico	b324e8e9-9a4c-44fa-8f1a-7f39ea7ab576	7fea5f1c-f762-11e1-a439-00145eb45e9a
3329	3329	0	GBIF Germany	4f6826f2-4ff6-443d-b966-e6913bd24013	81dde352-f762-11e1-a439-00145eb45e9a
235	235	0	GBIF Germany	4f6826f2-4ff6-443d-b966-e6913bd24013	820aee92-f762-11e1-a439-00145eb45e9a
5664	5664	0	GBIF France	da44cd31-5901-4687-a106-6d1c7734ee3a	829402be-43f2-4944-8e5d-d7935e24ce9d
3	3	0	Plazi	ffb07bec-2d10-492d-9c37-361fe0b79427	849dcd63-d0a7-4903-935c-2ad89b208831
19760	19760	0	DanBIF - Danish Biodiversity Information Facility	4ddd294f-02b7-4359-ac33-0806a9ca9c6b	84d5d4b6-f762-11e1-a439-00145eb45e9a
4124	4124	0	GBIF Spain	1f94b3ca-9345-4d65-afe2-4bace93aa0fe	8656f716-f762-11e1-a439-00145eb45e9a
242	242	0	GBIF Germany	4f6826f2-4ff6-443d-b966-e6913bd24013	86fdc032-f762-11e1-a439-00145eb45e9a
160	115	-45	GBIF Germany	4f6826f2-4ff6-443d-b966-e6913bd24013	87836570-f762-11e1-a439-00145eb45e9a
11729	11729	0	Colombian Biodiversity Information System	7e865cba-7c46-417b-ade5-97f2cf5b7be0	878b1066-ebac-4a81-a852-7db747ba07b9
94	89	-5	GBIF Germany	4f6826f2-4ff6-443d-b966-e6913bd24013	884079e4-f762-11e1-a439-00145eb45e9a
317	275	-42	GBIF Germany	4f6826f2-4ff6-443d-b966-e6913bd24013	88470b7e-f762-11e1-a439-00145eb45e9a
1429	1429	0	GBIF Germany	4f6826f2-4ff6-443d-b966-e6913bd24013	89a4687c-f762-11e1-a439-00145eb45e9a
942	942	0	GBIF Germany	4f6826f2-4ff6-443d-b966-e6913bd24013	89fdf47c-d177-4426-b3bb-c5a4422f1b92
48	48	0	GBIF Germany	4f6826f2-4ff6-443d-b966-e6913bd24013	8a959224-f762-11e1-a439-00145eb45e9a
41	41	0	GBIF Germany	4f6826f2-4ff6-443d-b966-e6913bd24013	8bd18882-f762-11e1-a439-00145eb45e9a
270	270	0	GBIF Viet Nam	7f4b5eab-2edf-4b46-9360-d9574ab0f1d7	8c70740b-8fc5-458e-a6a0-154c65c4f7c7
111	111	0	GBIF Germany	4f6826f2-4ff6-443d-b966-e6913bd24013	8c8901c4-f762-11e1-a439-00145eb45e9a
20	12	-8	GBIF Germany	4f6826f2-4ff6-443d-b966-e6913bd24013	8d2f3562-f762-11e1-a439-00145eb45e9a
1026	810	-216	GBIF Germany	4f6826f2-4ff6-443d-b966-e6913bd24013	8d821d9a-f762-11e1-a439-00145eb45e9a
390	264	-126	GBIF Germany	4f6826f2-4ff6-443d-b966-e6913bd24013	8e71ab8a-f762-11e1-a439-00145eb45e9a
2	2	0	Plazi	ffb07bec-2d10-492d-9c37-361fe0b79427	8f361ffe-9e56-41f8-ab77-fae3b124798d
194	110	-84	GBIF Germany	4f6826f2-4ff6-443d-b966-e6913bd24013	9030195c-f762-11e1-a439-00145eb45e9a
5	3	-2	GBIF Germany	4f6826f2-4ff6-443d-b966-e6913bd24013	90ea7716-f762-11e1-a439-00145eb45e9a
6	4	-2	GBIF Germany	4f6826f2-4ff6-443d-b966-e6913bd24013	91121eb0-f762-11e1-a439-00145eb45e9a
52	55	3	National Biodiversity Network	d897a5b9-35ee-4232-94bd-b0bcaac003c2	9223ae40-6d6f-458f-83f8-8d58300f5ebf
9	9	0	GBIF Sweden	a0b3be64-6525-4387-ac67-a499950f92e1	92e3db46-7840-483d-a2bc-57f20d37f9ff
746	746	0	GBIF France	da44cd31-5901-4687-a106-6d1c7734ee3a	930886b0-dac6-4721-b54e-45cd1b19072a
13527	13527	0	National Biodiversity Data Centre	422b00b2-6c94-4bb6-976b-c359916efdb8	94060ade-4c37-43f4-b44c-250508cf74e7
38	38	0	GBIF Germany	4f6826f2-4ff6-443d-b966-e6913bd24013	9505a082-f762-11e1-a439-00145eb45e9a
992	992	0	GBIF Germany	4f6826f2-4ff6-443d-b966-e6913bd24013	950c52e2-f762-11e1-a439-00145eb45e9a
3257	2984	-273	GBIF Germany	4f6826f2-4ff6-443d-b966-e6913bd24013	9526aa02-f762-11e1-a439-00145eb45e9a
5	5	0	Plazi	ffb07bec-2d10-492d-9c37-361fe0b79427	95453e21-7f90-4f85-822c-d7b0d8c7543c
16369	16864	495	GBIF Japan	db5705aa-6a6e-42f1-8942-d77b9f4896ea	95f74c02-f762-11e1-a439-00145eb45e9a
42453	50583	8130	GBIF Germany	4f6826f2-4ff6-443d-b966-e6913bd24013	9661bc40-f762-11e1-a439-00145eb45e9a
0	5483	5483	Colombian Biodiversity Information System	7e865cba-7c46-417b-ade5-97f2cf5b7be0	9698b903-7dd4-4465-bead-eb43341efa66
46	46	0	Plazi	ffb07bec-2d10-492d-9c37-361fe0b79427	978ec4b3-8d0e-4f47-8084-610b34b96759
0	133326	133326	Belgian Biodiversity Platform	fb11cfe1-ebc3-45af-9159-17d9fddbcdac	98db0c34-403c-448d-9ac7-e8546abd6e63
3	3	0	Plazi	ffb07bec-2d10-492d-9c37-361fe0b79427	99190eeb-d27c-4184-a1a6-2682f933a4b5
154	154	0	GBIF France	da44cd31-5901-4687-a106-6d1c7734ee3a	a1099555-575f-4b59-a67b-eaa3848395f4
982	2210	1228	GBIF Norway	4f829580-180d-46a9-9c87-ed8ec959b545	a12cba4c-c620-4e76-aa22-0ec988824b6d
8	8	0	GBIF Germany	4f6826f2-4ff6-443d-b966-e6913bd24013	a2f2cff0-1787-4a97-b7bc-392bd96f94df
0	108	108	Ocean Biodiversity Information System	ba0670b9-4186-41e6-8e70-f9cb3065551a	a4ab13a5-0357-4d3e-b5d3-3a8abe84933c
882	234	-648	GBIF Germany	4f6826f2-4ff6-443d-b966-e6913bd24013	a8d84f1d-52ec-4a90-a796-aacd5d2cde85
14006	14085	79	GBIF Brazil	cdc9736d-5ff7-4ece-9959-3c744360cdb3	a9317b52-6c43-452c-87d5-ea43e4773058
338	338	0	GBIF Malawi	2a42e4d7-ad4a-41b3-84c4-de4aa7b74d35	a95f76a9-99ed-4bda-b14d-5cb35e40f980
0	2	2	Plazi	ffb07bec-2d10-492d-9c37-361fe0b79427	acbcbc6c-e088-4fc2-a657-39db8315a91e
3	3	0	Plazi	ffb07bec-2d10-492d-9c37-361fe0b79427	af7d48d4-492a-4f7d-9ae2-929ae6dbe1dd
0	4	4	Plazi	ffb07bec-2d10-492d-9c37-361fe0b79427	b1578e9d-8724-4bfe-8e55-7094e750f94d
50	50	0	GBIF Germany	4f6826f2-4ff6-443d-b966-e6913bd24013	b26ea01d-37d4-4517-aaa8-219f9022904b
22945	23187	242	GBIF Brazil	cdc9736d-5ff7-4ece-9959-3c744360cdb3	b3769e61-c3d0-4046-81cf-bf4d6b23b444
119	119	0	GBIF Benin	efb9c00e-f802-45dd-8826-a52ec45b89ff	b3a30978-e46d-44d0-9c32-7fcd8ba410b5
4	4	0	Plazi	ffb07bec-2d10-492d-9c37-361fe0b79427	b44745ed-b90a-4b62-b636-23c48c56471a
6	6	0	Plazi	ffb07bec-2d10-492d-9c37-361fe0b79427	b4f0e99f-ea68-4ee2-98ad-71a681d2e083
1	1	0	GBIF Argentina	2426a871-9feb-40a1-96c6-0c593a76b835	bcae9fad-f84c-47f0-b85a-92970fd94262
8364	8364	0	GBIF Brazil	cdc9736d-5ff7-4ece-9959-3c744360cdb3	bd87f432-1b92-4494-894b-e3f0b1eca64d
4644	4644	0	GBIF France	da44cd31-5901-4687-a106-6d1c7734ee3a	c3919abf-064d-41f1-94ec-54a29ca9b52d
4	4	0	Plazi	ffb07bec-2d10-492d-9c37-361fe0b79427	c4b57da2-360e-45f4-9375-df44dec5b58d
760	720	-40	GBIF Germany	4f6826f2-4ff6-443d-b966-e6913bd24013	c66ce64a-2809-4afe-80e5-f53f6ff3187a
1311	1311	0	Colombian Biodiversity Information System	7e865cba-7c46-417b-ade5-97f2cf5b7be0	c6f4c2de-3b71-4ebd-9c98-c21537548f07
2	2	0	Plazi	ffb07bec-2d10-492d-9c37-361fe0b79427	c7693ffd-e157-4dfe-ad25-dd8c054b07e2
0	72728	72728	GBIF Ecuador	2dc472f1-c3d9-486d-b3c1-12ca7ba1ed22	cb16fc5b-70b7-420c-ad10-e3c6b7baf184
27	27	0	GBIF France	da44cd31-5901-4687-a106-6d1c7734ee3a	cc7f27fa-44c5-44bf-af84-238107c95a7a
4	4	0	Plazi	ffb07bec-2d10-492d-9c37-361fe0b79427	cd170264-b2ab-4040-b3fa-4025648e9991
4	4	0	Korean Biodiversity Information Facility	e0a1e772-0177-4800-94b4-2d023fe6cdf4	cecd0557-5f3d-4ca2-b0bd-89e84a89f0e5
90852	90852	0	GBIF Spain	1f94b3ca-9345-4d65-afe2-4bace93aa0fe	ceff8c75-950b-4405-a116-60247d1adacb
14395	14402	7	GBIF Brazil	cdc9736d-5ff7-4ece-9959-3c744360cdb3	d031156d-6ff8-4eb5-b91a-a50861e98be9
2416	2416	0	GBIF Benin	efb9c00e-f802-45dd-8826-a52ec45b89ff	d059988c-ac22-4ac5-9999-6dbc4cecaf52
738	738	0	U.S. Geological Survey	8618c64a-93e0-4300-b546-7249e5148ed2	d1d59f9f-e130-4715-bc9b-8a25e7b62e89
0	2	2	Plazi	ffb07bec-2d10-492d-9c37-361fe0b79427	d202edfa-9b8b-4948-9512-a04e9836d6a2
0	825	825	Ocean Biodiversity Information System	ba0670b9-4186-41e6-8e70-f9cb3065551a	d3e48d53-0b95-430c-bc92-d7221b4b262d
7	7	0	Plazi	ffb07bec-2d10-492d-9c37-361fe0b79427	d5e07669-fe02-47d3-becd-411b43e6f471
0	80	80	Korean Biodiversity Information Facility	e0a1e772-0177-4800-94b4-2d023fe6cdf4	d673256e-38ea-4aee-bfc5-866e653655a4
0	88	88	Ocean Biodiversity Information System	ba0670b9-4186-41e6-8e70-f9cb3065551a	d8125c76-b612-4db0-b8a7-750d5988bc15
1673	1673	0	Plazi	ffb07bec-2d10-492d-9c37-361fe0b79427	d873f9a9-94e3-4a74-ace7-e536c7bf1721
0	1	1	Plazi	ffb07bec-2d10-492d-9c37-361fe0b79427	d8aff5bd-c19d-4537-9d3d-800305c8192c
0	21	21	Plazi	ffb07bec-2d10-492d-9c37-361fe0b79427	d92d447b-3342-41ca-bdcd-1175c037416f
111744	111744	0	Canada Biodiversity Information Facility	8f83fc96-c966-4126-83f7-bf044dc49efa	d9522343-146c-4d6b-b312-543d4d8ca0e8
0	1	1	Plazi	ffb07bec-2d10-492d-9c37-361fe0b79427	db6b8252-7d11-4895-ae61-d95b13a30299
6	6	0	Plazi	ffb07bec-2d10-492d-9c37-361fe0b79427	dbbdad6a-4219-463c-a554-98a619774f3b
7446	7446	0	GBIF Japan	db5705aa-6a6e-42f1-8942-d77b9f4896ea	dbbdb1f4-d5c7-4b72-b31f-ef6fdf33a9b3
1571731	1560995	-10736	Atlas of Living Australia	4a6f1b71-969e-4fc5-a693-282b05e1220c	dce8feb0-6c89-11de-8225-b8a03c50a862
0	237	237	Ocean Biodiversity Information System	ba0670b9-4186-41e6-8e70-f9cb3065551a	dd888c80-4f73-48d8-944c-4d2a563f2043
300936	308452	7516	GBIF New Zealand	4f9fd726-20dd-445e-89a1-8ed93792276f	df582950-3b58-11dc-8c19-b8a03c50a862
5	5	0	Plazi	ffb07bec-2d10-492d-9c37-361fe0b79427	e259c3a3-b3b9-4317-a298-114a4a7b5500
946	946	0	GBIF France	da44cd31-5901-4687-a106-6d1c7734ee3a	e27cf37d-a2c8-41ad-8059-ebdff346f147
0	1279	1279	Colombian Biodiversity Information System	7e865cba-7c46-417b-ade5-97f2cf5b7be0	e2807119-02f5-4c4c-b08b-ead05f38d146
2	2	0	Plazi	ffb07bec-2d10-492d-9c37-361fe0b79427	e351328a-5fed-4cd0-b6d0-17ee68fbc8c1
0	7	7	Plazi	ffb07bec-2d10-492d-9c37-361fe0b79427	e5eb79b3-7bf3-4eb9-bcb9-49b516a8fc90
0	124	124	Ocean Biodiversity Information System	ba0670b9-4186-41e6-8e70-f9cb3065551a	e6667955-ada1-4412-b0f5-e224481688ff
57	57	0	GBIF Finland	dd514216-5c7c-45f3-910d-797424cb5be6	e68a878d-ea9c-45d9-a4c6-776ebc101374
1966	1966	0	GBIF Germany	4f6826f2-4ff6-443d-b966-e6913bd24013	e8b782ce-22a5-48e4-a62e-8c0ffb9f95e4
0	15	15	Plazi	ffb07bec-2d10-492d-9c37-361fe0b79427	ed6c552e-6c5e-4d03-943c-c9262c05ddca
18	18	0	Plazi	ffb07bec-2d10-492d-9c37-361fe0b79427	edf77b7a-5703-449a-9afb-af33d65b0f9c
0	14	14	Plazi	ffb07bec-2d10-492d-9c37-361fe0b79427	eef0878a-7b23-4746-9680-f1b997bf9935
0	38	38	Plazi	ffb07bec-2d10-492d-9c37-361fe0b79427	f0ac1e8c-b600-4930-94f1-3992327986d4
233	233	0	GBIF Madagascar	2dbfc5c5-51b5-4494-9dfc-4d3f013a3b64	f0ad347c-dfaf-4326-9bb3-5e25f9b45514
82	82	0	Plazi	ffb07bec-2d10-492d-9c37-361fe0b79427	f3e30c6c-2978-4cdf-93f9-dd7ff7bdd921
12	12	0	Plazi	ffb07bec-2d10-492d-9c37-361fe0b79427	f44fa8aa-21e5-4512-85ca-1c810907962d
10404	10404	0	National Biodiversity Network	d897a5b9-35ee-4232-94bd-b0bcaac003c2	f530f789-58de-4b43-9f42-1292db1945cf
2	2	0	Plazi	ffb07bec-2d10-492d-9c37-361fe0b79427	f5aad131-7aa9-44eb-a033-07665bda4ca8
224432	224432	0	Chinese Academy of Sciences	e760dc6f-dd68-474d-ab41-bd3588571793	f9336171-e9a9-4147-b9f6-2d6c133afffd
0	164	164	National Biodiversity Data Centre	422b00b2-6c94-4bb6-976b-c359916efdb8	f9e117d8-d8f7-4d62-b0e2-c12c78f08c56
1936	1936	0	National Biodiversity Network	d897a5b9-35ee-4232-94bd-b0bcaac003c2	fcd8414a-9d49-492c-ab63-17b55aa05b95
327284	327284	0	GBIF Sweden	a0b3be64-6525-4387-ac67-a499950f92e1	fe35d6a0-0c6e-11dd-84d2-b8a03c50a862
0	51	51	GBIF Spain	1f94b3ca-9345-4d65-afe2-4bace93aa0fe	ff273c1a-9abe-4353-af0f-2fed1031e4f0
124376	125791	1415	Netherlands Biodiversity Information Facility	0909d601-bda2-42df-9e63-a6d51847ebce	0102d2af-7f21-4238-b1fa-cbbeeee60423
0	17	17	Participant Node Managers Committee	7f48e0c8-5c96-49ec-b972-30748e339115	061aef68-acfe-4e24-ac63-8a59a9accf93
0	4	4	Plazi	ffb07bec-2d10-492d-9c37-361fe0b79427	07e3a04d-e38a-4d94-b750-5b689f1f246b
6	6	0	Plazi	ffb07bec-2d10-492d-9c37-361fe0b79427	08a63c3c-ef37-4a13-ad59-436532201c95
9	9	0	Plazi	ffb07bec-2d10-492d-9c37-361fe0b79427	08edb842-f385-4e51-9f40-4470fad5545f
12	12	0	Plazi	ffb07bec-2d10-492d-9c37-361fe0b79427	0a904757-e79b-4065-981f-5dcf10ae7d07
0	9	9	Ocean Biodiversity Information System	ba0670b9-4186-41e6-8e70-f9cb3065551a	0d552105-1df6-4ab4-b290-184e6c6fe9e0
42	42	0	GBIF Spain	1f94b3ca-9345-4d65-afe2-4bace93aa0fe	0e0f740e-b9de-41ff-8bdf-17c32a6efb4b
1027	1027	0	Colombian Biodiversity Information System	7e865cba-7c46-417b-ade5-97f2cf5b7be0	0e2f9870-33bf-4ad9-a6cf-379169b428cd
74	74	0	GBIF France	da44cd31-5901-4687-a106-6d1c7734ee3a	1307e459-36cf-4fde-9f1e-d95638334856
7842	7842	0	GBIF France	da44cd31-5901-4687-a106-6d1c7734ee3a	130eea59-ef11-4fb4-91c7-ad51fe5af069
77	77	0	Plazi	ffb07bec-2d10-492d-9c37-361fe0b79427	13301a8f-3060-4f1b-9743-b55303c84a48
4	4	0	Plazi	ffb07bec-2d10-492d-9c37-361fe0b79427	13966ea2-f556-4d72-917e-a1b7dd85d0ec
1001	1001	0	Colombian Biodiversity Information System	7e865cba-7c46-417b-ade5-97f2cf5b7be0	13b4fdb0-92a0-4497-bc0a-16d2fdf806fd
1008908	1016796	7888	Atlas of Living Australia	4a6f1b71-969e-4fc5-a693-282b05e1220c	15738fee-78b1-4751-bcc1-cbf7139c68de
3	3	0	Plazi	ffb07bec-2d10-492d-9c37-361fe0b79427	15a17e6a-ec5e-48d6-8fe1-7e1d19d07f94
11498	11498	0	Atlas of Living Australia	4a6f1b71-969e-4fc5-a693-282b05e1220c	167f1948-8f8e-4561-8f44-6184f3c79ef4
22	22	0	Plazi	ffb07bec-2d10-492d-9c37-361fe0b79427	1691ecf1-4a6d-4eff-a0bb-6cb9d1201ec6
0	4	4	Plazi	ffb07bec-2d10-492d-9c37-361fe0b79427	1848c76d-9ab1-4d46-b1bd-d1c64255df32
0	11	11	Plazi	ffb07bec-2d10-492d-9c37-361fe0b79427	18e80f90-c3cc-4085-a554-b4e8c4620234
727	727	0	Biodiversity Information System of Mexico	b324e8e9-9a4c-44fa-8f1a-7f39ea7ab576	19d4325b-d2b3-4afe-8d13-18771cf8f8ab
717	717	0	GBIF France	da44cd31-5901-4687-a106-6d1c7734ee3a	1d2d0c5c-20d2-408c-8627-eedf3cda520e
25	25	0	Colombian Biodiversity Information System	7e865cba-7c46-417b-ade5-97f2cf5b7be0	1d9311c3-d022-4914-8d57-c3c23bb0a74a
41984	41984	0	Biodiversity Information System of Mexico	b324e8e9-9a4c-44fa-8f1a-7f39ea7ab576	1f0febc4-6876-45fd-9cee-da09ba3e937a
0	7027	7027	Ocean Biodiversity Information System	ba0670b9-4186-41e6-8e70-f9cb3065551a	2247b821-1216-4933-8a6e-cd8b3457e49d
98374	95347	-3027	National Biodiversity Network	d897a5b9-35ee-4232-94bd-b0bcaac003c2	233ba471-91a2-47a4-9946-b7e844f2124c
954	954	0	Ocean Biodiversity Information System	ba0670b9-4186-41e6-8e70-f9cb3065551a	24c56165-469b-426a-98bb-2cbdef596680
155	155	0	Plazi	ffb07bec-2d10-492d-9c37-361fe0b79427	24c8554d-e477-4440-8e3f-17af20c1ddc8
2	2	0	Plazi	ffb07bec-2d10-492d-9c37-361fe0b79427	25d4f489-9598-4f7a-b57d-cb54825bdf27
27	27	0	Plazi	ffb07bec-2d10-492d-9c37-361fe0b79427	273e6e1d-05d8-44a5-988d-e7433f986ed8
3	3	0	Plazi	ffb07bec-2d10-492d-9c37-361fe0b79427	277eca87-67c5-42bf-b494-397887598bb9
0	5585	5585	Participant Node Managers Committee	7f48e0c8-5c96-49ec-b972-30748e339115	284f1484-10b7-4ef5-87b7-9de1159e6b42
1	1	0	Plazi	ffb07bec-2d10-492d-9c37-361fe0b79427	29ea1d80-f5ce-4dcd-a9c2-459ee48228b7
2036	2036	0	National Biodiversity Network	d897a5b9-35ee-4232-94bd-b0bcaac003c2	2a2d599b-c605-42a2-8ba6-d54604080579
26	26	0	Plazi	ffb07bec-2d10-492d-9c37-361fe0b79427	2e0de6ff-c2b8-4115-a034-70f80e8f254d
24	24	0	Participant Node Managers Committee	7f48e0c8-5c96-49ec-b972-30748e339115	2ee9763f-58bd-447b-bc37-0ac42e5dccb6
2808	1312	-1496	GBIF Germany	4f6826f2-4ff6-443d-b966-e6913bd24013	31c3308b-9418-4b3e-b219-170223870be5
718	718	0	Atlas of Living Australia	4a6f1b71-969e-4fc5-a693-282b05e1220c	31cc8b55-0455-4faa-aa50-e135d1dcacf0
0	15	15	Plazi	ffb07bec-2d10-492d-9c37-361fe0b79427	38b66f4f-97ce-4458-822b-c6c3dcff3ba7
30	30	0	GBIF Spain	1f94b3ca-9345-4d65-afe2-4bace93aa0fe	3abc2cac-92d8-49d4-9336-f0653b57da2a
1578	1509	-69	GBIF Germany	4f6826f2-4ff6-443d-b966-e6913bd24013	3dc3bf2d-79b6-4677-b50e-313e1299b2de
670	690	20	GBIF Japan	db5705aa-6a6e-42f1-8942-d77b9f4896ea	4006e183-1542-41fe-b79c-28290c70b0d0
763	763	0	GBIF France	da44cd31-5901-4687-a106-6d1c7734ee3a	40510712-89bf-4cac-b794-22f9d29a4f0e
77	77	0	Plazi	ffb07bec-2d10-492d-9c37-361fe0b79427	43bd4af8-e1d9-4d5f-b5f6-73d9c339b2da
0	7	7	Plazi	ffb07bec-2d10-492d-9c37-361fe0b79427	45d1d4f9-cd28-4759-bba9-4029f04f3f7e
12	12	0	Plazi	ffb07bec-2d10-492d-9c37-361fe0b79427	49578aa0-7bd0-4aaf-a5af-b21b02e38bfc
0	12	12	Plazi	ffb07bec-2d10-492d-9c37-361fe0b79427	4982b2bf-0e26-4592-8f4a-6ffcafe31349
16067	16067	0	GBIF Guinea	b1cd2e84-c4ba-47bd-b72a-dfd1f92dce0a	4b3ec18d-2b2e-490b-a92d-1a4088065712
0	9	9	Ocean Biodiversity Information System	ba0670b9-4186-41e6-8e70-f9cb3065551a	4ca7f648-4abb-455a-a0b8-00b3f0b88c1b
74	74	0	GBIF Germany	4f6826f2-4ff6-443d-b966-e6913bd24013	4f5c812c-ead7-4a8b-b270-c7bee01f12ae
78	78	0	Plazi	ffb07bec-2d10-492d-9c37-361fe0b79427	4fde1748-1d18-48e7-abb5-77949f6ead6e
611	611	0	GBIF France	da44cd31-5901-4687-a106-6d1c7734ee3a	52353beb-cc30-41d4-ad7f-918db3cd0e17
1971	1897	-74	Biodiversity Information System of Mexico	b324e8e9-9a4c-44fa-8f1a-7f39ea7ab576	530fefbf-0ce3-4624-a692-301c2126be3a
2017	2017	0	GBIF Benin	efb9c00e-f802-45dd-8826-a52ec45b89ff	53fcab81-1c0a-4a71-98ae-79dbe016771b
0	6	6	Plazi	ffb07bec-2d10-492d-9c37-361fe0b79427	5693a0e7-bfe6-4c07-8dd6-ad4fbc01a04b
2966	2966	0	Society for the Management of Electronic Biodiversity Data	97818ee4-1461-4180-bf1d-b3201050124f	58414378-4fb2-47e0-8dd5-8b55d5c77117
4	4	0	Plazi	ffb07bec-2d10-492d-9c37-361fe0b79427	5b9710ba-c865-47d9-b31d-f4089bd709a0
10353	10353	0	National Biodiversity Network	d897a5b9-35ee-4232-94bd-b0bcaac003c2	60dff3b3-1a39-4417-9d23-92df3d84c28f
51	51	0	GBIF Malawi	2a42e4d7-ad4a-41b3-84c4-de4aa7b74d35	6378806e-388e-4293-b7f4-775548da77b3
3	3	0	Atlas of Living Australia	4a6f1b71-969e-4fc5-a693-282b05e1220c	63a4d812-1a6e-4c69-a47f-7493405bdba8
91	91	0	GBIF Germany	4f6826f2-4ff6-443d-b966-e6913bd24013	63b8f2d6-f762-11e1-a439-00145eb45e9a
3	3	0	Plazi	ffb07bec-2d10-492d-9c37-361fe0b79427	64cd9b6c-4bfd-43f9-8b63-53ecd1b0a361
116	116	0	GBIF Germany	4f6826f2-4ff6-443d-b966-e6913bd24013	6733baf4-f762-11e1-a439-00145eb45e9a
1	1	0	Plazi	ffb07bec-2d10-492d-9c37-361fe0b79427	679016b8-b920-4dd0-a8ff-9b20dc507106
3455	3455	0	Ocean Biodiversity Information System	ba0670b9-4186-41e6-8e70-f9cb3065551a	68ce269d-4a2d-4a49-9555-36f01aa66bf9
10	10	0	GBIF Germany	4f6826f2-4ff6-443d-b966-e6913bd24013	692db328-f762-11e1-a439-00145eb45e9a
267	267	0	GBIF Germany	4f6826f2-4ff6-443d-b966-e6913bd24013	6a60a296-f762-11e1-a439-00145eb45e9a
18	18	0	GBIF Germany	4f6826f2-4ff6-443d-b966-e6913bd24013	6b13dd70-f762-11e1-a439-00145eb45e9a
151657	151657	0	GBIF Japan	db5705aa-6a6e-42f1-8942-d77b9f4896ea	6b58525c-da6e-4d0a-a3fd-457efa65984b
22	22	0	GBIF Germany	4f6826f2-4ff6-443d-b966-e6913bd24013	6c7f7e76-f762-11e1-a439-00145eb45e9a
10	10	0	Plazi	ffb07bec-2d10-492d-9c37-361fe0b79427	6c82c02a-495c-4aed-95f0-41c2bcb5f131
136556	136556	0	GBIF Brazil	cdc9736d-5ff7-4ece-9959-3c744360cdb3	6cb1a437-f8a6-4bdc-a534-87cf2b710427
30	30	0	GBIF Germany	4f6826f2-4ff6-443d-b966-e6913bd24013	6cb4fb6e-f762-11e1-a439-00145eb45e9a
0	32	32	Plazi	ffb07bec-2d10-492d-9c37-361fe0b79427	6cd3f782-5ecf-40a1-ab54-e992619f1349
196	196	0	GBIF Germany	4f6826f2-4ff6-443d-b966-e6913bd24013	6d1f668e-f762-11e1-a439-00145eb45e9a
694	694	0	National Biodiversity Network	d897a5b9-35ee-4232-94bd-b0bcaac003c2	6f35d38c-b6a0-4cd3-b63b-cbbeff51fee9
7	7	0	Plazi	ffb07bec-2d10-492d-9c37-361fe0b79427	70701cda-5e9f-4b76-bdf3-28e8e9d617f7
24	24	0	Plazi	ffb07bec-2d10-492d-9c37-361fe0b79427	709495c3-d142-4551-a5b1-a112aeb66ffe
89	89	0	GBIF Germany	4f6826f2-4ff6-443d-b966-e6913bd24013	70bc8ace-f762-11e1-a439-00145eb45e9a
368	368	0	GBIF France	da44cd31-5901-4687-a106-6d1c7734ee3a	716f686c-a13e-4975-9076-7ee9f59bb4a3
41	41	0	GBIF Germany	4f6826f2-4ff6-443d-b966-e6913bd24013	71990ca6-f762-11e1-a439-00145eb45e9a
56	56	0	GBIF Germany	4f6826f2-4ff6-443d-b966-e6913bd24013	71a161e4-f762-11e1-a439-00145eb45e9a
2969	2969	0	National Biodiversity Network	d897a5b9-35ee-4232-94bd-b0bcaac003c2	72be2c22-53e1-44a6-bbb5-38a03ac21b6b
19686	19686	0	U.S. Geological Survey	8618c64a-93e0-4300-b546-7249e5148ed2	72c4d3c6-5b8d-49f5-bfbe-febd53849588
27	27	0	GBIF Germany	4f6826f2-4ff6-443d-b966-e6913bd24013	7359aafa-f762-11e1-a439-00145eb45e9a
15902	15902	0	GBIF Germany	4f6826f2-4ff6-443d-b966-e6913bd24013	7377c214-e7f1-4fc0-a9de-3b85728ccc11
4	4	0	GBIF Germany	4f6826f2-4ff6-443d-b966-e6913bd24013	742cc0fc-f762-11e1-a439-00145eb45e9a
27	27	0	GBIF Germany	4f6826f2-4ff6-443d-b966-e6913bd24013	755dd1e6-f762-11e1-a439-00145eb45e9a
12681	12681	0	GBIF Argentina	2426a871-9feb-40a1-96c6-0c593a76b835	7814596d-f762-432d-abda-a2e5ad64df92
0	4	4	Plazi	ffb07bec-2d10-492d-9c37-361fe0b79427	795e70be-a6cd-449e-b356-d54f061dd506
41	33	-8	GBIF Germany	4f6826f2-4ff6-443d-b966-e6913bd24013	79b1cd2e-f762-11e1-a439-00145eb45e9a
0	3	3	Plazi	ffb07bec-2d10-492d-9c37-361fe0b79427	7e0cf09d-eb93-4af1-90a4-4f923d81c94e
320	320	0	GBIF Finland	dd514216-5c7c-45f3-910d-797424cb5be6	7e2dcc4f-6468-4b0a-bbd5-d63d3bc8b088
953	953	0	GBIF Germany	4f6826f2-4ff6-443d-b966-e6913bd24013	7eaa4b3a-f762-11e1-a439-00145eb45e9a
384	384	0	GBIF Germany	4f6826f2-4ff6-443d-b966-e6913bd24013	7ecbaef6-f762-11e1-a439-00145eb45e9a
135	135	0	ASEAN Centre for Biodiversity	af2a0fa1-4c8e-4bdc-8954-b1a55e32b0f1	7f30b6c4-bdd7-4dc0-b32e-699a8d96dc47
441	441	0	Biodiversity Information System of Mexico	b324e8e9-9a4c-44fa-8f1a-7f39ea7ab576	7fa70514-f762-11e1-a439-00145eb45e9a
79	79	0	Plazi	ffb07bec-2d10-492d-9c37-361fe0b79427	7fee90de-e441-41be-9663-7bfd11eec4b2
2304	2304	0	Biodiversity Information System of Mexico	b324e8e9-9a4c-44fa-8f1a-7f39ea7ab576	8014fede-f762-11e1-a439-00145eb45e9a
4837	1154684	1149847	Biodiversity Information System of Mexico	b324e8e9-9a4c-44fa-8f1a-7f39ea7ab576	8016518a-f762-11e1-a439-00145eb45e9a
1026	1026	0	GBIF Brazil	cdc9736d-5ff7-4ece-9959-3c744360cdb3	80fdc69b-fb8f-48ef-9066-ade0f60ef5a0
1600	992	-608	GBIF Germany	4f6826f2-4ff6-443d-b966-e6913bd24013	81f57dc8-f762-11e1-a439-00145eb45e9a
385203	388120	2917	Belgian Biodiversity Platform	fb11cfe1-ebc3-45af-9159-17d9fddbcdac	823dc56e-f987-495c-98bf-43318719e30f
51	51	0	GBIF Germany	4f6826f2-4ff6-443d-b966-e6913bd24013	824cefb8-f762-11e1-a439-00145eb45e9a
305	305	0	Participant Node Managers Committee	7f48e0c8-5c96-49ec-b972-30748e339115	82abf189-6d5a-4426-babf-4c2074aea90e
1871	1871	0	GBIF France	da44cd31-5901-4687-a106-6d1c7734ee3a	8498dd6f-9fe8-4651-b017-0d012dd09bcc
92	92	0	U.S. Geological Survey	8618c64a-93e0-4300-b546-7249e5148ed2	8523e688-f762-11e1-a439-00145eb45e9a
164	129	-35	GBIF Germany	4f6826f2-4ff6-443d-b966-e6913bd24013	86f09c5e-f762-11e1-a439-00145eb45e9a
1889	1549	-340	GBIF Germany	4f6826f2-4ff6-443d-b966-e6913bd24013	877cbb1c-f762-11e1-a439-00145eb45e9a
506	367	-139	GBIF Germany	4f6826f2-4ff6-443d-b966-e6913bd24013	87e57abc-f762-11e1-a439-00145eb45e9a
345	279	-66	GBIF Germany	4f6826f2-4ff6-443d-b966-e6913bd24013	87e96514-f762-11e1-a439-00145eb45e9a
391	391	0	GBIF Germany	4f6826f2-4ff6-443d-b966-e6913bd24013	89e49bfe-f762-11e1-a439-00145eb45e9a
718	718	0	GBIF Germany	4f6826f2-4ff6-443d-b966-e6913bd24013	8a5e6484-f762-11e1-a439-00145eb45e9a
539	539	0	GBIF France	da44cd31-5901-4687-a106-6d1c7734ee3a	8afb9798-356b-4b49-98c7-246a19e5b0d0
0	142	142	U.S. Geological Survey	8618c64a-93e0-4300-b546-7249e5148ed2	8c483b15-2fdf-49c8-a4e1-d2fcf3a4aa9d
270	133	-137	GBIF Germany	4f6826f2-4ff6-443d-b966-e6913bd24013	8e191592-f762-11e1-a439-00145eb45e9a
98	39	-59	GBIF Germany	4f6826f2-4ff6-443d-b966-e6913bd24013	8fb32c30-f762-11e1-a439-00145eb45e9a
617	338	-279	GBIF Germany	4f6826f2-4ff6-443d-b966-e6913bd24013	906f37b8-f762-11e1-a439-00145eb45e9a
1	1	0	Plazi	ffb07bec-2d10-492d-9c37-361fe0b79427	90ac196d-f96f-4cf1-92ff-302608dbfadf
332	296	-36	GBIF Germany	4f6826f2-4ff6-443d-b966-e6913bd24013	9173c8b8-f762-11e1-a439-00145eb45e9a
8	8	0	Plazi	ffb07bec-2d10-492d-9c37-361fe0b79427	924c88e7-bef5-46fb-9bc7-7a2ce2c56ff7
607	606	-1	Biodiversity Information System of Mexico	b324e8e9-9a4c-44fa-8f1a-7f39ea7ab576	9346821c-3672-47d1-b3eb-ea9175fa1280
116	116	0	GBIF Germany	4f6826f2-4ff6-443d-b966-e6913bd24013	9367af90-f762-11e1-a439-00145eb45e9a
1	1	0	GBIF Germany	4f6826f2-4ff6-443d-b966-e6913bd24013	9394c46c-f762-11e1-a439-00145eb45e9a
1296	1296	0	Ocean Biodiversity Information System	ba0670b9-4186-41e6-8e70-f9cb3065551a	94a7bb14-d0bc-4082-b4eb-b300bcbdd058
0	3	3	Plazi	ffb07bec-2d10-492d-9c37-361fe0b79427	95b610e7-2c5d-4053-a0c9-c833c1abcee5
4381	5039	658	GBIF Japan	db5705aa-6a6e-42f1-8942-d77b9f4896ea	95f62232-f762-11e1-a439-00145eb45e9a
2934	2934	0	GBIF Germany	4f6826f2-4ff6-443d-b966-e6913bd24013	96729998-f762-11e1-a439-00145eb45e9a
18120	18120	0	U.S. Geological Survey	8618c64a-93e0-4300-b546-7249e5148ed2	96c383a8-f762-11e1-a439-00145eb45e9a
0	2229	2229	Ocean Biodiversity Information System	ba0670b9-4186-41e6-8e70-f9cb3065551a	96fae9be-8455-4015-b447-a00f935e8e77
131	131	0	Plazi	ffb07bec-2d10-492d-9c37-361fe0b79427	9760712d-123a-4499-9500-2ab7f743f0ce
0	1	1	Plazi	ffb07bec-2d10-492d-9c37-361fe0b79427	9858fd3c-4d18-48b2-9d3a-6545c7afffd4
1	1	0	Plazi	ffb07bec-2d10-492d-9c37-361fe0b79427	9a9f7bb5-ef8f-4984-8015-b3f1163286bc
713	713	0	Biodiversity Information System of Mexico	b324e8e9-9a4c-44fa-8f1a-7f39ea7ab576	9be2ab2a-1395-4257-a41e-b50c88c4042c
199	199	0	Plazi	ffb07bec-2d10-492d-9c37-361fe0b79427	9ce1d103-9234-4fbe-9544-f1c294bb8783
7724	7724	0	National Biodiversity Network	d897a5b9-35ee-4232-94bd-b0bcaac003c2	9d6d5d38-3ba9-4ff9-9fb6-e9724d2a830e
580	580	0	GBIF France	da44cd31-5901-4687-a106-6d1c7734ee3a	9de3b887-5642-4483-a2c4-319786b3cde2
0	1	1	Plazi	ffb07bec-2d10-492d-9c37-361fe0b79427	9e958680-584d-4057-bc60-8ae20cb9f210
1	1	0	Plazi	ffb07bec-2d10-492d-9c37-361fe0b79427	9f4903b7-99b1-4b6c-b7a1-833e38656a05
0	3	3	Ocean Biodiversity Information System	ba0670b9-4186-41e6-8e70-f9cb3065551a	9f69eef0-3f96-4e00-9093-a7616b8ba70e
0	2	2	Plazi	ffb07bec-2d10-492d-9c37-361fe0b79427	a3d2b133-d857-4d82-aa4c-014de230bef2
13	13	0	Plazi	ffb07bec-2d10-492d-9c37-361fe0b79427	a4016504-4522-4bd3-85db-89df1ebce440
0	14	14	Plazi	ffb07bec-2d10-492d-9c37-361fe0b79427	a68e1651-dad4-47f1-bb88-4b0fca055035
0	2	2	Participant Node Managers Committee	7f48e0c8-5c96-49ec-b972-30748e339115	a8e1f0d9-c48b-4002-b3f5-2d3a8de45b23
4	4	0	Plazi	ffb07bec-2d10-492d-9c37-361fe0b79427	aa3f0ecd-b8b6-4383-832f-92c8b6f6126d
0	20	20	Plazi	ffb07bec-2d10-492d-9c37-361fe0b79427	ab35015c-4b44-4f6d-9403-e6159dac3a5f
21	21	0	Participant Node Managers Committee	7f48e0c8-5c96-49ec-b972-30748e339115	ad94fb48-5118-40e0-99bc-fa1d94ead1c9
270	270	0	Participant Node Managers Committee	7f48e0c8-5c96-49ec-b972-30748e339115	ae8278d8-b34c-43ad-80cd-127997c3dd68
3	3	0	Plazi	ffb07bec-2d10-492d-9c37-361fe0b79427	b246fbef-f5fb-4a4d-b70d-e92fe63b4bfe
6	6	0	Plazi	ffb07bec-2d10-492d-9c37-361fe0b79427	b3a82448-c750-400c-b568-f995c142eced
237	237	0	National Biodiversity Network	d897a5b9-35ee-4232-94bd-b0bcaac003c2	b3e40bf4-1981-458f-82ff-9e1d316c137f
0	4	4	Plazi	ffb07bec-2d10-492d-9c37-361fe0b79427	b5314e83-212b-4985-a80b-8dac61a991a5
1	1	0	Plazi	ffb07bec-2d10-492d-9c37-361fe0b79427	b5868db0-a591-43d4-848f-d7d6899c651c
0	3	3	Plazi	ffb07bec-2d10-492d-9c37-361fe0b79427	baceb3d3-1924-4841-a173-f9a3cbe7353b
12632	12632	0	GBIF Norway	4f829580-180d-46a9-9c87-ed8ec959b545	bb39604c-3731-49ce-a9dc-f3617d3d0d15
0	29	29	Plazi	ffb07bec-2d10-492d-9c37-361fe0b79427	bf0d1bc8-4e91-4ebb-8684-b8f9b4559169
0	191171	191171	National Biodiversity Network	d897a5b9-35ee-4232-94bd-b0bcaac003c2	c13b687b-5750-456a-856f-4b64303f713f
2	2	0	Plazi	ffb07bec-2d10-492d-9c37-361fe0b79427	c5a10490-5007-46b9-bd4e-24b136f57d99
200	200	0	GBIF France	da44cd31-5901-4687-a106-6d1c7734ee3a	c5b513a4-45a6-4564-88b0-111015ea1c41
139	139	0	GBIF France	da44cd31-5901-4687-a106-6d1c7734ee3a	c61afbe8-8bc6-4fc2-a2a1-d0b995703422
357	357	0	Participant Node Managers Committee	7f48e0c8-5c96-49ec-b972-30748e339115	c6449c7b-775c-41b1-93cd-9fde78f0af10
0	11	11	Plazi	ffb07bec-2d10-492d-9c37-361fe0b79427	c64d68a8-b4e8-4d06-af0d-b2ec86ac8a92
0	62	62	Participant Node Managers Committee	7f48e0c8-5c96-49ec-b972-30748e339115	c6f82368-6586-4b7c-8ab9-06d0e7ebb7ac
248	248	0	Plazi	ffb07bec-2d10-492d-9c37-361fe0b79427	c723b052-3bef-46d2-903b-048ce2cebb1f
665	665	0	GBIF Portugal	673f7038-4262-4149-b753-5658a4e912f6	c72a7a97-9de0-4854-aa80-90df6389ff12
65	65	0	GBIF Norway	4f829580-180d-46a9-9c87-ed8ec959b545	c7aa4f2e-0c01-41c4-b326-d6730134718e
67	67	0	Plazi	ffb07bec-2d10-492d-9c37-361fe0b79427	cafbd6bc-9a54-4733-a377-8f403bef154c
21	21	0	National Biodiversity Network	d897a5b9-35ee-4232-94bd-b0bcaac003c2	cd3a676a-26e4-421f-9de4-fa819fc8c299
0	622	622	U.S. Geological Survey	8618c64a-93e0-4300-b546-7249e5148ed2	cdba51f9-cf9c-48b3-8b4b-9a8d322d79f0
0	8347	8347	Participant Node Managers Committee	7f48e0c8-5c96-49ec-b972-30748e339115	d0d5ef85-71b2-4da6-b6f6-c1c3d60987d3
46	47	1	GBIF Brazil	cdc9736d-5ff7-4ece-9959-3c744360cdb3	d40307f5-55e0-4e9e-a42a-5f3612c56f31
493	493	0	GBIF Guinea	b1cd2e84-c4ba-47bd-b72a-dfd1f92dce0a	d7cf2c48-3d3a-4981-bfce-dbef6fe6eef3
1502	1502	0	Colombian Biodiversity Information System	7e865cba-7c46-417b-ade5-97f2cf5b7be0	d87e8fe8-0746-479c-bdfb-3db6857ab24b
0	11	11	Plazi	ffb07bec-2d10-492d-9c37-361fe0b79427	da0ce38c-0f0f-4f05-87d6-6eedc15a56db
51513	51513	0	Canada Biodiversity Information Facility	8f83fc96-c966-4126-83f7-bf044dc49efa	e0dbf705-cec4-4dce-a152-fc4ebe14674d
2	2	0	Plazi	ffb07bec-2d10-492d-9c37-361fe0b79427	e17780b8-4e8a-466c-9562-b4cda3d2e175
0	68	68	Ocean Biodiversity Information System	ba0670b9-4186-41e6-8e70-f9cb3065551a	e78256b5-5626-4a5b-af7b-6ef147dfb6a8
9264	9264	0	U.S. Geological Survey	8618c64a-93e0-4300-b546-7249e5148ed2	e99c1b37-f7b7-4316-9749-fc9d4f3dfc0b
2	2	0	Plazi	ffb07bec-2d10-492d-9c37-361fe0b79427	ea5631cc-38d4-48ba-b6ee-76372550ded6
60	60	0	Colombian Biodiversity Information System	7e865cba-7c46-417b-ade5-97f2cf5b7be0	f14ea637-af26-4b70-8e8b-8b1dd416e961
0	214	214	Belgian Biodiversity Platform	fb11cfe1-ebc3-45af-9159-17d9fddbcdac	f5361e97-c8f1-4697-b209-8817e14ae780
2	2	0	Plazi	ffb07bec-2d10-492d-9c37-361fe0b79427	f6f4e200-f649-491b-bece-0cd0f7b4d632
1	1	0	Plazi	ffb07bec-2d10-492d-9c37-361fe0b79427	f86c0afe-5fbf-4b97-b6b6-16dece45e39f
19	19	0	GBIF Germany	4f6826f2-4ff6-443d-b966-e6913bd24013	f870fad8-7d72-48b6-bd78-321d30dbdac2
6	6	0	Plazi	ffb07bec-2d10-492d-9c37-361fe0b79427	f8824fbc-a420-4e93-937e-c3bde707227e
1	1	0	Plazi	ffb07bec-2d10-492d-9c37-361fe0b79427	f9d082ce-b4e1-46b6-ad5d-16f17b38aed7
30436	30436	0	Netherlands Biodiversity Information Facility	0909d601-bda2-42df-9e63-a6d51847ebce	fbe1f070-b6e4-11dd-81f6-b8a03c50a862
198698	198698	0	U.S. Geological Survey	8618c64a-93e0-4300-b546-7249e5148ed2	04257f52-91ed-4851-905d-d5887465d363
0	279	279	Belgian Biodiversity Platform	fb11cfe1-ebc3-45af-9159-17d9fddbcdac	04b4dbf9-9b98-4f8f-9112-272015b32232
0	21	21	Ocean Biodiversity Information System	ba0670b9-4186-41e6-8e70-f9cb3065551a	06e003a5-b4cc-4cd5-ba08-697800cf659f
25	25	0	Plazi	ffb07bec-2d10-492d-9c37-361fe0b79427	070850ee-3501-4232-88c6-c5bed10a65eb
26534	26534	0	GBIF Germany	4f6826f2-4ff6-443d-b966-e6913bd24013	0bbc5ba0-d7f8-11e2-95e7-00145eb45e9a
3	3	0	Plazi	ffb07bec-2d10-492d-9c37-361fe0b79427	0d4b2345-a98b-4d14-a844-6182551f9332
0	3	3	Plazi	ffb07bec-2d10-492d-9c37-361fe0b79427	0df45d6f-0665-4855-9778-91d6bf437b68
0	13	13	Plazi	ffb07bec-2d10-492d-9c37-361fe0b79427	0e5ba00b-c61a-4da3-bacd-e0ae74716632
62	62	0	GBIF Guinea	b1cd2e84-c4ba-47bd-b72a-dfd1f92dce0a	111e4699-b9da-4750-b85d-46a6fcf4ca3c
1135	1135	0	U.S. Geological Survey	8618c64a-93e0-4300-b546-7249e5148ed2	11348e7a-b7ce-44ce-8112-1b18828f029d
2851	2851	0	GBIF Japan	db5705aa-6a6e-42f1-8942-d77b9f4896ea	12ccff8a-cfa8-46f8-a8b0-c6da39cb8910
0	13	13	Plazi	ffb07bec-2d10-492d-9c37-361fe0b79427	1322b578-84ee-418e-963a-c0327462188c
4046	4046	0	Biodiversity Information System of Mexico	b324e8e9-9a4c-44fa-8f1a-7f39ea7ab576	14efaf3e-d053-4f50-8e44-d0d2c5ab48b7
32	32	0	Participant Node Managers Committee	7f48e0c8-5c96-49ec-b972-30748e339115	15f4cb28-ede1-422c-a2d6-efbd43682c61
17	17	0	Plazi	ffb07bec-2d10-492d-9c37-361fe0b79427	162fd3ef-01e7-42aa-aec3-2119d32eaead
0	111	111	Plazi	ffb07bec-2d10-492d-9c37-361fe0b79427	18a7da01-2a91-4662-b5d5-34f9af05d2a6
1201	1201	0	Participant Node Managers Committee	7f48e0c8-5c96-49ec-b972-30748e339115	1962b370-4fd5-4b22-a30e-0adb8570688d
82653	82385	-268	U.S. Geological Survey	8618c64a-93e0-4300-b546-7249e5148ed2	1a9d08bb-9e2c-4540-8f7f-3205846b6ddc
0	35	35	Plazi	ffb07bec-2d10-492d-9c37-361fe0b79427	1af8ab63-49e8-498e-8ea6-54882d25654f
2284	2284	0	GBIF Spain	1f94b3ca-9345-4d65-afe2-4bace93aa0fe	1be624ad-2628-4a57-a68f-0fea6e3fba31
11	11	0	National Biodiversity Network	d897a5b9-35ee-4232-94bd-b0bcaac003c2	1bf8f32b-4d03-439c-9144-1396f8f265d1
16	16	0	Plazi	ffb07bec-2d10-492d-9c37-361fe0b79427	2149dae2-5343-4153-a05a-1bbef0e701c3
43	43	0	GBIF France	da44cd31-5901-4687-a106-6d1c7734ee3a	21b5ec6b-a4c5-40de-b0f8-5da9607ac150
7	7	0	Plazi	ffb07bec-2d10-492d-9c37-361fe0b79427	230f1edf-d723-44a6-9f0e-04a119889733
146	146	0	Biodiversity Information System of Mexico	b324e8e9-9a4c-44fa-8f1a-7f39ea7ab576	244834e9-f320-4368-b928-dd66e991f852
1000	1000	0	Biodiversity Information System of Mexico	b324e8e9-9a4c-44fa-8f1a-7f39ea7ab576	26fa7769-bb24-4cd7-a49c-a76817ca9e7d
8	8	0	Plazi	ffb07bec-2d10-492d-9c37-361fe0b79427	2af5b78d-ef37-4561-9ff6-3fac4a7e320c
58	58	0	GBIF France	da44cd31-5901-4687-a106-6d1c7734ee3a	2d47f362-609d-4870-9f44-bdbfa9a01709
0	691	691	Participant Node Managers Committee	7f48e0c8-5c96-49ec-b972-30748e339115	30481570-92ba-4ab0-ac6d-5ca34d1f00a4
0	280	280	GBIF Uganda	71b40829-6a12-4c3d-8fee-5746f5e9cf8c	305fd445-ee71-44af-9bed-a92da93fed88
4772	5118	346	National Biodiversity Network	d897a5b9-35ee-4232-94bd-b0bcaac003c2	3184ffaf-a7d3-4498-a8f9-3f1e0e45e1e9
2	2	0	Plazi	ffb07bec-2d10-492d-9c37-361fe0b79427	31888828-c367-402e-9af8-f715f9f14b55
0	16	16	Participant Node Managers Committee	7f48e0c8-5c96-49ec-b972-30748e339115	35589660-146b-4509-b3be-f4b9db7d6e9d
24	24	0	GBIF Germany	4f6826f2-4ff6-443d-b966-e6913bd24013	35e7825b-4c73-4ff6-9364-90f116f4d4fa
6	6	0	Plazi	ffb07bec-2d10-492d-9c37-361fe0b79427	388a52b8-c2fb-4b47-90f7-23f4f6c30f93
48576	48576	0	National Biodiversity Network	d897a5b9-35ee-4232-94bd-b0bcaac003c2	3a7f5881-230e-4eaa-a514-c73e184cb40b
0	263213	263213	U.S. Geological Survey	8618c64a-93e0-4300-b546-7249e5148ed2	3ab13bbb-8efa-4f6a-838b-b6a8eaa3f4df
2	2	0	Participant Node Managers Committee	7f48e0c8-5c96-49ec-b972-30748e339115	3acd6fb6-afce-49a3-a70d-070d4250229b
332	332	0	National Biodiversity Network	d897a5b9-35ee-4232-94bd-b0bcaac003c2	3b954df3-543d-4045-a24c-00e6d15f7a0b
60	60	0	Plazi	ffb07bec-2d10-492d-9c37-361fe0b79427	3ca0710c-d484-4e32-805a-3c6281d1ef6e
8104	8104	0	Atlas of Living Australia	4a6f1b71-969e-4fc5-a693-282b05e1220c	3d93e795-10d9-41fd-8eca-579c2aca513e
0	154	154	Plazi	ffb07bec-2d10-492d-9c37-361fe0b79427	3d9df3ba-adb5-46ec-9784-eb3a9853258b
220	15	-205	GBIF Germany	4f6826f2-4ff6-443d-b966-e6913bd24013	3eff910f-eef4-4674-b9ab-c1ebaa16d524
10	10	0	Colombian Biodiversity Information System	7e865cba-7c46-417b-ade5-97f2cf5b7be0	413be735-4908-431b-af91-a1e86479a11f
11399	11399	0	GBIF France	da44cd31-5901-4687-a106-6d1c7734ee3a	41c2c751-d619-4825-9ed6-02d67ccebc98
1	1	0	Participant Node Managers Committee	7f48e0c8-5c96-49ec-b972-30748e339115	43a2cf52-50a6-446c-a5b5-3c779f5c20c4
308	308	0	GBIF Norway	4f829580-180d-46a9-9c87-ed8ec959b545	499f7f48-56fc-44a6-b5a4-d4f5e4bfdd97
29480	29480	0	GBIF France	da44cd31-5901-4687-a106-6d1c7734ee3a	49e2373b-a93a-4943-ae4b-92d54f30971b
41	41	0	Plazi	ffb07bec-2d10-492d-9c37-361fe0b79427	4e0ac72c-07e7-4624-8701-f09ada76ce1b
5	5	0	Plazi	ffb07bec-2d10-492d-9c37-361fe0b79427	4f9269d2-8566-473d-b29c-f01db41b5e34
4	4	0	Plazi	ffb07bec-2d10-492d-9c37-361fe0b79427	51c08ce7-4068-4aa3-ad1b-98475d45a168
330	330	0	GBIF Portugal	673f7038-4262-4149-b753-5658a4e912f6	53147811-d7a8-4f80-aaad-c752058dc808
0	2	2	Plazi	ffb07bec-2d10-492d-9c37-361fe0b79427	533241d7-2c6d-4374-9933-4bd9b45078b8
0	6	6	Plazi	ffb07bec-2d10-492d-9c37-361fe0b79427	5e205564-bd7d-44be-8995-dd9552353360
3327	3327	0	GBIF Israel	8cb55387-7802-40e8-86d6-d357a583c596	5f20e856-9c2d-424f-b2c7-7092c1d6908f
0	24	24	Plazi	ffb07bec-2d10-492d-9c37-361fe0b79427	5ffd0d3f-8a5d-406e-a458-3ab1b5b2cef0
35	35	0	Plazi	ffb07bec-2d10-492d-9c37-361fe0b79427	60161840-b9ca-420f-9ef4-c0918e409da6
6368	6368	0	Participant Node Managers Committee	7f48e0c8-5c96-49ec-b972-30748e339115	602b5978-0777-41d7-8c9f-44f459b0f8ef
111	111	0	GBIF Germany	4f6826f2-4ff6-443d-b966-e6913bd24013	6116d9ee-f762-11e1-a439-00145eb45e9a
81	81	0	GBIF Germany	4f6826f2-4ff6-443d-b966-e6913bd24013	6138480e-f762-11e1-a439-00145eb45e9a
118	118	0	GBIF Germany	4f6826f2-4ff6-443d-b966-e6913bd24013	625ebaa6-f762-11e1-a439-00145eb45e9a
22	22	0	GBIF Germany	4f6826f2-4ff6-443d-b966-e6913bd24013	62f3279a-f762-11e1-a439-00145eb45e9a
105	105	0	GBIF Germany	4f6826f2-4ff6-443d-b966-e6913bd24013	63d82ebc-f762-11e1-a439-00145eb45e9a
114	114	0	GBIF Germany	4f6826f2-4ff6-443d-b966-e6913bd24013	63ef4f66-f762-11e1-a439-00145eb45e9a
3	3	0	Plazi	ffb07bec-2d10-492d-9c37-361fe0b79427	64627d34-0044-4584-b626-3d2fce2a3d65
23	20	-3	GBIF Germany	4f6826f2-4ff6-443d-b966-e6913bd24013	65d2821c-f762-11e1-a439-00145eb45e9a
134	90	-44	GBIF Germany	4f6826f2-4ff6-443d-b966-e6913bd24013	65fbfc32-f762-11e1-a439-00145eb45e9a
0	45	45	Plazi	ffb07bec-2d10-492d-9c37-361fe0b79427	66abbd26-0f90-4888-9851-b54dc1f135cb
17253	17253	0	GBIF Argentina	2426a871-9feb-40a1-96c6-0c593a76b835	66df75d3-6b1b-4251-bd09-bfa4f0f12bf0
124	124	0	GBIF Germany	4f6826f2-4ff6-443d-b966-e6913bd24013	671eceb4-f762-11e1-a439-00145eb45e9a
68	68	0	GBIF Germany	4f6826f2-4ff6-443d-b966-e6913bd24013	6770980c-f762-11e1-a439-00145eb45e9a
2	2	0	Plazi	ffb07bec-2d10-492d-9c37-361fe0b79427	67de54d7-b8fe-47dd-81d7-b077e7d9c210
101	101	0	GBIF Germany	4f6826f2-4ff6-443d-b966-e6913bd24013	6918553c-f762-11e1-a439-00145eb45e9a
83	83	0	GBIF Germany	4f6826f2-4ff6-443d-b966-e6913bd24013	69970a44-f762-11e1-a439-00145eb45e9a
102	102	0	GBIF Germany	4f6826f2-4ff6-443d-b966-e6913bd24013	6a0a56a6-cde4-4998-8014-4e14972512df
249	249	0	GBIF Germany	4f6826f2-4ff6-443d-b966-e6913bd24013	6a694798-f762-11e1-a439-00145eb45e9a
166	166	0	Plazi	ffb07bec-2d10-492d-9c37-361fe0b79427	6b915c93-4df0-4c78-a23d-b47ad5cb6a00
12	12	0	GBIF Germany	4f6826f2-4ff6-443d-b966-e6913bd24013	6bd5ddf8-f762-11e1-a439-00145eb45e9a
233	233	0	GBIF Germany	4f6826f2-4ff6-443d-b966-e6913bd24013	6c13eca6-f762-11e1-a439-00145eb45e9a
112	112	0	GBIF Germany	4f6826f2-4ff6-443d-b966-e6913bd24013	6d547040-f762-11e1-a439-00145eb45e9a
1046	780	-266	GBIF Germany	4f6826f2-4ff6-443d-b966-e6913bd24013	704ba99e-f762-11e1-a439-00145eb45e9a
6	6	0	Plazi	ffb07bec-2d10-492d-9c37-361fe0b79427	70d413a9-9268-42ac-9af7-8877de777634
2303	2303	0	GBIF Germany	4f6826f2-4ff6-443d-b966-e6913bd24013	7106d2ff-f04d-436f-91b5-ff96b0d44fc5
65917	65917	0	National Biodiversity Network	d897a5b9-35ee-4232-94bd-b0bcaac003c2	717b3b87-0ebd-46b4-812b-4a29786798d9
0	8	8	Plazi	ffb07bec-2d10-492d-9c37-361fe0b79427	7264c303-f507-40d9-a6d7-7d4e0629d402
3	3	0	Plazi	ffb07bec-2d10-492d-9c37-361fe0b79427	73c3d6ef-363f-4327-9131-914f1c6735b8
271	271	0	GBIF Germany	4f6826f2-4ff6-443d-b966-e6913bd24013	73fe06c2-f762-11e1-a439-00145eb45e9a
157	157	0	GBIF Germany	4f6826f2-4ff6-443d-b966-e6913bd24013	753bd9ce-f762-11e1-a439-00145eb45e9a
0	2	2	Plazi	ffb07bec-2d10-492d-9c37-361fe0b79427	75e6cca4-d312-43d5-8299-9e5788de58d2
2	2	0	Plazi	ffb07bec-2d10-492d-9c37-361fe0b79427	760e676f-1822-46b3-a555-f5addfe67085
3940	226	-3714	GBIF Germany	4f6826f2-4ff6-443d-b966-e6913bd24013	7763fd3a-f762-11e1-a439-00145eb45e9a
1000	1000	0	GBIF Japan	db5705aa-6a6e-42f1-8942-d77b9f4896ea	78172eb7-f7af-4a11-8041-1c31967c4a77
10	10	0	Plazi	ffb07bec-2d10-492d-9c37-361fe0b79427	7856d718-8d6c-4df7-9244-a1402370fb3b
3776	1984	-1792	GBIF Germany	4f6826f2-4ff6-443d-b966-e6913bd24013	7bdd42d6-f762-11e1-a439-00145eb45e9a
68	68	0	GBIF France	da44cd31-5901-4687-a106-6d1c7734ee3a	7c9d24e9-f9ee-405a-9150-29719a7af2f8
391	391	0	GBIF Germany	4f6826f2-4ff6-443d-b966-e6913bd24013	7e1bbd98-f762-11e1-a439-00145eb45e9a
153	153	0	National Biodiversity Data Centre	422b00b2-6c94-4bb6-976b-c359916efdb8	7e225289-7c61-498a-bbcc-9995685b9abc
3105	3105	0	Participant Node Managers Committee	7f48e0c8-5c96-49ec-b972-30748e339115	7e41f9c5-1c01-4ade-a51a-803b1ce588dc
7	7	0	GBIF Germany	4f6826f2-4ff6-443d-b966-e6913bd24013	81904476-f762-11e1-a439-00145eb45e9a
40	40	0	GBIF Germany	4f6826f2-4ff6-443d-b966-e6913bd24013	822a8608-f762-11e1-a439-00145eb45e9a
0	107	107	Plazi	ffb07bec-2d10-492d-9c37-361fe0b79427	83109e54-596a-4be0-ac2c-c4e1702cfb8a
0	43	43	Ocean Biodiversity Information System	ba0670b9-4186-41e6-8e70-f9cb3065551a	831a251c-c7dc-40a4-9b00-3d7577a77164
54530	54533	3	GBIF Spain	1f94b3ca-9345-4d65-afe2-4bace93aa0fe	8353c5bc-f762-11e1-a439-00145eb45e9a
39148	39148	0	GBIF Spain	1f94b3ca-9345-4d65-afe2-4bace93aa0fe	835613da-f762-11e1-a439-00145eb45e9a
0	6188	6188	GBIF Benin	efb9c00e-f802-45dd-8826-a52ec45b89ff	8382d626-e590-46cd-9143-241dc0257757
245	245	0	Albertine Rift Conservation Society	90a939d3-e99c-4f6d-915f-2616423b3735	84176530-6d89-4f7e-bb6d-a31d13a1fe2f
331	331	0	GBIF Argentina	2426a871-9feb-40a1-96c6-0c593a76b835	85814728-1453-4d63-8c03-40739a4ea684
195264	195264	0	U.S. Geological Survey	8618c64a-93e0-4300-b546-7249e5148ed2	864da4c2-f762-11e1-a439-00145eb45e9a
212	212	0	GBIF Germany	4f6826f2-4ff6-443d-b966-e6913bd24013	882cebea-f762-11e1-a439-00145eb45e9a
35	35	0	Plazi	ffb07bec-2d10-492d-9c37-361fe0b79427	8892b00f-9426-4398-afd2-db9d8412e922
145055	145055	0	GBIF France	da44cd31-5901-4687-a106-6d1c7734ee3a	88967ea9-19ea-4f4d-b137-879ee00ebda8
4	4	0	Plazi	ffb07bec-2d10-492d-9c37-361fe0b79427	88df94bf-3dc0-47f4-a9a7-11f8878e5357
164	164	0	GBIF Germany	4f6826f2-4ff6-443d-b966-e6913bd24013	8a27b560-f762-11e1-a439-00145eb45e9a
307	307	0	GBIF Germany	4f6826f2-4ff6-443d-b966-e6913bd24013	8a2a9bcc-f762-11e1-a439-00145eb45e9a
104	104	0	GBIF Germany	4f6826f2-4ff6-443d-b966-e6913bd24013	8a52244e-f762-11e1-a439-00145eb45e9a
107	107	0	GBIF Germany	4f6826f2-4ff6-443d-b966-e6913bd24013	8a6c20ba-f762-11e1-a439-00145eb45e9a
54	54	0	GBIF Germany	4f6826f2-4ff6-443d-b966-e6913bd24013	8ab1d0f6-f762-11e1-a439-00145eb45e9a
28	28	0	GBIF Germany	4f6826f2-4ff6-443d-b966-e6913bd24013	8c9c161a-f762-11e1-a439-00145eb45e9a
1	1	0	GBIF France	da44cd31-5901-4687-a106-6d1c7734ee3a	8d47411f-9e61-40ff-891f-2fee5ede61b1
109	103	-6	GBIF Germany	4f6826f2-4ff6-443d-b966-e6913bd24013	8df9a19e-f762-11e1-a439-00145eb45e9a
0	12	12	Plazi	ffb07bec-2d10-492d-9c37-361fe0b79427	8e212350-ccea-443c-abab-278bab381aa3
1037	1037	0	Colombian Biodiversity Information System	7e865cba-7c46-417b-ade5-97f2cf5b7be0	8e921f3a-f567-4c8e-99ba-8d9cde75b9a3
983	737	-246	GBIF Germany	4f6826f2-4ff6-443d-b966-e6913bd24013	8fa1c756-f762-11e1-a439-00145eb45e9a
10	6	-4	GBIF Germany	4f6826f2-4ff6-443d-b966-e6913bd24013	9049ab74-f762-11e1-a439-00145eb45e9a
925	535	-390	GBIF Germany	4f6826f2-4ff6-443d-b966-e6913bd24013	9094da22-f762-11e1-a439-00145eb45e9a
4	4	0	Plazi	ffb07bec-2d10-492d-9c37-361fe0b79427	9103f07a-5514-40f7-8624-b81b7a04510a
10	10	0	GBIF Germany	4f6826f2-4ff6-443d-b966-e6913bd24013	915ed71e-f762-11e1-a439-00145eb45e9a
1305	1305	0	GBIF Germany	4f6826f2-4ff6-443d-b966-e6913bd24013	93550692-f762-11e1-a439-00145eb45e9a
126	126	0	GBIF Germany	4f6826f2-4ff6-443d-b966-e6913bd24013	9597b49a-f762-11e1-a439-00145eb45e9a
148	148	0	Colombian Biodiversity Information System	7e865cba-7c46-417b-ade5-97f2cf5b7be0	963e4eb1-9ee4-47cb-bf1f-c6092ca5e985
1828	1828	0	GBIF France	da44cd31-5901-4687-a106-6d1c7734ee3a	9a534fe9-2726-4272-a62d-90492b65ca56
40	40	0	GBIF France	da44cd31-5901-4687-a106-6d1c7734ee3a	9bfcf745-653d-45ce-ba8c-87acfbaa1520
169	169	0	Colombian Biodiversity Information System	7e865cba-7c46-417b-ade5-97f2cf5b7be0	9dc3501a-29a0-4907-8f17-614079f34dd2
2	2	0	Plazi	ffb07bec-2d10-492d-9c37-361fe0b79427	9e5c003e-59a5-4d2e-abc6-664d9450042a
5	5	0	Plazi	ffb07bec-2d10-492d-9c37-361fe0b79427	a040d3bb-a756-4f44-80d7-c5213e325b94
1627	1627	0	GBIF Finland	dd514216-5c7c-45f3-910d-797424cb5be6	a0c29d70-d10e-430a-81cc-730fdc4299ef
0	1075	1075	Colombian Biodiversity Information System	7e865cba-7c46-417b-ade5-97f2cf5b7be0	a36db975-46a4-4664-a12f-85dfb76a81d2
0	196	196	Colombian Biodiversity Information System	7e865cba-7c46-417b-ade5-97f2cf5b7be0	a36fc1d5-3410-4e99-b90b-87645a4a0d36
525	525	0	Colombian Biodiversity Information System	7e865cba-7c46-417b-ade5-97f2cf5b7be0	a4555281-5046-424f-9cd1-e7c103234416
0	4745	4745	GBIF Benin	efb9c00e-f802-45dd-8826-a52ec45b89ff	a4cb66e3-1217-407b-b4b1-bf19c2659d17
215	215	0	Colombian Biodiversity Information System	7e865cba-7c46-417b-ade5-97f2cf5b7be0	a6797d23-a714-4f64-b1c9-6c6c6f0aeb03
8	8	0	Plazi	ffb07bec-2d10-492d-9c37-361fe0b79427	a813546a-5bf8-490d-8198-82f24ea7cf21
3229	3242	13	Colombian Biodiversity Information System	7e865cba-7c46-417b-ade5-97f2cf5b7be0	a923e872-a8b8-4ea7-9a21-826b09d01eec
13	13	0	Plazi	ffb07bec-2d10-492d-9c37-361fe0b79427	ab1280cb-11f0-495d-9dd6-f121598eebe2
0	183	183	Ocean Biodiversity Information System	ba0670b9-4186-41e6-8e70-f9cb3065551a	ae045eff-4828-42cd-a811-7f3e0ac02b7c
3	3	0	Plazi	ffb07bec-2d10-492d-9c37-361fe0b79427	aed90136-53f9-4de1-944a-0fd6c8433dc8
118	118	0	Plazi	ffb07bec-2d10-492d-9c37-361fe0b79427	b4e5a26a-0e84-4210-b2f1-284545cc1b8a
5	5	0	Plazi	ffb07bec-2d10-492d-9c37-361fe0b79427	b6d7bb5c-3394-47cf-b384-dc727a152bbe
385	385	0	GBIF France	da44cd31-5901-4687-a106-6d1c7734ee3a	b7f2f852-f332-43af-8575-25a6906b8db2
498	498	0	Participant Node Managers Committee	7f48e0c8-5c96-49ec-b972-30748e339115	ba9b69e2-a26d-49f3-aba4-034d04489b62
4951	4951	0	GBIF Spain	1f94b3ca-9345-4d65-afe2-4bace93aa0fe	bf4ab07a-4d9b-4ee9-af03-d22651385dbc
34	34	0	GBIF France	da44cd31-5901-4687-a106-6d1c7734ee3a	c002c21b-7569-4f30-8006-2be28ede5101
0	1	1	Plazi	ffb07bec-2d10-492d-9c37-361fe0b79427	c0ae70d0-176e-40ed-921b-f428d40ed22b
3	3	0	Plazi	ffb07bec-2d10-492d-9c37-361fe0b79427	c0f11974-9286-442b-85d3-bfd8b561a78d
6	6	0	Plazi	ffb07bec-2d10-492d-9c37-361fe0b79427	c3ff1de4-12ec-4b60-a2e2-a359054bfed6
329	329	0	National Biodiversity Network	d897a5b9-35ee-4232-94bd-b0bcaac003c2	c422d55a-9e33-46b7-bb88-5545634c22bf
0	18	18	Plazi	ffb07bec-2d10-492d-9c37-361fe0b79427	c50f5780-523a-40db-bade-2289eedfa11d
7	7	0	GBIF Germany	4f6826f2-4ff6-443d-b966-e6913bd24013	c5de1155-cc7e-43e8-bf01-b8b2e23cc9e5
49370	49370	0	GBIF France	da44cd31-5901-4687-a106-6d1c7734ee3a	cba362bc-aab5-4ad2-9d72-d3498851e53f
4	4	0	Plazi	ffb07bec-2d10-492d-9c37-361fe0b79427	cd0655f9-d43c-4244-8538-f69ca836da36
6	6	0	Plazi	ffb07bec-2d10-492d-9c37-361fe0b79427	d038a07d-5b96-4168-8b67-a84cb2ad6edc
4958	4957	-1	Biodiversity Information System of Mexico	b324e8e9-9a4c-44fa-8f1a-7f39ea7ab576	d1bb9ca1-95c3-453a-9ff2-2ee2e4ad6a62
0	4	4	Plazi	ffb07bec-2d10-492d-9c37-361fe0b79427	d2198843-0bff-42aa-b874-11f842515995
3	3	0	Plazi	ffb07bec-2d10-492d-9c37-361fe0b79427	d76fe223-3a3c-42a9-84dc-8d52956afb1c
9	9	0	GBIF Argentina	2426a871-9feb-40a1-96c6-0c593a76b835	df9f3eb1-97fd-4d3e-a0ee-6daa609a50e9
19	19	0	Plazi	ffb07bec-2d10-492d-9c37-361fe0b79427	dfb42b32-32b8-4e81-9caa-702a249d7845
8	8	0	Plazi	ffb07bec-2d10-492d-9c37-361fe0b79427	e01a3a46-9e8c-4866-b9f7-53f9ec24ba66
335	335	0	National Biodiversity Network	d897a5b9-35ee-4232-94bd-b0bcaac003c2	e08de352-9383-48b0-88ae-be15cce386c5
19	19	0	Participant Node Managers Committee	7f48e0c8-5c96-49ec-b972-30748e339115	e1e61f69-2201-416f-bd66-c09643e7e256
0	24	24	Plazi	ffb07bec-2d10-492d-9c37-361fe0b79427	e3c4deca-19c7-45f4-ac19-b6e709b0de9c
10	10	0	Plazi	ffb07bec-2d10-492d-9c37-361fe0b79427	e48ca9ee-7e55-4ed0-a0c6-0898a7d75f83
0	5	5	Plazi	ffb07bec-2d10-492d-9c37-361fe0b79427	e8a47bc6-e0ca-4389-9c90-b23a1e56581f
231	231	0	GBIF Guinea	b1cd2e84-c4ba-47bd-b72a-dfd1f92dce0a	e99cb328-39fb-46da-9cad-b3957c2cbe8c
0	24	24	Plazi	ffb07bec-2d10-492d-9c37-361fe0b79427	e9e5ca91-5568-46c6-8d7f-3b5f1697788a
0	131	131	Ocean Biodiversity Information System	ba0670b9-4186-41e6-8e70-f9cb3065551a	e9e6f0ba-b7c8-4557-ad7c-c5ff91a01a74
1280	1280	0	GBIF Brazil	cdc9736d-5ff7-4ece-9959-3c744360cdb3	ea351d78-d189-41aa-af7f-bdd3bfc89ef1
0	60	60	U.S. Geological Survey	8618c64a-93e0-4300-b546-7249e5148ed2	ea93c576-2814-44d9-a645-0f22af6d35d4
101339	102898	1559	GBIF Norway	4f829580-180d-46a9-9c87-ed8ec959b545	edd9b710-f3bb-4c49-9fa5-724cd4ecfc7d
0	91	91	Ocean Biodiversity Information System	ba0670b9-4186-41e6-8e70-f9cb3065551a	eeec48dd-d2c9-454f-a9d6-4cea1c00ee31
20430	20430	0	GBIF Benin	efb9c00e-f802-45dd-8826-a52ec45b89ff	ef9fca55-a303-458a-b95d-eeff0e8cce46
10	10	0	Plazi	ffb07bec-2d10-492d-9c37-361fe0b79427	f267c3f7-48d8-45f7-a480-b1660dc6b391
2	2	0	Plazi	ffb07bec-2d10-492d-9c37-361fe0b79427	f5d4ff01-a068-4ac4-a0d6-59cdbd79bf3e
0	95	95	Ocean Biodiversity Information System	ba0670b9-4186-41e6-8e70-f9cb3065551a	f6f93345-c80d-4c0a-8978-7632b7f66eef
2	2	0	Plazi	ffb07bec-2d10-492d-9c37-361fe0b79427	f7e92d99-c469-49ed-a44f-fe241e84897b
189	164	-25	GBIF Germany	4f6826f2-4ff6-443d-b966-e6913bd24013	f869175b-c837-451c-af44-63fcf2b41536
0	46	46	Plazi	ffb07bec-2d10-492d-9c37-361fe0b79427	f8eb7e73-4a8e-4e34-a286-73e87bed4afa
4	4	0	Plazi	ffb07bec-2d10-492d-9c37-361fe0b79427	f97522b4-9676-45f4-92af-f06f8397ebbf
9546	4648	-4898	Participant Node Managers Committee	7f48e0c8-5c96-49ec-b972-30748e339115	f9c264e3-d808-4b42-8091-87cafca2e38d
0	352	352	Belgian Biodiversity Platform	fb11cfe1-ebc3-45af-9159-17d9fddbcdac	fad87fd2-db71-4c87-98c8-abad6ea8f5f7
4	4	0	Plazi	ffb07bec-2d10-492d-9c37-361fe0b79427	fc57b226-5665-435b-9e37-5ce9b6d13df5
441	441	0	GBIF Germany	4f6826f2-4ff6-443d-b966-e6913bd24013	fca1c6a5-601c-4f97-ab05-7595d094585c
4	4	0	Plazi	ffb07bec-2d10-492d-9c37-361fe0b79427	ff7707f0-058f-4f40-8eb8-2b6c9c75a173
0	1	1	Plazi	ffb07bec-2d10-492d-9c37-361fe0b79427	008c75c8-4381-447d-ba0d-24e09edecf74
0	221	221	Participant Node Managers Committee	7f48e0c8-5c96-49ec-b972-30748e339115	02c9ce3a-b048-4fe2-bbe0-645fd9b12191
3395	3395	0	GBIF Spain	1f94b3ca-9345-4d65-afe2-4bace93aa0fe	035c61a1-b2a0-4c10-bf96-577997b3b21a
0	10012	10012	Netherlands Biodiversity Information Facility	0909d601-bda2-42df-9e63-a6d51847ebce	0360c673-20fc-420a-845a-05d20f185dcf
13	13	0	Plazi	ffb07bec-2d10-492d-9c37-361fe0b79427	03d67507-fe7a-44e3-bf0f-3b842d7d2e72
4	4	0	Plazi	ffb07bec-2d10-492d-9c37-361fe0b79427	064f8e93-138b-4f9e-acc2-4d52a6129834
7782	7782	0	Participant Node Managers Committee	7f48e0c8-5c96-49ec-b972-30748e339115	0777230d-c252-4f99-9c16-cc63c09dfd52
885	885	0	GBIF France	da44cd31-5901-4687-a106-6d1c7734ee3a	0ac4f1b5-472c-40d9-9e10-753ea0dd7c1a
9535	9864	329	GBIF Brazil	cdc9736d-5ff7-4ece-9959-3c744360cdb3	0c00cc8f-fd48-4771-acae-216bfc42dfc2
0	15	15	Plazi	ffb07bec-2d10-492d-9c37-361fe0b79427	0e9faf44-2578-4ca5-ae69-7e5166852a63
13869	13869	0	GBIF France	da44cd31-5901-4687-a106-6d1c7734ee3a	0eb4ad83-f80d-4d86-83d8-f3a55ddd216f
1	1	0	Plazi	ffb07bec-2d10-492d-9c37-361fe0b79427	0f9ef5f7-ffca-4a86-bfd7-3e88af0a577b
1208	1208	0	GBIF Portugal	673f7038-4262-4149-b753-5658a4e912f6	14114ed0-213a-481e-881e-2584e7272cea
2478	2479	1	GBIF Brazil	cdc9736d-5ff7-4ece-9959-3c744360cdb3	166db736-ab3e-4e33-b766-96bbbb7f6b4a
645	645	0	National Biodiversity Network	d897a5b9-35ee-4232-94bd-b0bcaac003c2	16d6d281-88c2-43b4-bb09-e2eb05c0c074
2	2	0	Plazi	ffb07bec-2d10-492d-9c37-361fe0b79427	181ce711-f48a-4664-969d-854333283a76
11	11	0	Plazi	ffb07bec-2d10-492d-9c37-361fe0b79427	195c5a0b-ee6c-4865-ae6e-52403a5b0bc5
32	32	0	GBIF Germany	4f6826f2-4ff6-443d-b966-e6913bd24013	1bf6eaed-c900-4ee5-8473-71f7d940decc
5	5	0	Plazi	ffb07bec-2d10-492d-9c37-361fe0b79427	1f8b6014-8a6a-4376-8376-2b43cf5c9825
5	5	0	Plazi	ffb07bec-2d10-492d-9c37-361fe0b79427	1fd372c4-261f-4901-be0f-d93b44edf2c8
2	2	0	GBIF France	da44cd31-5901-4687-a106-6d1c7734ee3a	25538734-2875-4fcb-83b0-f243497942a5
2	2	0	Plazi	ffb07bec-2d10-492d-9c37-361fe0b79427	25e8a8fb-36bd-40ac-8355-9a3d913c1091
2998	2998	0	Biodiversity Information System of Mexico	b324e8e9-9a4c-44fa-8f1a-7f39ea7ab576	264da7bf-9e07-4480-aab7-a76cd38c6e9c
0	11	11	Plazi	ffb07bec-2d10-492d-9c37-361fe0b79427	268a909c-d4e4-420a-9f04-164740888acb
12	12	0	Plazi	ffb07bec-2d10-492d-9c37-361fe0b79427	28046c1b-405b-4b6e-b291-e88a770321e5
60	60	0	Plazi	ffb07bec-2d10-492d-9c37-361fe0b79427	29fba4ab-bb3e-4766-804f-5de6591ef0bf
21	21	0	Plazi	ffb07bec-2d10-492d-9c37-361fe0b79427	2a2f38ca-c6d9-4512-b977-e157be51e4ca
4804	4803	-1	National Biodiversity Network	d897a5b9-35ee-4232-94bd-b0bcaac003c2	2ae1fe04-6f12-4766-bdee-50e5b2dc1148
66116	66116	0	Biodiversity Information System of Mexico	b324e8e9-9a4c-44fa-8f1a-7f39ea7ab576	2beeb895-b24c-4136-9037-b05ba4d09fd3
218884	218884	0	Canadensys	4db9cfd2-1191-4b9d-b579-0b68ceabd968	2d18c666-ee2b-40a3-a708-280ea19c0fbc
59311	59318	7	National Biodiversity Network	d897a5b9-35ee-4232-94bd-b0bcaac003c2	33325913-c769-48ca-b7fc-1d22dfa9beee
38827	38827	0	GBIF Argentina	2426a871-9feb-40a1-96c6-0c593a76b835	34e892b0-d9c7-11de-b793-b8a03c50a862
0	1	1	Plazi	ffb07bec-2d10-492d-9c37-361fe0b79427	3521506a-c83c-4845-b95c-13198d0f7569
92	92	0	GBIF Benin	efb9c00e-f802-45dd-8826-a52ec45b89ff	35e78c77-2da1-482d-80e5-3091eeb164e5
1	1	0	Plazi	ffb07bec-2d10-492d-9c37-361fe0b79427	3607ad60-33c1-4aee-81b4-1034b289182a
0	1	1	Plazi	ffb07bec-2d10-492d-9c37-361fe0b79427	391e2afd-d4d9-4249-8174-176141bf2bb1
500000	500000	0	Chinese Academy of Sciences	e760dc6f-dd68-474d-ab41-bd3588571793	3942a8dc-9f01-420d-a829-01675dc01c73
763	763	0	Colombian Biodiversity Information System	7e865cba-7c46-417b-ade5-97f2cf5b7be0	3945e97d-a88a-4e91-ab4e-931b53f91792
3444	1230	-2214	GBIF Germany	4f6826f2-4ff6-443d-b966-e6913bd24013	3991b871-e528-4ff5-a895-5a2cd25672b9
115652	115652	0	National Biodiversity Network	d897a5b9-35ee-4232-94bd-b0bcaac003c2	3c2fb76f-ed3f-40dc-bb40-21adbbd857d5
1083	1083	0	National Biodiversity Network	d897a5b9-35ee-4232-94bd-b0bcaac003c2	3c60e7ff-94e4-4e19-b397-51590d2c57bd
0	6	6	Plazi	ffb07bec-2d10-492d-9c37-361fe0b79427	3cc28d72-0573-40d2-8b8c-c279013a6733
0	9	9	Plazi	ffb07bec-2d10-492d-9c37-361fe0b79427	40f8ab29-3a24-4af3-b408-c3bb148cac6c
11	11	0	Plazi	ffb07bec-2d10-492d-9c37-361fe0b79427	4112942b-2fea-4116-a681-d9bc71938c18
0	525	525	Participant Node Managers Committee	7f48e0c8-5c96-49ec-b972-30748e339115	4166b42d-a037-4b2a-9efd-f3d6ae70a28a
225	225	0	Participant Node Managers Committee	7f48e0c8-5c96-49ec-b972-30748e339115	4611dedc-2b3e-428e-b799-d244f4e4146f
9351	9351	0	National Biodiversity Network	d897a5b9-35ee-4232-94bd-b0bcaac003c2	461b4ba8-fd48-4ae1-ab85-107960b7a008
172	172	0	GBIF France	da44cd31-5901-4687-a106-6d1c7734ee3a	4778b7d1-6d6a-445e-b0fc-9cdb0e82c941
0	5	5	Plazi	ffb07bec-2d10-492d-9c37-361fe0b79427	48cef009-33e4-4cf4-98c3-35f17ad3533f
122	122	0	GBIF France	da44cd31-5901-4687-a106-6d1c7734ee3a	4990f654-6ac5-4011-bf0a-cb992e088106
21	22	1	Plazi	ffb07bec-2d10-492d-9c37-361fe0b79427	4b8bbb36-efbd-4337-8f66-124b5340ea74
76	76	0	Plazi	ffb07bec-2d10-492d-9c37-361fe0b79427	4ec5c830-c54a-4a09-9790-d2123972fc14
164	164	0	National Biodiversity Network	d897a5b9-35ee-4232-94bd-b0bcaac003c2	4fa0d1fc-ad2f-4c0d-b716-278693f91afc
816	816	0	Colombian Biodiversity Information System	7e865cba-7c46-417b-ade5-97f2cf5b7be0	51d648b8-5d7a-4233-b491-d00a8d54b215
22	22	0	Plazi	ffb07bec-2d10-492d-9c37-361fe0b79427	5548ab92-335c-433e-9d2c-8af0ec8f8209
385	595	210	GBIF Uganda	71b40829-6a12-4c3d-8fee-5746f5e9cf8c	5764708e-2a95-4d95-9447-2ed8a3bc46bd
153	153	0	GBIF France	da44cd31-5901-4687-a106-6d1c7734ee3a	5bf4d0cc-28ea-42d2-9588-22c923dd1cec
10	10	0	Plazi	ffb07bec-2d10-492d-9c37-361fe0b79427	5fac9c21-a601-4155-873a-0ddd55f3a0b0
2	2	0	Plazi	ffb07bec-2d10-492d-9c37-361fe0b79427	61d9e5eb-2bab-4110-b83f-e88e239ffd97
4	4	0	Plazi	ffb07bec-2d10-492d-9c37-361fe0b79427	631d3896-6dff-4a16-8d5b-c96e11a50d9b
41	41	0	GBIF Germany	4f6826f2-4ff6-443d-b966-e6913bd24013	63210692-f762-11e1-a439-00145eb45e9a
45	45	0	GBIF France	da44cd31-5901-4687-a106-6d1c7734ee3a	635d5f88-35f5-4ab8-8473-0f2ebcc047f2
2968	2968	0	VertNet	d205def7-82c3-472a-be4b-31d11dcd51fd	658ab0a2-69f3-4094-a2fe-3834bee063c8
646	407	-239	GBIF Germany	4f6826f2-4ff6-443d-b966-e6913bd24013	66155056-f762-11e1-a439-00145eb45e9a
203	203	0	GBIF Germany	4f6826f2-4ff6-443d-b966-e6913bd24013	66402128-f762-11e1-a439-00145eb45e9a
3795	3795	0	Colombian Biodiversity Information System	7e865cba-7c46-417b-ade5-97f2cf5b7be0	675a1bfd-9bcc-46ea-a417-1f68f23a10f6
342	342	0	GBIF Sweden	a0b3be64-6525-4387-ac67-a499950f92e1	68017a1e-690a-4a79-ab5c-fb11f93b5234
1	1	0	GBIF Germany	4f6826f2-4ff6-443d-b966-e6913bd24013	68cacb0a-f762-11e1-a439-00145eb45e9a
3	4	1	Plazi	ffb07bec-2d10-492d-9c37-361fe0b79427	68dd0ab1-ecc3-4ac5-a00d-84d38ed0e5d4
162	103	-59	GBIF Germany	4f6826f2-4ff6-443d-b966-e6913bd24013	69493bf2-f762-11e1-a439-00145eb45e9a
64	64	0	GBIF Germany	4f6826f2-4ff6-443d-b966-e6913bd24013	699f5320-f762-11e1-a439-00145eb45e9a
133	133	0	GBIF Germany	4f6826f2-4ff6-443d-b966-e6913bd24013	6a7869bc-f762-11e1-a439-00145eb45e9a
8	8	0	GBIF Germany	4f6826f2-4ff6-443d-b966-e6913bd24013	6ae99970-f762-11e1-a439-00145eb45e9a
42	42	0	GBIF Germany	4f6826f2-4ff6-443d-b966-e6913bd24013	6b70a190-f762-11e1-a439-00145eb45e9a
12	12	0	GBIF Germany	4f6826f2-4ff6-443d-b966-e6913bd24013	6bb46d4e-f762-11e1-a439-00145eb45e9a
37	37	0	GBIF Germany	4f6826f2-4ff6-443d-b966-e6913bd24013	6c836acc-f762-11e1-a439-00145eb45e9a
459	459	0	GBIF Spain	1f94b3ca-9345-4d65-afe2-4bace93aa0fe	6d66d064-0f02-4441-95fc-a83840c7f8ff
3994	3994	0	GBIF Germany	4f6826f2-4ff6-443d-b966-e6913bd24013	713c2900-f762-11e1-a439-00145eb45e9a
163	163	0	GBIF Germany	4f6826f2-4ff6-443d-b966-e6913bd24013	72363030-f762-11e1-a439-00145eb45e9a
30	30	0	GBIF Germany	4f6826f2-4ff6-443d-b966-e6913bd24013	72b6d64a-f762-11e1-a439-00145eb45e9a
39	39	0	GBIF Germany	4f6826f2-4ff6-443d-b966-e6913bd24013	72d73688-f762-11e1-a439-00145eb45e9a
22	22	0	GBIF Germany	4f6826f2-4ff6-443d-b966-e6913bd24013	73444d36-f762-11e1-a439-00145eb45e9a
21	21	0	GBIF Germany	4f6826f2-4ff6-443d-b966-e6913bd24013	739c5a62-f762-11e1-a439-00145eb45e9a
36	36	0	GBIF Germany	4f6826f2-4ff6-443d-b966-e6913bd24013	73f61214-f762-11e1-a439-00145eb45e9a
12	12	0	GBIF Germany	4f6826f2-4ff6-443d-b966-e6913bd24013	7405d974-f762-11e1-a439-00145eb45e9a
8	8	0	Plazi	ffb07bec-2d10-492d-9c37-361fe0b79427	74322c33-5f04-4474-a9ff-0dbc181e7bfc
97	97	0	GBIF Germany	4f6826f2-4ff6-443d-b966-e6913bd24013	74e75048-f762-11e1-a439-00145eb45e9a
35	35	0	GBIF Germany	4f6826f2-4ff6-443d-b966-e6913bd24013	755afebc-f762-11e1-a439-00145eb45e9a
20	20	0	Plazi	ffb07bec-2d10-492d-9c37-361fe0b79427	786fe950-08b0-4072-bf66-7f64702748df
85	34	-51	GBIF Germany	4f6826f2-4ff6-443d-b966-e6913bd24013	79abc816-f762-11e1-a439-00145eb45e9a
741	741	0	Ocean Biodiversity Information System	ba0670b9-4186-41e6-8e70-f9cb3065551a	7b4f3cc0-f762-11e1-a439-00145eb45e9a
177	177	0	Ocean Biodiversity Information System	ba0670b9-4186-41e6-8e70-f9cb3065551a	7b5d6a48-f762-11e1-a439-00145eb45e9a
7829	7829	0	GBIF Spain	1f94b3ca-9345-4d65-afe2-4bace93aa0fe	7bac0ff4-f762-11e1-a439-00145eb45e9a
17920	17920	0	Secretariat of the Pacific Regional Environment Programme	29c6a139-ea7f-41f5-8d9b-c55af8736182	7c518f3a-4a12-48e5-8b81-589c94cca973
42	42	0	GBIF France	da44cd31-5901-4687-a106-6d1c7734ee3a	7cb9afea-e2a3-46ff-9c40-404ed8004f85
167	167	0	GBIF Germany	4f6826f2-4ff6-443d-b966-e6913bd24013	7d5a6bac-f762-11e1-a439-00145eb45e9a
608	608	0	GBIF Germany	4f6826f2-4ff6-443d-b966-e6913bd24013	7dd4f764-f762-11e1-a439-00145eb45e9a
102	102	0	GBIF Germany	4f6826f2-4ff6-443d-b966-e6913bd24013	7e3a7846-f762-11e1-a439-00145eb45e9a
0	55	55	National Biodiversity Network	d897a5b9-35ee-4232-94bd-b0bcaac003c2	803a0543-ee93-4b83-94d7-1281bb8eab5d
181	181	0	Biodiversity Information System of Mexico	b324e8e9-9a4c-44fa-8f1a-7f39ea7ab576	8072bd76-f762-11e1-a439-00145eb45e9a
495	495	0	Biodiversity Information System of Mexico	b324e8e9-9a4c-44fa-8f1a-7f39ea7ab576	80cb120a-f762-11e1-a439-00145eb45e9a
9	9	0	Plazi	ffb07bec-2d10-492d-9c37-361fe0b79427	80f6b0f9-010f-4ae4-a944-fa8de3aa9a30
6500	3900	-2600	GBIF Germany	4f6826f2-4ff6-443d-b966-e6913bd24013	8153ec7e-f762-11e1-a439-00145eb45e9a
19	19	0	Plazi	ffb07bec-2d10-492d-9c37-361fe0b79427	816ae2d5-1123-47be-9bd5-f5270a315f7a
6	6	0	Plazi	ffb07bec-2d10-492d-9c37-361fe0b79427	8347f9a9-487b-4375-82a4-79c0b4b6767d
36169	39029	2860	GBIF Spain	1f94b3ca-9345-4d65-afe2-4bace93aa0fe	835d30de-f762-11e1-a439-00145eb45e9a
191859	191859	0	Costa Rica Biodiversity Facility	3379bb09-1a58-41e7-9c57-e3b66c3eb5a0	848182d0-f762-11e1-a439-00145eb45e9a
60883	84883	24000	GBIF Japan	db5705aa-6a6e-42f1-8942-d77b9f4896ea	869b5244-f762-11e1-a439-00145eb45e9a
656	461	-195	GBIF Germany	4f6826f2-4ff6-443d-b966-e6913bd24013	87dc5c3e-f762-11e1-a439-00145eb45e9a
756	622	-134	GBIF Germany	4f6826f2-4ff6-443d-b966-e6913bd24013	88006f98-f762-11e1-a439-00145eb45e9a
248	207	-41	GBIF Germany	4f6826f2-4ff6-443d-b966-e6913bd24013	88580276-f762-11e1-a439-00145eb45e9a
17	17	0	GBIF Germany	4f6826f2-4ff6-443d-b966-e6913bd24013	886bdc7e-f762-11e1-a439-00145eb45e9a
160	160	0	Atlas of Living Australia	4a6f1b71-969e-4fc5-a693-282b05e1220c	88e120c4-f762-11e1-a439-00145eb45e9a
2	2	0	Plazi	ffb07bec-2d10-492d-9c37-361fe0b79427	896825be-23b0-42c1-9c31-64d4f027b0b4
2	2	0	Plazi	ffb07bec-2d10-492d-9c37-361fe0b79427	8a8f30db-6da3-4b9b-8911-865a140a2ff3
626	626	0	GBIF Germany	4f6826f2-4ff6-443d-b966-e6913bd24013	8aa83136-f762-11e1-a439-00145eb45e9a
1932	1932	0	GBIF Germany	4f6826f2-4ff6-443d-b966-e6913bd24013	8ae14962-f762-11e1-a439-00145eb45e9a
3	3	0	Plazi	ffb07bec-2d10-492d-9c37-361fe0b79427	8ba6e51d-e141-47f2-9929-73127f823066
11	11	0	Colombian Biodiversity Information System	7e865cba-7c46-417b-ade5-97f2cf5b7be0	8c624b50-f8e5-4ce0-b070-ac27d4d923ad
72	48	-24	GBIF Germany	4f6826f2-4ff6-443d-b966-e6913bd24013	8cd1f82a-f762-11e1-a439-00145eb45e9a
4	1	-3	GBIF Germany	4f6826f2-4ff6-443d-b966-e6913bd24013	8cde76c2-f762-11e1-a439-00145eb45e9a
0	1	1	Plazi	ffb07bec-2d10-492d-9c37-361fe0b79427	90a54948-29c5-470f-8067-8de0c240f480
0	139	139	Ocean Biodiversity Information System	ba0670b9-4186-41e6-8e70-f9cb3065551a	91188cc4-f3d0-4280-b3e3-398bdf419e66
38	38	0	Plazi	ffb07bec-2d10-492d-9c37-361fe0b79427	918d86bb-f11d-414e-9c1e-21ec17737792
625	625	0	Plazi	ffb07bec-2d10-492d-9c37-361fe0b79427	91ad2b95-a4d1-4b55-bcf8-0ebc2f5d2f64
1	1	0	Plazi	ffb07bec-2d10-492d-9c37-361fe0b79427	91cebe45-ac50-48a5-a425-b0beda2a2fb6
385	385	0	GBIF Germany	4f6826f2-4ff6-443d-b966-e6913bd24013	93b94c74-f762-11e1-a439-00145eb45e9a
1	1	0	GBIF Germany	4f6826f2-4ff6-443d-b966-e6913bd24013	93dada1a-f762-11e1-a439-00145eb45e9a
0	17	17	GBIF Uganda	71b40829-6a12-4c3d-8fee-5746f5e9cf8c	94ce65b1-bef0-40e0-8d0c-ebc38e1de624
19603	19603	0	GBIF Germany	4f6826f2-4ff6-443d-b966-e6913bd24013	97bd086a-cf43-11e2-a9b3-00145eb45e9a
133	133	0	GBIF Germany	4f6826f2-4ff6-443d-b966-e6913bd24013	97c1e510-f762-11e1-a439-00145eb45e9a
73257	73469	212	U.S. Geological Survey	8618c64a-93e0-4300-b546-7249e5148ed2	989d0279-05c2-4488-9c57-48fa1b6af3cf
8	8	0	National Biodiversity Network	d897a5b9-35ee-4232-94bd-b0bcaac003c2	98f35b4c-0a6d-4008-9e0c-b40061abfcd5
4	4	0	Plazi	ffb07bec-2d10-492d-9c37-361fe0b79427	992f4b79-fec7-44fa-9118-038849e3f6ec
8	8	0	Plazi	ffb07bec-2d10-492d-9c37-361fe0b79427	9a3a333c-0a76-42f0-a764-aacec714effd
1	1	0	Plazi	ffb07bec-2d10-492d-9c37-361fe0b79427	9fbed31e-edfd-44b0-8e53-948ba6d3658a
0	221	221	Ocean Biodiversity Information System	ba0670b9-4186-41e6-8e70-f9cb3065551a	a17d512d-da2b-4649-a2fa-f083627a84cc
3	3	0	Plazi	ffb07bec-2d10-492d-9c37-361fe0b79427	a221e7cc-6002-4874-990a-663ebca2b503
17	17	0	Plazi	ffb07bec-2d10-492d-9c37-361fe0b79427	a2931a35-5d09-421d-9aa1-d8111f35c57b
70	70	0	GBIF Germany	4f6826f2-4ff6-443d-b966-e6913bd24013	a4f78b61-0d55-4f52-a017-cc7a1c89e868
38	38	0	GBIF Germany	4f6826f2-4ff6-443d-b966-e6913bd24013	a581931d-1004-498e-ad97-58d6b12cddaa
2810	2810	0	GBIF Spain	1f94b3ca-9345-4d65-afe2-4bace93aa0fe	a6f9f411-ab90-4d94-82de-f5edf8c3fa2a
0	1191	1191	Atlas of Living Australia	4a6f1b71-969e-4fc5-a693-282b05e1220c	a79a2ab2-5de8-4ac6-a0de-3e994cd8f7f5
9478	9478	0	GBIF France	da44cd31-5901-4687-a106-6d1c7734ee3a	aa35e7a6-9b69-4d22-ab22-4b84d3949d75
1506	1506	0	Netherlands Biodiversity Information Facility	0909d601-bda2-42df-9e63-a6d51847ebce	aa53b19b-ee49-4ff6-963d-2d9499808b72
62	62	0	Plazi	ffb07bec-2d10-492d-9c37-361fe0b79427	aaba7ff9-05cc-4f7d-aea1-9b3d4dafa6b3
249	249	0	GBIF Spain	1f94b3ca-9345-4d65-afe2-4bace93aa0fe	ad070c2c-587e-4ebb-a11e-489c0db0dd19
164	164	0	National Biodiversity Network	d897a5b9-35ee-4232-94bd-b0bcaac003c2	b1c70f97-f130-4eee-a408-a7b0b99e797f
0	3	3	Plazi	ffb07bec-2d10-492d-9c37-361fe0b79427	b3cfdb01-7636-443f-92da-81a65b6a949d
24955	24955	0	Taiwan Biodiversity Information Facility	e1b85abc-61f9-430f-ba79-6813dec53a0f	b7dd8170-98a0-11de-b4d9-b8a03c50a862
148	148	0	GBIF Germany	4f6826f2-4ff6-443d-b966-e6913bd24013	ba20df08-d873-4738-931d-a595126eb822
360	360	0	GBIF Germany	4f6826f2-4ff6-443d-b966-e6913bd24013	bec990f5-e8d4-422b-b049-3883a5b24896
45	45	0	GBIF France	da44cd31-5901-4687-a106-6d1c7734ee3a	c008a4cc-ecc1-4903-85a6-86257c438434
1319	1319	0	GBIF France	da44cd31-5901-4687-a106-6d1c7734ee3a	c3681e83-eba9-494c-a61f-45fc3e0b7a4a
0	7	7	Plazi	ffb07bec-2d10-492d-9c37-361fe0b79427	c5b3471f-b1e0-4174-8a8f-dbdbc5322195
0	4	4	Plazi	ffb07bec-2d10-492d-9c37-361fe0b79427	c89e4c28-2c4e-41c9-b5b8-fc013e5d1e5a
34	34	0	Participant Node Managers Committee	7f48e0c8-5c96-49ec-b972-30748e339115	c8e6673d-a18c-4479-be1a-c795e759abfe
1897	1897	0	Canadensys	4db9cfd2-1191-4b9d-b579-0b68ceabd968	cc75dca7-0de4-435b-8e3a-c1b2f1db8eed
6773	6773	0	Biodiversity Information System of Mexico	b324e8e9-9a4c-44fa-8f1a-7f39ea7ab576	ce3fdfbf-4571-4e98-af3c-b9cafb08b589
14	14	0	Plazi	ffb07bec-2d10-492d-9c37-361fe0b79427	d0fbb3de-5cfd-4253-b7d4-9bf5496991bf
0	7	7	Plazi	ffb07bec-2d10-492d-9c37-361fe0b79427	d69b687d-e2db-4144-90e0-ad7fab4b35dd
0	12	12	Plazi	ffb07bec-2d10-492d-9c37-361fe0b79427	e040b4d9-f94d-4880-a069-33ab19e3a21e
0	8	8	Plazi	ffb07bec-2d10-492d-9c37-361fe0b79427	e5f0fd86-cd64-4bc7-a687-728b198598cb
84	84	0	GBIF Germany	4f6826f2-4ff6-443d-b966-e6913bd24013	e9e2eac6-8789-4cf5-8d05-90c9ea325e57
3	3	0	Plazi	ffb07bec-2d10-492d-9c37-361fe0b79427	ea7cbde6-2399-4d12-9793-d6321bbea6a9
8479	8479	0	GBIF France	da44cd31-5901-4687-a106-6d1c7734ee3a	ec2fbf1a-7320-43b3-8f14-9863f6874b33
200	200	0	GBIF Norway	4f829580-180d-46a9-9c87-ed8ec959b545	ec961283-84ec-46e4-80ba-2cedb9ee51d3
0	10	10	Ocean Biodiversity Information System	ba0670b9-4186-41e6-8e70-f9cb3065551a	ec9cbf0e-0e30-43ab-a3f9-ce5ec29df3ef
22	22	0	Plazi	ffb07bec-2d10-492d-9c37-361fe0b79427	f0ddd1f9-77b4-4f07-9416-fe212026d741
0	6	6	Plazi	ffb07bec-2d10-492d-9c37-361fe0b79427	f37caa88-763d-4dbb-8ed3-5d5daccd6104
1015	1015	0	Colombian Biodiversity Information System	7e865cba-7c46-417b-ade5-97f2cf5b7be0	f3e7c1f2-ada4-4169-9d0d-3d798392dfee
3	3	0	Plazi	ffb07bec-2d10-492d-9c37-361fe0b79427	f475bef2-1873-4aaa-947a-a21397d0a9ed
15198	15198	0	GBIF Germany	4f6826f2-4ff6-443d-b966-e6913bd24013	f4a44701-7d70-4f6d-8479-4f27680dcf2f
2	2	0	Plazi	ffb07bec-2d10-492d-9c37-361fe0b79427	f5404ab1-c45e-4fff-afc2-d385386e6750
4222	4222	0	Atlas of Living Australia	4a6f1b71-969e-4fc5-a693-282b05e1220c	f7d6a733-fa5e-43ba-b06e-e70778953ead
1688	1688	0	U.S. Geological Survey	8618c64a-93e0-4300-b546-7249e5148ed2	fbaa63e3-945b-43d9-920b-812215a5bb1f
0	424	424	Plazi	ffb07bec-2d10-492d-9c37-361fe0b79427	fde5f083-514d-400b-b886-e792390afd86
44	44	0	Plazi	ffb07bec-2d10-492d-9c37-361fe0b79427	ffdfb2b7-ecf7-4eef-a826-cbaeed24bb17
804	804	0	National Biodiversity Network	d897a5b9-35ee-4232-94bd-b0bcaac003c2	ffe8e031-7fcc-4b1c-82f2-7a3a71d5203c
0	45	45	Plazi	ffb07bec-2d10-492d-9c37-361fe0b79427	02e15568-9697-42ad-af97-54abb128a40f
2	2	0	Plazi	ffb07bec-2d10-492d-9c37-361fe0b79427	033b1c4e-d4cb-41d2-b1b8-0a9d8195f1cc
7134889	7236892	102003	International Barcode of Life	b797ce0f-47e6-4231-b048-6b62ca3b0f55	040c5662-da76-4782-a48e-cdea1892d14c
989	989	0	GBIF France	da44cd31-5901-4687-a106-6d1c7734ee3a	053cc46d-7d65-42e9-9577-4c39c90693d8
38	38	0	GBIF France	da44cd31-5901-4687-a106-6d1c7734ee3a	055956fe-ea8a-4f05-a167-d8c5d18dba8f
11	11	0	Plazi	ffb07bec-2d10-492d-9c37-361fe0b79427	076ab8e1-1a46-4c48-86ae-4c1de532a84a
2	2	0	Plazi	ffb07bec-2d10-492d-9c37-361fe0b79427	07bbefab-9867-4811-ad08-8f186dce79a3
2	2	0	Plazi	ffb07bec-2d10-492d-9c37-361fe0b79427	07cff1f9-d1c5-4c42-b0db-670d2e3fa27e
1	1	0	Plazi	ffb07bec-2d10-492d-9c37-361fe0b79427	08590295-0924-4b58-a28d-8c921cea6ff7
1	1	0	Plazi	ffb07bec-2d10-492d-9c37-361fe0b79427	08db8a19-1279-4ace-8e85-e88ede20e29b
0	4	4	Plazi	ffb07bec-2d10-492d-9c37-361fe0b79427	09db07d1-e350-481e-baf0-35135ea80472
8	8	0	Plazi	ffb07bec-2d10-492d-9c37-361fe0b79427	0a051914-adb3-43d4-bb48-01c60a344d0e
213	213	0	GBIF France	da44cd31-5901-4687-a106-6d1c7734ee3a	0a1bd4da-25af-45f4-8517-4450e3926ef5
16	16	0	Plazi	ffb07bec-2d10-492d-9c37-361fe0b79427	0bb5ded5-7681-4717-9a9a-4bb7550f6621
18210	18210	0	U.S. Geological Survey	8618c64a-93e0-4300-b546-7249e5148ed2	0d4af118-b79e-40c7-9cc6-142c5027cb16
1183	1183	0	National Biodiversity Network	d897a5b9-35ee-4232-94bd-b0bcaac003c2	111a8e87-929e-4212-a1d7-8825e0f49e61
0	39238	39238	GBIF Finland	dd514216-5c7c-45f3-910d-797424cb5be6	11512fe2-50cf-48e1-b681-3bb1f347eb86
771454	787159	15705	U.S. Geological Survey	8618c64a-93e0-4300-b546-7249e5148ed2	13b70480-bd69-11dd-b15f-b8a03c50a862
812	812	0	GBIF Benin	efb9c00e-f802-45dd-8826-a52ec45b89ff	14df967d-1720-4be2-88be-5e9bbda53991
31150	31150	0	National Biodiversity Network	d897a5b9-35ee-4232-94bd-b0bcaac003c2	1578a76d-a0dc-4d31-8fcb-d1eb487b353f
0	1	1	Plazi	ffb07bec-2d10-492d-9c37-361fe0b79427	15853026-173a-4816-bcb4-6f779d13efcc
4940566	4967454	26888	Netherlands Biodiversity Information Facility	0909d601-bda2-42df-9e63-a6d51847ebce	15f819bd-6612-4447-854b-14d12ee1022d
5	5	0	Plazi	ffb07bec-2d10-492d-9c37-361fe0b79427	16df7f67-dc81-4959-b4c4-460f2bd321fa
0	42	42	U.S. Geological Survey	8618c64a-93e0-4300-b546-7249e5148ed2	2102aa85-de63-410d-a4f9-499b7f27d1c9
409	409	0	GBIF Spain	1f94b3ca-9345-4d65-afe2-4bace93aa0fe	21934821-38c4-496f-a17b-e8dafd29eabf
11	11	0	Plazi	ffb07bec-2d10-492d-9c37-361fe0b79427	242e45aa-05df-4fb0-92af-0e03bab82088
295277	295277	0	U.S. Geological Survey	8618c64a-93e0-4300-b546-7249e5148ed2	2501caa2-803b-4f6b-9e36-f9f5c72c0666
0	11	11	Plazi	ffb07bec-2d10-492d-9c37-361fe0b79427	2510e8e5-faf1-49cb-b653-984b52f808ad
12	12	0	Plazi	ffb07bec-2d10-492d-9c37-361fe0b79427	273104b1-3539-43af-82b5-3a77e86712aa
571	284	-287	GBIF Germany	4f6826f2-4ff6-443d-b966-e6913bd24013	29dfd992-2307-4f2b-a398-6f6e7ea225cf
4	4	0	Plazi	ffb07bec-2d10-492d-9c37-361fe0b79427	2c902394-1936-4afa-a073-ffc258f6860f
98423	98423	0	GBIF Japan	db5705aa-6a6e-42f1-8942-d77b9f4896ea	308f7f4b-279c-457f-b6e3-ecfccd1b598d
5	5	0	Plazi	ffb07bec-2d10-492d-9c37-361fe0b79427	33d9a98d-85a1-4dc8-9dfa-07b90f577f8d
0	1	1	Plazi	ffb07bec-2d10-492d-9c37-361fe0b79427	344f8a86-21a1-428e-ae4f-01ea6082254a
3	3	0	Plazi	ffb07bec-2d10-492d-9c37-361fe0b79427	352a8612-76b6-48f4-b3f9-50107c119980
620	620	0	Biodiversity Information System of Mexico	b324e8e9-9a4c-44fa-8f1a-7f39ea7ab576	38073295-5a6a-4ec9-b1a9-90966c3e6099
0	3	3	Plazi	ffb07bec-2d10-492d-9c37-361fe0b79427	4019c163-3618-461c-96d4-aeb03854b542
0	1	1	Plazi	ffb07bec-2d10-492d-9c37-361fe0b79427	41df6976-b3d3-4f2f-8644-f05640e8ff69
9	9	0	Plazi	ffb07bec-2d10-492d-9c37-361fe0b79427	41ea425f-527b-4b41-8b7e-5feaa9bbc997
214	214	0	GBIF France	da44cd31-5901-4687-a106-6d1c7734ee3a	4308c555-a246-4030-8c1b-ff8ef7c1b032
12	12	0	Plazi	ffb07bec-2d10-492d-9c37-361fe0b79427	44143d6b-fc66-467c-98bb-bc2207e629eb
64764	66369	1605	GBIF Estonia	2c11b821-d22b-4c64-8cd3-c1578173b129	46239994-a621-4d41-9556-e53e0e9bed63
0	2	2	Plazi	ffb07bec-2d10-492d-9c37-361fe0b79427	46442868-35d2-4107-84ae-d4cb25121544
91	91	0	GBIF France	da44cd31-5901-4687-a106-6d1c7734ee3a	47346b5b-2d32-4e0e-afab-ec9a6544021f
0	800	800	Colombian Biodiversity Information System	7e865cba-7c46-417b-ade5-97f2cf5b7be0	4fa187d0-563f-42ec-b496-99e5ad747750
0	2028	2028	Participant Node Managers Committee	7f48e0c8-5c96-49ec-b972-30748e339115	4fdd70bd-8ef4-4727-b6db-6441a414b7d8
5	5	0	Plazi	ffb07bec-2d10-492d-9c37-361fe0b79427	50cee940-aa9d-410f-9217-425658d1d587
508	508	0	Plazi	ffb07bec-2d10-492d-9c37-361fe0b79427	555c12a5-9aed-4738-8ac9-22e469bf7687
2769	2769	0	GBIF France	da44cd31-5901-4687-a106-6d1c7734ee3a	5a8aa2ad-261c-4f61-a98e-26dd752fe1c5
0	4	4	Plazi	ffb07bec-2d10-492d-9c37-361fe0b79427	5aec84f2-b3a3-4f16-bb46-efec4dddcb9e
0	12	12	Ocean Biodiversity Information System	ba0670b9-4186-41e6-8e70-f9cb3065551a	5d33063b-bc3e-4886-b744-29b0ec4c332f
0	14	14	Plazi	ffb07bec-2d10-492d-9c37-361fe0b79427	5ef75467-22ad-499c-8ab7-a9de913a4fca
0	12	12	Plazi	ffb07bec-2d10-492d-9c37-361fe0b79427	60740210-999d-4526-88e3-464fd93143ac
155	155	0	GBIF Germany	4f6826f2-4ff6-443d-b966-e6913bd24013	624e4180-f762-11e1-a439-00145eb45e9a
5	5	0	GBIF Germany	4f6826f2-4ff6-443d-b966-e6913bd24013	6259f368-f762-11e1-a439-00145eb45e9a
78	78	0	GBIF Germany	4f6826f2-4ff6-443d-b966-e6913bd24013	6294bcc8-f762-11e1-a439-00145eb45e9a
66	66	0	GBIF Germany	4f6826f2-4ff6-443d-b966-e6913bd24013	629870fc-f762-11e1-a439-00145eb45e9a
7	7	0	GBIF Germany	4f6826f2-4ff6-443d-b966-e6913bd24013	62f5b442-f762-11e1-a439-00145eb45e9a
0	184	184	Ocean Biodiversity Information System	ba0670b9-4186-41e6-8e70-f9cb3065551a	62ffc88f-b7fa-48e3-a43a-9f8587bc07cd
58	58	0	GBIF Germany	4f6826f2-4ff6-443d-b966-e6913bd24013	6489c014-f762-11e1-a439-00145eb45e9a
145	145	0	GBIF Germany	4f6826f2-4ff6-443d-b966-e6913bd24013	64b0c038-f762-11e1-a439-00145eb45e9a
111	111	0	GBIF Germany	4f6826f2-4ff6-443d-b966-e6913bd24013	64c44522-f762-11e1-a439-00145eb45e9a
605	605	0	GBIF Germany	4f6826f2-4ff6-443d-b966-e6913bd24013	64f451c2-f762-11e1-a439-00145eb45e9a
1040	1040	0	Colombian Biodiversity Information System	7e865cba-7c46-417b-ade5-97f2cf5b7be0	664833b0-056c-4b16-bfa0-16e69dc3e67a
0	23	23	Plazi	ffb07bec-2d10-492d-9c37-361fe0b79427	66eb2002-0cf8-4755-8af4-304c8094d74d
145	145	0	GBIF Germany	4f6826f2-4ff6-443d-b966-e6913bd24013	67326aa0-f762-11e1-a439-00145eb45e9a
3	3	0	Plazi	ffb07bec-2d10-492d-9c37-361fe0b79427	673dcee7-a4d7-45d4-9bbf-59ffb4fe4bdc
13	13	0	GBIF Germany	4f6826f2-4ff6-443d-b966-e6913bd24013	6938e14e-f762-11e1-a439-00145eb45e9a
0	32	32	Plazi	ffb07bec-2d10-492d-9c37-361fe0b79427	69bb0193-897c-4573-81f7-46baa18a3c17
79	79	0	GBIF Germany	4f6826f2-4ff6-443d-b966-e6913bd24013	69c37016-f762-11e1-a439-00145eb45e9a
11	11	0	Plazi	ffb07bec-2d10-492d-9c37-361fe0b79427	6ac74335-126d-4ea7-99d7-ee69acfd792e
16	16	0	GBIF Germany	4f6826f2-4ff6-443d-b966-e6913bd24013	6af826fc-f762-11e1-a439-00145eb45e9a
18	18	0	GBIF Germany	4f6826f2-4ff6-443d-b966-e6913bd24013	6b88c95a-f762-11e1-a439-00145eb45e9a
0	180	180	Colombian Biodiversity Information System	7e865cba-7c46-417b-ade5-97f2cf5b7be0	6bf6536f-fabc-47fe-9d7e-b84d131459f3
0	5	5	Ocean Biodiversity Information System	ba0670b9-4186-41e6-8e70-f9cb3065551a	6c80a0f0-b62a-491a-8cea-f77bbd07401c
0	1147	1147	Ocean Biodiversity Information System	ba0670b9-4186-41e6-8e70-f9cb3065551a	6ca6f1e1-1ea3-47e1-8b81-1ca92474a6e0
30	30	0	GBIF Germany	4f6826f2-4ff6-443d-b966-e6913bd24013	6ce082b6-f762-11e1-a439-00145eb45e9a
828	828	0	GBIF Germany	4f6826f2-4ff6-443d-b966-e6913bd24013	6e8f8bb6-f762-11e1-a439-00145eb45e9a
0	3	3	Plazi	ffb07bec-2d10-492d-9c37-361fe0b79427	6e9066ab-782c-443a-8984-f1fe9f1e7546
6186	6186	0	GBIF France	da44cd31-5901-4687-a106-6d1c7734ee3a	6f7c417f-74df-4b7d-bce5-35a9ee9bc2a6
7439	7439	0	Participant Node Managers Committee	7f48e0c8-5c96-49ec-b972-30748e339115	6fddae5d-1ecf-4818-8a80-c56cf2494b4f
16664	16664	0	National Biodiversity Network	d897a5b9-35ee-4232-94bd-b0bcaac003c2	707bb56b-1d0f-4d7d-bcdb-e1f324129f43
751	751	0	Colombian Biodiversity Information System	7e865cba-7c46-417b-ade5-97f2cf5b7be0	707d4dee-b189-43f6-a681-56a3e9a9b61d
2	2	0	Plazi	ffb07bec-2d10-492d-9c37-361fe0b79427	70870cc8-4ef5-4816-981f-b0dce3b2c118
0	32	32	Plazi	ffb07bec-2d10-492d-9c37-361fe0b79427	722c160e-2d11-4a58-83fc-d346d227f9e9
1	1	0	Plazi	ffb07bec-2d10-492d-9c37-361fe0b79427	7259cd46-a1db-4d03-bdd6-5993474ded22
37	37	0	Plazi	ffb07bec-2d10-492d-9c37-361fe0b79427	73db70ae-7c5e-4172-8a21-0643f4b41b1a
79	79	0	GBIF Germany	4f6826f2-4ff6-443d-b966-e6913bd24013	74abfdd6-f762-11e1-a439-00145eb45e9a
19517	19517	0	Colombian Biodiversity Information System	7e865cba-7c46-417b-ade5-97f2cf5b7be0	75148e05-8c02-4d6d-ad90-30ca01f9b37d
0	3	3	Plazi	ffb07bec-2d10-492d-9c37-361fe0b79427	7559b3d0-ef01-4ac1-9113-dae133457106
93	93	0	GBIF Germany	4f6826f2-4ff6-443d-b966-e6913bd24013	760039ea-f762-11e1-a439-00145eb45e9a
0	6	6	Plazi	ffb07bec-2d10-492d-9c37-361fe0b79427	777b3eba-ef2c-4947-9763-77d66526fd6d
159	159	0	Participant Node Managers Committee	7f48e0c8-5c96-49ec-b972-30748e339115	77b6b8df-34ad-443c-ba73-91603aa06124
144	144	0	GBIF Germany	4f6826f2-4ff6-443d-b966-e6913bd24013	784f9b03-ab2e-4a92-a0c4-4d02cc2231d3
1271	1271	0	GBIF Japan	db5705aa-6a6e-42f1-8942-d77b9f4896ea	7adf9745-c840-484d-b4b6-fdf097d96f77
660	660	0	GBIF Germany	4f6826f2-4ff6-443d-b966-e6913bd24013	7b8145ee-f762-11e1-a439-00145eb45e9a
1785	1785	0	GBIF France	da44cd31-5901-4687-a106-6d1c7734ee3a	7bb5c5c7-1b33-4949-8ede-75c6f9c8c268
212	212	0	GBIF Germany	4f6826f2-4ff6-443d-b966-e6913bd24013	7c6065a8-f762-11e1-a439-00145eb45e9a
0	12	12	National Biodiversity Network	d897a5b9-35ee-4232-94bd-b0bcaac003c2	7c9a9634-b7df-4309-b6b4-971a42c901c5
0	5	5	Plazi	ffb07bec-2d10-492d-9c37-361fe0b79427	7cbefabb-36c4-49d3-8c33-013fa8e9c07e
196	140	-56	GBIF Germany	4f6826f2-4ff6-443d-b966-e6913bd24013	7d6b49b8-f762-11e1-a439-00145eb45e9a
141	141	0	GBIF Germany	4f6826f2-4ff6-443d-b966-e6913bd24013	7ea40a86-f762-11e1-a439-00145eb45e9a
2	2	0	Plazi	ffb07bec-2d10-492d-9c37-361fe0b79427	7ef05595-7150-4b6e-a893-e8e78dab1ba0
72	72	0	GBIF Germany	4f6826f2-4ff6-443d-b966-e6913bd24013	7f4c5fe2-f762-11e1-a439-00145eb45e9a
140	140	0	GBIF Germany	4f6826f2-4ff6-443d-b966-e6913bd24013	829cf3b4-f762-11e1-a439-00145eb45e9a
25	25	0	Plazi	ffb07bec-2d10-492d-9c37-361fe0b79427	832a4b0d-511a-4903-b210-b122a4379c66
53	53	0	GBIF Spain	1f94b3ca-9345-4d65-afe2-4bace93aa0fe	83725ef0-f762-11e1-a439-00145eb45e9a
26	26	0	Canada Biodiversity Information Facility	8f83fc96-c966-4126-83f7-bf044dc49efa	845e169c-f762-11e1-a439-00145eb45e9a
11926	11926	0	Canada Biodiversity Information Facility	8f83fc96-c966-4126-83f7-bf044dc49efa	8463b732-f762-11e1-a439-00145eb45e9a
1824	1824	0	Biodiversity Information System of Mexico	b324e8e9-9a4c-44fa-8f1a-7f39ea7ab576	851630b0-f762-11e1-a439-00145eb45e9a
11	11	0	GBIF Germany	4f6826f2-4ff6-443d-b966-e6913bd24013	863cbacc-f762-11e1-a439-00145eb45e9a
111	55	-56	GBIF Germany	4f6826f2-4ff6-443d-b966-e6913bd24013	8705fd42-f762-11e1-a439-00145eb45e9a
625	479	-146	GBIF Germany	4f6826f2-4ff6-443d-b966-e6913bd24013	8716361c-f762-11e1-a439-00145eb45e9a
146	146	0	Colombian Biodiversity Information System	7e865cba-7c46-417b-ade5-97f2cf5b7be0	888f0578-bef9-41f6-a687-19137510a437
98	74	-24	GBIF Germany	4f6826f2-4ff6-443d-b966-e6913bd24013	8964f5c0-f762-11e1-a439-00145eb45e9a
3124	3124	0	DanBIF - Danish Biodiversity Information Facility	4ddd294f-02b7-4359-ac33-0806a9ca9c6b	8b708d1a-3021-4cfd-aa17-f9696317292b
29	29	0	GBIF Germany	4f6826f2-4ff6-443d-b966-e6913bd24013	8bc158a4-f762-11e1-a439-00145eb45e9a
1141	1141	0	National Biodiversity Network	d897a5b9-35ee-4232-94bd-b0bcaac003c2	8cf293b8-72cc-4a1a-8efb-1e916291cd18
0	31040	31040	Ocean Biodiversity Information System	ba0670b9-4186-41e6-8e70-f9cb3065551a	8d014dc4-39cf-470b-a387-a015dee983c8
147	81	-66	GBIF Germany	4f6826f2-4ff6-443d-b966-e6913bd24013	8e7459ca-f762-11e1-a439-00145eb45e9a
13	13	0	Plazi	ffb07bec-2d10-492d-9c37-361fe0b79427	8ea9444e-4322-4907-902b-e7b27f018899
44	40	-4	GBIF Germany	4f6826f2-4ff6-443d-b966-e6913bd24013	8f32f2f4-f762-11e1-a439-00145eb45e9a
737	582	-155	GBIF Germany	4f6826f2-4ff6-443d-b966-e6913bd24013	8f39705c-f762-11e1-a439-00145eb45e9a
80	52	-28	GBIF Germany	4f6826f2-4ff6-443d-b966-e6913bd24013	8fef90ee-f762-11e1-a439-00145eb45e9a
77	60	-17	GBIF Germany	4f6826f2-4ff6-443d-b966-e6913bd24013	91faf90a-f762-11e1-a439-00145eb45e9a
67	67	0	National Biodiversity Network	d897a5b9-35ee-4232-94bd-b0bcaac003c2	930f7ae9-e054-4b2b-b7d0-9eb637124cec
13646	13646	0	Ocean Biodiversity Information System	ba0670b9-4186-41e6-8e70-f9cb3065551a	96180cd0-f762-11e1-a439-00145eb45e9a
607	607	0	Atlas of Living Australia	4a6f1b71-969e-4fc5-a693-282b05e1220c	96a682ee-f762-11e1-a439-00145eb45e9a
2	2	0	Plazi	ffb07bec-2d10-492d-9c37-361fe0b79427	9871a844-8250-4348-b8bd-31bc1161328d
5	5	0	Plazi	ffb07bec-2d10-492d-9c37-361fe0b79427	9a36b4e8-ff1f-4076-8a02-7cf01c47ad78
6	6	0	Plazi	ffb07bec-2d10-492d-9c37-361fe0b79427	9b404efd-c9b4-4d83-bc6d-1fa39672a9c6
621	621	0	GBIF Norway	4f829580-180d-46a9-9c87-ed8ec959b545	9c4e14d4-4047-4d30-9954-1a2df1ba7d15
5	5	0	Plazi	ffb07bec-2d10-492d-9c37-361fe0b79427	9c8850ff-11d0-47a9-8c8a-b5e17cb8ec06
0	6	6	Plazi	ffb07bec-2d10-492d-9c37-361fe0b79427	9cba504a-8bd1-4c19-b911-fea012f6b9ed
294	294	0	GBIF Portugal	673f7038-4262-4149-b753-5658a4e912f6	9cd9d5e6-68cd-48f0-a88b-2a604398ae72
3738	3763	25	Canada Biodiversity Information Facility	8f83fc96-c966-4126-83f7-bf044dc49efa	9dab876a-98bf-4ba2-b425-0d40947eebd4
0	7540	7540	Ocean Biodiversity Information System	ba0670b9-4186-41e6-8e70-f9cb3065551a	a1d3149a-899c-431b-b8f0-16df4eaaaa40
0	20	20	Plazi	ffb07bec-2d10-492d-9c37-361fe0b79427	a1e2c13b-e264-4f5a-9576-0721f8cbfbbe
0	19780	19780	Canada Biodiversity Information Facility	8f83fc96-c966-4126-83f7-bf044dc49efa	a5105b23-ef9c-4ff7-8d0b-a09104130e29
0	77	77	Plazi	ffb07bec-2d10-492d-9c37-361fe0b79427	a5454a8b-04cd-4cc6-ae0b-f13f31a7af34
0	4	4	Ocean Biodiversity Information System	ba0670b9-4186-41e6-8e70-f9cb3065551a	a664460a-266e-4975-b451-9a38fadce603
10959	10959	0	National Biodiversity Network	d897a5b9-35ee-4232-94bd-b0bcaac003c2	a925a78d-bb92-449e-a5c0-cc8536b805e7
4	4	0	Plazi	ffb07bec-2d10-492d-9c37-361fe0b79427	aa9f0ab8-94ca-4990-9817-103f00ee9caa
250422	256509	6087	U.S. Geological Survey	8618c64a-93e0-4300-b546-7249e5148ed2	b6015b60-6f96-43a9-88e5-2f41854e8f07
53	53	0	GBIF Germany	4f6826f2-4ff6-443d-b966-e6913bd24013	b79d1ca3-6d5c-422f-bffe-bff4603a84d8
154	154	0	International Centre for Insect Physiology and Ecology	b9628650-eeb8-44e3-80b8-ea6626956793	b9fd03c9-29f6-4498-b3b4-0afa92b48534
0	1644	1644	International Centre for Integrated Mountain Development	b35cf8f1-748d-467a-adca-4f9170f20a4e	bbd4effa-9796-4e0c-8c1a-0b92f6a95907
3	3	0	Plazi	ffb07bec-2d10-492d-9c37-361fe0b79427	bc0d8578-73eb-45dd-96c4-865971ff2ab4
17715	17715	0	Taiwan Biodiversity Information Facility	e1b85abc-61f9-430f-ba79-6813dec53a0f	bc76c690-60a3-11de-a447-b8a03c50a862
4	4	0	Plazi	ffb07bec-2d10-492d-9c37-361fe0b79427	c11aa3ca-081e-4989-a154-b23f721848e9
1555	1555	0	GBIF Benin	efb9c00e-f802-45dd-8826-a52ec45b89ff	c3163166-8dea-4125-892c-59fe9c903349
0	4	4	Plazi	ffb07bec-2d10-492d-9c37-361fe0b79427	c3f61d23-b35a-450c-a0c3-18c1112b9520
909	909	0	GBIF Spain	1f94b3ca-9345-4d65-afe2-4bace93aa0fe	c5542412-e7f0-40ce-b134-9a435a836e9b
34767	34767	0	National Biodiversity Network	d897a5b9-35ee-4232-94bd-b0bcaac003c2	c852d2b9-75fb-4d9f-9a34-9beacc5c54fb
232	232	0	Colombian Biodiversity Information System	7e865cba-7c46-417b-ade5-97f2cf5b7be0	c93574ce-39ec-4d73-bd9b-61ab85ae6b7c
0	6	6	Plazi	ffb07bec-2d10-492d-9c37-361fe0b79427	ca29364e-8f84-404b-a77a-ec2269cb73be
2	2	0	Plazi	ffb07bec-2d10-492d-9c37-361fe0b79427	cae68429-8a99-455d-8f5b-4a6054985293
137	137	0	GBIF France	da44cd31-5901-4687-a106-6d1c7734ee3a	cbe0a4a8-817a-4edd-840f-a46e35121e69
0	7	7	Plazi	ffb07bec-2d10-492d-9c37-361fe0b79427	cc8c5c32-aef0-4a9d-afae-c500d74ad12a
16	16	0	Plazi	ffb07bec-2d10-492d-9c37-361fe0b79427	cdd4b871-c712-43cc-b93e-683cce85d722
0	6	6	Plazi	ffb07bec-2d10-492d-9c37-361fe0b79427	cee55987-4eca-4b90-b884-1cba808a660b
116	116	0	GBIF France	da44cd31-5901-4687-a106-6d1c7734ee3a	d1a885f1-2e9d-4722-a3bf-6fafc4e7a070
1801	1801	0	Netherlands Biodiversity Information Facility	0909d601-bda2-42df-9e63-a6d51847ebce	d2e91e98-c145-4d02-83db-456a43ed04a8
0	19	19	Plazi	ffb07bec-2d10-492d-9c37-361fe0b79427	d354f7f9-95e6-41ac-ae1c-7110e09ffd7a
6	6	0	GBIF Finland	dd514216-5c7c-45f3-910d-797424cb5be6	d47f8848-8de8-4e30-bb82-27d32da5ee64
9	9	0	Plazi	ffb07bec-2d10-492d-9c37-361fe0b79427	d5ddaf75-c39b-49b3-bbf5-7e7af2f7ad66
6	6	0	Plazi	ffb07bec-2d10-492d-9c37-361fe0b79427	dab61956-a8d0-4bf2-b5c6-a1453915d69e
4	4	0	Plazi	ffb07bec-2d10-492d-9c37-361fe0b79427	dc71c105-ff31-4af3-b1f4-5d137f99782f
0	5	5	Plazi	ffb07bec-2d10-492d-9c37-361fe0b79427	df0c3bde-8223-4bd7-8d5a-cdab3162add9
159	159	0	Plazi	ffb07bec-2d10-492d-9c37-361fe0b79427	df892163-6e24-4fd8-9ea7-156a33701b8a
0	1	1	Participant Node Managers Committee	7f48e0c8-5c96-49ec-b972-30748e339115	dfee69a3-7618-4b97-a436-a94205a18aba
0	22497	22497	Participant Node Managers Committee	7f48e0c8-5c96-49ec-b972-30748e339115	e4415adb-50b0-4322-8932-00dcd36792e6
1500	1500	0	Korean Biodiversity Information Facility	e0a1e772-0177-4800-94b4-2d023fe6cdf4	e56dcc4d-ddad-47f4-925c-a085634cf27f
0	741	741	Participant Node Managers Committee	7f48e0c8-5c96-49ec-b972-30748e339115	e7731ade-2877-467e-a9d7-ac19cb1dafb4
0	2	2	Plazi	ffb07bec-2d10-492d-9c37-361fe0b79427	e7e629c2-15d5-46f2-8ff4-0b62503345ad
0	54	54	Plazi	ffb07bec-2d10-492d-9c37-361fe0b79427	ea7a5aa0-0ce5-48f3-bebc-bae40df09c91
440	440	0	GBIF France	da44cd31-5901-4687-a106-6d1c7734ee3a	eaf3bb91-2997-4304-b9f9-d9e5d9ad00ac
5	5	0	Plazi	ffb07bec-2d10-492d-9c37-361fe0b79427	eb0448d5-d42c-42b9-9682-e3704b6a1947
7565	7565	0	GBIF France	da44cd31-5901-4687-a106-6d1c7734ee3a	eb4b2590-2eb1-4e9d-b543-aef0ed9f4dee
683	683	0	GBIF Benin	efb9c00e-f802-45dd-8826-a52ec45b89ff	ed15e812-6b49-4587-84e4-a413d081f4b2
9	9	0	Ocean Biodiversity Information System	ba0670b9-4186-41e6-8e70-f9cb3065551a	eddeff93-b667-4a15-b81d-ebcc1180f7ba
14860	14860	0	GBIF Benin	efb9c00e-f802-45dd-8826-a52ec45b89ff	f18a17fc-38a8-49aa-a2e6-5dd99eea1bbb
1300	1300	0	Korean Biodiversity Information Facility	e0a1e772-0177-4800-94b4-2d023fe6cdf4	f323a8b9-6b7a-48d4-8cd5-e1a93943cc7c
2582	2582	0	GBIF France	da44cd31-5901-4687-a106-6d1c7734ee3a	f33375a8-468a-4e13-ae76-357b4b34e850
481	481	0	Participant Node Managers Committee	7f48e0c8-5c96-49ec-b972-30748e339115	f8acba56-93a4-4de3-a407-00e57337822e
0	41	41	Plazi	ffb07bec-2d10-492d-9c37-361fe0b79427	f95c7c95-304a-4c2b-82d1-0ed07e8c4724
0	4	4	Plazi	ffb07bec-2d10-492d-9c37-361fe0b79427	fbb07928-ec48-47bd-8fef-8595b96b0f68
2	2	0	Plazi	ffb07bec-2d10-492d-9c37-361fe0b79427	fbc5073c-f6bc-41f4-aacd-3f5c8cdb16c8
1888	1888	0	Biodiversity Information System of Mexico	b324e8e9-9a4c-44fa-8f1a-7f39ea7ab576	fd7c202b-3980-4b19-b3a0-8b288c634fa7
13450	13450	0	GBIF Sweden	a0b3be64-6525-4387-ac67-a499950f92e1	fea587f0-540e-11de-bdf7-b8a03c50a862
182	182	0	Ocean Biodiversity Information System	ba0670b9-4186-41e6-8e70-f9cb3065551a	fefda674-129a-4882-8ccc-e81651946111
82	82	0	Plazi	ffb07bec-2d10-492d-9c37-361fe0b79427	ff51c162-2353-488f-b80a-0dcd3b11ad96
10	10	0	GBIF France	da44cd31-5901-4687-a106-6d1c7734ee3a	00f03652-0e86-4038-a8a3-fc41ee4a1bc2
2661	2661	0	Colombian Biodiversity Information System	7e865cba-7c46-417b-ade5-97f2cf5b7be0	04376115-6207-4af2-8d51-d71f5fbb21be
55	55	0	Plazi	ffb07bec-2d10-492d-9c37-361fe0b79427	05055b8b-79f0-4143-a3b4-d901963e6e25
1	1	0	Plazi	ffb07bec-2d10-492d-9c37-361fe0b79427	06b6d362-1aad-4429-8bce-9bd2f7c4287e
190	190	0	Plazi	ffb07bec-2d10-492d-9c37-361fe0b79427	099d3015-8af8-4ae1-b667-1ac61dde9294
323	323	0	GBIF France	da44cd31-5901-4687-a106-6d1c7734ee3a	0a965192-6e7e-41a4-9289-e979416dbd14
1	1	0	Plazi	ffb07bec-2d10-492d-9c37-361fe0b79427	0e51bef9-6ac5-4ae0-8b10-b5079e3853a0
0	3	3	Plazi	ffb07bec-2d10-492d-9c37-361fe0b79427	15384e11-bd90-4f9f-af75-a1ad1d07a45c
431	431	0	Colombian Biodiversity Information System	7e865cba-7c46-417b-ade5-97f2cf5b7be0	157f0615-5efa-4447-b488-3650a1aca6de
2421	1097	-1324	Biodiversity Information System of Mexico	b324e8e9-9a4c-44fa-8f1a-7f39ea7ab576	171f18cb-5a9f-4abc-922e-4df68fbb0271
0	5	5	Ocean Biodiversity Information System	ba0670b9-4186-41e6-8e70-f9cb3065551a	19763943-5b2f-4064-826f-393dd3758c37
2	2	0	Plazi	ffb07bec-2d10-492d-9c37-361fe0b79427	1b832922-abf2-40ec-a346-9c9a7019a9b5
2	2	0	Plazi	ffb07bec-2d10-492d-9c37-361fe0b79427	1e26f723-8d0e-4e37-be6c-50318378d6f9
15	15	0	Plazi	ffb07bec-2d10-492d-9c37-361fe0b79427	2043bfdb-76a0-4a4a-bcea-c8d286d2a93b
719	719	0	GBIF France	da44cd31-5901-4687-a106-6d1c7734ee3a	21d60f87-ef97-4ddb-99ed-742d78c06efa
63	63	0	GBIF France	da44cd31-5901-4687-a106-6d1c7734ee3a	24e31afb-7fc7-45d0-a899-3821bfa26730
0	9	9	Plazi	ffb07bec-2d10-492d-9c37-361fe0b79427	261218c5-3c78-4ba7-876e-44a43ad3642b
0	3	3	Ocean Biodiversity Information System	ba0670b9-4186-41e6-8e70-f9cb3065551a	2ab883c1-f7bc-45fd-95ad-ccfb85ce9de4
496	496	0	GBIF Argentina	2426a871-9feb-40a1-96c6-0c593a76b835	2f1a2f9a-4efe-4765-b772-2d47bd04c835
3	3	0	Plazi	ffb07bec-2d10-492d-9c37-361fe0b79427	309b96ba-b27b-4dd5-b4e3-3d4dabf0bcb6
0	2152	2152	GBIF Portugal	673f7038-4262-4149-b753-5658a4e912f6	34269d1c-27c7-483b-9e2d-a17d5a4d465d
74551	74624	73	U.S. Geological Survey	8618c64a-93e0-4300-b546-7249e5148ed2	39f7ffd7-9416-4efb-934a-c81f116893fc
251744	251744	0	GBIF Brazil	cdc9736d-5ff7-4ece-9959-3c744360cdb3	3cc6171e-8c52-4f65-ad7a-32c74e395f29
1553	1553	0	Belgian Biodiversity Platform	fb11cfe1-ebc3-45af-9159-17d9fddbcdac	3e2a280e-33ab-449d-a543-dc97e96a664b
0	10	10	Plazi	ffb07bec-2d10-492d-9c37-361fe0b79427	3fbb2cbb-07dc-47ac-ae8a-257f70c83339
346	346	0	South African Biodiversity Information Facility	7190b835-4e86-4b6e-85c1-19cc6677c250	3fd87f77-1da0-44c7-b5e7-5c33103ca18c
9	9	0	Plazi	ffb07bec-2d10-492d-9c37-361fe0b79427	410ed7a0-f786-46eb-9eb7-b6cad33cb9e1
0	2973	2973	National Biodiversity Network	d897a5b9-35ee-4232-94bd-b0bcaac003c2	42af43c7-361f-426f-bd5f-33486fcc8855
28	28	0	Participant Node Managers Committee	7f48e0c8-5c96-49ec-b972-30748e339115	454dca75-c72a-4d15-82de-bce8344029ad
0	4	4	Plazi	ffb07bec-2d10-492d-9c37-361fe0b79427	48d0c0d1-720b-47dd-bb88-cfb26f8fa1c5
1677	1677	0	Participant Node Managers Committee	7f48e0c8-5c96-49ec-b972-30748e339115	4aeef7f2-a35b-405e-bcc6-7024a251ddab
0	7	7	Plazi	ffb07bec-2d10-492d-9c37-361fe0b79427	4c07e3a9-3c3b-436c-852f-3864fe68fc8e
0	21963	21963	Belgian Biodiversity Platform	fb11cfe1-ebc3-45af-9159-17d9fddbcdac	4cfcc190-f0e0-4611-8253-003481290d38
952	952	0	GBIF France	da44cd31-5901-4687-a106-6d1c7734ee3a	4e5b7609-ecdb-4963-9172-9065f63424f7
10	200	190	GBIF Japan	db5705aa-6a6e-42f1-8942-d77b9f4896ea	4f86435d-e304-47e0-95e8-bb1ba9e8e79a
202122	202122	0	U.S. Geological Survey	8618c64a-93e0-4300-b546-7249e5148ed2	5199d77b-fc69-4c85-94f2-4d3e63e777ff
2330	2330	0	GBIF Japan	db5705aa-6a6e-42f1-8942-d77b9f4896ea	53687028-18f5-11e2-98fb-00145eb45e9a
9085	9085	0	Colombian Biodiversity Information System	7e865cba-7c46-417b-ade5-97f2cf5b7be0	5458db14-d1c8-45ac-9bf3-8cc027df3c94
0	1	1	Plazi	ffb07bec-2d10-492d-9c37-361fe0b79427	577746e0-2596-4518-9616-18524cdf941f
0	4	4	Plazi	ffb07bec-2d10-492d-9c37-361fe0b79427	58f69c1b-04a8-4c2d-8159-a71b81d14ff6
0	3054	3054	Atlas of Living Australia	4a6f1b71-969e-4fc5-a693-282b05e1220c	5a8abb99-1a7c-4cc8-b801-2b383037492f
4	4	0	Plazi	ffb07bec-2d10-492d-9c37-361fe0b79427	5efe084f-2fbf-4b7b-a164-6bc8a765cca2
625	625	0	GBIF France	da44cd31-5901-4687-a106-6d1c7734ee3a	5f5f48ac-05bc-4280-a6fc-1de4a8553a7b
61	61	0	GBIF Germany	4f6826f2-4ff6-443d-b966-e6913bd24013	6238ea7e-f762-11e1-a439-00145eb45e9a
2	2	0	Plazi	ffb07bec-2d10-492d-9c37-361fe0b79427	6275da5a-e3f9-4e42-9d6d-27860b50f6d8
300	300	0	Biodiversity Information System of Mexico	b324e8e9-9a4c-44fa-8f1a-7f39ea7ab576	62945544-1709-4569-97e9-6abfd0fd6651
0	78	78	Plazi	ffb07bec-2d10-492d-9c37-361fe0b79427	6317470e-eca6-47a1-97ef-33d45fdcc62a
82	82	0	GBIF Germany	4f6826f2-4ff6-443d-b966-e6913bd24013	64cabd76-f762-11e1-a439-00145eb45e9a
204	204	0	GBIF Germany	4f6826f2-4ff6-443d-b966-e6913bd24013	663b6336-f762-11e1-a439-00145eb45e9a
482	482	0	Ocean Biodiversity Information System	ba0670b9-4186-41e6-8e70-f9cb3065551a	683957d7-7bb8-44da-bdc1-8d61a41d2b7b
127	127	0	GBIF Germany	4f6826f2-4ff6-443d-b966-e6913bd24013	683bec6e-f762-11e1-a439-00145eb45e9a
69	69	0	GBIF Germany	4f6826f2-4ff6-443d-b966-e6913bd24013	68a4bb18-f762-11e1-a439-00145eb45e9a
143	95	-48	GBIF Germany	4f6826f2-4ff6-443d-b966-e6913bd24013	68dee522-f762-11e1-a439-00145eb45e9a
66	66	0	GBIF Germany	4f6826f2-4ff6-443d-b966-e6913bd24013	69040438-f762-11e1-a439-00145eb45e9a
2	2	0	Plazi	ffb07bec-2d10-492d-9c37-361fe0b79427	698325eb-16e9-4345-8020-fd89f81dac51
22	22	0	GBIF Germany	4f6826f2-4ff6-443d-b966-e6913bd24013	6a998502-f762-11e1-a439-00145eb45e9a
13	13	0	Plazi	ffb07bec-2d10-492d-9c37-361fe0b79427	6b3928ce-b7c6-42a2-ab24-995c30a122cc
9	9	0	GBIF Germany	4f6826f2-4ff6-443d-b966-e6913bd24013	6bab00ec-f762-11e1-a439-00145eb45e9a
41	41	0	GBIF Germany	4f6826f2-4ff6-443d-b966-e6913bd24013	6cb3ccc6-f762-11e1-a439-00145eb45e9a
64	64	0	GBIF Germany	4f6826f2-4ff6-443d-b966-e6913bd24013	6ce6bf5a-f762-11e1-a439-00145eb45e9a
38672	38672	0	National Biodiversity Data Centre	422b00b2-6c94-4bb6-976b-c359916efdb8	6eed5110-c7b8-11de-b279-d063ea754e15
4853	4853	0	GBIF Benin	efb9c00e-f802-45dd-8826-a52ec45b89ff	6f18bf6c-1874-41b1-840c-adf7c56b9e79
45	45	0	GBIF Germany	4f6826f2-4ff6-443d-b966-e6913bd24013	6f4a4bb2-4c3c-4f52-8acf-fa8f44b30ada
0	2	2	Ocean Biodiversity Information System	ba0670b9-4186-41e6-8e70-f9cb3065551a	71c2a31d-820a-4999-b672-6b16752694b6
52	52	0	GBIF Germany	4f6826f2-4ff6-443d-b966-e6913bd24013	72b812e4-f762-11e1-a439-00145eb45e9a
255	255	0	GBIF Germany	4f6826f2-4ff6-443d-b966-e6913bd24013	74047bf6-f762-11e1-a439-00145eb45e9a
18	18	0	Plazi	ffb07bec-2d10-492d-9c37-361fe0b79427	749ffcd5-2b11-4a35-a97e-a6f416e251f4
808	808	0	GBIF Germany	4f6826f2-4ff6-443d-b966-e6913bd24013	74a69cc4-f762-11e1-a439-00145eb45e9a
5	5	0	Plazi	ffb07bec-2d10-492d-9c37-361fe0b79427	758720c0-3a9e-4ca4-9ecd-a3461bacc7aa
0	38	38	Plazi	ffb07bec-2d10-492d-9c37-361fe0b79427	7855bd55-8b08-4cf7-ae87-67f9f3d5b2c1
0	287	287	GBIF Chile	a8b16421-d80b-4ef3-8f22-098b01a89255	790bf8ec-fe11-4272-8f53-132f7a9b0b39
36	28	-8	GBIF Germany	4f6826f2-4ff6-443d-b966-e6913bd24013	795967ce-f762-11e1-a439-00145eb45e9a
10	10	0	Plazi	ffb07bec-2d10-492d-9c37-361fe0b79427	799c80c8-c7dc-44fa-83c3-f43c62fe1e1e
206	206	0	Colombian Biodiversity Information System	7e865cba-7c46-417b-ade5-97f2cf5b7be0	799cba8b-badc-4bb2-b8f7-3e6b6d2e7b3c
10	10	0	Plazi	ffb07bec-2d10-492d-9c37-361fe0b79427	7cce35d8-9550-4d28-acc6-259a5733e207
4295332	4586797	291465	National Biodiversity Network	d897a5b9-35ee-4232-94bd-b0bcaac003c2	7e380070-f762-11e1-a439-00145eb45e9a
204	204	0	GBIF Germany	4f6826f2-4ff6-443d-b966-e6913bd24013	7e4b04a4-f762-11e1-a439-00145eb45e9a
95	95	0	GBIF Germany	4f6826f2-4ff6-443d-b966-e6913bd24013	7ef3f0b4-f762-11e1-a439-00145eb45e9a
12	12	0	Plazi	ffb07bec-2d10-492d-9c37-361fe0b79427	7f14d42f-d78a-4273-869d-c1317e2e6516
5	5	0	Plazi	ffb07bec-2d10-492d-9c37-361fe0b79427	80581287-c827-4329-86ea-67cf41f658f8
517	517	0	Biodiversity Information System of Mexico	b324e8e9-9a4c-44fa-8f1a-7f39ea7ab576	806d5b92-f762-11e1-a439-00145eb45e9a
91	91	0	GBIF Guinea	b1cd2e84-c4ba-47bd-b72a-dfd1f92dce0a	8103e2c8-6335-49f4-9dd6-2d97169a6ceb
23774	23774	0	GBIF Japan	db5705aa-6a6e-42f1-8942-d77b9f4896ea	810e15d2-f762-11e1-a439-00145eb45e9a
238	246	8	GBIF Germany	4f6826f2-4ff6-443d-b966-e6913bd24013	82c64584-f762-11e1-a439-00145eb45e9a
819	819	0	CABI Bioscience	ed988a18-81f8-4d5f-a88d-f93ef592b2f2	8324c0dc-f762-11e1-a439-00145eb45e9a
11335	11335	0	Biodiversity Information System of Mexico	b324e8e9-9a4c-44fa-8f1a-7f39ea7ab576	832d4481-84ff-4bf5-ad97-a88392c2e61c
11224	11224	0	GBIF Finland	dd514216-5c7c-45f3-910d-797424cb5be6	8431711e-f762-11e1-a439-00145eb45e9a
599	599	0	Canada Biodiversity Information Facility	8f83fc96-c966-4126-83f7-bf044dc49efa	844aa7ec-f762-11e1-a439-00145eb45e9a
1702	1702	0	Ocean Biodiversity Information System	ba0670b9-4186-41e6-8e70-f9cb3065551a	859afa3f-c79e-4fa0-98d8-9b0eb0d64c12
9	9	0	GBIF Germany	4f6826f2-4ff6-443d-b966-e6913bd24013	85e437d0-f762-11e1-a439-00145eb45e9a
46156	46156	0	GBIF Spain	1f94b3ca-9345-4d65-afe2-4bace93aa0fe	867c8490-f762-11e1-a439-00145eb45e9a
3824	3824	0	GBIF Brazil	cdc9736d-5ff7-4ece-9959-3c744360cdb3	86b262c2-f762-11e1-a439-00145eb45e9a
304	201	-103	GBIF Germany	4f6826f2-4ff6-443d-b966-e6913bd24013	86e4c69a-f762-11e1-a439-00145eb45e9a
8354	5976	-2378	GBIF Germany	4f6826f2-4ff6-443d-b966-e6913bd24013	870bba81-9aff-4520-b001-8acda939328d
1	1	0	Plazi	ffb07bec-2d10-492d-9c37-361fe0b79427	87c05aa2-0c8f-4e5b-be2b-c0a1fd8142d0
712	518	-194	GBIF Germany	4f6826f2-4ff6-443d-b966-e6913bd24013	87ee7fc2-f762-11e1-a439-00145eb45e9a
85	85	0	GBIF Germany	4f6826f2-4ff6-443d-b966-e6913bd24013	89a74cb8-f762-11e1-a439-00145eb45e9a
73	73	0	GBIF Germany	4f6826f2-4ff6-443d-b966-e6913bd24013	8a385ed8-f762-11e1-a439-00145eb45e9a
0	22	22	Plazi	ffb07bec-2d10-492d-9c37-361fe0b79427	8a707980-1d3a-4cf9-b9d1-283e101f47b4
29	29	0	GBIF Germany	4f6826f2-4ff6-443d-b966-e6913bd24013	8a72e35a-f762-11e1-a439-00145eb45e9a
15	8	-7	GBIF Germany	4f6826f2-4ff6-443d-b966-e6913bd24013	8cec0634-f762-11e1-a439-00145eb45e9a
2767	2767	0	GBIF Germany	4f6826f2-4ff6-443d-b966-e6913bd24013	8d7e2f1e-f762-11e1-a439-00145eb45e9a
71	28	-43	GBIF Germany	4f6826f2-4ff6-443d-b966-e6913bd24013	8e4a2d6c-f762-11e1-a439-00145eb45e9a
280	191	-89	GBIF Germany	4f6826f2-4ff6-443d-b966-e6913bd24013	8e8a53b0-f762-11e1-a439-00145eb45e9a
762	463	-299	GBIF Germany	4f6826f2-4ff6-443d-b966-e6913bd24013	8ea72ad0-f762-11e1-a439-00145eb45e9a
274	232	-42	GBIF Germany	4f6826f2-4ff6-443d-b966-e6913bd24013	8eccdab4-f762-11e1-a439-00145eb45e9a
261	213	-48	GBIF Germany	4f6826f2-4ff6-443d-b966-e6913bd24013	8f5d9662-f762-11e1-a439-00145eb45e9a
317	317	0	GBIF Germany	4f6826f2-4ff6-443d-b966-e6913bd24013	920d742c-f762-11e1-a439-00145eb45e9a
1044	1044	0	GBIF Germany	4f6826f2-4ff6-443d-b966-e6913bd24013	943412c4-f762-11e1-a439-00145eb45e9a
858	858	0	GBIF Germany	4f6826f2-4ff6-443d-b966-e6913bd24013	949c5118-f762-11e1-a439-00145eb45e9a
96	96	0	GBIF France	da44cd31-5901-4687-a106-6d1c7734ee3a	94a75fc6-fe8a-4cde-8581-a029c5550ced
34766	35089	323	U.S. Geological Survey	8618c64a-93e0-4300-b546-7249e5148ed2	96419bea-f762-11e1-a439-00145eb45e9a
453	52	-401	GBIF Germany	4f6826f2-4ff6-443d-b966-e6913bd24013	96771fb8-f762-11e1-a439-00145eb45e9a
1	1	0	Plazi	ffb07bec-2d10-492d-9c37-361fe0b79427	9695364c-5284-47f4-8f95-3c21304e4f2f
989	989	0	Biodiversity Information System of Mexico	b324e8e9-9a4c-44fa-8f1a-7f39ea7ab576	96b064a8-f762-11e1-a439-00145eb45e9a
74	74	0	GBIF Germany	4f6826f2-4ff6-443d-b966-e6913bd24013	97c34086-f762-11e1-a439-00145eb45e9a
1	1	0	Plazi	ffb07bec-2d10-492d-9c37-361fe0b79427	9a79d0d9-928a-4b60-99e2-5031c9d9ac53
13	13	0	Plazi	ffb07bec-2d10-492d-9c37-361fe0b79427	9b87c5b1-a625-4bbd-840b-19f3d5aa7ed7
1	1	0	Plazi	ffb07bec-2d10-492d-9c37-361fe0b79427	9e616425-484c-4252-ac56-38de6af08d4e
0	29	29	Plazi	ffb07bec-2d10-492d-9c37-361fe0b79427	9e64464b-7cc6-44c5-9c1e-073ac4bd2623
82	82	0	Plazi	ffb07bec-2d10-492d-9c37-361fe0b79427	9ec1478c-2bdc-43d3-9317-6e38503f1d51
200	200	0	U.S. Geological Survey	8618c64a-93e0-4300-b546-7249e5148ed2	9ee6cfc8-8d60-41cf-a397-c973fabac388
131	131	0	Biodiversity Information System of Mexico	b324e8e9-9a4c-44fa-8f1a-7f39ea7ab576	9fa12a2d-65f4-467a-9255-4b291127a0dd
0	53	53	Plazi	ffb07bec-2d10-492d-9c37-361fe0b79427	a1053c94-58d2-4e68-80f8-fc983d11ee88
0	4	4	Plazi	ffb07bec-2d10-492d-9c37-361fe0b79427	a192308f-bdb9-4d16-81aa-1faa8f277615
1035	2392	1357	GBIF Japan	db5705aa-6a6e-42f1-8942-d77b9f4896ea	a1b562d2-1f3f-4d2b-aa2f-11e5e49d4898
0	50	50	Plazi	ffb07bec-2d10-492d-9c37-361fe0b79427	a333c0b8-de3f-4f3b-a9b9-05453686efc4
12	12	0	GBIF Estonia	2c11b821-d22b-4c64-8cd3-c1578173b129	a63c8e4a-a084-43f0-b53a-d113ccd2a413
1	1	0	Plazi	ffb07bec-2d10-492d-9c37-361fe0b79427	a6c2daaa-106b-4373-9e9b-22b88fa2276e
5	5	0	Plazi	ffb07bec-2d10-492d-9c37-361fe0b79427	a884362d-a9f8-4cee-8cd4-dcf59a73ede2
264	264	0	GBIF Sweden	a0b3be64-6525-4387-ac67-a499950f92e1	a8b89b7e-6095-44a1-a328-eedb595eddc6
13871	13871	0	GBIF Portugal	673f7038-4262-4149-b753-5658a4e912f6	a8f74dd0-1999-4948-944b-d0905cfbd461
1	1	0	Plazi	ffb07bec-2d10-492d-9c37-361fe0b79427	a9253ad9-0b73-497d-bc9b-831f72b5ad28
0	10	10	Plazi	ffb07bec-2d10-492d-9c37-361fe0b79427	abf184b2-cd76-4c22-bb32-69374b268b0d
0	3	3	Plazi	ffb07bec-2d10-492d-9c37-361fe0b79427	abf516a9-35b4-43be-bac0-876e8985d85b
0	233	233	GBIF Japan	db5705aa-6a6e-42f1-8942-d77b9f4896ea	b052c099-2882-44e8-94e1-537a323156ab
310	310	0	Plazi	ffb07bec-2d10-492d-9c37-361fe0b79427	b4b2b894-205d-4787-bb50-257c53155a65
49	49	0	Plazi	ffb07bec-2d10-492d-9c37-361fe0b79427	b5902a9d-c38b-462f-ad8a-95693c1822dc
27480	27538	58	U.S. Geological Survey	8618c64a-93e0-4300-b546-7249e5148ed2	b65c0886-3c24-4ead-a93a-b89d2a676b10
0	8	8	Plazi	ffb07bec-2d10-492d-9c37-361fe0b79427	b7b21974-e27d-4209-938a-e26cfa2e2c8a
3	3	0	Plazi	ffb07bec-2d10-492d-9c37-361fe0b79427	ba7b88b1-1996-4f20-b1d9-8d30c380acd6
3	3	0	Plazi	ffb07bec-2d10-492d-9c37-361fe0b79427	bb607b09-622f-4638-9656-296f5b32651c
8011	9415	1404	GBIF Brazil	cdc9736d-5ff7-4ece-9959-3c744360cdb3	bbb1f181-3221-4a10-ad52-14f1da0dca26
2	2	0	Plazi	ffb07bec-2d10-492d-9c37-361fe0b79427	bd2c50db-bf58-415d-b761-f51fdab39125
3	3	0	Plazi	ffb07bec-2d10-492d-9c37-361fe0b79427	be6c7133-d160-49c1-aa22-4031e2276ed0
598	437	-161	GBIF Germany	4f6826f2-4ff6-443d-b966-e6913bd24013	bed966df-9c01-4489-9627-6d4b87949473
0	4	4	Plazi	ffb07bec-2d10-492d-9c37-361fe0b79427	c5721071-19d2-46ef-bf67-48c56a572cae
0	2	2	Plazi	ffb07bec-2d10-492d-9c37-361fe0b79427	c6c4fcfe-8e16-4a0e-9110-35c2a3f383de
116	116	0	National Biodiversity Network	d897a5b9-35ee-4232-94bd-b0bcaac003c2	c868343a-5ba1-4640-8bb2-db2ae43d79a7
0	41	41	Plazi	ffb07bec-2d10-492d-9c37-361fe0b79427	ca6226eb-f64a-44d1-9f7b-fd0dd870cc7a
1	1	0	Plazi	ffb07bec-2d10-492d-9c37-361fe0b79427	cc6e93e6-3e79-47dd-b2b2-ce3a0debdca6
0	5	5	Plazi	ffb07bec-2d10-492d-9c37-361fe0b79427	cc8ef700-464e-4ede-9ea0-7b94b7ce3bb9
1214	1214	0	GBIF Argentina	2426a871-9feb-40a1-96c6-0c593a76b835	cc902858-60bd-49b9-a7ae-ae1015210295
245	245	0	GBIF Norway	4f829580-180d-46a9-9c87-ed8ec959b545	cef50838-45d9-488a-831e-3dc3fc6b62fd
1741	1741	0	Colombian Biodiversity Information System	7e865cba-7c46-417b-ade5-97f2cf5b7be0	cef7b557-11d6-484b-83df-73fc1c21a9e4
6	6	0	Plazi	ffb07bec-2d10-492d-9c37-361fe0b79427	cf60f15f-b920-4d20-883c-43f5d583ec89
9	9	0	Plazi	ffb07bec-2d10-492d-9c37-361fe0b79427	d03d8191-e882-4de4-943c-2b9b59d7570a
30	30	0	Plazi	ffb07bec-2d10-492d-9c37-361fe0b79427	d1a866ca-b5ec-4344-8991-1dcbb37b4a0f
174	174	0	Participant Node Managers Committee	7f48e0c8-5c96-49ec-b972-30748e339115	d6ede82a-680c-4c03-bd2c-0e3f736fb2fe
0	919	919	Ocean Biodiversity Information System	ba0670b9-4186-41e6-8e70-f9cb3065551a	d7ff0a6b-404c-468c-bba0-e313215e2d40
0	509	509	Ocean Biodiversity Information System	ba0670b9-4186-41e6-8e70-f9cb3065551a	dad5e059-3864-48e3-b518-577a80927c97
350	350	0	Netherlands Biodiversity Information Facility	0909d601-bda2-42df-9e63-a6d51847ebce	db2db3cd-5473-43be-b57a-95eff336f09c
0	71453	71453	Ocean Biodiversity Information System	ba0670b9-4186-41e6-8e70-f9cb3065551a	dcc94d36-ba8b-4ccb-8a48-d92c0e5e98f9
0	19	19	Plazi	ffb07bec-2d10-492d-9c37-361fe0b79427	dd11b811-58d1-439a-b666-9e7b8bda3365
109	109	0	Biodiversity Information System of Mexico	b324e8e9-9a4c-44fa-8f1a-7f39ea7ab576	ddd235f9-2b66-44ed-8053-7980df8ac32e
0	101	101	Colombian Biodiversity Information System	7e865cba-7c46-417b-ade5-97f2cf5b7be0	deabb3b8-4eb0-46e3-beb9-be296cff45c0
307107	307107	0	GBIF France	da44cd31-5901-4687-a106-6d1c7734ee3a	def8d066-e920-42d6-bb67-dfca6980c7f3
3	3	0	Plazi	ffb07bec-2d10-492d-9c37-361fe0b79427	e37c393a-74ee-4b08-8c35-b5b7e26b1f39
1015	1015	0	GBIF France	da44cd31-5901-4687-a106-6d1c7734ee3a	e54fab29-8685-41b4-8fe7-796a5b9a3de5
0	53	53	Ocean Biodiversity Information System	ba0670b9-4186-41e6-8e70-f9cb3065551a	e610c90f-7c35-4400-8325-9bfc95bb2514
4	4	0	Plazi	ffb07bec-2d10-492d-9c37-361fe0b79427	e67012f6-74e4-4a40-86ee-793c130ac98e
10	10	0	Plazi	ffb07bec-2d10-492d-9c37-361fe0b79427	e744e05e-6483-4a96-b00e-8c5f91602acd
4	4	0	Plazi	ffb07bec-2d10-492d-9c37-361fe0b79427	e822bdc4-188e-4718-a194-42f02a4fbd29
54	54	0	GBIF France	da44cd31-5901-4687-a106-6d1c7734ee3a	e8de6860-1518-4546-b6f5-b5747914b064
8	8	0	Plazi	ffb07bec-2d10-492d-9c37-361fe0b79427	ea237bbb-b6cf-443f-bd94-36e49a926620
4	4	0	Atlas of Living Australia	4a6f1b71-969e-4fc5-a693-282b05e1220c	ea2fdd57-4632-4e7c-a20d-5d88982d55d1
0	10	10	Plazi	ffb07bec-2d10-492d-9c37-361fe0b79427	ea544b4c-f007-4b2b-b39f-9959e70fc411
28	28	0	Ocean Biodiversity Information System	ba0670b9-4186-41e6-8e70-f9cb3065551a	ea8469bb-918a-4a15-9448-5509e36d229a
302	302	0	GBIF Germany	4f6826f2-4ff6-443d-b966-e6913bd24013	ed7cf919-cf2c-4caa-a505-484470871865
3939	3939	0	GBIF Benin	efb9c00e-f802-45dd-8826-a52ec45b89ff	f0a99f2c-2670-4ae8-8b9f-8661e02a33a8
1066	1066	0	Colombian Biodiversity Information System	7e865cba-7c46-417b-ade5-97f2cf5b7be0	f1ab0312-f0f8-4a86-a0e4-4e3907ab7b2b
0	82	82	Ocean Biodiversity Information System	ba0670b9-4186-41e6-8e70-f9cb3065551a	f1e8822f-8068-43f5-96bb-1e80f3273e5d
58	58	0	Plazi	ffb07bec-2d10-492d-9c37-361fe0b79427	f1edbdd7-dc18-4c34-b236-fb45c9401096
1080	1080	0	GBIF Germany	4f6826f2-4ff6-443d-b966-e6913bd24013	f1f11ac2-62e1-44b4-9625-4f43597c9722
22	22	0	Plazi	ffb07bec-2d10-492d-9c37-361fe0b79427	f210f8de-d4d2-4670-b8d8-7b4f0f813049
4200	4200	0	GBIF France	da44cd31-5901-4687-a106-6d1c7734ee3a	f423fae4-1af6-42d6-b9ef-407e3fdd4683
0	225	225	GBIF Spain	1f94b3ca-9345-4d65-afe2-4bace93aa0fe	f478eadd-cf37-45fb-9d19-5602ea95fecb
0	56957	56957	U.S. Geological Survey	8618c64a-93e0-4300-b546-7249e5148ed2	f5eeb94b-21f8-42e2-932a-e638bde8d9aa
35	59	24	Participant Node Managers Committee	7f48e0c8-5c96-49ec-b972-30748e339115	f8445a71-64ca-4ebd-91d0-e2b0228f8929
4	4	0	Plazi	ffb07bec-2d10-492d-9c37-361fe0b79427	f8aa10b4-d50c-4c18-963c-26354159860e
0	443	443	Colombian Biodiversity Information System	7e865cba-7c46-417b-ade5-97f2cf5b7be0	f95094c5-ace9-4495-9000-7a537989fce2
7	7	0	Plazi	ffb07bec-2d10-492d-9c37-361fe0b79427	fa8e01a0-3ffd-4004-a4e2-6530f93b2d16
0	3	3	Plazi	ffb07bec-2d10-492d-9c37-361fe0b79427	fbf3f2d6-93c1-4093-be60-33dd558ddef9
55	55	0	GBIF France	da44cd31-5901-4687-a106-6d1c7734ee3a	fcddd554-3201-46f2-82cd-9032b54432df
0	1	1	Plazi	ffb07bec-2d10-492d-9c37-361fe0b79427	fd2403ce-d0d2-40a9-97cf-265e9dffe3d9
260	260	0	Colombian Biodiversity Information System	7e865cba-7c46-417b-ade5-97f2cf5b7be0	fed5c699-f867-4bad-a7c4-b39cf95cac34
0	1219	1219	Participant Node Managers Committee	7f48e0c8-5c96-49ec-b972-30748e339115	0201340c-c8df-433b-85b8-f2383a49cf20
146	146	0	Plazi	ffb07bec-2d10-492d-9c37-361fe0b79427	03e1d49e-b7d9-470c-ae8e-70bb30b0cc85
3	3	0	Plazi	ffb07bec-2d10-492d-9c37-361fe0b79427	040488e3-5906-4e86-8722-532417da4652
0	4218	4218	GBIF Benin	efb9c00e-f802-45dd-8826-a52ec45b89ff	05a9f26e-a3bf-4fb9-a2a0-93dc9b5ff145
24	24	0	Plazi	ffb07bec-2d10-492d-9c37-361fe0b79427	05dc4b2b-842a-409e-a90c-fe171c3bfbc7
1300	1300	0	National Biodiversity Network	d897a5b9-35ee-4232-94bd-b0bcaac003c2	060c39c3-1bd5-459d-980f-113a2bffc696
4256	4256	0	Atlas of Living Australia	4a6f1b71-969e-4fc5-a693-282b05e1220c	06cb2d65-3dc1-4f9f-8e73-c4348abeba77
380	380	0	U.S. Geological Survey	8618c64a-93e0-4300-b546-7249e5148ed2	08e03b4d-a30e-4dfd-978c-36712c7ccbd6
5709	5709	0	Polish Biodiversity Information Network	2618bfdf-e194-4911-a241-80db3107bc51	0a56da10-13c6-11de-b2de-b8a03c50a862
612	612	0	Belgian Biodiversity Platform	fb11cfe1-ebc3-45af-9159-17d9fddbcdac	1033d90e-c10c-4ce8-87d0-0f8227300765
0	43	43	Plazi	ffb07bec-2d10-492d-9c37-361fe0b79427	114135c4-23cb-444b-8cff-75d9f43aad6a
2113	2113	0	GBIF Argentina	2426a871-9feb-40a1-96c6-0c593a76b835	14bda39a-de67-4504-b1e3-883d7ed118d6
15	15	0	Plazi	ffb07bec-2d10-492d-9c37-361fe0b79427	152ffdff-be39-4dcd-bebd-aec3041f2ec2
0	2	2	Plazi	ffb07bec-2d10-492d-9c37-361fe0b79427	1535e145-5b0d-4e32-b880-77558b654ae9
1751	1751	0	ASEAN Centre for Biodiversity	af2a0fa1-4c8e-4bdc-8954-b1a55e32b0f1	16c59d42-d480-40bb-b593-dc6381df7a5b
16	16	0	Plazi	ffb07bec-2d10-492d-9c37-361fe0b79427	1fb77063-018a-4222-8733-9450729ac222
1	1	0	Plazi	ffb07bec-2d10-492d-9c37-361fe0b79427	1fe35367-9af9-4249-b5b7-cd447270aa42
19651	19651	0	Colombian Biodiversity Information System	7e865cba-7c46-417b-ade5-97f2cf5b7be0	2092da06-aade-460b-9525-3098eca9abbc
1995	1995	0	Biodiversity Information System of Mexico	b324e8e9-9a4c-44fa-8f1a-7f39ea7ab576	2388291e-d210-40f5-be53-5b87ac0806c0
0	400	400	Korean Biodiversity Information Facility	e0a1e772-0177-4800-94b4-2d023fe6cdf4	241198f7-a0fd-4607-85ad-be863069ceaf
0	117	117	Ocean Biodiversity Information System	ba0670b9-4186-41e6-8e70-f9cb3065551a	267d0bb0-1307-49cf-bf05-eacd4bc13770
0	39	39	Plazi	ffb07bec-2d10-492d-9c37-361fe0b79427	2bbc92ef-c6a7-4e7a-8da8-5f542394fda1
410	410	0	GBIF France	da44cd31-5901-4687-a106-6d1c7734ee3a	2c34e57d-c625-4731-88db-b45317027b9b
303	303	0	Plazi	ffb07bec-2d10-492d-9c37-361fe0b79427	2cbf5346-a6be-44bd-b93a-1a7e3e45899c
868	907	39	GBIF France	da44cd31-5901-4687-a106-6d1c7734ee3a	2f23ac81-674e-4e4e-982f-73f49ccdb9df
0	73	73	Ocean Biodiversity Information System	ba0670b9-4186-41e6-8e70-f9cb3065551a	2fa30a14-8bbd-439c-b8a7-8f8c94dc9834
16	16	0	Ocean Biodiversity Information System	ba0670b9-4186-41e6-8e70-f9cb3065551a	301b8cdd-663f-46fc-b0e7-e48f3cd79c27
0	78	78	Participant Node Managers Committee	7f48e0c8-5c96-49ec-b972-30748e339115	37317472-cdb7-4ac2-a510-b577937f18dc
41	41	0	Plazi	ffb07bec-2d10-492d-9c37-361fe0b79427	393a3cb9-e2d8-445f-a2a5-34dcd6168f84
1	1	0	Plazi	ffb07bec-2d10-492d-9c37-361fe0b79427	3a3f858d-4d26-4dfa-80bd-9018ae86db93
0	1	1	Plazi	ffb07bec-2d10-492d-9c37-361fe0b79427	3a41740a-f828-4282-a212-5b876d21da2f
5	5	0	Plazi	ffb07bec-2d10-492d-9c37-361fe0b79427	3bb8c8e6-3c22-406f-b3ac-7a2809a391ed
48	261	213	Colombian Biodiversity Information System	7e865cba-7c46-417b-ade5-97f2cf5b7be0	3be77ee4-3313-4669-a8e8-beb650334e8c
10432	10116	-316	Biodiversity Information System of Mexico	b324e8e9-9a4c-44fa-8f1a-7f39ea7ab576	3c089a4c-c5af-4fa0-b46f-1885036b82f4
26	26	0	Participant Node Managers Committee	7f48e0c8-5c96-49ec-b972-30748e339115	3db35ca0-6ec6-4e11-9cae-1d6d0a4c36c5
568	568	0	Colombian Biodiversity Information System	7e865cba-7c46-417b-ade5-97f2cf5b7be0	42d96803-4890-44ee-b3dc-7979534de46f
8585	8585	0	National Biodiversity Network	d897a5b9-35ee-4232-94bd-b0bcaac003c2	44c73c0b-662e-41e7-8eee-4754a8592a27
0	15	15	Plazi	ffb07bec-2d10-492d-9c37-361fe0b79427	45689462-002e-4c20-be8c-923f89a9da97
4	4	0	Plazi	ffb07bec-2d10-492d-9c37-361fe0b79427	48399970-b4aa-4f89-9739-3644a0f1d596
0	79	79	Plazi	ffb07bec-2d10-492d-9c37-361fe0b79427	4a5c9cb9-9aa6-4fcc-a4cc-561e0551866c
7	7	0	Plazi	ffb07bec-2d10-492d-9c37-361fe0b79427	4af419e9-fd97-4270-ba7c-c5423b72fdba
108	108	0	GBIF Finland	dd514216-5c7c-45f3-910d-797424cb5be6	4c06b9f4-19ad-42c0-b832-17e1b96ba699
0	336	336	Colombian Biodiversity Information System	7e865cba-7c46-417b-ade5-97f2cf5b7be0	4cb361e1-81d2-437c-95eb-ec7772ea1b2d
0	48	48	Ocean Biodiversity Information System	ba0670b9-4186-41e6-8e70-f9cb3065551a	4ffbf1ef-ad3f-4f29-b2ed-0c1d8b118234
0	40	40	Plazi	ffb07bec-2d10-492d-9c37-361fe0b79427	529d48db-4299-4e2d-9aaf-6c4178c08b18
0	107	107	Plazi	ffb07bec-2d10-492d-9c37-361fe0b79427	5378cee4-4671-4527-965e-72b98ab75a68
685	685	0	GBIF France	da44cd31-5901-4687-a106-6d1c7734ee3a	538c6ee9-eb5e-4420-abca-7f1ec1ed443a
0	1	1	Plazi	ffb07bec-2d10-492d-9c37-361fe0b79427	540141ce-6044-48c2-86f4-64c41468fc4a
2	2	0	Plazi	ffb07bec-2d10-492d-9c37-361fe0b79427	545190ca-0bbf-442d-8502-9c839cae794a
16	16	0	GBIF France	da44cd31-5901-4687-a106-6d1c7734ee3a	54734c28-f718-4826-b228-78b566c5e587
110	110	0	National Biodiversity Network	d897a5b9-35ee-4232-94bd-b0bcaac003c2	5513fe62-0b0c-4e8f-970a-dd0cefda23fc
39382	39382	0	National Biodiversity Network	d897a5b9-35ee-4232-94bd-b0bcaac003c2	552346e7-47c0-425c-9fbd-cb0366759db1
0	3	3	Plazi	ffb07bec-2d10-492d-9c37-361fe0b79427	5a39a6a3-b979-475b-acb6-ed87759c8629
139	139	0	Plazi	ffb07bec-2d10-492d-9c37-361fe0b79427	5b73da75-c73d-4433-88c8-e7c2a7f8cff6
248	248	0	Biodiversity Information System of Mexico	b324e8e9-9a4c-44fa-8f1a-7f39ea7ab576	610ea243-6b10-4d44-a6cd-0e12cd6a38bd
77	77	0	GBIF Germany	4f6826f2-4ff6-443d-b966-e6913bd24013	61ec6578-f762-11e1-a439-00145eb45e9a
79	79	0	GBIF Germany	4f6826f2-4ff6-443d-b966-e6913bd24013	626bfee6-f762-11e1-a439-00145eb45e9a
0	2	2	Plazi	ffb07bec-2d10-492d-9c37-361fe0b79427	63a18b74-7e40-466d-868a-477e4008c4ce
102	102	0	GBIF Germany	4f6826f2-4ff6-443d-b966-e6913bd24013	63cd46d2-f762-11e1-a439-00145eb45e9a
38	38	0	GBIF Portugal	673f7038-4262-4149-b753-5658a4e912f6	64704ea2-6caf-40fd-a323-641b536f5152
152	147	-5	GBIF Germany	4f6826f2-4ff6-443d-b966-e6913bd24013	65eeee52-f762-11e1-a439-00145eb45e9a
152	152	0	GBIF Germany	4f6826f2-4ff6-443d-b966-e6913bd24013	6683f8e4-f762-11e1-a439-00145eb45e9a
60	60	0	GBIF Germany	4f6826f2-4ff6-443d-b966-e6913bd24013	66a9b08e-f762-11e1-a439-00145eb45e9a
56	56	0	GBIF Germany	4f6826f2-4ff6-443d-b966-e6913bd24013	66afc276-f762-11e1-a439-00145eb45e9a
169	169	0	GBIF Germany	4f6826f2-4ff6-443d-b966-e6913bd24013	671d75be-f762-11e1-a439-00145eb45e9a
104	104	0	GBIF Germany	4f6826f2-4ff6-443d-b966-e6913bd24013	68654eec-f762-11e1-a439-00145eb45e9a
115	115	0	GBIF Germany	4f6826f2-4ff6-443d-b966-e6913bd24013	6878673e-f762-11e1-a439-00145eb45e9a
1047	1047	0	National Biodiversity Network	d897a5b9-35ee-4232-94bd-b0bcaac003c2	693d4827-5e55-4cef-9ea7-d6194a5fb1d9
196	196	0	GBIF Germany	4f6826f2-4ff6-443d-b966-e6913bd24013	69deca32-f762-11e1-a439-00145eb45e9a
101	101	0	GBIF Germany	4f6826f2-4ff6-443d-b966-e6913bd24013	6a4baea4-f762-11e1-a439-00145eb45e9a
85	85	0	GBIF Germany	4f6826f2-4ff6-443d-b966-e6913bd24013	6aa2a86c-f762-11e1-a439-00145eb45e9a
34	34	0	GBIF Germany	4f6826f2-4ff6-443d-b966-e6913bd24013	6aa3f1a4-f762-11e1-a439-00145eb45e9a
26	26	0	GBIF Germany	4f6826f2-4ff6-443d-b966-e6913bd24013	6c98a4aa-f762-11e1-a439-00145eb45e9a
8	8	0	GBIF Germany	4f6826f2-4ff6-443d-b966-e6913bd24013	6ca54db8-f762-11e1-a439-00145eb45e9a
0	9	9	Plazi	ffb07bec-2d10-492d-9c37-361fe0b79427	6cb6ef09-a25a-42c5-849a-cd404a1d161f
1462	1462	0	GBIF Uganda	71b40829-6a12-4c3d-8fee-5746f5e9cf8c	6cef8c28-b4dd-4082-af20-57cdc660a5bd
0	482	482	Plazi	ffb07bec-2d10-492d-9c37-361fe0b79427	6de1cf29-59a5-4805-8d91-d9bf5bea4f63
4	4	0	Plazi	ffb07bec-2d10-492d-9c37-361fe0b79427	6ef4ad0e-2d1a-498f-b752-3b19c6068c4f
49	49	0	Plazi	ffb07bec-2d10-492d-9c37-361fe0b79427	6f053bf9-e690-4990-87ca-effdf6b3dcd3
67	67	0	GBIF Germany	4f6826f2-4ff6-443d-b966-e6913bd24013	6f9e3476-f762-11e1-a439-00145eb45e9a
499	425	-74	GBIF Germany	4f6826f2-4ff6-443d-b966-e6913bd24013	6fe70ea8-f762-11e1-a439-00145eb45e9a
11	11	0	GBIF Germany	4f6826f2-4ff6-443d-b966-e6913bd24013	7001b262-f762-11e1-a439-00145eb45e9a
31	31	0	GBIF Germany	4f6826f2-4ff6-443d-b966-e6913bd24013	716eb01e-f762-11e1-a439-00145eb45e9a
102	102	0	GBIF Germany	4f6826f2-4ff6-443d-b966-e6913bd24013	71ad9112-f762-11e1-a439-00145eb45e9a
43	43	0	GBIF Germany	4f6826f2-4ff6-443d-b966-e6913bd24013	7244dfd6-f762-11e1-a439-00145eb45e9a
160	160	0	GBIF Germany	4f6826f2-4ff6-443d-b966-e6913bd24013	7272365c-f762-11e1-a439-00145eb45e9a
226	226	0	GBIF Germany	4f6826f2-4ff6-443d-b966-e6913bd24013	72c4013a-f762-11e1-a439-00145eb45e9a
4	4	0	GBIF Germany	4f6826f2-4ff6-443d-b966-e6913bd24013	73602466-f762-11e1-a439-00145eb45e9a
6	6	0	GBIF Germany	4f6826f2-4ff6-443d-b966-e6913bd24013	7382a5c2-f762-11e1-a439-00145eb45e9a
248	248	0	GBIF Germany	4f6826f2-4ff6-443d-b966-e6913bd24013	75035d60-f762-11e1-a439-00145eb45e9a
18	18	0	GBIF Malawi	2a42e4d7-ad4a-41b3-84c4-de4aa7b74d35	783cd211-63ae-41c7-854d-6aa7abd1e2ff
90	10	-80	GBIF Germany	4f6826f2-4ff6-443d-b966-e6913bd24013	7ca677be-f762-11e1-a439-00145eb45e9a
0	10120	10120	Korean Biodiversity Information Facility	e0a1e772-0177-4800-94b4-2d023fe6cdf4	7cd251a3-4b8b-4f7d-86ad-fc3742b3f44a
0	2	2	Plazi	ffb07bec-2d10-492d-9c37-361fe0b79427	7da78f65-24bb-4b7e-b2ad-5f466fb4cff3
1560	1560	0	GBIF Germany	4f6826f2-4ff6-443d-b966-e6913bd24013	7dcbecb4-f762-11e1-a439-00145eb45e9a
0	33641	33641	Colombian Biodiversity Information System	7e865cba-7c46-417b-ade5-97f2cf5b7be0	7e4d62f9-af91-4656-a4a8-5bbc53ad4460
26	26	0	GBIF Germany	4f6826f2-4ff6-443d-b966-e6913bd24013	7f152694-f762-11e1-a439-00145eb45e9a
201	96	-105	GBIF Germany	4f6826f2-4ff6-443d-b966-e6913bd24013	7f2c6fd4-f762-11e1-a439-00145eb45e9a
6417	6417	0	Biodiversity Information System of Mexico	b324e8e9-9a4c-44fa-8f1a-7f39ea7ab576	7f64cabe-f762-11e1-a439-00145eb45e9a
3699	3699	0	Biodiversity Information System of Mexico	b324e8e9-9a4c-44fa-8f1a-7f39ea7ab576	80425e9c-f762-11e1-a439-00145eb45e9a
45	45	0	Biodiversity Information System of Mexico	b324e8e9-9a4c-44fa-8f1a-7f39ea7ab576	80460150-f762-11e1-a439-00145eb45e9a
8577	8575	-2	Biodiversity Information System of Mexico	b324e8e9-9a4c-44fa-8f1a-7f39ea7ab576	80a76dc8-f762-11e1-a439-00145eb45e9a
2000	2000	0	GBIF Japan	db5705aa-6a6e-42f1-8942-d77b9f4896ea	80dcfbe6-f762-11e1-a439-00145eb45e9a
0	11	11	Plazi	ffb07bec-2d10-492d-9c37-361fe0b79427	81959816-3776-4ec5-a2ce-39e71eaa6906
95	95	0	GBIF Germany	4f6826f2-4ff6-443d-b966-e6913bd24013	8271ec0a-f762-11e1-a439-00145eb45e9a
2	2	0	Participant Node Managers Committee	7f48e0c8-5c96-49ec-b972-30748e339115	83aaa4c7-2a96-4677-acc8-e565f14b7595
11009	11009	0	GBIF Peru	46e3639a-27f8-45af-bfbe-d19b77efb040	84b991ca-f762-11e1-a439-00145eb45e9a
1825	1825	0	DanBIF - Danish Biodiversity Information Facility	4ddd294f-02b7-4359-ac33-0806a9ca9c6b	84c333ce-f762-11e1-a439-00145eb45e9a
1270	1270	0	GBIF France	da44cd31-5901-4687-a106-6d1c7734ee3a	856b787f-114b-4f28-b1f6-360e03fdfab5
33	33	0	Plazi	ffb07bec-2d10-492d-9c37-361fe0b79427	85b2cd80-804e-4a02-9d4b-1d8181edb805
1	1	0	Plazi	ffb07bec-2d10-492d-9c37-361fe0b79427	866bda57-1368-47b6-8353-3e5a10e7c610
4149	2820	-1329	GBIF Germany	4f6826f2-4ff6-443d-b966-e6913bd24013	86ede86a-f762-11e1-a439-00145eb45e9a
310	310	0	Plazi	ffb07bec-2d10-492d-9c37-361fe0b79427	87f27ca8-5527-45a3-a570-0db3f60f7d9f
164	164	0	GBIF Germany	4f6826f2-4ff6-443d-b966-e6913bd24013	881e9dce-f762-11e1-a439-00145eb45e9a
155	155	0	GBIF Germany	4f6826f2-4ff6-443d-b966-e6913bd24013	8ac9ad16-f762-11e1-a439-00145eb45e9a
12000	12000	0	GBIF Argentina	2426a871-9feb-40a1-96c6-0c593a76b835	8b04ec7c-7248-4cb4-990d-5957c10b6e9e
20	20	0	GBIF Germany	4f6826f2-4ff6-443d-b966-e6913bd24013	8c6a5b5c-f762-11e1-a439-00145eb45e9a
0	11	11	Plazi	ffb07bec-2d10-492d-9c37-361fe0b79427	8cace22d-738f-4025-84d7-f1c87f065a5e
11	4	-7	GBIF Germany	4f6826f2-4ff6-443d-b966-e6913bd24013	8ceacc6a-f762-11e1-a439-00145eb45e9a
104	72	-32	GBIF Germany	4f6826f2-4ff6-443d-b966-e6913bd24013	8d0f61d8-f762-11e1-a439-00145eb45e9a
601	601	0	GBIF Germany	4f6826f2-4ff6-443d-b966-e6913bd24013	8d7a48ae-f762-11e1-a439-00145eb45e9a
1140	1140	0	GBIF Germany	4f6826f2-4ff6-443d-b966-e6913bd24013	8de6d33e-f762-11e1-a439-00145eb45e9a
130	99	-31	GBIF Germany	4f6826f2-4ff6-443d-b966-e6913bd24013	8dfaea5e-f762-11e1-a439-00145eb45e9a
299	299	0	National Biodiversity Network	d897a5b9-35ee-4232-94bd-b0bcaac003c2	8e704b25-e00c-47d2-8dbc-e388808b24f8
104	99	-5	GBIF Germany	4f6826f2-4ff6-443d-b966-e6913bd24013	8eb0bf3c-f762-11e1-a439-00145eb45e9a
552	391	-161	GBIF Germany	4f6826f2-4ff6-443d-b966-e6913bd24013	8fcb19a8-f762-11e1-a439-00145eb45e9a
4	3	-1	GBIF Germany	4f6826f2-4ff6-443d-b966-e6913bd24013	8ff35a08-f762-11e1-a439-00145eb45e9a
12	9	-3	GBIF Germany	4f6826f2-4ff6-443d-b966-e6913bd24013	90d5a0c0-f762-11e1-a439-00145eb45e9a
5	4	-1	GBIF Germany	4f6826f2-4ff6-443d-b966-e6913bd24013	9189f430-f762-11e1-a439-00145eb45e9a
3	2	-1	GBIF Germany	4f6826f2-4ff6-443d-b966-e6913bd24013	91f86d8e-f762-11e1-a439-00145eb45e9a
316	201	-115	GBIF Germany	4f6826f2-4ff6-443d-b966-e6913bd24013	92a6bdd0-f762-11e1-a439-00145eb45e9a
135	135	0	GBIF Germany	4f6826f2-4ff6-443d-b966-e6913bd24013	931f2f7c-f762-11e1-a439-00145eb45e9a
1680	1680	0	GBIF Germany	4f6826f2-4ff6-443d-b966-e6913bd24013	941d58f4-f762-11e1-a439-00145eb45e9a
30	30	0	GBIF Germany	4f6826f2-4ff6-443d-b966-e6913bd24013	97726cec-f762-11e1-a439-00145eb45e9a
13	13	0	GBIF Germany	4f6826f2-4ff6-443d-b966-e6913bd24013	9777d010-f762-11e1-a439-00145eb45e9a
84	84	0	GBIF Germany	4f6826f2-4ff6-443d-b966-e6913bd24013	9793e4bc-f762-11e1-a439-00145eb45e9a
7	7	0	Plazi	ffb07bec-2d10-492d-9c37-361fe0b79427	989ea711-119d-4f2d-a042-a93b87107b61
19443	19443	0	U.S. Geological Survey	8618c64a-93e0-4300-b546-7249e5148ed2	99cac79f-b9bf-42e5-88bd-68c30a595437
0	69	69	Plazi	ffb07bec-2d10-492d-9c37-361fe0b79427	9a8b6684-f12b-4ea1-8c30-63cdc8539ff1
0	1	1	Ocean Biodiversity Information System	ba0670b9-4186-41e6-8e70-f9cb3065551a	9b582ee8-69a8-4ec5-8194-a114a08536fc
10458	10458	0	National Biodiversity Network	d897a5b9-35ee-4232-94bd-b0bcaac003c2	9df7af7e-e759-4482-8d55-ba24733e5f9b
59236	59236	0	U.S. Geological Survey	8618c64a-93e0-4300-b546-7249e5148ed2	9e02f8f5-ae2f-49b9-b896-ffb0260a284c
146	146	0	Biodiversity Information System of Mexico	b324e8e9-9a4c-44fa-8f1a-7f39ea7ab576	a1f64ea8-7e60-4542-aa6e-7baa09be0d69
372	372	0	GBIF Germany	4f6826f2-4ff6-443d-b966-e6913bd24013	a384b562-0749-46ce-88e8-32924f73c190
15	15	0	Plazi	ffb07bec-2d10-492d-9c37-361fe0b79427	a5168d5b-f2f3-4ca9-be27-cf0a4b3421df
2	2	0	Plazi	ffb07bec-2d10-492d-9c37-361fe0b79427	a5c73910-4b1c-48a1-bbb3-4819fa8e9430
9	9	0	Plazi	ffb07bec-2d10-492d-9c37-361fe0b79427	a6c9a125-4013-4abd-be06-dfb04357b7ee
0	4	4	Plazi	ffb07bec-2d10-492d-9c37-361fe0b79427	a83edd56-bfda-4ee9-b9e0-65f9f3c38d12
17	17	0	Plazi	ffb07bec-2d10-492d-9c37-361fe0b79427	aa4ab61b-5bb7-4a74-857b-e92447ed1425
0	4812	4812	GBIF Portugal	673f7038-4262-4149-b753-5658a4e912f6	aba7811f-91ce-4166-a7a9-13c49587e803
551	183	-368	Biodiversity Information System of Mexico	b324e8e9-9a4c-44fa-8f1a-7f39ea7ab576	abb9972c-8003-464a-89d7-955f10064cae
2545	2628	83	U.S. Geological Survey	8618c64a-93e0-4300-b546-7249e5148ed2	abcaccad-9e01-4b2a-b493-32531cbed32a
0	3	3	Plazi	ffb07bec-2d10-492d-9c37-361fe0b79427	ac1d9ea3-1306-430a-8254-c311fcfb273b
82	82	0	GBIF France	da44cd31-5901-4687-a106-6d1c7734ee3a	af882075-32a6-4ad2-83d5-6d44542b68e7
8	8	0	Plazi	ffb07bec-2d10-492d-9c37-361fe0b79427	b43e8245-124b-466b-8993-22bffdca3a45
0	16	16	Plazi	ffb07bec-2d10-492d-9c37-361fe0b79427	b4cfe27f-245d-40e2-8e3b-7b59463cfa77
0	364	364	Ocean Biodiversity Information System	ba0670b9-4186-41e6-8e70-f9cb3065551a	b5234065-c150-4184-aa2a-2fd94b843e59
0	9	9	Plazi	ffb07bec-2d10-492d-9c37-361fe0b79427	b6d642ba-67fa-4991-bf5d-5583e71f9896
948	948	0	GBIF France	da44cd31-5901-4687-a106-6d1c7734ee3a	b8592b78-94c2-489f-920f-35d717d8009e
0	6	6	Plazi	ffb07bec-2d10-492d-9c37-361fe0b79427	bad29d24-807d-4370-8894-28b2b542db1d
17171	17171	0	National Biodiversity Network	d897a5b9-35ee-4232-94bd-b0bcaac003c2	bd5b5eee-6b5b-48be-b929-2329a3c59746
1	1	0	Plazi	ffb07bec-2d10-492d-9c37-361fe0b79427	bfa42c2c-04fd-4050-8115-74793cc1670e
0	61	61	GBIF New Zealand	4f9fd726-20dd-445e-89a1-8ed93792276f	c023c854-3bc9-43af-af49-c2290b809710
6966	6966	0	Colombian Biodiversity Information System	7e865cba-7c46-417b-ade5-97f2cf5b7be0	c1316d40-133e-485a-aa5b-e62091ebfdf5
1949	1949	0	GBIF Norway	4f829580-180d-46a9-9c87-ed8ec959b545	c1f425be-cf91-4df4-ac10-f48066facf52
551	551	0	National Biodiversity Network	d897a5b9-35ee-4232-94bd-b0bcaac003c2	c2722072-2464-41d0-b82e-adb4ef553550
6173	6173	0	Participant Node Managers Committee	7f48e0c8-5c96-49ec-b972-30748e339115	c32071b2-045f-4468-a288-0eeb51c3f5d6
2	2	0	Plazi	ffb07bec-2d10-492d-9c37-361fe0b79427	c94150fb-babd-4b57-b4f9-82254444e99b
0	44	44	Ocean Biodiversity Information System	ba0670b9-4186-41e6-8e70-f9cb3065551a	ca791b09-cdf5-49ce-ad7b-c3a34a070f0a
2043	2043	0	National Biodiversity Network	d897a5b9-35ee-4232-94bd-b0bcaac003c2	caaa42a1-5956-41cd-9b79-94baf0ed8b32
0	10	10	Plazi	ffb07bec-2d10-492d-9c37-361fe0b79427	cbeabb5d-61b6-4e3b-b00a-dc66893e0bc8
2	2	0	Plazi	ffb07bec-2d10-492d-9c37-361fe0b79427	cd07c5fc-96bc-4431-9a6f-241fe3affb4b
4	4	0	Participant Node Managers Committee	7f48e0c8-5c96-49ec-b972-30748e339115	d05b86b9-9a15-401c-a3fb-0233ebc4afd3
39	39	0	Colombian Biodiversity Information System	7e865cba-7c46-417b-ade5-97f2cf5b7be0	d261442b-a9fc-480c-9ebc-b1607c17b9bc
0	4	4	Plazi	ffb07bec-2d10-492d-9c37-361fe0b79427	d34ef9e9-8aa8-48ce-bc42-a57fd4cf9032
27	27	0	Plazi	ffb07bec-2d10-492d-9c37-361fe0b79427	d3fbd48f-3e09-410f-915b-3f1aeccd73e2
1	1	0	Plazi	ffb07bec-2d10-492d-9c37-361fe0b79427	d429375c-c6bc-421f-9d0c-2dd8c427d682
24786	24786	0	Netherlands Biodiversity Information Facility	0909d601-bda2-42df-9e63-a6d51847ebce	da90017f-41d6-4bfa-a7bc-af50c80e90a2
0	2	2	Plazi	ffb07bec-2d10-492d-9c37-361fe0b79427	db652516-0bba-4fde-9f67-3f518841dddc
21	21	0	GBIF Malawi	2a42e4d7-ad4a-41b3-84c4-de4aa7b74d35	dddc21b3-9ad6-46fa-871a-86eefaabc38d
10	10	0	Plazi	ffb07bec-2d10-492d-9c37-361fe0b79427	e007fb73-f0f6-448b-9c34-94b59e3ee695
272910	272910	0	GBIF France	da44cd31-5901-4687-a106-6d1c7734ee3a	e110bdcf-81f6-4d3b-b7e8-fe12ed94e3e3
498	498	0	GBIF Benin	efb9c00e-f802-45dd-8826-a52ec45b89ff	e1fc23b5-0ef7-4510-8026-67a83305d1d9
0	16	16	Colombian Biodiversity Information System	7e865cba-7c46-417b-ade5-97f2cf5b7be0	e3c09ba2-d9cd-494d-9080-3122be400162
705	705	0	GBIF Germany	4f6826f2-4ff6-443d-b966-e6913bd24013	e701177f-baa9-433c-a7b6-0d19d552e36c
9	9	0	Plazi	ffb07bec-2d10-492d-9c37-361fe0b79427	e7983c67-0ce5-4b7f-9373-8782b86e059b
117904	117904	0	National Biodiversity Network	d897a5b9-35ee-4232-94bd-b0bcaac003c2	e888b05a-cd6b-4b00-bee6-dc185d9e8c24
0	288	288	Colombian Biodiversity Information System	7e865cba-7c46-417b-ade5-97f2cf5b7be0	e9316c8c-f57d-4e31-b9b8-633dd2ac53b6
24905	24905	0	Participant Node Managers Committee	7f48e0c8-5c96-49ec-b972-30748e339115	eb95d204-6391-4b03-9602-7dfdfffd4f49
235089	235814	725	U.S. Geological Survey	8618c64a-93e0-4300-b546-7249e5148ed2	eccf4b09-f0c8-462d-a48c-41a7ce36815a
0	3	3	Plazi	ffb07bec-2d10-492d-9c37-361fe0b79427	ed601617-c371-412c-8dbb-828a253726b2
3888	3889	1	GBIF Norway	4f829580-180d-46a9-9c87-ed8ec959b545	edaf95d8-2c34-4792-8170-04d7c79a5a89
1120	1120	0	GBIF France	da44cd31-5901-4687-a106-6d1c7734ee3a	f240817c-23f3-4a8f-b32e-97833663fd4d
183	200	17	National Biodiversity Network	d897a5b9-35ee-4232-94bd-b0bcaac003c2	f24cb6bb-8333-4ce1-9fdf-71bd3bec0ff6
122	122	0	GBIF France	da44cd31-5901-4687-a106-6d1c7734ee3a	f298a93b-5b19-428f-b078-889d44531396
93	93	0	National Biodiversity Network	d897a5b9-35ee-4232-94bd-b0bcaac003c2	f6384b4e-64c0-4d0d-b080-a3f7cc3ae745
182	182	0	GBIF Sweden	a0b3be64-6525-4387-ac67-a499950f92e1	fa65300a-060c-430f-91d0-4b79550f04c4
42	42	0	Plazi	ffb07bec-2d10-492d-9c37-361fe0b79427	fcc0d0d7-7644-4242-af38-b01eb270f8cc
115	115	0	Plazi	ffb07bec-2d10-492d-9c37-361fe0b79427	fcd8b13d-0c2c-40ea-9053-8b6c1b3b5a47
0	2	2	Plazi	ffb07bec-2d10-492d-9c37-361fe0b79427	fd22468d-37ba-4056-806f-2d12af30bdf0
0	8	8	Plazi	ffb07bec-2d10-492d-9c37-361fe0b79427	fe34d562-8dde-4905-9845-93d5224cdaa1
0	32	32	Plazi	ffb07bec-2d10-492d-9c37-361fe0b79427	fed4a06f-7511-4cb0-82de-218f7a6dd132
1	1	0	Plazi	ffb07bec-2d10-492d-9c37-361fe0b79427	ffebf990-da85-4f28-b57a-56f43bb29ccb
2294	2294	0	South African Biodiversity Information Facility	7190b835-4e86-4b6e-85c1-19cc6677c250	0081d6b8-9c38-49ee-8355-f5a118cc0876
0	240679	240679	GBIF Sweden	a0b3be64-6525-4387-ac67-a499950f92e1	02a4348e-69b2-4b8c-a474-79361ef37e3c
0	285	285	GBIF Benin	efb9c00e-f802-45dd-8826-a52ec45b89ff	0496122f-8430-488b-bf78-64debf9cc2e4
0	25	25	Ocean Biodiversity Information System	ba0670b9-4186-41e6-8e70-f9cb3065551a	090fc836-9152-4f2c-b546-48ec5dd4b6ec
279	279	0	Colombian Biodiversity Information System	7e865cba-7c46-417b-ade5-97f2cf5b7be0	09bbd7cb-afe7-4c98-a2a9-1f1081a82d19
51	51	0	Plazi	ffb07bec-2d10-492d-9c37-361fe0b79427	0acb8deb-e98b-4f39-bae1-2900dd4b21f6
15	15	0	Plazi	ffb07bec-2d10-492d-9c37-361fe0b79427	0e77b7f6-1f66-419f-ac40-0af683c6a574
14414	14414	0	GBIF Argentina	2426a871-9feb-40a1-96c6-0c593a76b835	0f116646-70d3-4aa2-b428-6971623a285f
0	15	15	Plazi	ffb07bec-2d10-492d-9c37-361fe0b79427	113e013b-fc98-4a18-8e30-c8056c1e1493
15	15	0	Belgian Biodiversity Platform	fb11cfe1-ebc3-45af-9159-17d9fddbcdac	13505587-6ed4-4a92-b9d6-067f99cfa41f
21	22	1	Plazi	ffb07bec-2d10-492d-9c37-361fe0b79427	142a25ed-47c3-4361-bc24-6f1b3e8dba5c
14705	21897	7192	Symbiota Support Hub	612b5a0b-908b-4b4e-b9bf-ca15dfdc94fa	14aff274-bf79-4a74-86ce-fb8b115adbf3
15	15	0	GBIF Togo	c9659a3e-07e9-4fcb-83c6-de8b9009a02e	16019640-147f-4249-8d02-f40bfe7a3c1b
5	5	0	Plazi	ffb07bec-2d10-492d-9c37-361fe0b79427	1e1ebe03-19d2-4515-9730-c330a36b74c4
3	3	0	Plazi	ffb07bec-2d10-492d-9c37-361fe0b79427	1ef79202-f1d6-4072-9f50-49ed3784fc7a
27	27	0	Plazi	ffb07bec-2d10-492d-9c37-361fe0b79427	1f84a7e2-7d98-4857-ba28-f79bb43d7415
11802	11802	0	Atlas of Living Australia	4a6f1b71-969e-4fc5-a693-282b05e1220c	2002f5f5-a2b6-43ee-bcc7-44811ae22acb
0	121	121	Participant Node Managers Committee	7f48e0c8-5c96-49ec-b972-30748e339115	21038b89-b495-455a-8cfd-575e844973a4
1	1	0	Plazi	ffb07bec-2d10-492d-9c37-361fe0b79427	22608c9c-0c23-4c3b-aeca-c3d813683aeb
0	85	85	Ocean Biodiversity Information System	ba0670b9-4186-41e6-8e70-f9cb3065551a	2479e1b4-3658-4ebb-97ca-8fbd86961002
813	813	0	Colombian Biodiversity Information System	7e865cba-7c46-417b-ade5-97f2cf5b7be0	24b5d45f-2349-4c99-a20b-c676cf2f533d
11851	11851	0	GBIF Brazil	cdc9736d-5ff7-4ece-9959-3c744360cdb3	25d9c44f-9a42-4292-85ca-c4118198d76c
0	3	3	Plazi	ffb07bec-2d10-492d-9c37-361fe0b79427	26d7022f-7867-4adf-b786-ec9d2ce6e67a
11	11	0	Plazi	ffb07bec-2d10-492d-9c37-361fe0b79427	2870ed42-271b-4ee7-8776-d3804c806fb1
2	2	0	Plazi	ffb07bec-2d10-492d-9c37-361fe0b79427	289ca390-345b-40e4-b93e-164962bb277d
20440	20440	0	GBIF France	da44cd31-5901-4687-a106-6d1c7734ee3a	29c1d93e-fff9-45c8-8b28-5761b2bcdf64
0	380	380	GBIF Japan	db5705aa-6a6e-42f1-8942-d77b9f4896ea	2df73c5a-da8b-4d04-a6ab-bfb22d9727d7
0	2	2	Plazi	ffb07bec-2d10-492d-9c37-361fe0b79427	2fba929b-0394-4145-b5c8-7900fa821bbe
100	100	0	GBIF Germany	4f6826f2-4ff6-443d-b966-e6913bd24013	3047a42a-2874-4fe8-ba2a-2789ffc6b48f
50	50	0	Belgian Biodiversity Platform	fb11cfe1-ebc3-45af-9159-17d9fddbcdac	333c25de-9bf0-42d5-99f6-16170ba8f04f
35	35	0	GBIF Spain	1f94b3ca-9345-4d65-afe2-4bace93aa0fe	34b5f4ce-bbbe-43b8-a82e-4a6e2791fa77
1	1	0	Plazi	ffb07bec-2d10-492d-9c37-361fe0b79427	34ec33c6-cfff-4879-bd5d-f9c4072dafb7
1260	1260	0	GBIF Norway	4f829580-180d-46a9-9c87-ed8ec959b545	36526979-9f6a-47c3-8ca8-b286b8899729
973	973	0	U.S. Geological Survey	8618c64a-93e0-4300-b546-7249e5148ed2	375eb3fe-af43-4d37-815a-d8bd891e8ca5
8	8	0	Plazi	ffb07bec-2d10-492d-9c37-361fe0b79427	39071d6f-d900-4c81-ace1-dd03875018c5
1264	1264	0	GBIF Kenya	2a44d626-9f7a-4120-8a7a-4ab5ac15ff2a	399c081a-7237-4363-9299-6d731637d314
159	159	0	GBIF Sweden	a0b3be64-6525-4387-ac67-a499950f92e1	3b3c90c6-9eeb-4470-a54e-2b672ae4fa9b
172421	172421	0	GBIF Sweden	a0b3be64-6525-4387-ac67-a499950f92e1	3b88fd26-936c-4fe7-bbb7-684ba6264cf1
0	10	10	Plazi	ffb07bec-2d10-492d-9c37-361fe0b79427	3d55327c-e5d5-402b-aa7d-c537505e2876
0	3	3	Plazi	ffb07bec-2d10-492d-9c37-361fe0b79427	3e366419-f283-4f6b-aa2d-0b7618d37908
0	1	1	Plazi	ffb07bec-2d10-492d-9c37-361fe0b79427	3f41eee8-0ca7-409b-b828-75d100b0f218
900	900	0	Ghana Biodiversity Information Facility	b5633b75-6a86-4fdf-9cfc-506047fb9dc7	40a262b4-6627-4011-afbe-159c00ec97e7
71313	71313	0	Atlas of Living Australia	4a6f1b71-969e-4fc5-a693-282b05e1220c	433e55fe-a408-46f8-8184-dd4e33e4782f
0	41	41	Ocean Biodiversity Information System	ba0670b9-4186-41e6-8e70-f9cb3065551a	44454d64-7ecf-4e5e-bbdf-50c3c45bb708
229	229	0	GBIF New Zealand	4f9fd726-20dd-445e-89a1-8ed93792276f	44839329-fa4d-468d-9da0-39739a2d0b63
0	1	1	Plazi	ffb07bec-2d10-492d-9c37-361fe0b79427	4807be22-d46a-461b-ae64-1d63d6acae3f
583	583	0	GBIF Benin	efb9c00e-f802-45dd-8826-a52ec45b89ff	4aaa8072-3711-4668-8276-deef01ad29bc
51	51	0	GBIF France	da44cd31-5901-4687-a106-6d1c7734ee3a	4da1a6d5-48c0-42f8-af2c-01d0f5af8826
79773	79773	0	National Biodiversity Network	d897a5b9-35ee-4232-94bd-b0bcaac003c2	4e7820a7-1958-4fc2-bce4-3c71ab4475f8
747	747	0	Participant Node Managers Committee	7f48e0c8-5c96-49ec-b972-30748e339115	57b0a989-1e6b-4b49-ab8a-8aed98b98ef0
0	2	2	Plazi	ffb07bec-2d10-492d-9c37-361fe0b79427	59e0113f-90f0-4cc7-a332-7a8c7269435b
10	10	0	Plazi	ffb07bec-2d10-492d-9c37-361fe0b79427	5a9f4750-4b2a-47f1-b2ea-ce2550eaec80
4	4	0	Plazi	ffb07bec-2d10-492d-9c37-361fe0b79427	5b03347b-4db9-473a-84c4-d653cfea6b6c
1575	1575	0	Atlas of Living Australia	4a6f1b71-969e-4fc5-a693-282b05e1220c	5d243972-6de3-4917-abfc-a2cd0c8438a9
16128	16128	0	GBIF France	da44cd31-5901-4687-a106-6d1c7734ee3a	5e989c66-59f9-4dfa-9c76-d1502d2051d4
39766	39766	0	GBIF Israel	8cb55387-7802-40e8-86d6-d357a583c596	5f4c1155-2025-4e96-9ba0-896b712f6841
0	50	50	Colombian Biodiversity Information System	7e865cba-7c46-417b-ade5-97f2cf5b7be0	5f647492-7aee-4c5e-8a95-fc6ef54b54ce
129	129	0	Korean Biodiversity Information Facility	e0a1e772-0177-4800-94b4-2d023fe6cdf4	5fdae206-58ec-4b7a-a27e-8b761d6713bc
207	207	0	U.S. Geological Survey	8618c64a-93e0-4300-b546-7249e5148ed2	60526e0c-6ef7-4610-9027-e604d448b959
270	270	0	GBIF Germany	4f6826f2-4ff6-443d-b966-e6913bd24013	6173ab24-f762-11e1-a439-00145eb45e9a
18	18	0	GBIF Germany	4f6826f2-4ff6-443d-b966-e6913bd24013	61c06cd4-f762-11e1-a439-00145eb45e9a
53	53	0	GBIF Germany	4f6826f2-4ff6-443d-b966-e6913bd24013	62249ae2-f762-11e1-a439-00145eb45e9a
87	87	0	GBIF Germany	4f6826f2-4ff6-443d-b966-e6913bd24013	624258b6-f762-11e1-a439-00145eb45e9a
24124	40283	16159	Belgian Biodiversity Platform	fb11cfe1-ebc3-45af-9159-17d9fddbcdac	63938753-1fec-4c08-ae39-e9f8a6576521
0	226	226	Plazi	ffb07bec-2d10-492d-9c37-361fe0b79427	63986af4-a04f-47f6-a9db-983b7474acd1
272	272	0	GBIF Germany	4f6826f2-4ff6-443d-b966-e6913bd24013	639a59ac-f762-11e1-a439-00145eb45e9a
119	119	0	GBIF Germany	4f6826f2-4ff6-443d-b966-e6913bd24013	63eb4164-f762-11e1-a439-00145eb45e9a
261	261	0	GBIF Germany	4f6826f2-4ff6-443d-b966-e6913bd24013	64a34a34-f762-11e1-a439-00145eb45e9a
52	52	0	GBIF Germany	4f6826f2-4ff6-443d-b966-e6913bd24013	64de20e6-f762-11e1-a439-00145eb45e9a
181	181	0	GBIF Germany	4f6826f2-4ff6-443d-b966-e6913bd24013	665d0fe0-f762-11e1-a439-00145eb45e9a
84140	84140	0	U.S. Geological Survey	8618c64a-93e0-4300-b546-7249e5148ed2	675bbffd-ff44-4b8a-a1b9-d520ec9220c9
717	717	0	GBIF Germany	4f6826f2-4ff6-443d-b966-e6913bd24013	6978c688-f762-11e1-a439-00145eb45e9a
13	13	0	Plazi	ffb07bec-2d10-492d-9c37-361fe0b79427	6abb9acd-8867-41c1-9258-d57acc5c54d5
34	34	0	GBIF Germany	4f6826f2-4ff6-443d-b966-e6913bd24013	6abf85c2-f762-11e1-a439-00145eb45e9a
18	18	0	GBIF Germany	4f6826f2-4ff6-443d-b966-e6913bd24013	6badbbca-f762-11e1-a439-00145eb45e9a
318	318	0	GBIF Germany	4f6826f2-4ff6-443d-b966-e6913bd24013	70d92fc4-a39e-40b5-b19a-8b248af6ef36
46	46	0	Plazi	ffb07bec-2d10-492d-9c37-361fe0b79427	712a6136-5d6c-4505-8a8a-3d0556e146c1
755	755	0	GBIF Germany	4f6826f2-4ff6-443d-b966-e6913bd24013	71352dd0-f762-11e1-a439-00145eb45e9a
62	62	0	GBIF Germany	4f6826f2-4ff6-443d-b966-e6913bd24013	7144698a-f762-11e1-a439-00145eb45e9a
69	69	0	GBIF Germany	4f6826f2-4ff6-443d-b966-e6913bd24013	71538d48-f762-11e1-a439-00145eb45e9a
0	1013	1013	Ocean Biodiversity Information System	ba0670b9-4186-41e6-8e70-f9cb3065551a	72d8d09f-b831-406c-ab20-2447a284fbd8
5585	7235	1650	Colombian Biodiversity Information System	7e865cba-7c46-417b-ade5-97f2cf5b7be0	72fa796a-29c3-4805-86c3-9380be2cc5a9
9	9	0	GBIF Germany	4f6826f2-4ff6-443d-b966-e6913bd24013	7374caba-f762-11e1-a439-00145eb45e9a
106	106	0	GBIF Germany	4f6826f2-4ff6-443d-b966-e6913bd24013	73c30d06-f762-11e1-a439-00145eb45e9a
0	3	3	Participant Node Managers Committee	7f48e0c8-5c96-49ec-b972-30748e339115	75882e6c-ac94-4154-8835-0539431a3f30
54874	54874	0	Netherlands Biodiversity Information Facility	0909d601-bda2-42df-9e63-a6d51847ebce	758afb5f-11c9-44f8-8bff-294169123910
145	145	0	GBIF Germany	4f6826f2-4ff6-443d-b966-e6913bd24013	75b73218-f762-11e1-a439-00145eb45e9a
25	25	0	GBIF Norway	4f829580-180d-46a9-9c87-ed8ec959b545	787e8928-0088-42f4-8922-1ba5ecd4fa5d
0	175	175	Ocean Biodiversity Information System	ba0670b9-4186-41e6-8e70-f9cb3065551a	7a81e0d8-e0d9-451a-bbbd-f8026d630f70
76	76	0	Korean Biodiversity Information Facility	e0a1e772-0177-4800-94b4-2d023fe6cdf4	7ae7ea52-f762-11e1-a439-00145eb45e9a
60000	60000	0	Korean Biodiversity Information Facility	e0a1e772-0177-4800-94b4-2d023fe6cdf4	7b1b0b8a-f762-11e1-a439-00145eb45e9a
46	46	0	Ocean Biodiversity Information System	ba0670b9-4186-41e6-8e70-f9cb3065551a	7b579758-f762-11e1-a439-00145eb45e9a
114	114	0	Ocean Biodiversity Information System	ba0670b9-4186-41e6-8e70-f9cb3065551a	7b6697b2-f762-11e1-a439-00145eb45e9a
4	4	0	Participant Node Managers Committee	7f48e0c8-5c96-49ec-b972-30748e339115	7b9521ef-988f-45eb-9c89-b8528a7debc1
0	1712	1712	Participant Node Managers Committee	7f48e0c8-5c96-49ec-b972-30748e339115	7c056eac-7921-46ac-99a7-74136e746566
25	25	0	GBIF France	da44cd31-5901-4687-a106-6d1c7734ee3a	7c480996-e4c8-4829-9fe3-b2d5d8ec6f23
1017	1017	0	GBIF Germany	4f6826f2-4ff6-443d-b966-e6913bd24013	7c4b98a8-f762-11e1-a439-00145eb45e9a
495	495	0	GBIF Germany	4f6826f2-4ff6-443d-b966-e6913bd24013	7d551486-f762-11e1-a439-00145eb45e9a
120	120	0	Plazi	ffb07bec-2d10-492d-9c37-361fe0b79427	7de9a197-47f0-467f-9a99-c20252990df4
7	7	0	Plazi	ffb07bec-2d10-492d-9c37-361fe0b79427	80715276-706f-4d06-a8c2-49e32c03f155
32341	32341	0	Biodiversity Information System of Mexico	b324e8e9-9a4c-44fa-8f1a-7f39ea7ab576	80d3003c-f762-11e1-a439-00145eb45e9a
96	96	0	GBIF Germany	4f6826f2-4ff6-443d-b966-e6913bd24013	817ec28c-f762-11e1-a439-00145eb45e9a
15787	16019	232	U.S. Geological Survey	8618c64a-93e0-4300-b546-7249e5148ed2	854f602e-f762-11e1-a439-00145eb45e9a
15895	15895	0	GBIF Japan	db5705aa-6a6e-42f1-8942-d77b9f4896ea	85b8ed3c-f762-11e1-a439-00145eb45e9a
3	3	0	GBIF Germany	4f6826f2-4ff6-443d-b966-e6913bd24013	85df9d6a-f762-11e1-a439-00145eb45e9a
0	43	43	Ocean Biodiversity Information System	ba0670b9-4186-41e6-8e70-f9cb3065551a	863732f2-4f5a-4774-b906-243db7c2f2bf
4	4	0	GBIF Germany	4f6826f2-4ff6-443d-b966-e6913bd24013	863dd268-f762-11e1-a439-00145eb45e9a
764	383	-381	GBIF Germany	4f6826f2-4ff6-443d-b966-e6913bd24013	86db6d2a-f762-11e1-a439-00145eb45e9a
33	33	0	Plazi	ffb07bec-2d10-492d-9c37-361fe0b79427	876d1781-7086-46ee-b7d6-94753804c4b2
29	29	0	Plazi	ffb07bec-2d10-492d-9c37-361fe0b79427	87920495-c1bf-4bdb-b153-50e709c1d6c2
4703	4703	0	Atlas of Living Australia	4a6f1b71-969e-4fc5-a693-282b05e1220c	87dcc098-729a-4444-8f0f-4c2971fe07e5
352	352	0	Plazi	ffb07bec-2d10-492d-9c37-361fe0b79427	8922450e-b0c1-4951-b591-5f1b5bc60965
582	252	-330	GBIF Germany	4f6826f2-4ff6-443d-b966-e6913bd24013	8950cec4-f762-11e1-a439-00145eb45e9a
0	1	1	Plazi	ffb07bec-2d10-492d-9c37-361fe0b79427	8961efc4-38a4-45ca-ae96-7dc85da95579
148	148	0	GBIF Germany	4f6826f2-4ff6-443d-b966-e6913bd24013	8a8bde64-f762-11e1-a439-00145eb45e9a
10	10	0	GBIF Germany	4f6826f2-4ff6-443d-b966-e6913bd24013	8c0d629e-f762-11e1-a439-00145eb45e9a
10	10	0	GBIF Germany	4f6826f2-4ff6-443d-b966-e6913bd24013	8c19e532-f762-11e1-a439-00145eb45e9a
158	90	-68	GBIF Germany	4f6826f2-4ff6-443d-b966-e6913bd24013	8e01a132-f762-11e1-a439-00145eb45e9a
11	10	-1	GBIF Germany	4f6826f2-4ff6-443d-b966-e6913bd24013	901cdf54-f762-11e1-a439-00145eb45e9a
0	2	2	Plazi	ffb07bec-2d10-492d-9c37-361fe0b79427	90755edb-c4d1-4009-8a2b-69b7d930ca55
82	57	-25	GBIF Germany	4f6826f2-4ff6-443d-b966-e6913bd24013	90d6eb9c-f762-11e1-a439-00145eb45e9a
3	3	0	Plazi	ffb07bec-2d10-492d-9c37-361fe0b79427	924564d3-af90-47f9-8759-1e82331f6d50
286	286	0	Participant Node Managers Committee	7f48e0c8-5c96-49ec-b972-30748e339115	927f03b1-58ad-4f3c-80a1-e171eac2d5de
18	18	0	Plazi	ffb07bec-2d10-492d-9c37-361fe0b79427	92a8f55c-4685-49d4-9bfd-3e216898cf85
275	126	-149	GBIF Germany	4f6826f2-4ff6-443d-b966-e6913bd24013	92e62484-f762-11e1-a439-00145eb45e9a
9	3	-6	GBIF Germany	4f6826f2-4ff6-443d-b966-e6913bd24013	9353bc60-f762-11e1-a439-00145eb45e9a
2254	2254	0	GBIF France	da44cd31-5901-4687-a106-6d1c7734ee3a	93554762-c2cf-4ee4-a475-7d1d4dc01372
98	92	-6	GBIF Germany	4f6826f2-4ff6-443d-b966-e6913bd24013	936f2478-f762-11e1-a439-00145eb45e9a
779	779	0	Atlas of Living Australia	4a6f1b71-969e-4fc5-a693-282b05e1220c	9419c0b3-4c23-40de-b96d-c4e55a23975e
863	848	-15	GBIF Germany	4f6826f2-4ff6-443d-b966-e6913bd24013	9527efa2-f762-11e1-a439-00145eb45e9a
1863	1863	0	U.S. Geological Survey	8618c64a-93e0-4300-b546-7249e5148ed2	958892f6-fa60-40ab-8906-939922aa7d7d
5	5	0	GBIF Japan	db5705aa-6a6e-42f1-8942-d77b9f4896ea	9622906c-39e1-4470-8e55-388d3fe76c21
5951	5951	0	GBIF Germany	4f6826f2-4ff6-443d-b966-e6913bd24013	967aaef8-f762-11e1-a439-00145eb45e9a
34958	34958	0	GBIF Spain	1f94b3ca-9345-4d65-afe2-4bace93aa0fe	96b7961a-f762-11e1-a439-00145eb45e9a
0	6	6	Plazi	ffb07bec-2d10-492d-9c37-361fe0b79427	9700f576-7d61-4139-9565-64b7d017398c
10086	6419	-3667	GBIF Germany	4f6826f2-4ff6-443d-b966-e6913bd24013	97339f44-f762-11e1-a439-00145eb45e9a
106	89	-17	GBIF Germany	4f6826f2-4ff6-443d-b966-e6913bd24013	97891f46-f762-11e1-a439-00145eb45e9a
1660	1554	-106	GBIF Germany	4f6826f2-4ff6-443d-b966-e6913bd24013	98493a48-b025-4553-809b-d7a719d6ea77
27919	27919	0	GBIF Norway	4f829580-180d-46a9-9c87-ed8ec959b545	99006141-bf02-4821-8e6e-5818a1cbf70a
0	22	22	Ocean Biodiversity Information System	ba0670b9-4186-41e6-8e70-f9cb3065551a	99ed4beb-56d6-45af-8d4d-d59abe08bfe2
3	3	0	Plazi	ffb07bec-2d10-492d-9c37-361fe0b79427	9e2df405-b944-451a-ad2c-7192b06127f4
0	197	197	Plazi	ffb07bec-2d10-492d-9c37-361fe0b79427	a1bfbb3c-ae2d-46cf-9eb6-16aaf974ea61
138	138	0	Belgian Biodiversity Platform	fb11cfe1-ebc3-45af-9159-17d9fddbcdac	a48f262e-caeb-4531-bedb-fdd0553473b9
9	9	0	Plazi	ffb07bec-2d10-492d-9c37-361fe0b79427	a9a98949-5409-4048-87fc-17b11dc8541f
1216	1216	0	GBIF Germany	4f6826f2-4ff6-443d-b966-e6913bd24013	aaf83068-2078-4fbb-a72f-df8cb0b3adf6
415	415	0	Colombian Biodiversity Information System	7e865cba-7c46-417b-ade5-97f2cf5b7be0	ab3a79c9-be6c-4897-8d80-a3db2ec32bb5
84	84	0	Plazi	ffb07bec-2d10-492d-9c37-361fe0b79427	ace23a37-5877-4fc2-b7dd-650ac154b98f
86	86	0	Plazi	ffb07bec-2d10-492d-9c37-361fe0b79427	ad669f25-a6a1-4680-9089-5f28d28e8b0d
3853	3520	-333	GBIF Germany	4f6826f2-4ff6-443d-b966-e6913bd24013	af0f8bca-b57d-4b82-9781-8e3ea1c92b8f
4520	4520	0	GBIF France	da44cd31-5901-4687-a106-6d1c7734ee3a	b11b04b1-1e1e-4cc0-9881-af1b31cd0f2f
27	27	0	Plazi	ffb07bec-2d10-492d-9c37-361fe0b79427	b2889c0a-756a-472b-afff-233337b6e02d
2	2	0	Plazi	ffb07bec-2d10-492d-9c37-361fe0b79427	b70b739a-4fa3-45a6-968e-cc1cf44c66a2
6792	6792	0	National Biodiversity Network	d897a5b9-35ee-4232-94bd-b0bcaac003c2	ba84601e-4470-4de5-ae07-02431ac322ab
3027	3027	0	National Biodiversity Network	d897a5b9-35ee-4232-94bd-b0bcaac003c2	bb7283bc-6215-4c30-b640-2266c579d50f
10205	10205	0	Polish Biodiversity Information Network	2618bfdf-e194-4911-a241-80db3107bc51	bd246610-0e2d-11de-b8e6-b8a03c50a862
23620	23620	0	National Biodiversity Network	d897a5b9-35ee-4232-94bd-b0bcaac003c2	bd8b945c-6eb4-4301-b6f1-2f4c8047d0ff
5	5	0	Plazi	ffb07bec-2d10-492d-9c37-361fe0b79427	bf542573-c115-40ad-8555-851a6d17717d
0	385	385	Colombian Biodiversity Information System	7e865cba-7c46-417b-ade5-97f2cf5b7be0	c2c66348-860e-4591-af13-db3c6adff043
0	17	17	Plazi	ffb07bec-2d10-492d-9c37-361fe0b79427	c3db82b1-ba26-4152-83be-e672680bc875
7	7	0	Plazi	ffb07bec-2d10-492d-9c37-361fe0b79427	c4ffa296-a21f-43b9-9771-771e507e2f9e
2	2	0	Plazi	ffb07bec-2d10-492d-9c37-361fe0b79427	ca61e3d0-1902-4916-8627-03a7ea812b36
5	5	0	Plazi	ffb07bec-2d10-492d-9c37-361fe0b79427	cc55fb33-81c6-4a12-901a-e58eb7ff53fd
9	9	0	Plazi	ffb07bec-2d10-492d-9c37-361fe0b79427	ccd461dd-0e67-4533-a992-27055444ed35
0	6	6	Ocean Biodiversity Information System	ba0670b9-4186-41e6-8e70-f9cb3065551a	cd8a2e94-d295-42bf-b9fb-dd95d37a7c6d
10	10	0	Plazi	ffb07bec-2d10-492d-9c37-361fe0b79427	cec7be2f-355f-40ae-ab3b-85961ed769da
96290	96290	0	Colombian Biodiversity Information System	7e865cba-7c46-417b-ade5-97f2cf5b7be0	cf8f886b-7289-4d59-9cb1-f2d293147d98
1086	1086	0	GBIF Germany	4f6826f2-4ff6-443d-b966-e6913bd24013	cf910a71-5c97-40b9-b10c-7d9a1eca2c85
0	13	13	Plazi	ffb07bec-2d10-492d-9c37-361fe0b79427	d23af9df-f41f-492c-a123-2a497f38ec7b
2154	2154	0	U.S. Geological Survey	8618c64a-93e0-4300-b546-7249e5148ed2	d271ae38-a8eb-46d5-875a-2a851818785d
5092	5092	0	National Biodiversity Network	d897a5b9-35ee-4232-94bd-b0bcaac003c2	d2b75a96-369e-4273-8d1c-f8e5e591caf9
11	11	0	GBIF France	da44cd31-5901-4687-a106-6d1c7734ee3a	d3db9304-260d-43a4-8da6-6c83ec2977bc
0	13	13	Plazi	ffb07bec-2d10-492d-9c37-361fe0b79427	d5243f20-ae1f-4562-9bb0-8607d6794b07
308	392	84	Colombian Biodiversity Information System	7e865cba-7c46-417b-ade5-97f2cf5b7be0	d5474422-7025-41bb-a78d-19127c0106b2
180	180	0	GBIF France	da44cd31-5901-4687-a106-6d1c7734ee3a	d637bead-2374-4dba-a751-96eb3a83b8cc
765	765	0	GBIF France	da44cd31-5901-4687-a106-6d1c7734ee3a	d7c67c84-38f6-472b-85f4-8162dbab2938
0	2	2	Plazi	ffb07bec-2d10-492d-9c37-361fe0b79427	d80b22a7-06b9-4f3d-925b-892a7788fb26
0	3	3	Plazi	ffb07bec-2d10-492d-9c37-361fe0b79427	da478d9e-effb-40d1-9def-b604423f8fb6
2284	2284	0	Biodiversity Information System of Mexico	b324e8e9-9a4c-44fa-8f1a-7f39ea7ab576	db6e18ea-16cb-4047-a261-1488c8ea3317
3456	3456	0	National Biodiversity Network	d897a5b9-35ee-4232-94bd-b0bcaac003c2	ddba492c-057c-473d-8139-38eff66ad347
0	1	1	Plazi	ffb07bec-2d10-492d-9c37-361fe0b79427	def1e7d3-1656-4b07-83b4-aff5996c1054
2036	2036	0	Colombian Biodiversity Information System	7e865cba-7c46-417b-ade5-97f2cf5b7be0	df863040-ea71-49c2-940a-b346abe0a7b6
0	8	8	Plazi	ffb07bec-2d10-492d-9c37-361fe0b79427	e0537405-a0a5-4079-a875-4d0a95d18762
24093	24093	0	National Biodiversity Network	d897a5b9-35ee-4232-94bd-b0bcaac003c2	e3d81244-4408-46a4-a88f-690cb19f44e9
27	27	0	Participant Node Managers Committee	7f48e0c8-5c96-49ec-b972-30748e339115	e5e13b4c-e903-4507-9f00-47d764c2fe16
23295	23296	1	U.S. Geological Survey	8618c64a-93e0-4300-b546-7249e5148ed2	e6033178-5da4-411d-91cf-457683f28b3d
0	3	3	Plazi	ffb07bec-2d10-492d-9c37-361fe0b79427	e9fc53d8-015c-487a-9ac6-48cfe710f8ae
1	1	0	Plazi	ffb07bec-2d10-492d-9c37-361fe0b79427	ea64b4c1-1fbc-43ac-b953-317c5d19e3e4
17	17	0	GBIF Viet Nam	7f4b5eab-2edf-4b46-9360-d9574ab0f1d7	eac5c6f9-74cf-4aee-b74a-38cbd4946cee
7539	7539	0	Secretariat of the Pacific Regional Environment Programme	29c6a139-ea7f-41f5-8d9b-c55af8736182	ed7d4c25-b00a-4b7f-b84b-1f5286bfba8f
182	182	0	GBIF Germany	4f6826f2-4ff6-443d-b966-e6913bd24013	f1106060-6797-4234-91df-980128aa7155
11	11	0	Plazi	ffb07bec-2d10-492d-9c37-361fe0b79427	f15563b6-3180-4918-b8cd-86e2d240850c
11	11	0	Plazi	ffb07bec-2d10-492d-9c37-361fe0b79427	f155c619-ee05-44b6-a8b1-feb851ca1af5
3120	384325	381205	Taiwan Biodiversity Information Facility	e1b85abc-61f9-430f-ba79-6813dec53a0f	f170f056-3f8a-4ef3-ac9f-4503cc854ce0
1815	1815	0	Colombian Biodiversity Information System	7e865cba-7c46-417b-ade5-97f2cf5b7be0	f1caac33-15ac-4185-90df-aec093abc0cd
173	173	0	Participant Node Managers Committee	7f48e0c8-5c96-49ec-b972-30748e339115	f2233580-f8f7-434b-af11-7a88cf4ded21
256	256	0	Colombian Biodiversity Information System	7e865cba-7c46-417b-ade5-97f2cf5b7be0	f248c45a-97da-4ed2-b89c-b47c9a885f3c
2	2	0	Plazi	ffb07bec-2d10-492d-9c37-361fe0b79427	f39c8458-583b-4bc4-bc9a-b26d7c0c4e73
6	6	0	GBIF France	da44cd31-5901-4687-a106-6d1c7734ee3a	f3dbf642-253c-459e-9cf2-1ec069d1333e
0	4	4	Plazi	ffb07bec-2d10-492d-9c37-361fe0b79427	f4727393-7d2b-4850-9ff6-6650c9e3168a
188801	188801	0	GBIF Switzerland	169eb292-376b-4cc6-8e31-9c2c432de0ad	f577c9f3-ae71-4278-b6bf-512ba1dfaa21
159	159	0	Plazi	ffb07bec-2d10-492d-9c37-361fe0b79427	f5a96f72-1549-41e7-9cf7-f282c66d73b6
4837	4837	0	GBIF Argentina	2426a871-9feb-40a1-96c6-0c593a76b835	f750f213-77c6-467e-9434-35e167d4845c
6	6	0	Participant Node Managers Committee	7f48e0c8-5c96-49ec-b972-30748e339115	fa9028ea-da44-4cc9-af9e-ba2ff3c8b20d
1	1	0	Plazi	ffb07bec-2d10-492d-9c37-361fe0b79427	faa7e22e-b9ff-44b2-aae4-601c7360356a
1842	1842	0	Biodiversity Information System of Mexico	b324e8e9-9a4c-44fa-8f1a-7f39ea7ab576	fb74bb66-8f7c-4d13-bed0-c8e46725c54e
12654	12654	0	Taiwan Biodiversity Information Facility	e1b85abc-61f9-430f-ba79-6813dec53a0f	fb93fb10-f1ca-11dd-b2d4-b8a03c50a862
0	861	861	Ocean Biodiversity Information System	ba0670b9-4186-41e6-8e70-f9cb3065551a	fbd321be-0dd6-466b-8bb3-701ea697dfcf
4	4	0	Plazi	ffb07bec-2d10-492d-9c37-361fe0b79427	fbeb026f-5afd-48d9-a72f-11a08f25b401
4	4	0	Plazi	ffb07bec-2d10-492d-9c37-361fe0b79427	fccfd522-fba1-4a1a-9001-ae641be6941a
4793	4793	0	GBIF France	da44cd31-5901-4687-a106-6d1c7734ee3a	fefbe340-ee56-44ad-98c5-50549d78a82d
1	1	0	Plazi	ffb07bec-2d10-492d-9c37-361fe0b79427	00b5bbcb-ca5d-495d-a502-615a5d6e5c06
216	216	0	Colombian Biodiversity Information System	7e865cba-7c46-417b-ade5-97f2cf5b7be0	01536750-8af5-430c-b0e2-077dee7f7d5f
0	4	4	Plazi	ffb07bec-2d10-492d-9c37-361fe0b79427	0189bddc-fc52-4ee3-a359-1e1a9981ad3e
751	767	16	GBIF Germany	4f6826f2-4ff6-443d-b966-e6913bd24013	08af8a57-3933-436c-af7d-b227314cc27a
144	144	0	GBIF France	da44cd31-5901-4687-a106-6d1c7734ee3a	09763705-ad11-4aa6-8892-b253ac0ca015
1827	1827	0	GBIF France	da44cd31-5901-4687-a106-6d1c7734ee3a	0b90d9d1-4825-4917-9665-04d2014fa794
0	1587	1587	GBIF Argentina	2426a871-9feb-40a1-96c6-0c593a76b835	0c839b4b-6db2-4d4b-9478-3b213b2e3d4e
1127	1127	0	National Biodiversity Network	d897a5b9-35ee-4232-94bd-b0bcaac003c2	0e8e2667-4077-4f28-be3b-01de631049e5
117	117	0	GBIF France	da44cd31-5901-4687-a106-6d1c7734ee3a	13d55bc2-2ea8-4adc-8fb1-6044ff59b211
77	77	0	Plazi	ffb07bec-2d10-492d-9c37-361fe0b79427	15784c76-41dc-47a2-aad7-db1b284033d1
15	15	0	Plazi	ffb07bec-2d10-492d-9c37-361fe0b79427	1645ea42-4c26-466d-9be8-c22bf3c12c45
0	22	22	Ocean Biodiversity Information System	ba0670b9-4186-41e6-8e70-f9cb3065551a	1c61952a-9c15-48cc-b3c4-f3d541e45ab2
4	4	0	Plazi	ffb07bec-2d10-492d-9c37-361fe0b79427	1c9fc5e7-070b-49e4-b5f6-51521b1f3489
8	8	0	Plazi	ffb07bec-2d10-492d-9c37-361fe0b79427	1d472e8c-2bef-43f1-9b95-d2ca2914fc7b
8172	8172	0	GBIF Madagascar	2dbfc5c5-51b5-4494-9dfc-4d3f013a3b64	22cd931a-95ab-4b68-be6c-e0eff9365eae
0	650166	650166	Canada Biodiversity Information Facility	8f83fc96-c966-4126-83f7-bf044dc49efa	240f38f1-ada4-4eac-a9b5-28dd8308d01d
0	8	8	Plazi	ffb07bec-2d10-492d-9c37-361fe0b79427	24100a7d-89d7-4618-8578-5716026788a1
324442	295043	-29399	Atlas of Living Australia	4a6f1b71-969e-4fc5-a693-282b05e1220c	270c3da6-45ad-4272-804b-33ac7ee33421
4	4	0	Plazi	ffb07bec-2d10-492d-9c37-361fe0b79427	274931a7-8e98-4744-bfae-4786a3035976
1490	1490	0	GBIF Germany	4f6826f2-4ff6-443d-b966-e6913bd24013	28a69e1c-0f2a-40f0-a0df-a646fbc57343
5	5	0	Plazi	ffb07bec-2d10-492d-9c37-361fe0b79427	29033971-cc71-44ce-9a46-9ab104d684ea
422	422	0	Plazi	ffb07bec-2d10-492d-9c37-361fe0b79427	2c8355fa-af80-4a52-be9a-a3c36a99bb19
2520	2520	0	GBIF Norway	4f829580-180d-46a9-9c87-ed8ec959b545	2d674c8e-958a-486a-a130-250af425c222
4	4	0	Plazi	ffb07bec-2d10-492d-9c37-361fe0b79427	2febe8b5-9bed-4434-80cc-2271c2b2de38
116	116	0	GBIF France	da44cd31-5901-4687-a106-6d1c7734ee3a	32ba223a-0c17-46f0-b1e5-244eeefa8839
372	372	0	Colombian Biodiversity Information System	7e865cba-7c46-417b-ade5-97f2cf5b7be0	33d52667-27bd-45fd-b710-2854751aac72
25754	25754	0	Biodiversity Information System of Mexico	b324e8e9-9a4c-44fa-8f1a-7f39ea7ab576	3420d094-6fe4-4df8-a119-86a7506751a2
67	67	0	GBIF France	da44cd31-5901-4687-a106-6d1c7734ee3a	34e956c7-6c96-4923-b7e7-e68370270a9a
993	993	0	National Biodiversity Network	d897a5b9-35ee-4232-94bd-b0bcaac003c2	3a71ec83-4f75-4416-9f3e-aa5b0766b474
462	462	0	GBIF Germany	4f6826f2-4ff6-443d-b966-e6913bd24013	3d725a18-dd38-42fe-bd4b-1aa81381930a
0	12	12	Plazi	ffb07bec-2d10-492d-9c37-361fe0b79427	3f04dd66-d3bc-43e2-af6b-db2dd50e9dac
9	9	0	Plazi	ffb07bec-2d10-492d-9c37-361fe0b79427	43234c4b-40c9-4d1b-aa5f-51d222a421b2
1283	2247	964	Colombian Biodiversity Information System	7e865cba-7c46-417b-ade5-97f2cf5b7be0	4346356a-8773-4205-95ce-57d3541017d4
3712	3712	0	GBIF Chile	a8b16421-d80b-4ef3-8f22-098b01a89255	45385b93-1542-40b7-8d6e-9f44bd626cbe
3969	3969	0	Ocean Biodiversity Information System	ba0670b9-4186-41e6-8e70-f9cb3065551a	4900fa23-93ef-41ae-80bb-e58119b7ba0d
4	4	0	Plazi	ffb07bec-2d10-492d-9c37-361fe0b79427	499ae33e-f149-4d64-af49-63a601515778
0	3	3	Plazi	ffb07bec-2d10-492d-9c37-361fe0b79427	4a156dee-882e-498f-bc2e-ffc48189c915
8887	8899	12	GBIF France	da44cd31-5901-4687-a106-6d1c7734ee3a	4b6f0569-9925-4a42-84a0-7d4ff5d13593
4	4	0	Plazi	ffb07bec-2d10-492d-9c37-361fe0b79427	4edbdeb0-1bf3-40f0-b739-3efe9e466e23
374	327	-47	GBIF Germany	4f6826f2-4ff6-443d-b966-e6913bd24013	4f573df4-c333-4b89-b3d5-03c3a58112de
57	57	0	Plazi	ffb07bec-2d10-492d-9c37-361fe0b79427	4fc4ef80-e5fe-4572-9a8e-af55c5ad5fbc
1	1	0	Plazi	ffb07bec-2d10-492d-9c37-361fe0b79427	50360293-505b-4f3d-a566-863db157ac3d
7	7	0	Plazi	ffb07bec-2d10-492d-9c37-361fe0b79427	51e70785-9816-4582-a138-ac29d95eb692
7	7	0	Plazi	ffb07bec-2d10-492d-9c37-361fe0b79427	54a4f350-fb99-4729-a787-40400335f0d2
3893	3893	0	Ocean Biodiversity Information System	ba0670b9-4186-41e6-8e70-f9cb3065551a	54dd1589-f730-4c64-a891-06f2f25f71b1
588	588	0	GBIF France	da44cd31-5901-4687-a106-6d1c7734ee3a	5841a257-8f7d-433f-8882-5a10e10fd7e3
10	10	0	Plazi	ffb07bec-2d10-492d-9c37-361fe0b79427	5855c0d5-b127-4703-b7fe-73f6a0e0ec63
0	827	827	Ocean Biodiversity Information System	ba0670b9-4186-41e6-8e70-f9cb3065551a	59cc6219-c920-47ce-babc-581679f8e074
34	34	0	Plazi	ffb07bec-2d10-492d-9c37-361fe0b79427	5f73d28a-b9b5-4297-91c5-e14ce6f4db0b
141	141	0	GBIF Germany	4f6826f2-4ff6-443d-b966-e6913bd24013	624be94e-f762-11e1-a439-00145eb45e9a
1	1	0	Plazi	ffb07bec-2d10-492d-9c37-361fe0b79427	62fd4290-8788-43d7-869a-5f28f2a95149
18	18	0	GBIF Germany	4f6826f2-4ff6-443d-b966-e6913bd24013	632dded0-f762-11e1-a439-00145eb45e9a
15	15	0	GBIF Germany	4f6826f2-4ff6-443d-b966-e6913bd24013	632f2042-f762-11e1-a439-00145eb45e9a
2	2	0	GBIF Germany	4f6826f2-4ff6-443d-b966-e6913bd24013	633ea97c-f762-11e1-a439-00145eb45e9a
61	61	0	GBIF Germany	4f6826f2-4ff6-443d-b966-e6913bd24013	6342b404-f762-11e1-a439-00145eb45e9a
70	70	0	GBIF Sweden	a0b3be64-6525-4387-ac67-a499950f92e1	63ff531e-8d81-4224-9478-cf2054c38ab1
177	177	0	GBIF Germany	4f6826f2-4ff6-443d-b966-e6913bd24013	644dc3e8-f762-11e1-a439-00145eb45e9a
114	114	0	GBIF Germany	4f6826f2-4ff6-443d-b966-e6913bd24013	659f8bc8-f762-11e1-a439-00145eb45e9a
12	12	0	GBIF Germany	4f6826f2-4ff6-443d-b966-e6913bd24013	666ce6c2-f762-11e1-a439-00145eb45e9a
127	127	0	GBIF Germany	4f6826f2-4ff6-443d-b966-e6913bd24013	667cc452-f762-11e1-a439-00145eb45e9a
120	120	0	GBIF Germany	4f6826f2-4ff6-443d-b966-e6913bd24013	66b75a40-f762-11e1-a439-00145eb45e9a
0	2	2	Plazi	ffb07bec-2d10-492d-9c37-361fe0b79427	6742c1a0-276f-46fe-8c1e-f123ed9934eb
77	77	0	GBIF Germany	4f6826f2-4ff6-443d-b966-e6913bd24013	67691eb0-f762-11e1-a439-00145eb45e9a
58	58	0	GBIF Germany	4f6826f2-4ff6-443d-b966-e6913bd24013	69053d80-f762-11e1-a439-00145eb45e9a
31	31	0	GBIF Germany	4f6826f2-4ff6-443d-b966-e6913bd24013	693dff3a-f762-11e1-a439-00145eb45e9a
96	96	0	GBIF Germany	4f6826f2-4ff6-443d-b966-e6913bd24013	6994566e-f762-11e1-a439-00145eb45e9a
140	140	0	GBIF Germany	4f6826f2-4ff6-443d-b966-e6913bd24013	69d334ba-f762-11e1-a439-00145eb45e9a
24	24	0	GBIF Germany	4f6826f2-4ff6-443d-b966-e6913bd24013	6b2139e8-f762-11e1-a439-00145eb45e9a
12	12	0	GBIF Germany	4f6826f2-4ff6-443d-b966-e6913bd24013	6bc473ec-f762-11e1-a439-00145eb45e9a
1389	1389	0	GBIF Germany	4f6826f2-4ff6-443d-b966-e6913bd24013	6c2ad86c-f762-11e1-a439-00145eb45e9a
3	3	0	Plazi	ffb07bec-2d10-492d-9c37-361fe0b79427	6e52ae42-2048-42d4-995a-a52543b75059
1173	1173	0	GBIF Germany	4f6826f2-4ff6-443d-b966-e6913bd24013	6f304cfe-f762-11e1-a439-00145eb45e9a
100	100	0	GBIF Germany	4f6826f2-4ff6-443d-b966-e6913bd24013	6ff8d2c8-f762-11e1-a439-00145eb45e9a
36	36	0	Plazi	ffb07bec-2d10-492d-9c37-361fe0b79427	707c349d-ff40-4444-ab0b-b48d51c70460
34	34	0	Plazi	ffb07bec-2d10-492d-9c37-361fe0b79427	708e152e-4450-4439-84a9-3c56148cd082
127	127	0	GBIF Germany	4f6826f2-4ff6-443d-b966-e6913bd24013	70c07bde-f762-11e1-a439-00145eb45e9a
34	34	0	GBIF Germany	4f6826f2-4ff6-443d-b966-e6913bd24013	73c7159a-f762-11e1-a439-00145eb45e9a
118	118	0	GBIF Germany	4f6826f2-4ff6-443d-b966-e6913bd24013	73d52e1e-f762-11e1-a439-00145eb45e9a
18	18	0	GBIF Germany	4f6826f2-4ff6-443d-b966-e6913bd24013	7424ff0c-f762-11e1-a439-00145eb45e9a
145	145	0	GBIF Germany	4f6826f2-4ff6-443d-b966-e6913bd24013	74b7ecf4-f762-11e1-a439-00145eb45e9a
40	40	0	GBIF Norway	4f829580-180d-46a9-9c87-ed8ec959b545	75e53d5f-0531-4076-8bd2-0400ee219805
0	1	1	Plazi	ffb07bec-2d10-492d-9c37-361fe0b79427	75ff5869-1000-489e-82f0-4e672de0fb42
0	3	3	Ocean Biodiversity Information System	ba0670b9-4186-41e6-8e70-f9cb3065551a	76046617-0e8a-4bea-9317-10c5702dbaf0
30	30	0	GBIF Germany	4f6826f2-4ff6-443d-b966-e6913bd24013	7842722c-f762-11e1-a439-00145eb45e9a
114	114	0	GBIF Germany	4f6826f2-4ff6-443d-b966-e6913bd24013	791488d4-f762-11e1-a439-00145eb45e9a
38	33	-5	GBIF Germany	4f6826f2-4ff6-443d-b966-e6913bd24013	796f41f2-f762-11e1-a439-00145eb45e9a
0	2583	2583	Participant Node Managers Committee	7f48e0c8-5c96-49ec-b972-30748e339115	79a2fbbd-a1fc-4f1f-a5af-9c3a6ad398db
1	1	0	Plazi	ffb07bec-2d10-492d-9c37-361fe0b79427	7d280ef6-f662-4882-ad04-2f3b08d8548c
0	4	4	Plazi	ffb07bec-2d10-492d-9c37-361fe0b79427	7dc8160d-98f9-4c8a-8382-994e97b7d71f
132	132	0	GBIF Germany	4f6826f2-4ff6-443d-b966-e6913bd24013	7dfe71de-f762-11e1-a439-00145eb45e9a
396	386	-10	Biodiversity Information System of Mexico	b324e8e9-9a4c-44fa-8f1a-7f39ea7ab576	7faf940e-f762-11e1-a439-00145eb45e9a
11	11	0	GBIF Germany	4f6826f2-4ff6-443d-b966-e6913bd24013	800489ed-b266-4c34-8495-355537068fb1
1009	1009	0	Biodiversity Information System of Mexico	b324e8e9-9a4c-44fa-8f1a-7f39ea7ab576	8056a0e6-f762-11e1-a439-00145eb45e9a
4475	4475	0	Biodiversity Information System of Mexico	b324e8e9-9a4c-44fa-8f1a-7f39ea7ab576	80a3729a-f762-11e1-a439-00145eb45e9a
138	124	-14	GBIF Germany	4f6826f2-4ff6-443d-b966-e6913bd24013	818775a8-f762-11e1-a439-00145eb45e9a
458	458	0	GBIF France	da44cd31-5901-4687-a106-6d1c7734ee3a	8241988a-ed52-4933-a007-44019a763134
2755	2755	0	National Biodiversity Network	d897a5b9-35ee-4232-94bd-b0bcaac003c2	83102903-4ab9-4c33-8e49-38f9eca6f550
466734	466734	0	Ocean Biodiversity Information System	ba0670b9-4186-41e6-8e70-f9cb3065551a	83ae75fc-f762-11e1-a439-00145eb45e9a
4	4	0	Plazi	ffb07bec-2d10-492d-9c37-361fe0b79427	83f9be2a-feb1-4c79-b0bc-194af1e20258
301	301	0	Colombian Biodiversity Information System	7e865cba-7c46-417b-ade5-97f2cf5b7be0	842b7289-c374-4056-8329-19b418e559e1
18	18	0	GBIF Germany	4f6826f2-4ff6-443d-b966-e6913bd24013	844b0ce3-e460-4a83-9726-2efa1ddccb55
40	40	0	GBIF Germany	4f6826f2-4ff6-443d-b966-e6913bd24013	851602bd-a9eb-48c0-9f3b-1fa13babbd85
2	2	0	Plazi	ffb07bec-2d10-492d-9c37-361fe0b79427	851d1f38-f621-4f26-8fd4-40d3a6976b2e
18	18	0	Colombian Biodiversity Information System	7e865cba-7c46-417b-ade5-97f2cf5b7be0	853b94ac-43aa-407c-abdf-f9dde211e758
6627	6627	0	World Federation for Culture Collections	a6bdc523-5368-4e0f-9d2e-de1c262ac092	8552b53a-f762-11e1-a439-00145eb45e9a
263	197	-66	GBIF Germany	4f6826f2-4ff6-443d-b966-e6913bd24013	8784ca5a-f762-11e1-a439-00145eb45e9a
1784	1561	-223	GBIF Germany	4f6826f2-4ff6-443d-b966-e6913bd24013	87c89e60-f762-11e1-a439-00145eb45e9a
2673	2376	-297	GBIF Germany	4f6826f2-4ff6-443d-b966-e6913bd24013	896667de-f762-11e1-a439-00145eb45e9a
518	518	0	GBIF Germany	4f6826f2-4ff6-443d-b966-e6913bd24013	89af6b5a-f762-11e1-a439-00145eb45e9a
124	124	0	GBIF Germany	4f6826f2-4ff6-443d-b966-e6913bd24013	8a538438-f762-11e1-a439-00145eb45e9a
147	147	0	Plazi	ffb07bec-2d10-492d-9c37-361fe0b79427	8bb17a01-6ca6-4225-a42c-be3cb22e3db0
10	10	0	GBIF Germany	4f6826f2-4ff6-443d-b966-e6913bd24013	8c14f586-f762-11e1-a439-00145eb45e9a
20	14	-6	GBIF Germany	4f6826f2-4ff6-443d-b966-e6913bd24013	8c641e18-f762-11e1-a439-00145eb45e9a
0	34	34	Plazi	ffb07bec-2d10-492d-9c37-361fe0b79427	8ddb8ab6-2231-4eee-a1b1-ffcff5185129
2130	2130	0	GBIF Madagascar	2dbfc5c5-51b5-4494-9dfc-4d3f013a3b64	8df1c385-d564-465a-8c82-49c3e75d6090
343	307	-36	GBIF Germany	4f6826f2-4ff6-443d-b966-e6913bd24013	8dfc55e2-f762-11e1-a439-00145eb45e9a
1364	1116	-248	GBIF Germany	4f6826f2-4ff6-443d-b966-e6913bd24013	8f000402-f762-11e1-a439-00145eb45e9a
1018	548	-470	GBIF Germany	4f6826f2-4ff6-443d-b966-e6913bd24013	8fc22d52-f762-11e1-a439-00145eb45e9a
90	90	0	GBIF Spain	1f94b3ca-9345-4d65-afe2-4bace93aa0fe	90da14b1-1be6-4cb1-b4a9-da87300b7cba
316	542	226	National Biodiversity Network	d897a5b9-35ee-4232-94bd-b0bcaac003c2	90ed39e5-8f88-421c-a89d-cdcdcbfef392
756	756	0	GBIF Germany	4f6826f2-4ff6-443d-b966-e6913bd24013	921abd62-f762-11e1-a439-00145eb45e9a
7	7	0	GBIF Germany	4f6826f2-4ff6-443d-b966-e6913bd24013	936c9dc0-f762-11e1-a439-00145eb45e9a
1	1	0	GBIF Germany	4f6826f2-4ff6-443d-b966-e6913bd24013	939af990-f762-11e1-a439-00145eb45e9a
191	191	0	GBIF France	da44cd31-5901-4687-a106-6d1c7734ee3a	990649d4-fc41-4823-8d4e-8e0a7939b591
0	7	7	Colombian Biodiversity Information System	7e865cba-7c46-417b-ade5-97f2cf5b7be0	9adf83f9-a92a-4f1e-9b27-7cf3cbcf1f93
149	149	0	GBIF France	da44cd31-5901-4687-a106-6d1c7734ee3a	9be798a2-5d45-4d76-8d59-b801f0a427ac
255	255	0	GBIF France	da44cd31-5901-4687-a106-6d1c7734ee3a	9d727432-b397-4958-9c3b-7fdd02dfec3c
861	861	0	Biodiversity Information System of Mexico	b324e8e9-9a4c-44fa-8f1a-7f39ea7ab576	9dee772f-2fbf-43d4-a278-3a2d9385e3f4
17505	17505	0	National Biodiversity Network	d897a5b9-35ee-4232-94bd-b0bcaac003c2	9e749f1b-3da9-4864-b7d0-1aab92c18342
324	324	0	Netherlands Biodiversity Information Facility	0909d601-bda2-42df-9e63-a6d51847ebce	9f67b8e1-25dc-4316-83c1-e0795e1b29d9
0	1	1	Plazi	ffb07bec-2d10-492d-9c37-361fe0b79427	9fd3fb60-b7ba-454a-bb0a-40aaaa5dad4b
0	2	2	Ocean Biodiversity Information System	ba0670b9-4186-41e6-8e70-f9cb3065551a	a054336f-e498-4789-92ee-3aae6e1f9891
2	2	0	Plazi	ffb07bec-2d10-492d-9c37-361fe0b79427	a12b585f-992c-4105-a40f-9a165bfc0788
0	6	6	Plazi	ffb07bec-2d10-492d-9c37-361fe0b79427	a416516e-a6f0-4fab-9e3c-1b50abe53f1e
83	83	0	Plazi	ffb07bec-2d10-492d-9c37-361fe0b79427	a899bf77-8412-4dc6-94cd-90aa47efa462
0	23	23	Plazi	ffb07bec-2d10-492d-9c37-361fe0b79427	a89deaac-3274-4c55-8b30-fc70d5a6e56f
1058	1058	0	Biodiversity Information System of Mexico	b324e8e9-9a4c-44fa-8f1a-7f39ea7ab576	a9c1249d-773f-4bf2-bbd1-3802a3a7f3ea
0	31	31	U.S. Geological Survey	8618c64a-93e0-4300-b546-7249e5148ed2	aa0ce746-9b9e-4948-92cf-80b38ed289f0
3	3	0	Plazi	ffb07bec-2d10-492d-9c37-361fe0b79427	aa7fd103-8318-4cc4-9e3d-0e83b95adcb0
123	153	30	U.S. Geological Survey	8618c64a-93e0-4300-b546-7249e5148ed2	aca0fb62-58f7-4d4e-b4a4-2ec485448490
1893	1893	0	Ghana Biodiversity Information Facility	b5633b75-6a86-4fdf-9cfc-506047fb9dc7	acb08fed-85f6-482e-a8a5-f04b253ddfb8
143	143	0	GBIF France	da44cd31-5901-4687-a106-6d1c7734ee3a	ad2898c2-a82e-46f2-9e6e-e3872d728dcc
0	2	2	Plazi	ffb07bec-2d10-492d-9c37-361fe0b79427	adcee87d-bfbb-4404-9abb-9d4e078166c9
0	120	120	Ocean Biodiversity Information System	ba0670b9-4186-41e6-8e70-f9cb3065551a	aff92d5b-17d0-4137-bdb3-3cbe8decf9cd
19	19	0	Plazi	ffb07bec-2d10-492d-9c37-361fe0b79427	b145ae84-fdf7-4bee-a1ce-da40f55ff58d
6	6	0	Plazi	ffb07bec-2d10-492d-9c37-361fe0b79427	b1e16a53-5007-4f56-ac45-926d4f729fbe
0	1888	1888	Colombian Biodiversity Information System	7e865cba-7c46-417b-ade5-97f2cf5b7be0	b2fb610d-a9e8-4b84-9a39-757bbf562d2b
37	37	0	GBIF New Zealand	4f9fd726-20dd-445e-89a1-8ed93792276f	b34fca67-16b0-482d-87f3-2620cc1477b3
137	137	0	GBIF France	da44cd31-5901-4687-a106-6d1c7734ee3a	b47d7d74-dabb-42f0-a7b8-31501d153621
0	2	2	Plazi	ffb07bec-2d10-492d-9c37-361fe0b79427	b6ef714d-a627-4d76-ad99-eb415f5762cd
7	7	0	Plazi	ffb07bec-2d10-492d-9c37-361fe0b79427	b732f1bc-50fa-422e-b9e2-7f21c2626144
9811	9811	0	GBIF France	da44cd31-5901-4687-a106-6d1c7734ee3a	b83e514a-48fa-4ec2-a516-29e48bb9488c
125	125	0	Colombian Biodiversity Information System	7e865cba-7c46-417b-ade5-97f2cf5b7be0	ba94c52c-70b2-4b8a-a91c-1fc78fe8fbde
1066	1066	0	GBIF Norway	4f829580-180d-46a9-9c87-ed8ec959b545	bbf196d7-fe61-4941-8080-4a8cd7c4f126
1257	1257	0	GBIF France	da44cd31-5901-4687-a106-6d1c7734ee3a	c17268a5-7aa6-4877-9019-aaa45f210c81
3	3	0	Plazi	ffb07bec-2d10-492d-9c37-361fe0b79427	c1ec7d18-049a-493a-91fe-fab34dd2cc4c
2166	2166	0	National Biodiversity Data Centre	422b00b2-6c94-4bb6-976b-c359916efdb8	c35d6000-c7b8-11de-b279-9fe72ba677dc
29	29	0	Plazi	ffb07bec-2d10-492d-9c37-361fe0b79427	c47ff596-c049-46e1-b6c6-d0cd9ded095e
79141	79141	0	Netherlands Biodiversity Information Facility	0909d601-bda2-42df-9e63-a6d51847ebce	cb429b64-d789-47bb-a7d8-379657c5e407
0	198	198	Plazi	ffb07bec-2d10-492d-9c37-361fe0b79427	ce43ff05-bbcd-4d0a-af20-313db664517e
3	3	0	Plazi	ffb07bec-2d10-492d-9c37-361fe0b79427	ce5435dc-3b0d-4db1-b78f-ec9d8e50abe1
0	153	153	Plazi	ffb07bec-2d10-492d-9c37-361fe0b79427	d0614f63-670a-4220-a1c1-5fe9c15d3e4a
0	2	2	Plazi	ffb07bec-2d10-492d-9c37-361fe0b79427	d28ddaf8-3b50-46bb-89a4-0e325e35b705
46	46	0	Plazi	ffb07bec-2d10-492d-9c37-361fe0b79427	d40d94a8-75f5-486c-a377-6c1c7ba067dc
891	891	0	Colombian Biodiversity Information System	7e865cba-7c46-417b-ade5-97f2cf5b7be0	d52b82ef-d3b9-47e3-802b-5725659812a6
0	555	555	Ocean Biodiversity Information System	ba0670b9-4186-41e6-8e70-f9cb3065551a	d5b8f2bb-520e-4741-9b6e-e88b4c3eff97
14	14	0	Plazi	ffb07bec-2d10-492d-9c37-361fe0b79427	d946e671-4329-46d1-bffc-646fe2572ddd
24	24	0	GBIF France	da44cd31-5901-4687-a106-6d1c7734ee3a	da3b3af7-6414-4f1a-a9d5-3ea160a7e3b5
19	19	0	Plazi	ffb07bec-2d10-492d-9c37-361fe0b79427	dad6cdac-7a9e-4fe1-acf5-6d83fa65bbe7
503	503	0	GBIF Nigeria	6529bcb5-a542-4fda-be87-54a624515335	dbf97ebc-f931-4b99-8b3b-6fb1375b21bb
455	455	0	Biodiversity Information System of Mexico	b324e8e9-9a4c-44fa-8f1a-7f39ea7ab576	dd1c0ad1-ad9b-49c3-8783-aa5c9b66e75d
266400	266400	0	GBIF Spain	1f94b3ca-9345-4d65-afe2-4bace93aa0fe	dfddad59-5bc5-4e35-8b35-334eed43bba9
0	7	7	Plazi	ffb07bec-2d10-492d-9c37-361fe0b79427	e0e68c24-5845-4be0-b649-545944d2aefe
329	329	0	Ocean Biodiversity Information System	ba0670b9-4186-41e6-8e70-f9cb3065551a	e13faa2d-3cd9-4716-aeb1-1a489d9b69b4
2337	2770	433	Participant Node Managers Committee	7f48e0c8-5c96-49ec-b972-30748e339115	e373b7c1-aaf0-4398-9c5b-43b96d721d47
4512	4512	0	GBIF Finland	dd514216-5c7c-45f3-910d-797424cb5be6	e4e37ec6-c30b-4663-8752-14b6f74b231e
0	2	2	Plazi	ffb07bec-2d10-492d-9c37-361fe0b79427	e658290c-0e30-4782-acd0-85ae534b5207
72307	72307	0	Atlas of Living Australia	4a6f1b71-969e-4fc5-a693-282b05e1220c	e8443518-d916-47aa-9ae9-405333745b66
71	71	0	GBIF Brazil	cdc9736d-5ff7-4ece-9959-3c744360cdb3	e9f3638b-a222-488e-aa58-7f13ae54e718
0	12	12	Ocean Biodiversity Information System	ba0670b9-4186-41e6-8e70-f9cb3065551a	ebf1c823-bb60-44fd-ab47-22cb621080cc
0	13723	13723	Ocean Biodiversity Information System	ba0670b9-4186-41e6-8e70-f9cb3065551a	ecbef00d-f672-4384-ac81-497f11a2858e
33	33	0	GBIF Germany	4f6826f2-4ff6-443d-b966-e6913bd24013	ee01f4a1-a2ed-4d64-9d52-cbc52732036d
479	479	0	Colombian Biodiversity Information System	7e865cba-7c46-417b-ade5-97f2cf5b7be0	f05fbc1c-36d7-4a23-9266-dd2093c55bfb
491	491	0	National Biodiversity Network	d897a5b9-35ee-4232-94bd-b0bcaac003c2	f5477e1b-bd64-4725-823c-4e4f548b3ec7
376	376	0	Biodiversity Information System of Mexico	b324e8e9-9a4c-44fa-8f1a-7f39ea7ab576	f933bc72-4600-4201-8454-c85cf0c48545
1287	1287	0	GBIF Argentina	2426a871-9feb-40a1-96c6-0c593a76b835	faf8b3c3-21dc-48b6-8a5c-e1f037789f74
0	4	4	Plazi	ffb07bec-2d10-492d-9c37-361fe0b79427	ffb607f0-c1ab-4398-acf2-cb84fbbf9c37
0	3	3	Plazi	ffb07bec-2d10-492d-9c37-361fe0b79427	01ffdba3-b7dd-45cd-aaf9-54a6e3c31e8c
0	112	112	Ocean Biodiversity Information System	ba0670b9-4186-41e6-8e70-f9cb3065551a	02647337-8eef-4673-b42b-b655b2140b77
0	23	23	Plazi	ffb07bec-2d10-492d-9c37-361fe0b79427	04426a8e-c179-4af0-8e23-d72908e8b4cc
127	127	0	Colombian Biodiversity Information System	7e865cba-7c46-417b-ade5-97f2cf5b7be0	0d83737f-b7a1-42bf-a829-f21f5b8ffe04
0	2	2	Plazi	ffb07bec-2d10-492d-9c37-361fe0b79427	0dcda71b-4d8c-4c97-a509-a47f3b2f5573
33	33	0	Plazi	ffb07bec-2d10-492d-9c37-361fe0b79427	10c257cd-4869-4667-86fb-9ff9b671ada1
3	3	0	Plazi	ffb07bec-2d10-492d-9c37-361fe0b79427	11828a62-a1bc-496b-9ec0-7775fa930019
0	106	106	Plazi	ffb07bec-2d10-492d-9c37-361fe0b79427	12d0c219-cdcc-4ec9-b968-011da925cbee
73579	73579	0	Atlas of Living Australia	4a6f1b71-969e-4fc5-a693-282b05e1220c	14a9a51d-a69d-49a8-b4ec-8f8455acc34b
13	13	0	Plazi	ffb07bec-2d10-492d-9c37-361fe0b79427	14bb8884-5965-4f4c-8c8f-404cb9f64261
8	8	0	Plazi	ffb07bec-2d10-492d-9c37-361fe0b79427	155d74b6-1ad0-44e4-a821-eb8c3d3dc19a
3	3	0	Plazi	ffb07bec-2d10-492d-9c37-361fe0b79427	15e2857b-23b4-4974-9813-8930dcd65a75
0	13	13	Plazi	ffb07bec-2d10-492d-9c37-361fe0b79427	16ebf94a-9ae1-4744-ac41-2bfa923ee3f5
25	25	0	Plazi	ffb07bec-2d10-492d-9c37-361fe0b79427	19f10ac5-196a-43b0-9bb1-bee8765f1bec
8	8	0	Plazi	ffb07bec-2d10-492d-9c37-361fe0b79427	1ba06be9-81d7-44c8-abf5-a0e508983a6f
24	24	0	Plazi	ffb07bec-2d10-492d-9c37-361fe0b79427	222b7335-0d4e-45f7-87a7-f06f40902687
0	16	16	Plazi	ffb07bec-2d10-492d-9c37-361fe0b79427	22637bea-6153-4ce9-8593-28c5a86ee311
17	17	0	Plazi	ffb07bec-2d10-492d-9c37-361fe0b79427	22ef92b8-1d9c-4e9f-b01c-ce1f5d3faa7b
0	2	2	Plazi	ffb07bec-2d10-492d-9c37-361fe0b79427	22f5b738-fc7c-4947-8154-1027f1cee9ce
298	298	0	Biodiversity Information System of Mexico	b324e8e9-9a4c-44fa-8f1a-7f39ea7ab576	24b62e2c-826f-425f-b990-285fb350811a
429551	431991	2440	U.S. Geological Survey	8618c64a-93e0-4300-b546-7249e5148ed2	27b4ff4b-29c3-4017-9c48-3750861392f7
10738	10738	0	GBIF Japan	db5705aa-6a6e-42f1-8942-d77b9f4896ea	27be081b-0250-4cfe-ab5c-e835a66772b8
28221	28221	0	Atlas of Living Australia	4a6f1b71-969e-4fc5-a693-282b05e1220c	29b28617-c91c-4bc9-b3aa-c97960a8b5c8
2	2	0	Plazi	ffb07bec-2d10-492d-9c37-361fe0b79427	2a2184ef-154c-4452-86f0-29baf5c107c1
365	365	0	GBIF Argentina	2426a871-9feb-40a1-96c6-0c593a76b835	2aa53e94-8c53-4afc-b246-d58d5bc6b0fd
2	2	0	Plazi	ffb07bec-2d10-492d-9c37-361fe0b79427	2d07daf7-d677-4cdc-b633-9fda7188e232
1905	1905	0	National Biodiversity Network	d897a5b9-35ee-4232-94bd-b0bcaac003c2	2d4b3bf7-b913-4552-af6d-9cfaad6a43f3
1	1	0	Plazi	ffb07bec-2d10-492d-9c37-361fe0b79427	2d745938-e44d-447a-9796-97f05a4d34a4
3687	3687	0	National Biodiversity Data Centre	422b00b2-6c94-4bb6-976b-c359916efdb8	2f63bb07-dbb6-4f9f-9507-ff75f77a4512
0	2	2	Plazi	ffb07bec-2d10-492d-9c37-361fe0b79427	2fca6f10-d9b1-4011-93c5-2a8a7ef3ee4b
0	88	88	Plazi	ffb07bec-2d10-492d-9c37-361fe0b79427	300bac18-55f5-4e34-90e1-7fccd02d68c1
17	17	0	Plazi	ffb07bec-2d10-492d-9c37-361fe0b79427	3658273a-3bc4-40c8-a44a-4c32f353d3f4
1748	1748	0	GBIF Germany	4f6826f2-4ff6-443d-b966-e6913bd24013	37937bd0-33f9-4418-bd42-ab05efeaeb59
0	81	81	GBIF Chile	a8b16421-d80b-4ef3-8f22-098b01a89255	38e79791-7b68-424d-99ee-079aa1826dbe
216	216	0	GBIF Germany	4f6826f2-4ff6-443d-b966-e6913bd24013	3a50b2c9-f7d1-4b70-ab64-43196982bd9a
2243	1923	-320	Biodiversity Information System of Mexico	b324e8e9-9a4c-44fa-8f1a-7f39ea7ab576	3c78b768-00e8-41aa-8efb-c4d928b21bb0
16351	16351	0	U.S. Geological Survey	8618c64a-93e0-4300-b546-7249e5148ed2	3dedd874-1c74-487c-9fb3-48dcaf922bab
2	2	0	Participant Node Managers Committee	7f48e0c8-5c96-49ec-b972-30748e339115	3ed38b2a-e9e8-4b42-a221-a514caaa7950
1602	1602	0	Participant Node Managers Committee	7f48e0c8-5c96-49ec-b972-30748e339115	4071501e-25fd-4a1c-9381-a3d5cb8d166c
33	33	0	Colombian Biodiversity Information System	7e865cba-7c46-417b-ade5-97f2cf5b7be0	43eb42c9-db49-4359-b682-3270aa35f47c
0	450	450	Korean Biodiversity Information Facility	e0a1e772-0177-4800-94b4-2d023fe6cdf4	444a0108-84fe-4b38-ae6d-14593739697f
2	2	0	Plazi	ffb07bec-2d10-492d-9c37-361fe0b79427	44aec0b4-e0c6-4127-bde8-13bc70071eef
0	1	1	Ocean Biodiversity Information System	ba0670b9-4186-41e6-8e70-f9cb3065551a	4b6c6daf-f83c-4ed1-8961-cde911551e1d
2781	2781	0	National Biodiversity Network	d897a5b9-35ee-4232-94bd-b0bcaac003c2	4caa2abf-8e32-4c4d-9b61-1c9b470718ce
144	144	0	Participant Node Managers Committee	7f48e0c8-5c96-49ec-b972-30748e339115	4dc3f35e-eb7e-4f73-a12a-a51a6f525002
0	95	95	Plazi	ffb07bec-2d10-492d-9c37-361fe0b79427	4f029708-021a-4c44-8e87-bb9ed9846cf6
22	22	0	Plazi	ffb07bec-2d10-492d-9c37-361fe0b79427	50a48915-86cf-4e7d-881e-ae19609f0871
0	2	2	Plazi	ffb07bec-2d10-492d-9c37-361fe0b79427	5263d902-19f7-4803-ac63-fd5381619c74
97	97	0	Plazi	ffb07bec-2d10-492d-9c37-361fe0b79427	5274b2f8-e4d0-4ac9-8e81-a23e886b2380
4077	4077	0	GBIF France	da44cd31-5901-4687-a106-6d1c7734ee3a	540eb0ee-7dad-4dab-8eb3-3c60165698ce
5	5	0	Plazi	ffb07bec-2d10-492d-9c37-361fe0b79427	566b7242-f243-485b-8b3d-edc7cc4eacde
268	268	0	Colombian Biodiversity Information System	7e865cba-7c46-417b-ade5-97f2cf5b7be0	57a372e5-b06e-4ec8-b82c-0cb8ecc57556
0	544	544	Ocean Biodiversity Information System	ba0670b9-4186-41e6-8e70-f9cb3065551a	582edcfc-922c-43eb-b480-63971c425f2d
447	447	0	GBIF France	da44cd31-5901-4687-a106-6d1c7734ee3a	59ffe691-64ad-4472-a46f-6b31ae34d412
405	405	0	National Biodiversity Network	d897a5b9-35ee-4232-94bd-b0bcaac003c2	5a6f312d-336a-413e-a437-be850dda7a4a
144	144	0	GBIF France	da44cd31-5901-4687-a106-6d1c7734ee3a	5ec0f837-8d2c-4bd3-9876-d3f296f08c18
257	257	0	GBIF Germany	4f6826f2-4ff6-443d-b966-e6913bd24013	614245e8-f762-11e1-a439-00145eb45e9a
111	111	0	GBIF Germany	4f6826f2-4ff6-443d-b966-e6913bd24013	61e1f53e-f762-11e1-a439-00145eb45e9a
94	94	0	GBIF Germany	4f6826f2-4ff6-443d-b966-e6913bd24013	6254168c-f762-11e1-a439-00145eb45e9a
217	217	0	GBIF Germany	4f6826f2-4ff6-443d-b966-e6913bd24013	62611e4a-f762-11e1-a439-00145eb45e9a
111	111	0	Plazi	ffb07bec-2d10-492d-9c37-361fe0b79427	6384b520-7e9f-4874-a414-76c2e9b01d74
84	84	0	GBIF Germany	4f6826f2-4ff6-443d-b966-e6913bd24013	63b64e3c-f762-11e1-a439-00145eb45e9a
37	37	0	Plazi	ffb07bec-2d10-492d-9c37-361fe0b79427	66b35539-d2b9-4a3c-b8fc-2b1d9df8526e
20	20	0	GBIF Germany	4f6826f2-4ff6-443d-b966-e6913bd24013	674c475e-f762-11e1-a439-00145eb45e9a
122	122	0	GBIF Germany	4f6826f2-4ff6-443d-b966-e6913bd24013	679be17e-f762-11e1-a439-00145eb45e9a
0	185	185	Ocean Biodiversity Information System	ba0670b9-4186-41e6-8e70-f9cb3065551a	67c29a8e-f987-4fc5-83df-fb731a226c6f
147	147	0	GBIF Germany	4f6826f2-4ff6-443d-b966-e6913bd24013	686af63a-f762-11e1-a439-00145eb45e9a
13	13	0	GBIF Germany	4f6826f2-4ff6-443d-b966-e6913bd24013	6937b01c-f762-11e1-a439-00145eb45e9a
0	112	112	Ocean Biodiversity Information System	ba0670b9-4186-41e6-8e70-f9cb3065551a	6999a8e3-b298-4d4c-9b92-b046539b5bf1
105	105	0	GBIF Germany	4f6826f2-4ff6-443d-b966-e6913bd24013	69a9a80c-f762-11e1-a439-00145eb45e9a
80	80	0	Plazi	ffb07bec-2d10-492d-9c37-361fe0b79427	6a6c7cfe-460a-4186-a040-48f5dd80b4b3
12	12	0	Plazi	ffb07bec-2d10-492d-9c37-361fe0b79427	6cbafb23-657b-41dc-8434-17fcfeb526ad
30	30	0	Plazi	ffb07bec-2d10-492d-9c37-361fe0b79427	6cd26a25-a9a5-474b-9aa6-eb65f09e76a6
87	87	0	GBIF Germany	4f6826f2-4ff6-443d-b966-e6913bd24013	6f9a7b56-f762-11e1-a439-00145eb45e9a
1	1	0	Plazi	ffb07bec-2d10-492d-9c37-361fe0b79427	70530061-5ce4-46aa-949b-628e7f542c90
0	213950	213950	Canada Biodiversity Information Facility	8f83fc96-c966-4126-83f7-bf044dc49efa	7066ae08-1550-4071-8058-168456c427f6
0	25	25	Participant Node Managers Committee	7f48e0c8-5c96-49ec-b972-30748e339115	70701323-bbb4-4d5c-a964-cd794167d59f
84	84	0	GBIF Germany	4f6826f2-4ff6-443d-b966-e6913bd24013	707e8486-f762-11e1-a439-00145eb45e9a
10	10	0	GBIF Germany	4f6826f2-4ff6-443d-b966-e6913bd24013	7087d798-f762-11e1-a439-00145eb45e9a
0	3	3	Plazi	ffb07bec-2d10-492d-9c37-361fe0b79427	70f86fa8-71e6-49aa-be1e-0c9115e10346
59	59	0	GBIF Germany	4f6826f2-4ff6-443d-b966-e6913bd24013	7143034c-f762-11e1-a439-00145eb45e9a
1	1	0	GBIF Germany	4f6826f2-4ff6-443d-b966-e6913bd24013	7187f4e8-f762-11e1-a439-00145eb45e9a
16	16	0	GBIF Germany	4f6826f2-4ff6-443d-b966-e6913bd24013	720d11e6-f762-11e1-a439-00145eb45e9a
0	6	6	Plazi	ffb07bec-2d10-492d-9c37-361fe0b79427	726682f3-9eac-4961-ac4d-d8b8679e8211
52	52	0	GBIF Germany	4f6826f2-4ff6-443d-b966-e6913bd24013	7274d542-f762-11e1-a439-00145eb45e9a
1	1	0	Plazi	ffb07bec-2d10-492d-9c37-361fe0b79427	72a42bf2-29dc-429e-8062-40c03837722e
7	7	0	GBIF Germany	4f6826f2-4ff6-443d-b966-e6913bd24013	73a8f9b6-f762-11e1-a439-00145eb45e9a
55	55	0	GBIF Germany	4f6826f2-4ff6-443d-b966-e6913bd24013	7471fb36-f762-11e1-a439-00145eb45e9a
39033	39033	0	U.S. Geological Survey	8618c64a-93e0-4300-b546-7249e5148ed2	75018539-6328-41de-b875-7c2e61dc1635
0	9	9	Plazi	ffb07bec-2d10-492d-9c37-361fe0b79427	7af2fc34-63ae-40d2-95a6-4bed18653e7a
354	354	0	GBIF France	da44cd31-5901-4687-a106-6d1c7734ee3a	7b48f128-8eca-444b-aa84-deb65c7544e3
177	177	0	Colombian Biodiversity Information System	7e865cba-7c46-417b-ade5-97f2cf5b7be0	7c59ec48-022f-4298-929d-20100d7913cb
2819	2819	0	GBIF Germany	4f6826f2-4ff6-443d-b966-e6913bd24013	7c75da14-f762-11e1-a439-00145eb45e9a
283	134	-149	GBIF Germany	4f6826f2-4ff6-443d-b966-e6913bd24013	7cc28cd8-f762-11e1-a439-00145eb45e9a
660	480	-180	GBIF Germany	4f6826f2-4ff6-443d-b966-e6913bd24013	7d52765e-f762-11e1-a439-00145eb45e9a
53	53	0	Atlas of Living Australia	4a6f1b71-969e-4fc5-a693-282b05e1220c	7d805628-f762-11e1-a439-00145eb45e9a
2	2	0	Plazi	ffb07bec-2d10-492d-9c37-361fe0b79427	7e4a0c92-6883-4edd-9af7-a56d123b7173
2072	2072	0	GBIF Benin	efb9c00e-f802-45dd-8826-a52ec45b89ff	8033dd89-8e40-46af-98ff-e82fbdc16b11
308	308	0	Biodiversity Information System of Mexico	b324e8e9-9a4c-44fa-8f1a-7f39ea7ab576	803bf32c-f762-11e1-a439-00145eb45e9a
102032	102032	0	U.S. Geological Survey	8618c64a-93e0-4300-b546-7249e5148ed2	813b435e-f762-11e1-a439-00145eb45e9a
880	880	0	GBIF France	da44cd31-5901-4687-a106-6d1c7734ee3a	81880628-c616-417e-8d1a-d519577c2087
18	18	0	Plazi	ffb07bec-2d10-492d-9c37-361fe0b79427	81cb1794-6fbd-47d1-b6b6-34a52069f488
2468	2470	2	GBIF Germany	4f6826f2-4ff6-443d-b966-e6913bd24013	8295f33e-f762-11e1-a439-00145eb45e9a
28	28	0	Korean Biodiversity Information Facility	e0a1e772-0177-4800-94b4-2d023fe6cdf4	83043da8-f762-11e1-a439-00145eb45e9a
3210	3210	0	GBIF Peru	46e3639a-27f8-45af-bfbe-d19b77efb040	83951602-f762-11e1-a439-00145eb45e9a
0	9511	9511	GBIF France	da44cd31-5901-4687-a106-6d1c7734ee3a	83d90f99-8c19-4df3-88e4-7977ae30c453
0	4	4	Plazi	ffb07bec-2d10-492d-9c37-361fe0b79427	84340ac2-552b-4174-b3a2-6bb13b83bcfa
1	1	0	Plazi	ffb07bec-2d10-492d-9c37-361fe0b79427	844b3211-e4f2-4d13-9287-f7c96112687f
7	7	0	GBIF Germany	4f6826f2-4ff6-443d-b966-e6913bd24013	84705d57-3241-4401-91e6-1907812dabf9
66530	66530	0	U.S. Geological Survey	8618c64a-93e0-4300-b546-7249e5148ed2	84aefc7e-f762-11e1-a439-00145eb45e9a
477	477	0	GBIF Peru	46e3639a-27f8-45af-bfbe-d19b77efb040	84b85d1e-f762-11e1-a439-00145eb45e9a
2291	2291	0	U.S. Geological Survey	8618c64a-93e0-4300-b546-7249e5148ed2	84ea67fa-f762-11e1-a439-00145eb45e9a
0	11468	11468	Ocean Biodiversity Information System	ba0670b9-4186-41e6-8e70-f9cb3065551a	86de218c-cc46-409e-aa2f-b25559703900
0	147	147	Participant Node Managers Committee	7f48e0c8-5c96-49ec-b972-30748e339115	87fa0cd5-4495-413f-a0bf-957e87c4e338
10	10	0	GBIF Germany	4f6826f2-4ff6-443d-b966-e6913bd24013	880c0a4c-f762-11e1-a439-00145eb45e9a
32	32	0	Plazi	ffb07bec-2d10-492d-9c37-361fe0b79427	8868480c-dfe4-41b9-898a-3d724ebf2ecd
209	209	0	GBIF France	da44cd31-5901-4687-a106-6d1c7734ee3a	896fea96-e78c-488a-b28f-0f4aad1dbca0
15	15	0	Belgian Biodiversity Platform	fb11cfe1-ebc3-45af-9159-17d9fddbcdac	89ec855f-1478-46ad-a80f-b5249593ba24
4	4	0	GBIF Germany	4f6826f2-4ff6-443d-b966-e6913bd24013	8ba9bcbc-f762-11e1-a439-00145eb45e9a
8	8	0	GBIF Germany	4f6826f2-4ff6-443d-b966-e6913bd24013	8c3bc602-f762-11e1-a439-00145eb45e9a
4	4	0	GBIF Germany	4f6826f2-4ff6-443d-b966-e6913bd24013	8c42260a-f762-11e1-a439-00145eb45e9a
12	11	-1	GBIF Germany	4f6826f2-4ff6-443d-b966-e6913bd24013	8d9f0c98-f762-11e1-a439-00145eb45e9a
231	73	-158	GBIF Germany	4f6826f2-4ff6-443d-b966-e6913bd24013	8dc2e14a-f762-11e1-a439-00145eb45e9a
76	76	0	Plazi	ffb07bec-2d10-492d-9c37-361fe0b79427	8ffeb723-43a9-41a7-9a16-127a005f9ea8
0	31	31	Plazi	ffb07bec-2d10-492d-9c37-361fe0b79427	923a3d8d-eb08-4250-88ee-4216e182003e
154	154	0	GBIF Germany	4f6826f2-4ff6-443d-b966-e6913bd24013	9260f872-f762-11e1-a439-00145eb45e9a
83	57	-26	GBIF Germany	4f6826f2-4ff6-443d-b966-e6913bd24013	92a81a7c-f762-11e1-a439-00145eb45e9a
24588	24605	17	GBIF Estonia	2c11b821-d22b-4c64-8cd3-c1578173b129	95da13d0-f762-11e1-a439-00145eb45e9a
0	1420	1420	Ocean Biodiversity Information System	ba0670b9-4186-41e6-8e70-f9cb3065551a	99654f9c-c123-4035-8afb-7c63dde0d7fc
42	42	0	Plazi	ffb07bec-2d10-492d-9c37-361fe0b79427	9993ce48-70e1-4fd4-8c3b-450408aba033
10073	10073	0	Biodiversity Information System of Mexico	b324e8e9-9a4c-44fa-8f1a-7f39ea7ab576	9afc91df-a756-4a22-a8cc-672d0be762c0
0	5192	5192	Belgian Biodiversity Platform	fb11cfe1-ebc3-45af-9159-17d9fddbcdac	9be00561-9236-462f-b536-4a073b4f02f7
19	19	0	GBIF France	da44cd31-5901-4687-a106-6d1c7734ee3a	9ca7b5d0-d59d-412b-bf6d-6af74efc03a8
1232	1232	0	GBIF France	da44cd31-5901-4687-a106-6d1c7734ee3a	9ed71a89-2273-4c7f-ba11-a182816a1af6
1	1	0	Plazi	ffb07bec-2d10-492d-9c37-361fe0b79427	a30ef595-7382-4c33-953c-c6c30dfebfef
80	80	0	Plazi	ffb07bec-2d10-492d-9c37-361fe0b79427	a7f74b17-30a7-4836-9e50-e17727013a3f
25	25	0	Plazi	ffb07bec-2d10-492d-9c37-361fe0b79427	a86ebbda-e16c-440b-afbd-f954646ca5f8
5	5	0	Plazi	ffb07bec-2d10-492d-9c37-361fe0b79427	a9d1d601-d5f9-4fb8-90b9-cc761f301e9b
1	1	0	Plazi	ffb07bec-2d10-492d-9c37-361fe0b79427	a9fa297c-2ef8-4599-ac6e-4ede538b0500
1467	1467	0	Biodiversity Information System of Mexico	b324e8e9-9a4c-44fa-8f1a-7f39ea7ab576	ad6ffdd1-07ca-46f5-a07b-b3db178e77eb
57420	59114	1694	U.S. Geological Survey	8618c64a-93e0-4300-b546-7249e5148ed2	aec6d756-3aa8-465e-83fd-4f6ee83e693e
78193	88241	10048	Participant Node Managers Committee	7f48e0c8-5c96-49ec-b972-30748e339115	af5f680a-e0cc-46c8-b623-ceeaab70aa9e
0	47	47	Plazi	ffb07bec-2d10-492d-9c37-361fe0b79427	b0861b12-f855-43bf-a8d1-656a904ba6c5
112	112	0	GBIF Germany	4f6826f2-4ff6-443d-b966-e6913bd24013	b201c8fb-0502-437f-ba77-8e092273328b
78	78	0	Plazi	ffb07bec-2d10-492d-9c37-361fe0b79427	b412f1c4-28b9-4786-9aec-f930c9c00373
0	179	179	Ocean Biodiversity Information System	ba0670b9-4186-41e6-8e70-f9cb3065551a	b4ab67b0-eca5-49a4-9f66-c5deaeee1b07
1990	1990	0	GBIF Germany	4f6826f2-4ff6-443d-b966-e6913bd24013	b55a9f01-8a85-4abd-917b-3d4f1fdb26ce
13040	18572	5532	National Biodiversity Network	d897a5b9-35ee-4232-94bd-b0bcaac003c2	b650365b-6ff5-403b-916a-f1c4a176bb45
10122	10122	0	National Biodiversity Network	d897a5b9-35ee-4232-94bd-b0bcaac003c2	b6ce73fb-6a98-4bde-b583-37a4634efef4
0	475	475	Colombian Biodiversity Information System	7e865cba-7c46-417b-ade5-97f2cf5b7be0	b914edca-e251-46e1-94a0-fe0f9be210d8
0	1	1	Plazi	ffb07bec-2d10-492d-9c37-361fe0b79427	bc0de19d-fd57-4b83-820d-585c0d061be6
2187	2187	0	Colombian Biodiversity Information System	7e865cba-7c46-417b-ade5-97f2cf5b7be0	bc2c3c27-97b6-473e-abe0-6f8478b3e2f8
0	20	20	Plazi	ffb07bec-2d10-492d-9c37-361fe0b79427	bc778fb5-3634-4da8-9297-0d6c2cdde0eb
0	16289	16289	GBIF Finland	dd514216-5c7c-45f3-910d-797424cb5be6	c1d45286-a9a3-4399-acf3-1eccb8c68673
2	2	0	Plazi	ffb07bec-2d10-492d-9c37-361fe0b79427	c6c3cfda-f47e-412f-9d13-05b4537a97c1
4	4	0	Plazi	ffb07bec-2d10-492d-9c37-361fe0b79427	c6f9538f-c3b9-4ea6-a51e-8e04d5d647db
0	28	28	Plazi	ffb07bec-2d10-492d-9c37-361fe0b79427	c79684a6-ca35-4efe-be33-dfe58b5b83df
0	1	1	Plazi	ffb07bec-2d10-492d-9c37-361fe0b79427	c906ba38-dabf-4e07-b2d9-2d2bd9f19ee6
20	20	0	Plazi	ffb07bec-2d10-492d-9c37-361fe0b79427	c914809b-7383-4367-9481-37d3e78afe81
0	5	5	Plazi	ffb07bec-2d10-492d-9c37-361fe0b79427	c967b123-3ba5-49b7-8d1d-c9f76ce58f75
33	33	0	Atlas of Living Australia	4a6f1b71-969e-4fc5-a693-282b05e1220c	cbee6026-cfa5-476f-aaa6-7884ab9eb964
37	37	0	Ghana Biodiversity Information Facility	b5633b75-6a86-4fdf-9cfc-506047fb9dc7	cc488b41-4e98-4dff-ae42-b44fa31bd442
0	3	3	Plazi	ffb07bec-2d10-492d-9c37-361fe0b79427	cc75eea1-230e-42a9-bc20-b3a63261cc02
950	950	0	GBIF France	da44cd31-5901-4687-a106-6d1c7734ee3a	d21c8332-af1a-4c5e-a1ac-f6346bc0a7ad
1640	1172	-468	GBIF Germany	4f6826f2-4ff6-443d-b966-e6913bd24013	d29eb422-52b3-4a05-ba6e-616790f9527b
5721	5721	0	Atlas of Living Australia	4a6f1b71-969e-4fc5-a693-282b05e1220c	d34738d4-f096-4781-8156-14e782a2ee1e
0	502	502	Participant Node Managers Committee	7f48e0c8-5c96-49ec-b972-30748e339115	d5ba665a-c07b-4379-85ff-15d7e3a9331a
0	1	1	Plazi	ffb07bec-2d10-492d-9c37-361fe0b79427	d6e4e6d5-7cca-4bf2-a0cf-5575c3a21f0b
186	186	0	Plazi	ffb07bec-2d10-492d-9c37-361fe0b79427	dc28910f-3259-459f-8ccd-bac35d2720d0
1838	1838	0	GBIF France	da44cd31-5901-4687-a106-6d1c7734ee3a	dd366f57-ef9e-4c6f-a096-e953f6dae044
1872	1872	0	GBIF Guinea	b1cd2e84-c4ba-47bd-b72a-dfd1f92dce0a	ddf2eb29-e879-4f04-94f9-ef8f272ab12b
932	932	0	GBIF France	da44cd31-5901-4687-a106-6d1c7734ee3a	e1b2955d-3982-4aef-a451-f7b1785b9f11
0	21	21	Plazi	ffb07bec-2d10-492d-9c37-361fe0b79427	e2280d05-d091-4c28-93ae-83542929509e
110	110	0	Plazi	ffb07bec-2d10-492d-9c37-361fe0b79427	e23922d1-6f43-4280-8ac6-131767dc4464
1082	1082	0	GBIF Sweden	a0b3be64-6525-4387-ac67-a499950f92e1	e267ed2f-3a17-434d-8355-32ff72be12f4
1	1	0	Plazi	ffb07bec-2d10-492d-9c37-361fe0b79427	e39bdec4-ab34-4797-9ca6-8543a77d81d8
0	55	55	Plazi	ffb07bec-2d10-492d-9c37-361fe0b79427	e4d5c08b-7e5b-4747-9743-211bddc9eb3a
7849	7849	0	GBIF France	da44cd31-5901-4687-a106-6d1c7734ee3a	e8183974-e88e-4d68-ab48-b28284770c24
3	3	0	Plazi	ffb07bec-2d10-492d-9c37-361fe0b79427	e888458c-2599-411a-b476-f0e35fbe62d7
4	4	0	Plazi	ffb07bec-2d10-492d-9c37-361fe0b79427	ea4c3cf5-f543-4665-ba47-03423b1c57a4
25	25	0	Plazi	ffb07bec-2d10-492d-9c37-361fe0b79427	eb5d92a1-889c-4999-be72-fe82f0f25ebe
0	5806	5806	Participant Node Managers Committee	7f48e0c8-5c96-49ec-b972-30748e339115	ec534611-51bc-48f7-867e-f0e6500fb2a8
37973	38214	241	U.S. Geological Survey	8618c64a-93e0-4300-b546-7249e5148ed2	ecca1a3e-3b7d-4229-8a7a-d106997e6d03
56	56	0	GBIF France	da44cd31-5901-4687-a106-6d1c7734ee3a	ef56cabf-6720-4dee-af38-de5798dc4654
493	493	0	Belgian Biodiversity Platform	fb11cfe1-ebc3-45af-9159-17d9fddbcdac	f1719d1a-996a-4a6c-931e-0d68bc2344a8
0	2044	2044	GBIF Norway	4f829580-180d-46a9-9c87-ed8ec959b545	f1af1d2b-2d22-48e5-857c-0048710e0c16
0	4	4	Plazi	ffb07bec-2d10-492d-9c37-361fe0b79427	f3008308-781c-4f3d-acd9-3aa17c325937
22	22	0	Plazi	ffb07bec-2d10-492d-9c37-361fe0b79427	f4009631-c937-46ee-8fac-970fe827cdaf
0	5	5	Plazi	ffb07bec-2d10-492d-9c37-361fe0b79427	f8cc71a6-fbae-4862-a29f-7d165ba17ff6
244	244	0	GBIF Germany	4f6826f2-4ff6-443d-b966-e6913bd24013	f9529b99-dad9-4d08-8938-bd175035693f
0	29	29	Ocean Biodiversity Information System	ba0670b9-4186-41e6-8e70-f9cb3065551a	fb7cec1d-bdd7-4750-900a-b30cdeb8b930
87	87	0	GBIF Benin	efb9c00e-f802-45dd-8826-a52ec45b89ff	fcbdcb07-af22-404a-934b-dec42d846a1c
1682	1682	0	GBIF Germany	4f6826f2-4ff6-443d-b966-e6913bd24013	fcc16e1b-3c1f-4119-bdfd-d4cbaa80afe6
26480	26568	88	Atlas of Living Australia	4a6f1b71-969e-4fc5-a693-282b05e1220c	01bc220b-39b8-4837-b235-f921187af771
325983	333092	7109	Netherlands Biodiversity Information Facility	0909d601-bda2-42df-9e63-a6d51847ebce	03f2256a-e548-43d7-a731-253302f4aa34
3	3	0	Plazi	ffb07bec-2d10-492d-9c37-361fe0b79427	046bf2c1-3242-42f9-9e1e-f87c61c99bed
3	3	0	Plazi	ffb07bec-2d10-492d-9c37-361fe0b79427	0535eaeb-2e3b-4b6d-9ced-58a61fd02e03
29	29	0	Plazi	ffb07bec-2d10-492d-9c37-361fe0b79427	0bd16ef3-56e3-4251-8243-9d59e5606493
18	18	0	GBIF France	da44cd31-5901-4687-a106-6d1c7734ee3a	0da9c4c2-c249-4c08-8f92-cb8693bc7666
4896	4896	0	GBIF Germany	4f6826f2-4ff6-443d-b966-e6913bd24013	1289397d-51bc-4d47-8c8a-55c4671bec71
0	3025	3025	GBIF Portugal	673f7038-4262-4149-b753-5658a4e912f6	13745243-620e-4c04-9178-773e4bfc2072
237	237	0	GBIF France	da44cd31-5901-4687-a106-6d1c7734ee3a	154c6088-4a85-47ab-91b4-17156acc7cfc
78491	84964	6473	U.S. Geological Survey	8618c64a-93e0-4300-b546-7249e5148ed2	1804436b-6a12-4fcc-a372-531cc23a41c4
1	1	0	Plazi	ffb07bec-2d10-492d-9c37-361fe0b79427	1aa8372d-a8e5-4512-8e2c-337ee3106b01
2210	2210	0	National Biodiversity Network	d897a5b9-35ee-4232-94bd-b0bcaac003c2	1c02a2c0-9981-4824-b21c-1c5db609b6ae
0	1	1	Plazi	ffb07bec-2d10-492d-9c37-361fe0b79427	1c969ead-bc9e-475f-955f-d0a55035f76d
278	278	0	Belgian Biodiversity Platform	fb11cfe1-ebc3-45af-9159-17d9fddbcdac	1d8dbca8-7d4b-479f-8626-c93a4a3d3cdf
655	805	150	GBIF Japan	db5705aa-6a6e-42f1-8942-d77b9f4896ea	21f080d0-1c8d-484b-b347-dcdb04204ee0
7242	7242	0	GBIF Brazil	cdc9736d-5ff7-4ece-9959-3c744360cdb3	22bd6f42-72a2-4a4c-9d14-a97f7efd556c
12	12	0	Participant Node Managers Committee	7f48e0c8-5c96-49ec-b972-30748e339115	233e1bdb-3141-4367-b364-1f88db6b65a1
94739	94930	191	Canada Biodiversity Information Facility	8f83fc96-c966-4126-83f7-bf044dc49efa	2429287b-ef65-4cfd-afcc-11cc3ba95cca
6703	10411	3708	U.S. Geological Survey	8618c64a-93e0-4300-b546-7249e5148ed2	26b8da97-b067-4220-8335-7c267726ba41
0	1210	1210	Ocean Biodiversity Information System	ba0670b9-4186-41e6-8e70-f9cb3065551a	2962af85-2cc7-4213-9487-5f3e0735f99e
0	32	32	Plazi	ffb07bec-2d10-492d-9c37-361fe0b79427	2b5f73b6-a862-4440-b40f-038099d0875b
4	4	0	Plazi	ffb07bec-2d10-492d-9c37-361fe0b79427	2c856dad-dfc5-4983-a2e7-9494ba2b701f
1947	1947	0	National Biodiversity Network	d897a5b9-35ee-4232-94bd-b0bcaac003c2	2f3751bd-f348-4dd0-bec3-61053f43d211
0	294	294	Plazi	ffb07bec-2d10-492d-9c37-361fe0b79427	3035ca9c-cfc4-4c81-982e-d973e5d3724e
0	2743	2743	U.S. Geological Survey	8618c64a-93e0-4300-b546-7249e5148ed2	324ca21e-71f1-4480-a09f-6f6f4a1ad5ba
509	509	0	GBIF France	da44cd31-5901-4687-a106-6d1c7734ee3a	32d14bd1-05d2-4814-add6-965870279bad
6	6	0	Plazi	ffb07bec-2d10-492d-9c37-361fe0b79427	33cd8c7b-b66b-42f8-bf64-972777a5ea58
0	1387	1387	GBIF Benin	efb9c00e-f802-45dd-8826-a52ec45b89ff	342b7211-9fc8-4ec5-8a61-d1953dba4822
0	2	2	Ocean Biodiversity Information System	ba0670b9-4186-41e6-8e70-f9cb3065551a	359078ce-e956-485c-b6e2-027e977ae594
3	3	0	Plazi	ffb07bec-2d10-492d-9c37-361fe0b79427	365007a3-10a0-4a7e-a27a-eac37c849690
1948	1948	0	U.S. Geological Survey	8618c64a-93e0-4300-b546-7249e5148ed2	383f8172-fcf3-481d-b2fa-decd9e54bb69
635	635	0	Plazi	ffb07bec-2d10-492d-9c37-361fe0b79427	3981e1e7-9d35-4f45-857c-da0bca835157
0	843	843	Ocean Biodiversity Information System	ba0670b9-4186-41e6-8e70-f9cb3065551a	3aa55366-1ad9-4a96-9893-be7cb7e50126
16	16	0	GBIF Japan	db5705aa-6a6e-42f1-8942-d77b9f4896ea	3c442521-4f04-479b-8bf8-443a751807ab
69	76	7	Belgian Biodiversity Platform	fb11cfe1-ebc3-45af-9159-17d9fddbcdac	3c7768dd-8101-4318-8de3-f848878eeea0
84	84	0	GBIF Portugal	673f7038-4262-4149-b753-5658a4e912f6	3c9e599a-0111-4be7-b48a-678fe0546790
0	271	271	Belgian Biodiversity Platform	fb11cfe1-ebc3-45af-9159-17d9fddbcdac	41c5cef3-2200-4998-a4d4-edf12b031412
204	204	0	Colombian Biodiversity Information System	7e865cba-7c46-417b-ade5-97f2cf5b7be0	46a9a848-4645-4a5a-b58e-ffc38a410810
0	55	55	Colombian Biodiversity Information System	7e865cba-7c46-417b-ade5-97f2cf5b7be0	48b7b0a4-1ab0-4701-9542-609a272266b1
1762492	1762492	0	GBIF Estonia	2c11b821-d22b-4c64-8cd3-c1578173b129	4b15eab0-67e6-42c6-bc1a-9bb44354d837
0	35	35	Plazi	ffb07bec-2d10-492d-9c37-361fe0b79427	4d051a76-581a-4b76-870f-838731ad198d
152	152	0	GBIF France	da44cd31-5901-4687-a106-6d1c7734ee3a	4d7a43f8-36c0-41bd-ae25-748ba41a1291
48	48	0	Plazi	ffb07bec-2d10-492d-9c37-361fe0b79427	4e1adc72-60c9-4846-af21-ed080ed81401
4447	29012	24565	National Biodiversity Network	d897a5b9-35ee-4232-94bd-b0bcaac003c2	4fac6de9-a3ae-4334-809c-89d7a56e0d06
0	505	505	GBIF Japan	db5705aa-6a6e-42f1-8942-d77b9f4896ea	50be15cf-30e0-4646-862b-3a9556dc68bd
3753	3753	0	Colombian Biodiversity Information System	7e865cba-7c46-417b-ade5-97f2cf5b7be0	52ffdb54-a3e9-4e83-9d30-ff81659873f9
549	549	0	GBIF France	da44cd31-5901-4687-a106-6d1c7734ee3a	5a36659f-59c8-457e-9f39-a7ccc94a8ddd
5	5	0	Plazi	ffb07bec-2d10-492d-9c37-361fe0b79427	5f87bbc8-a39a-473e-b0b9-57ea5d673dda
114	114	0	GBIF Germany	4f6826f2-4ff6-443d-b966-e6913bd24013	61137362-f762-11e1-a439-00145eb45e9a
0	20	20	Plazi	ffb07bec-2d10-492d-9c37-361fe0b79427	61176e3b-9cfb-499f-be30-cfde91a58a48
379	379	0	Atlas of Living Australia	4a6f1b71-969e-4fc5-a693-282b05e1220c	617b1622-e700-49f7-8747-482231d23d38
87	87	0	GBIF Germany	4f6826f2-4ff6-443d-b966-e6913bd24013	6257a37e-f762-11e1-a439-00145eb45e9a
396	396	0	GBIF Argentina	2426a871-9feb-40a1-96c6-0c593a76b835	645a34cb-0d74-42b7-b7e8-f170c4c20b76
37	37	0	GBIF Germany	4f6826f2-4ff6-443d-b966-e6913bd24013	64f0fb94-f762-11e1-a439-00145eb45e9a
2	2	0	Plazi	ffb07bec-2d10-492d-9c37-361fe0b79427	66601a1e-ba16-41b2-b182-0fd80e75ccba
51	51	0	GBIF Germany	4f6826f2-4ff6-443d-b966-e6913bd24013	667a62ca-f762-11e1-a439-00145eb45e9a
11	11	0	Plazi	ffb07bec-2d10-492d-9c37-361fe0b79427	66ec8407-6d61-4062-9c1f-b0fcacd412ad
18924	18924	0	GBIF France	da44cd31-5901-4687-a106-6d1c7734ee3a	67f85ce5-4cfb-45ac-b05f-cac763d0b838
58	58	0	GBIF Germany	4f6826f2-4ff6-443d-b966-e6913bd24013	6868318e-f762-11e1-a439-00145eb45e9a
0	228	228	Ocean Biodiversity Information System	ba0670b9-4186-41e6-8e70-f9cb3065551a	68706325-a5af-4918-bf8c-217ed954eaed
2	2	0	Plazi	ffb07bec-2d10-492d-9c37-361fe0b79427	68cad7e9-16f0-4e20-b4a7-df44977890be
180	180	0	GBIF Germany	4f6826f2-4ff6-443d-b966-e6913bd24013	694fb69e-f762-11e1-a439-00145eb45e9a
542	542	0	Biodiversity Information System of Mexico	b324e8e9-9a4c-44fa-8f1a-7f39ea7ab576	6b2dd7dd-9304-4060-b0bd-6d25a82d1024
177	177	0	GBIF Germany	4f6826f2-4ff6-443d-b966-e6913bd24013	6d270a88-f762-11e1-a439-00145eb45e9a
212	212	0	GBIF Germany	4f6826f2-4ff6-443d-b966-e6913bd24013	6d2aca4c-f762-11e1-a439-00145eb45e9a
5	5	0	Plazi	ffb07bec-2d10-492d-9c37-361fe0b79427	6ebf9dcb-db2d-4e08-807c-43f5d55392a4
13	13	0	GBIF Germany	4f6826f2-4ff6-443d-b966-e6913bd24013	6fad8c5a-f762-11e1-a439-00145eb45e9a
10	10	0	GBIF Germany	4f6826f2-4ff6-443d-b966-e6913bd24013	6fd1f91e-f762-11e1-a439-00145eb45e9a
2	2	0	Plazi	ffb07bec-2d10-492d-9c37-361fe0b79427	706253b2-beb2-4712-8b44-9dd7e400e20c
0	10	10	Plazi	ffb07bec-2d10-492d-9c37-361fe0b79427	7076f014-afc2-452a-9929-90e36f8d5b22
0	194	194	Colombian Biodiversity Information System	7e865cba-7c46-417b-ade5-97f2cf5b7be0	70e3da86-aed3-4149-bdeb-49c7d3564f24
91	91	0	GBIF France	da44cd31-5901-4687-a106-6d1c7734ee3a	71212ade-2cfb-4a75-bbc3-f0bd35d3cb50
583	583	0	National Biodiversity Network	d897a5b9-35ee-4232-94bd-b0bcaac003c2	71c21f25-c877-495b-a372-07c3a1c091ca
405	405	0	GBIF Germany	4f6826f2-4ff6-443d-b966-e6913bd24013	73263c06-f762-11e1-a439-00145eb45e9a
12	12	0	GBIF Germany	4f6826f2-4ff6-443d-b966-e6913bd24013	7434a24a-f762-11e1-a439-00145eb45e9a
161	161	0	GBIF Germany	4f6826f2-4ff6-443d-b966-e6913bd24013	754ad280-f762-11e1-a439-00145eb45e9a
13113	13113	0	National Biodiversity Network	d897a5b9-35ee-4232-94bd-b0bcaac003c2	75732d18-9bee-47cd-a5d4-24172c1eee9c
4	4	0	GBIF Germany	4f6826f2-4ff6-443d-b966-e6913bd24013	7899763a-f762-11e1-a439-00145eb45e9a
589	448	-141	GBIF Germany	4f6826f2-4ff6-443d-b966-e6913bd24013	79aa78e4-f762-11e1-a439-00145eb45e9a
16632	16632	0	GBIF Spain	1f94b3ca-9345-4d65-afe2-4bace93aa0fe	7a23f386-f762-11e1-a439-00145eb45e9a
9039	9039	0	GBIF Germany	4f6826f2-4ff6-443d-b966-e6913bd24013	7b7bb606-f762-11e1-a439-00145eb45e9a
330	330	0	GBIF Germany	4f6826f2-4ff6-443d-b966-e6913bd24013	7beec632-f762-11e1-a439-00145eb45e9a
0	5	5	Plazi	ffb07bec-2d10-492d-9c37-361fe0b79427	7c5f2b66-1285-4efa-b02b-0b94decd5aed
64	64	0	GBIF France	da44cd31-5901-4687-a106-6d1c7734ee3a	7d4f5adb-0960-41e8-b9a5-8eddcecc620f
0	15	15	Plazi	ffb07bec-2d10-492d-9c37-361fe0b79427	7e060571-071a-41b2-a2ba-df66720354ea
971	971	0	GBIF Germany	4f6826f2-4ff6-443d-b966-e6913bd24013	7ef7f2b8-f762-11e1-a439-00145eb45e9a
62	62	0	Colombian Biodiversity Information System	7e865cba-7c46-417b-ade5-97f2cf5b7be0	7ff37375-d4d8-4a3d-bfb8-0bf498e21a62
21076	21076	0	Biodiversity Information System of Mexico	b324e8e9-9a4c-44fa-8f1a-7f39ea7ab576	7ffabf88-f762-11e1-a439-00145eb45e9a
7763	7763	0	National Biodiversity Network	d897a5b9-35ee-4232-94bd-b0bcaac003c2	805ae16a-0339-4777-9940-a6ddafbe8c69
170	170	0	Biodiversity Information System of Mexico	b324e8e9-9a4c-44fa-8f1a-7f39ea7ab576	808b418e-f762-11e1-a439-00145eb45e9a
191	191	0	Plazi	ffb07bec-2d10-492d-9c37-361fe0b79427	817b5e30-6beb-4862-9304-d09d9481d093
0	9	9	Plazi	ffb07bec-2d10-492d-9c37-361fe0b79427	83d18cb1-636e-4ebf-85f5-4c4d4ad1fb74
1701	1389	-312	GBIF Germany	4f6826f2-4ff6-443d-b966-e6913bd24013	86c08618-f762-11e1-a439-00145eb45e9a
17425	17425	0	GBIF France	da44cd31-5901-4687-a106-6d1c7734ee3a	8789d659-e98c-40ab-8a96-43086d95c5aa
2	2	0	Plazi	ffb07bec-2d10-492d-9c37-361fe0b79427	87c7c118-eacb-4d54-be14-db8a8b50c797
108	60	-48	GBIF Germany	4f6826f2-4ff6-443d-b966-e6913bd24013	8801bdc6-f762-11e1-a439-00145eb45e9a
1	1	0	Plazi	ffb07bec-2d10-492d-9c37-361fe0b79427	88abc046-b975-4119-9dae-9a022ab6347f
4	4	0	Plazi	ffb07bec-2d10-492d-9c37-361fe0b79427	89d5cc69-ce22-4b62-9e3d-0b791edc81d8
59	59	0	GBIF Germany	4f6826f2-4ff6-443d-b966-e6913bd24013	8abd1754-f762-11e1-a439-00145eb45e9a
78	78	0	GBIF France	da44cd31-5901-4687-a106-6d1c7734ee3a	8ac1c811-f041-467b-8ef3-953ac9316cbf
36	36	0	GBIF Germany	4f6826f2-4ff6-443d-b966-e6913bd24013	8c9d6286-f762-11e1-a439-00145eb45e9a
1949	1949	0	Ghana Biodiversity Information Facility	b5633b75-6a86-4fdf-9cfc-506047fb9dc7	8d759514-5679-4f7d-b745-e75707c06bc9
305	305	0	GBIF Germany	4f6826f2-4ff6-443d-b966-e6913bd24013	8ec3156a-f762-11e1-a439-00145eb45e9a
0	4	4	Plazi	ffb07bec-2d10-492d-9c37-361fe0b79427	8f0dd4e6-1af0-457d-81c0-29f2c9955376
0	46	46	Ocean Biodiversity Information System	ba0670b9-4186-41e6-8e70-f9cb3065551a	8f23f4f1-1fdc-4169-9edf-da7b9eb6e6a1
0	7	7	Plazi	ffb07bec-2d10-492d-9c37-361fe0b79427	8f9ffba0-4524-4204-8b98-5aa9aaa2690c
415	301	-114	GBIF Germany	4f6826f2-4ff6-443d-b966-e6913bd24013	8fcc5bb0-f762-11e1-a439-00145eb45e9a
39	26	-13	GBIF Germany	4f6826f2-4ff6-443d-b966-e6913bd24013	910cdbbc-f762-11e1-a439-00145eb45e9a
139	111	-28	GBIF Germany	4f6826f2-4ff6-443d-b966-e6913bd24013	9125d4f0-f762-11e1-a439-00145eb45e9a
202	202	0	GBIF Germany	4f6826f2-4ff6-443d-b966-e6913bd24013	93efd21c-f762-11e1-a439-00145eb45e9a
588	588	0	GBIF Germany	4f6826f2-4ff6-443d-b966-e6913bd24013	94291bc6-f762-11e1-a439-00145eb45e9a
0	1	1	Plazi	ffb07bec-2d10-492d-9c37-361fe0b79427	95393e8a-ade3-4198-bda2-0e37875d9cf7
254	254	0	GBIF Germany	4f6826f2-4ff6-443d-b966-e6913bd24013	95907ce8-f762-11e1-a439-00145eb45e9a
6	6	0	Plazi	ffb07bec-2d10-492d-9c37-361fe0b79427	959bc098-1b50-41a8-bf9f-2e3996288c54
8	8	0	Plazi	ffb07bec-2d10-492d-9c37-361fe0b79427	96372afc-2608-4f05-9d83-51971010508a
7731	8007	276	GBIF Brazil	cdc9736d-5ff7-4ece-9959-3c744360cdb3	965b5ae5-7b2d-4155-a7ff-e9e496d70f90
2530	2530	0	GBIF Sweden	a0b3be64-6525-4387-ac67-a499950f92e1	9954f25c-ec37-414d-b22a-51c79b5b1352
68522	68522	0	Canada Biodiversity Information Facility	8f83fc96-c966-4126-83f7-bf044dc49efa	9c45867f-f77d-42f3-9751-ae16bb7c9bc8
240	240	0	GBIF France	da44cd31-5901-4687-a106-6d1c7734ee3a	9dbe5871-8b6f-4401-9607-6c338b6da26e
31	31	0	Plazi	ffb07bec-2d10-492d-9c37-361fe0b79427	9eb56102-4ed4-4fc6-a4e6-ee94a4b727e1
1712	1712	0	Participant Node Managers Committee	7f48e0c8-5c96-49ec-b972-30748e339115	a298520b-dccd-4eb5-ae58-ec797b0210ea
0	5	5	Plazi	ffb07bec-2d10-492d-9c37-361fe0b79427	a51bb380-e42b-4b8f-9b25-27925807792f
1814	1814	0	National Biodiversity Network	d897a5b9-35ee-4232-94bd-b0bcaac003c2	a5faa00c-028b-4a7d-9dda-e5c39a9678f7
99	99	0	Atlas of Living Australia	4a6f1b71-969e-4fc5-a693-282b05e1220c	a8d6ee00-7297-425e-bcac-9b3b5cc093aa
0	17672	17672	Biodiversity Information System of Mexico	b324e8e9-9a4c-44fa-8f1a-7f39ea7ab576	a984bfc4-ab1f-4e4e-bc7f-e84314f5328f
48	48	0	Plazi	ffb07bec-2d10-492d-9c37-361fe0b79427	b0a3a5c6-0885-4f87-a931-3d629233ad37
0	9	9	Plazi	ffb07bec-2d10-492d-9c37-361fe0b79427	b13d14f8-504a-437c-984b-d2320ca41426
84	84	0	National Biodiversity Network	d897a5b9-35ee-4232-94bd-b0bcaac003c2	b61a751b-8f22-4027-a074-fffa3fe1f9d3
731	731	0	Secretariat of the Pacific Regional Environment Programme	29c6a139-ea7f-41f5-8d9b-c55af8736182	b68c47fc-7e62-440f-9f4b-fc7ab0766df4
1910	1910	0	GBIF France	da44cd31-5901-4687-a106-6d1c7734ee3a	b78cb8f5-86c1-48d3-a151-0c4df6305ed8
12724	12724	0	GBIF France	da44cd31-5901-4687-a106-6d1c7734ee3a	b7b59a50-edad-4c28-9951-c64e50537af3
24	24	0	Colombian Biodiversity Information System	7e865cba-7c46-417b-ade5-97f2cf5b7be0	b8398108-c096-449c-a34f-3341a0d21f1c
4	4	0	Plazi	ffb07bec-2d10-492d-9c37-361fe0b79427	b931ec92-910e-4224-9b4a-463112805869
0	1	1	Plazi	ffb07bec-2d10-492d-9c37-361fe0b79427	bc76aad8-58be-49f2-8746-c252c23471cf
94	94	0	Plazi	ffb07bec-2d10-492d-9c37-361fe0b79427	bd2c96f3-38a4-4d90-85d6-9b90db5936fe
139	139	0	GBIF France	da44cd31-5901-4687-a106-6d1c7734ee3a	be49d007-674b-4a11-a8cc-4cdb49eaf7bc
1	1	0	Plazi	ffb07bec-2d10-492d-9c37-361fe0b79427	bea9fe5a-e3aa-47c3-a268-766e1053e9b3
1516	1516	0	Polish Biodiversity Information Network	2618bfdf-e194-4911-a241-80db3107bc51	c0e00e40-13ae-11de-b2de-b8a03c50a862
35	35	0	Plazi	ffb07bec-2d10-492d-9c37-361fe0b79427	c1e6e039-c100-4c0c-9b4f-fb685f1c9ee0
0	58	58	Plazi	ffb07bec-2d10-492d-9c37-361fe0b79427	c38a3105-adcb-4659-a4ad-8c61df29b90a
0	10951	10951	Ocean Biodiversity Information System	ba0670b9-4186-41e6-8e70-f9cb3065551a	c475ee30-481f-43b4-809d-386b440ebe42
10211	10211	0	Participant Node Managers Committee	7f48e0c8-5c96-49ec-b972-30748e339115	c4a2c617-91a7-4d4f-90dd-a78b899f8545
0	10	10	Plazi	ffb07bec-2d10-492d-9c37-361fe0b79427	c5e32ea3-f3ef-49b1-84b7-ad00caa2ea42
76	77	1	Taiwan Biodiversity Information Facility	e1b85abc-61f9-430f-ba79-6813dec53a0f	c93e0fd0-46a4-48e7-bf68-fc52e2b5f2e9
144	144	0	GBIF France	da44cd31-5901-4687-a106-6d1c7734ee3a	c95cbc18-3beb-4401-806d-a2f8855d27ae
0	3	3	Plazi	ffb07bec-2d10-492d-9c37-361fe0b79427	ca4c7449-f613-4d11-a79f-c4582f3f1750
8462	8462	0	South African Biodiversity Information Facility	7190b835-4e86-4b6e-85c1-19cc6677c250	cc3b1f69-482e-4446-964a-9bbbea66429f
528	528	0	GBIF France	da44cd31-5901-4687-a106-6d1c7734ee3a	cc78dd87-a2ed-449a-9a82-2de10a93cf66
25	25	0	Plazi	ffb07bec-2d10-492d-9c37-361fe0b79427	cfc8b353-070f-4081-a954-8ee7cec84a16
901	901	0	GBIF Japan	db5705aa-6a6e-42f1-8942-d77b9f4896ea	cfd95755-907c-480a-a08f-11d6cbb1e2b5
2	2	0	Plazi	ffb07bec-2d10-492d-9c37-361fe0b79427	d17f25eb-6875-4fcb-b296-d4b6fe0057b4
0	24	24	Plazi	ffb07bec-2d10-492d-9c37-361fe0b79427	d4c72cc3-104c-4371-b921-893e2fca0ac0
16282	16282	0	GBIF Germany	4f6826f2-4ff6-443d-b966-e6913bd24013	d5312bc2-819b-11e2-bad2-00145eb45e9a
2387	2387	0	GBIF France	da44cd31-5901-4687-a106-6d1c7734ee3a	d74a4963-4f71-45a5-82ca-1d81d1ce4321
77	80	3	U.S. Geological Survey	8618c64a-93e0-4300-b546-7249e5148ed2	d7b80380-1156-4d50-a261-c5b1ac1ea59a
328	328	0	Atlas of Living Australia	4a6f1b71-969e-4fc5-a693-282b05e1220c	db9efd51-4f8b-4e58-b2a8-875a151ee00e
3	3	0	Plazi	ffb07bec-2d10-492d-9c37-361fe0b79427	df425f1f-fbf0-4996-b51b-07cb9cb136c9
2184	2184	0	GBIF France	da44cd31-5901-4687-a106-6d1c7734ee3a	e091028c-81ab-4848-b190-081a5224008b
26	26	0	Plazi	ffb07bec-2d10-492d-9c37-361fe0b79427	e3eb548e-fa57-4a0e-8d2d-5e299b5b136e
15	15	0	Plazi	ffb07bec-2d10-492d-9c37-361fe0b79427	e4b2ce86-efc1-4409-8f6e-b21c21877946
123915	123915	0	U.S. Geological Survey	8618c64a-93e0-4300-b546-7249e5148ed2	e635240a-3cb1-4d26-ab87-57d8c7afdfdb
202	202	0	Atlas of Living Australia	4a6f1b71-969e-4fc5-a693-282b05e1220c	e671c044-762c-4db2-bbba-07175f5f3c10
5	5	0	Plazi	ffb07bec-2d10-492d-9c37-361fe0b79427	e8082d85-c74f-4f92-b638-2148540a183c
0	3225	3225	National Biodiversity Network	d897a5b9-35ee-4232-94bd-b0bcaac003c2	e90be209-a5ba-4421-a360-985a2acf5290
11	11	0	Plazi	ffb07bec-2d10-492d-9c37-361fe0b79427	ebc93baf-41f9-4add-951a-442466aa5a24
4327	4327	0	GBIF France	da44cd31-5901-4687-a106-6d1c7734ee3a	ed98d12f-a7ec-446d-b220-00959b80f124
684	684	0	Colombian Biodiversity Information System	7e865cba-7c46-417b-ade5-97f2cf5b7be0	f6af3fa1-5cd9-4404-ac1e-95e3adc53b8b
437	437	0	Plazi	ffb07bec-2d10-492d-9c37-361fe0b79427	f7482a89-9b90-4604-8d8f-2be9083f2161
8	8	0	Plazi	ffb07bec-2d10-492d-9c37-361fe0b79427	f7f55b42-37aa-4568-9202-2313305eace6
42	42	0	GBIF Togo	c9659a3e-07e9-4fcb-83c6-de8b9009a02e	f83b0c09-4ef6-4c6c-9868-019709ba4820
14	14	0	Plazi	ffb07bec-2d10-492d-9c37-361fe0b79427	f8c739e0-2226-47cc-b4ba-f94523fa7834
0	17	17	Plazi	ffb07bec-2d10-492d-9c37-361fe0b79427	f8df9064-3236-42d0-b335-2141cd1fc735
7	7	0	Plazi	ffb07bec-2d10-492d-9c37-361fe0b79427	fb300fa5-6de3-40b4-894d-0dd519de4eb5
473	473	0	GBIF France	da44cd31-5901-4687-a106-6d1c7734ee3a	fba2b843-012f-4ffd-9dfb-57fff0a7099a
7	7	0	Plazi	ffb07bec-2d10-492d-9c37-361fe0b79427	fc353d65-89bb-4f5e-8d25-de00f03bf8be
13	13	0	Plazi	ffb07bec-2d10-492d-9c37-361fe0b79427	fe0d5093-27a5-4ec6-a801-53efd049e49c
10	10	0	Plazi	ffb07bec-2d10-492d-9c37-361fe0b79427	fe8c265b-fb0a-47c8-b0eb-f70a9aedd136
67	67	0	Plazi	ffb07bec-2d10-492d-9c37-361fe0b79427	ffc831a0-51a8-4aac-ab00-55297fc91dd9
0	43	43	Plazi	ffb07bec-2d10-492d-9c37-361fe0b79427	0464179d-9549-4885-9ddd-32ffef32942e
6	6	0	GBIF France	da44cd31-5901-4687-a106-6d1c7734ee3a	06cf5aba-05c9-494d-a53e-3552c7e66869
10	10	0	Plazi	ffb07bec-2d10-492d-9c37-361fe0b79427	0ac34796-b3ba-4f48-8ac2-0195d8eed74c
3	3	0	Plazi	ffb07bec-2d10-492d-9c37-361fe0b79427	0ba97f06-6338-4048-92b1-9c3aebebc794
26	26	0	Colombian Biodiversity Information System	7e865cba-7c46-417b-ade5-97f2cf5b7be0	0c39c5ab-2ad2-47dd-9517-ff9beab25657
146	146	0	Colombian Biodiversity Information System	7e865cba-7c46-417b-ade5-97f2cf5b7be0	0e92918e-72ea-449a-963b-1acc3283488c
356	356	0	GBIF Germany	4f6826f2-4ff6-443d-b966-e6913bd24013	0f0e8e89-03f2-40ec-8e4a-e427f052a248
0	9859	9859	National Biodiversity Network	d897a5b9-35ee-4232-94bd-b0bcaac003c2	0ff1dbf3-7e14-41ec-9394-3c5813fee491
0	106	106	Plazi	ffb07bec-2d10-492d-9c37-361fe0b79427	10b0289e-3eca-4073-8fe7-ac08369f1cdb
6	6	0	Plazi	ffb07bec-2d10-492d-9c37-361fe0b79427	10b71511-1148-4dbb-81ac-7028b6d2ef81
0	7	7	Plazi	ffb07bec-2d10-492d-9c37-361fe0b79427	148ad787-6fea-4334-aaf9-383f85211900
12	12	0	Plazi	ffb07bec-2d10-492d-9c37-361fe0b79427	14f67e3f-f66e-4818-b05a-df5d58fe72a8
0	161	161	Plazi	ffb07bec-2d10-492d-9c37-361fe0b79427	154fa04a-d90d-401d-8d8f-52467a275fce
48	48	0	Plazi	ffb07bec-2d10-492d-9c37-361fe0b79427	1668be17-f285-47ef-98b6-c9d90b8cbd6e
123	123	0	Belgian Biodiversity Platform	fb11cfe1-ebc3-45af-9159-17d9fddbcdac	190ebf60-604c-48c3-a905-c26956572429
0	9	9	Ocean Biodiversity Information System	ba0670b9-4186-41e6-8e70-f9cb3065551a	192280f1-9ce4-4802-8344-eede4ff90ecc
186	186	0	Belgian Biodiversity Platform	fb11cfe1-ebc3-45af-9159-17d9fddbcdac	19c45e1c-c9fa-4b20-9670-61f7fa23140b
52	52	0	Plazi	ffb07bec-2d10-492d-9c37-361fe0b79427	1ed5ac34-1b70-4189-a175-7526621e1705
565	565	0	GBIF Portugal	673f7038-4262-4149-b753-5658a4e912f6	1fe3804c-b788-4031-90b6-8d8040c2f656
75	75	0	GBIF France	da44cd31-5901-4687-a106-6d1c7734ee3a	220c0a3f-c6a5-4303-8600-17ca5a2787a9
12	12	0	Plazi	ffb07bec-2d10-492d-9c37-361fe0b79427	24702638-be7b-411f-a897-1362cff3db8d
4501	4501	0	GBIF Argentina	2426a871-9feb-40a1-96c6-0c593a76b835	24922c42-cd81-4ceb-b348-b9973bdedeaa
4	4	0	Plazi	ffb07bec-2d10-492d-9c37-361fe0b79427	249ecbef-6f9b-468c-90ea-b33d7b8f19e5
0	10	10	Plazi	ffb07bec-2d10-492d-9c37-361fe0b79427	2631a5b1-d231-40e0-9038-ab65aaadba9f
13	13	0	Plazi	ffb07bec-2d10-492d-9c37-361fe0b79427	27b6933e-5ce3-4aae-bf7a-653d3cf161d9
2000	2000	0	Colombian Biodiversity Information System	7e865cba-7c46-417b-ade5-97f2cf5b7be0	2cc1e048-96db-40d2-b9b7-54d0d6975d54
770	770	0	GBIF Germany	4f6826f2-4ff6-443d-b966-e6913bd24013	2d251c2a-0512-4ba6-a018-77f63b837875
3	3	0	Plazi	ffb07bec-2d10-492d-9c37-361fe0b79427	2ddb9653-04c7-45a0-9734-b74b8908695b
112538	112538	0	U.S. Geological Survey	8618c64a-93e0-4300-b546-7249e5148ed2	2e6298fb-d9d7-4915-b69d-890b5aaf91df
1686	1686	0	GBIF France	da44cd31-5901-4687-a106-6d1c7734ee3a	2f18bc65-3097-4624-8c97-60acc8d58658
5097	5095	-2	GBIF Kenya	2a44d626-9f7a-4120-8a7a-4ab5ac15ff2a	302155f9-49a6-4ee2-a01b-293067ddeeed
7	7	0	Participant Node Managers Committee	7f48e0c8-5c96-49ec-b972-30748e339115	312ddc7c-1f8e-4975-bf0b-833356ba0041
109	109	0	Colombian Biodiversity Information System	7e865cba-7c46-417b-ade5-97f2cf5b7be0	344742ba-29c4-4349-9b63-ad33f4a61067
0	17	17	Ocean Biodiversity Information System	ba0670b9-4186-41e6-8e70-f9cb3065551a	3a89acd1-be4c-4321-b37a-28fb3201acf7
10	10	0	Plazi	ffb07bec-2d10-492d-9c37-361fe0b79427	3cb35a49-8d51-490f-b2a1-4706ffca1686
3281	3281	0	GBIF France	da44cd31-5901-4687-a106-6d1c7734ee3a	3d6839a9-d3f5-4f23-8709-fb4dd7531a56
2868	2868	0	GBIF Brazil	cdc9736d-5ff7-4ece-9959-3c744360cdb3	3e95aa8e-a40c-4d34-ad11-7560484f1ff9
272	272	0	Biodiversity Information System of Mexico	b324e8e9-9a4c-44fa-8f1a-7f39ea7ab576	4143ee66-a65a-48c7-8662-765ea71cfc75
15	15	0	Plazi	ffb07bec-2d10-492d-9c37-361fe0b79427	44ad79ec-88a9-411f-8f34-ffbcea09e6ed
1189	1189	0	GBIF Germany	4f6826f2-4ff6-443d-b966-e6913bd24013	4603dd9b-5716-4c68-960b-7102e77520aa
26	26	0	Colombian Biodiversity Information System	7e865cba-7c46-417b-ade5-97f2cf5b7be0	46f9a136-cdea-4ee8-9066-5fff8fd50550
30317	30317	0	Atlas of Living Australia	4a6f1b71-969e-4fc5-a693-282b05e1220c	4797da32-5693-4281-a8f1-bf99bae66ddb
0	4	4	Plazi	ffb07bec-2d10-492d-9c37-361fe0b79427	49e43c44-0a34-4852-86c3-f5269cb7af74
5	5	0	Plazi	ffb07bec-2d10-492d-9c37-361fe0b79427	4b59d032-c569-40be-9cb1-64a2b84dc83c
42	42	0	GBIF Germany	4f6826f2-4ff6-443d-b966-e6913bd24013	4f4046fd-a8c8-45cb-a090-b8bb98036144
8488	8488	0	National Biodiversity Network	d897a5b9-35ee-4232-94bd-b0bcaac003c2	4fc4d2c0-f70c-4038-b98d-9ed1a0634b15
3	3	0	GBIF France	da44cd31-5901-4687-a106-6d1c7734ee3a	50ebd277-0f0a-41fa-9ce7-a6cb4f8787f1
4669	4669	0	Colombian Biodiversity Information System	7e865cba-7c46-417b-ade5-97f2cf5b7be0	528fcbfa-bcb7-4a28-b202-2eadfe93ca2d
150	150	0	GBIF Brazil	cdc9736d-5ff7-4ece-9959-3c744360cdb3	538a8b4a-1696-4708-868a-bc8816b1a276
2043	2043	0	GBIF Japan	db5705aa-6a6e-42f1-8942-d77b9f4896ea	53b1c7f0-18f5-11e2-98fb-00145eb45e9a
0	403	403	Ocean Biodiversity Information System	ba0670b9-4186-41e6-8e70-f9cb3065551a	55851a1a-31c5-4d72-b405-b0e8529818cb
2226	2226	0	Participant Node Managers Committee	7f48e0c8-5c96-49ec-b972-30748e339115	575c5097-521d-47ef-908b-cc659ff249f4
0	27	27	Plazi	ffb07bec-2d10-492d-9c37-361fe0b79427	590e6ac1-bd84-4bac-9d7b-6478be745a4b
0	12	12	Plazi	ffb07bec-2d10-492d-9c37-361fe0b79427	5a95a406-1971-4704-8fae-b4c1c9e555f8
3083	3083	0	GBIF France	da44cd31-5901-4687-a106-6d1c7734ee3a	5cb593bb-ba38-4f48-b67e-e3907df24b16
1228	1228	0	GBIF France	da44cd31-5901-4687-a106-6d1c7734ee3a	5cc66bbc-27a2-4461-8a7f-035cda07e07f
263	263	0	GBIF Germany	4f6826f2-4ff6-443d-b966-e6913bd24013	6171366e-f762-11e1-a439-00145eb45e9a
208	208	0	GBIF Germany	4f6826f2-4ff6-443d-b966-e6913bd24013	61f8f3ba-f762-11e1-a439-00145eb45e9a
28	28	0	GBIF Germany	4f6826f2-4ff6-443d-b966-e6913bd24013	6210f1cc-f762-11e1-a439-00145eb45e9a
87	87	0	GBIF Germany	4f6826f2-4ff6-443d-b966-e6913bd24013	629c30de-f762-11e1-a439-00145eb45e9a
21	21	0	GBIF Germany	4f6826f2-4ff6-443d-b966-e6913bd24013	62b54d08-f762-11e1-a439-00145eb45e9a
24	24	0	GBIF Germany	4f6826f2-4ff6-443d-b966-e6913bd24013	62e530a4-f762-11e1-a439-00145eb45e9a
1	1	0	Plazi	ffb07bec-2d10-492d-9c37-361fe0b79427	62f4ba21-3990-4538-ba14-b5ddfbfcbfbe
15	15	0	GBIF Germany	4f6826f2-4ff6-443d-b966-e6913bd24013	62faea20-f762-11e1-a439-00145eb45e9a
2	2	0	Plazi	ffb07bec-2d10-492d-9c37-361fe0b79427	66ccf05a-746e-41a8-b2a6-85901c55d154
826	826	0	National Biodiversity Network	d897a5b9-35ee-4232-94bd-b0bcaac003c2	66f39e15-e74d-491c-b5d2-397cd6bad884
1099	1099	0	Colombian Biodiversity Information System	7e865cba-7c46-417b-ade5-97f2cf5b7be0	689385b6-a672-4919-a4cc-3365c9d5aceb
42552	42551	-1	GBIF Brazil	cdc9736d-5ff7-4ece-9959-3c744360cdb3	68c90cbc-e74b-4fb6-8ee4-6fa3bd247837
53	53	0	GBIF Germany	4f6826f2-4ff6-443d-b966-e6913bd24013	6902b3f8-f762-11e1-a439-00145eb45e9a
335	335	0	GBIF Germany	4f6826f2-4ff6-443d-b966-e6913bd24013	6a7f57e0-f762-11e1-a439-00145eb45e9a
179	179	0	GBIF Germany	4f6826f2-4ff6-443d-b966-e6913bd24013	6c32402a-f762-11e1-a439-00145eb45e9a
13925	14095	170	U.S. Geological Survey	8618c64a-93e0-4300-b546-7249e5148ed2	6cd25714-849f-4240-a762-ef33aa2e5db5
0	18	18	Plazi	ffb07bec-2d10-492d-9c37-361fe0b79427	6d32f9c2-3094-425b-bb7e-9c6e0517d4fd
170	170	0	Plazi	ffb07bec-2d10-492d-9c37-361fe0b79427	6f5e6228-cb60-4d34-94d4-637d8bfd59d7
186	186	0	Plazi	ffb07bec-2d10-492d-9c37-361fe0b79427	70390707-8e0d-4e5e-8531-e35541bc049c
4692	5740	1048	GBIF Germany	4f6826f2-4ff6-443d-b966-e6913bd24013	71f725b6-f762-11e1-a439-00145eb45e9a
24	24	0	Plazi	ffb07bec-2d10-492d-9c37-361fe0b79427	721a63a7-e667-428c-8574-82693fa25d9e
22	22	0	GBIF Germany	4f6826f2-4ff6-443d-b966-e6913bd24013	73aea7ee-f762-11e1-a439-00145eb45e9a
17	17	0	GBIF Germany	4f6826f2-4ff6-443d-b966-e6913bd24013	73c99ebe-f762-11e1-a439-00145eb45e9a
0	4846	4846	GBIF Norway	4f829580-180d-46a9-9c87-ed8ec959b545	77e91a4f-7b9d-458d-b585-298aa1ef41f8
7	7	0	Plazi	ffb07bec-2d10-492d-9c37-361fe0b79427	782a7986-8a1c-4324-b3fc-23b2fe0b09f0
0	7	7	Plazi	ffb07bec-2d10-492d-9c37-361fe0b79427	785bb8a5-771e-4d07-92be-0178527e1590
116	116	0	GBIF Germany	4f6826f2-4ff6-443d-b966-e6913bd24013	79cb2544-f762-11e1-a439-00145eb45e9a
0	7	7	Ocean Biodiversity Information System	ba0670b9-4186-41e6-8e70-f9cb3065551a	79e82292-96c5-4e30-b0a8-da86bdd229ff
1108	735	-373	GBIF Germany	4f6826f2-4ff6-443d-b966-e6913bd24013	7a11c1d4-f762-11e1-a439-00145eb45e9a
15	15	0	Plazi	ffb07bec-2d10-492d-9c37-361fe0b79427	7a1dc20a-af00-46c0-af31-66ac8bf6fbb4
91	91	0	GBIF France	da44cd31-5901-4687-a106-6d1c7734ee3a	7a269c50-586f-4bdc-b947-f66c2a9e0ad5
8749	8749	0	GBIF Brazil	cdc9736d-5ff7-4ece-9959-3c744360cdb3	7aac2a16-2b16-410c-8649-6aae7a752ebb
10	10	0	Plazi	ffb07bec-2d10-492d-9c37-361fe0b79427	7b6db67b-4b7f-4853-bfb0-6470ac47462b
68	68	0	GBIF Germany	4f6826f2-4ff6-443d-b966-e6913bd24013	7c691644-f762-11e1-a439-00145eb45e9a
238	153	-85	GBIF Germany	4f6826f2-4ff6-443d-b966-e6913bd24013	7cbeac12-f762-11e1-a439-00145eb45e9a
0	15	15	Plazi	ffb07bec-2d10-492d-9c37-361fe0b79427	7d2c1009-228b-4292-857b-c61cfbf7d6f0
580	580	0	GBIF Germany	4f6826f2-4ff6-443d-b966-e6913bd24013	7dbc3d96-f762-11e1-a439-00145eb45e9a
4	4	0	Plazi	ffb07bec-2d10-492d-9c37-361fe0b79427	7dddc276-7521-4b72-b606-2676a149ba8d
111	111	0	GBIF Germany	4f6826f2-4ff6-443d-b966-e6913bd24013	7e4f85b0-f762-11e1-a439-00145eb45e9a
48	48	0	Plazi	ffb07bec-2d10-492d-9c37-361fe0b79427	7e9a6243-ff30-4781-9c3e-b3f53950867f
1485	1485	0	Canadensys	4db9cfd2-1191-4b9d-b579-0b68ceabd968	7efaf3c5-bd1a-42b9-852e-fd39fbc6c5b8
396	396	0	GBIF Germany	4f6826f2-4ff6-443d-b966-e6913bd24013	7f478a3a-f762-11e1-a439-00145eb45e9a
222	222	0	Ocean Biodiversity Information System	ba0670b9-4186-41e6-8e70-f9cb3065551a	7ffd804c-d389-41ad-84ba-4ad5d51d8f04
35	35	0	National Biodiversity Network	d897a5b9-35ee-4232-94bd-b0bcaac003c2	8073bd4c-cf6e-42ad-979c-dc8b3ba1d422
0	10	10	Plazi	ffb07bec-2d10-492d-9c37-361fe0b79427	80d0667e-57fa-41f9-be4b-1af73772d90d
4529	4328	-201	Biodiversity Information System of Mexico	b324e8e9-9a4c-44fa-8f1a-7f39ea7ab576	80d44654-f762-11e1-a439-00145eb45e9a
115	115	0	GBIF Japan	db5705aa-6a6e-42f1-8942-d77b9f4896ea	8104afec-f762-11e1-a439-00145eb45e9a
473	473	0	GBIF Germany	4f6826f2-4ff6-443d-b966-e6913bd24013	814dcb8c-f762-11e1-a439-00145eb45e9a
156	156	0	GBIF Germany	4f6826f2-4ff6-443d-b966-e6913bd24013	8183cfca-f762-11e1-a439-00145eb45e9a
4	4	0	Plazi	ffb07bec-2d10-492d-9c37-361fe0b79427	81f8ec0d-f5d6-418a-a15b-028259ed061a
98	98	0	GBIF Argentina	2426a871-9feb-40a1-96c6-0c593a76b835	8243728a-c19a-4471-8974-249ffc938c29
196	196	0	Colombian Biodiversity Information System	7e865cba-7c46-417b-ade5-97f2cf5b7be0	86505552-36e9-4ced-8ad0-077a9ef83b58
0	8	8	Plazi	ffb07bec-2d10-492d-9c37-361fe0b79427	866eda6e-74f1-4508-85eb-974ffc7bdae8
13	13	0	GBIF Germany	4f6826f2-4ff6-443d-b966-e6913bd24013	88864d48-f762-11e1-a439-00145eb45e9a
15	15	0	GBIF Germany	4f6826f2-4ff6-443d-b966-e6913bd24013	889fc390-f762-11e1-a439-00145eb45e9a
3644	3644	0	U.S. Geological Survey	8618c64a-93e0-4300-b546-7249e5148ed2	8934ad0c-f762-11e1-a439-00145eb45e9a
962	1010	48	GBIF Japan	db5705aa-6a6e-42f1-8942-d77b9f4896ea	89e0c8c6-969e-46a2-b82f-16c24f57bb04
115	115	0	GBIF Germany	4f6826f2-4ff6-443d-b966-e6913bd24013	8a4f6e16-f762-11e1-a439-00145eb45e9a
109	109	0	GBIF Germany	4f6826f2-4ff6-443d-b966-e6913bd24013	8a9b29e6-f762-11e1-a439-00145eb45e9a
267236	267236	0	U.S. Geological Survey	8618c64a-93e0-4300-b546-7249e5148ed2	8be43f9b-52e7-47d4-be3e-dbcc066d70ab
10	10	0	GBIF Germany	4f6826f2-4ff6-443d-b966-e6913bd24013	8c1c817a-f762-11e1-a439-00145eb45e9a
955	955	0	Colombian Biodiversity Information System	7e865cba-7c46-417b-ade5-97f2cf5b7be0	8db77d0a-f139-4f1c-b1c3-16c7fd4a17c0
692	557	-135	GBIF Germany	4f6826f2-4ff6-443d-b966-e6913bd24013	8f52728c-f762-11e1-a439-00145eb45e9a
6	3	-3	GBIF Germany	4f6826f2-4ff6-443d-b966-e6913bd24013	90288de0-f762-11e1-a439-00145eb45e9a
127	111	-16	GBIF Germany	4f6826f2-4ff6-443d-b966-e6913bd24013	932960b4-f762-11e1-a439-00145eb45e9a
500	500	0	Korean Biodiversity Information Facility	e0a1e772-0177-4800-94b4-2d023fe6cdf4	946a5238-d2a4-42b6-8615-384cfe6f10f6
154	143	-11	GBIF Germany	4f6826f2-4ff6-443d-b966-e6913bd24013	953a90d0-f762-11e1-a439-00145eb45e9a
6	5	-1	GBIF Germany	4f6826f2-4ff6-443d-b966-e6913bd24013	95748196-f762-11e1-a439-00145eb45e9a
443	443	0	GBIF Germany	4f6826f2-4ff6-443d-b966-e6913bd24013	958c154a-f762-11e1-a439-00145eb45e9a
1230	1247	17	Colombian Biodiversity Information System	7e865cba-7c46-417b-ade5-97f2cf5b7be0	95f8be9e-48a3-490b-8bd8-b03cc775b14e
121	121	0	National Biodiversity Network	d897a5b9-35ee-4232-94bd-b0bcaac003c2	96650f03-b67c-47e7-a4dd-186ba073e6dc
5	5	0	Plazi	ffb07bec-2d10-492d-9c37-361fe0b79427	9691a997-b6e4-4d47-9082-bbcba7347a3e
8	8	0	Plazi	ffb07bec-2d10-492d-9c37-361fe0b79427	97360f20-c368-4646-b2d0-865ae53e60da
310	310	0	Ocean Biodiversity Information System	ba0670b9-4186-41e6-8e70-f9cb3065551a	9737046d-84e9-4e7d-8f11-5cbc0741da77
2771	2771	0	Biodiversity Information System of Mexico	b324e8e9-9a4c-44fa-8f1a-7f39ea7ab576	9882e0cf-f735-4692-b294-8eb379bd4bb3
494248	494248	0	National Biodiversity Network	d897a5b9-35ee-4232-94bd-b0bcaac003c2	998ff7b4-0e07-40d0-ba1f-c5f249dbcd51
2970	2970	0	GBIF Benin	efb9c00e-f802-45dd-8826-a52ec45b89ff	9d850f67-e358-4dfb-8748-57cd668031e8
49	49	0	GBIF France	da44cd31-5901-4687-a106-6d1c7734ee3a	a00cc4f8-209f-4568-a218-5f499cf2bde1
0	28	28	Ocean Biodiversity Information System	ba0670b9-4186-41e6-8e70-f9cb3065551a	a768900b-a93e-4925-81de-a7009a08cda0
22	22	0	Colombian Biodiversity Information System	7e865cba-7c46-417b-ade5-97f2cf5b7be0	a7bbba02-3242-4dd0-8ee3-1d33642805ca
2	2	0	Plazi	ffb07bec-2d10-492d-9c37-361fe0b79427	aafae82a-0011-4f48-9bc9-4d891aaccb30
0	117	117	Participant Node Managers Committee	7f48e0c8-5c96-49ec-b972-30748e339115	ab201254-ed06-4290-9af9-33c421cdc391
0	1	1	Plazi	ffb07bec-2d10-492d-9c37-361fe0b79427	ab27829e-5f78-436f-8390-7d7d077a1c04
117	117	0	Colombian Biodiversity Information System	7e865cba-7c46-417b-ade5-97f2cf5b7be0	af98f926-16e4-4c9f-b7c2-3057d8a83ecc
2	2	0	GBIF France	da44cd31-5901-4687-a106-6d1c7734ee3a	b0bd16e0-a3a6-4989-935d-a40874fc00ea
8	8	0	Plazi	ffb07bec-2d10-492d-9c37-361fe0b79427	b0d92a8d-4eef-4a58-83a9-e7f3fa078ef0
921	921	0	GBIF Finland	dd514216-5c7c-45f3-910d-797424cb5be6	b159e5c0-075f-425b-b543-c02a44ece750
0	1193	1193	Ocean Biodiversity Information System	ba0670b9-4186-41e6-8e70-f9cb3065551a	b18cc876-e22c-446b-a91e-fc82722e0040
37	37	0	GBIF Sweden	a0b3be64-6525-4387-ac67-a499950f92e1	b204df9b-71d1-4a82-833a-31915c3c392d
6027	6027	0	Scientific Committee on Antarctic Research	51e4e8ff-bff0-4996-8b27-9107d61b3478	b212e93b-7800-4b05-8e2d-5f26798f5002
6884	6884	0	Atlas of Living Australia	4a6f1b71-969e-4fc5-a693-282b05e1220c	b88664ca-8b02-46c4-a6b8-80ba371e164c
7	7	0	GBIF Germany	4f6826f2-4ff6-443d-b966-e6913bd24013	bc8bb396-10e9-4311-a09b-59be67d4b135
0	4	4	Plazi	ffb07bec-2d10-492d-9c37-361fe0b79427	bd547e26-8bd1-4d24-a918-f2efac7a0692
6	6	0	Plazi	ffb07bec-2d10-492d-9c37-361fe0b79427	bd691cfc-041d-4ed5-b9dc-eab3c3c26d4c
9	9	0	Plazi	ffb07bec-2d10-492d-9c37-361fe0b79427	bf10a187-3f72-4852-9665-28abd120b225
976	976	0	GBIF Argentina	2426a871-9feb-40a1-96c6-0c593a76b835	bf46ae19-3c02-4701-bcb9-ca6d176c4895
546	546	0	Plazi	ffb07bec-2d10-492d-9c37-361fe0b79427	c2906488-8302-4ccb-b2cf-e9fe1e782ea5
54	54	0	GBIF Argentina	2426a871-9feb-40a1-96c6-0c593a76b835	c29a9c24-c6b8-4afb-9054-9292cc45b43a
22	22	0	Colombian Biodiversity Information System	7e865cba-7c46-417b-ade5-97f2cf5b7be0	c4756d59-c109-4035-bca2-3414512013ad
2005	1853	-152	Biodiversity Information System of Mexico	b324e8e9-9a4c-44fa-8f1a-7f39ea7ab576	c4782b11-2acd-417c-bca2-8c587f3297f0
321	321	0	Colombian Biodiversity Information System	7e865cba-7c46-417b-ade5-97f2cf5b7be0	c6860ae3-8485-4d31-bc79-c60f0fe0d3d0
62709	63086	377	GBIF Brazil	cdc9736d-5ff7-4ece-9959-3c744360cdb3	ca7f81ae-ebf9-43a8-947c-535a87fe5aec
158	158	0	National Biodiversity Network	d897a5b9-35ee-4232-94bd-b0bcaac003c2	cbb29a05-c37f-4eec-99d2-fb27489f5028
8	8	0	GBIF France	da44cd31-5901-4687-a106-6d1c7734ee3a	cd8b7fec-7af8-4dab-a113-85791e821768
0	163	163	Ocean Biodiversity Information System	ba0670b9-4186-41e6-8e70-f9cb3065551a	cfd45dbd-7749-42ed-a1aa-4faf3f4a1d82
0	116	116	Ocean Biodiversity Information System	ba0670b9-4186-41e6-8e70-f9cb3065551a	d176b86e-2ddb-47ef-bc3d-610d0110b413
11396	11396	0	U.S. Geological Survey	8618c64a-93e0-4300-b546-7249e5148ed2	d4855ca5-4037-4a00-a698-8cddbf7e4438
292	292	0	GBIF Germany	4f6826f2-4ff6-443d-b966-e6913bd24013	d6618bc2-ce35-4c16-94e1-d58063736899
7	7	0	Plazi	ffb07bec-2d10-492d-9c37-361fe0b79427	d80fc0d4-506d-45ee-9f91-ce68f0ac21a8
0	27	27	Plazi	ffb07bec-2d10-492d-9c37-361fe0b79427	d86446dd-01d8-4ebe-8d43-c19e94d70334
144	144	0	Participant Node Managers Committee	7f48e0c8-5c96-49ec-b972-30748e339115	d9390fcc-b612-472d-bfea-a0047cd6d8c8
15534	15534	0	Atlas of Living Australia	4a6f1b71-969e-4fc5-a693-282b05e1220c	d9ebe5c6-0295-487b-8c26-3f2ff626fce3
267	267	0	Participant Node Managers Committee	7f48e0c8-5c96-49ec-b972-30748e339115	dce6d2a2-ad45-4b97-8ce5-aace48cb8c8f
967	967	0	GBIF France	da44cd31-5901-4687-a106-6d1c7734ee3a	df7a89d4-20cf-402a-ae5d-15e97b040692
0	1	1	Plazi	ffb07bec-2d10-492d-9c37-361fe0b79427	e3fd15a2-5823-4640-bd84-46058d760fb1
2968	2968	0	Biodiversity Information System of Mexico	b324e8e9-9a4c-44fa-8f1a-7f39ea7ab576	e505b8fb-46a2-4c59-8d82-c2173177ff3a
4494	4494	0	Netherlands Biodiversity Information Facility	0909d601-bda2-42df-9e63-a6d51847ebce	e567684d-9998-4604-9790-b0ac00e090c1
4	4	0	Plazi	ffb07bec-2d10-492d-9c37-361fe0b79427	ea34233a-9ba5-4022-ad7c-78eb11687693
0	15	15	Ocean Biodiversity Information System	ba0670b9-4186-41e6-8e70-f9cb3065551a	eb2e0db0-079d-460e-a8ab-055f4a426dec
445	445	0	GBIF France	da44cd31-5901-4687-a106-6d1c7734ee3a	ed6ee121-1b4c-4382-bd4d-2128aa47c202
0	6	6	Plazi	ffb07bec-2d10-492d-9c37-361fe0b79427	f0f32929-a7e7-4a5d-acf7-16d1eff7491a
9640	9640	0	Polish Biodiversity Information Network	2618bfdf-e194-4911-a241-80db3107bc51	f507fe60-30b1-11de-b170-b8a03c50a862
154	154	0	GBIF Portugal	673f7038-4262-4149-b753-5658a4e912f6	f76f3667-d0ff-4304-af67-ceab4820445a
1	1	0	Plazi	ffb07bec-2d10-492d-9c37-361fe0b79427	fb186d24-4da3-4a99-aa6d-71e1b64797bf
862	862	0	GBIF Germany	4f6826f2-4ff6-443d-b966-e6913bd24013	fcd7b289-577c-407d-b2af-bd69f9925847
42570	42570	0	Polish Biodiversity Information Network	2618bfdf-e194-4911-a241-80db3107bc51	fdf5cc60-9fcc-11da-a90c-b8a03c50a862
0	35	35	Plazi	ffb07bec-2d10-492d-9c37-361fe0b79427	02750558-eeb0-417a-813c-7c34b00a1979
0	52	52	Plazi	ffb07bec-2d10-492d-9c37-361fe0b79427	02a1dc1e-5f74-40e6-8f7b-24f96874124e
0	17	17	Plazi	ffb07bec-2d10-492d-9c37-361fe0b79427	0446a02f-582d-4cc6-b559-06e15b28e6ab
0	5528	5528	Canada Biodiversity Information Facility	8f83fc96-c966-4126-83f7-bf044dc49efa	084feec5-77dc-4fad-9037-42880f2a3214
6	6	0	Plazi	ffb07bec-2d10-492d-9c37-361fe0b79427	0894f26c-4559-44d2-84ff-237f06f60500
2	2	0	Plazi	ffb07bec-2d10-492d-9c37-361fe0b79427	0942ce3f-ffb7-4bab-a0d6-195e1771fbea
78246	78246	0	GBIF France	da44cd31-5901-4687-a106-6d1c7734ee3a	0b5f972e-0f84-4d07-9b84-96c09e2925da
0	1	1	Plazi	ffb07bec-2d10-492d-9c37-361fe0b79427	0d74f3b0-6e97-4801-90e7-ce9585ebd1dd
86	86	0	GBIF France	da44cd31-5901-4687-a106-6d1c7734ee3a	11b1d2a9-4014-490c-88a8-6b43eb3dc01c
0	6370	6370	Ocean Biodiversity Information System	ba0670b9-4186-41e6-8e70-f9cb3065551a	1339958d-cfb0-43d5-8a36-5f3c08d0d6cd
23	23	0	Plazi	ffb07bec-2d10-492d-9c37-361fe0b79427	168fa4f3-250e-41a7-b4a5-78c76f2501c1
1857	1857	0	GBIF Spain	1f94b3ca-9345-4d65-afe2-4bace93aa0fe	1b904099-fc6e-4824-b72e-d93574090354
0	7	7	Plazi	ffb07bec-2d10-492d-9c37-361fe0b79427	1c2a3959-390a-4727-a9fc-ae520426eeea
4216	4216	0	GBIF France	da44cd31-5901-4687-a106-6d1c7734ee3a	1d9d4582-b0aa-4e91-96cb-f80a0de21680
0	3	3	Ocean Biodiversity Information System	ba0670b9-4186-41e6-8e70-f9cb3065551a	20b89c9f-0a89-4fb6-9dd0-473bba1f656d
0	1	1	Plazi	ffb07bec-2d10-492d-9c37-361fe0b79427	27f2c93d-544d-46be-b66f-f26ac0fbe0f0
896	896	0	GBIF Benin	efb9c00e-f802-45dd-8826-a52ec45b89ff	289d0510-12d8-4d87-9875-465cfc7a8769
0	8	8	Plazi	ffb07bec-2d10-492d-9c37-361fe0b79427	2a751447-2736-4c6d-a379-5d6c31745974
0	1	1	Plazi	ffb07bec-2d10-492d-9c37-361fe0b79427	2b7b8251-3653-4ba3-a436-acbdb5a93fc6
1193488	1193488	0	U.S. Geological Survey	8618c64a-93e0-4300-b546-7249e5148ed2	31a35af0-c997-4f76-b045-9942bc14b896
1035	995	-40	Participant Node Managers Committee	7f48e0c8-5c96-49ec-b972-30748e339115	31bb628c-cc7f-423c-914e-746271fb5694
0	1	1	Plazi	ffb07bec-2d10-492d-9c37-361fe0b79427	33418eac-3f41-4da6-94aa-eafa33222a2e
0	12	12	Plazi	ffb07bec-2d10-492d-9c37-361fe0b79427	338182f7-c740-4bbb-bbcf-1e7caef8f9fc
9	9	0	Plazi	ffb07bec-2d10-492d-9c37-361fe0b79427	35700b8a-4079-4a2e-9df6-31626580cc8b
22551	22551	0	U.S. Geological Survey	8618c64a-93e0-4300-b546-7249e5148ed2	35720b3e-aded-4b83-b4f1-967f1d457d6a
474	474	0	GBIF France	da44cd31-5901-4687-a106-6d1c7734ee3a	36d27777-f6fa-454e-9a70-c4e9a8a547f3
75	75	0	Participant Node Managers Committee	7f48e0c8-5c96-49ec-b972-30748e339115	3c040495-147e-4740-b793-e99edbbc317a
8109	8109	0	GBIF Spain	1f94b3ca-9345-4d65-afe2-4bace93aa0fe	3f907a27-73e4-429b-9d36-7476f3b75c58
919	919	0	GBIF France	da44cd31-5901-4687-a106-6d1c7734ee3a	43325c51-e94d-4ccf-9a17-f61f2fcdee6b
27290	27290	0	Costa Rica Biodiversity Facility	3379bb09-1a58-41e7-9c57-e3b66c3eb5a0	43f37d70-f50e-4021-95ae-5b9526df2388
2381	2381	0	GBIF Japan	db5705aa-6a6e-42f1-8942-d77b9f4896ea	4487d0be-178f-412f-b2fc-bb4aabcd867a
13	13	0	Plazi	ffb07bec-2d10-492d-9c37-361fe0b79427	45d116e6-543a-4b1b-9e4c-6a09146d4b5d
2088	2088	0	U.S. Geological Survey	8618c64a-93e0-4300-b546-7249e5148ed2	45f925a5-c75a-4386-b74d-9e62e5229399
832	832	0	GBIF France	da44cd31-5901-4687-a106-6d1c7734ee3a	46c6c590-2115-4ddb-a20c-c6ad4295eb8d
0	70	70	Plazi	ffb07bec-2d10-492d-9c37-361fe0b79427	4763889e-2887-4a8f-b3da-7849c139bb28
66542	66542	0	GBIF France	da44cd31-5901-4687-a106-6d1c7734ee3a	49350fa5-9510-4fdb-a657-02a8194c2de3
0	5	5	Plazi	ffb07bec-2d10-492d-9c37-361fe0b79427	49bf613b-5fcc-4d38-b4ae-80c9699566f7
508	508	0	Participant Node Managers Committee	7f48e0c8-5c96-49ec-b972-30748e339115	4b07e08f-3be0-4a5c-ae7d-e450e6a7a1fb
9957	9957	0	Atlas of Living Australia	4a6f1b71-969e-4fc5-a693-282b05e1220c	4b0a57d0-1d9a-462e-aaf5-2a727081a207
0	3	3	Plazi	ffb07bec-2d10-492d-9c37-361fe0b79427	4b187e4d-a8e1-4c62-be7f-8759989f9590
1801	1801	0	GBIF France	da44cd31-5901-4687-a106-6d1c7734ee3a	4b74f1d2-b8de-477b-a7e9-7e6e4bd4f63e
258	269	11	GBIF Germany	4f6826f2-4ff6-443d-b966-e6913bd24013	4d6131e0-97a0-4531-a8fa-67bb6aa46a37
1	1	0	Plazi	ffb07bec-2d10-492d-9c37-361fe0b79427	4d7d39f9-35e1-470e-bc2a-dc7cdf931c01
5	5	0	Plazi	ffb07bec-2d10-492d-9c37-361fe0b79427	50565735-7a9a-4154-925a-5d82934ced48
992	832	-160	GBIF Germany	4f6826f2-4ff6-443d-b966-e6913bd24013	5066e5ae-adf8-4cb5-a8ba-b7f3cbe58968
0	2	2	Plazi	ffb07bec-2d10-492d-9c37-361fe0b79427	51b55a33-197a-4572-a8cb-02d1a8bb92b2
10	10	0	Plazi	ffb07bec-2d10-492d-9c37-361fe0b79427	580bbe51-8a39-4668-8b46-508f4e66e920
1087	1087	0	GBIF Brazil	cdc9736d-5ff7-4ece-9959-3c744360cdb3	5846793d-f540-473c-88ee-23b2b13af7ef
0	8	8	Plazi	ffb07bec-2d10-492d-9c37-361fe0b79427	59baf61d-91b4-473a-aa66-3538f59e09fb
0	14	14	Plazi	ffb07bec-2d10-492d-9c37-361fe0b79427	5ae83f46-d196-4ea8-a7a0-621a73e6c9ec
0	182	182	Symbiota Support Hub	612b5a0b-908b-4b4e-b9bf-ca15dfdc94fa	5bab201b-e36e-4c4d-898c-bff52957da1d
547	547	0	Colombian Biodiversity Information System	7e865cba-7c46-417b-ade5-97f2cf5b7be0	5e574acf-6516-492f-823c-f04bd312821f
9	9	0	GBIF Germany	4f6826f2-4ff6-443d-b966-e6913bd24013	5fc69478-a5d3-4c7e-8ece-78cf02f14538
1734	1734	0	GBIF Germany	4f6826f2-4ff6-443d-b966-e6913bd24013	60bae0de-7730-43a8-8fdf-57f417f80ca6
88	88	0	GBIF Germany	4f6826f2-4ff6-443d-b966-e6913bd24013	6160f524-f762-11e1-a439-00145eb45e9a
28	28	0	GBIF Germany	4f6826f2-4ff6-443d-b966-e6913bd24013	61dba88c-f762-11e1-a439-00145eb45e9a
0	64658	64658	Participant Node Managers Committee	7f48e0c8-5c96-49ec-b972-30748e339115	61e92984-382b-4158-be6b-e391c7ed5a64
96	71	-25	Biodiversity Information System of Mexico	b324e8e9-9a4c-44fa-8f1a-7f39ea7ab576	648ab960-2021-4f48-8b3a-7b7343f3c84f
4861	4682	-179	GBIF Germany	4f6826f2-4ff6-443d-b966-e6913bd24013	6536cfe8-f762-11e1-a439-00145eb45e9a
421	421	0	GBIF Germany	4f6826f2-4ff6-443d-b966-e6913bd24013	653c8898-f762-11e1-a439-00145eb45e9a
85	85	0	GBIF Germany	4f6826f2-4ff6-443d-b966-e6913bd24013	665ab952-f762-11e1-a439-00145eb45e9a
32183	32183	0	GBIF France	da44cd31-5901-4687-a106-6d1c7734ee3a	679c0376-3de3-4edb-98d2-32ac4a5dd503
75	75	0	GBIF Germany	4f6826f2-4ff6-443d-b966-e6913bd24013	6879c142-f762-11e1-a439-00145eb45e9a
60	60	0	GBIF Germany	4f6826f2-4ff6-443d-b966-e6913bd24013	692c675c-f762-11e1-a439-00145eb45e9a
0	234	234	Colombian Biodiversity Information System	7e865cba-7c46-417b-ade5-97f2cf5b7be0	69cad520-4608-44d7-b96b-96a9d1cd5bd9
4	4	0	GBIF Germany	4f6826f2-4ff6-443d-b966-e6913bd24013	6a0306ea-f762-11e1-a439-00145eb45e9a
126	126	0	GBIF France	da44cd31-5901-4687-a106-6d1c7734ee3a	6a5bca76-9c9b-4962-acda-c02ddc2292dc
918	918	0	GBIF France	da44cd31-5901-4687-a106-6d1c7734ee3a	6ab6196f-f71c-44de-b49b-ec16b95ac335
4	4	0	GBIF Germany	4f6826f2-4ff6-443d-b966-e6913bd24013	6b5b6c12-f762-11e1-a439-00145eb45e9a
78	78	0	GBIF Germany	4f6826f2-4ff6-443d-b966-e6913bd24013	6cc53524-f762-11e1-a439-00145eb45e9a
25	25	0	Plazi	ffb07bec-2d10-492d-9c37-361fe0b79427	6db0888d-983c-4766-aafd-f565fece0887
2	2	0	Plazi	ffb07bec-2d10-492d-9c37-361fe0b79427	7043056b-4747-42d4-a100-27de14f69713
4	4	0	GBIF Germany	4f6826f2-4ff6-443d-b966-e6913bd24013	72ab785e-f762-11e1-a439-00145eb45e9a
61	61	0	Plazi	ffb07bec-2d10-492d-9c37-361fe0b79427	72ce7b68-eaab-4136-b40c-3512b3578bfe
13	13	0	GBIF Germany	4f6826f2-4ff6-443d-b966-e6913bd24013	73cae878-f762-11e1-a439-00145eb45e9a
22	22	0	GBIF Germany	4f6826f2-4ff6-443d-b966-e6913bd24013	745a3f00-f762-11e1-a439-00145eb45e9a
235	235	0	GBIF Germany	4f6826f2-4ff6-443d-b966-e6913bd24013	7509083c-f762-11e1-a439-00145eb45e9a
45	45	0	Plazi	ffb07bec-2d10-492d-9c37-361fe0b79427	761e959f-fbe6-4906-861d-1df09f331e52
2	2	0	GBIF Sweden	a0b3be64-6525-4387-ac67-a499950f92e1	76fbd3dc-2ae8-4794-8ef9-ca9b501925d3
1043	836	-207	GBIF Germany	4f6826f2-4ff6-443d-b966-e6913bd24013	79b95fb2-f762-11e1-a439-00145eb45e9a
0	105	105	Ocean Biodiversity Information System	ba0670b9-4186-41e6-8e70-f9cb3065551a	79de9b5f-24f0-4f1f-9f54-81148f08d382
360	64	-296	GBIF Germany	4f6826f2-4ff6-443d-b966-e6913bd24013	7cb59604-f762-11e1-a439-00145eb45e9a
1806	504	-1302	GBIF Germany	4f6826f2-4ff6-443d-b966-e6913bd24013	7cdc1342-f762-11e1-a439-00145eb45e9a
8	8	0	GBIF Japan	db5705aa-6a6e-42f1-8942-d77b9f4896ea	7d4ae541-a54e-45a5-8dc2-faa8a7c1613b
1640	1640	0	GBIF Germany	4f6826f2-4ff6-443d-b966-e6913bd24013	7d5e42a4-f762-11e1-a439-00145eb45e9a
24	24	0	Plazi	ffb07bec-2d10-492d-9c37-361fe0b79427	7e0c069a-ada6-4402-9b98-972d4cc463e6
700	700	0	GBIF Germany	4f6826f2-4ff6-443d-b966-e6913bd24013	7f040aa8-f762-11e1-a439-00145eb45e9a
20	20	0	Plazi	ffb07bec-2d10-492d-9c37-361fe0b79427	7f223778-dd55-45a1-9878-88ae789e57ac
1564	707	-857	Biodiversity Information System of Mexico	b324e8e9-9a4c-44fa-8f1a-7f39ea7ab576	7f6143b2-f762-11e1-a439-00145eb45e9a
12	12	0	Plazi	ffb07bec-2d10-492d-9c37-361fe0b79427	8002132f-c8b6-4e97-b29c-7bcebbad3de3
20170	20170	0	Biodiversity Information System of Mexico	b324e8e9-9a4c-44fa-8f1a-7f39ea7ab576	802f2cdc-f762-11e1-a439-00145eb45e9a
506	506	0	Biodiversity Information System of Mexico	b324e8e9-9a4c-44fa-8f1a-7f39ea7ab576	809d22b4-f762-11e1-a439-00145eb45e9a
7462	7462	0	GBIF Japan	db5705aa-6a6e-42f1-8942-d77b9f4896ea	81251eee-f762-11e1-a439-00145eb45e9a
313	313	0	GBIF Germany	4f6826f2-4ff6-443d-b966-e6913bd24013	819db3fe-f762-11e1-a439-00145eb45e9a
0	20	20	Plazi	ffb07bec-2d10-492d-9c37-361fe0b79427	82bdee28-6a14-4f2d-b7b1-b4b103383775
175755	177582	1827	U.S. Geological Survey	8618c64a-93e0-4300-b546-7249e5148ed2	832b8188-f762-11e1-a439-00145eb45e9a
5449	5426	-23	Ocean Biodiversity Information System	ba0670b9-4186-41e6-8e70-f9cb3065551a	83e29da0-f762-11e1-a439-00145eb45e9a
7873	7873	0	GBIF Argentina	2426a871-9feb-40a1-96c6-0c593a76b835	840db01a-f557-4c70-9f26-ac272faeeda2
789	789	0	Atlas of Living Australia	4a6f1b71-969e-4fc5-a693-282b05e1220c	84149905-2fc7-4cc6-a9c8-f4186e0a62a8
6323	6323	0	Canada Biodiversity Information Facility	8f83fc96-c966-4126-83f7-bf044dc49efa	8472b4b2-f762-11e1-a439-00145eb45e9a
190	190	0	GBIF France	da44cd31-5901-4687-a106-6d1c7734ee3a	84b5acd8-80f5-4464-9254-f6687c3859f8
119	119	0	U.S. Geological Survey	8618c64a-93e0-4300-b546-7249e5148ed2	851bd272-f762-11e1-a439-00145eb45e9a
125449	125449	0	GBIF Israel	8cb55387-7802-40e8-86d6-d357a583c596	863c1269-5f38-4862-a161-ea3a50654d4f
0	15	15	Plazi	ffb07bec-2d10-492d-9c37-361fe0b79427	8676cee2-bcd9-4c05-8420-af7951a7c387
41	41	0	GBIF Germany	4f6826f2-4ff6-443d-b966-e6913bd24013	86f20c06-f762-11e1-a439-00145eb45e9a
685	685	0	GBIF Germany	4f6826f2-4ff6-443d-b966-e6913bd24013	87a9feba-f762-11e1-a439-00145eb45e9a
224	224	0	GBIF Germany	4f6826f2-4ff6-443d-b966-e6913bd24013	8a20c066-f762-11e1-a439-00145eb45e9a
194	194	0	GBIF Germany	4f6826f2-4ff6-443d-b966-e6913bd24013	8bdc91be-f762-11e1-a439-00145eb45e9a
8	8	0	GBIF Germany	4f6826f2-4ff6-443d-b966-e6913bd24013	8c0eb090-f762-11e1-a439-00145eb45e9a
604	604	0	GBIF Germany	4f6826f2-4ff6-443d-b966-e6913bd24013	8d73d9b0-f762-11e1-a439-00145eb45e9a
43	43	0	Participant Node Managers Committee	7f48e0c8-5c96-49ec-b972-30748e339115	8f6d3a0d-10d2-44e3-8612-be219376c860
2984	2984	0	U.S. Geological Survey	8618c64a-93e0-4300-b546-7249e5148ed2	8fc950e3-53c4-4fad-a9b0-1b13b31bd87b
5	11	6	Plazi	ffb07bec-2d10-492d-9c37-361fe0b79427	91cacb4e-dc01-4157-af9a-ebdc303ce86f
181	122	-59	GBIF Germany	4f6826f2-4ff6-443d-b966-e6913bd24013	924bdd52-f762-11e1-a439-00145eb45e9a
35	33	-2	GBIF Germany	4f6826f2-4ff6-443d-b966-e6913bd24013	9290b134-f762-11e1-a439-00145eb45e9a
1	1	0	Plazi	ffb07bec-2d10-492d-9c37-361fe0b79427	929605d5-af60-4733-b17d-6379d750ae04
1567	1362	-205	GBIF Germany	4f6826f2-4ff6-443d-b966-e6913bd24013	92db3b78-f762-11e1-a439-00145eb45e9a
231	147	-84	GBIF Germany	4f6826f2-4ff6-443d-b966-e6913bd24013	931a2e00-f762-11e1-a439-00145eb45e9a
565	565	0	GBIF Germany	4f6826f2-4ff6-443d-b966-e6913bd24013	950ef6d2-f762-11e1-a439-00145eb45e9a
20	20	0	Plazi	ffb07bec-2d10-492d-9c37-361fe0b79427	960808cf-a740-4bb6-95a6-ecac790695a5
1198	1198	0	Colombian Biodiversity Information System	7e865cba-7c46-417b-ade5-97f2cf5b7be0	96c10340-e43d-4542-8d34-7dd0c4b3b010
0	9	9	Plazi	ffb07bec-2d10-492d-9c37-361fe0b79427	978b6d1a-2dfd-4820-8e28-5d0def7ba731
1442	1442	0	GBIF France	da44cd31-5901-4687-a106-6d1c7734ee3a	97ba3fd4-bfbb-4dc6-9298-b8c71ad630b7
2	2	0	Plazi	ffb07bec-2d10-492d-9c37-361fe0b79427	97d3beda-ceba-4422-8787-79e564142fea
0	66152	66152	GBIF Switzerland	169eb292-376b-4cc6-8e31-9c2c432de0ad	98436813-7443-41cf-ae89-c53d199af8d0
7	7	0	Plazi	ffb07bec-2d10-492d-9c37-361fe0b79427	9ae86fbe-1d06-4ee2-a2e8-0ee751be7599
1211	1211	0	GBIF Spain	1f94b3ca-9345-4d65-afe2-4bace93aa0fe	9bed48a2-4af2-4adc-bb73-7af14117dbc3
1	1	0	Plazi	ffb07bec-2d10-492d-9c37-361fe0b79427	9c5dee5f-93cb-41cb-8b5b-5c70898806d0
1703418	1703418	0	GBIF Spain	1f94b3ca-9345-4d65-afe2-4bace93aa0fe	a4b7c71e-fc73-434e-a008-d63c222179d0
0	3	3	Plazi	ffb07bec-2d10-492d-9c37-361fe0b79427	a58aac40-c791-4326-a0c4-7e43c36095b8
0	2	2	Plazi	ffb07bec-2d10-492d-9c37-361fe0b79427	a59626b9-25ac-43a2-bb1e-163f8d98f229
12	12	0	GBIF Brazil	cdc9736d-5ff7-4ece-9959-3c744360cdb3	a6170091-e531-474f-aa0a-db79a0739e81
2	2	0	GBIF France	da44cd31-5901-4687-a106-6d1c7734ee3a	a6509cef-e57c-42d4-b7d4-b49f721bb4fb
1124	1124	0	National Biodiversity Network	d897a5b9-35ee-4232-94bd-b0bcaac003c2	a6b4e389-9e9a-4868-a0ba-37adf1f17da7
0	4	4	Plazi	ffb07bec-2d10-492d-9c37-361fe0b79427	a7bd7f2f-33d4-4ff6-8912-a1ac27b0183d
12	12	0	Plazi	ffb07bec-2d10-492d-9c37-361fe0b79427	a9a57287-a368-470c-b655-91442580d467
511273	511273	0	GBIF France	da44cd31-5901-4687-a106-6d1c7734ee3a	ab47c4a9-4b6a-4d59-b846-899d9420f7d3
19	19	0	Plazi	ffb07bec-2d10-492d-9c37-361fe0b79427	abe73cb2-b930-4796-8fcd-31d840646551
0	8	8	Participant Node Managers Committee	7f48e0c8-5c96-49ec-b972-30748e339115	ac87fc1e-71ef-4eca-8bad-586264fe85a5
1	1	0	Plazi	ffb07bec-2d10-492d-9c37-361fe0b79427	acd9cbd2-489f-4c24-a2fa-87637f5fb64a
2090	2090	0	National Biodiversity Network	d897a5b9-35ee-4232-94bd-b0bcaac003c2	ae1c0f69-c920-4a94-94d5-4a0b08966a86
1691	1691	0	Atlas of Living Australia	4a6f1b71-969e-4fc5-a693-282b05e1220c	aea7520f-8c5d-4a7a-9240-4e7fbeaefe86
6	6	0	Plazi	ffb07bec-2d10-492d-9c37-361fe0b79427	af6d65e5-186c-41b6-b9f5-cdc05b220dbc
375	375	0	GBIF France	da44cd31-5901-4687-a106-6d1c7734ee3a	b0c75669-4339-4bba-b0e0-98b2a88e166d
6	6	0	Plazi	ffb07bec-2d10-492d-9c37-361fe0b79427	b35bfbad-0050-4662-b03e-3a59235b22d2
0	1014	1014	Ocean Biodiversity Information System	ba0670b9-4186-41e6-8e70-f9cb3065551a	b5c8dd21-4138-4bc2-84cd-761470faa01e
1	1	0	Plazi	ffb07bec-2d10-492d-9c37-361fe0b79427	bb5dab77-edad-48fe-aeb2-a72b9d94a6a0
0	7	7	Colombian Biodiversity Information System	7e865cba-7c46-417b-ade5-97f2cf5b7be0	bda73b1f-2a50-4bb6-b6b4-3561f2bfd307
0	22	22	Plazi	ffb07bec-2d10-492d-9c37-361fe0b79427	bebcad4f-3fed-4820-ac9f-e61f806868a0
294	294	0	GBIF France	da44cd31-5901-4687-a106-6d1c7734ee3a	c08252b8-8310-41fe-8bf7-e2ec071a6a46
1	1	0	GBIF Portugal	673f7038-4262-4149-b753-5658a4e912f6	c0bd5266-b0f3-48d2-bc9f-1bf7bc70a8ce
138313	138648	335	U.S. Geological Survey	8618c64a-93e0-4300-b546-7249e5148ed2	c267909d-184f-4138-9e67-a074d478d52b
0	24	24	Plazi	ffb07bec-2d10-492d-9c37-361fe0b79427	c45ae0a1-a4c5-4cd5-93c5-abdbb5a2a727
5	5	0	Plazi	ffb07bec-2d10-492d-9c37-361fe0b79427	c9bb3dff-7b8b-4968-a913-52120b4315c9
6197	6197	0	Polish Biodiversity Information Network	2618bfdf-e194-4911-a241-80db3107bc51	ca5ff7c0-ad1f-11db-9793-b8a03c50a862
8	8	0	Plazi	ffb07bec-2d10-492d-9c37-361fe0b79427	ca8ad547-1de7-4220-88ad-6b0a697a1811
0	1123	1123	Participant Node Managers Committee	7f48e0c8-5c96-49ec-b972-30748e339115	cb28169b-df56-44d5-994a-b35cdaa81fa6
2800	2110	-690	GBIF Germany	4f6826f2-4ff6-443d-b966-e6913bd24013	cef775a7-999f-49f3-b03f-802f1b839b59
11	11	0	Plazi	ffb07bec-2d10-492d-9c37-361fe0b79427	d012c38c-05b2-40ca-bba5-1753d6d8d543
213	213	0	GBIF France	da44cd31-5901-4687-a106-6d1c7734ee3a	d087d5b8-0d37-4937-afe3-dc44692a09a6
0	8	8	Plazi	ffb07bec-2d10-492d-9c37-361fe0b79427	d6e0819a-dbc2-4e5c-92b2-0827ef2e7cca
843	843	0	Colombian Biodiversity Information System	7e865cba-7c46-417b-ade5-97f2cf5b7be0	d9d550ed-581d-4444-9b1b-2f26c68cecaa
7	7	0	Plazi	ffb07bec-2d10-492d-9c37-361fe0b79427	e0477c9d-3db9-4dc4-ae15-1fe7e02eb35f
23	23	0	Plazi	ffb07bec-2d10-492d-9c37-361fe0b79427	e053f55e-306f-4574-82b1-86dfafb96951
1	1	0	Plazi	ffb07bec-2d10-492d-9c37-361fe0b79427	e10c309a-3306-481c-b2bb-e3c4b5431e4e
10747	10749	2	Biodiversity Information System of Mexico	b324e8e9-9a4c-44fa-8f1a-7f39ea7ab576	e6dc2144-bccb-4ac0-95f8-935d32c6144b
2	2	0	Plazi	ffb07bec-2d10-492d-9c37-361fe0b79427	e7b48288-9df7-4f3c-bfdc-d3d382b034a4
11594	11594	0	Biodiversity Information System of Mexico	b324e8e9-9a4c-44fa-8f1a-7f39ea7ab576	e8bfbb07-a739-49e9-952f-cd4e9a06603c
0	27	27	Plazi	ffb07bec-2d10-492d-9c37-361fe0b79427	e9998851-b415-4197-8022-3239c24cd611
20	20	0	Plazi	ffb07bec-2d10-492d-9c37-361fe0b79427	eb1ba75d-e187-4213-a415-2e4def3001f3
305	305	0	Colombian Biodiversity Information System	7e865cba-7c46-417b-ade5-97f2cf5b7be0	eb9a4bef-227c-4ec3-b0a0-2c1c06e071ed
64	64	0	Participant Node Managers Committee	7f48e0c8-5c96-49ec-b972-30748e339115	ebd9c591-3b08-4ebb-9bdb-b9a6eccc7849
2094	2094	0	GBIF France	da44cd31-5901-4687-a106-6d1c7734ee3a	ebf5c9c8-14fd-4e3f-9e51-38fa280db009
968	968	0	U.S. Geological Survey	8618c64a-93e0-4300-b546-7249e5148ed2	ec4ab3fa-ba4c-4e10-8e13-350c75739f3e
0	33284	33284	GBIF Portugal	673f7038-4262-4149-b753-5658a4e912f6	efd57d4b-2a63-477a-a6ea-7211f37e9d66
140	140	0	Plazi	ffb07bec-2d10-492d-9c37-361fe0b79427	efec1c9a-9bf5-4599-bfd4-b932b9d34026
0	440	440	Ocean Biodiversity Information System	ba0670b9-4186-41e6-8e70-f9cb3065551a	f2276bd7-f791-4d17-ab1f-21a8c400222c
5776	5776	0	GBIF Uganda	71b40829-6a12-4c3d-8fee-5746f5e9cf8c	f53fe209-a37c-409e-858e-e57c3988fe6a
36	36	0	Plazi	ffb07bec-2d10-492d-9c37-361fe0b79427	f764d561-b3a3-4eab-9772-959ebb569310
830	830	0	National Biodiversity Network	d897a5b9-35ee-4232-94bd-b0bcaac003c2	f83a7c5b-1e0b-4216-81b5-e1f19528fa2f
0	1	1	Ocean Biodiversity Information System	ba0670b9-4186-41e6-8e70-f9cb3065551a	f9eb0f2b-4ee2-4221-b438-7341ac24b4c1
0	2	2	Plazi	ffb07bec-2d10-492d-9c37-361fe0b79427	fa7ec5d2-b715-41a4-8989-57bed5db408b
0	1	1	Plazi	ffb07bec-2d10-492d-9c37-361fe0b79427	fb7563ac-459c-4545-b4ae-e513b26d333f
19	19	0	GBIF Japan	db5705aa-6a6e-42f1-8942-d77b9f4896ea	fc33cdf1-dd24-4593-af7d-b9df93268f18
0	10	10	Plazi	ffb07bec-2d10-492d-9c37-361fe0b79427	fd4b2931-7bad-4644-b485-f365040ae01e
63	63	0	U.S. Geological Survey	8618c64a-93e0-4300-b546-7249e5148ed2	fda694ce-fb23-4c47-b765-4cd7d8b4d43d
60	60	0	Plazi	ffb07bec-2d10-492d-9c37-361fe0b79427	ff41552a-7cc5-42ba-9336-7a61f2845b41
2	2	0	Plazi	ffb07bec-2d10-492d-9c37-361fe0b79427	ff46070b-239d-4502-9edc-ce03ad0abcb3
3728	3728	0	GBIF France	da44cd31-5901-4687-a106-6d1c7734ee3a	ffd94f81-36e4-408c-868a-16f38d899b54
0	7	7	Plazi	ffb07bec-2d10-492d-9c37-361fe0b79427	05375634-2bf8-4058-b1c1-8c54f2dbb3c5
0	5	5	Plazi	ffb07bec-2d10-492d-9c37-361fe0b79427	05fe11ff-f01b-45eb-9eed-b80d7b5cb965
191	191	0	Colombian Biodiversity Information System	7e865cba-7c46-417b-ade5-97f2cf5b7be0	085a42b1-cc01-45c4-b21f-0a45833a8008
0	177	177	Ocean Biodiversity Information System	ba0670b9-4186-41e6-8e70-f9cb3065551a	09a5e148-e146-4536-86ab-541bf26f6928
80	80	0	Plazi	ffb07bec-2d10-492d-9c37-361fe0b79427	0d2221a5-44fe-443e-85b5-85231989373b
131	131	0	Plazi	ffb07bec-2d10-492d-9c37-361fe0b79427	11a122a9-8f3e-4a1c-a8d3-5ef3bea09b59
6	6	0	Plazi	ffb07bec-2d10-492d-9c37-361fe0b79427	13c50c08-32cd-415a-818f-632ef4736aa6
3188	3188	0	GBIF France	da44cd31-5901-4687-a106-6d1c7734ee3a	13d53708-111d-40b3-ac66-b582f099685b
4906	4906	0	GBIF France	da44cd31-5901-4687-a106-6d1c7734ee3a	165289f9-f323-47aa-ac69-f50a27c51406
1	1	0	Plazi	ffb07bec-2d10-492d-9c37-361fe0b79427	170f489e-4f44-4283-8c5a-6a7426f72eeb
1910	1910	0	Biodiversity Information System of Mexico	b324e8e9-9a4c-44fa-8f1a-7f39ea7ab576	19dab322-882a-4d7e-80a5-28644b750634
0	9	9	Plazi	ffb07bec-2d10-492d-9c37-361fe0b79427	1a631353-be5d-4bc4-b2f0-5b142c57aeb0
415	415	0	GBIF France	da44cd31-5901-4687-a106-6d1c7734ee3a	1a773212-92f8-4a60-b8f6-6b47e3c73245
3	3	0	Plazi	ffb07bec-2d10-492d-9c37-361fe0b79427	1d21c891-0967-49fe-af90-ab8617c34917
153	153	0	Plazi	ffb07bec-2d10-492d-9c37-361fe0b79427	1d5fdead-d612-4c66-b482-4f051f990351
12808	12808	0	Netherlands Biodiversity Information Facility	0909d601-bda2-42df-9e63-a6d51847ebce	1dcc7df9-e92d-4c6a-a4d8-547138ba6f5d
8	8	0	Plazi	ffb07bec-2d10-492d-9c37-361fe0b79427	1e89d723-7f54-4d6b-85dd-6bcd573eca32
4	4	0	Plazi	ffb07bec-2d10-492d-9c37-361fe0b79427	216da6d6-e86c-465f-901b-e47d2c7107fe
661	661	0	GBIF France	da44cd31-5901-4687-a106-6d1c7734ee3a	21bf0727-d25f-4bf0-bcd7-2e103527cf1f
545	545	0	Plazi	ffb07bec-2d10-492d-9c37-361fe0b79427	248cfde9-84c8-4101-887c-08f27ad5afac
0	4	4	Plazi	ffb07bec-2d10-492d-9c37-361fe0b79427	25230e38-2e74-4a14-8391-a993eefb731b
1715	1715	0	GBIF Finland	dd514216-5c7c-45f3-910d-797424cb5be6	25a7f866-6262-41f9-a5e5-c44829ea7c3e
0	9	9	Participant Node Managers Committee	7f48e0c8-5c96-49ec-b972-30748e339115	271bc68a-d144-4b06-a0ca-82677489dd7d
11	11	0	Plazi	ffb07bec-2d10-492d-9c37-361fe0b79427	272b87dd-9d98-4ddd-94ee-f986d13e5515
94	94	0	Plazi	ffb07bec-2d10-492d-9c37-361fe0b79427	28ac3eca-421e-4f15-a17e-c7b0fcda3304
0	1	1	Plazi	ffb07bec-2d10-492d-9c37-361fe0b79427	291d2d29-0d6b-44f9-816a-7f7aa2330ec2
0	629	629	Tanzania Biodiversity Information Facility	abd95ca6-3959-4db9-aaa6-2de1aeecf514	2ab1e331-b308-4755-ac97-44b6d5b6ee30
0	254	254	Ocean Biodiversity Information System	ba0670b9-4186-41e6-8e70-f9cb3065551a	2eaa899d-9700-4544-ad18-8ce6d023f56d
391	391	0	GBIF Norway	4f829580-180d-46a9-9c87-ed8ec959b545	2f7d526c-750a-41ae-a98e-ddcfb6550d79
0	6	6	Plazi	ffb07bec-2d10-492d-9c37-361fe0b79427	2f825f49-8c4a-4749-a3d9-19010e66aaf3
490571	507668	17097	U.S. Geological Survey	8618c64a-93e0-4300-b546-7249e5148ed2	2fba9985-ac30-46cb-99bf-91ccde0d8d2f
328	328	0	National Biodiversity Network	d897a5b9-35ee-4232-94bd-b0bcaac003c2	3024598d-3f18-4305-9adc-009a5381a556
51	51	0	Plazi	ffb07bec-2d10-492d-9c37-361fe0b79427	30f61169-25e7-49b9-bd53-560062736a31
536	536	0	Plazi	ffb07bec-2d10-492d-9c37-361fe0b79427	31d6e081-95c3-4086-a45a-c11555dda3aa
122	122	0	Plazi	ffb07bec-2d10-492d-9c37-361fe0b79427	3338cfec-542f-4836-9a6f-78771e3a750c
329	202	-127	GBIF Germany	4f6826f2-4ff6-443d-b966-e6913bd24013	339292ce-c32c-4f27-8551-09f20fffe165
333	333	0	GBIF France	da44cd31-5901-4687-a106-6d1c7734ee3a	36714b50-dc56-455a-9ba7-9560e082d653
6905468	8285400	1379932	Atlas of Living Australia	4a6f1b71-969e-4fc5-a693-282b05e1220c	37beb6ea-e591-41e3-b781-e384250dc42c
0	4	4	Plazi	ffb07bec-2d10-492d-9c37-361fe0b79427	383bee79-0964-4aa3-9916-6811814a3895
2	2	0	Plazi	ffb07bec-2d10-492d-9c37-361fe0b79427	3a031c64-52bb-4194-a4c5-e24f7ae524e2
91	91	0	National Biodiversity Network	d897a5b9-35ee-4232-94bd-b0bcaac003c2	3b0df8d3-59c5-484d-862f-a46680a5f505
0	3	3	Plazi	ffb07bec-2d10-492d-9c37-361fe0b79427	3c18edd0-e558-41f9-bb3d-d9c211baeb23
172	172	0	South African Biodiversity Information Facility	7190b835-4e86-4b6e-85c1-19cc6677c250	3c7c79f0-4ee6-4ea0-bc96-1c347d63cb67
14	14	0	Plazi	ffb07bec-2d10-492d-9c37-361fe0b79427	3ca74e64-321c-47ab-9fc5-d1bc97c954f5
41155	41155	0	U.S. Geological Survey	8618c64a-93e0-4300-b546-7249e5148ed2	3cc72eb1-0f9e-496d-96e9-3cf6f7d94b0a
3	3	0	Plazi	ffb07bec-2d10-492d-9c37-361fe0b79427	3deb99d5-9899-4be3-b719-52c06f7c8d54
30	30	0	Plazi	ffb07bec-2d10-492d-9c37-361fe0b79427	401838f5-42ff-44dd-95c0-5992c74b9ecc
219	219	0	Plazi	ffb07bec-2d10-492d-9c37-361fe0b79427	4210c98c-65e5-4557-a166-49fd6f9ead0a
12	12	0	Plazi	ffb07bec-2d10-492d-9c37-361fe0b79427	4379d666-80f8-4dab-b420-f7e93cc0cffd
1	1	0	Plazi	ffb07bec-2d10-492d-9c37-361fe0b79427	43e88407-6a19-4776-9093-6fc9a15f78b3
42	42	0	GBIF Finland	dd514216-5c7c-45f3-910d-797424cb5be6	4436b62c-8d2e-4ad6-826e-06672897b89e
1	1	0	Plazi	ffb07bec-2d10-492d-9c37-361fe0b79427	44b05120-f8d3-49b1-b077-979cbbadc6fa
492	492	0	GBIF France	da44cd31-5901-4687-a106-6d1c7734ee3a	472f3b04-27a1-4e9c-ad40-b069f1299d30
145	145	0	GBIF France	da44cd31-5901-4687-a106-6d1c7734ee3a	475e54bc-0168-4309-890a-1330f9ca1fc5
20	20	0	Plazi	ffb07bec-2d10-492d-9c37-361fe0b79427	49c8edca-97c9-4a2e-8079-15e670f8188c
94	94	0	Plazi	ffb07bec-2d10-492d-9c37-361fe0b79427	4b21dc8e-e2dc-448f-8605-5b21f9f727a2
5	5	0	Plazi	ffb07bec-2d10-492d-9c37-361fe0b79427	4f3dbbef-f8dc-46bb-8bb0-fa8025b4741a
2	2	0	Plazi	ffb07bec-2d10-492d-9c37-361fe0b79427	5055cc26-7c64-478c-bcaf-72784931d7e4
29	29	0	Plazi	ffb07bec-2d10-492d-9c37-361fe0b79427	51adf720-0d97-45dd-ac98-c3c79ba4d3ce
81	81	0	GBIF Spain	1f94b3ca-9345-4d65-afe2-4bace93aa0fe	558b89af-0cf0-4f53-b8e0-dbaccc9d6925
2375	2375	0	GBIF Germany	4f6826f2-4ff6-443d-b966-e6913bd24013	561b9139-b5e0-4b34-b926-5a844f284da7
7	7	0	Plazi	ffb07bec-2d10-492d-9c37-361fe0b79427	57cfb289-89a3-48b0-901c-c76fb029d2c7
0	28	28	Plazi	ffb07bec-2d10-492d-9c37-361fe0b79427	59e873ae-93fe-4127-b0ec-38e882d791b3
1	1	0	Plazi	ffb07bec-2d10-492d-9c37-361fe0b79427	5b0d19ac-86a1-4e0f-adb3-b7c6230947b8
0	3	3	Ocean Biodiversity Information System	ba0670b9-4186-41e6-8e70-f9cb3065551a	5c13e5a0-6ed1-412b-90c9-6e24e27feaea
0	434	434	Ocean Biodiversity Information System	ba0670b9-4186-41e6-8e70-f9cb3065551a	5c488b46-101b-470d-8b2b-ccf279488c04
62	62	0	Plazi	ffb07bec-2d10-492d-9c37-361fe0b79427	5e65e38c-fb0f-4bc3-81ec-aa827b75314d
523	523	0	GBIF Argentina	2426a871-9feb-40a1-96c6-0c593a76b835	607e6375-e753-49d2-96b8-b52c2b68c8bc
194	194	0	GBIF Germany	4f6826f2-4ff6-443d-b966-e6913bd24013	620122c4-f762-11e1-a439-00145eb45e9a
82	82	0	GBIF Germany	4f6826f2-4ff6-443d-b966-e6913bd24013	6219dd46-f762-11e1-a439-00145eb45e9a
43	43	0	GBIF Germany	4f6826f2-4ff6-443d-b966-e6913bd24013	621b00c2-f762-11e1-a439-00145eb45e9a
32	32	0	Plazi	ffb07bec-2d10-492d-9c37-361fe0b79427	628844a2-73ea-4aed-b578-5d228dc8e736
16006	16006	0	GBIF Spain	1f94b3ca-9345-4d65-afe2-4bace93aa0fe	6364371e-f762-11e1-a439-00145eb45e9a
84	84	0	GBIF Germany	4f6826f2-4ff6-443d-b966-e6913bd24013	644587be-f762-11e1-a439-00145eb45e9a
303	296	-7	GBIF Germany	4f6826f2-4ff6-443d-b966-e6913bd24013	656ac4f6-f762-11e1-a439-00145eb45e9a
192	192	0	GBIF Germany	4f6826f2-4ff6-443d-b966-e6913bd24013	6719c8ce-f762-11e1-a439-00145eb45e9a
944	944	0	National Biodiversity Network	d897a5b9-35ee-4232-94bd-b0bcaac003c2	6784f3fb-7d74-450f-8c1a-64d8a71637fb
62	62	0	GBIF Germany	4f6826f2-4ff6-443d-b966-e6913bd24013	67c375fe-f762-11e1-a439-00145eb45e9a
138	138	0	GBIF Germany	4f6826f2-4ff6-443d-b966-e6913bd24013	6869a1ae-f762-11e1-a439-00145eb45e9a
0	20	20	Colombian Biodiversity Information System	7e865cba-7c46-417b-ade5-97f2cf5b7be0	68a21873-67f5-4d37-afcb-2a9a4308cecf
51	51	0	Colombian Biodiversity Information System	7e865cba-7c46-417b-ade5-97f2cf5b7be0	6a0690bc-95c2-45c0-8a8a-a4c0d58dbc0e
0	11	11	Plazi	ffb07bec-2d10-492d-9c37-361fe0b79427	6abc40cc-8530-4b07-8951-ed99438d3d1a
18	18	0	GBIF Germany	4f6826f2-4ff6-443d-b966-e6913bd24013	6b2eed54-f762-11e1-a439-00145eb45e9a
1138	1138	0	Colombian Biodiversity Information System	7e865cba-7c46-417b-ade5-97f2cf5b7be0	6e2745d1-ebfe-400a-ae9f-81b405ae09bb
0	3323	3323	Participant Node Managers Committee	7f48e0c8-5c96-49ec-b972-30748e339115	6f0d0430-b719-4a2e-9bb0-20b35ba4bc6c
29	29	0	Plazi	ffb07bec-2d10-492d-9c37-361fe0b79427	6f2bd978-b3da-4c20-8211-a020355831e5
100	100	0	GBIF Japan	db5705aa-6a6e-42f1-8942-d77b9f4896ea	6fa4f45d-c4e6-48d4-847b-afe42817bd84
118	118	0	Colombian Biodiversity Information System	7e865cba-7c46-417b-ade5-97f2cf5b7be0	707ae06a-750f-4322-b2d4-cdc64342d8eb
9	9	0	Plazi	ffb07bec-2d10-492d-9c37-361fe0b79427	71f9552c-d7e7-4005-81b5-7e3f99ef447a
91	91	0	Plazi	ffb07bec-2d10-492d-9c37-361fe0b79427	72e5bd66-b8bf-4267-b245-a766bcfbfcd0
60	60	0	GBIF Germany	4f6826f2-4ff6-443d-b966-e6913bd24013	73213134-f762-11e1-a439-00145eb45e9a
0	568	568	U.S. Geological Survey	8618c64a-93e0-4300-b546-7249e5148ed2	7369663d-76ae-4f0a-a1d5-b362f0b33276
95	95	0	GBIF Germany	4f6826f2-4ff6-443d-b966-e6913bd24013	7445c2c8-f762-11e1-a439-00145eb45e9a
8900	8900	0	GBIF France	da44cd31-5901-4687-a106-6d1c7734ee3a	752a8459-f10a-4133-aa21-4f55f8a27b73
2	2	0	Plazi	ffb07bec-2d10-492d-9c37-361fe0b79427	762304f7-def1-4031-af54-547862e1e43d
154	154	0	GBIF France	da44cd31-5901-4687-a106-6d1c7734ee3a	77bdb599-a49c-43b9-b97b-9032e296c486
1	1	0	Plazi	ffb07bec-2d10-492d-9c37-361fe0b79427	781c9b33-535d-4f9b-83fc-0db0e256502b
229051	229051	0	Atlas of Living Australia	4a6f1b71-969e-4fc5-a693-282b05e1220c	793c3890-6c8a-11de-8226-b8a03c50a862
0	1	1	Plazi	ffb07bec-2d10-492d-9c37-361fe0b79427	7a60e99a-a06c-43f3-a259-0f98bd28ec0f
3	3	0	Plazi	ffb07bec-2d10-492d-9c37-361fe0b79427	7b59820e-be57-4450-a0bd-dd11d5f81993
1020	120	-900	GBIF Germany	4f6826f2-4ff6-443d-b966-e6913bd24013	7bfd4b08-f762-11e1-a439-00145eb45e9a
470	470	0	GBIF Germany	4f6826f2-4ff6-443d-b966-e6913bd24013	7c536ee8-f762-11e1-a439-00145eb45e9a
1025	1025	0	GBIF France	da44cd31-5901-4687-a106-6d1c7734ee3a	7e84425e-bc3f-408b-b16e-5bf1e28ea8ef
133	133	0	GBIF Germany	4f6826f2-4ff6-443d-b966-e6913bd24013	7e8ec432-f762-11e1-a439-00145eb45e9a
27409	27409	0	GBIF France	da44cd31-5901-4687-a106-6d1c7734ee3a	7ebc64d0-7f25-4e68-a449-b1bb45aeb1ea
1660	1593	-67	Biodiversity Information System of Mexico	b324e8e9-9a4c-44fa-8f1a-7f39ea7ab576	80178f32-f762-11e1-a439-00145eb45e9a
12	12	0	GBIF Germany	4f6826f2-4ff6-443d-b966-e6913bd24013	80fc3950-6036-47a6-bad5-ff032c97a94d
26143	26143	0	GBIF Switzerland	169eb292-376b-4cc6-8e31-9c2c432de0ad	82a65706-f762-11e1-a439-00145eb45e9a
5922	5922	0	GBIF Switzerland	169eb292-376b-4cc6-8e31-9c2c432de0ad	82a7898c-f762-11e1-a439-00145eb45e9a
183585	183585	0	U.S. Geological Survey	8618c64a-93e0-4300-b546-7249e5148ed2	8310f570-f762-11e1-a439-00145eb45e9a
135	135	0	GBIF France	da44cd31-5901-4687-a106-6d1c7734ee3a	83b1214c-30c7-4967-8d47-353385b26d7c
41	41	0	GBIF France	da44cd31-5901-4687-a106-6d1c7734ee3a	83fc37a6-7d01-4163-a5e8-a0473669c6e1
3632	3632	0	Canada Biodiversity Information Facility	8f83fc96-c966-4126-83f7-bf044dc49efa	840c0c39-ebdf-4679-9730-aec440b5cb8e
5514	5514	0	GBIF Brazil	cdc9736d-5ff7-4ece-9959-3c744360cdb3	869d4bcc-f8a8-475c-9635-973e1456984d
33	33	0	GBIF Germany	4f6826f2-4ff6-443d-b966-e6913bd24013	87334464-f762-11e1-a439-00145eb45e9a
19	11	-8	GBIF Germany	4f6826f2-4ff6-443d-b966-e6913bd24013	877b694c-f762-11e1-a439-00145eb45e9a
465	465	0	GBIF Germany	4f6826f2-4ff6-443d-b966-e6913bd24013	89cbad42-f762-11e1-a439-00145eb45e9a
1	1	0	Plazi	ffb07bec-2d10-492d-9c37-361fe0b79427	8a8a66c3-84a0-4115-b3bf-cae2a00bfe24
460	460	0	GBIF Germany	4f6826f2-4ff6-443d-b966-e6913bd24013	8abe750e-f762-11e1-a439-00145eb45e9a
0	14181	14181	Canada Biodiversity Information Facility	8f83fc96-c966-4126-83f7-bf044dc49efa	8c3fa5c6-8fb2-4080-8124-e402a253fa8b
105	72	-33	GBIF Germany	4f6826f2-4ff6-443d-b966-e6913bd24013	8cb66e16-f762-11e1-a439-00145eb45e9a
16	10	-6	GBIF Germany	4f6826f2-4ff6-443d-b966-e6913bd24013	8ce5dd2c-f762-11e1-a439-00145eb45e9a
118	118	0	Plazi	ffb07bec-2d10-492d-9c37-361fe0b79427	8d7e0967-6f93-42bd-911b-0314d5ccfb6e
1	1	0	GBIF Germany	4f6826f2-4ff6-443d-b966-e6913bd24013	8daeff2c-f762-11e1-a439-00145eb45e9a
602	488	-114	GBIF Germany	4f6826f2-4ff6-443d-b966-e6913bd24013	8e5d2976-f762-11e1-a439-00145eb45e9a
7266	7266	0	GBIF France	da44cd31-5901-4687-a106-6d1c7734ee3a	8ed7b879-e2fb-4896-9acc-1c911bcdaf6b
222	222	0	Plazi	ffb07bec-2d10-492d-9c37-361fe0b79427	8f741800-9424-4a6c-b527-2a9862135b1d
134	110	-24	GBIF Germany	4f6826f2-4ff6-443d-b966-e6913bd24013	912b2978-f762-11e1-a439-00145eb45e9a
317	317	0	GBIF Germany	4f6826f2-4ff6-443d-b966-e6913bd24013	929e80b6-f762-11e1-a439-00145eb45e9a
7	7	0	Plazi	ffb07bec-2d10-492d-9c37-361fe0b79427	92b65e86-0bc4-41ae-adfc-3833a409115b
50	20	-30	GBIF Germany	4f6826f2-4ff6-443d-b966-e6913bd24013	9318e0a4-f762-11e1-a439-00145eb45e9a
235	235	0	GBIF Germany	4f6826f2-4ff6-443d-b966-e6913bd24013	93e440dc-f762-11e1-a439-00145eb45e9a
0	4	4	Plazi	ffb07bec-2d10-492d-9c37-361fe0b79427	9424b9ff-5c3e-4c56-8f8e-bbe4e8622fa3
937	959	22	GBIF Germany	4f6826f2-4ff6-443d-b966-e6913bd24013	952eaec8-f762-11e1-a439-00145eb45e9a
433	417	-16	GBIF Germany	4f6826f2-4ff6-443d-b966-e6913bd24013	953eac60-f762-11e1-a439-00145eb45e9a
51	51	0	GBIF Germany	4f6826f2-4ff6-443d-b966-e6913bd24013	976fdd74-f762-11e1-a439-00145eb45e9a
7	7	0	Plazi	ffb07bec-2d10-492d-9c37-361fe0b79427	9a3090a2-f226-4d11-9514-a30ca1783fcb
19085	19085	0	GBIF Ecuador	2dc472f1-c3d9-486d-b3c1-12ca7ba1ed22	9bbdb0ea-b792-4047-be06-c4285ad47f3f
18	18	0	GBIF Argentina	2426a871-9feb-40a1-96c6-0c593a76b835	9c1776e9-9abf-432b-9736-98d1be3de3cb
4	4	0	Plazi	ffb07bec-2d10-492d-9c37-361fe0b79427	a1407eed-b24d-4132-b411-ee8da970d2d4
2	2	0	Plazi	ffb07bec-2d10-492d-9c37-361fe0b79427	a343443c-2024-44c3-99a8-0a1fe6e7ae14
5	5	0	Plazi	ffb07bec-2d10-492d-9c37-361fe0b79427	a3554ea1-61da-4082-97c6-b590ea38dee8
6	6	0	Plazi	ffb07bec-2d10-492d-9c37-361fe0b79427	a62afda5-4a8d-4fa5-bbae-c2f02d874b27
86676	86676	0	National Biodiversity Network	d897a5b9-35ee-4232-94bd-b0bcaac003c2	a71b06c8-c62d-46ed-8daa-f10b0aeca0da
19	19	0	Plazi	ffb07bec-2d10-492d-9c37-361fe0b79427	a73fe572-f4e3-4f6c-954d-a034f4b337c2
0	11	11	Plazi	ffb07bec-2d10-492d-9c37-361fe0b79427	a7a14919-538e-47c6-af07-0e81457a5583
0	3	3	Plazi	ffb07bec-2d10-492d-9c37-361fe0b79427	aa24cf9f-7f0b-4154-99ec-7c0ab993a026
2	2	0	Plazi	ffb07bec-2d10-492d-9c37-361fe0b79427	aa3e7560-6071-4268-a1b3-5f1be5854c57
0	13	13	Plazi	ffb07bec-2d10-492d-9c37-361fe0b79427	ac32974b-57b6-4da1-9955-c6b49f9496fc
8	8	0	Plazi	ffb07bec-2d10-492d-9c37-361fe0b79427	ac6c9e7c-6e97-47f5-a163-e21ab8c840b8
0	10	10	Plazi	ffb07bec-2d10-492d-9c37-361fe0b79427	af069679-c2ad-4ce4-bf40-3bdd47294599
0	1	1	Plazi	ffb07bec-2d10-492d-9c37-361fe0b79427	b0ebf52b-7ed4-412e-808d-f80571ee637d
1	1	0	Plazi	ffb07bec-2d10-492d-9c37-361fe0b79427	b3cbf37c-f0c9-4400-bc97-a265a91cbaf7
0	3	3	Ocean Biodiversity Information System	ba0670b9-4186-41e6-8e70-f9cb3065551a	b5c5f4b1-1b74-4ece-9483-6e4808999cb7
5415	5415	0	GBIF Israel	8cb55387-7802-40e8-86d6-d357a583c596	b6834d2b-77de-49ac-9b23-c93ebf54e245
0	33528	33528	Ocean Biodiversity Information System	ba0670b9-4186-41e6-8e70-f9cb3065551a	b8bb529b-4e90-4a8b-be14-d4383f06bf0f
106	106	0	Scientific Committee on Antarctic Research	51e4e8ff-bff0-4996-8b27-9107d61b3478	bbb3b3a9-5596-41b2-acc9-dac239abe164
65326	65326	0	U.S. Geological Survey	8618c64a-93e0-4300-b546-7249e5148ed2	c01696db-a5fe-4d3a-8b26-90760604774b
0	1	1	Plazi	ffb07bec-2d10-492d-9c37-361fe0b79427	c05dbc91-b9a4-496f-b862-83f326b8002f
7270	7270	0	Ocean Biodiversity Information System	ba0670b9-4186-41e6-8e70-f9cb3065551a	c063bd29-d63b-4ff5-bb79-adb1a4533b1a
60074	60074	0	GBIF Brazil	cdc9736d-5ff7-4ece-9959-3c744360cdb3	c0a459c6-2ae7-4890-a1e4-38e24e671269
169	169	0	Plazi	ffb07bec-2d10-492d-9c37-361fe0b79427	c2e17975-440e-40f9-8b37-f078f9aadf1b
4	4	0	Plazi	ffb07bec-2d10-492d-9c37-361fe0b79427	c447a6b6-36b5-40de-ab76-80a9c7d96d3a
1428	1428	0	GBIF Germany	4f6826f2-4ff6-443d-b966-e6913bd24013	cb0bdd91-6af6-4872-b583-6bb0df33ae1e
21	21	0	Plazi	ffb07bec-2d10-492d-9c37-361fe0b79427	d0475a35-fe3a-487c-8158-6ae2347fd460
82	82	0	Plazi	ffb07bec-2d10-492d-9c37-361fe0b79427	d1294a80-1739-4e2d-a26b-e27a2f150d16
852	852	0	GBIF France	da44cd31-5901-4687-a106-6d1c7734ee3a	d1896b53-ecd5-47cc-9e59-0dde2d9e76da
0	3793	3793	Colombian Biodiversity Information System	7e865cba-7c46-417b-ade5-97f2cf5b7be0	d27e3988-f380-43dc-927a-0897726a0d44
9587	2361	-7226	GBIF Germany	4f6826f2-4ff6-443d-b966-e6913bd24013	d589e21b-4724-4069-a9f4-89debcc3a196
157978	157978	0	Netherlands Biodiversity Information Facility	0909d601-bda2-42df-9e63-a6d51847ebce	dad6253c-be06-4626-9b95-d48823137ced
2709	2709	0	GBIF France	da44cd31-5901-4687-a106-6d1c7734ee3a	e01e2f95-7c4c-4310-8bc9-90f1997042b0
0	556	556	Colombian Biodiversity Information System	7e865cba-7c46-417b-ade5-97f2cf5b7be0	e19d9005-0f3c-4c21-8cfe-f5544398fc66
721	721	0	GBIF France	da44cd31-5901-4687-a106-6d1c7734ee3a	e48115ce-e4db-4d84-800c-327503c77028
6830	6830	0	Ocean Biodiversity Information System	ba0670b9-4186-41e6-8e70-f9cb3065551a	e5306688-5202-45b9-b858-e4683f3ccfab
343	343	0	GBIF France	da44cd31-5901-4687-a106-6d1c7734ee3a	e5687c66-55a2-4f5f-82aa-1838d9e67470
72	72	0	GBIF France	da44cd31-5901-4687-a106-6d1c7734ee3a	e5b03966-f0fe-4fd4-b8c4-f07dbd07aae2
0	1	1	Plazi	ffb07bec-2d10-492d-9c37-361fe0b79427	e6da253b-3709-43cb-8ba9-12b1dd02727a
363560	363560	0	National Biodiversity Network	d897a5b9-35ee-4232-94bd-b0bcaac003c2	e6f2325a-af8d-4935-9f10-163e87f472bf
0	16	16	Plazi	ffb07bec-2d10-492d-9c37-361fe0b79427	e764fd2c-8149-4cfd-87a3-6d29f159116f
0	12	12	Plazi	ffb07bec-2d10-492d-9c37-361fe0b79427	eb517ca7-0640-4667-840f-30e4fcf67a61
128	128	0	GBIF France	da44cd31-5901-4687-a106-6d1c7734ee3a	ebaf63b5-ad8e-438a-aa5f-cf7e3422edf4
0	1	1	Plazi	ffb07bec-2d10-492d-9c37-361fe0b79427	f1ba8e62-9647-43d5-9ca3-4f0a054a8b1d
0	7	7	Plazi	ffb07bec-2d10-492d-9c37-361fe0b79427	f3c23bc0-76d4-45eb-b6a0-ac90b31d2453
59	464	405	Colombian Biodiversity Information System	7e865cba-7c46-417b-ade5-97f2cf5b7be0	f7661570-46ff-4359-8a5e-eab9d03cba9d
120	119	-1	Plazi	ffb07bec-2d10-492d-9c37-361fe0b79427	f7974bcf-11e7-4d1b-b09d-530dc2dbd54f
433	433	0	GBIF France	da44cd31-5901-4687-a106-6d1c7734ee3a	f889f885-323c-4a62-a94f-bb26c320badb
1289	1289	0	National Biodiversity Network	d897a5b9-35ee-4232-94bd-b0bcaac003c2	f8caee29-6357-4b44-8c2f-d0262ee532eb
3	3	0	Plazi	ffb07bec-2d10-492d-9c37-361fe0b79427	facfc140-79a2-4608-acf2-a2a3369c0224
0	2	2	Ocean Biodiversity Information System	ba0670b9-4186-41e6-8e70-f9cb3065551a	018f8afc-5ab4-44af-9fc3-fac24d2750d5
148529	148529	0	National Biodiversity Network	d897a5b9-35ee-4232-94bd-b0bcaac003c2	0284b82d-cdd1-4d67-83bd-c8e42e988adb
10229	10229	0	GBIF France	da44cd31-5901-4687-a106-6d1c7734ee3a	035941f6-46af-457b-9c23-bfb21ffd0904
10072	10072	0	GBIF France	da44cd31-5901-4687-a106-6d1c7734ee3a	03f255d0-9870-4357-be22-09613bc36dbf
440	440	0	U.S. Geological Survey	8618c64a-93e0-4300-b546-7249e5148ed2	06448b27-4c5c-4296-8ece-a87e124c4f4e
40	40	0	National Biodiversity Network	d897a5b9-35ee-4232-94bd-b0bcaac003c2	09a93352-c65c-46be-9e24-61629f55fda5
10	10	0	Plazi	ffb07bec-2d10-492d-9c37-361fe0b79427	0b058e80-e7f8-4422-aaa6-caa1118209a1
7	7	0	Plazi	ffb07bec-2d10-492d-9c37-361fe0b79427	0c64669d-6317-4425-9029-e8a312dc0dfb
0	3	3	Plazi	ffb07bec-2d10-492d-9c37-361fe0b79427	0eb71e26-0772-482b-9a11-158668fe7737
23	23	0	Colombian Biodiversity Information System	7e865cba-7c46-417b-ade5-97f2cf5b7be0	0ee83c9d-e34d-42f1-b65d-0263b5eeb497
0	20	20	Participant Node Managers Committee	7f48e0c8-5c96-49ec-b972-30748e339115	12cfda6e-7b9a-4ad3-8e03-a505e4a9fff2
345587	370896	25309	U.S. Geological Survey	8618c64a-93e0-4300-b546-7249e5148ed2	13e7869e-0c76-473a-a227-53d6e3d6fbf2
1345	1345	0	Biodiversity Information System of Mexico	b324e8e9-9a4c-44fa-8f1a-7f39ea7ab576	143bc778-c784-45ea-a6fe-d6bbf499a08e
0	15	15	Plazi	ffb07bec-2d10-492d-9c37-361fe0b79427	16913b12-3124-4ea1-b47d-857a23eb5aba
0	120	120	Ocean Biodiversity Information System	ba0670b9-4186-41e6-8e70-f9cb3065551a	1836758a-2cc3-447f-ba55-7eb07d284ff3
322193	322193	0	U.S. Geological Survey	8618c64a-93e0-4300-b546-7249e5148ed2	1840aafc-6446-450e-9d7d-483790b20f6a
342350	342350	0	Colombian Biodiversity Information System	7e865cba-7c46-417b-ade5-97f2cf5b7be0	18da9e5d-8966-4893-bf70-b3911152d991
31324	31361	37	National Biodiversity Data Centre	422b00b2-6c94-4bb6-976b-c359916efdb8	1a6d5bcd-cb62-468f-967f-fd25e18c3b8c
82	82	0	GBIF France	da44cd31-5901-4687-a106-6d1c7734ee3a	1bc5fc33-0dae-46f3-ab35-373b3ba2d30a
495	495	0	Participant Node Managers Committee	7f48e0c8-5c96-49ec-b972-30748e339115	1d5da860-7160-4a15-b6d3-44fec0bab183
6	6	0	GBIF Finland	dd514216-5c7c-45f3-910d-797424cb5be6	20d66963-96bf-4cfe-99d4-67c00500b891
0	836	836	Ocean Biodiversity Information System	ba0670b9-4186-41e6-8e70-f9cb3065551a	21ad676e-2b33-4134-83c5-c79d7a80ff69
0	2	2	Plazi	ffb07bec-2d10-492d-9c37-361fe0b79427	22339a0f-face-4296-a851-b006076e350a
25	25	0	Plazi	ffb07bec-2d10-492d-9c37-361fe0b79427	23ae4ed9-fc50-4de2-9291-683bf4d7b93b
4	4	0	Plazi	ffb07bec-2d10-492d-9c37-361fe0b79427	25b68124-2101-4477-ad5f-5d08988f5dbb
134	134	0	Plazi	ffb07bec-2d10-492d-9c37-361fe0b79427	269e39e4-19ff-4a70-9376-8b7eaf09f663
25498	27509	2011	Participant Node Managers Committee	7f48e0c8-5c96-49ec-b972-30748e339115	281d50e6-3990-4a02-83b1-a6ca3330ee97
122	122	0	National Biodiversity Network	d897a5b9-35ee-4232-94bd-b0bcaac003c2	28efdec7-f62e-4b41-8dc7-cf39ff1d1de9
0	30	30	Ocean Biodiversity Information System	ba0670b9-4186-41e6-8e70-f9cb3065551a	29c5c372-750f-49c1-a752-12b6b2b277ad
41553	41552	-1	National Biodiversity Network	d897a5b9-35ee-4232-94bd-b0bcaac003c2	2a101f26-35e1-4197-94ec-bd25033292a7
26	26	0	Participant Node Managers Committee	7f48e0c8-5c96-49ec-b972-30748e339115	2b2b6f5a-0656-4ad3-bfd1-33bea7c6c44b
0	5	5	Plazi	ffb07bec-2d10-492d-9c37-361fe0b79427	2f120013-a253-42a6-922b-dc960840b7a2
3	3	0	Plazi	ffb07bec-2d10-492d-9c37-361fe0b79427	2ffd1299-7a53-4ce9-868c-64e82f6fc053
230880	231786	906	National Biodiversity Network	d897a5b9-35ee-4232-94bd-b0bcaac003c2	307bce9d-3963-418f-a8ad-cf5fe503dec1
964	964	0	Ocean Biodiversity Information System	ba0670b9-4186-41e6-8e70-f9cb3065551a	3096645c-ac8c-4ef0-b7de-028f22511060
514	514	0	National Biodiversity Network	d897a5b9-35ee-4232-94bd-b0bcaac003c2	30efc75e-6513-4530-be56-4634fba875df
121	121	0	Biodiversity Information System of Mexico	b324e8e9-9a4c-44fa-8f1a-7f39ea7ab576	33dacd55-1c8e-4c95-9a15-b882b4d40eab
0	3	3	Plazi	ffb07bec-2d10-492d-9c37-361fe0b79427	346d020b-2759-4951-8f67-a4eb3d9e8889
132	132	0	Plazi	ffb07bec-2d10-492d-9c37-361fe0b79427	36ddfb02-3eb7-42af-89ca-0f4e77bd6aa3
0	5	5	Plazi	ffb07bec-2d10-492d-9c37-361fe0b79427	3d8f8320-c725-4157-a450-5c94f03a1b65
86	86	0	National Biodiversity Network	d897a5b9-35ee-4232-94bd-b0bcaac003c2	3df9766b-ba53-4355-a801-930d89df841a
10	10	0	Plazi	ffb07bec-2d10-492d-9c37-361fe0b79427	3f253e3e-777e-465d-841d-a67e3b645d1a
0	3	3	Plazi	ffb07bec-2d10-492d-9c37-361fe0b79427	40c23e3e-d4b8-4217-9841-cb41d4464aa3
190997	190997	0	GBIF France	da44cd31-5901-4687-a106-6d1c7734ee3a	40e69efe-e113-4eea-9363-0a8eec54cf38
20212	20212	0	GBIF France	da44cd31-5901-4687-a106-6d1c7734ee3a	42696cfe-b0fb-459b-9f69-bda6746910e1
355	355	0	GBIF Germany	4f6826f2-4ff6-443d-b966-e6913bd24013	4390de75-3572-4af2-aab8-df92298debe6
748	748	0	Participant Node Managers Committee	7f48e0c8-5c96-49ec-b972-30748e339115	474eb947-606d-4e86-99df-800af617e6e4
56942	78991	22049	GBIF Japan	db5705aa-6a6e-42f1-8942-d77b9f4896ea	4965c6a0-338c-4b27-8cf0-523abe237fac
14	14	0	GBIF Germany	4f6826f2-4ff6-443d-b966-e6913bd24013	4b33fea4-dd4d-4bb3-99c5-53aedbb161b3
1937	1937	0	GBIF France	da44cd31-5901-4687-a106-6d1c7734ee3a	4b7d9185-e77b-4b39-9151-239c0d7fa627
240	240	0	Plazi	ffb07bec-2d10-492d-9c37-361fe0b79427	4d438ca0-e475-456e-98a1-d45aa4dab121
7407	7407	0	National Biodiversity Network	d897a5b9-35ee-4232-94bd-b0bcaac003c2	4f272892-7a07-434f-8a69-7032826bcfb3
21	21	0	Plazi	ffb07bec-2d10-492d-9c37-361fe0b79427	5329bfc4-61b2-48f5-a96a-caf4ba31039b
0	6	6	Ocean Biodiversity Information System	ba0670b9-4186-41e6-8e70-f9cb3065551a	553a7433-b0a9-4cd4-a2ae-5d8fee4da3ba
3359	3359	0	GBIF Brazil	cdc9736d-5ff7-4ece-9959-3c744360cdb3	559917d6-f709-4482-82ef-97e76a815cc9
0	5	5	Ocean Biodiversity Information System	ba0670b9-4186-41e6-8e70-f9cb3065551a	56e350ed-c14c-49d4-887e-1a5b788e3065
200	200	0	Ocean Biodiversity Information System	ba0670b9-4186-41e6-8e70-f9cb3065551a	57b23628-702b-4ac8-b400-1039f7549792
18	18	0	Plazi	ffb07bec-2d10-492d-9c37-361fe0b79427	5a1b1966-f70a-4b72-9f37-d9fd846fdf84
74	74	0	GBIF Germany	4f6826f2-4ff6-443d-b966-e6913bd24013	61727cb8-f762-11e1-a439-00145eb45e9a
151108	151108	0	GBIF France	da44cd31-5901-4687-a106-6d1c7734ee3a	6242ca69-c65e-4723-b629-9aeb05b51c88
0	12	12	Plazi	ffb07bec-2d10-492d-9c37-361fe0b79427	62e5a9af-bd12-4c15-b621-8cd26a65b3a8
4	4	0	Plazi	ffb07bec-2d10-492d-9c37-361fe0b79427	65753548-3acd-49be-956b-db037db3f45f
131	126	-5	GBIF Germany	4f6826f2-4ff6-443d-b966-e6913bd24013	657c496a-f762-11e1-a439-00145eb45e9a
160	2660	2500	GBIF Japan	db5705aa-6a6e-42f1-8942-d77b9f4896ea	65a6fbc5-a6d9-4cea-bc08-818652f95b20
177	177	0	GBIF Germany	4f6826f2-4ff6-443d-b966-e6913bd24013	66342620-f762-11e1-a439-00145eb45e9a
52584	53226	642	U.S. Geological Survey	8618c64a-93e0-4300-b546-7249e5148ed2	66df9620-115a-4794-be25-3a5b99786b1d
0	10	10	Plazi	ffb07bec-2d10-492d-9c37-361fe0b79427	67893006-2912-4134-835f-37b022607840
44	44	0	GBIF Germany	4f6826f2-4ff6-443d-b966-e6913bd24013	67ec3d2c-f762-11e1-a439-00145eb45e9a
348	348	0	GBIF Brazil	cdc9736d-5ff7-4ece-9959-3c744360cdb3	6834c3b4-50a7-42df-a87f-324239eaca66
6	6	0	GBIF Germany	4f6826f2-4ff6-443d-b966-e6913bd24013	69367814-f762-11e1-a439-00145eb45e9a
185	185	0	GBIF Germany	4f6826f2-4ff6-443d-b966-e6913bd24013	696406c6-f762-11e1-a439-00145eb45e9a
47	47	0	GBIF Germany	4f6826f2-4ff6-443d-b966-e6913bd24013	6a1d63c8-f762-11e1-a439-00145eb45e9a
16	16	0	GBIF Germany	4f6826f2-4ff6-443d-b966-e6913bd24013	6af2ddb4-f762-11e1-a439-00145eb45e9a
45	45	0	GBIF Germany	4f6826f2-4ff6-443d-b966-e6913bd24013	6c9c2d82-f762-11e1-a439-00145eb45e9a
65	65	0	Plazi	ffb07bec-2d10-492d-9c37-361fe0b79427	6e176ff1-c6ce-429c-8b36-9d32c3cdc5c9
393	393	0	GBIF Germany	4f6826f2-4ff6-443d-b966-e6913bd24013	6f37b250-f762-11e1-a439-00145eb45e9a
7337	6316	-1021	GBIF Germany	4f6826f2-4ff6-443d-b966-e6913bd24013	70965958-f762-11e1-a439-00145eb45e9a
0	62	62	Ocean Biodiversity Information System	ba0670b9-4186-41e6-8e70-f9cb3065551a	71a8ec9f-e5f4-4e02-8542-640cffe10096
0	4	4	Plazi	ffb07bec-2d10-492d-9c37-361fe0b79427	71bdd341-af13-4447-ba22-9b2bb8de2f80
193	183	-10	GBIF Germany	4f6826f2-4ff6-443d-b966-e6913bd24013	72134976-f762-11e1-a439-00145eb45e9a
104	104	0	GBIF Germany	4f6826f2-4ff6-443d-b966-e6913bd24013	74e60b5c-f762-11e1-a439-00145eb45e9a
0	1	1	Plazi	ffb07bec-2d10-492d-9c37-361fe0b79427	7500c962-24cb-4d14-a162-ec8ad8f8c0dd
1455	1536	81	GBIF Chile	a8b16421-d80b-4ef3-8f22-098b01a89255	75a6f6f1-de60-4ec6-8830-2766719231e7
192	192	0	GBIF Brazil	cdc9736d-5ff7-4ece-9959-3c744360cdb3	760f2869-a232-4762-9afb-472853a3bf1e
106	106	0	GBIF France	da44cd31-5901-4687-a106-6d1c7734ee3a	76d845e8-2905-45f4-950e-18183bcca22b
0	28	28	Plazi	ffb07bec-2d10-492d-9c37-361fe0b79427	76f24cec-201c-4ef7-bf42-8dc067466963
2	2	0	GBIF Germany	4f6826f2-4ff6-443d-b966-e6913bd24013	7893230c-f762-11e1-a439-00145eb45e9a
0	31	31	Plazi	ffb07bec-2d10-492d-9c37-361fe0b79427	799b4c90-4e60-4ba8-a28d-d922802cfa1e
1667	1667	0	GBIF Spain	1f94b3ca-9345-4d65-afe2-4bace93aa0fe	7a4856d6-f762-11e1-a439-00145eb45e9a
11314	11314	0	GBIF Japan	db5705aa-6a6e-42f1-8942-d77b9f4896ea	7a53eaaa-f762-11e1-a439-00145eb45e9a
1397	1397	0	Korean Biodiversity Information Facility	e0a1e772-0177-4800-94b4-2d023fe6cdf4	7af83574-f762-11e1-a439-00145eb45e9a
647	647	0	GBIF Germany	4f6826f2-4ff6-443d-b966-e6913bd24013	7c44f9bc-f762-11e1-a439-00145eb45e9a
4290	4290	0	GBIF Portugal	673f7038-4262-4149-b753-5658a4e912f6	7c9298cf-8f55-4433-a1eb-e1342946a104
66	66	0	GBIF Germany	4f6826f2-4ff6-443d-b966-e6913bd24013	7e6a47ce-f762-11e1-a439-00145eb45e9a
72	72	0	GBIF Germany	4f6826f2-4ff6-443d-b966-e6913bd24013	7ee14d92-f762-11e1-a439-00145eb45e9a
7010	1640	-5370	Biodiversity Information System of Mexico	b324e8e9-9a4c-44fa-8f1a-7f39ea7ab576	7faac758-f762-11e1-a439-00145eb45e9a
0	5	5	Plazi	ffb07bec-2d10-492d-9c37-361fe0b79427	80e59ba6-6754-4a58-aa4b-1633da397c8c
1998	1998	0	GBIF Germany	4f6826f2-4ff6-443d-b966-e6913bd24013	8152bbce-f762-11e1-a439-00145eb45e9a
1771864	1843990	72126	GBIF Switzerland	169eb292-376b-4cc6-8e31-9c2c432de0ad	82ad4e4e-f762-11e1-a439-00145eb45e9a
3407	3406	-1	Biodiversity Information System of Mexico	b324e8e9-9a4c-44fa-8f1a-7f39ea7ab576	82d3b0c5-d3f4-46af-b54f-a0bbf1980dd2
1350	1350	0	Belgian Biodiversity Platform	fb11cfe1-ebc3-45af-9159-17d9fddbcdac	845b8011-722d-41da-8253-df341221932e
55216	55216	0	GBIF Japan	db5705aa-6a6e-42f1-8942-d77b9f4896ea	8491c136-f762-11e1-a439-00145eb45e9a
41100	49100	8000	GBIF Japan	db5705aa-6a6e-42f1-8942-d77b9f4896ea	86172abe-f762-11e1-a439-00145eb45e9a
5346	5346	0	GBIF Japan	db5705aa-6a6e-42f1-8942-d77b9f4896ea	869249c4-f762-11e1-a439-00145eb45e9a
0	6	6	Plazi	ffb07bec-2d10-492d-9c37-361fe0b79427	869aeeae-a01c-4d9a-89d7-731b7a6d2134
166	166	0	GBIF Germany	4f6826f2-4ff6-443d-b966-e6913bd24013	8855680e-f762-11e1-a439-00145eb45e9a
644	611	-33	GBIF Germany	4f6826f2-4ff6-443d-b966-e6913bd24013	88bfdc70-f762-11e1-a439-00145eb45e9a
68	29	-39	GBIF Germany	4f6826f2-4ff6-443d-b966-e6913bd24013	8df58370-f762-11e1-a439-00145eb45e9a
5	4	-1	GBIF Germany	4f6826f2-4ff6-443d-b966-e6913bd24013	8e3cbff6-f762-11e1-a439-00145eb45e9a
23	21	-2	GBIF Germany	4f6826f2-4ff6-443d-b966-e6913bd24013	8e771886-f762-11e1-a439-00145eb45e9a
132	102	-30	GBIF Germany	4f6826f2-4ff6-443d-b966-e6913bd24013	8ea042c4-f762-11e1-a439-00145eb45e9a
41	30	-11	GBIF Germany	4f6826f2-4ff6-443d-b966-e6913bd24013	8f2d8d78-f762-11e1-a439-00145eb45e9a
166	166	0	GBIF Germany	4f6826f2-4ff6-443d-b966-e6913bd24013	8fc5bfc7-ac1d-4243-8d37-281a462594cb
13	11	-2	GBIF Germany	4f6826f2-4ff6-443d-b966-e6913bd24013	8ff711d4-f762-11e1-a439-00145eb45e9a
3	3	0	GBIF Germany	4f6826f2-4ff6-443d-b966-e6913bd24013	92cc93c0-f762-11e1-a439-00145eb45e9a
768	768	0	GBIF Germany	4f6826f2-4ff6-443d-b966-e6913bd24013	940432d4-f762-11e1-a439-00145eb45e9a
0	13394	13394	Belgian Biodiversity Platform	fb11cfe1-ebc3-45af-9159-17d9fddbcdac	94647b27-6e70-44d1-9232-78b71b6b14a8
1097	1097	0	National Biodiversity Network	d897a5b9-35ee-4232-94bd-b0bcaac003c2	95a56312-3405-4286-8e39-1dcaae4c9217
439	439	0	GBIF France	da44cd31-5901-4687-a106-6d1c7734ee3a	96535a61-d77c-43e5-ae57-8cc085be67d2
482622	483119	497	U.S. Geological Survey	8618c64a-93e0-4300-b546-7249e5148ed2	9654e4d4-f762-11e1-a439-00145eb45e9a
22	22	0	Plazi	ffb07bec-2d10-492d-9c37-361fe0b79427	975891c9-6f9a-4746-9ad1-cc1562a8f087
48	48	0	Biodiversity Information System of Mexico	b324e8e9-9a4c-44fa-8f1a-7f39ea7ab576	97ea1a18-d8f8-4943-9430-1b985e91ee9a
1286	1286	0	Biodiversity Information System of Mexico	b324e8e9-9a4c-44fa-8f1a-7f39ea7ab576	98fe10b3-bc07-4ae6-8acf-7129288cb06d
1	1	0	Plazi	ffb07bec-2d10-492d-9c37-361fe0b79427	9ac948bb-57a8-47db-9de1-106f700a6a0e
6288	6288	0	GBIF New Zealand	4f9fd726-20dd-445e-89a1-8ed93792276f	9c240935-a231-4067-a7ff-e171761c90dd
1165	1165	0	Scientific Committee on Antarctic Research	51e4e8ff-bff0-4996-8b27-9107d61b3478	9dae1fa0-5800-4f18-8f4e-a87f05c73eb1
284	284	0	Biodiversity Information System of Mexico	b324e8e9-9a4c-44fa-8f1a-7f39ea7ab576	9e35e854-f490-4f6f-8c1b-3b330010fe86
0	5	5	Plazi	ffb07bec-2d10-492d-9c37-361fe0b79427	9eb1aca4-fd44-49ec-b534-1e9ae3ccadb7
517	517	0	Ocean Biodiversity Information System	ba0670b9-4186-41e6-8e70-f9cb3065551a	a2365c64-d3fb-4ef8-a18e-ac5b66cb90fe
0	2	2	Plazi	ffb07bec-2d10-492d-9c37-361fe0b79427	a2718082-7cbb-4d25-850d-3dfb7d0ea8af
0	2	2	Plazi	ffb07bec-2d10-492d-9c37-361fe0b79427	a5a689aa-8ed3-4987-ad2f-5cfeb43b9b48
23	23	0	Plazi	ffb07bec-2d10-492d-9c37-361fe0b79427	a687f818-766a-4567-b1ff-ad243b7c8334
43	43	0	South African Biodiversity Information Facility	7190b835-4e86-4b6e-85c1-19cc6677c250	a71aeb4a-46bc-43b0-b752-c6f5e0d6561c
115	115	0	GBIF France	da44cd31-5901-4687-a106-6d1c7734ee3a	a9ec0e74-5c51-46e0-b424-8ad383112d56
0	3	3	Plazi	ffb07bec-2d10-492d-9c37-361fe0b79427	aa0acf9d-ff8a-4719-bdb7-55256c40c37b
521	691	170	GBIF Japan	db5705aa-6a6e-42f1-8942-d77b9f4896ea	aa4f7405-273d-4a27-bac2-611416f1902b
3500	3500	0	National Biodiversity Network	d897a5b9-35ee-4232-94bd-b0bcaac003c2	ac9eec06-47cb-40d6-8f35-b12af7a67216
1465	1465	0	GBIF Norway	4f829580-180d-46a9-9c87-ed8ec959b545	ad747a8d-72d0-40b1-a5b6-75dcea8c9ca8
113293	104149	-9144	U.S. Geological Survey	8618c64a-93e0-4300-b546-7249e5148ed2	ae33dc82-0bc2-43b5-b69b-65bf858f1e7a
71	71	0	GBIF Germany	4f6826f2-4ff6-443d-b966-e6913bd24013	afcd379b-ce1a-44ae-a1a9-9bdebffb71cd
95	95	0	Plazi	ffb07bec-2d10-492d-9c37-361fe0b79427	b183ba29-ac05-49fe-b6b6-e7caa56d59ad
29	29	0	Plazi	ffb07bec-2d10-492d-9c37-361fe0b79427	b26a6032-62d2-4b97-a37d-f35e05bbad32
50	50	0	GBIF Germany	4f6826f2-4ff6-443d-b966-e6913bd24013	b366e083-c6ee-4739-8292-4f129eac19c4
0	2	2	Plazi	ffb07bec-2d10-492d-9c37-361fe0b79427	b404ef1c-c075-4098-9a0e-32a490b84fc3
17784	17784	0	GBIF Portugal	673f7038-4262-4149-b753-5658a4e912f6	b965f812-5e19-4b91-b524-a86bbc2ff8d8
204	204	0	GBIF Germany	4f6826f2-4ff6-443d-b966-e6913bd24013	bf1cf7e5-a65b-47e4-befa-caa5361e7c82
89738	89738	0	GBIF France	da44cd31-5901-4687-a106-6d1c7734ee3a	c186e534-5281-4d9e-a389-f0415aa70331
550	550	0	Atlas of Living Australia	4a6f1b71-969e-4fc5-a693-282b05e1220c	c23f8085-b3e9-4741-a620-b4997dbb4b25
101919	101919	0	Canadensys	4db9cfd2-1191-4b9d-b579-0b68ceabd968	c4a5efee-4c61-45d8-bd7a-6275b2388308
0	7	7	Plazi	ffb07bec-2d10-492d-9c37-361fe0b79427	c6163d29-9efd-4b11-a460-65d21e76adeb
1402	1402	0	GBIF Argentina	2426a871-9feb-40a1-96c6-0c593a76b835	c667b83e-106e-49bd-a4af-0f9a016e28c4
16	16	0	GBIF Guinea	b1cd2e84-c4ba-47bd-b72a-dfd1f92dce0a	c8835694-195d-4f96-9849-ddc12272f454
15	15	0	Plazi	ffb07bec-2d10-492d-9c37-361fe0b79427	c9bf5059-abe4-414e-a7c2-f3f9e75f2979
54	54	0	GBIF Germany	4f6826f2-4ff6-443d-b966-e6913bd24013	c9d81cbf-e59e-4820-bb5b-5d720d9e9f9c
0	12	12	Ocean Biodiversity Information System	ba0670b9-4186-41e6-8e70-f9cb3065551a	c9f7a170-1c15-42d1-9ddc-cdc8da2a763b
44	44	0	Plazi	ffb07bec-2d10-492d-9c37-361fe0b79427	ca0a78a3-4d56-409f-ae44-c7ffe330ee8a
1	1	0	Plazi	ffb07bec-2d10-492d-9c37-361fe0b79427	cad8e5bb-40ef-40b4-b8f5-7d1542d2097d
1556	1556	0	GBIF Norway	4f829580-180d-46a9-9c87-ed8ec959b545	ce697b4c-7803-47d8-81bd-5a172f4960b5
2	2	0	Plazi	ffb07bec-2d10-492d-9c37-361fe0b79427	d3fcc3d8-efcc-4afd-b0ec-8ca1e19caf27
9454	9454	0	National Biodiversity Network	d897a5b9-35ee-4232-94bd-b0bcaac003c2	d4ac1450-443e-4b89-9290-cf03072cdb25
1	1	0	Plazi	ffb07bec-2d10-492d-9c37-361fe0b79427	d54ced1f-7deb-4234-af78-53394a1f5aa7
3	3	0	Plazi	ffb07bec-2d10-492d-9c37-361fe0b79427	d5b2c375-1c51-4830-afdf-17fcbe947027
0	454	454	Colombian Biodiversity Information System	7e865cba-7c46-417b-ade5-97f2cf5b7be0	d95256d1-8948-49dd-9970-8dd8bbb57ac7
6	6	0	GBIF France	da44cd31-5901-4687-a106-6d1c7734ee3a	dc33b137-95af-472a-a265-19d704ae8ea1
33	33	0	GBIF France	da44cd31-5901-4687-a106-6d1c7734ee3a	dcbe123f-908a-4bc8-bc24-f1d563c67ea1
3	3	0	Plazi	ffb07bec-2d10-492d-9c37-361fe0b79427	dd5f4941-dd0f-4b58-aa27-a6cda534dc17
17	17	0	Plazi	ffb07bec-2d10-492d-9c37-361fe0b79427	de7c4264-09b0-4361-a7cb-04f80e6ddbe2
31	31	0	Plazi	ffb07bec-2d10-492d-9c37-361fe0b79427	df8e24d8-b6f2-4006-a065-dbae51af1600
6	6	0	Plazi	ffb07bec-2d10-492d-9c37-361fe0b79427	e0078a85-2a99-4e9b-8add-91c9029db2b6
585	180	-405	GBIF Germany	4f6826f2-4ff6-443d-b966-e6913bd24013	e160a13e-70e7-422d-8ba1-4461d1cf0c1c
52474	52474	0	Participant Node Managers Committee	7f48e0c8-5c96-49ec-b972-30748e339115	e1c320f6-370e-4d5e-8253-9b5285a0775f
2	2	0	Plazi	ffb07bec-2d10-492d-9c37-361fe0b79427	e2e71763-3b43-4845-81f3-26d56a4adf7d
8006	8006	0	Canada Biodiversity Information Facility	8f83fc96-c966-4126-83f7-bf044dc49efa	e316afc7-2ec6-45e6-b48e-8d06d56772b0
6311	6311	0	GBIF Brazil	cdc9736d-5ff7-4ece-9959-3c744360cdb3	e81d05a6-541c-4cda-9650-a4aac9d35e3b
1483	1483	0	GBIF France	da44cd31-5901-4687-a106-6d1c7734ee3a	ea372629-c38a-46df-981c-b821b7849a48
104	104	0	Plazi	ffb07bec-2d10-492d-9c37-361fe0b79427	ea44347b-d895-4d9a-940f-7f2c8e3c62be
203	203	0	GBIF France	da44cd31-5901-4687-a106-6d1c7734ee3a	ea571a45-feb5-44fb-afac-e121cc526279
36014	36859	845	GBIF Brazil	cdc9736d-5ff7-4ece-9959-3c744360cdb3	eb521f93-d62d-4332-a5f0-989ed94d9cc4
0	7	7	Plazi	ffb07bec-2d10-492d-9c37-361fe0b79427	ec5410f4-b0ae-4563-a730-c1c0f0869aeb
3	3	0	Participant Node Managers Committee	7f48e0c8-5c96-49ec-b972-30748e339115	ec60eeee-3fbe-425e-b10a-cbe54a05279f
0	967	967	Ocean Biodiversity Information System	ba0670b9-4186-41e6-8e70-f9cb3065551a	ee593a8a-d9a4-4600-80c3-78f3fe2b620f
6	6	0	GBIF Argentina	2426a871-9feb-40a1-96c6-0c593a76b835	effb8343-bc06-4edf-a6f2-8caa1afe8a57
6904	6904	0	National Biodiversity Network	d897a5b9-35ee-4232-94bd-b0bcaac003c2	f11d5695-fca8-4e5c-8032-a078b1f9bf65
442	442	0	Biodiversity Information System of Mexico	b324e8e9-9a4c-44fa-8f1a-7f39ea7ab576	f1ae44ab-62da-4a76-9118-738e203ba9f4
2934	2934	0	GBIF France	da44cd31-5901-4687-a106-6d1c7734ee3a	f2df8baf-aaa3-4aa6-a593-c7bb2785b7e4
100	100	0	Colombian Biodiversity Information System	7e865cba-7c46-417b-ade5-97f2cf5b7be0	f371c8fe-c831-4934-92b1-cc67ba4aa66f
1	1	0	GBIF France	da44cd31-5901-4687-a106-6d1c7734ee3a	f3a9317f-1950-4a95-ad7f-45ae98d2a60c
25	25	0	Plazi	ffb07bec-2d10-492d-9c37-361fe0b79427	f53d60b5-0295-4ed5-8e6e-1d93d6f22df2
971	971	0	GBIF Portugal	673f7038-4262-4149-b753-5658a4e912f6	f6094efe-26ec-4bb8-9a30-5de911277c47
0	39	39	Plazi	ffb07bec-2d10-492d-9c37-361fe0b79427	fc56a00d-cf6b-4fda-aa56-d0492e4781cb
1348	1348	0	GBIF Benin	efb9c00e-f802-45dd-8826-a52ec45b89ff	015ff14b-bc6e-4631-a34c-2af4f512c888
9305	9304	-1	National Biodiversity Network	d897a5b9-35ee-4232-94bd-b0bcaac003c2	0233af7f-11ae-491e-be56-a4038ecf6585
12	12	0	Plazi	ffb07bec-2d10-492d-9c37-361fe0b79427	025ce23f-5060-44ac-ace3-e8c6a429ecf8
2175	2175	0	Biodiversity Information System of Mexico	b324e8e9-9a4c-44fa-8f1a-7f39ea7ab576	02ee147f-70eb-4156-910c-7e1fbdd34518
9875	9875	0	GBIF France	da44cd31-5901-4687-a106-6d1c7734ee3a	07adabd1-4687-48ce-aa5f-fb32fbf02108
0	6	6	Plazi	ffb07bec-2d10-492d-9c37-361fe0b79427	0bc0ddb8-06ae-415d-9d50-ca2fdc5455fe
24	24	0	GBIF France	da44cd31-5901-4687-a106-6d1c7734ee3a	0e434ac6-d2d5-44d2-8fb1-e870776bc7e8
0	2	2	Ocean Biodiversity Information System	ba0670b9-4186-41e6-8e70-f9cb3065551a	0eb87c08-ebba-41ad-b2c9-bbe8721f9c75
27	27	0	National Biodiversity Network	d897a5b9-35ee-4232-94bd-b0bcaac003c2	0f4dd742-52b9-4c8f-8834-fe9a92124119
11	11	0	Plazi	ffb07bec-2d10-492d-9c37-361fe0b79427	0f54121a-e9a2-4d40-86e9-b3f206efe50d
1818	1818	0	GBIF France	da44cd31-5901-4687-a106-6d1c7734ee3a	1199003d-8b75-410d-a843-7ff64b21e330
87	87	0	Participant Node Managers Committee	7f48e0c8-5c96-49ec-b972-30748e339115	1228306b-f4c8-45ec-83cf-c006b8236021
179	179	0	GBIF Sweden	a0b3be64-6525-4387-ac67-a499950f92e1	1340fe1d-4bd3-4d13-adc7-791810188679
105	105	0	Participant Node Managers Committee	7f48e0c8-5c96-49ec-b972-30748e339115	13d7cb4c-3dc0-4276-b3cf-c29d10e92beb
29219	29219	0	Atlas of Living Australia	4a6f1b71-969e-4fc5-a693-282b05e1220c	19369ff7-ef17-44ef-8df2-c02b3132fffd
25	25	0	Plazi	ffb07bec-2d10-492d-9c37-361fe0b79427	1a555801-dc77-4cd8-a613-4f51e74e9c13
22030	22030	0	GBIF France	da44cd31-5901-4687-a106-6d1c7734ee3a	1b8ab2fc-1b1c-4132-8142-d416ebf76d7c
9366	9366	0	Participant Node Managers Committee	7f48e0c8-5c96-49ec-b972-30748e339115	1d1f4137-7653-4eac-ab67-7487dae51739
17	17	0	Plazi	ffb07bec-2d10-492d-9c37-361fe0b79427	1ebd2beb-8308-4052-8227-aac8dd738056
346643	346643	0	Chinese Academy of Sciences	e760dc6f-dd68-474d-ab41-bd3588571793	246ad1f8-e75c-419d-b97e-16dde697ae30
741	741	0	Plazi	ffb07bec-2d10-492d-9c37-361fe0b79427	27455364-100a-4f24-b17c-b051ae69dd3a
173	173	0	Atlas of Living Australia	4a6f1b71-969e-4fc5-a693-282b05e1220c	281d6c9a-a199-4f76-828d-1bc3f874da5d
1230	1230	0	GBIF France	da44cd31-5901-4687-a106-6d1c7734ee3a	2a7e9bd0-322f-4ff2-b31c-34eb9758aba1
4	4	0	Plazi	ffb07bec-2d10-492d-9c37-361fe0b79427	309f28f9-2ce7-43c1-921f-5eefb09bffc7
8	8	0	GBIF Germany	4f6826f2-4ff6-443d-b966-e6913bd24013	3265e93b-a6a6-4ae8-b50c-1ebda5d1362d
1288	1288	0	National Biodiversity Network	d897a5b9-35ee-4232-94bd-b0bcaac003c2	33a1b6e9-76fd-4c18-8820-706ba5bfbc3c
0	7	7	Participant Node Managers Committee	7f48e0c8-5c96-49ec-b972-30748e339115	33f7f618-bc62-4cf3-ab46-92def77a2b69
56	56	0	Plazi	ffb07bec-2d10-492d-9c37-361fe0b79427	34fa910e-bd20-460f-8343-cb7097ba4126
2691	2691	0	U.S. Geological Survey	8618c64a-93e0-4300-b546-7249e5148ed2	353b7fba-63df-4cbe-86d1-bf854850edf8
790	838	48	GBIF Germany	4f6826f2-4ff6-443d-b966-e6913bd24013	3755fe94-6b02-4a6f-9db3-7c39dc80eb62
8422	8577	155	Symbiota Support Hub	612b5a0b-908b-4b4e-b9bf-ca15dfdc94fa	375fe518-f58b-4ec7-868c-99218dfd2866
3	3	0	Plazi	ffb07bec-2d10-492d-9c37-361fe0b79427	383a1f23-b283-4d73-b96d-76376d0bd9ff
536	536	0	GBIF Argentina	2426a871-9feb-40a1-96c6-0c593a76b835	3b1d6d7d-bd17-499e-98d9-ec18e0e7b61e
13	13	0	GBIF France	da44cd31-5901-4687-a106-6d1c7734ee3a	3b40e756-66ab-41f6-9046-55f94ca2e55a
3979	3979	0	GBIF Argentina	2426a871-9feb-40a1-96c6-0c593a76b835	3c436b0f-fb55-4e16-9c51-2966cae36e65
0	3	3	Plazi	ffb07bec-2d10-492d-9c37-361fe0b79427	3dd3c1b1-0a88-4148-a734-9cc659539e07
13868	13868	0	GBIF France	da44cd31-5901-4687-a106-6d1c7734ee3a	3fc4714c-bbd1-4336-9b49-77bdb76910e3
0	37	37	Ocean Biodiversity Information System	ba0670b9-4186-41e6-8e70-f9cb3065551a	403819f8-dca9-42af-8d61-1e11761c57f2
49	49	0	Plazi	ffb07bec-2d10-492d-9c37-361fe0b79427	41e824c2-f965-4129-8dd0-b05f33f04d93
20992	20992	0	U.S. Geological Survey	8618c64a-93e0-4300-b546-7249e5148ed2	43e0bba3-9edb-4b00-b490-84924e55a222
153	153	0	GBIF Brazil	cdc9736d-5ff7-4ece-9959-3c744360cdb3	449e5108-19cf-4c79-9cfc-6fe3acb61574
546	546	0	GBIF France	da44cd31-5901-4687-a106-6d1c7734ee3a	44a0147e-d5d1-413a-8729-f8e63ceca86b
31947	35175	3228	GBIF Sweden	a0b3be64-6525-4387-ac67-a499950f92e1	4508bed1-d45d-4a2d-9790-34cc99ee8cce
7107	7107	0	Biodiversity Information System of Mexico	b324e8e9-9a4c-44fa-8f1a-7f39ea7ab576	463c9658-f584-4b61-859a-bdeec78d8cc8
0	9	9	Ocean Biodiversity Information System	ba0670b9-4186-41e6-8e70-f9cb3065551a	483d60d0-baf2-4cb9-855b-ebdd0e24da8d
192	192	0	Plazi	ffb07bec-2d10-492d-9c37-361fe0b79427	48be31ab-c94e-4044-bc82-751bd71fe938
11	11	0	Plazi	ffb07bec-2d10-492d-9c37-361fe0b79427	49fc84bd-f42b-4bb6-a781-c42b6a0e95e0
0	4	4	Plazi	ffb07bec-2d10-492d-9c37-361fe0b79427	4bd74c24-ebc3-47cc-b8e8-41d513bec5c2
684	684	0	Biodiversity Information System of Mexico	b324e8e9-9a4c-44fa-8f1a-7f39ea7ab576	4c4567f2-e495-4351-8f35-309dfa02a025
1	1	0	Participant Node Managers Committee	7f48e0c8-5c96-49ec-b972-30748e339115	506691c5-1d0b-4f3c-b09d-e518d67ae4b1
51	51	0	Biodiversity Information System of Mexico	b324e8e9-9a4c-44fa-8f1a-7f39ea7ab576	50efc135-cd5f-4282-b38b-1f73be8affe1
6979	6979	0	Polish Biodiversity Information Network	2618bfdf-e194-4911-a241-80db3107bc51	533e8bc0-925e-11da-8900-b8a03c50a862
0	3323	3323	U.S. Geological Survey	8618c64a-93e0-4300-b546-7249e5148ed2	53bfee71-d855-4bbf-a017-06db1780ddfa
7	7	0	Plazi	ffb07bec-2d10-492d-9c37-361fe0b79427	55b5ae73-6fd6-4c60-8230-ab3d60f5f163
207114	207114	0	U.S. Geological Survey	8618c64a-93e0-4300-b546-7249e5148ed2	5c02bff2-9680-4df7-b543-3682b60e6b76
4845	4845	0	Participant Node Managers Committee	7f48e0c8-5c96-49ec-b972-30748e339115	5c1308de-3e3b-4ce6-81fa-f45950801fd0
9101	9101	0	GBIF France	da44cd31-5901-4687-a106-6d1c7734ee3a	5c5cb902-8c57-4488-b453-1b13eb151a8b
0	18	18	Plazi	ffb07bec-2d10-492d-9c37-361fe0b79427	5d123380-5ada-4704-8913-244b25263eee
192	192	0	GBIF Germany	4f6826f2-4ff6-443d-b966-e6913bd24013	61a8ffc2-f762-11e1-a439-00145eb45e9a
120	120	0	GBIF Germany	4f6826f2-4ff6-443d-b966-e6913bd24013	626382ac-f762-11e1-a439-00145eb45e9a
51	51	0	GBIF Germany	4f6826f2-4ff6-443d-b966-e6913bd24013	62a3ac06-f762-11e1-a439-00145eb45e9a
15	15	0	GBIF Germany	4f6826f2-4ff6-443d-b966-e6913bd24013	62eceb00-f762-11e1-a439-00145eb45e9a
42	42	0	Plazi	ffb07bec-2d10-492d-9c37-361fe0b79427	642ca789-19dd-4958-bfa9-78e79adfd842
259	259	0	Scientific Committee on Antarctic Research	51e4e8ff-bff0-4996-8b27-9107d61b3478	65e34334-66b3-4536-ac3c-857893fe0f6a
213	213	0	GBIF Germany	4f6826f2-4ff6-443d-b966-e6913bd24013	664ae0d6-f762-11e1-a439-00145eb45e9a
873	873	0	GBIF France	da44cd31-5901-4687-a106-6d1c7734ee3a	68340cac-348a-4ac9-9d15-6e34139f7df9
255	3471	3216	National Biodiversity Network	d897a5b9-35ee-4232-94bd-b0bcaac003c2	688e9ab9-d010-4691-96e0-80ca29323a57
123	123	0	GBIF Germany	4f6826f2-4ff6-443d-b966-e6913bd24013	6893f92c-f762-11e1-a439-00145eb45e9a
132	132	0	GBIF Germany	4f6826f2-4ff6-443d-b966-e6913bd24013	68a0a15e-f762-11e1-a439-00145eb45e9a
95	95	0	GBIF Germany	4f6826f2-4ff6-443d-b966-e6913bd24013	68bf950a-f762-11e1-a439-00145eb45e9a
116	116	0	GBIF Germany	4f6826f2-4ff6-443d-b966-e6913bd24013	69003574-f762-11e1-a439-00145eb45e9a
50	50	0	Plazi	ffb07bec-2d10-492d-9c37-361fe0b79427	6a6d2b8d-a344-44e6-bfbd-24554d49f950
123	123	0	GBIF Germany	4f6826f2-4ff6-443d-b966-e6913bd24013	6a7e0598-f762-11e1-a439-00145eb45e9a
8	8	0	GBIF Germany	4f6826f2-4ff6-443d-b966-e6913bd24013	6ae18f8c-f762-11e1-a439-00145eb45e9a
24	24	0	GBIF Germany	4f6826f2-4ff6-443d-b966-e6913bd24013	6b71fa22-f762-11e1-a439-00145eb45e9a
8	8	0	GBIF Germany	4f6826f2-4ff6-443d-b966-e6913bd24013	6bfed096-f762-11e1-a439-00145eb45e9a
13	13	0	Plazi	ffb07bec-2d10-492d-9c37-361fe0b79427	6c27fa6f-8be8-4b9a-8f3f-f6581007b008
0	1	1	Plazi	ffb07bec-2d10-492d-9c37-361fe0b79427	6c6f58f1-e5a8-4b59-936d-e924e6f96663
3085	3311	226	GBIF Japan	db5705aa-6a6e-42f1-8942-d77b9f4896ea	6c827f0d-9371-447b-b42b-199ad19bdb64
1	1	0	Plazi	ffb07bec-2d10-492d-9c37-361fe0b79427	6e841f69-ffc9-4bf1-94e3-a25a115d7180
2	2	0	Plazi	ffb07bec-2d10-492d-9c37-361fe0b79427	6fb299b2-2f9e-468b-8d80-626264b43539
12	12	0	GBIF Germany	4f6826f2-4ff6-443d-b966-e6913bd24013	70cb2be2-f762-11e1-a439-00145eb45e9a
16	16	0	GBIF Germany	4f6826f2-4ff6-443d-b966-e6913bd24013	70d20a34-f762-11e1-a439-00145eb45e9a
124	124	0	GBIF Germany	4f6826f2-4ff6-443d-b966-e6913bd24013	70f3965e-f762-11e1-a439-00145eb45e9a
1584	1538	-46	GBIF Germany	4f6826f2-4ff6-443d-b966-e6913bd24013	711fca8a-f762-11e1-a439-00145eb45e9a
0	9	9	Plazi	ffb07bec-2d10-492d-9c37-361fe0b79427	71c7761d-6c67-47ca-9732-ef6cf0180e42
0	2	2	Plazi	ffb07bec-2d10-492d-9c37-361fe0b79427	721dee89-0949-41ec-96b8-30bd8618df75
504	504	0	Scientific Committee on Antarctic Research	51e4e8ff-bff0-4996-8b27-9107d61b3478	74277118-41a6-4e2b-bfe3-4d002cca369f
31	31	0	GBIF Germany	4f6826f2-4ff6-443d-b966-e6913bd24013	745ce6ec-f762-11e1-a439-00145eb45e9a
6	6	0	GBIF Germany	4f6826f2-4ff6-443d-b966-e6913bd24013	746cc58a-f762-11e1-a439-00145eb45e9a
7	7	0	Plazi	ffb07bec-2d10-492d-9c37-361fe0b79427	746fe4b9-0576-4139-8b72-f11669a8be4e
643	643	0	GBIF Germany	4f6826f2-4ff6-443d-b966-e6913bd24013	74db90be-f762-11e1-a439-00145eb45e9a
361	361	0	GBIF Germany	4f6826f2-4ff6-443d-b966-e6913bd24013	751fcdb0-f762-11e1-a439-00145eb45e9a
151	151	0	GBIF Germany	4f6826f2-4ff6-443d-b966-e6913bd24013	75bc1cb0-f762-11e1-a439-00145eb45e9a
40824	40952	128	GBIF Brazil	cdc9736d-5ff7-4ece-9959-3c744360cdb3	76823beb-2f33-47a6-96a1-ccd2df47ac28
4	4	0	GBIF Germany	4f6826f2-4ff6-443d-b966-e6913bd24013	78946596-f762-11e1-a439-00145eb45e9a
13	13	0	GBIF Germany	4f6826f2-4ff6-443d-b966-e6913bd24013	78af35ec-f762-11e1-a439-00145eb45e9a
400	400	0	GBIF Germany	4f6826f2-4ff6-443d-b966-e6913bd24013	78b68b5b-7518-49b6-84a6-3dc15d02dc38
3	3	0	GBIF Germany	4f6826f2-4ff6-443d-b966-e6913bd24013	78eaa8f2-f762-11e1-a439-00145eb45e9a
297	297	0	GBIF Germany	4f6826f2-4ff6-443d-b966-e6913bd24013	794c7cda-f762-11e1-a439-00145eb45e9a
17	17	0	Plazi	ffb07bec-2d10-492d-9c37-361fe0b79427	7953b4d5-d0ba-47ef-a793-fcd18b76e92b
1445	1445	0	Korean Biodiversity Information Facility	e0a1e772-0177-4800-94b4-2d023fe6cdf4	7b269446-f762-11e1-a439-00145eb45e9a
262	262	0	GBIF New Zealand	4f9fd726-20dd-445e-89a1-8ed93792276f	7b804dff-24a8-42a2-97ee-be9601c2626e
26	26	0	Plazi	ffb07bec-2d10-492d-9c37-361fe0b79427	7b80b2e8-b5fc-49ad-add8-4a4bd0c70875
0	17	17	Plazi	ffb07bec-2d10-492d-9c37-361fe0b79427	7beefd33-c83a-4e05-82d1-7522b65c112c
0	4	4	Plazi	ffb07bec-2d10-492d-9c37-361fe0b79427	7ca3efd1-4b06-47cf-a9cf-3985b60632f7
1769	1769	0	GBIF Germany	4f6826f2-4ff6-443d-b966-e6913bd24013	7e7b055e-6d8c-4c64-8acd-892417144788
1658	1713	55	GBIF Germany	4f6826f2-4ff6-443d-b966-e6913bd24013	7f4020e2-1387-11e2-bb2e-00145eb45e9a
0	70	70	Tanzania Biodiversity Information Facility	abd95ca6-3959-4db9-aaa6-2de1aeecf514	7ffdd73a-fb27-4f2e-9798-65bc576d2555
746	530	-216	GBIF Germany	4f6826f2-4ff6-443d-b966-e6913bd24013	81df1d44-f762-11e1-a439-00145eb45e9a
54	54	0	GBIF Germany	4f6826f2-4ff6-443d-b966-e6913bd24013	8261511a-f762-11e1-a439-00145eb45e9a
14009	14009	0	GBIF Germany	4f6826f2-4ff6-443d-b966-e6913bd24013	82833b9a-f762-11e1-a439-00145eb45e9a
0	2	2	Plazi	ffb07bec-2d10-492d-9c37-361fe0b79427	8375d69e-2c9c-4c34-9d90-9cfd70d31325
21898	21898	0	South African Biodiversity Information Facility	7190b835-4e86-4b6e-85c1-19cc6677c250	85487457-e02f-4dee-95ea-8dc0d220c52d
6	6	0	GBIF Germany	4f6826f2-4ff6-443d-b966-e6913bd24013	857846ba-f762-11e1-a439-00145eb45e9a
111209	111209	0	U.S. Geological Survey	8618c64a-93e0-4300-b546-7249e5148ed2	8728ca0b-4943-4dd0-8161-b9d820f06221
3	3	0	Plazi	ffb07bec-2d10-492d-9c37-361fe0b79427	88f03af6-910d-43bf-80fe-e11348727f3e
296	296	0	GBIF Germany	4f6826f2-4ff6-443d-b966-e6913bd24013	897be9a6-f762-11e1-a439-00145eb45e9a
1	1	0	Plazi	ffb07bec-2d10-492d-9c37-361fe0b79427	8b65a8fa-bc4b-4b34-83aa-a458e19eadc4
132	132	0	GBIF Germany	4f6826f2-4ff6-443d-b966-e6913bd24013	8b9d6a2a-f762-11e1-a439-00145eb45e9a
32	23	-9	GBIF Germany	4f6826f2-4ff6-443d-b966-e6913bd24013	8c4af2d0-f762-11e1-a439-00145eb45e9a
63	63	0	GBIF Germany	4f6826f2-4ff6-443d-b966-e6913bd24013	8cd33582-f762-11e1-a439-00145eb45e9a
391	17	-374	GBIF Germany	4f6826f2-4ff6-443d-b966-e6913bd24013	8e2c9716-f762-11e1-a439-00145eb45e9a
635	459	-176	GBIF Germany	4f6826f2-4ff6-443d-b966-e6913bd24013	8e788b3a-f762-11e1-a439-00145eb45e9a
683	465	-218	GBIF Germany	4f6826f2-4ff6-443d-b966-e6913bd24013	8e8e6572-f762-11e1-a439-00145eb45e9a
63	26	-37	GBIF Germany	4f6826f2-4ff6-443d-b966-e6913bd24013	8f4ebc00-f762-11e1-a439-00145eb45e9a
473	212	-261	GBIF Germany	4f6826f2-4ff6-443d-b966-e6913bd24013	8f9cbb6c-f762-11e1-a439-00145eb45e9a
126	126	0	GBIF Portugal	673f7038-4262-4149-b753-5658a4e912f6	9010e865-59c5-44ac-a188-e43cc729dcd6
127834	127834	0	GBIF France	da44cd31-5901-4687-a106-6d1c7734ee3a	906b2d3f-dbd7-4c5c-acfc-c572c35c2b5a
6	6	0	Plazi	ffb07bec-2d10-492d-9c37-361fe0b79427	918f2145-a708-460e-b19b-4f67e6c99b30
1788	1265	-523	GBIF Germany	4f6826f2-4ff6-443d-b966-e6913bd24013	92337eb0-f762-11e1-a439-00145eb45e9a
54	33	-21	GBIF Germany	4f6826f2-4ff6-443d-b966-e6913bd24013	9334a488-f762-11e1-a439-00145eb45e9a
390	135	-255	GBIF Germany	4f6826f2-4ff6-443d-b966-e6913bd24013	93653dc8-f762-11e1-a439-00145eb45e9a
0	3	3	Plazi	ffb07bec-2d10-492d-9c37-361fe0b79427	942a4172-715d-4479-88e0-06f8106da0af
4	4	0	Plazi	ffb07bec-2d10-492d-9c37-361fe0b79427	984253a1-5d7d-4676-9042-784f9afb10da
186766	192614	5848	GBIF Sweden	a0b3be64-6525-4387-ac67-a499950f92e1	9940af5a-3271-4e6a-ad71-ced986b9a9a5
0	3927	3927	GBIF Benin	efb9c00e-f802-45dd-8826-a52ec45b89ff	9abfa445-6d93-4ae6-9844-1d2ae44cf9ee
0	7	7	Plazi	ffb07bec-2d10-492d-9c37-361fe0b79427	9acb900d-8c7a-4f43-b8a3-5a8b0efed1be
1634	1777	143	National Biodiversity Network	d897a5b9-35ee-4232-94bd-b0bcaac003c2	9b65cb62-96b8-4809-84f0-511134fa03d9
4	4	0	Plazi	ffb07bec-2d10-492d-9c37-361fe0b79427	9c8d5159-aa69-47a6-9f5f-6bc0599fa594
0	6	6	U.S. Geological Survey	8618c64a-93e0-4300-b546-7249e5148ed2	a65a206f-106b-4344-8c83-9bf48c67f3f6
0	2	2	Ocean Biodiversity Information System	ba0670b9-4186-41e6-8e70-f9cb3065551a	a671d4cd-8876-4dec-8d67-f8e1f8f5e63c
0	112	112	Plazi	ffb07bec-2d10-492d-9c37-361fe0b79427	a68ac12f-87f8-412b-83e6-86b3f20109f6
230	230	0	GBIF Brazil	cdc9736d-5ff7-4ece-9959-3c744360cdb3	ac54751d-33ef-41b0-af8a-bb5db5a040e1
3	3	0	Plazi	ffb07bec-2d10-492d-9c37-361fe0b79427	ada7375b-0f2c-42de-a321-b52ef3bb346e
0	27	27	Plazi	ffb07bec-2d10-492d-9c37-361fe0b79427	adcf90da-6248-40d0-bd86-4e3c0d82dfc6
3960	3960	0	GBIF France	da44cd31-5901-4687-a106-6d1c7734ee3a	b16171e4-fe77-4657-beb9-aa9a55a8b1a0
2116	2116	0	South African Biodiversity Information Facility	7190b835-4e86-4b6e-85c1-19cc6677c250	b2cf1219-3804-451d-ad69-95f099569847
5	5	0	Plazi	ffb07bec-2d10-492d-9c37-361fe0b79427	b2ec8d66-5ed3-4e39-844e-86998876e367
5	5	0	Plazi	ffb07bec-2d10-492d-9c37-361fe0b79427	b348142b-ca9c-42b4-a174-94a160ff8480
0	3	3	Plazi	ffb07bec-2d10-492d-9c37-361fe0b79427	b39bc65b-aa5a-4c56-a04a-3b0a28a5f039
2572	2148	-424	GBIF Germany	4f6826f2-4ff6-443d-b966-e6913bd24013	b4e246db-2ee1-497f-98f9-d8ed652aaa9a
575	575	0	Ocean Biodiversity Information System	ba0670b9-4186-41e6-8e70-f9cb3065551a	b70fe614-89fd-4c24-9e8d-e3797cc0c736
261	261	0	Plazi	ffb07bec-2d10-492d-9c37-361fe0b79427	b798d46c-a7bf-4984-ba4b-49c1a2504fe5
33737	33737	0	U.S. Geological Survey	8618c64a-93e0-4300-b546-7249e5148ed2	b84099fa-99ac-4e11-a8da-d09add544131
9716	9716	0	Ocean Biodiversity Information System	ba0670b9-4186-41e6-8e70-f9cb3065551a	ba04e196-d8b4-42af-90be-73168ffbc0cb
0	5	5	Plazi	ffb07bec-2d10-492d-9c37-361fe0b79427	bb76f834-f20d-4515-87ee-3c7816adc87a
1	1	0	Plazi	ffb07bec-2d10-492d-9c37-361fe0b79427	bcfeb25c-f017-4b7a-9271-6853c5e54b1d
6	6	0	Plazi	ffb07bec-2d10-492d-9c37-361fe0b79427	bfbd1a77-236d-4192-b05b-23a247ffdadc
100	100	0	U.S. Geological Survey	8618c64a-93e0-4300-b546-7249e5148ed2	bffdde48-a268-4132-a0ed-aefababea446
0	620	620	Plazi	ffb07bec-2d10-492d-9c37-361fe0b79427	bffe4ff6-abdf-4d7d-a00a-d82e333454b4
74	74	0	Colombian Biodiversity Information System	7e865cba-7c46-417b-ade5-97f2cf5b7be0	c0fbf926-e627-4243-a52a-1a8ee39fee5c
10	10	0	National Biodiversity Network	d897a5b9-35ee-4232-94bd-b0bcaac003c2	c2037a54-ce53-48fd-a5bf-6d382faa9f67
87	87	0	Colombian Biodiversity Information System	7e865cba-7c46-417b-ade5-97f2cf5b7be0	c3155684-157a-49d9-b63d-87fb4b63a361
0	12	12	Plazi	ffb07bec-2d10-492d-9c37-361fe0b79427	c31ce8bd-b442-4668-956b-a6696feae657
18	18	0	Plazi	ffb07bec-2d10-492d-9c37-361fe0b79427	c3ae854c-7f32-477f-8840-45abf925d610
0	6	6	Plazi	ffb07bec-2d10-492d-9c37-361fe0b79427	c462e174-27ee-4625-a9b8-19e0b3c817bd
299	299	0	GBIF France	da44cd31-5901-4687-a106-6d1c7734ee3a	c734cde8-a858-476a-b293-f948db4c93f3
0	70	70	Plazi	ffb07bec-2d10-492d-9c37-361fe0b79427	c824e298-6eb3-43bf-8d6a-6dcf6baf691a
18842	18842	0	GBIF Sweden	a0b3be64-6525-4387-ac67-a499950f92e1	ca35c47e-4099-4f1e-bb7b-db70e7300dd3
1	1	0	GBIF Argentina	2426a871-9feb-40a1-96c6-0c593a76b835	ce3e64f6-1e44-4c67-a88f-ad9aaeafa9dc
1	1	0	Plazi	ffb07bec-2d10-492d-9c37-361fe0b79427	ce4619ea-625b-42f6-bcfe-ce884ff92359
19833	19834	1	National Biodiversity Network	d897a5b9-35ee-4232-94bd-b0bcaac003c2	cf0a605d-7e32-4482-9e45-1a83bfd8061a
105	105	0	GBIF Germany	4f6826f2-4ff6-443d-b966-e6913bd24013	cfe228df-f16e-4a63-ae19-b46657ab16cb
0	2	2	Plazi	ffb07bec-2d10-492d-9c37-361fe0b79427	d43f251d-0380-42bb-aafb-c6f620c32570
3	3	0	Plazi	ffb07bec-2d10-492d-9c37-361fe0b79427	d55b90e6-f4d7-45dd-adfd-19fe8fc02fe6
1773	1773	0	GBIF France	da44cd31-5901-4687-a106-6d1c7734ee3a	d7fd91b2-25fe-4541-8b66-b37fe38941b2
1709	1709	0	National Biodiversity Data Centre	422b00b2-6c94-4bb6-976b-c359916efdb8	d8144310-c7b8-11de-b279-97e3db606fab
2108	2108	0	GBIF Brazil	cdc9736d-5ff7-4ece-9959-3c744360cdb3	d9ffc198-2a90-4c06-b145-d3cc98a09b84
91610	269801	178191	National Biodiversity Network	d897a5b9-35ee-4232-94bd-b0bcaac003c2	dabb020c-9e4e-4e61-b058-bec11779f71b
374	374	0	VertNet	d205def7-82c3-472a-be4b-31d11dcd51fd	db81038b-c938-4b9a-8b30-4242ece71aad
298029	314265	16236	National Biodiversity Network	d897a5b9-35ee-4232-94bd-b0bcaac003c2	db9fe307-0dd1-48d8-b977-f025efb21a62
1	1	0	Plazi	ffb07bec-2d10-492d-9c37-361fe0b79427	e1164817-0460-473b-a804-de01f676575d
770	777	7	GBIF Brazil	cdc9736d-5ff7-4ece-9959-3c744360cdb3	e14c1abc-d4a7-48b2-a7cb-79f2d0cd59ad
1184	848	-336	GBIF Germany	4f6826f2-4ff6-443d-b966-e6913bd24013	e15c712a-e1fd-4c79-afd3-6bff50b2554c
1	1	0	Plazi	ffb07bec-2d10-492d-9c37-361fe0b79427	e2515827-77a7-4cbd-bd8b-d9c2762dc515
236	236	0	Colombian Biodiversity Information System	7e865cba-7c46-417b-ade5-97f2cf5b7be0	e9221f67-898e-4728-b744-de3b6b905fbc
8	8	0	GBIF France	da44cd31-5901-4687-a106-6d1c7734ee3a	e92b921d-fc07-447a-a45c-ce6708a6f7ec
5725	5725	0	Biodiversity Information System of Mexico	b324e8e9-9a4c-44fa-8f1a-7f39ea7ab576	e95ec36e-e8b6-401d-be47-18ffcc383356
5	5	0	Plazi	ffb07bec-2d10-492d-9c37-361fe0b79427	ea7c5ec5-cf83-441e-8be2-4a19b368574e
0	5	5	Plazi	ffb07bec-2d10-492d-9c37-361fe0b79427	eac655f2-0a83-4da1-94e8-d3c494df1eb8
581	581	0	GBIF France	da44cd31-5901-4687-a106-6d1c7734ee3a	eb6a3fcc-07e8-4cea-b21c-93382834f490
28	28	0	Colombian Biodiversity Information System	7e865cba-7c46-417b-ade5-97f2cf5b7be0	ecf59d5c-861d-47f8-af7a-a321b4bfade1
4096	4096	0	GBIF Germany	4f6826f2-4ff6-443d-b966-e6913bd24013	ed820bdb-4345-4143-a280-4fbffaacd31d
1061	1061	0	GBIF New Zealand	4f9fd726-20dd-445e-89a1-8ed93792276f	ee069354-4c2f-4ace-ae26-86243fc0592a
2	2	0	Plazi	ffb07bec-2d10-492d-9c37-361fe0b79427	ee618a01-aca2-49b3-895f-9720645ba6e1
254240	254253	13	GBIF Norway	4f829580-180d-46a9-9c87-ed8ec959b545	f06ed729-104f-4e51-9db3-dfd9b228a1be
7	7	0	Plazi	ffb07bec-2d10-492d-9c37-361fe0b79427	f3a915c9-a35b-454a-9090-c8792904d8d4
651	651	0	GBIF France	da44cd31-5901-4687-a106-6d1c7734ee3a	f614ff27-d93a-4604-86c7-a2ed2d2c4327
870	870	0	GBIF France	da44cd31-5901-4687-a106-6d1c7734ee3a	f6ef7f09-dd59-4510-9d93-e117f0a69ae6
39	39	0	Plazi	ffb07bec-2d10-492d-9c37-361fe0b79427	f8ebafc8-79ab-4eef-b52b-8c207ff2b1ec
5	5	0	Plazi	ffb07bec-2d10-492d-9c37-361fe0b79427	f951894a-49a5-4519-aa91-6d4bdcb10820
0	3	3	Participant Node Managers Committee	7f48e0c8-5c96-49ec-b972-30748e339115	f97a9d19-c116-4c15-8f07-fd17e97c0aa7
2	2	0	Plazi	ffb07bec-2d10-492d-9c37-361fe0b79427	fc00695e-0226-4bd4-8ddf-eef50bf81fe2
3	3	0	Plazi	ffb07bec-2d10-492d-9c37-361fe0b79427	fcefbd6c-a129-4576-91c8-569c8e0e37f6
9	9	0	Plazi	ffb07bec-2d10-492d-9c37-361fe0b79427	ff472d9b-dd08-479b-ac18-8e3ee827ab73
71	71	0	Belgian Biodiversity Platform	fb11cfe1-ebc3-45af-9159-17d9fddbcdac	ff66e6e8-dcb0-4e51-89b1-545ab1161877
3	3	0	Plazi	ffb07bec-2d10-492d-9c37-361fe0b79427	05b43628-64e6-4c8a-8447-b3a9657fd98d
2822	2822	0	GBIF France	da44cd31-5901-4687-a106-6d1c7734ee3a	05f109ca-e39a-44e8-8774-85ba6d0caa8a
9	9	0	Plazi	ffb07bec-2d10-492d-9c37-361fe0b79427	076d885b-94d4-461f-b50f-83259f4cfcb9
0	82	82	Plazi	ffb07bec-2d10-492d-9c37-361fe0b79427	084d8de1-dab3-4d6e-9db0-69e853c39709
14	14	0	Plazi	ffb07bec-2d10-492d-9c37-361fe0b79427	08fefa83-10c2-4720-b724-3542e6c8a3c5
22	22	0	GBIF Germany	4f6826f2-4ff6-443d-b966-e6913bd24013	09df25be-0af9-473b-bd8a-ecf4d26d2efc
0	10	10	Plazi	ffb07bec-2d10-492d-9c37-361fe0b79427	0d5dbc26-d59b-44d8-aa1e-bc6b29f10b76
7	7	0	Plazi	ffb07bec-2d10-492d-9c37-361fe0b79427	0df60ac3-92fe-491e-ba26-40d2db665a4e
2	2	0	Plazi	ffb07bec-2d10-492d-9c37-361fe0b79427	0fc56867-af92-4adb-a8c7-234d7e82fe91
0	6	6	Plazi	ffb07bec-2d10-492d-9c37-361fe0b79427	1058a1fe-8a20-4dc4-9675-1e1cd0754771
47970	47970	0	Atlas of Living Australia	4a6f1b71-969e-4fc5-a693-282b05e1220c	12d4db8d-5529-43da-b790-2796cfd5c09b
0	230	230	Ocean Biodiversity Information System	ba0670b9-4186-41e6-8e70-f9cb3065551a	14997c99-f2c2-4aed-8243-833997af9c72
51583	51583	0	GBIF France	da44cd31-5901-4687-a106-6d1c7734ee3a	170c15ec-9705-46ce-9b9c-3b551f66ece9
0	142220	142220	National Biodiversity Network	d897a5b9-35ee-4232-94bd-b0bcaac003c2	1cd10854-e401-4822-ae48-adaeeedc647d
0	640	640	GBIF Portugal	673f7038-4262-4149-b753-5658a4e912f6	1eb2814e-71aa-4757-8959-a1ade18ae534
1	1	0	Plazi	ffb07bec-2d10-492d-9c37-361fe0b79427	204b959b-a233-40b6-bb64-7bbe6922c75c
1360	1360	0	GBIF Finland	dd514216-5c7c-45f3-910d-797424cb5be6	21afc06a-f097-47bd-b85e-ff2301436101
836	836	0	GBIF Nigeria	6529bcb5-a542-4fda-be87-54a624515335	25f28184-995a-499f-8594-de3b757d8047
121	121	0	Atlas of Living Australia	4a6f1b71-969e-4fc5-a693-282b05e1220c	2812fba1-cf15-471e-88f0-1a4e6f25f72c
0	29	29	Plazi	ffb07bec-2d10-492d-9c37-361fe0b79427	289a1c9c-4cd3-4b79-9938-a4c75110df77
24	24	0	Plazi	ffb07bec-2d10-492d-9c37-361fe0b79427	2d9cc532-dbf4-46f5-b134-4d8fa2f93663
241	241	0	Ocean Biodiversity Information System	ba0670b9-4186-41e6-8e70-f9cb3065551a	2f2b607d-762d-4318-8a52-5e42507171c9
9	9	0	Plazi	ffb07bec-2d10-492d-9c37-361fe0b79427	2f42c219-e456-4e6c-97b2-3ca9bfded43d
0	1	1	Ocean Biodiversity Information System	ba0670b9-4186-41e6-8e70-f9cb3065551a	3093ad93-ba3b-4716-b1f4-f3ec63f09a53
0	1	1	Plazi	ffb07bec-2d10-492d-9c37-361fe0b79427	30c2369a-9306-4504-b02e-1040172cf041
0	13424	13424	Canada Biodiversity Information Facility	8f83fc96-c966-4126-83f7-bf044dc49efa	30f020da-bda8-417d-a1e2-b067b849dea8
21809	21809	0	National Biodiversity Network	d897a5b9-35ee-4232-94bd-b0bcaac003c2	3163892f-7c3b-4c92-98b1-e69203418a20
9	9	0	Plazi	ffb07bec-2d10-492d-9c37-361fe0b79427	3231094c-11d4-45f5-be56-c78d5294dca6
39	39	0	Participant Node Managers Committee	7f48e0c8-5c96-49ec-b972-30748e339115	356b14b5-6f62-4500-9f1d-76104094aab4
2	2	0	Plazi	ffb07bec-2d10-492d-9c37-361fe0b79427	36cde03c-58c3-4695-971e-9d6037837a14
56339	56339	0	GBIF France	da44cd31-5901-4687-a106-6d1c7734ee3a	36d9b785-0739-4ce9-82e7-cf5001c20104
0	12	12	Plazi	ffb07bec-2d10-492d-9c37-361fe0b79427	37781dcd-ffff-4c1e-9483-fb726b42b440
0	9	9	Plazi	ffb07bec-2d10-492d-9c37-361fe0b79427	3ab85c94-9a87-4a81-b3a9-dae2e2465e1a
1	1	0	Plazi	ffb07bec-2d10-492d-9c37-361fe0b79427	3b34d02b-00c8-4856-ae60-fc09530c4bab
39	39	0	GBIF France	da44cd31-5901-4687-a106-6d1c7734ee3a	3b74ac9f-b90b-4113-969f-a489a5aa11fc
583	583	0	Biodiversity Information System of Mexico	b324e8e9-9a4c-44fa-8f1a-7f39ea7ab576	3ce834a6-f29f-40ed-9d41-bc85d42cd35b
13568	13568	0	Indonesian Biodiversity Information Facility	2ebd91f6-f14f-4375-b525-c011a3774f03	3e0987c4-375f-4d68-b2ac-5e4e3a6d3d6d
0	1	1	Ocean Biodiversity Information System	ba0670b9-4186-41e6-8e70-f9cb3065551a	3ebb2e59-e627-43b6-9c49-3d1e9faf0ec7
8	8	0	Plazi	ffb07bec-2d10-492d-9c37-361fe0b79427	42bc67ae-807a-4969-bde8-efe7fccd484b
22	22	0	Colombian Biodiversity Information System	7e865cba-7c46-417b-ade5-97f2cf5b7be0	43460666-2eb6-4b2f-9819-0259534a32c3
6	6	0	Plazi	ffb07bec-2d10-492d-9c37-361fe0b79427	43c261ec-1a26-4137-af47-7f80da23d273
0	4	4	Plazi	ffb07bec-2d10-492d-9c37-361fe0b79427	440190e8-4b31-4860-b7e8-bf4d237c7ca2
0	2	2	Plazi	ffb07bec-2d10-492d-9c37-361fe0b79427	4633852c-4bb2-4ab1-b63e-4e73c8eeb031
5	5	0	Plazi	ffb07bec-2d10-492d-9c37-361fe0b79427	48e6fe2c-28f4-4949-bb0b-bb1fad428fc8
3	3	0	Plazi	ffb07bec-2d10-492d-9c37-361fe0b79427	48ffa365-3fb6-4380-94e2-756bc7a95493
94	94	0	Plazi	ffb07bec-2d10-492d-9c37-361fe0b79427	4d265a70-8c63-49bb-8b30-bac7d2f060fc
380	380	0	GBIF Brazil	cdc9736d-5ff7-4ece-9959-3c744360cdb3	50992882-c7b7-419e-ac49-e2d4cbe40e6a
310	310	0	GBIF France	da44cd31-5901-4687-a106-6d1c7734ee3a	513c9fbd-73b5-4b2c-b4e7-21043e948f79
10	10	0	Plazi	ffb07bec-2d10-492d-9c37-361fe0b79427	53367972-ec48-46d0-a688-09ab9e4ce5f7
22	22	0	Plazi	ffb07bec-2d10-492d-9c37-361fe0b79427	5397a3ac-ffb7-408e-ab5b-50be49c2331d
2	2	0	GBIF France	da44cd31-5901-4687-a106-6d1c7734ee3a	5430e862-de07-4227-a27c-1db39dd924a3
0	2	2	Ocean Biodiversity Information System	ba0670b9-4186-41e6-8e70-f9cb3065551a	55d98bef-ab71-493e-98a4-121f7d350a37
0	3	3	Plazi	ffb07bec-2d10-492d-9c37-361fe0b79427	56e78c14-d8e8-47bd-b7fd-4030da7f86e0
1713	1713	0	GBIF France	da44cd31-5901-4687-a106-6d1c7734ee3a	5889bb53-efcf-42a6-81ba-624d127a76c2
0	24	24	Ocean Biodiversity Information System	ba0670b9-4186-41e6-8e70-f9cb3065551a	5ab2268f-664c-4518-b8a1-12fe1128c34d
0	15	15	Plazi	ffb07bec-2d10-492d-9c37-361fe0b79427	5c509a2b-ded3-4709-a1fc-b668c6bba7b6
0	95	95	Plazi	ffb07bec-2d10-492d-9c37-361fe0b79427	5c5c8aad-73f1-4a26-bdca-d1d02ba3fec1
550243	557718	7475	Atlas of Living Australia	4a6f1b71-969e-4fc5-a693-282b05e1220c	5d7f5915-0561-4107-aa20-20a4267c203f
0	1	1	Ocean Biodiversity Information System	ba0670b9-4186-41e6-8e70-f9cb3065551a	6110c3fc-991e-42a4-9a77-217121c8aede
155	155	0	GBIF Germany	4f6826f2-4ff6-443d-b966-e6913bd24013	6158f5c2-f762-11e1-a439-00145eb45e9a
797	797	0	National Biodiversity Network	d897a5b9-35ee-4232-94bd-b0bcaac003c2	61935e6b-ff4c-426d-80dd-973b76889ef3
112	112	0	GBIF Germany	4f6826f2-4ff6-443d-b966-e6913bd24013	61afe076-f762-11e1-a439-00145eb45e9a
4	4	0	Plazi	ffb07bec-2d10-492d-9c37-361fe0b79427	62083208-4daf-4757-9d82-c9a7bf58f367
96	96	0	Plazi	ffb07bec-2d10-492d-9c37-361fe0b79427	627c5262-5f05-45f3-a88e-dd2cfeec5043
8633	8633	0	U.S. Geological Survey	8618c64a-93e0-4300-b546-7249e5148ed2	62f37aae-c69a-422f-ad23-32bd92454806
7	7	0	Plazi	ffb07bec-2d10-492d-9c37-361fe0b79427	633f5bfc-2533-4984-ae01-6d6d896656c2
110	110	0	GBIF Germany	4f6826f2-4ff6-443d-b966-e6913bd24013	662c369a-f762-11e1-a439-00145eb45e9a
39	39	0	GBIF Germany	4f6826f2-4ff6-443d-b966-e6913bd24013	67799696-f762-11e1-a439-00145eb45e9a
105	105	0	GBIF Germany	4f6826f2-4ff6-443d-b966-e6913bd24013	680eaf10-f762-11e1-a439-00145eb45e9a
64	64	0	U.S. Geological Survey	8618c64a-93e0-4300-b546-7249e5148ed2	6814e124-bb30-45c3-928e-c00985d27e4d
0	1	1	Plazi	ffb07bec-2d10-492d-9c37-361fe0b79427	685b49cb-9812-445d-842d-c5566f2de2cb
7	7	0	GBIF Germany	4f6826f2-4ff6-443d-b966-e6913bd24013	68e97ea6-f762-11e1-a439-00145eb45e9a
17	17	0	GBIF Germany	4f6826f2-4ff6-443d-b966-e6913bd24013	6925feee-f762-11e1-a439-00145eb45e9a
570	570	0	Participant Node Managers Committee	7f48e0c8-5c96-49ec-b972-30748e339115	6944b893-6194-4bb6-b2bf-7dc3600cd3ef
16	16	0	GBIF Germany	4f6826f2-4ff6-443d-b966-e6913bd24013	6b05840a-f762-11e1-a439-00145eb45e9a
0	9454	9454	Ocean Biodiversity Information System	ba0670b9-4186-41e6-8e70-f9cb3065551a	6b33d7c4-d66b-4856-8297-117477639c3e
0	50	50	Ocean Biodiversity Information System	ba0670b9-4186-41e6-8e70-f9cb3065551a	6da9153e-aa1b-403f-915e-531f0afe0243
0	7	7	Plazi	ffb07bec-2d10-492d-9c37-361fe0b79427	6db5a7ca-bafb-40ba-89a1-350157ffb16f
2520	2520	0	GBIF Germany	4f6826f2-4ff6-443d-b966-e6913bd24013	6e525e30-f762-11e1-a439-00145eb45e9a
585	585	0	Atlas of Living Australia	4a6f1b71-969e-4fc5-a693-282b05e1220c	6f19bb5e-ef43-492e-af23-608f2d84e064
173	173	0	Plazi	ffb07bec-2d10-492d-9c37-361fe0b79427	6f31cc43-ebda-47d9-8925-baeb959ab570
9146	9146	0	National Biodiversity Network	d897a5b9-35ee-4232-94bd-b0bcaac003c2	6f6b1102-5baa-4e24-86be-073a90b14db0
72170	84583	12413	GBIF Germany	4f6826f2-4ff6-443d-b966-e6913bd24013	70906b9c-9594-42e4-84fb-8cf0ee66d22f
382	382	0	GBIF Germany	4f6826f2-4ff6-443d-b966-e6913bd24013	70a6403e-f762-11e1-a439-00145eb45e9a
0	16	16	Plazi	ffb07bec-2d10-492d-9c37-361fe0b79427	70c4854f-ccdf-48ca-96f1-01aa9d094b9e
108	108	0	Participant Node Managers Committee	7f48e0c8-5c96-49ec-b972-30748e339115	71028ffa-8880-41e1-8d66-5b595b92ef68
62	62	0	GBIF Germany	4f6826f2-4ff6-443d-b966-e6913bd24013	720a7ed6-f762-11e1-a439-00145eb45e9a
1218	1218	0	GBIF Germany	4f6826f2-4ff6-443d-b966-e6913bd24013	721e32aa-f762-11e1-a439-00145eb45e9a
307	307	0	GBIF Germany	4f6826f2-4ff6-443d-b966-e6913bd24013	7324eefa-f762-11e1-a439-00145eb45e9a
6	6	0	GBIF Germany	4f6826f2-4ff6-443d-b966-e6913bd24013	739e0d8a-f762-11e1-a439-00145eb45e9a
2522	2522	0	GBIF France	da44cd31-5901-4687-a106-6d1c7734ee3a	73a7ba69-d4f9-4df8-aab5-67e9183c2e16
134	134	0	GBIF Germany	4f6826f2-4ff6-443d-b966-e6913bd24013	73b6c726-f762-11e1-a439-00145eb45e9a
14	14	0	GBIF Germany	4f6826f2-4ff6-443d-b966-e6913bd24013	74a94fb4-f762-11e1-a439-00145eb45e9a
1	1	0	GBIF Germany	4f6826f2-4ff6-443d-b966-e6913bd24013	758478a0-f762-11e1-a439-00145eb45e9a
331	331	0	GBIF Germany	4f6826f2-4ff6-443d-b966-e6913bd24013	75a39f96-f762-11e1-a439-00145eb45e9a
21	21	0	Plazi	ffb07bec-2d10-492d-9c37-361fe0b79427	7bdbb02c-ce5d-4df5-846a-b45c54fedc5a
360	360	0	GBIF Germany	4f6826f2-4ff6-443d-b966-e6913bd24013	7d8a9d0e-f762-11e1-a439-00145eb45e9a
1584	836	-748	GBIF Germany	4f6826f2-4ff6-443d-b966-e6913bd24013	7d8bd9a8-f762-11e1-a439-00145eb45e9a
10149	10149	0	Polish Biodiversity Information Network	2618bfdf-e194-4911-a241-80db3107bc51	7f318210-2fe9-11de-816f-b8a03c50a862
9454	9454	0	GBIF Germany	4f6826f2-4ff6-443d-b966-e6913bd24013	7f537a16-f762-11e1-a439-00145eb45e9a
2723	29	-2694	Biodiversity Information System of Mexico	b324e8e9-9a4c-44fa-8f1a-7f39ea7ab576	8009aa7a-f762-11e1-a439-00145eb45e9a
2	2	0	GBIF Japan	db5705aa-6a6e-42f1-8942-d77b9f4896ea	80e7e75e-f762-11e1-a439-00145eb45e9a
64	64	0	GBIF Japan	db5705aa-6a6e-42f1-8942-d77b9f4896ea	80f76404-f762-11e1-a439-00145eb45e9a
3	3	0	GBIF Japan	db5705aa-6a6e-42f1-8942-d77b9f4896ea	80ffda76-f762-11e1-a439-00145eb45e9a
1007	1007	0	GBIF Germany	4f6826f2-4ff6-443d-b966-e6913bd24013	814b4c18-f762-11e1-a439-00145eb45e9a
1622	1673	51	GBIF Germany	4f6826f2-4ff6-443d-b966-e6913bd24013	819ee7ba-f762-11e1-a439-00145eb45e9a
243	221	-22	GBIF Germany	4f6826f2-4ff6-443d-b966-e6913bd24013	8247eb12-f762-11e1-a439-00145eb45e9a
249130	249087	-43	National Biodiversity Network	d897a5b9-35ee-4232-94bd-b0bcaac003c2	8359171b-9432-421e-88fc-56a55f1c098c
101428	101503	75	Canada Biodiversity Information Facility	8f83fc96-c966-4126-83f7-bf044dc49efa	848586a4-a07b-4974-9f12-e1bbe0736a21
33	33	0	Plazi	ffb07bec-2d10-492d-9c37-361fe0b79427	84b9fbbc-4074-49bb-a056-34cb73a3e796
25	25	0	GBIF Niger	dc9041d6-a5ae-4217-92ea-f7674794d760	8ac24ec8-1e7b-40a9-a5b4-c8e3037a3431
163	163	0	GBIF Germany	4f6826f2-4ff6-443d-b966-e6913bd24013	8c2524ba-f762-11e1-a439-00145eb45e9a
0	5868	5868	DanBIF - Danish Biodiversity Information Facility	4ddd294f-02b7-4359-ac33-0806a9ca9c6b	8c834f97-c5df-4280-9623-86594979f91a
2	1	-1	GBIF Germany	4f6826f2-4ff6-443d-b966-e6913bd24013	8c86858e-f762-11e1-a439-00145eb45e9a
12	9	-3	GBIF Germany	4f6826f2-4ff6-443d-b966-e6913bd24013	8cfca6ba-f762-11e1-a439-00145eb45e9a
378	378	0	GBIF Germany	4f6826f2-4ff6-443d-b966-e6913bd24013	8d6fef62-f762-11e1-a439-00145eb45e9a
46	26	-20	GBIF Germany	4f6826f2-4ff6-443d-b966-e6913bd24013	8e420aba-f762-11e1-a439-00145eb45e9a
158	87	-71	GBIF Germany	4f6826f2-4ff6-443d-b966-e6913bd24013	8ea466c4-f762-11e1-a439-00145eb45e9a
12	9	-3	GBIF Germany	4f6826f2-4ff6-443d-b966-e6913bd24013	8eedafa0-f762-11e1-a439-00145eb45e9a
15	15	0	GBIF Brazil	cdc9736d-5ff7-4ece-9959-3c744360cdb3	8f845854-616a-46b7-8bca-34d0382915a5
0	697	697	GBIF Uruguay	a3ceb6dd-0a65-4f30-a385-30f6937c2096	8f84e304-9f33-4e4d-becc-f178154fd2ff
1	1	0	Plazi	ffb07bec-2d10-492d-9c37-361fe0b79427	8fe13dc7-414d-40bd-8087-e88cdff35ae7
305	305	0	Participant Node Managers Committee	7f48e0c8-5c96-49ec-b972-30748e339115	9013d641-a7e7-47b4-8d07-07ac9237ec99
198	182	-16	GBIF Germany	4f6826f2-4ff6-443d-b966-e6913bd24013	9168c2e2-f762-11e1-a439-00145eb45e9a
125	104	-21	GBIF Germany	4f6826f2-4ff6-443d-b966-e6913bd24013	917bb848-f762-11e1-a439-00145eb45e9a
250	250	0	GBIF Germany	4f6826f2-4ff6-443d-b966-e6913bd24013	93a292f4-f762-11e1-a439-00145eb45e9a
405	405	0	GBIF Germany	4f6826f2-4ff6-443d-b966-e6913bd24013	958d9faa-f762-11e1-a439-00145eb45e9a
56	56	0	GBIF Germany	4f6826f2-4ff6-443d-b966-e6913bd24013	959654c4-f762-11e1-a439-00145eb45e9a
214	214	0	GBIF Germany	4f6826f2-4ff6-443d-b966-e6913bd24013	959c0680-f762-11e1-a439-00145eb45e9a
3	3	0	Participant Node Managers Committee	7f48e0c8-5c96-49ec-b972-30748e339115	95cb15d4-adca-45b2-90dc-9950e5458d29
1	1	0	Plazi	ffb07bec-2d10-492d-9c37-361fe0b79427	967d8db9-3d1d-4c2d-89df-86d85afc6f88
270806	270806	0	Bioversity International	b8a5be24-9225-4ba5-b664-159308a4b537	96867b98-f762-11e1-a439-00145eb45e9a
0	4	4	Plazi	ffb07bec-2d10-492d-9c37-361fe0b79427	9701ad89-9445-42dd-a0f3-7876ff2c35e2
1	1	0	Plazi	ffb07bec-2d10-492d-9c37-361fe0b79427	973fc06c-9ee3-425d-bb8a-b3368fb81ba2
686	686	0	Atlas of Living Australia	4a6f1b71-969e-4fc5-a693-282b05e1220c	9cc2cbfc-1002-4d0d-b262-cc3c5b268757
13	13	0	Plazi	ffb07bec-2d10-492d-9c37-361fe0b79427	9e8ab3b3-05cc-4b41-9e9d-b3047bfc71ed
0	83	83	Plazi	ffb07bec-2d10-492d-9c37-361fe0b79427	a0bda143-0bc2-4e94-bbe6-f7bef8b5daee
89154	89154	0	GBIF France	da44cd31-5901-4687-a106-6d1c7734ee3a	a1b96bad-8ef6-4fcb-9653-fb74535a97e4
284	284	0	GBIF Germany	4f6826f2-4ff6-443d-b966-e6913bd24013	a5090dc4-1ac6-44af-babb-d77656132f56
3788	3788	0	GBIF Norway	4f829580-180d-46a9-9c87-ed8ec959b545	a5a68903-ae86-40d6-8c65-8e18127eddad
0	10	10	Plazi	ffb07bec-2d10-492d-9c37-361fe0b79427	a6705bd1-f344-40ce-a77a-2d2c4fa2f344
1132	1132	0	GBIF France	da44cd31-5901-4687-a106-6d1c7734ee3a	ab959114-4edf-40e4-a9d9-4b894235d7bc
2304	2304	0	Secretariat of the Pacific Regional Environment Programme	29c6a139-ea7f-41f5-8d9b-c55af8736182	ace06158-d785-405a-8f2e-dcdf38256972
0	3	3	Plazi	ffb07bec-2d10-492d-9c37-361fe0b79427	ad3ba6bd-eb0a-4334-ad02-3e0da79555b1
0	65	65	Ocean Biodiversity Information System	ba0670b9-4186-41e6-8e70-f9cb3065551a	adac650b-b2f8-4909-b134-d389117a66ba
0	2	2	Plazi	ffb07bec-2d10-492d-9c37-361fe0b79427	b0034b11-ab13-44da-8e39-de811b7b6a5a
122	122	0	GBIF France	da44cd31-5901-4687-a106-6d1c7734ee3a	b0a58a54-2c2b-4fad-8465-68e6b4f40af6
0	200	200	Ocean Biodiversity Information System	ba0670b9-4186-41e6-8e70-f9cb3065551a	b2323a05-0e60-4916-8940-0c146dad2b08
0	8	8	Plazi	ffb07bec-2d10-492d-9c37-361fe0b79427	b9f36fb1-1c9d-4af8-96ca-d57973b94862
17	17	0	Plazi	ffb07bec-2d10-492d-9c37-361fe0b79427	ba4d8b5b-a019-4f7b-a8df-af225074fef4
1574	1574	0	Atlas of Living Australia	4a6f1b71-969e-4fc5-a693-282b05e1220c	bed01630-5697-4965-94b1-e1d1ebdcbec9
0	708	708	Ocean Biodiversity Information System	ba0670b9-4186-41e6-8e70-f9cb3065551a	c1d556df-be28-49c0-8c56-fb78ff2ce986
0	440	440	Korean Biodiversity Information Facility	e0a1e772-0177-4800-94b4-2d023fe6cdf4	c35d9a99-9a4b-44e7-8c92-7b5fe302318b
219	219	0	GBIF France	da44cd31-5901-4687-a106-6d1c7734ee3a	c424b110-bc4d-43aa-980e-66cc853e6293
0	325	325	Ocean Biodiversity Information System	ba0670b9-4186-41e6-8e70-f9cb3065551a	c833d601-a90b-4061-b82c-36a217d7e10f
18	18	0	Plazi	ffb07bec-2d10-492d-9c37-361fe0b79427	c8e7a489-a454-48da-86c1-5f6a20f98470
0	1	1	Plazi	ffb07bec-2d10-492d-9c37-361fe0b79427	ce1dcc69-0ee4-4db2-9940-362ee904bde6
0	14	14	Plazi	ffb07bec-2d10-492d-9c37-361fe0b79427	d0fb5ad0-7ce0-4b99-813b-a31aa97a7f93
3	3	0	Plazi	ffb07bec-2d10-492d-9c37-361fe0b79427	d122bdb5-bbca-4853-8e6a-d5dab5b500d6
363	363	0	Colombian Biodiversity Information System	7e865cba-7c46-417b-ade5-97f2cf5b7be0	d388a696-b1f4-4515-a88e-6819f2ea75cc
10000	10000	0	GBIF Benin	efb9c00e-f802-45dd-8826-a52ec45b89ff	d3c8efbc-e246-4e52-b2d5-6fdae499b48b
67	67	0	Plazi	ffb07bec-2d10-492d-9c37-361fe0b79427	d778efa2-ac30-40a6-a187-0628be24c6d0
12	12	0	Plazi	ffb07bec-2d10-492d-9c37-361fe0b79427	da7297f9-6044-4fc4-a014-31741f6d8a0c
3446	3446	0	Plazi	ffb07bec-2d10-492d-9c37-361fe0b79427	db6a16a6-0fe8-4987-8ad5-42223825fcd7
3	3	0	Plazi	ffb07bec-2d10-492d-9c37-361fe0b79427	dcc54c42-6834-4a88-94b0-597505d28cee
1386	1386	0	National Biodiversity Network	d897a5b9-35ee-4232-94bd-b0bcaac003c2	ddbafedd-9649-4b6c-a88d-145f45ac8e1c
15	15	0	Plazi	ffb07bec-2d10-492d-9c37-361fe0b79427	de04a77c-45df-45f6-a802-a2acecd3e64f
2890	3331	441	GBIF Germany	4f6826f2-4ff6-443d-b966-e6913bd24013	e1beb83c-9b83-4d17-ac5e-d24e09507ec5
107	107	0	GBIF France	da44cd31-5901-4687-a106-6d1c7734ee3a	e332fe29-3688-4d98-b9cd-04b138028a25
1	1	0	Plazi	ffb07bec-2d10-492d-9c37-361fe0b79427	e36b4df2-d40d-4499-9bc1-2ab0f1576e95
12	12	0	Plazi	ffb07bec-2d10-492d-9c37-361fe0b79427	e3c8fdb6-8f18-470c-8f72-43bcf2effe2a
0	1	1	Plazi	ffb07bec-2d10-492d-9c37-361fe0b79427	e428ce02-b8b2-493e-b358-c6d0855f8db1
14	14	0	Plazi	ffb07bec-2d10-492d-9c37-361fe0b79427	e8ba8a68-c584-48d8-bfba-f4d2fd163e97
0	94	94	Participant Node Managers Committee	7f48e0c8-5c96-49ec-b972-30748e339115	eaebe1ac-c77d-4c6c-8fba-15533780cfef
7	7	0	Plazi	ffb07bec-2d10-492d-9c37-361fe0b79427	ec6caea8-97cc-4063-9510-26bb0612717e
91	91	0	Plazi	ffb07bec-2d10-492d-9c37-361fe0b79427	eea175bc-3caf-4a9b-8341-5029cbeb036e
8384	8384	0	National Biodiversity Network	d897a5b9-35ee-4232-94bd-b0bcaac003c2	ef78e7a8-4d9d-4675-a8fd-6fe063ddf2b2
2	2	0	Plazi	ffb07bec-2d10-492d-9c37-361fe0b79427	f324a471-6180-4bc0-9dcd-b9c2a3b07ca6
46	46	0	Biodiversity Information System of Mexico	b324e8e9-9a4c-44fa-8f1a-7f39ea7ab576	f3d57cfe-96b7-4d45-9009-d97088a78dfa
67	67	0	Plazi	ffb07bec-2d10-492d-9c37-361fe0b79427	f65a4cdd-fdc0-4a96-890f-d02ea4305d8e
10	10	0	Plazi	ffb07bec-2d10-492d-9c37-361fe0b79427	f82fd4e4-fc53-40eb-8644-83bc51c9417d
16839	16839	0	GBIF Argentina	2426a871-9feb-40a1-96c6-0c593a76b835	f9278128-1c7b-4881-97ea-6968b51e585f
511	511	0	Colombian Biodiversity Information System	7e865cba-7c46-417b-ade5-97f2cf5b7be0	fbb1a36b-20a9-484b-b78b-d5ff2161225d
1392	1392	0	Colombian Biodiversity Information System	7e865cba-7c46-417b-ade5-97f2cf5b7be0	fbff4768-8f4a-4d48-a821-5b4b491b2275
0	1	1	Ocean Biodiversity Information System	ba0670b9-4186-41e6-8e70-f9cb3065551a	fc2d749b-3087-48f7-9f3d-c4935065faed
43	43	0	Chinese Academy of Sciences	e760dc6f-dd68-474d-ab41-bd3588571793	fe6d1c27-5284-402f-a57a-55727ee3f981
57804	57804	0	Ocean Biodiversity Information System	ba0670b9-4186-41e6-8e70-f9cb3065551a	ff0d8744-9e2e-44ac-8a83-5976f579a87e
0	1	1	Plazi	ffb07bec-2d10-492d-9c37-361fe0b79427	ff3cc274-802b-4fb4-a2fe-34e06944229f
771	771	0	GBIF Brazil	cdc9736d-5ff7-4ece-9959-3c744360cdb3	01c0aa6b-a14a-474d-b455-701ce718375f
0	3	3	Plazi	ffb07bec-2d10-492d-9c37-361fe0b79427	068e9cb6-2b65-4792-8eb9-af57650c7b65
3399	3399	0	GBIF Spain	1f94b3ca-9345-4d65-afe2-4bace93aa0fe	07f0789f-c777-4c99-acb3-815c78c7db81
4164	4164	0	National Biodiversity Data Centre	422b00b2-6c94-4bb6-976b-c359916efdb8	0957a821-ac00-47de-93a8-87a8492d1a81
60	60	0	GBIF Brazil	cdc9736d-5ff7-4ece-9959-3c744360cdb3	0a44189f-8812-4b44-9786-92252b9545c5
124922	124922	0	National Biodiversity Network	d897a5b9-35ee-4232-94bd-b0bcaac003c2	0c0a11dd-cde0-4d25-b80b-d838bec3b559
26571	26571	0	GBIF Norway	4f829580-180d-46a9-9c87-ed8ec959b545	0ce32496-2305-4bac-a6b5-efa972aff14d
1	1	0	Plazi	ffb07bec-2d10-492d-9c37-361fe0b79427	0f39d08a-7275-4b35-9b34-0fb067a72c79
1929	1929	0	GBIF France	da44cd31-5901-4687-a106-6d1c7734ee3a	0f3b3db3-2fb4-46b2-aabf-939410026846
57	57	0	GBIF France	da44cd31-5901-4687-a106-6d1c7734ee3a	115ef17a-35bc-4e2f-81db-ae87da3a7049
0	14	14	Plazi	ffb07bec-2d10-492d-9c37-361fe0b79427	124de75c-aefc-4f0a-b532-da900f197b82
154	154	0	GBIF Germany	4f6826f2-4ff6-443d-b966-e6913bd24013	14e83b74-6928-4b00-b2ed-5875eaf2e165
444	444	0	Biodiversity Information System of Mexico	b324e8e9-9a4c-44fa-8f1a-7f39ea7ab576	206309ac-ce96-44ab-ad46-34dee3ef9971
0	4	4	Plazi	ffb07bec-2d10-492d-9c37-361fe0b79427	24876727-bea9-48bf-85e6-cfa61217790a
103310	103310	0	Chinese Academy of Sciences	e760dc6f-dd68-474d-ab41-bd3588571793	249ec6d9-ce13-4096-baf5-42130fc3d0b1
0	27	27	Participant Node Managers Committee	7f48e0c8-5c96-49ec-b972-30748e339115	24daaeb4-fc52-4088-b73f-1c145723290a
24	24	0	U.S. Geological Survey	8618c64a-93e0-4300-b546-7249e5148ed2	2528d225-e8dd-485d-9673-2be1cc3d9a3b
4	4	0	Plazi	ffb07bec-2d10-492d-9c37-361fe0b79427	28ad39d0-85aa-4df7-93bb-57c6e1cc3f31
1270	1270	0	GBIF Portugal	673f7038-4262-4149-b753-5658a4e912f6	2da596ae-e424-430a-83fc-da084090e329
0	26	26	Ocean Biodiversity Information System	ba0670b9-4186-41e6-8e70-f9cb3065551a	2dfe7e9e-bc3a-49f6-b0ee-15a64b0388f8
3	3	0	Plazi	ffb07bec-2d10-492d-9c37-361fe0b79427	2ea477f5-1176-4a39-b7be-0bc9a124282b
0	389	389	Ocean Biodiversity Information System	ba0670b9-4186-41e6-8e70-f9cb3065551a	2f42a349-b40e-4168-860a-35e5f7cf543f
2879	2879	0	U.S. Geological Survey	8618c64a-93e0-4300-b546-7249e5148ed2	2ff00ea3-8fa2-41bf-9bf0-273ed628c1d8
85	85	0	Plazi	ffb07bec-2d10-492d-9c37-361fe0b79427	3169a7bc-1a16-427d-9696-ae9c89da1dc9
8	8	0	Plazi	ffb07bec-2d10-492d-9c37-361fe0b79427	32762543-5a91-4e90-890a-c4a3451e5a91
10	10	0	Participant Node Managers Committee	7f48e0c8-5c96-49ec-b972-30748e339115	3351689c-5ca3-4def-a9a8-c593f6a9fbf1
6	6	0	Plazi	ffb07bec-2d10-492d-9c37-361fe0b79427	33e106cc-ce9e-4961-a008-618db6baa57f
325	325	0	GBIF Norway	4f829580-180d-46a9-9c87-ed8ec959b545	381802fd-f387-4d3e-a4d4-de13d5cdb3fa
158	158	0	Colombian Biodiversity Information System	7e865cba-7c46-417b-ade5-97f2cf5b7be0	38250edd-62ed-4fa0-9821-f1aa08c8fa23
0	50	50	Plazi	ffb07bec-2d10-492d-9c37-361fe0b79427	38255d4a-0223-4819-9a6c-cf3e93c57446
40	40	0	Plazi	ffb07bec-2d10-492d-9c37-361fe0b79427	38667836-972c-40f0-b78c-7b621c00b23b
0	82170	82170	GBIF Portugal	673f7038-4262-4149-b753-5658a4e912f6	38cf4018-9fc8-4f6d-b3c5-672fa8bcf705
87	87	0	GBIF France	da44cd31-5901-4687-a106-6d1c7734ee3a	39596485-2411-4a16-bdf2-ae2ab9d30bac
5366	5366	0	National Biodiversity Network	d897a5b9-35ee-4232-94bd-b0bcaac003c2	3a1bf23b-9951-4e6a-bade-5383e1ba6efe
38328	38328	0	National Biodiversity Network	d897a5b9-35ee-4232-94bd-b0bcaac003c2	3b69071b-11c6-4c73-a80a-f0f003b2b136
0	3	3	Plazi	ffb07bec-2d10-492d-9c37-361fe0b79427	3cf2c6ad-4274-4301-9cd0-e8295eace8cc
84	84	0	Colombian Biodiversity Information System	7e865cba-7c46-417b-ade5-97f2cf5b7be0	3dd1a517-73a9-40db-ae9e-b0e8ad342a22
1916	1916	0	Colombian Biodiversity Information System	7e865cba-7c46-417b-ade5-97f2cf5b7be0	3e692f0a-885e-4e5b-b080-36f658978252
0	34	34	Participant Node Managers Committee	7f48e0c8-5c96-49ec-b972-30748e339115	3f660546-1f6c-4361-a001-2c412af8ce9a
42	42	0	GBIF Germany	4f6826f2-4ff6-443d-b966-e6913bd24013	439ae544-3a0c-11e2-b0ce-00145eb45e9a
2	2	0	Plazi	ffb07bec-2d10-492d-9c37-361fe0b79427	44dfd6d5-4638-4164-bfb2-9c6fda53a218
364	364	0	GBIF Finland	dd514216-5c7c-45f3-910d-797424cb5be6	44f32d6c-0354-471d-b17e-4ec84834e2f1
120	120	0	National Biodiversity Network	d897a5b9-35ee-4232-94bd-b0bcaac003c2	4537f6d0-0302-4606-a893-c8dfaac4fa2a
0	33	33	Plazi	ffb07bec-2d10-492d-9c37-361fe0b79427	465ec37f-0f93-4137-932f-15e7d1b4b068
0	3	3	Ocean Biodiversity Information System	ba0670b9-4186-41e6-8e70-f9cb3065551a	475a0ca6-9c74-458c-9526-1a1cd0b925f8
6	6	0	Plazi	ffb07bec-2d10-492d-9c37-361fe0b79427	4831eaf2-dc6a-4e51-9c01-6b47019bb10a
2954	2954	0	GBIF Switzerland	169eb292-376b-4cc6-8e31-9c2c432de0ad	4b0ccaf3-36eb-4dc8-acba-6d08fb9004bb
18	18	0	Plazi	ffb07bec-2d10-492d-9c37-361fe0b79427	4e8bb819-6395-47d3-8a57-5857c9ff572f
8	8	0	Plazi	ffb07bec-2d10-492d-9c37-361fe0b79427	4ed337be-e700-480f-8710-8c4b0e89dc38
757	757	0	Colombian Biodiversity Information System	7e865cba-7c46-417b-ade5-97f2cf5b7be0	4ffe09c6-5647-4fe5-b1ed-af4b07be47a6
638	638	0	Participant Node Managers Committee	7f48e0c8-5c96-49ec-b972-30748e339115	50320846-bf5b-4e62-a5ff-17687f448089
0	7	7	Plazi	ffb07bec-2d10-492d-9c37-361fe0b79427	52b81c8e-2811-4679-b91b-1bce680407bd
9717	9717	0	National Biodiversity Network	d897a5b9-35ee-4232-94bd-b0bcaac003c2	52e809ec-8487-4e88-8c8d-1c7c14cf11c2
0	1	1	Plazi	ffb07bec-2d10-492d-9c37-361fe0b79427	54aed228-e8e6-4fd5-83dc-7cc59d609557
0	70	70	Ocean Biodiversity Information System	ba0670b9-4186-41e6-8e70-f9cb3065551a	55389a34-11fb-4d59-ab50-4796b5120430
5	5	0	Plazi	ffb07bec-2d10-492d-9c37-361fe0b79427	55ab23c4-7dda-4341-99ad-421971142dd6
0	19	19	Plazi	ffb07bec-2d10-492d-9c37-361fe0b79427	58a6feaf-7414-4224-8016-7d9017f944c1
0	9	9	Plazi	ffb07bec-2d10-492d-9c37-361fe0b79427	58cf5eca-ad81-4c3d-97a3-c6b17ee9137b
12	12	0	Plazi	ffb07bec-2d10-492d-9c37-361fe0b79427	59118ade-2ef2-4996-b7e5-9a18245e3c3c
0	20	20	Ocean Biodiversity Information System	ba0670b9-4186-41e6-8e70-f9cb3065551a	5b5493f2-4997-4329-8f7c-97490c0a985c
0	269	269	Colombian Biodiversity Information System	7e865cba-7c46-417b-ade5-97f2cf5b7be0	5cdd10e2-daca-45db-b683-b9740634fd6b
0	2	2	Ocean Biodiversity Information System	ba0670b9-4186-41e6-8e70-f9cb3065551a	5e9ed984-e54f-49a8-84c6-b48300d5ab51
11	11	0	Plazi	ffb07bec-2d10-492d-9c37-361fe0b79427	60d1bc89-5afc-4f3f-91c4-9b1c6da3f778
113	113	0	GBIF Germany	4f6826f2-4ff6-443d-b966-e6913bd24013	61b46c9a-f762-11e1-a439-00145eb45e9a
0	7	7	Plazi	ffb07bec-2d10-492d-9c37-361fe0b79427	63b712a3-371b-4931-8a89-c90499f8c7a8
24	24	0	GBIF Germany	4f6826f2-4ff6-443d-b966-e6913bd24013	64920c10-f762-11e1-a439-00145eb45e9a
8	6	-2	GBIF Germany	4f6826f2-4ff6-443d-b966-e6913bd24013	65b2648c-f762-11e1-a439-00145eb45e9a
93	93	0	GBIF Germany	4f6826f2-4ff6-443d-b966-e6913bd24013	6695a36e-f762-11e1-a439-00145eb45e9a
53	53	0	GBIF Germany	4f6826f2-4ff6-443d-b966-e6913bd24013	68184a16-f762-11e1-a439-00145eb45e9a
5	5	0	GBIF Germany	4f6826f2-4ff6-443d-b966-e6913bd24013	68c7222a-f762-11e1-a439-00145eb45e9a
0	30	30	Ocean Biodiversity Information System	ba0670b9-4186-41e6-8e70-f9cb3065551a	6a9cacbf-52cf-4a14-8ec9-8c0e2608d54f
4	4	0	GBIF Germany	4f6826f2-4ff6-443d-b966-e6913bd24013	6aca11f4-f762-11e1-a439-00145eb45e9a
8	8	0	GBIF Germany	4f6826f2-4ff6-443d-b966-e6913bd24013	6acf5d9e-f762-11e1-a439-00145eb45e9a
16	16	0	GBIF Germany	4f6826f2-4ff6-443d-b966-e6913bd24013	6c053f12-f762-11e1-a439-00145eb45e9a
0	515	515	Ocean Biodiversity Information System	ba0670b9-4186-41e6-8e70-f9cb3065551a	6d54f139-4b46-4e17-8f8d-ccc0e6394d48
150	150	0	GBIF Japan	db5705aa-6a6e-42f1-8942-d77b9f4896ea	6ffe6db1-ffe7-4d89-ab02-230fee59b3be
14018	14018	0	National Biodiversity Network	d897a5b9-35ee-4232-94bd-b0bcaac003c2	72db1440-8b28-43c0-9f39-c4cc1f592da1
599	599	0	GBIF Germany	4f6826f2-4ff6-443d-b966-e6913bd24013	74dce32e-f762-11e1-a439-00145eb45e9a
12118	12118	0	National Biodiversity Network	d897a5b9-35ee-4232-94bd-b0bcaac003c2	7585b2f0-0150-4409-985d-7b57832e3dca
208	208	0	Plazi	ffb07bec-2d10-492d-9c37-361fe0b79427	76fa7439-0e6f-4ebf-af0a-dad12f6ce35a
337	337	0	GBIF Germany	4f6826f2-4ff6-443d-b966-e6913bd24013	7746308e-f762-11e1-a439-00145eb45e9a
3227	4165	938	GBIF Finland	dd514216-5c7c-45f3-910d-797424cb5be6	7898cf5f-11e4-404c-87d2-1d5e3b3e0a18
13	13	0	GBIF Germany	4f6826f2-4ff6-443d-b966-e6913bd24013	78fc80f4-f762-11e1-a439-00145eb45e9a
168	168	0	GBIF Germany	4f6826f2-4ff6-443d-b966-e6913bd24013	7912ea9c-f762-11e1-a439-00145eb45e9a
776	776	0	GBIF France	da44cd31-5901-4687-a106-6d1c7734ee3a	7b362233-296a-4af4-9509-adb466e99bd1
138	138	0	Atlas of Living Australia	4a6f1b71-969e-4fc5-a693-282b05e1220c	7b702b2e-f762-11e1-a439-00145eb45e9a
0	48	48	Ocean Biodiversity Information System	ba0670b9-4186-41e6-8e70-f9cb3065551a	7c065e31-4eb2-4f15-aa16-2c6c9576628d
1441	1441	0	GBIF France	da44cd31-5901-4687-a106-6d1c7734ee3a	7c662bcf-830f-4ddc-b52b-ce4d6bfeeabf
783961	631179	-152782	Atlas of Living Australia	4a6f1b71-969e-4fc5-a693-282b05e1220c	7c93d290-6c8b-11de-8226-b8a03c50a862
94	94	0	GBIF Germany	4f6826f2-4ff6-443d-b966-e6913bd24013	7cefb74e-f762-11e1-a439-00145eb45e9a
3005	3005	0	Atlas of Living Australia	4a6f1b71-969e-4fc5-a693-282b05e1220c	7d36731e-f762-11e1-a439-00145eb45e9a
0	24	24	Plazi	ffb07bec-2d10-492d-9c37-361fe0b79427	7f01db51-02e7-49aa-adc5-191d90c14275
13899	13899	0	GBIF France	da44cd31-5901-4687-a106-6d1c7734ee3a	7f89b5f5-ce82-436b-9d27-ec9ba6540198
5	5	0	Plazi	ffb07bec-2d10-492d-9c37-361fe0b79427	814b5ea7-74f0-4c1f-b7bf-92f02ea07c1f
196	196	0	GBIF Germany	4f6826f2-4ff6-443d-b966-e6913bd24013	822953a0-f762-11e1-a439-00145eb45e9a
34	34	0	Plazi	ffb07bec-2d10-492d-9c37-361fe0b79427	822ba019-870c-4760-963c-22d6c50eff37
6	6	0	Plazi	ffb07bec-2d10-492d-9c37-361fe0b79427	82782a07-fc03-48a2-86ad-57f115d53d63
156	156	0	GBIF Germany	4f6826f2-4ff6-443d-b966-e6913bd24013	82c788c2-f762-11e1-a439-00145eb45e9a
10509	10509	0	U.S. Geological Survey	8618c64a-93e0-4300-b546-7249e5148ed2	82ceb6ba-f762-11e1-a439-00145eb45e9a
1082	1082	0	GBIF France	da44cd31-5901-4687-a106-6d1c7734ee3a	83687bf8-b312-4041-a4de-7c18056d963c
184	184	0	GBIF Norway	4f829580-180d-46a9-9c87-ed8ec959b545	841b568b-4ef6-456c-bee6-d780b06cd641
0	116024	116024	National Biodiversity Network	d897a5b9-35ee-4232-94bd-b0bcaac003c2	84f58d09-add5-469b-af6e-f3522a8dac7d
117	117	0	Plazi	ffb07bec-2d10-492d-9c37-361fe0b79427	8596c55f-62c4-4204-8cb6-3a44b0983a4c
0	3	3	Plazi	ffb07bec-2d10-492d-9c37-361fe0b79427	85bac109-2041-4a74-8b6b-088e82b0b899
6878	6878	0	GBIF France	da44cd31-5901-4687-a106-6d1c7734ee3a	867ccde2-77b6-423d-9bc7-b94566bb593b
525	380	-145	GBIF Germany	4f6826f2-4ff6-443d-b966-e6913bd24013	87d1fcbc-f762-11e1-a439-00145eb45e9a
68768	68768	0	Biodiversity Information System of Mexico	b324e8e9-9a4c-44fa-8f1a-7f39ea7ab576	88d47c48-f762-11e1-a439-00145eb45e9a
75	75	0	GBIF Germany	4f6826f2-4ff6-443d-b966-e6913bd24013	8a3db9d2-f762-11e1-a439-00145eb45e9a
80	80	0	GBIF Germany	4f6826f2-4ff6-443d-b966-e6913bd24013	8b911aa4-f762-11e1-a439-00145eb45e9a
52	40	-12	GBIF Germany	4f6826f2-4ff6-443d-b966-e6913bd24013	8c501724-f762-11e1-a439-00145eb45e9a
80	29	-51	GBIF Germany	4f6826f2-4ff6-443d-b966-e6913bd24013	8db59dbe-f762-11e1-a439-00145eb45e9a
224	224	0	GBIF Portugal	673f7038-4262-4149-b753-5658a4e912f6	8e7d5487-0308-472b-afd1-199a26fdad77
142	47	-95	GBIF Germany	4f6826f2-4ff6-443d-b966-e6913bd24013	8f167b9c-f762-11e1-a439-00145eb45e9a
79	54	-25	GBIF Germany	4f6826f2-4ff6-443d-b966-e6913bd24013	8ff21102-f762-11e1-a439-00145eb45e9a
94	40	-54	GBIF Germany	4f6826f2-4ff6-443d-b966-e6913bd24013	9029d9e8-f762-11e1-a439-00145eb45e9a
94	75	-19	GBIF Germany	4f6826f2-4ff6-443d-b966-e6913bd24013	90dc2080-f762-11e1-a439-00145eb45e9a
554679	554677	-2	National Biodiversity Network	d897a5b9-35ee-4232-94bd-b0bcaac003c2	91c4bb90-3608-47e6-9757-361a4a7728f5
995	995	0	GBIF France	da44cd31-5901-4687-a106-6d1c7734ee3a	9221caac-c8d9-494b-83c6-02a50f7cdbb7
150	150	0	GBIF Germany	4f6826f2-4ff6-443d-b966-e6913bd24013	92bc7c9c-f762-11e1-a439-00145eb45e9a
59	59	0	GBIF Germany	4f6826f2-4ff6-443d-b966-e6913bd24013	94feec24-f762-11e1-a439-00145eb45e9a
667	628	-39	GBIF Germany	4f6826f2-4ff6-443d-b966-e6913bd24013	953bfab0-f762-11e1-a439-00145eb45e9a
1	1	0	Plazi	ffb07bec-2d10-492d-9c37-361fe0b79427	98d83e6d-0af6-46a8-ae3c-244299146a68
0	236	236	Plazi	ffb07bec-2d10-492d-9c37-361fe0b79427	9bae7011-67a0-48f8-bf09-cc7ffd154e67
0	30	30	Plazi	ffb07bec-2d10-492d-9c37-361fe0b79427	9c4cb247-2c5b-44b8-975d-dbe356495cef
10798	10798	0	GBIF France	da44cd31-5901-4687-a106-6d1c7734ee3a	a7910107-b902-401c-989a-3b4e70c9070d
154	145	-9	GBIF Germany	4f6826f2-4ff6-443d-b966-e6913bd24013	ab59c5a9-f02b-4f65-aa00-af5ec231dc65
33	33	0	GBIF Germany	4f6826f2-4ff6-443d-b966-e6913bd24013	abb145d8-08a5-4cd0-a39b-fb1d69298cfd
1000	1020	20	GBIF Germany	4f6826f2-4ff6-443d-b966-e6913bd24013	ad3e0336-49b7-4bd0-8b89-f21e7ae2993c
0	1	1	Plazi	ffb07bec-2d10-492d-9c37-361fe0b79427	adae85b8-4785-4898-95a8-29779e26cb36
0	67	67	Indonesian Biodiversity Information Facility	2ebd91f6-f14f-4375-b525-c011a3774f03	afdd8aa3-056a-4c36-90e6-2f20f2b6dd46
0	77	77	Plazi	ffb07bec-2d10-492d-9c37-361fe0b79427	b0da7102-262a-416d-9676-fb46b340981e
320	320	0	Participant Node Managers Committee	7f48e0c8-5c96-49ec-b972-30748e339115	b18a0337-be57-4c70-9908-a46e45df6ae9
2	2	0	Participant Node Managers Committee	7f48e0c8-5c96-49ec-b972-30748e339115	b1fb8a0f-5584-4f8d-a32e-cf5fa25e15db
4475	4475	0	GBIF Spain	1f94b3ca-9345-4d65-afe2-4bace93aa0fe	b26baf87-6e82-4934-9c7b-f33d69b15f8d
1272	1272	0	Colombian Biodiversity Information System	7e865cba-7c46-417b-ade5-97f2cf5b7be0	b4a929e5-35bd-46d2-9ce7-e6ce5206eaec
445	445	0	GBIF Benin	efb9c00e-f802-45dd-8826-a52ec45b89ff	b71288e1-28ee-4ecd-ab53-dce37e57b7d5
2	2	0	Plazi	ffb07bec-2d10-492d-9c37-361fe0b79427	ba5c049c-3700-419a-8387-bbebc1910c64
23	23	0	Plazi	ffb07bec-2d10-492d-9c37-361fe0b79427	bba028eb-c611-4704-9c01-4d2ea30dc3e3
53	53	0	Atlas of Living Australia	4a6f1b71-969e-4fc5-a693-282b05e1220c	bbcdfbfc-d1d5-4ba1-a56f-bc4c96150a2f
3	3	0	Plazi	ffb07bec-2d10-492d-9c37-361fe0b79427	bd429e5b-5640-45c6-ae72-fc14fed35b5b
3	3	0	Plazi	ffb07bec-2d10-492d-9c37-361fe0b79427	c0a630de-82d2-409d-ab59-8b2bf26ae428
4	4	0	Plazi	ffb07bec-2d10-492d-9c37-361fe0b79427	c7103383-4d99-4c9f-b6f5-8c1304836960
0	1	1	Plazi	ffb07bec-2d10-492d-9c37-361fe0b79427	c7d1f878-aa69-401c-a98f-5ea0ea1f8466
8	8	0	Plazi	ffb07bec-2d10-492d-9c37-361fe0b79427	cac72c82-2c83-401f-b6d0-8afb5321fde3
191	191	0	GBIF France	da44cd31-5901-4687-a106-6d1c7734ee3a	cd199df4-35bf-4bd7-ba54-3dc432ba04d7
111	111	0	Plazi	ffb07bec-2d10-492d-9c37-361fe0b79427	ceb3ba80-3c38-4d93-97f1-ee98e52d1204
119	119	0	GBIF France	da44cd31-5901-4687-a106-6d1c7734ee3a	ced03f6f-f726-4f1a-9025-0b135bcb9eac
13	13	0	Plazi	ffb07bec-2d10-492d-9c37-361fe0b79427	d059e3a0-4309-42fd-8ee7-5d6d92aa1d5a
0	3	3	Plazi	ffb07bec-2d10-492d-9c37-361fe0b79427	d0eed949-3be9-4fd3-b3b5-63dadd8a0e56
0	16	16	Plazi	ffb07bec-2d10-492d-9c37-361fe0b79427	d321314d-9b31-4028-997f-75c91ddca182
4	4	0	Plazi	ffb07bec-2d10-492d-9c37-361fe0b79427	d8765160-79b1-4c03-a78b-7cf15dd4e3cc
120	120	0	Secretariat of the Pacific Regional Environment Programme	29c6a139-ea7f-41f5-8d9b-c55af8736182	d8b9c36d-c983-4b3e-a278-bbb013b5d117
6	6	0	Plazi	ffb07bec-2d10-492d-9c37-361fe0b79427	da957853-f720-404d-b32c-1858a3b0108f
265	265	0	GBIF Finland	dd514216-5c7c-45f3-910d-797424cb5be6	dbbd61e7-6e0e-4b18-b0a3-f836d55aac7c
3	3	0	Plazi	ffb07bec-2d10-492d-9c37-361fe0b79427	de977da4-2333-421c-a1cb-290105aa2cb0
13	13	0	Plazi	ffb07bec-2d10-492d-9c37-361fe0b79427	df187cf4-5bec-4a80-aa02-26c4201175af
297	297	0	GBIF Finland	dd514216-5c7c-45f3-910d-797424cb5be6	e12e5ea3-86bf-4cb0-9c70-384ee6ef6137
30	30	0	Plazi	ffb07bec-2d10-492d-9c37-361fe0b79427	e542d309-1af6-465f-816b-3ef3e62a526e
924	924	0	GBIF Malawi	2a42e4d7-ad4a-41b3-84c4-de4aa7b74d35	e58a3de7-a22c-4fd6-92d9-119343547474
236	236	0	GBIF France	da44cd31-5901-4687-a106-6d1c7734ee3a	e6d7b4eb-7afb-4c61-8787-9590016f45d2
2	2	0	Plazi	ffb07bec-2d10-492d-9c37-361fe0b79427	e8b76709-abe9-4caf-9bcf-3acad4f144ac
0	903	903	Ocean Biodiversity Information System	ba0670b9-4186-41e6-8e70-f9cb3065551a	e917484b-c0c6-4cb7-84f8-b2eb4662430f
7513	7513	0	Atlas of Living Australia	4a6f1b71-969e-4fc5-a693-282b05e1220c	ea0df0c3-fe1f-43d1-bf97-f4a7753cc049
3504	3504	0	Netherlands Biodiversity Information Facility	0909d601-bda2-42df-9e63-a6d51847ebce	ea53b031-75b8-47c7-8db9-4f59c58b000c
0	700	700	GBIF Japan	db5705aa-6a6e-42f1-8942-d77b9f4896ea	ea6b944f-7a7b-4640-b560-b8192af00be7
763	763	0	GBIF Germany	4f6826f2-4ff6-443d-b966-e6913bd24013	ecf34199-ae6d-4f65-b9f3-ac204e05fdd7
0	4	4	Plazi	ffb07bec-2d10-492d-9c37-361fe0b79427	ef339fe0-57ad-4f5f-bec5-bf32a579b2bc
44	44	0	U.S. Geological Survey	8618c64a-93e0-4300-b546-7249e5148ed2	f104b947-4b37-4c5b-b3bc-734d6ba36176
2	2	0	Plazi	ffb07bec-2d10-492d-9c37-361fe0b79427	f10d83aa-41cc-4a2b-8b37-dfabe65d5fd6
3406	3406	0	Colombian Biodiversity Information System	7e865cba-7c46-417b-ade5-97f2cf5b7be0	f13e2caf-5093-4f9a-9de6-e38775b5a737
0	318	318	Plazi	ffb07bec-2d10-492d-9c37-361fe0b79427	f4836c21-a062-4226-8865-1c2fbbbbbbe3
0	4	4	Plazi	ffb07bec-2d10-492d-9c37-361fe0b79427	f5eba536-7ab8-4351-bcdf-41fe1506a814
322	322	0	GBIF France	da44cd31-5901-4687-a106-6d1c7734ee3a	f7bec8f5-55a8-4dde-9b2e-571fef74bb23
24533	24533	0	GBIF France	da44cd31-5901-4687-a106-6d1c7734ee3a	fda395aa-63c9-4b98-99e4-8d37651aa4f5
0	8	8	Plazi	ffb07bec-2d10-492d-9c37-361fe0b79427	ff109a39-4b27-4def-a1c5-50a3b51b31e4
2103	2103	0	Belgian Biodiversity Platform	fb11cfe1-ebc3-45af-9159-17d9fddbcdac	0044f3b8-8305-47c6-b96d-a351a94ace74
16862	16862	0	Belgian Biodiversity Platform	fb11cfe1-ebc3-45af-9159-17d9fddbcdac	02a5ae5e-7b00-415f-b422-87d3d8ee2785
0	1091	1091	Ocean Biodiversity Information System	ba0670b9-4186-41e6-8e70-f9cb3065551a	06b146c8-d3f9-419c-ba73-97ac70ebda11
154	154	0	Colombian Biodiversity Information System	7e865cba-7c46-417b-ade5-97f2cf5b7be0	074474ad-aee2-46ec-bcb3-346a1a75691c
2	2	0	Plazi	ffb07bec-2d10-492d-9c37-361fe0b79427	0a00a2d1-cff4-4b37-8375-95b56ffd2f45
40	40	0	Ocean Biodiversity Information System	ba0670b9-4186-41e6-8e70-f9cb3065551a	0ac6ab6b-29a7-48c1-bc77-40afc1dd83bf
266	266	0	Plazi	ffb07bec-2d10-492d-9c37-361fe0b79427	0b7fd4db-9f34-47ef-b7e8-33363155d866
13	13	0	Plazi	ffb07bec-2d10-492d-9c37-361fe0b79427	0eeaf77d-fc91-4d2e-bfd7-2bfc2be09b6b
2	2	0	Plazi	ffb07bec-2d10-492d-9c37-361fe0b79427	1021c32b-f8dc-46f9-b715-bcc6ccb6e485
1	1	0	Plazi	ffb07bec-2d10-492d-9c37-361fe0b79427	13675cd5-c52b-4343-a3ff-7649680a6463
1	1	0	Plazi	ffb07bec-2d10-492d-9c37-361fe0b79427	14591574-dd24-496f-a975-1316c457d206
0	51	51	Plazi	ffb07bec-2d10-492d-9c37-361fe0b79427	1c6a3ac2-7bd7-4504-9040-4e46d7596300
11	11	0	Plazi	ffb07bec-2d10-492d-9c37-361fe0b79427	1c874b66-9b5c-47f1-a159-fb90e62550a2
95	95	0	GBIF Portugal	673f7038-4262-4149-b753-5658a4e912f6	1cb2beee-a72a-4789-8e33-49b397c1ee8b
3	3	0	Plazi	ffb07bec-2d10-492d-9c37-361fe0b79427	1cd9553c-1ca8-45ec-9a0e-2ba5bcdb5987
1	1	0	Plazi	ffb07bec-2d10-492d-9c37-361fe0b79427	1ce0261c-2e30-4975-8888-b15a30be5dc3
626	625	-1	Biodiversity Information System of Mexico	b324e8e9-9a4c-44fa-8f1a-7f39ea7ab576	1e8e9192-0b00-4fbb-93f8-1319d57346a5
6	6	0	Plazi	ffb07bec-2d10-492d-9c37-361fe0b79427	1f07f070-4f3c-4933-b6f9-03322904cf51
678	463	-215	GBIF Germany	4f6826f2-4ff6-443d-b966-e6913bd24013	1f17b8f7-d3f8-4bff-b773-933856ef3513
283	283	0	Colombian Biodiversity Information System	7e865cba-7c46-417b-ade5-97f2cf5b7be0	1f7c2e95-ebec-4d14-9adb-ee958da858dd
0	6	6	Plazi	ffb07bec-2d10-492d-9c37-361fe0b79427	2025274e-cd69-40aa-93b0-100f03c38652
9	9	0	GBIF Sweden	a0b3be64-6525-4387-ac67-a499950f92e1	22df6733-ec71-4ccf-91f4-34465e193591
756	756	0	GBIF New Zealand	4f9fd726-20dd-445e-89a1-8ed93792276f	230689f3-a045-4dbd-a874-26e37874edfd
3	3	0	Plazi	ffb07bec-2d10-492d-9c37-361fe0b79427	259c3604-d789-49d5-89b2-06775160dd86
3257	3257	0	GBIF France	da44cd31-5901-4687-a106-6d1c7734ee3a	25ff1a48-668d-470a-a149-5fa0e8535971
0	5	5	Ocean Biodiversity Information System	ba0670b9-4186-41e6-8e70-f9cb3065551a	26951bcd-6a85-48bd-a239-0038668a608c
363	363	0	GBIF Germany	4f6826f2-4ff6-443d-b966-e6913bd24013	2d694c75-bda1-4b5f-8b84-241d3d975055
115	115	0	Plazi	ffb07bec-2d10-492d-9c37-361fe0b79427	30dfda97-4c47-46c8-b309-b9edcd8435aa
124	124	0	Plazi	ffb07bec-2d10-492d-9c37-361fe0b79427	326e4593-b2e4-4016-9568-d6d8fc1a23d9
3	3	0	Plazi	ffb07bec-2d10-492d-9c37-361fe0b79427	34e720a4-37da-46ab-8861-6e7acbdca93a
1468	1468	0	Participant Node Managers Committee	7f48e0c8-5c96-49ec-b972-30748e339115	36ceb840-3011-4411-8739-1a0f02272489
106	106	0	Participant Node Managers Committee	7f48e0c8-5c96-49ec-b972-30748e339115	3a01c0ce-5046-4792-9f9f-5f413969cdf4
2	2	0	Plazi	ffb07bec-2d10-492d-9c37-361fe0b79427	3de78183-c323-44ba-9aaf-0db45842cde1
0	5	5	Plazi	ffb07bec-2d10-492d-9c37-361fe0b79427	3e0614b0-f19b-4e8f-bf8c-26a9cb292ec7
1191	1191	0	GBIF Spain	1f94b3ca-9345-4d65-afe2-4bace93aa0fe	3e8822f0-6db7-4831-a370-c0cdd3d05538
24	24	0	Plazi	ffb07bec-2d10-492d-9c37-361fe0b79427	3ea2481a-7288-4dfc-9bae-ce104e5c0ebd
992	850	-142	GBIF Germany	4f6826f2-4ff6-443d-b966-e6913bd24013	3ed891d2-ae3c-45a6-a27f-e9f0a9f4b8c1
5	5	0	Plazi	ffb07bec-2d10-492d-9c37-361fe0b79427	3f1f3f51-000b-4993-8f40-b4201479de91
2171	2171	0	GBIF Norway	4f829580-180d-46a9-9c87-ed8ec959b545	4089634e-9e8d-4d71-b344-b704c802c9c4
1	1	0	Plazi	ffb07bec-2d10-492d-9c37-361fe0b79427	41be85d1-326f-42b6-8b7e-2478e9fe99a8
0	4	4	Plazi	ffb07bec-2d10-492d-9c37-361fe0b79427	420fa78d-6ebc-434e-b062-bc73c3318309
4	4	0	GBIF Germany	4f6826f2-4ff6-443d-b966-e6913bd24013	442dd8cc-3a0c-11e2-b0ce-00145eb45e9a
30972	38030	7058	National Biodiversity Network	d897a5b9-35ee-4232-94bd-b0bcaac003c2	4575bf91-0c65-47a8-84cb-0b36111f8956
41	41	0	Plazi	ffb07bec-2d10-492d-9c37-361fe0b79427	470b137b-05b5-468a-b37e-6a315108ecc1
383	383	0	GBIF France	da44cd31-5901-4687-a106-6d1c7734ee3a	48f1c160-e87d-4c0c-89ca-1fde7a758378
144	144	0	Participant Node Managers Committee	7f48e0c8-5c96-49ec-b972-30748e339115	49408f5e-a345-4ce3-9de6-6f2403a4fcc4
2	2	0	Plazi	ffb07bec-2d10-492d-9c37-361fe0b79427	4acd922a-5895-4e20-9b12-aea9f2aed9b4
16844	16844	0	GBIF France	da44cd31-5901-4687-a106-6d1c7734ee3a	4e0ae4ef-4f11-4cfe-9f3a-3c8a2465d205
2	2	0	Plazi	ffb07bec-2d10-492d-9c37-361fe0b79427	51a196cf-2f2b-4fa7-acb2-7692c1011ca8
15	15	0	Plazi	ffb07bec-2d10-492d-9c37-361fe0b79427	52c2d4e5-cacc-4deb-b544-ff64ac469afe
2	2	0	Plazi	ffb07bec-2d10-492d-9c37-361fe0b79427	556ee213-0af0-4574-a052-3df033fac393
4	4	0	Plazi	ffb07bec-2d10-492d-9c37-361fe0b79427	5c2fac83-e9e2-401f-897d-d495205b617d
0	1	1	Ocean Biodiversity Information System	ba0670b9-4186-41e6-8e70-f9cb3065551a	5d06ad6b-6f98-437a-b8a2-156968e842d6
308528	316654	8126	U.S. Geological Survey	8618c64a-93e0-4300-b546-7249e5148ed2	5d283bb6-64dd-4626-8b3b-a4e8db5415c3
366	366	0	Atlas of Living Australia	4a6f1b71-969e-4fc5-a693-282b05e1220c	5e7c3e74-2aaa-42a5-b93d-5e6b8418bd30
0	2	2	Plazi	ffb07bec-2d10-492d-9c37-361fe0b79427	5f27307e-c43b-4627-9ddc-3504e684b08e
16	16	0	Participant Node Managers Committee	7f48e0c8-5c96-49ec-b972-30748e339115	6011377d-14c4-42fa-a5b1-22643dfacdf1
282	282	0	GBIF Germany	4f6826f2-4ff6-443d-b966-e6913bd24013	6175ff28-f762-11e1-a439-00145eb45e9a
303	303	0	GBIF Germany	4f6826f2-4ff6-443d-b966-e6913bd24013	61f2c5a8-f762-11e1-a439-00145eb45e9a
10	10	0	GBIF Germany	4f6826f2-4ff6-443d-b966-e6913bd24013	633058b8-f762-11e1-a439-00145eb45e9a
78	78	0	GBIF Germany	4f6826f2-4ff6-443d-b966-e6913bd24013	63af943e-f762-11e1-a439-00145eb45e9a
0	3	3	Ocean Biodiversity Information System	ba0670b9-4186-41e6-8e70-f9cb3065551a	63bb29af-4899-4e3b-aca6-24b8cc65e146
308	308	0	GBIF Germany	4f6826f2-4ff6-443d-b966-e6913bd24013	65470f5c-f762-11e1-a439-00145eb45e9a
36	36	0	GBIF Germany	4f6826f2-4ff6-443d-b966-e6913bd24013	6616853e-f762-11e1-a439-00145eb45e9a
88	88	0	GBIF Germany	4f6826f2-4ff6-443d-b966-e6913bd24013	664e5b1c-f762-11e1-a439-00145eb45e9a
60	60	0	GBIF Germany	4f6826f2-4ff6-443d-b966-e6913bd24013	66bee724-f762-11e1-a439-00145eb45e9a
50	50	0	GBIF Germany	4f6826f2-4ff6-443d-b966-e6913bd24013	66cb6666-f762-11e1-a439-00145eb45e9a
98	98	0	GBIF Germany	4f6826f2-4ff6-443d-b966-e6913bd24013	675a272a-f762-11e1-a439-00145eb45e9a
0	1	1	Plazi	ffb07bec-2d10-492d-9c37-361fe0b79427	67df3428-79b0-42aa-b89c-7efe973f9f7b
129	86	-43	GBIF Germany	4f6826f2-4ff6-443d-b966-e6913bd24013	69e785aa-f762-11e1-a439-00145eb45e9a
17451	19273	1822	GBIF Norway	4f829580-180d-46a9-9c87-ed8ec959b545	6a948a1c-7e23-4d99-b1c1-ec578d0d3159
4	4	0	GBIF Germany	4f6826f2-4ff6-443d-b966-e6913bd24013	6ad1fc66-f762-11e1-a439-00145eb45e9a
16	16	0	GBIF Germany	4f6826f2-4ff6-443d-b966-e6913bd24013	6bbb394e-f762-11e1-a439-00145eb45e9a
5	5	0	Plazi	ffb07bec-2d10-492d-9c37-361fe0b79427	6bdd86e5-fe0f-4ce6-b36c-fb17ca5a8322
89	89	0	GBIF Germany	4f6826f2-4ff6-443d-b966-e6913bd24013	6cc3fcd6-f762-11e1-a439-00145eb45e9a
140743	140743	0	National Biodiversity Network	d897a5b9-35ee-4232-94bd-b0bcaac003c2	6d2b1e38-6189-4542-ba36-94273f7b7f22
0	1	1	Ocean Biodiversity Information System	ba0670b9-4186-41e6-8e70-f9cb3065551a	6fabdb4e-45bb-4880-8386-a8fd0c93464f
13	13	0	GBIF Germany	4f6826f2-4ff6-443d-b966-e6913bd24013	6faee618-f762-11e1-a439-00145eb45e9a
27	27	0	GBIF Germany	4f6826f2-4ff6-443d-b966-e6913bd24013	711abdba-f762-11e1-a439-00145eb45e9a
21	21	0	Colombian Biodiversity Information System	7e865cba-7c46-417b-ade5-97f2cf5b7be0	735f38e4-8985-4673-829a-abf3a1c0434d
34	34	0	GBIF Germany	4f6826f2-4ff6-443d-b966-e6913bd24013	73bab7dc-f762-11e1-a439-00145eb45e9a
1	1	0	Plazi	ffb07bec-2d10-492d-9c37-361fe0b79427	73e59eea-95df-4001-9e89-7d0396faa0ea
21	21	0	GBIF Germany	4f6826f2-4ff6-443d-b966-e6913bd24013	742e1952-f762-11e1-a439-00145eb45e9a
2	2	0	GBIF Germany	4f6826f2-4ff6-443d-b966-e6913bd24013	7457ad44-f762-11e1-a439-00145eb45e9a
57	57	0	GBIF Germany	4f6826f2-4ff6-443d-b966-e6913bd24013	74a1377a-f762-11e1-a439-00145eb45e9a
97	97	0	Plazi	ffb07bec-2d10-492d-9c37-361fe0b79427	74b2f654-4384-4674-9044-4c1fcbadf8ca
108	108	0	GBIF Germany	4f6826f2-4ff6-443d-b966-e6913bd24013	7565331e-f762-11e1-a439-00145eb45e9a
71	71	0	GBIF France	da44cd31-5901-4687-a106-6d1c7734ee3a	77d92ec7-1fb9-4c79-8e73-a18b907c0104
8	8	0	GBIF Germany	4f6826f2-4ff6-443d-b966-e6913bd24013	78ed6b3c-f762-11e1-a439-00145eb45e9a
142	142	0	GBIF Germany	4f6826f2-4ff6-443d-b966-e6913bd24013	7919b8e0-f762-11e1-a439-00145eb45e9a
196	196	0	GBIF Germany	4f6826f2-4ff6-443d-b966-e6913bd24013	7a75bd56-f762-11e1-a439-00145eb45e9a
7	7	0	GBIF Germany	4f6826f2-4ff6-443d-b966-e6913bd24013	7aba11c2-f762-11e1-a439-00145eb45e9a
621	486	-135	GBIF Germany	4f6826f2-4ff6-443d-b966-e6913bd24013	7c50def8-f762-11e1-a439-00145eb45e9a
1785	1785	0	GBIF Germany	4f6826f2-4ff6-443d-b966-e6913bd24013	7c785bc2-f762-11e1-a439-00145eb45e9a
189	189	0	GBIF Germany	4f6826f2-4ff6-443d-b966-e6913bd24013	7c9e76f4-f762-11e1-a439-00145eb45e9a
4956	1239	-3717	GBIF Germany	4f6826f2-4ff6-443d-b966-e6913bd24013	7cdacec4-f762-11e1-a439-00145eb45e9a
30	18	-12	GBIF Germany	4f6826f2-4ff6-443d-b966-e6913bd24013	7e123d4a-f762-11e1-a439-00145eb45e9a
54	54	0	GBIF Germany	4f6826f2-4ff6-443d-b966-e6913bd24013	7e39246e-f762-11e1-a439-00145eb45e9a
5	5	0	GBIF Germany	4f6826f2-4ff6-443d-b966-e6913bd24013	7e6618c0-1387-11e2-bb2e-00145eb45e9a
441	168	-273	GBIF Germany	4f6826f2-4ff6-443d-b966-e6913bd24013	7eed3ec2-f762-11e1-a439-00145eb45e9a
155	155	0	Plazi	ffb07bec-2d10-492d-9c37-361fe0b79427	834858d8-f9a8-4d11-8f9e-36b90ea3b2b9
2	2	0	Plazi	ffb07bec-2d10-492d-9c37-361fe0b79427	85439034-f26e-40e2-ba2a-f5654eb352f1
2	2	0	Plazi	ffb07bec-2d10-492d-9c37-361fe0b79427	854c7e7a-542c-4fc3-9c79-3f301adf344c
12828	12828	0	GBIF Germany	4f6826f2-4ff6-443d-b966-e6913bd24013	858fa2ec-f762-11e1-a439-00145eb45e9a
2631	2631	0	GBIF Spain	1f94b3ca-9345-4d65-afe2-4bace93aa0fe	85b69b0e-f762-11e1-a439-00145eb45e9a
0	20	20	Plazi	ffb07bec-2d10-492d-9c37-361fe0b79427	87d17125-337d-4679-bdcd-102f6b022ad2
20	20	0	Plazi	ffb07bec-2d10-492d-9c37-361fe0b79427	87e60a32-5002-431d-b24e-2b0dd43b67fb
155	155	0	GBIF France	da44cd31-5901-4687-a106-6d1c7734ee3a	883f5f9a-70cb-4919-93c9-a9a9f356f54c
80	80	0	GBIF Germany	4f6826f2-4ff6-443d-b966-e6913bd24013	88541256-f762-11e1-a439-00145eb45e9a
30	26	-4	GBIF Germany	4f6826f2-4ff6-443d-b966-e6913bd24013	885bfa98-f762-11e1-a439-00145eb45e9a
0	2	2	Plazi	ffb07bec-2d10-492d-9c37-361fe0b79427	8bf9587c-8002-4cac-9347-0ad34c3cb75c
2	2	0	GBIF Germany	4f6826f2-4ff6-443d-b966-e6913bd24013	8c45d1ce-f762-11e1-a439-00145eb45e9a
0	13	13	Ocean Biodiversity Information System	ba0670b9-4186-41e6-8e70-f9cb3065551a	8cc4cfe3-9328-408e-8630-986afa397c94
188	75	-113	GBIF Germany	4f6826f2-4ff6-443d-b966-e6913bd24013	8db84582-f762-11e1-a439-00145eb45e9a
385	385	0	GBIF France	da44cd31-5901-4687-a106-6d1c7734ee3a	8e480871-aea1-413e-beca-2a260da03c49
123	83	-40	GBIF Germany	4f6826f2-4ff6-443d-b966-e6913bd24013	8f8ffa80-f762-11e1-a439-00145eb45e9a
4	4	0	Plazi	ffb07bec-2d10-492d-9c37-361fe0b79427	9005a5e2-b2dd-42db-aaa4-b17b8077988b
221	115	-106	GBIF Germany	4f6826f2-4ff6-443d-b966-e6913bd24013	902b1a92-f762-11e1-a439-00145eb45e9a
639	351	-288	GBIF Germany	4f6826f2-4ff6-443d-b966-e6913bd24013	906caf02-f762-11e1-a439-00145eb45e9a
0	2	2	Plazi	ffb07bec-2d10-492d-9c37-361fe0b79427	9119d268-f739-482c-822e-e642f13fa4be
2	2	0	GBIF Germany	4f6826f2-4ff6-443d-b966-e6913bd24013	92452a70-f762-11e1-a439-00145eb45e9a
23	23	0	Plazi	ffb07bec-2d10-492d-9c37-361fe0b79427	9264dfd0-7e0f-40ff-96e7-cdd2b096bb9b
807	336	-471	GBIF Germany	4f6826f2-4ff6-443d-b966-e6913bd24013	93427180-f762-11e1-a439-00145eb45e9a
53	53	0	GBIF Argentina	2426a871-9feb-40a1-96c6-0c593a76b835	935ec63f-8dfd-42da-8eef-0c1fd11f2dce
0	45	45	Plazi	ffb07bec-2d10-492d-9c37-361fe0b79427	96544bf9-acb7-48fc-ae04-60da8dc5561a
266	266	0	GBIF Germany	4f6826f2-4ff6-443d-b966-e6913bd24013	975804b0-f762-11e1-a439-00145eb45e9a
4	4	0	Plazi	ffb07bec-2d10-492d-9c37-361fe0b79427	9ab4daf3-90f8-4233-bbcd-bb6f447b5164
66	66	0	Plazi	ffb07bec-2d10-492d-9c37-361fe0b79427	9e712485-4178-42f4-92fb-f9835b51fd05
792	792	0	National Biodiversity Network	d897a5b9-35ee-4232-94bd-b0bcaac003c2	9e9ad301-b8e1-422a-bd5c-ac2d78239809
955	955	0	GBIF Finland	dd514216-5c7c-45f3-910d-797424cb5be6	9efee1a1-6181-47c1-887a-278b1fadbcb5
0	26	26	Plazi	ffb07bec-2d10-492d-9c37-361fe0b79427	9fc01d1c-8a2e-489e-aaa0-ec638b5cac93
10	10	0	GBIF France	da44cd31-5901-4687-a106-6d1c7734ee3a	a04828e9-d083-4e29-914e-309a58453686
97	97	0	Plazi	ffb07bec-2d10-492d-9c37-361fe0b79427	a04d0ca0-bb1e-4e39-836a-2b443b3ac61d
0	2	2	Plazi	ffb07bec-2d10-492d-9c37-361fe0b79427	a114ac18-a46f-456b-9052-1bbd63fa252d
12	12	0	Plazi	ffb07bec-2d10-492d-9c37-361fe0b79427	a1243515-bed4-4768-8e44-e2d81f1bbed8
14	14	0	Plazi	ffb07bec-2d10-492d-9c37-361fe0b79427	a17ca975-c052-45ac-b5f9-6a48c8efe7bd
384654	384654	0	GBIF Brazil	cdc9736d-5ff7-4ece-9959-3c744360cdb3	a185d0c4-1a12-45c1-a729-2a7b058b528d
1	1	0	Plazi	ffb07bec-2d10-492d-9c37-361fe0b79427	a1e28d9d-269c-46f6-bb19-10279ec9476b
0	9	9	Plazi	ffb07bec-2d10-492d-9c37-361fe0b79427	a35d887e-7c38-4407-a7a4-aa3c99062afd
0	382	382	Ocean Biodiversity Information System	ba0670b9-4186-41e6-8e70-f9cb3065551a	a8e5bfe2-1397-49f3-8397-55a82ea0ce27
6663	6663	0	Colombian Biodiversity Information System	7e865cba-7c46-417b-ade5-97f2cf5b7be0	aca3452a-0a90-431a-936c-8240ae367911
743	743	0	GBIF France	da44cd31-5901-4687-a106-6d1c7734ee3a	acf3ce8f-e58a-4027-bca5-76431f48ae3a
1036	336	-700	GBIF Germany	4f6826f2-4ff6-443d-b966-e6913bd24013	acfd15b7-2846-49b5-b309-fd2ebbdeab63
9	9	0	Plazi	ffb07bec-2d10-492d-9c37-361fe0b79427	b0ef150d-5e93-4475-a1c1-3309654a3055
7	7	0	Plazi	ffb07bec-2d10-492d-9c37-361fe0b79427	b35f4898-bb42-477b-999e-430e54810174
841422	841422	0	U.S. Geological Survey	8618c64a-93e0-4300-b546-7249e5148ed2	b3b7d5c4-f73a-475b-a203-c6a1ddd040cd
1095	1095	0	GBIF Germany	4f6826f2-4ff6-443d-b966-e6913bd24013	b3e12b33-b3ff-4b6d-91f7-01603762b8f8
1	1	0	Plazi	ffb07bec-2d10-492d-9c37-361fe0b79427	b5807231-270c-4a1d-814e-e2a15b2d4d52
0	13099	13099	Colombian Biodiversity Information System	7e865cba-7c46-417b-ade5-97f2cf5b7be0	b9461088-6f97-49b0-8f76-17e5be9e2df0
4149	4149	0	Ocean Biodiversity Information System	ba0670b9-4186-41e6-8e70-f9cb3065551a	c149ff8f-ef93-45ce-961c-ea50795fafb3
5	5	0	Plazi	ffb07bec-2d10-492d-9c37-361fe0b79427	c2109781-dca0-4cc7-aa86-e52949864b92
695	695	0	Participant Node Managers Committee	7f48e0c8-5c96-49ec-b972-30748e339115	c43c9a53-df36-410d-93b6-8977bd7f4068
29	29	0	GBIF France	da44cd31-5901-4687-a106-6d1c7734ee3a	c68aa851-db88-41cf-84cb-099dee7670ff
1	1	0	Plazi	ffb07bec-2d10-492d-9c37-361fe0b79427	cc8ba56f-af13-4605-bdda-e841fb299b2b
2	2	0	Plazi	ffb07bec-2d10-492d-9c37-361fe0b79427	ce8cc298-f7ac-434c-a77f-fa5a0caed754
318235	318235	0	U.S. Geological Survey	8618c64a-93e0-4300-b546-7249e5148ed2	cece4fc2-1fec-4bb5-a335-7252548e3f0b
8	8	0	Plazi	ffb07bec-2d10-492d-9c37-361fe0b79427	d05c85bb-4606-4db1-9392-c2b65150e7b3
16	16	0	Plazi	ffb07bec-2d10-492d-9c37-361fe0b79427	d0819d5e-2a5d-4fc1-bcb5-61989fc288d8
0	704	704	Ocean Biodiversity Information System	ba0670b9-4186-41e6-8e70-f9cb3065551a	d1aea7f5-299c-46be-90a7-5a0becf4cd10
4	4	0	Plazi	ffb07bec-2d10-492d-9c37-361fe0b79427	d32c5586-3a61-4208-bdd3-bd24f41c90c5
7	7	0	Plazi	ffb07bec-2d10-492d-9c37-361fe0b79427	d8860462-651d-4958-a111-d043c3d8c2c3
5	5	0	Plazi	ffb07bec-2d10-492d-9c37-361fe0b79427	de3eeca6-9a34-4bb6-a70a-74ed158c9f57
5	5	0	Plazi	ffb07bec-2d10-492d-9c37-361fe0b79427	e040ca71-6ab8-40ff-bbbe-910b350dae0e
17532	17532	0	Society for the Management of Electronic Biodiversity Data	97818ee4-1461-4180-bf1d-b3201050124f	e0aff3c8-3e32-412b-888c-fde75c2e8750
0	654	654	Colombian Biodiversity Information System	7e865cba-7c46-417b-ade5-97f2cf5b7be0	e0e68b58-b3e5-4acf-a830-45d6e104f150
304	304	0	GBIF France	da44cd31-5901-4687-a106-6d1c7734ee3a	e8725a83-b54e-4458-a17a-cd2baea9929c
2	2	0	Plazi	ffb07bec-2d10-492d-9c37-361fe0b79427	e9c49360-70c0-4196-bef8-eaaaa8f66455
15	15	0	Plazi	ffb07bec-2d10-492d-9c37-361fe0b79427	ed3d3142-6449-4d72-bea7-51186ee48f37
24	24	0	Plazi	ffb07bec-2d10-492d-9c37-361fe0b79427	f3de278f-f94c-4170-aa4d-addda0a22766
534995	530938	-4057	U.S. Geological Survey	8618c64a-93e0-4300-b546-7249e5148ed2	f3f03cbf-1a01-4739-ae15-c1355b8c2dbf
310	310	0	Biodiversity Information System of Mexico	b324e8e9-9a4c-44fa-8f1a-7f39ea7ab576	f4ecc84b-b746-48b2-81d7-119c35fa7cda
0	881	881	Colombian Biodiversity Information System	7e865cba-7c46-417b-ade5-97f2cf5b7be0	f84d4b54-4e93-40de-91c5-e74503664290
0	3	3	Plazi	ffb07bec-2d10-492d-9c37-361fe0b79427	f86801d1-5089-42e6-9f91-423312e06eba
1023	1023	0	Biodiversity Information System of Mexico	b324e8e9-9a4c-44fa-8f1a-7f39ea7ab576	f8d7caa1-31c9-421e-95f6-254655e755e7
4835	7659	2824	Participant Node Managers Committee	7f48e0c8-5c96-49ec-b972-30748e339115	f8faa08d-a029-4e62-97ed-cb7e97c30ba9
57	68	11	Plazi	ffb07bec-2d10-492d-9c37-361fe0b79427	f9072037-0c0f-4f59-95de-79d2895f9992
94774	94806	32	GBIF Norway	4f829580-180d-46a9-9c87-ed8ec959b545	fb1ecd28-f09e-4747-8bde-0b3d7a6f78d1
139	139	0	Plazi	ffb07bec-2d10-492d-9c37-361fe0b79427	fb975292-bd6b-4f79-8f17-2ee65e888c2e
4546	4546	0	GBIF Brazil	cdc9736d-5ff7-4ece-9959-3c744360cdb3	fc43f13c-7106-4dfb-a7b7-98b6a1fdd3d2
16	16	0	Colombian Biodiversity Information System	7e865cba-7c46-417b-ade5-97f2cf5b7be0	fe5174c1-1d56-49a0-b555-bb4307d2859b
20	20	0	Atlas of Living Australia	4a6f1b71-969e-4fc5-a693-282b05e1220c	ff6a915a-43f4-4e42-b2f9-6dc5fe577d0d
1178	1178	0	GBIF France	da44cd31-5901-4687-a106-6d1c7734ee3a	0678604f-53d6-4315-8cd7-23c6e0ee4cc2
5360	5360	0	Participant Node Managers Committee	7f48e0c8-5c96-49ec-b972-30748e339115	06f61e4a-9ca0-47e3-8e9b-8f953274d26f
2778	2778	0	National Biodiversity Network	d897a5b9-35ee-4232-94bd-b0bcaac003c2	070e5f32-3ea2-4b3d-b82b-d72d1a80305e
130	130	0	GBIF Germany	4f6826f2-4ff6-443d-b966-e6913bd24013	075d23c7-f299-4c23-96e4-ba5950a97d76
1476	1476	0	GBIF France	da44cd31-5901-4687-a106-6d1c7734ee3a	07dd136a-13f2-4814-aa0e-f4cf2b0c73f5
0	4	4	Plazi	ffb07bec-2d10-492d-9c37-361fe0b79427	082be138-30c1-4cbd-89f0-1c3b4e55e36f
438	438	0	GBIF France	da44cd31-5901-4687-a106-6d1c7734ee3a	0d6fa0fb-a1ab-422a-bdad-dd880651f40e
4386918	4386918	0	GBIF France	da44cd31-5901-4687-a106-6d1c7734ee3a	0d8cc344-d880-42ec-a200-40b4ad71affd
0	17	17	Plazi	ffb07bec-2d10-492d-9c37-361fe0b79427	15bf44e4-c720-42d7-b1ec-ab13da78e2a7
29	29	0	Participant Node Managers Committee	7f48e0c8-5c96-49ec-b972-30748e339115	16f71cc7-bc90-42ab-bfcf-816501fa9027
15	15	0	Plazi	ffb07bec-2d10-492d-9c37-361fe0b79427	1712ff70-5bc4-42d7-8071-726a30298735
6	6	0	Participant Node Managers Committee	7f48e0c8-5c96-49ec-b972-30748e339115	180f4bf9-20ff-4336-919c-7a55d6bdcf21
64	64	0	Participant Node Managers Committee	7f48e0c8-5c96-49ec-b972-30748e339115	19419775-afd7-4401-856a-097e711113f0
4	4	0	Plazi	ffb07bec-2d10-492d-9c37-361fe0b79427	1a339476-3c23-4b65-b776-47deaa6fa4dc
19	19	0	Biodiversity Information System of Mexico	b324e8e9-9a4c-44fa-8f1a-7f39ea7ab576	1a56d457-8ab8-4592-bcf3-0f57a937844f
257	257	0	Plazi	ffb07bec-2d10-492d-9c37-361fe0b79427	1bdb44ea-c474-40cc-83a2-e0e4b45310aa
3	3	0	National Biodiversity Network	d897a5b9-35ee-4232-94bd-b0bcaac003c2	1d52185f-1880-4c65-8e2a-9c926137f9ad
0	5	5	Plazi	ffb07bec-2d10-492d-9c37-361fe0b79427	1fdcbc8e-9ed1-4487-bf75-1bedf7b0b774
2009	2009	0	National Biodiversity Data Centre	422b00b2-6c94-4bb6-976b-c359916efdb8	202af80e-3bd1-4856-9f67-833588872230
93	93	0	Plazi	ffb07bec-2d10-492d-9c37-361fe0b79427	2429a921-404f-482c-8f90-741676225442
652	652	0	Participant Node Managers Committee	7f48e0c8-5c96-49ec-b972-30748e339115	24814443-5120-4da1-8b49-f345383ed4b4
44	44	0	Plazi	ffb07bec-2d10-492d-9c37-361fe0b79427	24a2ebdb-c5cb-46ef-9302-e491aceb8802
5	5	0	Plazi	ffb07bec-2d10-492d-9c37-361fe0b79427	265bfbe1-a4e3-4799-8f8c-75ed4a7d65d1
100	100	0	Plazi	ffb07bec-2d10-492d-9c37-361fe0b79427	27d3cd24-1cf4-43db-97b4-b00127a9ad99
1257	1257	0	National Biodiversity Network	d897a5b9-35ee-4232-94bd-b0bcaac003c2	28aeb698-8920-4fd4-bf32-7b4772731d3b
1024	1024	0	GBIF France	da44cd31-5901-4687-a106-6d1c7734ee3a	2a1eb0a6-04c7-438c-b50c-8edcc81eb68f
1978	1978	0	National Biodiversity Network	d897a5b9-35ee-4232-94bd-b0bcaac003c2	2a54253f-401a-4c0c-8abf-bd9b5cdc8011
5874	5874	0	National Biodiversity Network	d897a5b9-35ee-4232-94bd-b0bcaac003c2	2a587cf9-e1bb-4d51-b7e4-fe8f571357b7
0	2	2	Plazi	ffb07bec-2d10-492d-9c37-361fe0b79427	2c908bb7-8fca-4e76-85a6-92d91bb74bff
2739	2739	0	GBIF Kenya	2a44d626-9f7a-4120-8a7a-4ab5ac15ff2a	2d9bd0c1-98d1-476b-bd4d-22b472908eff
3	3	0	Plazi	ffb07bec-2d10-492d-9c37-361fe0b79427	2f0d2137-d4cc-4ffc-9a61-3be78f8b7574
255	255	0	Belgian Biodiversity Platform	fb11cfe1-ebc3-45af-9159-17d9fddbcdac	30ec0e8f-e4fb-405b-89fc-f636398a7c46
0	3	3	Plazi	ffb07bec-2d10-492d-9c37-361fe0b79427	3216f827-9f14-4ff3-ae77-8043389b6ccc
0	7	7	Plazi	ffb07bec-2d10-492d-9c37-361fe0b79427	35ddde37-c2d3-41db-9a2e-5fef3539bd5c
0	700	700	Korean Biodiversity Information Facility	e0a1e772-0177-4800-94b4-2d023fe6cdf4	3695de2d-9991-4d19-8d04-f2bb36e75e13
6	6	0	Plazi	ffb07bec-2d10-492d-9c37-361fe0b79427	3a2312d9-7f23-46f0-8962-6e1952105180
30091	30091	0	DanBIF - Danish Biodiversity Information Facility	4ddd294f-02b7-4359-ac33-0806a9ca9c6b	3b8c5ed8-b6c2-4264-ac52-a9d772d69e9f
1763	1719	-44	GBIF Germany	4f6826f2-4ff6-443d-b966-e6913bd24013	3bcb5cb3-f4d7-4826-8a37-02edab090ede
0	5	5	Plazi	ffb07bec-2d10-492d-9c37-361fe0b79427	3bcdae16-72ef-443f-934b-236978e3d2d8
0	28	28	Plazi	ffb07bec-2d10-492d-9c37-361fe0b79427	3cec2643-a3a9-4104-97f0-2d1ed963f772
0	44	44	Ocean Biodiversity Information System	ba0670b9-4186-41e6-8e70-f9cb3065551a	403653c6-3ed2-4215-a9e6-6e5c6017263e
287	287	0	GBIF France	da44cd31-5901-4687-a106-6d1c7734ee3a	415dbb6e-df4d-4138-8a13-cd5aec3a4d7f
21672	21672	0	U.S. Geological Survey	8618c64a-93e0-4300-b546-7249e5148ed2	420ab020-3d83-4787-8f3d-f83ebb0e6ded
11193	11193	0	National Biodiversity Network	d897a5b9-35ee-4232-94bd-b0bcaac003c2	454cba05-03a6-4947-84a0-56c7e75d565b
0	10	10	Ocean Biodiversity Information System	ba0670b9-4186-41e6-8e70-f9cb3065551a	4ad666be-a9dc-4af2-bcbe-6826076b0607
450	449	-1	National Biodiversity Network	d897a5b9-35ee-4232-94bd-b0bcaac003c2	4d4e7415-5800-4d8b-8d4d-6de938e8d38c
278	278	0	National Biodiversity Network	d897a5b9-35ee-4232-94bd-b0bcaac003c2	5486c4dc-a705-4cbb-9970-9a5ef129c9f9
4498	4498	0	GBIF Japan	db5705aa-6a6e-42f1-8942-d77b9f4896ea	55dc4a73-87ed-4420-8513-a44cce3753fe
0	1	1	Plazi	ffb07bec-2d10-492d-9c37-361fe0b79427	55e280fc-0d53-4c31-9fbb-52ab0f464832
84255	84255	0	South African Biodiversity Information Facility	7190b835-4e86-4b6e-85c1-19cc6677c250	56fe0b98-95e1-4544-b398-fa7cebf18598
1	1	0	Plazi	ffb07bec-2d10-492d-9c37-361fe0b79427	5706aafa-9ec9-4c3d-922d-9b166096c06b
0	77	77	Plazi	ffb07bec-2d10-492d-9c37-361fe0b79427	5861dccb-673f-43a7-80fb-919897dd8bde
4	4	0	Plazi	ffb07bec-2d10-492d-9c37-361fe0b79427	5d9a9285-05c4-4165-b2fd-2ba387adb424
101	101	0	GBIF Germany	4f6826f2-4ff6-443d-b966-e6913bd24013	6122b886-f762-11e1-a439-00145eb45e9a
144	144	0	GBIF Germany	4f6826f2-4ff6-443d-b966-e6913bd24013	61510b78-f762-11e1-a439-00145eb45e9a
0	37	37	Plazi	ffb07bec-2d10-492d-9c37-361fe0b79427	61de1ffa-cf13-43e6-817d-6b5ac09a9f83
2	2	0	Plazi	ffb07bec-2d10-492d-9c37-361fe0b79427	62367f1b-d041-4bc0-9bda-e1ec06723db7
69	69	0	GBIF Germany	4f6826f2-4ff6-443d-b966-e6913bd24013	6245d572-f762-11e1-a439-00145eb45e9a
71	71	0	GBIF Germany	4f6826f2-4ff6-443d-b966-e6913bd24013	629231d8-f762-11e1-a439-00145eb45e9a
47	47	0	GBIF Germany	4f6826f2-4ff6-443d-b966-e6913bd24013	62ab2fb2-f762-11e1-a439-00145eb45e9a
27	27	0	GBIF Germany	4f6826f2-4ff6-443d-b966-e6913bd24013	62f0aee8-f762-11e1-a439-00145eb45e9a
8	8	0	GBIF Germany	4f6826f2-4ff6-443d-b966-e6913bd24013	633abd26-f762-11e1-a439-00145eb45e9a
79	79	0	GBIF Germany	4f6826f2-4ff6-443d-b966-e6913bd24013	6442cd62-f762-11e1-a439-00145eb45e9a
6744	6744	0	GBIF Brazil	cdc9736d-5ff7-4ece-9959-3c744360cdb3	647d4916-9356-4fa1-b068-229ec6296098
19033	12580	-6453	GBIF Norway	4f829580-180d-46a9-9c87-ed8ec959b545	66276aee-900b-4259-bc7a-bcfbcb6d56b8
82	82	0	Plazi	ffb07bec-2d10-492d-9c37-361fe0b79427	66f29a08-b1d4-4f12-a18d-d8bd4288fabb
125	125	0	GBIF Germany	4f6826f2-4ff6-443d-b966-e6913bd24013	68441394-f762-11e1-a439-00145eb45e9a
22	22	0	GBIF Germany	4f6826f2-4ff6-443d-b966-e6913bd24013	68f4e264-f762-11e1-a439-00145eb45e9a
871	731	-140	GBIF Germany	4f6826f2-4ff6-443d-b966-e6913bd24013	6946c4ee-f762-11e1-a439-00145eb45e9a
65	65	0	GBIF Germany	4f6826f2-4ff6-443d-b966-e6913bd24013	698ae1ce-f762-11e1-a439-00145eb45e9a
1637	1160	-477	GBIF Germany	4f6826f2-4ff6-443d-b966-e6913bd24013	69f44268-f762-11e1-a439-00145eb45e9a
112	112	0	Colombian Biodiversity Information System	7e865cba-7c46-417b-ade5-97f2cf5b7be0	6a942b5e-d2ee-4655-88a5-488dd2a452d2
10052553	12383783	2331230	GBIF Germany	4f6826f2-4ff6-443d-b966-e6913bd24013	6ac3f774-d9fb-4796-b3e9-92bf6c81c084
0	3	3	Plazi	ffb07bec-2d10-492d-9c37-361fe0b79427	6b458439-7057-4ba7-b1e9-d6c1d2407d9a
0	2	2	Plazi	ffb07bec-2d10-492d-9c37-361fe0b79427	6b6f24d9-228b-4867-93cb-d0344a488cd8
8	8	0	Plazi	ffb07bec-2d10-492d-9c37-361fe0b79427	6c2c2795-d283-4de4-a94e-42c64c88187c
47	47	0	GBIF Germany	4f6826f2-4ff6-443d-b966-e6913bd24013	6ce44432-f762-11e1-a439-00145eb45e9a
31	31	0	GBIF Germany	4f6826f2-4ff6-443d-b966-e6913bd24013	6d3dbc42-f762-11e1-a439-00145eb45e9a
82	82	0	Biodiversity Information System of Mexico	b324e8e9-9a4c-44fa-8f1a-7f39ea7ab576	6e37944d-ae64-4e0a-9c00-bdc427fe2702
3944	3944	0	GBIF Kenya	2a44d626-9f7a-4120-8a7a-4ab5ac15ff2a	718d628f-149a-4789-a062-05415f042c40
67	67	0	GBIF Germany	4f6826f2-4ff6-443d-b966-e6913bd24013	719dc980-f762-11e1-a439-00145eb45e9a
45	45	0	GBIF Germany	4f6826f2-4ff6-443d-b966-e6913bd24013	723fd1f8-f762-11e1-a439-00145eb45e9a
146	146	0	GBIF Germany	4f6826f2-4ff6-443d-b966-e6913bd24013	72e7a8f6-f762-11e1-a439-00145eb45e9a
68	68	0	GBIF Germany	4f6826f2-4ff6-443d-b966-e6913bd24013	73368a2a-f762-11e1-a439-00145eb45e9a
121	121	0	GBIF Germany	4f6826f2-4ff6-443d-b966-e6913bd24013	7578e9f4-f762-11e1-a439-00145eb45e9a
134	134	0	GBIF Germany	4f6826f2-4ff6-443d-b966-e6913bd24013	75b083fa-f762-11e1-a439-00145eb45e9a
262	262	0	GBIF Germany	4f6826f2-4ff6-443d-b966-e6913bd24013	77411ea0-f762-11e1-a439-00145eb45e9a
84	84	0	GBIF Germany	4f6826f2-4ff6-443d-b966-e6913bd24013	77ac36fe-f762-11e1-a439-00145eb45e9a
599	599	0	GBIF Nigeria	6529bcb5-a542-4fda-be87-54a624515335	78901bbb-af83-4645-a209-1d84279e7097
20	20	0	GBIF Germany	4f6826f2-4ff6-443d-b966-e6913bd24013	78aa2598-f762-11e1-a439-00145eb45e9a
52	52	0	GBIF Germany	4f6826f2-4ff6-443d-b966-e6913bd24013	78c791d2-f762-11e1-a439-00145eb45e9a
96	83	-13	GBIF Germany	4f6826f2-4ff6-443d-b966-e6913bd24013	79955c70-f762-11e1-a439-00145eb45e9a
0	2240	2240	Canada Biodiversity Information Facility	8f83fc96-c966-4126-83f7-bf044dc49efa	79b10019-11f9-4528-87a3-efa4a81c38c1
10612	11045	433	GBIF Brazil	cdc9736d-5ff7-4ece-9959-3c744360cdb3	79f15804-4621-4cf1-b389-8bdcc2a3fe3b
1004	1004	0	GBIF Germany	4f6826f2-4ff6-443d-b966-e6913bd24013	7b8a8faa-f762-11e1-a439-00145eb45e9a
6084	6084	0	GBIF Germany	4f6826f2-4ff6-443d-b966-e6913bd24013	7bb4868e-f762-11e1-a439-00145eb45e9a
12454	12454	0	Participant Node Managers Committee	7f48e0c8-5c96-49ec-b972-30748e339115	7c0cd863-8b81-4937-84f9-2f596fd3fa79
185	185	0	GBIF Germany	4f6826f2-4ff6-443d-b966-e6913bd24013	7c3baf2e-f762-11e1-a439-00145eb45e9a
102	102	0	GBIF Germany	4f6826f2-4ff6-443d-b966-e6913bd24013	7e4852a4-f762-11e1-a439-00145eb45e9a
175	175	0	GBIF Germany	4f6826f2-4ff6-443d-b966-e6913bd24013	7e90384e-f762-11e1-a439-00145eb45e9a
26	26	0	Colombian Biodiversity Information System	7e865cba-7c46-417b-ade5-97f2cf5b7be0	7eb9d76d-168c-4a4d-8b65-53c80fcc47b1
874	304	-570	GBIF Germany	4f6826f2-4ff6-443d-b966-e6913bd24013	7f13e194-f762-11e1-a439-00145eb45e9a
3	3	0	Plazi	ffb07bec-2d10-492d-9c37-361fe0b79427	7fc7ebcb-2981-4a44-820c-1d8a47569a60
277	277	0	Biodiversity Information System of Mexico	b324e8e9-9a4c-44fa-8f1a-7f39ea7ab576	80049c24-f762-11e1-a439-00145eb45e9a
279	279	0	GBIF Finland	dd514216-5c7c-45f3-910d-797424cb5be6	8113f588-f762-11e1-a439-00145eb45e9a
173806	173870	64	U.S. Geological Survey	8618c64a-93e0-4300-b546-7249e5148ed2	815b2469-2686-4abd-8406-27ebe778a684
610	610	0	GBIF Germany	4f6826f2-4ff6-443d-b966-e6913bd24013	816d6cc6-f762-11e1-a439-00145eb45e9a
2	2	0	Plazi	ffb07bec-2d10-492d-9c37-361fe0b79427	8378fda1-7808-476f-9c03-b551204b03e6
0	1	1	Ocean Biodiversity Information System	ba0670b9-4186-41e6-8e70-f9cb3065551a	86ed86b4-4c70-4f56-8358-a0058e76c880
420	420	0	GBIF France	da44cd31-5901-4687-a106-6d1c7734ee3a	874ad1e9-c806-45d8-89c5-9bdf94389c98
413	159	-254	GBIF Germany	4f6826f2-4ff6-443d-b966-e6913bd24013	885eb576-f762-11e1-a439-00145eb45e9a
211	211	0	GBIF Germany	4f6826f2-4ff6-443d-b966-e6913bd24013	8a611e86-f762-11e1-a439-00145eb45e9a
40	40	0	GBIF Germany	4f6826f2-4ff6-443d-b966-e6913bd24013	8c9970a4-f762-11e1-a439-00145eb45e9a
16	8	-8	GBIF Germany	4f6826f2-4ff6-443d-b966-e6913bd24013	8ce8508e-f762-11e1-a439-00145eb45e9a
1134	891	-243	GBIF Germany	4f6826f2-4ff6-443d-b966-e6913bd24013	8d835f20-f762-11e1-a439-00145eb45e9a
990	720	-270	GBIF Germany	4f6826f2-4ff6-443d-b966-e6913bd24013	8d860a04-f762-11e1-a439-00145eb45e9a
4	4	0	Plazi	ffb07bec-2d10-492d-9c37-361fe0b79427	8defa883-2a40-4e1f-a989-9868f0558fc6
1121	1121	0	GBIF Germany	4f6826f2-4ff6-443d-b966-e6913bd24013	8e219af0-f762-11e1-a439-00145eb45e9a
4678	3631	-1047	GBIF Germany	4f6826f2-4ff6-443d-b966-e6913bd24013	905286e0-f762-11e1-a439-00145eb45e9a
1096	710	-386	GBIF Germany	4f6826f2-4ff6-443d-b966-e6913bd24013	907fe676-f762-11e1-a439-00145eb45e9a
3	2	-1	GBIF Germany	4f6826f2-4ff6-443d-b966-e6913bd24013	913c25d4-f762-11e1-a439-00145eb45e9a
125	130	5	GBIF Germany	4f6826f2-4ff6-443d-b966-e6913bd24013	92c89e32-f762-11e1-a439-00145eb45e9a
19	19	0	GBIF Germany	4f6826f2-4ff6-443d-b966-e6913bd24013	93179aa0-f762-11e1-a439-00145eb45e9a
80	73	-7	GBIF Germany	4f6826f2-4ff6-443d-b966-e6913bd24013	95355f66-f762-11e1-a439-00145eb45e9a
5588	5588	0	Atlas of Living Australia	4a6f1b71-969e-4fc5-a693-282b05e1220c	96a7c276-f762-11e1-a439-00145eb45e9a
0	1057	1057	U.S. Geological Survey	8618c64a-93e0-4300-b546-7249e5148ed2	97255e25-4983-4e2b-bf18-2127d29e12a9
28	28	0	GBIF Germany	4f6826f2-4ff6-443d-b966-e6913bd24013	97828cc6-f762-11e1-a439-00145eb45e9a
30	30	0	Plazi	ffb07bec-2d10-492d-9c37-361fe0b79427	990c7560-fd4d-4e92-b187-f04fdb751223
5	5	0	Plazi	ffb07bec-2d10-492d-9c37-361fe0b79427	9a362496-980d-4b2e-9fbb-02d6269d1ec0
12	12	0	Plazi	ffb07bec-2d10-492d-9c37-361fe0b79427	9a6e20a7-1a82-439c-bf30-07a892b110ef
92	92	0	Plazi	ffb07bec-2d10-492d-9c37-361fe0b79427	9a9b8fd9-2aaa-4f81-b833-24bc5c400ba8
95	95	0	Plazi	ffb07bec-2d10-492d-9c37-361fe0b79427	9ead5302-8391-4fc4-aa16-dff8a24959b6
0	1206	1206	Korean Biodiversity Information Facility	e0a1e772-0177-4800-94b4-2d023fe6cdf4	a183823e-7f57-4cb7-8893-a2daa605d4a0
114	114	0	National Biodiversity Network	d897a5b9-35ee-4232-94bd-b0bcaac003c2	a3d3fb48-90f0-442a-bd1a-d0876fc7972d
11	11	0	Plazi	ffb07bec-2d10-492d-9c37-361fe0b79427	a3ed9fb7-68a3-4a4e-9d3b-8375bedd234f
1037	1037	0	GBIF France	da44cd31-5901-4687-a106-6d1c7734ee3a	a9c0892e-0991-4c73-826d-8629cd71d95a
390	390	0	GBIF Portugal	673f7038-4262-4149-b753-5658a4e912f6	ab97f7ef-ccea-40d7-bea3-fb761e67c528
10	10	0	Plazi	ffb07bec-2d10-492d-9c37-361fe0b79427	ac9a4b1b-b3d2-4bb0-9ed3-0232012e96c2
25	25	0	Colombian Biodiversity Information System	7e865cba-7c46-417b-ade5-97f2cf5b7be0	ad61ef68-b44e-4926-9538-2c397a6fa7fd
0	30	30	Plazi	ffb07bec-2d10-492d-9c37-361fe0b79427	adccc692-03a2-4af9-959e-18afa8e43e0d
66	66	0	Colombian Biodiversity Information System	7e865cba-7c46-417b-ade5-97f2cf5b7be0	ae5a707e-b3f8-416a-ac21-a02577e3349d
2	2	0	Plazi	ffb07bec-2d10-492d-9c37-361fe0b79427	afde68cb-44e6-4117-820e-3304027b9ec3
0	2	2	Plazi	ffb07bec-2d10-492d-9c37-361fe0b79427	b2f65645-e992-48cd-8007-7f736d042993
1085628	1085627	-1	National Biodiversity Network	d897a5b9-35ee-4232-94bd-b0bcaac003c2	b3604297-f438-4b5c-b654-7976a909f24e
3436	3436	0	GBIF Brazil	cdc9736d-5ff7-4ece-9959-3c744360cdb3	b4a9aba3-9d66-4bdd-8e4b-ab42b11e69fd
68	68	0	Plazi	ffb07bec-2d10-492d-9c37-361fe0b79427	b5ea33bc-61d9-4849-89d8-4d54ff581052
3	3	0	GBIF Germany	4f6826f2-4ff6-443d-b966-e6913bd24013	b6cbc2fb-368b-40d9-99ab-8714b1fd103d
61311	61311	0	GBIF France	da44cd31-5901-4687-a106-6d1c7734ee3a	b9e8d4f9-7ca5-4990-9e89-c4582cd73572
0	155	155	Participant Node Managers Committee	7f48e0c8-5c96-49ec-b972-30748e339115	bb1f44ca-03ac-4998-a970-093ed7bb8db7
0	2	2	Plazi	ffb07bec-2d10-492d-9c37-361fe0b79427	bbf7ea3e-f490-450d-bc3b-37dc3e238f5b
1583	1583	0	Ocean Biodiversity Information System	ba0670b9-4186-41e6-8e70-f9cb3065551a	bc9ae1b5-b293-4952-ae2b-0ab0f705e06d
477	477	0	Participant Node Managers Committee	7f48e0c8-5c96-49ec-b972-30748e339115	be9224e7-11b8-4b79-b732-91525af9fed9
22	22	0	Colombian Biodiversity Information System	7e865cba-7c46-417b-ade5-97f2cf5b7be0	c037e90f-16e2-4304-87b6-9f025db0ae65
3	3	0	Plazi	ffb07bec-2d10-492d-9c37-361fe0b79427	c1882d4d-4ee6-4ea6-8464-9bc0f7a4a555
0	7	7	Plazi	ffb07bec-2d10-492d-9c37-361fe0b79427	c2af4a32-24c6-437f-b128-4dd897fa9308
0	57	57	Plazi	ffb07bec-2d10-492d-9c37-361fe0b79427	c4ddeab6-e087-4585-99d7-ac9f7dc4a102
2489	3766	1277	U.S. Geological Survey	8618c64a-93e0-4300-b546-7249e5148ed2	c561baa1-9f1c-460a-8efe-e6f7771e3a40
3435	3435	0	National Biodiversity Network	d897a5b9-35ee-4232-94bd-b0bcaac003c2	ca1ee088-4cd3-4412-bb5d-4d3cd68a9c1f
0	16	16	Plazi	ffb07bec-2d10-492d-9c37-361fe0b79427	caee27e5-0786-4e95-84fb-ee5394fa79e3
1910	1910	0	GBIF Germany	4f6826f2-4ff6-443d-b966-e6913bd24013	ccac69da-cb08-4b8e-8893-8b86e31a2eb2
7	7	0	Plazi	ffb07bec-2d10-492d-9c37-361fe0b79427	ce424e69-48c0-4c91-91cd-0e8561e0fa96
3	3	0	Plazi	ffb07bec-2d10-492d-9c37-361fe0b79427	cef590e5-f7a2-41da-b30b-57ea5141b84d
162	162	0	National Biodiversity Network	d897a5b9-35ee-4232-94bd-b0bcaac003c2	d4099588-0a07-4151-8aee-a0924afb58a9
0	44	44	Plazi	ffb07bec-2d10-492d-9c37-361fe0b79427	d8a6adbc-1a51-452e-81f9-9ece273151da
27	27	0	Colombian Biodiversity Information System	7e865cba-7c46-417b-ade5-97f2cf5b7be0	da434db5-aad4-4960-98b9-6245f7469b91
13769	13769	0	National Biodiversity Network	d897a5b9-35ee-4232-94bd-b0bcaac003c2	e142db13-5b0e-4f15-b652-6e72537b4337
6	6	0	Plazi	ffb07bec-2d10-492d-9c37-361fe0b79427	e2b30f7a-d16b-4a5d-954e-a2dac8786c84
2	2	0	Plazi	ffb07bec-2d10-492d-9c37-361fe0b79427	e3026213-c8a2-4c89-a7f3-ffb6488595ae
13	13	0	Plazi	ffb07bec-2d10-492d-9c37-361fe0b79427	e62c022c-9568-422c-afcf-a63fd7cb8158
25	25	0	Plazi	ffb07bec-2d10-492d-9c37-361fe0b79427	e80fc464-0c2a-4003-a867-ab8b5b3b399e
4	4	0	Plazi	ffb07bec-2d10-492d-9c37-361fe0b79427	e94aba28-8605-47ff-9917-4e0e46be0719
264608	264608	0	GBIF Brazil	cdc9736d-5ff7-4ece-9959-3c744360cdb3	ebed4456-76d2-408c-8467-fd66be066521
0	3190	3190	Atlas of Living Australia	4a6f1b71-969e-4fc5-a693-282b05e1220c	f2290e6d-d54e-481f-81d5-12ed6c7be0c5
0	23	23	Plazi	ffb07bec-2d10-492d-9c37-361fe0b79427	fa031765-b474-48aa-9d7e-b62dd092cfa4
0	4	4	Plazi	ffb07bec-2d10-492d-9c37-361fe0b79427	fb5e0c4f-1b64-427f-8d8c-7d3d962170fa
3651	3651	0	GBIF Brazil	cdc9736d-5ff7-4ece-9959-3c744360cdb3	fb5ee4f0-4504-4b86-9f28-1450ba53c372
17	17	0	Plazi	ffb07bec-2d10-492d-9c37-361fe0b79427	fc5b34c0-6efc-4397-93d0-9bbbd85f0891
0	3	3	Plazi	ffb07bec-2d10-492d-9c37-361fe0b79427	fc6b80f2-eed9-4f48-bdab-6f56ef007bf0
2264	3445	1181	National Biodiversity Network	d897a5b9-35ee-4232-94bd-b0bcaac003c2	fdc95521-2893-4c0b-9a3f-544f8aee4c55
0	113	113	Ocean Biodiversity Information System	ba0670b9-4186-41e6-8e70-f9cb3065551a	fdf98d13-b9dd-442d-ad5d-9ebc1088b7a0
0	20	20	Ocean Biodiversity Information System	ba0670b9-4186-41e6-8e70-f9cb3065551a	ff27fde3-c3cd-4c52-a67a-6c0a6d751c54
0	4	4	Plazi	ffb07bec-2d10-492d-9c37-361fe0b79427	01b94d4b-9006-43fb-bc7c-d953eb189ce8
2	2	0	Plazi	ffb07bec-2d10-492d-9c37-361fe0b79427	01dc4d5b-3cd9-4295-83a8-ad667a1c57ea
160	160	0	Colombian Biodiversity Information System	7e865cba-7c46-417b-ade5-97f2cf5b7be0	031676fb-d9f7-481f-ac4e-be949605c75d
6	6	0	GBIF Germany	4f6826f2-4ff6-443d-b966-e6913bd24013	0447779f-a730-4969-801b-e793e2496f8a
0	1	1	Plazi	ffb07bec-2d10-492d-9c37-361fe0b79427	0505bf66-2d30-4b8c-a6b8-d151236250df
532	532	0	GBIF France	da44cd31-5901-4687-a106-6d1c7734ee3a	05680501-cc60-45de-9fa7-bb284db274a9
909	909	0	Plazi	ffb07bec-2d10-492d-9c37-361fe0b79427	05c52030-f2c2-414d-bc08-76e006bea9e1
0	16708	16708	Ocean Biodiversity Information System	ba0670b9-4186-41e6-8e70-f9cb3065551a	0a6adffd-d66e-457a-9567-5a5f8b1242a1
746	746	0	GBIF France	da44cd31-5901-4687-a106-6d1c7734ee3a	0b5b7100-63a8-406d-a6ff-0b1a5f016a61
0	79	79	Plazi	ffb07bec-2d10-492d-9c37-361fe0b79427	0bc7f138-4a2e-4b1d-ae03-3076b68f200a
1581	1581	0	National Biodiversity Network	d897a5b9-35ee-4232-94bd-b0bcaac003c2	0c5d33ea-bf8d-40eb-a9e7-1370c1eea293
648	1664	1016	Atlas of Living Australia	4a6f1b71-969e-4fc5-a693-282b05e1220c	0ceb2c40-4134-482f-9d19-15560e3f1a97
520	520	0	GBIF Germany	4f6826f2-4ff6-443d-b966-e6913bd24013	0d413d4c-fe94-4d15-b16d-0fbef59bf042
0	21	21	Plazi	ffb07bec-2d10-492d-9c37-361fe0b79427	1450e926-933d-4ae8-bc64-a8df7b295697
0	121	121	Participant Node Managers Committee	7f48e0c8-5c96-49ec-b972-30748e339115	1477dbb4-a480-43a6-8055-8766a7fa8f71
3397	3397	0	Participant Node Managers Committee	7f48e0c8-5c96-49ec-b972-30748e339115	1580d4ee-042d-4809-8c80-1c3261150e00
2363	1826	-537	Biodiversity Information System of Mexico	b324e8e9-9a4c-44fa-8f1a-7f39ea7ab576	16bc0981-c7df-4df1-be86-a3af716577bf
0	1428	1428	Participant Node Managers Committee	7f48e0c8-5c96-49ec-b972-30748e339115	17af9dde-6387-4247-afda-faa26a572a08
1	1	0	Plazi	ffb07bec-2d10-492d-9c37-361fe0b79427	1a51a4bd-a21c-4baf-9c36-035c2385380b
0	1	1	Plazi	ffb07bec-2d10-492d-9c37-361fe0b79427	1c6c46be-99f2-43a4-b3d1-a8101d597cd5
0	51	51	Plazi	ffb07bec-2d10-492d-9c37-361fe0b79427	1c90c425-5e8a-432c-a8bc-5163a6f7c1c3
4447	4447	0	GBIF Sweden	a0b3be64-6525-4387-ac67-a499950f92e1	1d5c2b00-0c66-11dd-84d2-b8a03c50a862
119	119	0	GBIF Brazil	cdc9736d-5ff7-4ece-9959-3c744360cdb3	1fda7272-388d-47aa-98f5-b7fb666f7aa8
50991	50991	0	Atlas of Living Australia	4a6f1b71-969e-4fc5-a693-282b05e1220c	223f6e89-c7b5-4e8c-99a2-da2752f16435
443	443	0	GBIF Germany	4f6826f2-4ff6-443d-b966-e6913bd24013	24079d02-294b-4a0a-a02d-21d9a160e6e8
24011	24011	0	GBIF France	da44cd31-5901-4687-a106-6d1c7734ee3a	258c29cc-51f6-43f5-b702-3a833921a008
5850	5850	0	U.S. Geological Survey	8618c64a-93e0-4300-b546-7249e5148ed2	29d54fb6-ed46-4a75-9697-55b73e63beed
72512	72512	0	GBIF Norway	4f829580-180d-46a9-9c87-ed8ec959b545	2c28a663-db16-48d3-9cd0-3c7ec8d8d873
1775	1775	0	Participant Node Managers Committee	7f48e0c8-5c96-49ec-b972-30748e339115	2ca5c138-1c32-448e-bf64-ee20012604b9
13	13	0	Plazi	ffb07bec-2d10-492d-9c37-361fe0b79427	2e96d566-68f1-454b-8330-f6de6e85f236
14	14	0	Plazi	ffb07bec-2d10-492d-9c37-361fe0b79427	2f486dc5-6b53-4979-8511-005fec9bd55b
0	1011	1011	Ocean Biodiversity Information System	ba0670b9-4186-41e6-8e70-f9cb3065551a	32920bfb-a28c-4cfd-a30f-b78eb1320d81
0	66	66	Plazi	ffb07bec-2d10-492d-9c37-361fe0b79427	3669fe97-cacf-4a21-9932-f12193361e7d
0	20	20	Korean Biodiversity Information Facility	e0a1e772-0177-4800-94b4-2d023fe6cdf4	37376471-0976-468b-b07e-b1d6be7f1f8f
18601	19172	571	U.S. Geological Survey	8618c64a-93e0-4300-b546-7249e5148ed2	38df3ef2-72ea-4341-aad1-c67ac7c9f8b3
0	75	75	Ocean Biodiversity Information System	ba0670b9-4186-41e6-8e70-f9cb3065551a	3b3cd34a-39c1-4fd9-8a1c-a22eb81161e0
783	783	0	GBIF France	da44cd31-5901-4687-a106-6d1c7734ee3a	3bde2e3a-5c24-419f-9ead-86081c9788b2
0	61	61	Plazi	ffb07bec-2d10-492d-9c37-361fe0b79427	3ec27add-200f-4d9f-9fd3-a46ed282720a
1556	1814	258	GBIF Germany	4f6826f2-4ff6-443d-b966-e6913bd24013	42749746-3a0c-11e2-b0ce-00145eb45e9a
641	641	0	GBIF Japan	db5705aa-6a6e-42f1-8942-d77b9f4896ea	44481e05-53f7-41e6-b002-b70933dfa921
2612	2612	0	U.S. Geological Survey	8618c64a-93e0-4300-b546-7249e5148ed2	472a9647-bca4-4975-a5c4-613d1064ea69
39	39	0	GBIF France	da44cd31-5901-4687-a106-6d1c7734ee3a	4809099f-17c1-4f0e-9831-f9a793a59b7c
0	89	89	Ocean Biodiversity Information System	ba0670b9-4186-41e6-8e70-f9cb3065551a	4c43cf24-2c8c-4ab1-b8a8-6f49cfdf3503
0	42	42	Ocean Biodiversity Information System	ba0670b9-4186-41e6-8e70-f9cb3065551a	4dc38839-8947-4ee8-b0ea-c20880b4314f
154	154	0	GBIF France	da44cd31-5901-4687-a106-6d1c7734ee3a	4eaec54e-556d-465c-8525-31fdf978f252
7399	7399	0	National Biodiversity Network	d897a5b9-35ee-4232-94bd-b0bcaac003c2	4f5988d1-0550-4680-84ae-c8a005fe2e6e
0	6305	6305	Canada Biodiversity Information Facility	8f83fc96-c966-4126-83f7-bf044dc49efa	5206260d-8e9c-45f3-a1d9-89e2d4a5a5b7
625	625	0	GBIF France	da44cd31-5901-4687-a106-6d1c7734ee3a	52abccd3-3a4a-4a04-98d2-1e9f8b2ece18
5	5	0	Plazi	ffb07bec-2d10-492d-9c37-361fe0b79427	534da4e0-2064-4098-93c2-1f614aef9d2e
0	5	5	Plazi	ffb07bec-2d10-492d-9c37-361fe0b79427	545af53d-7f24-4445-be19-8da7966398d8
12	12	0	Plazi	ffb07bec-2d10-492d-9c37-361fe0b79427	568a5364-52f2-4feb-b08b-87eb85d4cf77
11198	11200	2	U.S. Geological Survey	8618c64a-93e0-4300-b546-7249e5148ed2	56caf05f-1364-4f24-85f6-0c82520c2792
134	134	0	GBIF France	da44cd31-5901-4687-a106-6d1c7734ee3a	57c13d88-1062-4f17-be90-8b7fedfe09c4
1	1	0	GBIF Germany	4f6826f2-4ff6-443d-b966-e6913bd24013	587c2944-a368-4e65-948a-a2c2f067865a
0	11	11	Plazi	ffb07bec-2d10-492d-9c37-361fe0b79427	60ef5d5f-d190-4ac7-a862-2a3d52298448
551	551	0	Plazi	ffb07bec-2d10-492d-9c37-361fe0b79427	6110e21e-b367-41ab-98f4-14b4b437c1c3
126	126	0	GBIF Germany	4f6826f2-4ff6-443d-b966-e6913bd24013	6285a350-f762-11e1-a439-00145eb45e9a
23	23	0	GBIF Germany	4f6826f2-4ff6-443d-b966-e6913bd24013	62cd3db4-f762-11e1-a439-00145eb45e9a
19	19	0	Ocean Biodiversity Information System	ba0670b9-4186-41e6-8e70-f9cb3065551a	6340b935-a382-455c-9588-30f46d9b021a
511	511	0	GBIF Spain	1f94b3ca-9345-4d65-afe2-4bace93aa0fe	6361dbf4-f762-11e1-a439-00145eb45e9a
15	15	0	GBIF Germany	4f6826f2-4ff6-443d-b966-e6913bd24013	63792b10-f762-11e1-a439-00145eb45e9a
643	643	0	GBIF Germany	4f6826f2-4ff6-443d-b966-e6913bd24013	64f6860e-f762-11e1-a439-00145eb45e9a
29	27	-2	GBIF Germany	4f6826f2-4ff6-443d-b966-e6913bd24013	65cf015a-f762-11e1-a439-00145eb45e9a
184	184	0	GBIF Germany	4f6826f2-4ff6-443d-b966-e6913bd24013	69e04204-f762-11e1-a439-00145eb45e9a
91	91	0	Plazi	ffb07bec-2d10-492d-9c37-361fe0b79427	6a6ca226-8343-4208-8cdb-f0bd627c3817
28	28	0	GBIF Germany	4f6826f2-4ff6-443d-b966-e6913bd24013	6b521054-f762-11e1-a439-00145eb45e9a
18	18	0	GBIF Germany	4f6826f2-4ff6-443d-b966-e6913bd24013	6b976366-f762-11e1-a439-00145eb45e9a
16	16	0	GBIF Germany	4f6826f2-4ff6-443d-b966-e6913bd24013	6bcdd1bc-f762-11e1-a439-00145eb45e9a
32	32	0	GBIF Germany	4f6826f2-4ff6-443d-b966-e6913bd24013	6c8767c6-f762-11e1-a439-00145eb45e9a
39	39	0	GBIF Germany	4f6826f2-4ff6-443d-b966-e6913bd24013	6ca10cd0-f762-11e1-a439-00145eb45e9a
23	23	0	GBIF Germany	4f6826f2-4ff6-443d-b966-e6913bd24013	6ca27020-f762-11e1-a439-00145eb45e9a
0	9	9	Plazi	ffb07bec-2d10-492d-9c37-361fe0b79427	6e894d08-6a6d-4160-b96e-0e05d3e76656
2	2	0	Plazi	ffb07bec-2d10-492d-9c37-361fe0b79427	6f4e1328-0bba-4f1c-aa66-4c1fe1fda040
4	4	0	GBIF Germany	4f6826f2-4ff6-443d-b966-e6913bd24013	708602c4-f762-11e1-a439-00145eb45e9a
144	144	0	Colombian Biodiversity Information System	7e865cba-7c46-417b-ade5-97f2cf5b7be0	7091e586-9021-4db2-99f8-316bc0af0719
82	70	-12	GBIF Germany	4f6826f2-4ff6-443d-b966-e6913bd24013	70d61aac-f762-11e1-a439-00145eb45e9a
128	128	0	GBIF Germany	4f6826f2-4ff6-443d-b966-e6913bd24013	710022b6-f762-11e1-a439-00145eb45e9a
306	306	0	GBIF Germany	4f6826f2-4ff6-443d-b966-e6913bd24013	7106012c-f762-11e1-a439-00145eb45e9a
3	3	0	Plazi	ffb07bec-2d10-492d-9c37-361fe0b79427	711a9580-5001-45c4-a403-7d382204da6b
26	26	0	GBIF Argentina	2426a871-9feb-40a1-96c6-0c593a76b835	715ca2a5-45cf-4ec3-b25c-f01629ee81e8
2577	2577	0	Colombian Biodiversity Information System	7e865cba-7c46-417b-ade5-97f2cf5b7be0	71a0da97-201f-4fee-982a-d138e21a0ecb
13	13	0	GBIF Germany	4f6826f2-4ff6-443d-b966-e6913bd24013	73942d2e-f762-11e1-a439-00145eb45e9a
11	11	0	GBIF Germany	4f6826f2-4ff6-443d-b966-e6913bd24013	74d11382-f762-11e1-a439-00145eb45e9a
72	72	0	GBIF Germany	4f6826f2-4ff6-443d-b966-e6913bd24013	74fc8e4a-f762-11e1-a439-00145eb45e9a
263	263	0	GBIF Germany	4f6826f2-4ff6-443d-b966-e6913bd24013	7500ba4c-f762-11e1-a439-00145eb45e9a
219	219	0	Belgian Biodiversity Platform	fb11cfe1-ebc3-45af-9159-17d9fddbcdac	75b24085-7b34-49dc-a49f-f1b007ab04d9
125	125	0	GBIF Germany	4f6826f2-4ff6-443d-b966-e6913bd24013	75c22ede-f762-11e1-a439-00145eb45e9a
67	67	0	Plazi	ffb07bec-2d10-492d-9c37-361fe0b79427	76924ecc-2833-4231-97e9-fcbaf6bfcda7
61	61	0	GBIF Finland	dd514216-5c7c-45f3-910d-797424cb5be6	76f4128f-b941-425e-9f38-24035703c47b
712	712	0	GBIF France	da44cd31-5901-4687-a106-6d1c7734ee3a	76f923c6-dbfe-4e7c-a487-805de68f8645
26	26	0	Colombian Biodiversity Information System	7e865cba-7c46-417b-ade5-97f2cf5b7be0	79b0c0db-671b-4012-ba29-e2b81e97806e
5	5	0	Plazi	ffb07bec-2d10-492d-9c37-361fe0b79427	7a877f23-71c7-47cf-b4fe-e133cbcfb0f0
184	184	0	GBIF Germany	4f6826f2-4ff6-443d-b966-e6913bd24013	7acbe49e-9770-40fa-b6be-3c1474917b91
911	911	0	Colombian Biodiversity Information System	7e865cba-7c46-417b-ade5-97f2cf5b7be0	7b11366b-e966-4b74-b414-0313bdf358fe
14	14	0	Plazi	ffb07bec-2d10-492d-9c37-361fe0b79427	7b208096-3c50-4855-98c8-adbf0bb0902d
14	14	0	Plazi	ffb07bec-2d10-492d-9c37-361fe0b79427	7b8aa892-302a-4d30-903a-42f9b537385b
385	373	-12	GBIF Germany	4f6826f2-4ff6-443d-b966-e6913bd24013	7bf9486e-f762-11e1-a439-00145eb45e9a
374	374	0	GBIF Germany	4f6826f2-4ff6-443d-b966-e6913bd24013	7d19b3be-f762-11e1-a439-00145eb45e9a
14	14	0	GBIF Germany	4f6826f2-4ff6-443d-b966-e6913bd24013	7dfab09e-f762-11e1-a439-00145eb45e9a
1701	1723	22	GBIF Germany	4f6826f2-4ff6-443d-b966-e6913bd24013	7ee41b08-f762-11e1-a439-00145eb45e9a
0	4	4	Plazi	ffb07bec-2d10-492d-9c37-361fe0b79427	7f3eb1f2-1c6f-4ca0-bdba-d393072794df
1371	1371	0	Participant Node Managers Committee	7f48e0c8-5c96-49ec-b972-30748e339115	7fac0837-4607-4402-a936-c7021f1ea788
1500	1500	0	GBIF Japan	db5705aa-6a6e-42f1-8942-d77b9f4896ea	80d94b5e-f762-11e1-a439-00145eb45e9a
34	34	0	GBIF Germany	4f6826f2-4ff6-443d-b966-e6913bd24013	8179a75c-f762-11e1-a439-00145eb45e9a
4	4	0	GBIF Germany	4f6826f2-4ff6-443d-b966-e6913bd24013	81bc76ae-f762-11e1-a439-00145eb45e9a
421	376	-45	GBIF Germany	4f6826f2-4ff6-443d-b966-e6913bd24013	81f08bd8-f762-11e1-a439-00145eb45e9a
73544	73544	0	Canada Biodiversity Information Facility	8f83fc96-c966-4126-83f7-bf044dc49efa	82d0e9e4-f762-11e1-a439-00145eb45e9a
544	544	0	National Biodiversity Network	d897a5b9-35ee-4232-94bd-b0bcaac003c2	82dc3f24-1977-44ad-88fa-1d2298d22003
2	2	0	Plazi	ffb07bec-2d10-492d-9c37-361fe0b79427	8325d33c-6141-4b3d-a6d4-1804926c81f0
11209	76047	64838	GBIF Portugal	673f7038-4262-4149-b753-5658a4e912f6	835ac57e-f762-11e1-a439-00145eb45e9a
26	26	0	Ocean Biodiversity Information System	ba0670b9-4186-41e6-8e70-f9cb3065551a	83ad4862-f762-11e1-a439-00145eb45e9a
108704	113559	4855	Atlas of Living Australia	4a6f1b71-969e-4fc5-a693-282b05e1220c	84a649ce-ff81-420d-9c41-aa1de59e3766
2817	2817	0	GBIF France	da44cd31-5901-4687-a106-6d1c7734ee3a	86f3853e-9e70-4b08-a52a-b7b58cd1ced6
436	309	-127	GBIF Germany	4f6826f2-4ff6-443d-b966-e6913bd24013	87deef6c-f762-11e1-a439-00145eb45e9a
213	186	-27	GBIF Germany	4f6826f2-4ff6-443d-b966-e6913bd24013	883c8b4a-f762-11e1-a439-00145eb45e9a
8974	8974	0	GBIF France	da44cd31-5901-4687-a106-6d1c7734ee3a	88cd034f-34a5-4a52-990d-78e085832ece
1	1	0	Plazi	ffb07bec-2d10-492d-9c37-361fe0b79427	8901e0e4-c1b9-40ae-8e82-39deebd598d2
18699	18699	0	U.S. Geological Survey	8618c64a-93e0-4300-b546-7249e5148ed2	8a1073ce-54a4-4712-89a6-e14d82836d9e
127	127	0	GBIF Germany	4f6826f2-4ff6-443d-b966-e6913bd24013	8a1b43e8-f762-11e1-a439-00145eb45e9a
117	117	0	Colombian Biodiversity Information System	7e865cba-7c46-417b-ade5-97f2cf5b7be0	8a3a9ea5-6247-411d-8df3-c72f6ac30c40
42	42	0	GBIF Germany	4f6826f2-4ff6-443d-b966-e6913bd24013	8c485b74-f762-11e1-a439-00145eb45e9a
2646	1666	-980	GBIF Germany	4f6826f2-4ff6-443d-b966-e6913bd24013	8d84b6cc-f762-11e1-a439-00145eb45e9a
538	401	-137	GBIF Germany	4f6826f2-4ff6-443d-b966-e6913bd24013	8e5a642a-f762-11e1-a439-00145eb45e9a
390	314	-76	GBIF Germany	4f6826f2-4ff6-443d-b966-e6913bd24013	9011ee28-f762-11e1-a439-00145eb45e9a
0	7	7	Plazi	ffb07bec-2d10-492d-9c37-361fe0b79427	91354319-27a8-4bdb-86af-857c5affbe76
1	1	0	Plazi	ffb07bec-2d10-492d-9c37-361fe0b79427	926b493e-d5c4-4dd8-a2c3-9853ea92aad8
209	116	-93	GBIF Germany	4f6826f2-4ff6-443d-b966-e6913bd24013	92e77b22-f762-11e1-a439-00145eb45e9a
1824	1824	0	GBIF Germany	4f6826f2-4ff6-443d-b966-e6913bd24013	9427e49a-f762-11e1-a439-00145eb45e9a
8	8	0	Plazi	ffb07bec-2d10-492d-9c37-361fe0b79427	9434ce3f-b243-4379-9137-90c77646a55b
0	50	50	Plazi	ffb07bec-2d10-492d-9c37-361fe0b79427	94b08d35-6b09-411b-94b8-2e3a0d10c373
1	1	0	Plazi	ffb07bec-2d10-492d-9c37-361fe0b79427	94e6a8fb-99a9-4bce-b79a-b716e1b04823
290	286	-4	GBIF Germany	4f6826f2-4ff6-443d-b966-e6913bd24013	953933de-f762-11e1-a439-00145eb45e9a
216	216	0	GBIF Germany	4f6826f2-4ff6-443d-b966-e6913bd24013	958a9a8a-f762-11e1-a439-00145eb45e9a
14	14	0	Plazi	ffb07bec-2d10-492d-9c37-361fe0b79427	9682b45b-5e22-4965-a293-e203660e0ed3
1197	1197	0	Ocean Biodiversity Information System	ba0670b9-4186-41e6-8e70-f9cb3065551a	96b47887-8acb-41e9-909d-58bf9c83fd44
0	55	55	Ocean Biodiversity Information System	ba0670b9-4186-41e6-8e70-f9cb3065551a	9d7f3239-3594-4275-a2e1-5b258d583dae
864	864	0	Biodiversity Information System of Mexico	b324e8e9-9a4c-44fa-8f1a-7f39ea7ab576	9e05b673-ef49-442f-874c-633433acb972
8	8	0	Plazi	ffb07bec-2d10-492d-9c37-361fe0b79427	a5b595b8-8f98-4ff7-9882-44d2aeeb8a4d
0	163	163	Plazi	ffb07bec-2d10-492d-9c37-361fe0b79427	a6f10916-99f2-4d28-8fe6-cf38cde04291
505	505	0	GBIF Benin	efb9c00e-f802-45dd-8826-a52ec45b89ff	a991bb19-63ac-4985-8fe1-e2bd7f4d6f58
0	66	66	Plazi	ffb07bec-2d10-492d-9c37-361fe0b79427	ab615a5f-4aa3-4d62-88dd-a05e7c613727
0	4	4	Plazi	ffb07bec-2d10-492d-9c37-361fe0b79427	af1d4768-dd24-484d-8ad6-a7fe1d300e12
424	424	0	Plazi	ffb07bec-2d10-492d-9c37-361fe0b79427	b0e41b14-7810-464d-9b1b-322bab9aa1bc
3606	3413	-193	Biodiversity Information System of Mexico	b324e8e9-9a4c-44fa-8f1a-7f39ea7ab576	b22656ab-91c5-43ee-b07e-11c58c391e21
132	132	0	Society for the Management of Electronic Biodiversity Data	97818ee4-1461-4180-bf1d-b3201050124f	b267ac9b-6516-458e-bea7-7643842187f7
1566	1566	0	National Biodiversity Network	d897a5b9-35ee-4232-94bd-b0bcaac003c2	b6a37bbd-95d2-4c5e-8b9e-3fbefd8bd8cd
3	3	0	Plazi	ffb07bec-2d10-492d-9c37-361fe0b79427	bbd60b0f-72c5-4670-97ac-7b29ef61a19b
1158	1158	0	Ghana Biodiversity Information Facility	b5633b75-6a86-4fdf-9cfc-506047fb9dc7	bf41b935-afd9-4ef5-8301-447841169eb2
0	23	23	Plazi	ffb07bec-2d10-492d-9c37-361fe0b79427	c2f8c695-2547-468b-b048-76c4ef60fa58
0	152886	152886	GBIF Switzerland	169eb292-376b-4cc6-8e31-9c2c432de0ad	c597d497-6659-4d4b-bb79-40b9fd528f38
4002	4002	0	Colombian Biodiversity Information System	7e865cba-7c46-417b-ade5-97f2cf5b7be0	cb356ce5-d4d8-4785-baa9-5fd2182e57f8
1	1	0	Plazi	ffb07bec-2d10-492d-9c37-361fe0b79427	d12c21d6-1cae-4ce8-bb72-4337dab30187
4	4	0	Plazi	ffb07bec-2d10-492d-9c37-361fe0b79427	d2ead34b-03f2-45e2-beb9-63c59f6a21cb
7	7	0	Plazi	ffb07bec-2d10-492d-9c37-361fe0b79427	d43023df-25d2-40d6-b749-5132add2f834
112	112	0	GBIF France	da44cd31-5901-4687-a106-6d1c7734ee3a	d4a9c5ab-ef5f-4330-9ba6-c3ed207dd27d
2	2	0	Plazi	ffb07bec-2d10-492d-9c37-361fe0b79427	d5897ff7-4917-47c6-9bed-91c1e3f431fd
2660	2660	0	GBIF Benin	efb9c00e-f802-45dd-8826-a52ec45b89ff	d6d71532-ee3a-4fc9-ae84-0d5505913dd0
20187	20187	0	Netherlands Biodiversity Information Facility	0909d601-bda2-42df-9e63-a6d51847ebce	d89cb35d-83db-47fa-8110-6649c269b380
121	121	0	GBIF France	da44cd31-5901-4687-a106-6d1c7734ee3a	d89cbd60-bb15-41e3-9706-911a37f8c6a6
2341	2341	0	National Biodiversity Network	d897a5b9-35ee-4232-94bd-b0bcaac003c2	da23c0cd-312a-46c2-9da6-c29f21b4bf79
292	292	0	Plazi	ffb07bec-2d10-492d-9c37-361fe0b79427	db9559f4-2f76-4e07-8ae5-03f0f8e5ad3a
6	6	0	Plazi	ffb07bec-2d10-492d-9c37-361fe0b79427	dd21d221-f27d-47bd-8554-476789c3550a
89	89	0	GBIF Japan	db5705aa-6a6e-42f1-8942-d77b9f4896ea	e03c0e51-f68e-4467-9f20-e6437c422c17
13	13	0	Plazi	ffb07bec-2d10-492d-9c37-361fe0b79427	e3adbec8-2861-49f8-b7a2-39f1bdcbb493
18	18	0	Plazi	ffb07bec-2d10-492d-9c37-361fe0b79427	e9aedf82-425f-4a63-a134-35c2aa6811be
794	794	0	National Biodiversity Network	d897a5b9-35ee-4232-94bd-b0bcaac003c2	ebce2473-2911-4b9b-b8bb-364a99bdc478
307	391	84	Biodiversity Information System of Mexico	b324e8e9-9a4c-44fa-8f1a-7f39ea7ab576	ed80a247-379f-4286-a348-63da32c9c047
268	268	0	Participant Node Managers Committee	7f48e0c8-5c96-49ec-b972-30748e339115	ee928289-699e-46e2-911a-6eafe133745b
154	154	0	GBIF Germany	4f6826f2-4ff6-443d-b966-e6913bd24013	eec08186-f4b6-40c4-9314-d0868f3795e7
62	62	0	Plazi	ffb07bec-2d10-492d-9c37-361fe0b79427	eeec8306-8c71-4db6-834a-c70396d43a82
7	7	0	Plazi	ffb07bec-2d10-492d-9c37-361fe0b79427	f0106ae9-b2bc-4e28-905e-2653f8f0cbd3
309	309	0	Plazi	ffb07bec-2d10-492d-9c37-361fe0b79427	f104b001-83c7-467b-89b1-91ff76779234
49	49	0	Ocean Biodiversity Information System	ba0670b9-4186-41e6-8e70-f9cb3065551a	f1f64446-0980-4980-a4f0-fd56ff6e22d4
4	4	0	Plazi	ffb07bec-2d10-492d-9c37-361fe0b79427	f36314b8-a9a6-4bd2-8704-8923013c22b7
6394	6394	0	GBIF Argentina	2426a871-9feb-40a1-96c6-0c593a76b835	f46c2ce0-8853-4c93-9922-63f850413809
93551	94968	1417	GBIF Japan	db5705aa-6a6e-42f1-8942-d77b9f4896ea	f47b0035-fc20-4ac1-905a-e0b79a1383d7
2	2	0	Plazi	ffb07bec-2d10-492d-9c37-361fe0b79427	f4a76226-caa9-44f3-8597-bdfb557a8ecb
1562	1787	225	Colombian Biodiversity Information System	7e865cba-7c46-417b-ade5-97f2cf5b7be0	f5ba6fec-046f-465c-b67c-68a3f86187b0
0	10	10	Plazi	ffb07bec-2d10-492d-9c37-361fe0b79427	f640780d-6db4-4317-95a0-6dec436148be
170	170	0	Plazi	ffb07bec-2d10-492d-9c37-361fe0b79427	f6d10cdc-bd71-4def-852f-665ce918e2f3
0	22	22	Ocean Biodiversity Information System	ba0670b9-4186-41e6-8e70-f9cb3065551a	fb1ce448-f136-4491-99cf-706fe74c7393
107333	107333	0	GBIF France	da44cd31-5901-4687-a106-6d1c7734ee3a	fb257244-7e61-4a6c-b097-54963ca5b7af
0	145	145	Plazi	ffb07bec-2d10-492d-9c37-361fe0b79427	fbc6b44f-4c5e-481a-8073-8a809b4a3819
0	9	9	Plazi	ffb07bec-2d10-492d-9c37-361fe0b79427	fc7b0f87-bad7-4509-9bea-7d922a8abed3
7	7	0	Plazi	ffb07bec-2d10-492d-9c37-361fe0b79427	fd188877-1767-43a2-8546-2c28c764d266
12	12	0	GBIF Finland	dd514216-5c7c-45f3-910d-797424cb5be6	fd9b0081-6770-4fea-a6f1-f0c3e0448940
4	4	0	Plazi	ffb07bec-2d10-492d-9c37-361fe0b79427	feb36cfe-9304-4d55-9b28-d3be4603592d
4	4	0	Plazi	ffb07bec-2d10-492d-9c37-361fe0b79427	0326ff69-8838-4577-a02f-7d07b341d0db
880	880	0	GBIF France	da44cd31-5901-4687-a106-6d1c7734ee3a	0368db19-ea27-403e-9095-95c068de9946
46	46	0	Secretariat of the Pacific Regional Environment Programme	29c6a139-ea7f-41f5-8d9b-c55af8736182	07a576ce-f6b0-4f1f-bf66-670e4f63f9b5
147	147	0	Indonesian Biodiversity Information Facility	2ebd91f6-f14f-4375-b525-c011a3774f03	09a6c040-a452-4f8f-b32b-d7762aa6bc85
0	4	4	Plazi	ffb07bec-2d10-492d-9c37-361fe0b79427	0a47a799-f3b0-461f-a4a2-42bd20fdc420
0	1244	1244	Ocean Biodiversity Information System	ba0670b9-4186-41e6-8e70-f9cb3065551a	0c850c93-615a-4820-87cc-2cb3964104a6
220937	220937	0	U.S. Geological Survey	8618c64a-93e0-4300-b546-7249e5148ed2	0c9234fb-f87c-4608-8ec8-0cc8a1f93079
50	50	0	National Biodiversity Network	d897a5b9-35ee-4232-94bd-b0bcaac003c2	0d3d9ae1-a1bf-4d85-b72f-4b38389fdb1e
325	325	0	National Biodiversity Network	d897a5b9-35ee-4232-94bd-b0bcaac003c2	0f56906c-30d6-48e0-a39f-65823c2d5f96
688	688	0	GBIF Spain	1f94b3ca-9345-4d65-afe2-4bace93aa0fe	11cfbde1-bb23-4937-bc98-7aa83d61efe0
3	3	0	Plazi	ffb07bec-2d10-492d-9c37-361fe0b79427	120c3942-9462-4479-9afb-e25ece8bcc34
246	246	0	GBIF France	da44cd31-5901-4687-a106-6d1c7734ee3a	128bc4ad-fc5c-44c2-8005-a1768f587704
657	657	0	GBIF Japan	db5705aa-6a6e-42f1-8942-d77b9f4896ea	15525510-6eeb-4e98-b07f-7dce28a90940
10	10	0	Plazi	ffb07bec-2d10-492d-9c37-361fe0b79427	1668e9e1-3403-41ba-b482-c4d86a612d43
9	9	0	GBIF France	da44cd31-5901-4687-a106-6d1c7734ee3a	169dd0b9-defe-403a-86e2-704a18a7f72b
27139	41162	14023	National Biodiversity Network	d897a5b9-35ee-4232-94bd-b0bcaac003c2	17ea10b4-1ef2-42ba-9cb1-b38937dd15b9
105	105	0	GBIF Brazil	cdc9736d-5ff7-4ece-9959-3c744360cdb3	17ea2567-f0a9-4cab-b7d2-124b9455b23e
0	81	81	Ocean Biodiversity Information System	ba0670b9-4186-41e6-8e70-f9cb3065551a	19e53aac-b41d-49e1-8763-863a92659df6
10	10	0	Plazi	ffb07bec-2d10-492d-9c37-361fe0b79427	1a228008-86f6-4ef1-aa12-28370f86cba0
245755	246266	511	U.S. Geological Survey	8618c64a-93e0-4300-b546-7249e5148ed2	1edd3c3f-cfd7-4fd5-bfba-2c67737a17ba
1566	1566	0	Colombian Biodiversity Information System	7e865cba-7c46-417b-ade5-97f2cf5b7be0	2196fd54-22a3-406e-8480-cbee25349024
49	49	0	Plazi	ffb07bec-2d10-492d-9c37-361fe0b79427	272ec605-68b4-400b-9461-99dcc8a60e32
22086	22086	0	Participant Node Managers Committee	7f48e0c8-5c96-49ec-b972-30748e339115	29e78377-34c3-4c91-8062-550069a92b70
168	168	0	Plazi	ffb07bec-2d10-492d-9c37-361fe0b79427	2cd7e95f-232f-44b1-8981-ca0cda569d2d
0	8	8	Plazi	ffb07bec-2d10-492d-9c37-361fe0b79427	2d098578-14da-437c-b5a1-a6b658ca1df4
2880	2880	0	GBIF Norway	4f829580-180d-46a9-9c87-ed8ec959b545	2d4d4edb-4a78-4855-909e-56dd4c6dfe38
0	2	2	Plazi	ffb07bec-2d10-492d-9c37-361fe0b79427	2d7003e5-498f-4fa8-92df-6c407fd18953
55	55	0	National Biodiversity Data Centre	422b00b2-6c94-4bb6-976b-c359916efdb8	2d9bfae9-789c-4a05-954b-ac9e28d0e395
254	254	0	Plazi	ffb07bec-2d10-492d-9c37-361fe0b79427	2dac93f3-40be-45f8-ba84-10026f56a001
0	18	18	Plazi	ffb07bec-2d10-492d-9c37-361fe0b79427	300ad198-2377-4bfd-9381-6868ee9c5f7a
1297	1297	0	GBIF France	da44cd31-5901-4687-a106-6d1c7734ee3a	31fa7438-297c-4d4c-897b-668c9a921d72
0	33	33	Plazi	ffb07bec-2d10-492d-9c37-361fe0b79427	341ea68c-5c47-4f13-b336-66e82e38c746
0	199	199	GBIF France	da44cd31-5901-4687-a106-6d1c7734ee3a	345820cc-a0a8-4d76-b7eb-fba85b21ad08
72	72	0	GBIF France	da44cd31-5901-4687-a106-6d1c7734ee3a	367b0998-8c40-4f87-bd38-d584bfabc2dd
1085	1085	0	National Biodiversity Network	d897a5b9-35ee-4232-94bd-b0bcaac003c2	3813b43e-09a9-401b-b748-649e9dfa9390
20	20	0	Colombian Biodiversity Information System	7e865cba-7c46-417b-ade5-97f2cf5b7be0	3b3da5d5-6fe1-4703-a8d7-5487d7b98610
0	810	810	Korean Biodiversity Information Facility	e0a1e772-0177-4800-94b4-2d023fe6cdf4	3dbf91b1-83db-4298-9d68-5f5f2eda850c
4	4	0	Plazi	ffb07bec-2d10-492d-9c37-361fe0b79427	40356ac5-27a8-4916-8018-2fc9d1260da0
3	3	0	Plazi	ffb07bec-2d10-492d-9c37-361fe0b79427	40e5b73d-8f64-4aa3-9b8f-2a748fd7a57f
0	896	896	Taiwan Biodiversity Information Facility	e1b85abc-61f9-430f-ba79-6813dec53a0f	42b98a7f-4252-42a0-a56e-069df3eb3a7d
7117	7117	0	GBIF Germany	4f6826f2-4ff6-443d-b966-e6913bd24013	44c26867-9738-4ac5-9213-f612b0ef3197
0	2	2	Plazi	ffb07bec-2d10-492d-9c37-361fe0b79427	45e0daa3-0642-49b8-ac62-6200ab72044f
5	5	0	Plazi	ffb07bec-2d10-492d-9c37-361fe0b79427	45efc168-d000-484b-872c-d37a5d901e12
55	57	2	GBIF Germany	4f6826f2-4ff6-443d-b966-e6913bd24013	4683344b-98d3-4bbb-a069-45c293d554cb
682	682	0	Participant Node Managers Committee	7f48e0c8-5c96-49ec-b972-30748e339115	47bfdc62-3b00-448d-989d-548c2ce848bd
0	270	270	Plazi	ffb07bec-2d10-492d-9c37-361fe0b79427	480f83cb-dbbe-4f6f-a047-c595a1304dc8
0	1	1	Plazi	ffb07bec-2d10-492d-9c37-361fe0b79427	497b29a8-1c02-469b-9c7b-e17602e733aa
91	91	0	Plazi	ffb07bec-2d10-492d-9c37-361fe0b79427	49eab955-d6ae-4253-bae3-ab650f77fcfc
0	3699	3699	Biodiversity Information System of Mexico	b324e8e9-9a4c-44fa-8f1a-7f39ea7ab576	4f39e882-046d-49e7-a7c0-d9e27de127df
12	12	0	Plazi	ffb07bec-2d10-492d-9c37-361fe0b79427	552d48b3-0f41-47c3-a9f6-5ce761af8f8a
0	3	3	Plazi	ffb07bec-2d10-492d-9c37-361fe0b79427	567d9ce0-80cd-426c-9be0-7035fd3ecdab
4203	4203	0	Participant Node Managers Committee	7f48e0c8-5c96-49ec-b972-30748e339115	5986dda7-803e-4ccb-b6db-43933e27751d
1914	1914	0	GBIF France	da44cd31-5901-4687-a106-6d1c7734ee3a	598c2228-f727-4eae-b7fa-592395cad8c6
4	4	0	Plazi	ffb07bec-2d10-492d-9c37-361fe0b79427	5a8f136f-108b-4b40-b2e5-2b5b87c908e3
3	3	0	Plazi	ffb07bec-2d10-492d-9c37-361fe0b79427	5b83e957-1037-49a7-bbee-c38f0e15733d
8120	8120	0	GBIF Germany	4f6826f2-4ff6-443d-b966-e6913bd24013	5e6ae014-b62f-11e2-afcb-00145eb45e9a
0	63	63	Plazi	ffb07bec-2d10-492d-9c37-361fe0b79427	604b1288-103e-4bb8-bd90-6f77b653dada
122	122	0	GBIF Germany	4f6826f2-4ff6-443d-b966-e6913bd24013	610b29c8-f762-11e1-a439-00145eb45e9a
24592	27211	2619	National Biodiversity Network	d897a5b9-35ee-4232-94bd-b0bcaac003c2	61313732-a660-4fdf-9cfb-0d13d4553bbe
69	69	0	GBIF Germany	4f6826f2-4ff6-443d-b966-e6913bd24013	613d7628-5176-4da7-b11b-49a2c631cad5
138	138	0	GBIF Germany	4f6826f2-4ff6-443d-b966-e6913bd24013	619a472a-f762-11e1-a439-00145eb45e9a
85	85	0	GBIF Germany	4f6826f2-4ff6-443d-b966-e6913bd24013	61b96218-f762-11e1-a439-00145eb45e9a
233	233	0	GBIF Germany	4f6826f2-4ff6-443d-b966-e6913bd24013	621e5a10-f762-11e1-a439-00145eb45e9a
133	133	0	Plazi	ffb07bec-2d10-492d-9c37-361fe0b79427	62552028-dd96-4a85-bd83-5e86bd957be4
8	8	0	Plazi	ffb07bec-2d10-492d-9c37-361fe0b79427	6272d31a-3400-4463-a2cd-ab66f124e643
48	48	0	GBIF Germany	4f6826f2-4ff6-443d-b966-e6913bd24013	62ea62d6-f762-11e1-a439-00145eb45e9a
1	1	0	GBIF Germany	4f6826f2-4ff6-443d-b966-e6913bd24013	6319141e-f762-11e1-a439-00145eb45e9a
84	84	0	GBIF Germany	4f6826f2-4ff6-443d-b966-e6913bd24013	63b4f4c4-f762-11e1-a439-00145eb45e9a
1	1	0	Plazi	ffb07bec-2d10-492d-9c37-361fe0b79427	63e43da4-3022-464e-9bd3-ab8ef1bd20f6
120	120	0	GBIF Germany	4f6826f2-4ff6-443d-b966-e6913bd24013	63e9df90-f762-11e1-a439-00145eb45e9a
0	2642	2642	Participant Node Managers Committee	7f48e0c8-5c96-49ec-b972-30748e339115	6410496e-930b-403f-a7a6-d6fd25a6a258
5	5	0	Plazi	ffb07bec-2d10-492d-9c37-361fe0b79427	6413936e-f3c6-4582-a979-85548f453113
12	12	0	GBIF Germany	4f6826f2-4ff6-443d-b966-e6913bd24013	649b99c4-f762-11e1-a439-00145eb45e9a
442	429	-13	GBIF Germany	4f6826f2-4ff6-443d-b966-e6913bd24013	6569972a-f762-11e1-a439-00145eb45e9a
0	10	10	Participant Node Managers Committee	7f48e0c8-5c96-49ec-b972-30748e339115	65b42544-2cdd-408e-b657-7f986db0f654
152	152	0	GBIF Germany	4f6826f2-4ff6-443d-b966-e6913bd24013	6655baec-f762-11e1-a439-00145eb45e9a
96	96	0	GBIF Germany	4f6826f2-4ff6-443d-b966-e6913bd24013	68aef754-f762-11e1-a439-00145eb45e9a
40	40	0	GBIF Germany	4f6826f2-4ff6-443d-b966-e6913bd24013	69133502-f762-11e1-a439-00145eb45e9a
142	142	0	GBIF Germany	4f6826f2-4ff6-443d-b966-e6913bd24013	69d8a1e8-f762-11e1-a439-00145eb45e9a
40	40	0	GBIF Germany	4f6826f2-4ff6-443d-b966-e6913bd24013	6aabd964-f762-11e1-a439-00145eb45e9a
252	252	0	GBIF Guinea	b1cd2e84-c4ba-47bd-b72a-dfd1f92dce0a	6cc96790-9e4b-4cf7-b3ce-b7df987e8eb8
372	372	0	GBIF Germany	4f6826f2-4ff6-443d-b966-e6913bd24013	6d2fdc62-f762-11e1-a439-00145eb45e9a
0	1	1	Plazi	ffb07bec-2d10-492d-9c37-361fe0b79427	70128aad-96db-4771-8e34-7b7960c43e3b
74	74	0	GBIF Germany	4f6826f2-4ff6-443d-b966-e6913bd24013	702ac242-f762-11e1-a439-00145eb45e9a
1	1	0	GBIF Japan	db5705aa-6a6e-42f1-8942-d77b9f4896ea	70497758-6c0f-4c25-b5ce-d1a448d088c6
0	8	8	Colombian Biodiversity Information System	7e865cba-7c46-417b-ade5-97f2cf5b7be0	70592d9c-4b83-4878-9e75-e1c3a1b7bc07
5915	5915	0	GBIF Spain	1f94b3ca-9345-4d65-afe2-4bace93aa0fe	71cfcf5c-f762-11e1-a439-00145eb45e9a
63	63	0	Plazi	ffb07bec-2d10-492d-9c37-361fe0b79427	729f8a90-e3f7-4262-826f-9849ccf2cf6f
3	3	0	Plazi	ffb07bec-2d10-492d-9c37-361fe0b79427	7333e6cb-d3ba-4ea1-b433-e597d69e0137
0	10	10	Plazi	ffb07bec-2d10-492d-9c37-361fe0b79427	74daff8d-fceb-4aab-a9c5-ee05fd3bce93
31	31	0	GBIF Germany	4f6826f2-4ff6-443d-b966-e6913bd24013	75151cb2-f762-11e1-a439-00145eb45e9a
0	1	1	Plazi	ffb07bec-2d10-492d-9c37-361fe0b79427	7695b8a9-d392-4a17-8755-af739677a469
1571794	1575113	3319	GBIF New Zealand	4f9fd726-20dd-445e-89a1-8ed93792276f	788439f0-3b56-11dc-8c19-b8a03c50a862
2085	2085	0	Colombian Biodiversity Information System	7e865cba-7c46-417b-ade5-97f2cf5b7be0	78daa98f-8351-48ba-b9ae-8ffa0a8d9560
3131	3113	-18	GBIF Germany	4f6826f2-4ff6-443d-b966-e6913bd24013	7a22e1e4-f762-11e1-a439-00145eb45e9a
1035	1035	0	GBIF Germany	4f6826f2-4ff6-443d-b966-e6913bd24013	7bb9991c-f762-11e1-a439-00145eb45e9a
2538	378	-2160	GBIF Germany	4f6826f2-4ff6-443d-b966-e6913bd24013	7bf1463c-f762-11e1-a439-00145eb45e9a
2257	1904	-353	GBIF Germany	4f6826f2-4ff6-443d-b966-e6913bd24013	7d64b80a-f762-11e1-a439-00145eb45e9a
792	792	0	GBIF Germany	4f6826f2-4ff6-443d-b966-e6913bd24013	7ddf5f92-f762-11e1-a439-00145eb45e9a
593	593	0	GBIF Germany	4f6826f2-4ff6-443d-b966-e6913bd24013	7de9da76-f762-11e1-a439-00145eb45e9a
0	7	7	Plazi	ffb07bec-2d10-492d-9c37-361fe0b79427	7ec4f551-f6a7-4dc4-a8cf-1c5a0a8a2eab
2	2	0	Plazi	ffb07bec-2d10-492d-9c37-361fe0b79427	7fbfd9ef-5c4b-4ab7-bbd6-6bf6fb443a52
0	97	97	Atlas of Living Australia	4a6f1b71-969e-4fc5-a693-282b05e1220c	7fd1bebe-942f-4cb3-ae10-8a29648e47cd
7376	7376	0	Biodiversity Information System of Mexico	b324e8e9-9a4c-44fa-8f1a-7f39ea7ab576	7fda37f4-f762-11e1-a439-00145eb45e9a
2111	2084	-27	Biodiversity Information System of Mexico	b324e8e9-9a4c-44fa-8f1a-7f39ea7ab576	80113592-f762-11e1-a439-00145eb45e9a
6	6	0	Biodiversity Information System of Mexico	b324e8e9-9a4c-44fa-8f1a-7f39ea7ab576	801efdc6-f762-11e1-a439-00145eb45e9a
81	81	0	Participant Node Managers Committee	7f48e0c8-5c96-49ec-b972-30748e339115	809f5ebf-c8ee-4182-851d-80cb2e72f1b9
731	731	0	DanBIF - Danish Biodiversity Information Facility	4ddd294f-02b7-4359-ac33-0806a9ca9c6b	816f6644-7a1d-4420-8396-63bfa9599fb0
2	2	0	Plazi	ffb07bec-2d10-492d-9c37-361fe0b79427	8364888f-cf86-47f4-b3cf-447277223dbf
11027	11027	0	GBIF Japan	db5705aa-6a6e-42f1-8942-d77b9f4896ea	84a05dc2-f762-11e1-a439-00145eb45e9a
5	5	0	Plazi	ffb07bec-2d10-492d-9c37-361fe0b79427	863379f6-862f-4feb-b517-2652284f72f1
238	238	0	Canada Biodiversity Information Facility	8f83fc96-c966-4126-83f7-bf044dc49efa	870c0c8b-79f5-482f-8110-8b99972c9450
3450	2974	-476	GBIF Germany	4f6826f2-4ff6-443d-b966-e6913bd24013	872b4426-f762-11e1-a439-00145eb45e9a
102	102	0	GBIF Germany	4f6826f2-4ff6-443d-b966-e6913bd24013	8a58e4aa-f762-11e1-a439-00145eb45e9a
61	61	0	GBIF Germany	4f6826f2-4ff6-443d-b966-e6913bd24013	8a8d4d62-f762-11e1-a439-00145eb45e9a
1242	1242	0	GBIF France	da44cd31-5901-4687-a106-6d1c7734ee3a	8ab63b07-a94e-4d84-adba-347994f74e56
3	3	0	Plazi	ffb07bec-2d10-492d-9c37-361fe0b79427	8e6a2cd7-9659-4b1c-9cfc-f9a0e65ba367
286	264	-22	GBIF Germany	4f6826f2-4ff6-443d-b966-e6913bd24013	8f0add6e-f762-11e1-a439-00145eb45e9a
3	3	0	Plazi	ffb07bec-2d10-492d-9c37-361fe0b79427	8f6191ee-caf2-4bf3-b896-67f43728d68f
260	150	-110	GBIF Germany	4f6826f2-4ff6-443d-b966-e6913bd24013	905e4796-f762-11e1-a439-00145eb45e9a
233	137	-96	GBIF Germany	4f6826f2-4ff6-443d-b966-e6913bd24013	90676a10-f762-11e1-a439-00145eb45e9a
102	82	-20	GBIF Germany	4f6826f2-4ff6-443d-b966-e6913bd24013	90b7c564-f762-11e1-a439-00145eb45e9a
12	8	-4	GBIF Germany	4f6826f2-4ff6-443d-b966-e6913bd24013	9136ddf4-f762-11e1-a439-00145eb45e9a
539	539	0	GBIF France	da44cd31-5901-4687-a106-6d1c7734ee3a	921deb0b-1af5-412a-bde2-1a67d35f46b1
38	38	0	Colombian Biodiversity Information System	7e865cba-7c46-417b-ade5-97f2cf5b7be0	92b52a23-22ce-44ca-b594-947855902751
0	6	6	Plazi	ffb07bec-2d10-492d-9c37-361fe0b79427	930dbbdf-100c-4d24-8f8d-1e5e7ffe7ddc
0	4	4	Plazi	ffb07bec-2d10-492d-9c37-361fe0b79427	93d14c68-9847-4de1-b22d-69e675d0d8ea
854	854	0	GBIF France	da44cd31-5901-4687-a106-6d1c7734ee3a	9842cdf1-f362-4922-ac80-5a6de0ebdb6a
49553	49553	0	National Biodiversity Network	d897a5b9-35ee-4232-94bd-b0bcaac003c2	999e141e-004e-4a61-a282-052ecf258474
19	19	0	Plazi	ffb07bec-2d10-492d-9c37-361fe0b79427	9da869d1-4c5c-420c-97cc-0ded19202a7a
49	49	0	National Biodiversity Network	d897a5b9-35ee-4232-94bd-b0bcaac003c2	a056ad0e-ce0c-4e86-8b68-2c8dd006f768
42	42	0	Plazi	ffb07bec-2d10-492d-9c37-361fe0b79427	a1483fa4-eeab-4e90-9d56-a3d0c9b3fee0
69	69	0	South African Biodiversity Information Facility	7190b835-4e86-4b6e-85c1-19cc6677c250	a4b2ec25-f145-4d44-8833-ceca317c0dbf
0	12	12	Plazi	ffb07bec-2d10-492d-9c37-361fe0b79427	a4c1ff18-1aa7-4dde-a8d0-2b0739cd4621
91	91	0	Plazi	ffb07bec-2d10-492d-9c37-361fe0b79427	a51932dc-5d7c-484d-bd31-8acdcddd36cb
0	4	4	Plazi	ffb07bec-2d10-492d-9c37-361fe0b79427	a51d5f24-48d1-49d6-812d-366e5b77dea3
542	542	0	GBIF Germany	4f6826f2-4ff6-443d-b966-e6913bd24013	a6b3dac2-8b99-4151-aa25-fd8a5d07564c
1519	116447	114928	National Biodiversity Network	d897a5b9-35ee-4232-94bd-b0bcaac003c2	a76463a5-cfb8-441f-9a2e-759d3f350e7e
201	201	0	GBIF France	da44cd31-5901-4687-a106-6d1c7734ee3a	a774b52b-4fac-4798-9db1-d49e0140220c
28	28	0	National Biodiversity Network	d897a5b9-35ee-4232-94bd-b0bcaac003c2	a7bd773c-80a5-4fbc-ae95-5f385eddaf64
4	4	0	Plazi	ffb07bec-2d10-492d-9c37-361fe0b79427	a850a99f-acfa-4f8e-b098-e7e783587f92
5953	5953	0	GBIF Benin	efb9c00e-f802-45dd-8826-a52ec45b89ff	aa0880b6-6445-4a45-b788-5b32158256b8
5	5	0	Plazi	ffb07bec-2d10-492d-9c37-361fe0b79427	aa29bec9-6ecd-43d2-9e02-865e9f5599dc
197	197	0	GBIF Germany	4f6826f2-4ff6-443d-b966-e6913bd24013	aba8cc4c-fba5-44f1-be2a-60c3592dc105
14923	17109	2186	GBIF Japan	db5705aa-6a6e-42f1-8942-d77b9f4896ea	acc7665d-82cc-472b-81ba-14d6bd3b5866
15	15	0	Colombian Biodiversity Information System	7e865cba-7c46-417b-ade5-97f2cf5b7be0	ae0f1dd9-5cf7-4fca-aa8a-78697ad94927
15	15	0	Colombian Biodiversity Information System	7e865cba-7c46-417b-ade5-97f2cf5b7be0	ae1fb7a8-ba94-4b1e-a85b-cb006c06b859
1258	1258	0	U.S. Geological Survey	8618c64a-93e0-4300-b546-7249e5148ed2	ae47ecf0-f506-4abc-9e08-9c1c2766c7ad
0	2	2	Plazi	ffb07bec-2d10-492d-9c37-361fe0b79427	ae9571a7-1b15-4a78-a83f-5f4404e140ac
1	1	0	Plazi	ffb07bec-2d10-492d-9c37-361fe0b79427	b0069883-90d1-40cf-a5a3-576d2bd8eb74
9519	9519	0	Colombian Biodiversity Information System	7e865cba-7c46-417b-ade5-97f2cf5b7be0	b01bffc2-67b0-4441-806d-65c2cff690b5
24016	24016	0	GBIF Brazil	cdc9736d-5ff7-4ece-9959-3c744360cdb3	b2f2cfc7-bd72-403b-9a58-8d0bcdc6e1d7
0	4	4	Plazi	ffb07bec-2d10-492d-9c37-361fe0b79427	b384e8ae-09bb-4df1-8a03-83f6d479e640
0	8	8	Plazi	ffb07bec-2d10-492d-9c37-361fe0b79427	b4124482-df92-4fae-ac3e-c7bf3a4599b6
4439	4439	0	GBIF France	da44cd31-5901-4687-a106-6d1c7734ee3a	b497a612-8a1c-497e-b72d-ce6efc406912
0	71	71	Colombian Biodiversity Information System	7e865cba-7c46-417b-ade5-97f2cf5b7be0	b82d2b1b-559f-4557-a79b-47c4dbd760ae
456	456	0	GBIF Germany	4f6826f2-4ff6-443d-b966-e6913bd24013	b8f55bfd-d54f-4ad1-8377-c8f3c5136294
0	2011	2011	Ocean Biodiversity Information System	ba0670b9-4186-41e6-8e70-f9cb3065551a	b9884b38-e184-4b4f-a786-2b1b021b2125
3	3	0	Plazi	ffb07bec-2d10-492d-9c37-361fe0b79427	ba8ed311-d6b4-4f7e-b87a-ab75cffe319e
69	69	0	GBIF Argentina	2426a871-9feb-40a1-96c6-0c593a76b835	bb74cda5-1e25-49a6-be1d-ac608ecc422b
4623	4623	0	GBIF Spain	1f94b3ca-9345-4d65-afe2-4bace93aa0fe	bbd69a3d-489d-494e-860f-318cc28f0e5c
0	1	1	Ocean Biodiversity Information System	ba0670b9-4186-41e6-8e70-f9cb3065551a	c208ddc8-93f2-4298-90fd-33ee18585698
0	2	2	Plazi	ffb07bec-2d10-492d-9c37-361fe0b79427	c383d935-f482-42b4-acfe-d9949dbcc9f6
0	2	2	Plazi	ffb07bec-2d10-492d-9c37-361fe0b79427	c3add27d-2b70-4115-9ae3-d5c4032b8da5
5	5	0	Plazi	ffb07bec-2d10-492d-9c37-361fe0b79427	c3b46112-2220-4822-a07a-c72708b228fc
91	91	0	Atlas of Living Australia	4a6f1b71-969e-4fc5-a693-282b05e1220c	c4a243a3-cc76-4e84-9f28-8a3c919bf0f4
22585	22585	0	GBIF France	da44cd31-5901-4687-a106-6d1c7734ee3a	c6277b3b-05d5-4ef4-8828-cba6e6b974dd
0	687	687	Plazi	ffb07bec-2d10-492d-9c37-361fe0b79427	c6cbde00-e2f0-47f6-bb5a-912843ace312
968	968	0	GBIF Portugal	673f7038-4262-4149-b753-5658a4e912f6	c6e94ce4-5d25-4758-8a52-2d5ee4d520fc
16618	16618	0	GBIF France	da44cd31-5901-4687-a106-6d1c7734ee3a	c709bf36-4964-4771-90f0-c6ba4b351620
0	2	2	Plazi	ffb07bec-2d10-492d-9c37-361fe0b79427	c9f96aae-36ef-4f44-a04e-bfeb9161901c
0	27	27	Plazi	ffb07bec-2d10-492d-9c37-361fe0b79427	ca292ebe-30e0-4fde-95c1-6219b8d6bb26
277	277	0	Colombian Biodiversity Information System	7e865cba-7c46-417b-ade5-97f2cf5b7be0	cd77bcbf-a35d-4e6a-a361-fd5634295c20
29	29	0	GBIF France	da44cd31-5901-4687-a106-6d1c7734ee3a	ce3b3082-daf8-4687-a5e4-ddeddcbd3d56
143	143	0	GBIF France	da44cd31-5901-4687-a106-6d1c7734ee3a	ceeb791f-fbea-43eb-8785-864be6df6c3c
7	7	0	Plazi	ffb07bec-2d10-492d-9c37-361fe0b79427	d0404406-fa96-41e0-89d0-6220a8a32a4f
0	75130	75130	Ocean Biodiversity Information System	ba0670b9-4186-41e6-8e70-f9cb3065551a	d135ba77-9d68-466b-bff9-8d1a0c53b7d7
0	1	1	Plazi	ffb07bec-2d10-492d-9c37-361fe0b79427	d15e654a-5d49-4939-9306-152f48e910a3
0	3	3	Plazi	ffb07bec-2d10-492d-9c37-361fe0b79427	d3987c43-08f1-42bf-8470-df14ef134c8d
3	3	0	Plazi	ffb07bec-2d10-492d-9c37-361fe0b79427	d4c22227-fe44-498c-a55f-3f2fb3c983ca
1148	1148	0	Participant Node Managers Committee	7f48e0c8-5c96-49ec-b972-30748e339115	d83793f0-b48b-4842-b584-8ad65d73daf3
0	50	50	Plazi	ffb07bec-2d10-492d-9c37-361fe0b79427	d863a5df-9418-4ed5-a8da-9ce9a673e25f
18	18	0	Plazi	ffb07bec-2d10-492d-9c37-361fe0b79427	d872eb99-3550-4b3f-9e43-4fc9377606fb
7	7	0	GBIF Brazil	cdc9736d-5ff7-4ece-9959-3c744360cdb3	d987ce61-5b9b-4dd7-9776-b5443d8b8dcc
35	35	0	Plazi	ffb07bec-2d10-492d-9c37-361fe0b79427	dbcf3047-c345-42a7-b3ef-c47791597613
0	135	135	Ocean Biodiversity Information System	ba0670b9-4186-41e6-8e70-f9cb3065551a	dc7232b0-3578-4dd4-a65a-3fc4f43edf6a
597	597	0	Participant Node Managers Committee	7f48e0c8-5c96-49ec-b972-30748e339115	ddf006f2-5c76-47d5-9180-4a52d8d5d4e0
0	1	1	Plazi	ffb07bec-2d10-492d-9c37-361fe0b79427	dee2fea5-4ce2-4362-a114-e3e08ae0a19e
0	2	2	Plazi	ffb07bec-2d10-492d-9c37-361fe0b79427	e49ccb42-0535-490c-b6c1-8a2cd7044be4
190	1255	1065	GBIF Argentina	2426a871-9feb-40a1-96c6-0c593a76b835	e59770e3-a45d-4997-baf4-8c1297a5ea28
0	3	3	Plazi	ffb07bec-2d10-492d-9c37-361fe0b79427	e78e91d5-6e7b-4be5-b5f9-81c827e0d139
1	1	0	Plazi	ffb07bec-2d10-492d-9c37-361fe0b79427	e98d00b2-67b2-49a6-803e-7a1520600ed0
2613	2613	0	National Biodiversity Network	d897a5b9-35ee-4232-94bd-b0bcaac003c2	ea25d7b3-ac00-4951-9c52-b4763240dc5b
189	189	0	GBIF Argentina	2426a871-9feb-40a1-96c6-0c593a76b835	ee5963a9-5f03-450f-9e60-6865cde496c5
5	5	0	Plazi	ffb07bec-2d10-492d-9c37-361fe0b79427	f02778e7-c73d-4d81-aa46-f44a7017a104
7241	7241	0	National Biodiversity Network	d897a5b9-35ee-4232-94bd-b0bcaac003c2	f0382d17-cd3b-437b-8cce-488ecd300c45
0	14	14	Plazi	ffb07bec-2d10-492d-9c37-361fe0b79427	f133b9c7-bb29-4834-92e3-d8a3cdaf5aa9
1538	1538	0	National Biodiversity Network	d897a5b9-35ee-4232-94bd-b0bcaac003c2	f1a35c03-bec8-4504-b01a-798e55aede9c
422	422	0	GBIF Brazil	cdc9736d-5ff7-4ece-9959-3c744360cdb3	f2e4fddc-f85c-4c79-8629-e5b448298b21
26	26	0	GBIF France	da44cd31-5901-4687-a106-6d1c7734ee3a	f3d13a43-bbe0-4729-845c-daafc233d333
549	549	0	GBIF Nigeria	6529bcb5-a542-4fda-be87-54a624515335	f4971deb-ddd5-42e9-8f5b-5d8daa6f251e
13800	13800	0	Canada Biodiversity Information Facility	8f83fc96-c966-4126-83f7-bf044dc49efa	f5711f76-582a-4f95-a55b-f85e66e08db7
40431	44911	4480	U.S. Geological Survey	8618c64a-93e0-4300-b546-7249e5148ed2	f5783452-6ff5-4bef-8f30-9adfeba81bd7
357	357	0	Belgian Biodiversity Platform	fb11cfe1-ebc3-45af-9159-17d9fddbcdac	f88d3365-634e-411b-9901-e5ca069de5ac
1	1	0	Plazi	ffb07bec-2d10-492d-9c37-361fe0b79427	faf981df-ba51-435f-8c3f-fa352ab22641
5496	5495	-1	National Biodiversity Network	d897a5b9-35ee-4232-94bd-b0bcaac003c2	fc355172-2a32-4b83-a0dc-1800ae9f563e
5	5	0	Plazi	ffb07bec-2d10-492d-9c37-361fe0b79427	fd6adac5-7672-4412-8700-e9186e6818d5
1	1	0	Plazi	ffb07bec-2d10-492d-9c37-361fe0b79427	fd7a2fb7-5a37-4c63-b213-ca05c6f3b36b
243	243	0	GBIF Norway	4f829580-180d-46a9-9c87-ed8ec959b545	fe1e8d55-615e-4334-93f3-325eda0627ab
2	2	0	Plazi	ffb07bec-2d10-492d-9c37-361fe0b79427	fe310b2b-b603-40e3-8898-9d90fb9dd1fb
3	3	0	Plazi	ffb07bec-2d10-492d-9c37-361fe0b79427	fe4025db-98a4-42b5-8098-8ab448381cc9
0	48038	48038	DanBIF - Danish Biodiversity Information Facility	4ddd294f-02b7-4359-ac33-0806a9ca9c6b	ffdbb934-3505-49ef-9af9-2619082e4d1c
0	40	40	Plazi	ffb07bec-2d10-492d-9c37-361fe0b79427	00a6c00a-00f0-4d37-9b84-c1f30c1b7341
0	139	139	Colombian Biodiversity Information System	7e865cba-7c46-417b-ade5-97f2cf5b7be0	00e733c8-8050-4f19-9705-66cffafdca50
0	10	10	Plazi	ffb07bec-2d10-492d-9c37-361fe0b79427	09ca7af6-f232-4272-ba7c-0f2686d11b78
3	3	0	Plazi	ffb07bec-2d10-492d-9c37-361fe0b79427	0ee24b50-53d4-4629-b897-f486d6eca776
15993	15993	0	U.S. Geological Survey	8618c64a-93e0-4300-b546-7249e5148ed2	1060a696-f6a2-4341-92ef-47a63babbea1
240	240	0	Colombian Biodiversity Information System	7e865cba-7c46-417b-ade5-97f2cf5b7be0	10a06925-bd04-4f18-afe4-23be410c10c1
0	41	41	Plazi	ffb07bec-2d10-492d-9c37-361fe0b79427	10c0936c-f405-4c8d-b34b-9c825f2683a5
2	2	0	Plazi	ffb07bec-2d10-492d-9c37-361fe0b79427	1126f89c-7da5-4ed7-9a34-ea613aa7b48d
2	2	0	Plazi	ffb07bec-2d10-492d-9c37-361fe0b79427	12752b19-d74b-4473-be76-190f6fd07080
0	3	3	Plazi	ffb07bec-2d10-492d-9c37-361fe0b79427	1339ad9b-f051-4055-ad11-05e6d4245392
0	5	5	Plazi	ffb07bec-2d10-492d-9c37-361fe0b79427	145931d9-6290-42ab-968b-80e8fab02740
3	3	0	Plazi	ffb07bec-2d10-492d-9c37-361fe0b79427	16ecd65e-f5f0-46e4-a1e0-5b83692a7a49
1	1	0	Plazi	ffb07bec-2d10-492d-9c37-361fe0b79427	17da9249-3dd8-4d35-bf3f-a59fbf8ce0e7
361	361	0	Biodiversity Information System of Mexico	b324e8e9-9a4c-44fa-8f1a-7f39ea7ab576	17f76205-c629-41d8-afc6-8959f90c8ab3
1	1	0	Plazi	ffb07bec-2d10-492d-9c37-361fe0b79427	19443e0f-7597-4c95-bd1e-56b63150c447
341	341	0	Belgian Biodiversity Platform	fb11cfe1-ebc3-45af-9159-17d9fddbcdac	19e7f71d-ad1e-4a03-9a24-983e74fe3809
13	13	0	Plazi	ffb07bec-2d10-492d-9c37-361fe0b79427	1b0ccc7a-833e-4706-bcad-b34c9a7f441a
444	444	0	GBIF Brazil	cdc9736d-5ff7-4ece-9959-3c744360cdb3	1d833521-e2d0-4bed-9ed2-4b9374b15527
0	31	31	Ocean Biodiversity Information System	ba0670b9-4186-41e6-8e70-f9cb3065551a	1de24009-dcbf-4fba-a385-9d75c1abcdd3
3	3	0	Plazi	ffb07bec-2d10-492d-9c37-361fe0b79427	1e7a2fce-52af-414e-8ca0-398b338fe188
637	637	0	Participant Node Managers Committee	7f48e0c8-5c96-49ec-b972-30748e339115	20e2524f-0354-4090-ab7e-c8d7c3e953db
2626773	2626773	0	Netherlands Biodiversity Information Facility	0909d601-bda2-42df-9e63-a6d51847ebce	20e3fcbb-c285-49ee-a93d-cc6ccd06ca9e
868	868	0	GBIF Germany	4f6826f2-4ff6-443d-b966-e6913bd24013	218cadd5-13ec-4263-84f7-c8a7caeada30
37	37	0	Plazi	ffb07bec-2d10-492d-9c37-361fe0b79427	22424bc1-fa32-4bfa-8e1e-426dce81dc66
3	3	0	Plazi	ffb07bec-2d10-492d-9c37-361fe0b79427	245482f1-7c3c-47ec-a848-9c79b6532258
85	85	0	Colombian Biodiversity Information System	7e865cba-7c46-417b-ade5-97f2cf5b7be0	2b96db8a-6454-4187-8dee-5f12128df2b3
911	911	0	GBIF France	da44cd31-5901-4687-a106-6d1c7734ee3a	2bff155e-6df9-4533-ae2d-30eb7a0da428
0	2	2	Plazi	ffb07bec-2d10-492d-9c37-361fe0b79427	2e5254f0-b5bd-4c28-b0c7-3280ee3b8c62
0	1	1	Plazi	ffb07bec-2d10-492d-9c37-361fe0b79427	2fa4f095-2d6e-4b04-8c4d-9d7d33778dea
4	4	0	Plazi	ffb07bec-2d10-492d-9c37-361fe0b79427	32590f0c-e30f-4068-8b77-9868bea17bc3
0	17	17	Plazi	ffb07bec-2d10-492d-9c37-361fe0b79427	3414c299-776c-46c7-acc2-ef3c185c7b9b
258	258	0	GBIF France	da44cd31-5901-4687-a106-6d1c7734ee3a	343215b7-c1ae-49cc-a0fe-58f8d70da63b
5720	5720	0	Colombian Biodiversity Information System	7e865cba-7c46-417b-ade5-97f2cf5b7be0	34d7a259-acf6-4b01-9640-0ab5efc17dad
849	849	0	Participant Node Managers Committee	7f48e0c8-5c96-49ec-b972-30748e339115	37867d84-1143-4378-ac6f-95e5e19650e9
0	7	7	Plazi	ffb07bec-2d10-492d-9c37-361fe0b79427	39c6f70c-8cc1-4d9c-8727-179c817b138c
3	3	0	Colombian Biodiversity Information System	7e865cba-7c46-417b-ade5-97f2cf5b7be0	49179ed7-f901-4ed8-9629-263be7398b0a
90	90	0	Biodiversity Information System of Mexico	b324e8e9-9a4c-44fa-8f1a-7f39ea7ab576	49821f95-e784-49d3-82ce-5b5cf9aa96f4
0	1	1	Participant Node Managers Committee	7f48e0c8-5c96-49ec-b972-30748e339115	4b650b48-3872-471a-add4-2013a3673311
4	4	0	Plazi	ffb07bec-2d10-492d-9c37-361fe0b79427	4bb742fd-812a-466e-a719-221361dc9094
234	234	0	GBIF France	da44cd31-5901-4687-a106-6d1c7734ee3a	4f354a60-2fc7-4038-b9f3-6cde73367cfc
1860	1860	0	Biodiversity Information System of Mexico	b324e8e9-9a4c-44fa-8f1a-7f39ea7ab576	51c9ee7c-6649-46fc-bf03-b3f7e6a09a84
928	928	0	GBIF Germany	4f6826f2-4ff6-443d-b966-e6913bd24013	59fa94cc-6c8b-4e32-991b-4dbad89f69b0
137	47	-90	GBIF Germany	4f6826f2-4ff6-443d-b966-e6913bd24013	5a57a724-6637-4d67-8bec-aff5c1ffb265
9054	9054	0	National Biodiversity Network	d897a5b9-35ee-4232-94bd-b0bcaac003c2	5accf920-492e-4641-9ba2-11481c116419
10	10	0	Plazi	ffb07bec-2d10-492d-9c37-361fe0b79427	5b5551b0-807a-46fa-a552-9ec629d0866c
1365	1365	0	GBIF Germany	4f6826f2-4ff6-443d-b966-e6913bd24013	60cb0297-9d2e-42ab-a901-4929286942f5
3	3	0	Plazi	ffb07bec-2d10-492d-9c37-361fe0b79427	6102dc82-f472-4c39-9e7f-f9b05956cec4
180	180	0	GBIF Germany	4f6826f2-4ff6-443d-b966-e6913bd24013	61ac87be-f762-11e1-a439-00145eb45e9a
4	4	0	Atlas of Living Australia	4a6f1b71-969e-4fc5-a693-282b05e1220c	62dbb284-ccc3-486b-a1f0-128a872da7ab
0	12	12	Plazi	ffb07bec-2d10-492d-9c37-361fe0b79427	6374cf98-83ad-4dbb-823f-cdd94ea9cafb
62	62	0	GBIF Germany	4f6826f2-4ff6-443d-b966-e6913bd24013	64100c74-f762-11e1-a439-00145eb45e9a
39	39	0	GBIF Germany	4f6826f2-4ff6-443d-b966-e6913bd24013	64c89e56-f762-11e1-a439-00145eb45e9a
1001	1001	0	Colombian Biodiversity Information System	7e865cba-7c46-417b-ade5-97f2cf5b7be0	6752309e-8b0b-4cc0-b6b5-7fe2d2511f9b
40	40	0	GBIF Germany	4f6826f2-4ff6-443d-b966-e6913bd24013	67813d06-f762-11e1-a439-00145eb45e9a
129	129	0	GBIF Germany	4f6826f2-4ff6-443d-b966-e6913bd24013	686c714a-f762-11e1-a439-00145eb45e9a
43	43	0	GBIF France	da44cd31-5901-4687-a106-6d1c7734ee3a	688f70a0-02a5-48ec-9839-17568999ea7e
68	68	0	GBIF Germany	4f6826f2-4ff6-443d-b966-e6913bd24013	69b14ce2-f762-11e1-a439-00145eb45e9a
202	202	0	GBIF France	da44cd31-5901-4687-a106-6d1c7734ee3a	6a743896-04e7-47f1-bfc3-95c0556e8912
0	35	35	Plazi	ffb07bec-2d10-492d-9c37-361fe0b79427	6bf67a5d-ecd7-4f43-b3df-ebcad1333e71
2	2	0	Plazi	ffb07bec-2d10-492d-9c37-361fe0b79427	6ce02479-95fb-47d7-a680-6dfe47cd2d23
6541	6541	0	GBIF France	da44cd31-5901-4687-a106-6d1c7734ee3a	6e64caac-efd9-4ab7-95d1-149f753bcd6e
7	7	0	GBIF Germany	4f6826f2-4ff6-443d-b966-e6913bd24013	6fdb5126-f762-11e1-a439-00145eb45e9a
23	23	0	GBIF Germany	4f6826f2-4ff6-443d-b966-e6913bd24013	700a6f06-f762-11e1-a439-00145eb45e9a
1170	764	-406	GBIF Germany	4f6826f2-4ff6-443d-b966-e6913bd24013	7044aad6-f762-11e1-a439-00145eb45e9a
4	4	0	Plazi	ffb07bec-2d10-492d-9c37-361fe0b79427	716d15d0-9301-4944-bb87-c3da275e3089
17	17	0	Plazi	ffb07bec-2d10-492d-9c37-361fe0b79427	743df07f-134c-49f1-a341-0e7a4d2ef32c
553	553	0	GBIF France	da44cd31-5901-4687-a106-6d1c7734ee3a	74733731-377a-44ae-98b5-9c3cb0740524
45	45	0	GBIF Germany	4f6826f2-4ff6-443d-b966-e6913bd24013	74aaab52-f762-11e1-a439-00145eb45e9a
0	22	22	Plazi	ffb07bec-2d10-492d-9c37-361fe0b79427	754bc642-127f-4ac2-99b4-4850cd68fd2d
0	60	60	Ocean Biodiversity Information System	ba0670b9-4186-41e6-8e70-f9cb3065551a	7844aadd-65db-456b-a2ea-986c3da1e74a
103	103	0	Korean Biodiversity Information Facility	e0a1e772-0177-4800-94b4-2d023fe6cdf4	7af5e22e-f762-11e1-a439-00145eb45e9a
5	5	0	Plazi	ffb07bec-2d10-492d-9c37-361fe0b79427	7b4fdf53-3c03-4fd0-8218-5d3d3788a9c7
36	36	0	Plazi	ffb07bec-2d10-492d-9c37-361fe0b79427	7bd398c4-9441-4286-b150-0c421f91ec7e
137	137	0	GBIF Germany	4f6826f2-4ff6-443d-b966-e6913bd24013	7cb8d366-84f0-4a02-aadc-1a46620302e6
48	48	0	GBIF Germany	4f6826f2-4ff6-443d-b966-e6913bd24013	7d53c4d2-f762-11e1-a439-00145eb45e9a
140	140	0	GBIF Germany	4f6826f2-4ff6-443d-b966-e6913bd24013	7e5e386c-f762-11e1-a439-00145eb45e9a
1798	1910	112	GBIF Germany	4f6826f2-4ff6-443d-b966-e6913bd24013	7ee2c7ee-f762-11e1-a439-00145eb45e9a
857	857	0	Ocean Biodiversity Information System	ba0670b9-4186-41e6-8e70-f9cb3065551a	80739819-f715-4bc6-9075-d3d9574561e9
1253	1253	0	National Biodiversity Network	d897a5b9-35ee-4232-94bd-b0bcaac003c2	8092be2b-7d33-4d60-9479-aef3375368bb
1348	1338	-10	Biodiversity Information System of Mexico	b324e8e9-9a4c-44fa-8f1a-7f39ea7ab576	80b7e6b2-f762-11e1-a439-00145eb45e9a
461	461	0	Biodiversity Information System of Mexico	b324e8e9-9a4c-44fa-8f1a-7f39ea7ab576	80cdb1cc-f762-11e1-a439-00145eb45e9a
818	818	0	Biodiversity Information System of Mexico	b324e8e9-9a4c-44fa-8f1a-7f39ea7ab576	80d59720-f762-11e1-a439-00145eb45e9a
403	403	0	Colombian Biodiversity Information System	7e865cba-7c46-417b-ade5-97f2cf5b7be0	8276c2d9-24ac-4f5c-8f79-06fcf31b9f70
7	7	0	GBIF Germany	4f6826f2-4ff6-443d-b966-e6913bd24013	827d886c-f762-11e1-a439-00145eb45e9a
3989	3989	0	GBIF Germany	4f6826f2-4ff6-443d-b966-e6913bd24013	82b46a9e-f762-11e1-a439-00145eb45e9a
143	143	0	Plazi	ffb07bec-2d10-492d-9c37-361fe0b79427	845d02d0-f3ff-4ec9-918d-8b801758f996
121	121	0	Plazi	ffb07bec-2d10-492d-9c37-361fe0b79427	84ef451f-d1a1-48f6-871e-f688204fd959
0	1970	1970	National Biodiversity Network	d897a5b9-35ee-4232-94bd-b0bcaac003c2	850058b9-c4a8-4c9c-bc19-d3354117024c
399	399	0	World Federation for Culture Collections	a6bdc523-5368-4e0f-9d2e-de1c262ac092	85599242-f762-11e1-a439-00145eb45e9a
4244	4244	0	GBIF Japan	db5705aa-6a6e-42f1-8942-d77b9f4896ea	868d5e1e-f762-11e1-a439-00145eb45e9a
177494	177494	0	Colombian Biodiversity Information System	7e865cba-7c46-417b-ade5-97f2cf5b7be0	876c11ed-b8a6-4b4b-868f-da9b91ab330c
0	30	30	Plazi	ffb07bec-2d10-492d-9c37-361fe0b79427	882c739d-79c1-4b85-9446-44cfef2c5b5a
224	224	0	Plazi	ffb07bec-2d10-492d-9c37-361fe0b79427	8914bb90-1af0-4a6e-b7be-0b8dce1401a5
27	27	0	GBIF Germany	4f6826f2-4ff6-443d-b966-e6913bd24013	899a1886-f762-11e1-a439-00145eb45e9a
81	81	0	GBIF Finland	dd514216-5c7c-45f3-910d-797424cb5be6	8a7d18a0-2c93-41cb-a018-c14d3ead8a45
53	53	0	GBIF Germany	4f6826f2-4ff6-443d-b966-e6913bd24013	8bbdc090-f762-11e1-a439-00145eb45e9a
6	6	0	GBIF Germany	4f6826f2-4ff6-443d-b966-e6913bd24013	8bca0eae-f762-11e1-a439-00145eb45e9a
2	2	0	Plazi	ffb07bec-2d10-492d-9c37-361fe0b79427	8bdec6fe-6f2f-4689-b5b2-baf65cd31104
16	16	0	Plazi	ffb07bec-2d10-492d-9c37-361fe0b79427	8c88621c-037e-4d69-b09b-3975da3289d1
0	6566	6566	GBIF France	da44cd31-5901-4687-a106-6d1c7734ee3a	8c9620c0-fc1d-4680-bab0-6e22dfe4bada
11	11	0	GBIF Germany	4f6826f2-4ff6-443d-b966-e6913bd24013	8d3075c6-f762-11e1-a439-00145eb45e9a
33	26	-7	GBIF Germany	4f6826f2-4ff6-443d-b966-e6913bd24013	8d36527a-f762-11e1-a439-00145eb45e9a
1	1	0	GBIF Germany	4f6826f2-4ff6-443d-b966-e6913bd24013	8daafce2-f762-11e1-a439-00145eb45e9a
103	22	-81	GBIF Germany	4f6826f2-4ff6-443d-b966-e6913bd24013	8e059c2e-f762-11e1-a439-00145eb45e9a
167	74	-93	GBIF Germany	4f6826f2-4ff6-443d-b966-e6913bd24013	8f26470c-f762-11e1-a439-00145eb45e9a
761	631	-130	GBIF Germany	4f6826f2-4ff6-443d-b966-e6913bd24013	8f76ba48-f762-11e1-a439-00145eb45e9a
63	45	-18	GBIF Germany	4f6826f2-4ff6-443d-b966-e6913bd24013	90aae916-f762-11e1-a439-00145eb45e9a
39	30	-9	GBIF Germany	4f6826f2-4ff6-443d-b966-e6913bd24013	9348a55a-f762-11e1-a439-00145eb45e9a
0	670	670	Ocean Biodiversity Information System	ba0670b9-4186-41e6-8e70-f9cb3065551a	937010bb-6a28-4743-b9b3-9b8059841248
0	10	10	Plazi	ffb07bec-2d10-492d-9c37-361fe0b79427	93f7dc2d-ba5b-4e2b-b3db-f5763e8e36aa
0	1055	1055	Colombian Biodiversity Information System	7e865cba-7c46-417b-ade5-97f2cf5b7be0	93ff5482-79f4-42c9-ba4c-0f29bd9d7034
780	780	0	GBIF Germany	4f6826f2-4ff6-443d-b966-e6913bd24013	9407fa22-f762-11e1-a439-00145eb45e9a
1211	1211	0	GBIF Germany	4f6826f2-4ff6-443d-b966-e6913bd24013	9423ec8c-f762-11e1-a439-00145eb45e9a
3088	3102	14	GBIF Germany	4f6826f2-4ff6-443d-b966-e6913bd24013	954ae8f4-f762-11e1-a439-00145eb45e9a
206	206	0	GBIF Germany	4f6826f2-4ff6-443d-b966-e6913bd24013	9796833e-f762-11e1-a439-00145eb45e9a
9	9	0	GBIF Germany	4f6826f2-4ff6-443d-b966-e6913bd24013	979e97b8-f762-11e1-a439-00145eb45e9a
3	3	0	GBIF Argentina	2426a871-9feb-40a1-96c6-0c593a76b835	99bc7ec5-65fc-475d-a79f-7a92ed08264a
0	8	8	Plazi	ffb07bec-2d10-492d-9c37-361fe0b79427	9c028f67-5ce1-41d2-ad4d-21424bb8057c
1083	1083	0	GBIF Norway	4f829580-180d-46a9-9c87-ed8ec959b545	9e54a9c3-98cf-438d-bdf2-89358b647ffa
12	12	0	Secretariat of the Pacific Regional Environment Programme	29c6a139-ea7f-41f5-8d9b-c55af8736182	9ed08a2d-9c26-473c-b47f-8e41a89ed11c
20	20	0	Inter American Biodiversity Information Network	69f8ea9e-b2a6-4e5a-896f-3bf8fc23cc8d	a0364481-b35c-4e5d-85c2-65f757f7ec40
2068	2068	0	Colombian Biodiversity Information System	7e865cba-7c46-417b-ade5-97f2cf5b7be0	a115ea66-a440-4abc-a0b3-a4c9e4e57f30
1	1	0	Plazi	ffb07bec-2d10-492d-9c37-361fe0b79427	a181b793-ed62-4840-b065-95cbf0522801
1656	1656	0	U.S. Geological Survey	8618c64a-93e0-4300-b546-7249e5148ed2	a3dead0e-d687-47c5-9ef9-b80c688a706e
4	4	0	Plazi	ffb07bec-2d10-492d-9c37-361fe0b79427	a554151f-5e90-49a8-bee4-84ac9251e0d8
78	78	0	Plazi	ffb07bec-2d10-492d-9c37-361fe0b79427	a5cbd5ef-7f49-4a94-a2f4-61adcc8c8d01
14	14	0	Plazi	ffb07bec-2d10-492d-9c37-361fe0b79427	a854a7a7-d2f4-4d24-87e7-490c191bd940
401	401	0	Belgian Biodiversity Platform	fb11cfe1-ebc3-45af-9159-17d9fddbcdac	a9a0d532-3287-4631-ac8b-6db55a799686
13968	13968	0	GBIF Madagascar	2dbfc5c5-51b5-4494-9dfc-4d3f013a3b64	ac8e5183-e233-4168-96a5-67541049aa67
2455	2455	0	GBIF France	da44cd31-5901-4687-a106-6d1c7734ee3a	ad4d7478-1789-4291-955c-b30cc889365b
266	266	0	Participant Node Managers Committee	7f48e0c8-5c96-49ec-b972-30748e339115	ae1b71d4-be5e-41e7-a886-b227762e50b8
4	4	0	Plazi	ffb07bec-2d10-492d-9c37-361fe0b79427	afeddac3-13cf-48ea-a7b3-f7e7618fe7c3
0	8	8	Plazi	ffb07bec-2d10-492d-9c37-361fe0b79427	b21652c7-9d47-402f-bf45-a524a3181d21
0	25	25	Plazi	ffb07bec-2d10-492d-9c37-361fe0b79427	b3293c54-11ba-43d8-8c3c-243a8c05d6cd
0	2	2	Plazi	ffb07bec-2d10-492d-9c37-361fe0b79427	b36ab825-a0bd-46b4-9563-3d99f727465a
248241	248658	417	National Biodiversity Network	d897a5b9-35ee-4232-94bd-b0bcaac003c2	b37a1b62-055c-4bc4-bb5a-53e1b9b41b72
0	231	231	Colombian Biodiversity Information System	7e865cba-7c46-417b-ade5-97f2cf5b7be0	b51ea693-b9d3-46f1-aa7e-7d4006264f36
427	428	1	GBIF Norway	4f829580-180d-46a9-9c87-ed8ec959b545	b5a4d944-8a51-4104-a4a7-c3637128bcc7
103625	103625	0	Belgian Biodiversity Platform	fb11cfe1-ebc3-45af-9159-17d9fddbcdac	b7ee2a4d-8e10-410f-a951-a7f032678ffe
27	27	0	Plazi	ffb07bec-2d10-492d-9c37-361fe0b79427	b89eef79-c05f-49af-8865-ad714d3cb410
14	14	0	Plazi	ffb07bec-2d10-492d-9c37-361fe0b79427	b93895f2-f4a1-4c78-b0dc-1fee622c25c0
3	3	0	Plazi	ffb07bec-2d10-492d-9c37-361fe0b79427	ba3ee98d-e064-4690-a363-8a5730e35fad
0	1142	1142	Ocean Biodiversity Information System	ba0670b9-4186-41e6-8e70-f9cb3065551a	bbf53f93-852f-466d-88ad-b9e1327f9215
34	34	0	GBIF Brazil	cdc9736d-5ff7-4ece-9959-3c744360cdb3	bdc71cdc-edb6-468a-b167-24ba6177ff46
173	173	0	Participant Node Managers Committee	7f48e0c8-5c96-49ec-b972-30748e339115	beae8840-4e3d-46d3-aa0b-4a60aaba0b49
438	438	0	GBIF France	da44cd31-5901-4687-a106-6d1c7734ee3a	bfcbfb83-db04-4a9b-9c51-4aecf60161aa
969	969	0	Polish Biodiversity Information Network	2618bfdf-e194-4911-a241-80db3107bc51	c2183cf0-13aa-11de-b2de-b8a03c50a862
8	8	0	Plazi	ffb07bec-2d10-492d-9c37-361fe0b79427	c28c29e6-43b2-4b31-9778-4bf2c8d65ccd
641	641	0	National Biodiversity Network	d897a5b9-35ee-4232-94bd-b0bcaac003c2	c31ee88d-75cc-4d1e-8285-1b4793a6d1e8
8	8	0	Atlas of Living Australia	4a6f1b71-969e-4fc5-a693-282b05e1220c	c39078e9-52c3-4df4-b7ae-aefcdd831be5
6	12	6	GBIF Japan	db5705aa-6a6e-42f1-8942-d77b9f4896ea	c81d43ba-3cf6-4016-9c74-321e07074f6c
4	4	0	National Biodiversity Network	d897a5b9-35ee-4232-94bd-b0bcaac003c2	c90b1621-8d38-42f2-a55e-712a3e9b2c13
0	1608	1608	GBIF Norway	4f829580-180d-46a9-9c87-ed8ec959b545	ca0d8107-a2bd-47a1-91a1-250179b534ec
1825	1825	0	GBIF Portugal	673f7038-4262-4149-b753-5658a4e912f6	cd080a65-5b26-4cad-abe8-c7b60b071e46
26520	26520	0	Ocean Biodiversity Information System	ba0670b9-4186-41e6-8e70-f9cb3065551a	ce695983-1492-433e-8f79-1f18e2393cf5
492	492	0	GBIF Norway	4f829580-180d-46a9-9c87-ed8ec959b545	cf645849-cbf8-48b7-82ea-a9f132612d62
0	144	144	Plazi	ffb07bec-2d10-492d-9c37-361fe0b79427	cfbb768d-ea35-404f-bd57-c51c200e0207
3	3	0	Plazi	ffb07bec-2d10-492d-9c37-361fe0b79427	d0128eb5-5a32-4586-bd97-74053de40a80
230	230	0	GBIF France	da44cd31-5901-4687-a106-6d1c7734ee3a	d2763a38-ac56-4773-a264-d272745a2e12
693	693	0	GBIF Germany	4f6826f2-4ff6-443d-b966-e6913bd24013	d78597ef-3726-48a7-aac3-2db57b0f1acb
1452	1452	0	GBIF France	da44cd31-5901-4687-a106-6d1c7734ee3a	d86fa8c8-2bfb-4ade-934a-540a11db8cc1
1507	1507	0	Biodiversity Information System of Mexico	b324e8e9-9a4c-44fa-8f1a-7f39ea7ab576	d8f60448-42c4-489c-8910-d8f0b58b24b1
0	174	174	GBIF Japan	db5705aa-6a6e-42f1-8942-d77b9f4896ea	d9e534c0-ac62-4e51-8bf2-4b5f8f3774e7
0	4	4	Plazi	ffb07bec-2d10-492d-9c37-361fe0b79427	dc14c45b-38bb-45b5-b8bc-706866f7fb41
46	46	0	Plazi	ffb07bec-2d10-492d-9c37-361fe0b79427	dd1ed2f6-525d-4dee-ac92-5c5f3a3f8119
5	5	0	Plazi	ffb07bec-2d10-492d-9c37-361fe0b79427	ddbf20bd-a496-402e-9048-804711808b44
62	62	0	Plazi	ffb07bec-2d10-492d-9c37-361fe0b79427	de19f321-d911-4fd4-9912-ab958efec458
113	113	0	GBIF France	da44cd31-5901-4687-a106-6d1c7734ee3a	df360805-b314-4ef8-b069-6a4c93d6ca22
2421	2421	0	GBIF Germany	4f6826f2-4ff6-443d-b966-e6913bd24013	e04232b1-0244-4083-852a-d652fac1e41a
36	36	0	GBIF France	da44cd31-5901-4687-a106-6d1c7734ee3a	e0e9f72d-a660-42c9-a2cb-4bb7ea4a1e95
37839	37839	0	GBIF Brazil	cdc9736d-5ff7-4ece-9959-3c744360cdb3	e11f4c32-cb63-4fe3-bf14-c3828623229e
3517	3517	0	National Biodiversity Network	d897a5b9-35ee-4232-94bd-b0bcaac003c2	e14e3985-89c2-4849-8964-96ef8c8a2051
50605	50605	0	GBIF Norway	4f829580-180d-46a9-9c87-ed8ec959b545	e306fa70-381e-4330-8e68-1f447b46a850
66	66	0	Colombian Biodiversity Information System	7e865cba-7c46-417b-ade5-97f2cf5b7be0	e3388e34-00dc-45bf-a870-8c89863d37bb
0	376	376	U.S. Geological Survey	8618c64a-93e0-4300-b546-7249e5148ed2	e5c0442d-6118-44ae-884e-aaced8be1140
9384	9384	0	GBIF Madagascar	2dbfc5c5-51b5-4494-9dfc-4d3f013a3b64	e6751193-fafa-4aae-a0c2-f2f1a93172ca
0	11	11	Plazi	ffb07bec-2d10-492d-9c37-361fe0b79427	e78a1472-d6c2-41b4-84d9-cbacfa420a67
3	3	0	Korean Biodiversity Information Facility	e0a1e772-0177-4800-94b4-2d023fe6cdf4	eade59fb-3fda-4399-93d5-994dbc324d27
5	5	0	Plazi	ffb07bec-2d10-492d-9c37-361fe0b79427	eb91da1b-b1df-431f-8d2a-5a0e3546497c
0	1	1	Plazi	ffb07bec-2d10-492d-9c37-361fe0b79427	ee1fd645-796b-40bd-aee7-42e31583fa64
2737	2737	0	National Biodiversity Network	d897a5b9-35ee-4232-94bd-b0bcaac003c2	ee4aeed5-cd8a-49f0-bbc5-6b799f20c08a
2	2	0	Plazi	ffb07bec-2d10-492d-9c37-361fe0b79427	efd6153b-d8ba-4e70-ab90-1a27ab696e11
46	46	0	GBIF Brazil	cdc9736d-5ff7-4ece-9959-3c744360cdb3	f0ef3703-bab0-4a6b-bab4-e49475784f61
12	12	0	Plazi	ffb07bec-2d10-492d-9c37-361fe0b79427	f2befdc9-02c0-44b7-9d78-2433a77ec64d
64	64	0	Plazi	ffb07bec-2d10-492d-9c37-361fe0b79427	f8e70840-628c-4491-b274-433f53396d8c
0	4	4	Plazi	ffb07bec-2d10-492d-9c37-361fe0b79427	f94f7853-196a-4ff9-a452-3363d22e377d
1500515	1500515	0	Canada Biodiversity Information Facility	8f83fc96-c966-4126-83f7-bf044dc49efa	f9a70dab-004b-45ad-90cb-24d8ff645b44
35753	36192	439	GBIF Brazil	cdc9736d-5ff7-4ece-9959-3c744360cdb3	fce21d43-c0c7-4d1f-b6d2-fc048f053456
1088	1088	0	GBIF Sweden	a0b3be64-6525-4387-ac67-a499950f92e1	fe1e1577-0883-4e2a-b435-d99451828a15
723	723	0	Atlas of Living Australia	4a6f1b71-969e-4fc5-a693-282b05e1220c	fed2ec12-dce0-4f72-8b25-c6c2fa64a0ef
299	299	0	GBIF France	da44cd31-5901-4687-a106-6d1c7734ee3a	0167c341-ca4e-428d-b7e0-a53ae32be2d2
222	222	0	Biodiversity Information System of Mexico	b324e8e9-9a4c-44fa-8f1a-7f39ea7ab576	05dcd87b-7aaa-4984-bc0f-20d4562f73ad
0	21	21	Plazi	ffb07bec-2d10-492d-9c37-361fe0b79427	06cd2741-40b2-4eb7-9e13-d032fcc2d8e6
49	49	0	Plazi	ffb07bec-2d10-492d-9c37-361fe0b79427	09484daa-48ba-4080-9e82-b92f0105607a
4377	4377	0	National Biodiversity Network	d897a5b9-35ee-4232-94bd-b0bcaac003c2	0b02615b-9e28-4425-b29f-1209f9a0a896
9	9	0	Plazi	ffb07bec-2d10-492d-9c37-361fe0b79427	0b5fb120-0ab9-449e-a587-cd979ae9906f
11	11	0	GBIF Togo	c9659a3e-07e9-4fcb-83c6-de8b9009a02e	0d8de808-1009-49cc-9c53-df9abb94af9f
321	321	0	Inter American Biodiversity Information Network	69f8ea9e-b2a6-4e5a-896f-3bf8fc23cc8d	0db0a5df-6fca-4ac1-b4d0-c061de5ff2b4
4	4	0	Plazi	ffb07bec-2d10-492d-9c37-361fe0b79427	14073a5d-dc2e-4abc-b8b2-bcfa1d6759e4
0	1528	1528	Ocean Biodiversity Information System	ba0670b9-4186-41e6-8e70-f9cb3065551a	14165ac9-2e8b-47e4-bd75-98c2351b332d
0	17	17	Plazi	ffb07bec-2d10-492d-9c37-361fe0b79427	14569d0f-7c0a-4ca9-bc15-2b3815119fab
103	103	0	Participant Node Managers Committee	7f48e0c8-5c96-49ec-b972-30748e339115	1570db97-7b8d-4f12-9c3b-10c731460ca6
2562	2562	0	Biodiversity Information System of Mexico	b324e8e9-9a4c-44fa-8f1a-7f39ea7ab576	1893c14e-0e32-43cf-8ea0-38eeacc2a3c0
529	529	0	National Biodiversity Data Centre	422b00b2-6c94-4bb6-976b-c359916efdb8	18c4234c-6b97-42f6-b27a-8fa3d87eebbf
2591	2591	0	National Biodiversity Network	d897a5b9-35ee-4232-94bd-b0bcaac003c2	1948a896-92c8-42de-a01a-38176a407e5a
7693	7693	0	GBIF Norway	4f829580-180d-46a9-9c87-ed8ec959b545	1acdfdd0-e43d-4d5d-92bc-7a2a60a03782
44	44	0	GBIF France	da44cd31-5901-4687-a106-6d1c7734ee3a	1ad2c0a9-2280-4a0e-94fb-629915eb070d
16537	16537	0	GBIF France	da44cd31-5901-4687-a106-6d1c7734ee3a	1b4071af-2811-44a9-95ea-9067c74f2430
226899	226899	0	GBIF France	da44cd31-5901-4687-a106-6d1c7734ee3a	217a1e61-33a1-471e-bb05-76cd2e22cb06
1	1	0	Plazi	ffb07bec-2d10-492d-9c37-361fe0b79427	249faa66-1f6a-44a0-b7f2-f12acaf62e5b
0	48	48	Plazi	ffb07bec-2d10-492d-9c37-361fe0b79427	2578a05f-0fae-474e-89af-8d5988121993
37342	37342	0	GBIF France	da44cd31-5901-4687-a106-6d1c7734ee3a	27108396-6c3d-4bbd-a98f-7b8fcce2f12b
5	5	0	Plazi	ffb07bec-2d10-492d-9c37-361fe0b79427	2bb49143-5cbd-42f7-9689-de741f351ff7
54	54	0	Plazi	ffb07bec-2d10-492d-9c37-361fe0b79427	2cd2ff4b-df92-4daa-a2b8-8f7a65dfcc96
41525	41525	0	Atlas of Living Australia	4a6f1b71-969e-4fc5-a693-282b05e1220c	2e844554-d9bf-4540-8c6d-2999ad5ced21
0	1	1	Plazi	ffb07bec-2d10-492d-9c37-361fe0b79427	320917c5-565c-417c-acf5-2ee9776ac6a2
30	30	0	Plazi	ffb07bec-2d10-492d-9c37-361fe0b79427	363bb64c-5e2a-4a2f-bfa1-3951d400082f
0	15	15	Plazi	ffb07bec-2d10-492d-9c37-361fe0b79427	37eefe05-4ff9-4762-a724-07deef527831
14502	14502	0	Biodiversity Information System of Mexico	b324e8e9-9a4c-44fa-8f1a-7f39ea7ab576	3b416007-a6f2-4f30-aa2d-42cb3701da8e
18	18	0	Plazi	ffb07bec-2d10-492d-9c37-361fe0b79427	3c15a81f-d876-4636-8287-0993298fb0eb
4998	4998	0	U.S. Geological Survey	8618c64a-93e0-4300-b546-7249e5148ed2	3d84f407-8a76-473a-b8c8-54a58d5f581b
75	75	0	Plazi	ffb07bec-2d10-492d-9c37-361fe0b79427	3dd16235-3e75-4b7f-aa95-689623b331aa
200	200	0	GBIF Brazil	cdc9736d-5ff7-4ece-9959-3c744360cdb3	3ebd762b-6924-43a8-8598-b61314091c2c
0	41	41	Plazi	ffb07bec-2d10-492d-9c37-361fe0b79427	4261ab18-9888-4937-b002-c7bfde574ff5
0	1	1	Plazi	ffb07bec-2d10-492d-9c37-361fe0b79427	42830af1-0fcb-4e30-b3d7-d3d685ba86d4
209	209	0	Participant Node Managers Committee	7f48e0c8-5c96-49ec-b972-30748e339115	447eabf9-3b04-4927-9420-52c5e5c096fc
127	127	0	GBIF Benin	efb9c00e-f802-45dd-8826-a52ec45b89ff	47010b29-1e8f-44df-9446-07057c4e1050
1660	1660	0	Plazi	ffb07bec-2d10-492d-9c37-361fe0b79427	4af4947a-c9d6-42ed-9af0-5c51ac265f51
778	778	0	U.S. Geological Survey	8618c64a-93e0-4300-b546-7249e5148ed2	4cb3d289-8d1e-4831-9c01-df02084b999a
0	1843	1843	DanBIF - Danish Biodiversity Information Facility	4ddd294f-02b7-4359-ac33-0806a9ca9c6b	4d1bd299-2435-47e2-8fe1-ac949394a40d
0	10	10	Plazi	ffb07bec-2d10-492d-9c37-361fe0b79427	4e72cf73-31a3-4dc1-8fc2-40e2cb7d8a91
0	2220	2220	Biodiversity Information System of Mexico	b324e8e9-9a4c-44fa-8f1a-7f39ea7ab576	4f22ccf9-4ac4-4dd5-8ca9-6c78e9112974
35	35	0	Plazi	ffb07bec-2d10-492d-9c37-361fe0b79427	508d8422-a253-47fc-a55e-26e58bc6a0ac
2	2	0	Plazi	ffb07bec-2d10-492d-9c37-361fe0b79427	50cdb3af-4b12-4065-a496-0ea8baf231fd
390	390	0	National Biodiversity Network	d897a5b9-35ee-4232-94bd-b0bcaac003c2	52494302-cab5-458a-9e98-9dffac262599
1319	1319	0	GBIF Portugal	673f7038-4262-4149-b753-5658a4e912f6	562e4391-c8f6-4835-8e91-beb85b094a18
0	3549	3549	Ocean Biodiversity Information System	ba0670b9-4186-41e6-8e70-f9cb3065551a	56f10d68-66ec-4a5d-a636-4bad5722ab60
42517	42517	0	Belgian Biodiversity Platform	fb11cfe1-ebc3-45af-9159-17d9fddbcdac	5d784d06-fa1d-4f00-8cdc-663d04d26061
54	54	0	GBIF Germany	4f6826f2-4ff6-443d-b966-e6913bd24013	61c76458-f762-11e1-a439-00145eb45e9a
160	160	0	GBIF Germany	4f6826f2-4ff6-443d-b966-e6913bd24013	61e67a8c-f762-11e1-a439-00145eb45e9a
245	245	0	GBIF Germany	4f6826f2-4ff6-443d-b966-e6913bd24013	62168560-f762-11e1-a439-00145eb45e9a
94	94	0	GBIF Germany	4f6826f2-4ff6-443d-b966-e6913bd24013	64612a0a-f762-11e1-a439-00145eb45e9a
11	11	0	GBIF Germany	4f6826f2-4ff6-443d-b966-e6913bd24013	649a41b4-f762-11e1-a439-00145eb45e9a
34	34	0	GBIF Germany	4f6826f2-4ff6-443d-b966-e6913bd24013	64cded66-f762-11e1-a439-00145eb45e9a
2	2	0	Plazi	ffb07bec-2d10-492d-9c37-361fe0b79427	65c38733-a538-46c5-a323-af23c50c9adf
0	43	43	Plazi	ffb07bec-2d10-492d-9c37-361fe0b79427	662e3cfb-c54c-4b01-ab00-a707ca9bf448
129	129	0	GBIF Germany	4f6826f2-4ff6-443d-b966-e6913bd24013	66d0a86a-f762-11e1-a439-00145eb45e9a
45	45	0	GBIF Germany	4f6826f2-4ff6-443d-b966-e6913bd24013	6cbede0e-f762-11e1-a439-00145eb45e9a
0	6396	6396	Ocean Biodiversity Information System	ba0670b9-4186-41e6-8e70-f9cb3065551a	6cc99ecb-d01f-4934-8d84-e39db0459afb
1395	1395	0	Netherlands Biodiversity Information Facility	0909d601-bda2-42df-9e63-a6d51847ebce	6f709fbf-67c5-4ae0-afe9-e8bc3ad6e2dc
8	8	0	GBIF Germany	4f6826f2-4ff6-443d-b966-e6913bd24013	6fb67e0a-f762-11e1-a439-00145eb45e9a
5978	5979	1	GBIF Brazil	cdc9736d-5ff7-4ece-9959-3c744360cdb3	704c6469-86ba-418b-bda1-66dc56f4b5ee
175	175	0	GBIF Germany	4f6826f2-4ff6-443d-b966-e6913bd24013	7191f93e-f762-11e1-a439-00145eb45e9a
491	491	0	Participant Node Managers Committee	7f48e0c8-5c96-49ec-b972-30748e339115	7198c3a4-925b-4081-9600-9cc18bd9aca1
50	32	-18	GBIF Germany	4f6826f2-4ff6-443d-b966-e6913bd24013	7228e6a0-f762-11e1-a439-00145eb45e9a
17938	17938	0	GBIF France	da44cd31-5901-4687-a106-6d1c7734ee3a	72b9e6cb-b0d2-4298-b4c5-4d270cd1b53f
2261	2261	0	Atlas of Living Australia	4a6f1b71-969e-4fc5-a693-282b05e1220c	72e7571d-6d9c-4a87-94ea-7c5732bab796
5	5	0	GBIF Germany	4f6826f2-4ff6-443d-b966-e6913bd24013	744d65dc-f762-11e1-a439-00145eb45e9a
539	539	0	GBIF Germany	4f6826f2-4ff6-443d-b966-e6913bd24013	7770db18-f762-11e1-a439-00145eb45e9a
49	49	0	GBIF Germany	4f6826f2-4ff6-443d-b966-e6913bd24013	7774ad06-f762-11e1-a439-00145eb45e9a
21	21	0	GBIF Germany	4f6826f2-4ff6-443d-b966-e6913bd24013	7843bab0-f762-11e1-a439-00145eb45e9a
32	32	0	GBIF Germany	4f6826f2-4ff6-443d-b966-e6913bd24013	78cd5a86-f762-11e1-a439-00145eb45e9a
391	391	0	GBIF France	da44cd31-5901-4687-a106-6d1c7734ee3a	78e4c782-134e-4b49-a9a4-74f43f5aa2c6
0	569	569	Participant Node Managers Committee	7f48e0c8-5c96-49ec-b972-30748e339115	7a504738-e749-4253-98bd-e30ae53302fd
86	86	0	GBIF Germany	4f6826f2-4ff6-443d-b966-e6913bd24013	7a8b66ec-f762-11e1-a439-00145eb45e9a
544	32	-512	GBIF Germany	4f6826f2-4ff6-443d-b966-e6913bd24013	7d9d935a-f762-11e1-a439-00145eb45e9a
645	645	0	GBIF Germany	4f6826f2-4ff6-443d-b966-e6913bd24013	7dda417e-f762-11e1-a439-00145eb45e9a
1	1	0	Plazi	ffb07bec-2d10-492d-9c37-361fe0b79427	7eba4551-e113-4902-9cb3-26a4d5df2993
1272	1272	0	Biodiversity Information System of Mexico	b324e8e9-9a4c-44fa-8f1a-7f39ea7ab576	80bd1db2-f762-11e1-a439-00145eb45e9a
2784	1044	-1740	GBIF Germany	4f6826f2-4ff6-443d-b966-e6913bd24013	81ec8f4c-f762-11e1-a439-00145eb45e9a
34	34	0	GBIF Germany	4f6826f2-4ff6-443d-b966-e6913bd24013	826a4536-f762-11e1-a439-00145eb45e9a
40	40	0	Korean Biodiversity Information Facility	e0a1e772-0177-4800-94b4-2d023fe6cdf4	84352188-f762-11e1-a439-00145eb45e9a
8670	8670	0	GBIF Portugal	673f7038-4262-4149-b753-5658a4e912f6	84575824-36b1-413b-8036-1d613a9e2de0
894	894	0	Biodiversity Information System of Mexico	b324e8e9-9a4c-44fa-8f1a-7f39ea7ab576	8514f100-f762-11e1-a439-00145eb45e9a
449	449	0	GBIF Germany	4f6826f2-4ff6-443d-b966-e6913bd24013	8586fb53-1b5d-4406-9cdc-8ac0fc8486cf
661	661	0	Korean Biodiversity Information Facility	e0a1e772-0177-4800-94b4-2d023fe6cdf4	8597c530-f762-11e1-a439-00145eb45e9a
51	51	0	GBIF Germany	4f6826f2-4ff6-443d-b966-e6913bd24013	85e3194a-f762-11e1-a439-00145eb45e9a
0	2	2	Plazi	ffb07bec-2d10-492d-9c37-361fe0b79427	85f2d97e-e6f9-42af-8b64-ec526e74fee6
36655	38655	2000	GBIF Japan	db5705aa-6a6e-42f1-8942-d77b9f4896ea	869fd238-f762-11e1-a439-00145eb45e9a
2067	1620	-447	GBIF Germany	4f6826f2-4ff6-443d-b966-e6913bd24013	86c8cbde-f762-11e1-a439-00145eb45e9a
808	619	-189	GBIF Germany	4f6826f2-4ff6-443d-b966-e6913bd24013	87f9f104-f762-11e1-a439-00145eb45e9a
789	789	0	GBIF Germany	4f6826f2-4ff6-443d-b966-e6913bd24013	898ea4a6-f762-11e1-a439-00145eb45e9a
129	129	0	GBIF Germany	4f6826f2-4ff6-443d-b966-e6913bd24013	89fa9d64-f762-11e1-a439-00145eb45e9a
134	134	0	GBIF Kenya	2a44d626-9f7a-4120-8a7a-4ab5ac15ff2a	8ae3f85f-7997-4a3e-8867-98b37af4d034
1017	1017	0	GBIF Germany	4f6826f2-4ff6-443d-b966-e6913bd24013	8b79a66c-f762-11e1-a439-00145eb45e9a
0	7	7	Plazi	ffb07bec-2d10-492d-9c37-361fe0b79427	8d1b6096-71da-464c-81b3-ef4a3764ce07
106	106	0	GBIF Germany	4f6826f2-4ff6-443d-b966-e6913bd24013	8d7ce38e-f762-11e1-a439-00145eb45e9a
1202	925	-277	GBIF Germany	4f6826f2-4ff6-443d-b966-e6913bd24013	8deaf5f4-f762-11e1-a439-00145eb45e9a
260	260	0	Participant Node Managers Committee	7f48e0c8-5c96-49ec-b972-30748e339115	8deb3d52-09d4-4c0f-9ca2-bd258a63b78c
13	8	-5	GBIF Germany	4f6826f2-4ff6-443d-b966-e6913bd24013	8e1d76fa-f762-11e1-a439-00145eb45e9a
485	352	-133	GBIF Germany	4f6826f2-4ff6-443d-b966-e6913bd24013	8e3a1e72-f762-11e1-a439-00145eb45e9a
63426	63426	0	U.S. Geological Survey	8618c64a-93e0-4300-b546-7249e5148ed2	8eddc200-f535-4c65-9b4d-f723eafe607e
104	104	0	GBIF Germany	4f6826f2-4ff6-443d-b966-e6913bd24013	8f40dbb2-f762-11e1-a439-00145eb45e9a
688	587	-101	GBIF Germany	4f6826f2-4ff6-443d-b966-e6913bd24013	907ea428-f762-11e1-a439-00145eb45e9a
438	371	-67	GBIF Germany	4f6826f2-4ff6-443d-b966-e6913bd24013	90939306-f762-11e1-a439-00145eb45e9a
114	75	-39	GBIF Germany	4f6826f2-4ff6-443d-b966-e6913bd24013	92ac44a8-f762-11e1-a439-00145eb45e9a
9	9	0	Plazi	ffb07bec-2d10-492d-9c37-361fe0b79427	92d7eb5b-8a7c-4ab3-8f77-7beb54bee4c9
911	911	0	GBIF Germany	4f6826f2-4ff6-443d-b966-e6913bd24013	94393b14-f762-11e1-a439-00145eb45e9a
2197	2197	0	GBIF Germany	4f6826f2-4ff6-443d-b966-e6913bd24013	9511ab0c-f762-11e1-a439-00145eb45e9a
4579	4579	0	GBIF Spain	1f94b3ca-9345-4d65-afe2-4bace93aa0fe	95e78a56-f762-11e1-a439-00145eb45e9a
162740	162768	28	U.S. Geological Survey	8618c64a-93e0-4300-b546-7249e5148ed2	963f12d0-f762-11e1-a439-00145eb45e9a
20	20	0	Plazi	ffb07bec-2d10-492d-9c37-361fe0b79427	96a275f2-51b7-40dc-ae02-e3f8611545d1
34	34	0	GBIF Germany	4f6826f2-4ff6-443d-b966-e6913bd24013	9767ee34-f762-11e1-a439-00145eb45e9a
8	8	0	GBIF Portugal	673f7038-4262-4149-b753-5658a4e912f6	9813ea12-db95-4695-8c7a-b001e2ac5a2c
12	12	0	Plazi	ffb07bec-2d10-492d-9c37-361fe0b79427	98bfb263-56ab-4260-8fb0-1bb6eaadbd02
2	2	0	Plazi	ffb07bec-2d10-492d-9c37-361fe0b79427	9b19b254-af96-4294-b623-5ed6bf2745e8
252799	255852	3053	U.S. Geological Survey	8618c64a-93e0-4300-b546-7249e5148ed2	9b7d1acf-b22f-4a1f-b6e8-f1ddd744dc07
102	102	0	GBIF Kenya	2a44d626-9f7a-4120-8a7a-4ab5ac15ff2a	9d4b213a-4946-46ed-801b-d9f9647a20e8
7	7	0	Plazi	ffb07bec-2d10-492d-9c37-361fe0b79427	9f32a269-ada4-46bd-afc2-d5f74b73e53a
4	4	0	Plazi	ffb07bec-2d10-492d-9c37-361fe0b79427	a01119e3-5395-4d97-8fa6-bb6742b6722d
20	20	0	Biodiversity Information System of Mexico	b324e8e9-9a4c-44fa-8f1a-7f39ea7ab576	a36c8169-0fdd-47d4-8d95-8ecca73dc1e2
190	190	0	Participant Node Managers Committee	7f48e0c8-5c96-49ec-b972-30748e339115	a60aa653-c01d-4e7a-b107-c92205633e93
20	20	0	Plazi	ffb07bec-2d10-492d-9c37-361fe0b79427	a7a5a68c-6084-4cf9-b941-d80718973a7d
17031	17031	0	Netherlands Biodiversity Information Facility	0909d601-bda2-42df-9e63-a6d51847ebce	ab3272e4-2b89-487f-8619-e59adf5733cd
31	31	0	Plazi	ffb07bec-2d10-492d-9c37-361fe0b79427	ac6549cd-1bfb-43d8-8cff-c6fc49bb30a7
59	59	0	GBIF France	da44cd31-5901-4687-a106-6d1c7734ee3a	af4d898b-f72b-4c9f-89e5-2e51705e77bb
0	114	114	Ocean Biodiversity Information System	ba0670b9-4186-41e6-8e70-f9cb3065551a	b1568c0b-fc65-41fd-a9d0-dcf40f5b4524
0	7	7	Plazi	ffb07bec-2d10-492d-9c37-361fe0b79427	b86975b8-85dd-498f-ab92-e628f96d66e4
0	12	12	Plazi	ffb07bec-2d10-492d-9c37-361fe0b79427	b932c9e5-ddad-4c11-8eee-ff17188d77cf
28	39	11	Plazi	ffb07bec-2d10-492d-9c37-361fe0b79427	b97fd151-e825-47df-8472-cf628646d260
5969	5969	0	Polish Biodiversity Information Network	2618bfdf-e194-4911-a241-80db3107bc51	ba53b8d0-13de-11de-b2e1-b8a03c50a862
7	7	0	Plazi	ffb07bec-2d10-492d-9c37-361fe0b79427	bc1633c1-9b3e-49d0-b3c6-1447d63c2901
170	170	0	Atlas of Living Australia	4a6f1b71-969e-4fc5-a693-282b05e1220c	bdda202f-3b58-4cbc-828a-12ea52253d62
96588	96865	277	U.S. Geological Survey	8618c64a-93e0-4300-b546-7249e5148ed2	bec73359-a65f-4402-9692-f498ef0e71cb
122	122	0	Participant Node Managers Committee	7f48e0c8-5c96-49ec-b972-30748e339115	bf35f7fe-b65f-4b95-b495-ea6eefb240bd
0	34437	34437	Colombian Biodiversity Information System	7e865cba-7c46-417b-ade5-97f2cf5b7be0	c3a5002d-06bf-47dc-8477-b75d5a848026
11	11	0	Plazi	ffb07bec-2d10-492d-9c37-361fe0b79427	c644a1dd-e0c9-4718-9d32-023067dbf1ce
0	55	55	Plazi	ffb07bec-2d10-492d-9c37-361fe0b79427	c6cd0951-6d64-4b2f-b920-bb7ba439eb39
79673	79673	0	National Biodiversity Network	d897a5b9-35ee-4232-94bd-b0bcaac003c2	ca7c3b59-6802-42fd-a7e6-18ad7409506b
3	3	0	Plazi	ffb07bec-2d10-492d-9c37-361fe0b79427	cc092c5e-54a2-40d3-a34f-ce0d71bb7d3b
9480	9480	0	Biodiversity Information System of Mexico	b324e8e9-9a4c-44fa-8f1a-7f39ea7ab576	cd2f99e0-9b66-44b5-8cd8-4f5dc58c2a54
20099	20099	0	GBIF Brazil	cdc9736d-5ff7-4ece-9959-3c744360cdb3	d206a2a0-cf78-4085-b808-2356058b742a
976	976	0	GBIF France	da44cd31-5901-4687-a106-6d1c7734ee3a	d68fa195-b3c5-490d-92cd-243972047a86
0	356	356	Plazi	ffb07bec-2d10-492d-9c37-361fe0b79427	d9b0cd0c-8637-4f41-aaca-f02f19a308e6
8	8	0	Plazi	ffb07bec-2d10-492d-9c37-361fe0b79427	dc5999f6-034e-4a1a-ab2e-f39002eef162
1	1	0	Plazi	ffb07bec-2d10-492d-9c37-361fe0b79427	dd3673fc-e1a3-46c9-8deb-c7f1a1f0a484
427	571	144	Atlas of Living Australia	4a6f1b71-969e-4fc5-a693-282b05e1220c	def80289-b974-48d3-8ff1-7e91c82b5bfd
4	4	0	Plazi	ffb07bec-2d10-492d-9c37-361fe0b79427	e1990f2e-89e4-476e-8407-8d736c02f47a
5443	5443	0	Polish Biodiversity Information Network	2618bfdf-e194-4911-a241-80db3107bc51	e4434e00-a215-11da-beae-b8a03c50a862
3341	3358	17	Canada Biodiversity Information Facility	8f83fc96-c966-4126-83f7-bf044dc49efa	e5e89b4d-bb7c-4dae-b1b4-924177e95c2b
2	2	0	Plazi	ffb07bec-2d10-492d-9c37-361fe0b79427	e6914caf-bb5b-41f6-bf49-eaa87ef1fb1f
2	2	0	Plazi	ffb07bec-2d10-492d-9c37-361fe0b79427	ea49d2ed-9124-4407-84b9-5702eee7e665
61366	61366	0	National Biodiversity Network	d897a5b9-35ee-4232-94bd-b0bcaac003c2	ec148118-3936-4e83-a2ca-a1e19529fa92
169859	173359	3500	National Biodiversity Network	d897a5b9-35ee-4232-94bd-b0bcaac003c2	efb3f1a0-43d5-4ae6-a58f-4fd61043756a
3	3	0	Plazi	ffb07bec-2d10-492d-9c37-361fe0b79427	f1195456-24f4-4762-88d5-c4ffe863e07e
1	1	0	Plazi	ffb07bec-2d10-492d-9c37-361fe0b79427	f1a143d1-fec6-4a90-9672-df34c33b72d4
3163	3163	0	GBIF Nigeria	6529bcb5-a542-4fda-be87-54a624515335	f1e99a55-3278-4279-bf54-68e8b84dfc1c
915	915	0	GBIF Benin	efb9c00e-f802-45dd-8826-a52ec45b89ff	f39014fa-89bf-4717-bcfc-0fb8841c32c1
0	3	3	Plazi	ffb07bec-2d10-492d-9c37-361fe0b79427	f58303c8-1f62-49dd-84fa-462098bcd2dd
20	20	0	Plazi	ffb07bec-2d10-492d-9c37-361fe0b79427	f71bb857-782a-4635-a98b-dd258ca2a1ba
0	271	271	Belgian Biodiversity Platform	fb11cfe1-ebc3-45af-9159-17d9fddbcdac	f7da6b93-4304-4646-80ad-99248d3e303c
0	2	2	Plazi	ffb07bec-2d10-492d-9c37-361fe0b79427	faddf0dd-4267-4ca2-ac71-dbba6f034866
0	2	2	Plazi	ffb07bec-2d10-492d-9c37-361fe0b79427	fb2cf0ca-f75b-4f80-a113-d1febae51c17
4	4	0	Plazi	ffb07bec-2d10-492d-9c37-361fe0b79427	fc566a9b-0495-4788-b0f4-238530113b77
0	18943	18943	U.S. Geological Survey	8618c64a-93e0-4300-b546-7249e5148ed2	fca6147f-6460-445a-9e6a-5ebc5eddf703
3	3	0	Plazi	ffb07bec-2d10-492d-9c37-361fe0b79427	01a6d01f-6119-46d3-b7c6-7d2ed44de08c
64	64	0	Participant Node Managers Committee	7f48e0c8-5c96-49ec-b972-30748e339115	070a84ca-390e-4985-9d4f-226faf859370
26	26	0	Plazi	ffb07bec-2d10-492d-9c37-361fe0b79427	08fb092e-b3df-47c4-a1ad-8ea8ffd2457a
0	10	10	Plazi	ffb07bec-2d10-492d-9c37-361fe0b79427	09a3523d-5fa7-4643-8610-3108b16d077e
0	29	29	Plazi	ffb07bec-2d10-492d-9c37-361fe0b79427	0b369942-b5f5-45a8-9975-14995ad9696c
3	3	0	Plazi	ffb07bec-2d10-492d-9c37-361fe0b79427	0c2bcd94-88bf-4d32-96ca-aab7ec26945f
1353	1353	0	GBIF Argentina	2426a871-9feb-40a1-96c6-0c593a76b835	0c876836-5fe0-4f3d-8eba-ef155f2568fd
0	83142	83142	U.S. Geological Survey	8618c64a-93e0-4300-b546-7249e5148ed2	0fd9d08c-63c4-4b9a-8d0f-15a6202d88e2
190	190	0	GBIF France	da44cd31-5901-4687-a106-6d1c7734ee3a	0ffb1175-af77-4b0c-833b-f1196a61d87e
16359	16359	0	GBIF Japan	db5705aa-6a6e-42f1-8942-d77b9f4896ea	1179f3c2-4501-4d27-b5f7-1e3440de12e7
2	2	0	Plazi	ffb07bec-2d10-492d-9c37-361fe0b79427	1195a4d4-0cf1-4481-a2aa-bfc216dd8ada
0	3	3	Plazi	ffb07bec-2d10-492d-9c37-361fe0b79427	11fcc792-8225-48e1-9eb5-9a4e617e55ab
355	355	0	GBIF Spain	1f94b3ca-9345-4d65-afe2-4bace93aa0fe	127d349d-c641-4897-8fe7-4bea2f540709
5490	5490	0	GBIF Japan	db5705aa-6a6e-42f1-8942-d77b9f4896ea	12b7c8fc-f696-4a10-86b1-5a97ffce428b
0	3	3	Plazi	ffb07bec-2d10-492d-9c37-361fe0b79427	12e7d368-6780-4c05-a842-207cecb70137
853	853	0	GBIF Togo	c9659a3e-07e9-4fcb-83c6-de8b9009a02e	137f238e-93af-48d1-8c27-c4b6efe4d71e
154	154	0	GBIF Germany	4f6826f2-4ff6-443d-b966-e6913bd24013	13a0db74-c9d4-41b2-9100-3bb4621dbd79
221510	241075	19565	GBIF Brazil	cdc9736d-5ff7-4ece-9959-3c744360cdb3	17efa320-7312-4b55-bf0a-a4cfc4613169
0	15	15	Plazi	ffb07bec-2d10-492d-9c37-361fe0b79427	1aad5191-b2c2-4c16-9efc-13d53ac49544
0	21	21	Plazi	ffb07bec-2d10-492d-9c37-361fe0b79427	1afc039c-02d1-444f-b0bb-eca4e7d077a5
80	80	0	GBIF France	da44cd31-5901-4687-a106-6d1c7734ee3a	1ca26539-22e1-4d8c-8c7d-8e34aec22ee6
106	106	0	Plazi	ffb07bec-2d10-492d-9c37-361fe0b79427	1cb05c32-d8ce-45c3-9a19-22ece4d259cb
0	6	6	Plazi	ffb07bec-2d10-492d-9c37-361fe0b79427	1ee4fa78-bb34-47ea-85f3-eeb8c7b9046a
169428	171380	1952	GBIF Sweden	a0b3be64-6525-4387-ac67-a499950f92e1	2356f899-6244-4bbb-aa33-50e29132e86a
0	3895	3895	Colombian Biodiversity Information System	7e865cba-7c46-417b-ade5-97f2cf5b7be0	23c0b8b2-3589-4b5e-a205-d02122aa9f9c
40814	40814	0	GBIF France	da44cd31-5901-4687-a106-6d1c7734ee3a	253ec34a-3492-45b5-a8df-d01ebde24bd2
5	5	0	Plazi	ffb07bec-2d10-492d-9c37-361fe0b79427	2a914627-2a79-491c-a3b0-d3977ea56e9d
3	3	0	Plazi	ffb07bec-2d10-492d-9c37-361fe0b79427	2cda8cb6-fde6-4cb1-8301-1c91bb3c2889
126	126	0	GBIF Brazil	cdc9736d-5ff7-4ece-9959-3c744360cdb3	2fd18368-47e7-49e8-9912-014093c433b3
0	3	3	Plazi	ffb07bec-2d10-492d-9c37-361fe0b79427	31f5a0ea-d850-4a75-89eb-99a2da24e53c
27	27	0	Plazi	ffb07bec-2d10-492d-9c37-361fe0b79427	32e7aaf6-319c-48a3-9daf-cfb5fd21c39c
0	2	2	Plazi	ffb07bec-2d10-492d-9c37-361fe0b79427	35a61eb4-ccdd-4ff8-b7ab-437ebca20c68
8	8	0	Plazi	ffb07bec-2d10-492d-9c37-361fe0b79427	376ad5e1-afef-42db-b017-593e1bcd01ac
0	4	4	Plazi	ffb07bec-2d10-492d-9c37-361fe0b79427	38660b46-e5cf-4386-8553-96f8d60bce25
2577	2577	0	Korean Biodiversity Information Facility	e0a1e772-0177-4800-94b4-2d023fe6cdf4	394aed4a-ecb9-4a72-94a8-e6889682985c
0	6	6	Plazi	ffb07bec-2d10-492d-9c37-361fe0b79427	3c0084e1-d3c9-4633-8e39-1513f2148596
868	868	0	Plazi	ffb07bec-2d10-492d-9c37-361fe0b79427	3e84f284-4d30-4c6e-a801-f9822d49edfc
62015	62015	0	GBIF Spain	1f94b3ca-9345-4d65-afe2-4bace93aa0fe	3eaec825-e7a4-49b2-b6e5-f406595f8555
52	52	0	GBIF Niger	dc9041d6-a5ae-4217-92ea-f7674794d760	3fb7ddd8-07c0-490d-a0f1-32b5dec8d583
0	11	11	Plazi	ffb07bec-2d10-492d-9c37-361fe0b79427	41c0f8e6-def5-49ad-a3ed-0b32df5c824d
1427	1427	0	Participant Node Managers Committee	7f48e0c8-5c96-49ec-b972-30748e339115	42072ec4-b20f-4550-869b-746786fe87b1
43	43	0	GBIF France	da44cd31-5901-4687-a106-6d1c7734ee3a	45f9d454-86ed-4b03-b09b-16f9a1877c21
0	10	10	Plazi	ffb07bec-2d10-492d-9c37-361fe0b79427	472c2996-ff03-46f4-bc3b-79efeeb33fee
75	75	0	Biodiversity Information System of Mexico	b324e8e9-9a4c-44fa-8f1a-7f39ea7ab576	478ccd9e-2dac-47c2-b50a-8209cc55d66e
749213	749213	0	Atlas of Living Australia	4a6f1b71-969e-4fc5-a693-282b05e1220c	47abf4a5-0eb2-4373-bc51-61196e7346d2
0	26	26	Plazi	ffb07bec-2d10-492d-9c37-361fe0b79427	488821ce-fa5c-478e-8804-6de7c27530c4
30	30	0	Plazi	ffb07bec-2d10-492d-9c37-361fe0b79427	4a45f44e-9b26-4cdc-82bc-a09715405e46
0	3	3	Plazi	ffb07bec-2d10-492d-9c37-361fe0b79427	4e0dadd2-0530-4ab7-8314-3a0b1576ea27
2	2	0	Plazi	ffb07bec-2d10-492d-9c37-361fe0b79427	4e1b168d-b36c-4c4f-9bdd-248ea3426a9f
0	30	30	Plazi	ffb07bec-2d10-492d-9c37-361fe0b79427	504c0953-bbfc-4bcf-9103-4c1ac7ff75dc
0	30	30	Ocean Biodiversity Information System	ba0670b9-4186-41e6-8e70-f9cb3065551a	51f67287-1ef4-4389-9951-1cb5067a5875
4	4	0	Plazi	ffb07bec-2d10-492d-9c37-361fe0b79427	53927ce7-a83a-4a6d-929b-b4269892bd23
65	65	0	Polish Biodiversity Information Network	2618bfdf-e194-4911-a241-80db3107bc51	550f8727-56d8-4feb-ae98-d8db0ead73bd
3	3	0	Plazi	ffb07bec-2d10-492d-9c37-361fe0b79427	5c631f70-cf76-4a9b-b449-656b69aa2c87
1353	1353	0	Colombian Biodiversity Information System	7e865cba-7c46-417b-ade5-97f2cf5b7be0	5f65fadb-106f-4d96-95b8-abc7fab492cc
4	4	0	Plazi	ffb07bec-2d10-492d-9c37-361fe0b79427	5fd2a2e6-6ec5-4fc9-8c79-e2b4b634b7b5
38	38	0	Plazi	ffb07bec-2d10-492d-9c37-361fe0b79427	60a3c79b-33df-421e-9e73-befe939ffb8c
55	55	0	GBIF Germany	4f6826f2-4ff6-443d-b966-e6913bd24013	615eab52-f762-11e1-a439-00145eb45e9a
1680	1680	0	Participant Node Managers Committee	7f48e0c8-5c96-49ec-b972-30748e339115	628e212b-2b41-421e-a4f6-db929356c743
2	2	0	Plazi	ffb07bec-2d10-492d-9c37-361fe0b79427	62d23c6d-47a2-45b2-b066-f60dac27e9e1
2814	2814	0	GBIF Germany	4f6826f2-4ff6-443d-b966-e6913bd24013	636e91aa-f762-11e1-a439-00145eb45e9a
1	1	0	GBIF Germany	4f6826f2-4ff6-443d-b966-e6913bd24013	64d8b228-f762-11e1-a439-00145eb45e9a
27	26	-1	GBIF Germany	4f6826f2-4ff6-443d-b966-e6913bd24013	65bcceae-f762-11e1-a439-00145eb45e9a
46265	46265	0	National Biodiversity Network	d897a5b9-35ee-4232-94bd-b0bcaac003c2	65f00962-c18e-44bc-b370-26c8e37bc6eb
47	47	0	GBIF Germany	4f6826f2-4ff6-443d-b966-e6913bd24013	668d4ac0-f762-11e1-a439-00145eb45e9a
145	145	0	GBIF Germany	4f6826f2-4ff6-443d-b966-e6913bd24013	67a39892-f762-11e1-a439-00145eb45e9a
52	52	0	GBIF Germany	4f6826f2-4ff6-443d-b966-e6913bd24013	67c742e2-f762-11e1-a439-00145eb45e9a
18	18	0	GBIF Germany	4f6826f2-4ff6-443d-b966-e6913bd24013	6b75f32a-f762-11e1-a439-00145eb45e9a
44	44	0	Plazi	ffb07bec-2d10-492d-9c37-361fe0b79427	6c12aca1-7350-4265-9ded-6d415152f181
42	42	0	Participant Node Managers Committee	7f48e0c8-5c96-49ec-b972-30748e339115	6c8d863f-790a-4d0d-9f3f-13b1ec804c58
188	188	0	GBIF Germany	4f6826f2-4ff6-443d-b966-e6913bd24013	6d1cdaea-f762-11e1-a439-00145eb45e9a
0	3	3	Plazi	ffb07bec-2d10-492d-9c37-361fe0b79427	6e884f1d-5bc1-4ec4-82b3-534fef9aab11
50	50	0	Plazi	ffb07bec-2d10-492d-9c37-361fe0b79427	6ffefb6a-2d25-4879-80e2-586cc59fcd2a
7043	7043	0	GBIF France	da44cd31-5901-4687-a106-6d1c7734ee3a	715b162c-be00-4013-b1e1-0ad270e3c867
109	102	-7	GBIF Germany	4f6826f2-4ff6-443d-b966-e6913bd24013	72148a70-f762-11e1-a439-00145eb45e9a
0	8	8	Ocean Biodiversity Information System	ba0670b9-4186-41e6-8e70-f9cb3065551a	726cdd3d-1baf-4de7-b5a7-2c7c23723c6c
17	17	0	GBIF Germany	4f6826f2-4ff6-443d-b966-e6913bd24013	72b06dfa-f762-11e1-a439-00145eb45e9a
46	46	0	GBIF Germany	4f6826f2-4ff6-443d-b966-e6913bd24013	736f5a4e-f762-11e1-a439-00145eb45e9a
204	204	0	GBIF Germany	4f6826f2-4ff6-443d-b966-e6913bd24013	75fc5e42-f762-11e1-a439-00145eb45e9a
323	323	0	GBIF Germany	4f6826f2-4ff6-443d-b966-e6913bd24013	7743ab5c-f762-11e1-a439-00145eb45e9a
559	559	0	Plazi	ffb07bec-2d10-492d-9c37-361fe0b79427	77799ae7-9459-43e9-af68-c88aa98852a5
205467	205467	0	GBIF Germany	4f6826f2-4ff6-443d-b966-e6913bd24013	77ecd330-b09e-11e2-a01d-00145eb45e9a
589	589	0	GBIF Germany	4f6826f2-4ff6-443d-b966-e6913bd24013	786d857a-f762-11e1-a439-00145eb45e9a
0	6	6	Plazi	ffb07bec-2d10-492d-9c37-361fe0b79427	7903d074-a590-48ba-b7e6-b515a0f1c65d
2	2	0	Plazi	ffb07bec-2d10-492d-9c37-361fe0b79427	79115675-6b68-445c-b6df-b221158c1b56
338	331	-7	GBIF Germany	4f6826f2-4ff6-443d-b966-e6913bd24013	79bbd8b4-f762-11e1-a439-00145eb45e9a
17	17	0	GBIF Argentina	2426a871-9feb-40a1-96c6-0c593a76b835	7bd94dab-64cb-4558-92b9-74bef1ff1be7
227	227	0	GBIF Germany	4f6826f2-4ff6-443d-b966-e6913bd24013	7c925694-f762-11e1-a439-00145eb45e9a
265	265	0	GBIF Japan	db5705aa-6a6e-42f1-8942-d77b9f4896ea	7cc37a0e-c51a-49dd-906e-a91cc5b64f31
7	7	0	Plazi	ffb07bec-2d10-492d-9c37-361fe0b79427	7cf259fe-0880-48a8-aa5e-f38e59a37b82
1424	1424	0	GBIF Germany	4f6826f2-4ff6-443d-b966-e6913bd24013	7ddb8bb0-f762-11e1-a439-00145eb45e9a
4317	4317	0	Biodiversity Information System of Mexico	b324e8e9-9a4c-44fa-8f1a-7f39ea7ab576	7fb97820-f762-11e1-a439-00145eb45e9a
0	5	5	Plazi	ffb07bec-2d10-492d-9c37-361fe0b79427	80071104-4086-41c3-896d-5d96bcdb5827
45308	45308	0	National Biodiversity Network	d897a5b9-35ee-4232-94bd-b0bcaac003c2	80455677-4c00-4c3d-8290-446e459a9e9c
2000	2000	0	GBIF Japan	db5705aa-6a6e-42f1-8942-d77b9f4896ea	81082abe-f762-11e1-a439-00145eb45e9a
3189	3456	267	GBIF Japan	db5705aa-6a6e-42f1-8942-d77b9f4896ea	810a9010-f762-11e1-a439-00145eb45e9a
2052	1674	-378	GBIF Germany	4f6826f2-4ff6-443d-b966-e6913bd24013	81687e50-f762-11e1-a439-00145eb45e9a
6812	6812	0	GBIF Germany	4f6826f2-4ff6-443d-b966-e6913bd24013	828467f4-f762-11e1-a439-00145eb45e9a
2060	2060	0	GBIF Germany	4f6826f2-4ff6-443d-b966-e6913bd24013	829aa406-f762-11e1-a439-00145eb45e9a
14830	14830	0	GBIF Switzerland	169eb292-376b-4cc6-8e31-9c2c432de0ad	82bb6da8-f762-11e1-a439-00145eb45e9a
1024	1024	0	GBIF France	da44cd31-5901-4687-a106-6d1c7734ee3a	82cdc14b-f7f4-4648-a434-b4fd35465aad
145	145	0	Participant Node Managers Committee	7f48e0c8-5c96-49ec-b972-30748e339115	84c24d06-3fd2-4988-892e-c79685d14bfa
0	113004	113004	Colombian Biodiversity Information System	7e865cba-7c46-417b-ade5-97f2cf5b7be0	84ed08a5-7d5b-4c0c-9de6-5185dd318e1f
389	327	-62	GBIF Germany	4f6826f2-4ff6-443d-b966-e6913bd24013	870fd790-f762-11e1-a439-00145eb45e9a
208	102	-106	GBIF Germany	4f6826f2-4ff6-443d-b966-e6913bd24013	879208fa-f762-11e1-a439-00145eb45e9a
27	27	0	GBIF Germany	4f6826f2-4ff6-443d-b966-e6913bd24013	8888e6a2-f762-11e1-a439-00145eb45e9a
0	382	382	Ocean Biodiversity Information System	ba0670b9-4186-41e6-8e70-f9cb3065551a	889345d0-8008-45cc-a169-37ee0289baa5
352	352	0	GBIF Brazil	cdc9736d-5ff7-4ece-9959-3c744360cdb3	8a1810db-1781-43e2-86fb-b8786dc44c08
222	222	0	GBIF Germany	4f6826f2-4ff6-443d-b966-e6913bd24013	8bb3d10c-f762-11e1-a439-00145eb45e9a
3960	3960	0	GBIF Germany	4f6826f2-4ff6-443d-b966-e6913bd24013	8bbf66ed-7835-4029-9445-68a9af6675bb
116	116	0	Colombian Biodiversity Information System	7e865cba-7c46-417b-ade5-97f2cf5b7be0	8bd0db12-a774-4a3e-b03f-043d568fbf02
22	22	0	Plazi	ffb07bec-2d10-492d-9c37-361fe0b79427	8bd94dd8-ed42-4034-b9a3-db1f55e277c9
10	10	0	GBIF Germany	4f6826f2-4ff6-443d-b966-e6913bd24013	8c1f0daa-f762-11e1-a439-00145eb45e9a
4	4	0	GBIF Germany	4f6826f2-4ff6-443d-b966-e6913bd24013	8c449eda-f762-11e1-a439-00145eb45e9a
138	89	-49	GBIF Germany	4f6826f2-4ff6-443d-b966-e6913bd24013	8c787142-f762-11e1-a439-00145eb45e9a
1723	1723	0	GBIF France	da44cd31-5901-4687-a106-6d1c7734ee3a	8c9ced05-6826-4f05-80b5-f9fa7ceb1833
1	1	0	GBIF Germany	4f6826f2-4ff6-443d-b966-e6913bd24013	8cdd3712-f762-11e1-a439-00145eb45e9a
158	158	0	GBIF Germany	4f6826f2-4ff6-443d-b966-e6913bd24013	8cf60b16-3f0c-4a48-8f6a-6aee193bf1d8
2	2	0	Plazi	ffb07bec-2d10-492d-9c37-361fe0b79427	8e943a26-2033-46bb-bcf7-f40f9e588fbb
293	246	-47	GBIF Germany	4f6826f2-4ff6-443d-b966-e6913bd24013	8efa4094-f762-11e1-a439-00145eb45e9a
153	153	0	GBIF Germany	4f6826f2-4ff6-443d-b966-e6913bd24013	8f7e84bc-f762-11e1-a439-00145eb45e9a
26	26	0	Plazi	ffb07bec-2d10-492d-9c37-361fe0b79427	8f8ea846-51e9-4b8f-9c6c-cb4467e09a37
29	29	0	GBIF Germany	4f6826f2-4ff6-443d-b966-e6913bd24013	90d839e8-f762-11e1-a439-00145eb45e9a
15	14	-1	GBIF Germany	4f6826f2-4ff6-443d-b966-e6913bd24013	916ccdc4-f762-11e1-a439-00145eb45e9a
62	62	0	GBIF Germany	4f6826f2-4ff6-443d-b966-e6913bd24013	91f9abfe-f762-11e1-a439-00145eb45e9a
5	5	0	GBIF Germany	4f6826f2-4ff6-443d-b966-e6913bd24013	923fc1de-f762-11e1-a439-00145eb45e9a
5	5	0	GBIF Germany	4f6826f2-4ff6-443d-b966-e6913bd24013	938d344a-f762-11e1-a439-00145eb45e9a
5035	7535	2500	GBIF Japan	db5705aa-6a6e-42f1-8942-d77b9f4896ea	9770446a-f836-428d-990d-7f46c4d14df8
0	4	4	Ocean Biodiversity Information System	ba0670b9-4186-41e6-8e70-f9cb3065551a	9954fb32-9c80-4c69-92a9-9059a30628ec
486	486	0	Colombian Biodiversity Information System	7e865cba-7c46-417b-ade5-97f2cf5b7be0	9ae949d2-1319-45f0-8ff8-d67d5379ebe9
4591	4591	0	GBIF India	59d15a9b-ba51-43c3-a53f-304fe6732c04	9e7ea106-0bf8-4087-bb61-dfe4f29e0f17
517	517	0	GBIF France	da44cd31-5901-4687-a106-6d1c7734ee3a	a0da4e08-565f-4e1e-9d9d-292bbe6de33d
2743	2743	0	National Biodiversity Network	d897a5b9-35ee-4232-94bd-b0bcaac003c2	a1934939-4a8b-4067-9d97-c789b168d4b6
4	4	0	Participant Node Managers Committee	7f48e0c8-5c96-49ec-b972-30748e339115	a2952129-fad8-4e19-86ce-d751a91298fc
15	15	0	Plazi	ffb07bec-2d10-492d-9c37-361fe0b79427	a2ac57e4-c8eb-41db-98e2-20a0475b8c53
212520	212520	0	GBIF Sweden	a0b3be64-6525-4387-ac67-a499950f92e1	a46ef430-15e2-11dd-b4e8-b8a03c50a862
0	1	1	Participant Node Managers Committee	7f48e0c8-5c96-49ec-b972-30748e339115	a5fe57e0-611b-46ba-be0e-86119ef0503d
0	61	61	Plazi	ffb07bec-2d10-492d-9c37-361fe0b79427	a82cb38a-03d5-4d23-845c-436529542679
4	4	0	Plazi	ffb07bec-2d10-492d-9c37-361fe0b79427	a976d990-77b1-47b6-a9d6-7391c386994b
16	16	0	Plazi	ffb07bec-2d10-492d-9c37-361fe0b79427	abb98a9e-3f3a-49b3-aae9-9c46daa52b5a
124	124	0	Atlas of Living Australia	4a6f1b71-969e-4fc5-a693-282b05e1220c	ad5b3c99-3877-4a24-9a26-6ab55fb9c39f
272	272	0	Colombian Biodiversity Information System	7e865cba-7c46-417b-ade5-97f2cf5b7be0	ade65535-e4b7-47af-8456-f71df55d0f5d
160269	177684	17415	U.S. Geological Survey	8618c64a-93e0-4300-b546-7249e5148ed2	ae24fb7b-af3c-478c-a1ed-2215a90793cc
21	21	0	Participant Node Managers Committee	7f48e0c8-5c96-49ec-b972-30748e339115	afd142ab-4a12-4ff9-b41f-abb59603f350
86	86	0	GBIF France	da44cd31-5901-4687-a106-6d1c7734ee3a	b3bbf03c-0365-456a-9dd1-a47983aeb727
0	3	3	Plazi	ffb07bec-2d10-492d-9c37-361fe0b79427	b3ec5236-4db1-4c7d-8cb8-4ccbb65aea21
0	8	8	Plazi	ffb07bec-2d10-492d-9c37-361fe0b79427	b4151509-1e7e-487a-b378-2312e810947e
0	3	3	Plazi	ffb07bec-2d10-492d-9c37-361fe0b79427	b50ec15a-4206-452e-9e25-1e394c6b42b3
0	568	568	Colombian Biodiversity Information System	7e865cba-7c46-417b-ade5-97f2cf5b7be0	b91ca14e-aa97-4e61-bc87-9c2c11dede19
2	2	0	GBIF Brazil	cdc9736d-5ff7-4ece-9959-3c744360cdb3	ba29109c-01c2-46b3-b594-2247bfbb0ed9
2194	2194	0	Biodiversity Information System of Mexico	b324e8e9-9a4c-44fa-8f1a-7f39ea7ab576	bb72c976-72e6-4870-8fd1-0b2305e2b7c0
589	589	0	Colombian Biodiversity Information System	7e865cba-7c46-417b-ade5-97f2cf5b7be0	c01c0127-7427-45ae-88f7-ff725bbe0342
12966	12966	0	Canada Biodiversity Information Facility	8f83fc96-c966-4126-83f7-bf044dc49efa	c5da77b7-7423-49a4-a379-f423ea0f07b8
411926	411926	0	Ocean Biodiversity Information System	ba0670b9-4186-41e6-8e70-f9cb3065551a	c7b39dbc-39f5-47e6-8b70-d49eea899ef9
26	26	0	Plazi	ffb07bec-2d10-492d-9c37-361fe0b79427	c90818fd-c8c9-42ba-94a7-0bab3eb62cf9
18	18	0	GBIF France	da44cd31-5901-4687-a106-6d1c7734ee3a	cab9873c-6b0f-4198-a913-2bd2bd96af7f
0	1303	1303	Ocean Biodiversity Information System	ba0670b9-4186-41e6-8e70-f9cb3065551a	cf715008-33c7-4aae-ae38-7a7bd501aa6d
352	352	0	National Biodiversity Network	d897a5b9-35ee-4232-94bd-b0bcaac003c2	cfa7bdfb-4b6d-47cd-9a42-55ab7d2e5dac
0	1	1	Plazi	ffb07bec-2d10-492d-9c37-361fe0b79427	cfb4458d-cca0-4ddd-9839-697531b0a9f3
0	333	333	Indonesian Biodiversity Information Facility	2ebd91f6-f14f-4375-b525-c011a3774f03	d21c9a7a-949e-4318-9079-1748253e48a9
4	4	0	Participant Node Managers Committee	7f48e0c8-5c96-49ec-b972-30748e339115	d3210a10-1449-4e51-a9c0-0cff2fafdd6e
120716	120716	0	National Biodiversity Network	d897a5b9-35ee-4232-94bd-b0bcaac003c2	d7d480b1-8406-40a3-b550-dfbcdd62dd57
17	17	0	Plazi	ffb07bec-2d10-492d-9c37-361fe0b79427	da2b247d-1a75-4dc8-90fc-cbfddc9e9eea
0	6	6	Plazi	ffb07bec-2d10-492d-9c37-361fe0b79427	dba46bab-d899-4ded-9310-ca8c53317f6d
13	13	0	Plazi	ffb07bec-2d10-492d-9c37-361fe0b79427	dbcec4ac-cf8f-4215-a445-a63e65e0f02f
0	5	5	Plazi	ffb07bec-2d10-492d-9c37-361fe0b79427	deab1dde-e979-4312-9c5a-5e34cecee4e5
2	2	0	Plazi	ffb07bec-2d10-492d-9c37-361fe0b79427	deacadb5-6964-4aa8-84a0-daef846a0396
140	140	0	Plazi	ffb07bec-2d10-492d-9c37-361fe0b79427	e0aabdb8-bda6-48e4-bdef-f7b64577d5cd
0	2	2	Plazi	ffb07bec-2d10-492d-9c37-361fe0b79427	e0e40523-b778-4563-b74b-f5334cba3646
4596	4596	0	National Biodiversity Network	d897a5b9-35ee-4232-94bd-b0bcaac003c2	eaf6dd00-91ae-4c7a-9966-b4b582404ef6
0	529	529	Ocean Biodiversity Information System	ba0670b9-4186-41e6-8e70-f9cb3065551a	eca6ce5b-72ce-4ce3-b96f-c6ed82eebcc9
15338	15338	0	Colombian Biodiversity Information System	7e865cba-7c46-417b-ade5-97f2cf5b7be0	ee9eb6e3-f770-4af9-962a-625a7235a449
0	5	5	Ocean Biodiversity Information System	ba0670b9-4186-41e6-8e70-f9cb3065551a	f08b36ca-192f-4aec-b555-48d7ce773467
39	39	0	Plazi	ffb07bec-2d10-492d-9c37-361fe0b79427	f2aded92-7461-4b7e-9a9c-1dbc5c307aff
0	5	5	Plazi	ffb07bec-2d10-492d-9c37-361fe0b79427	f2d69b95-656d-4a9b-9075-b0f1ff6689a1
9543	9543	0	National Biodiversity Network	d897a5b9-35ee-4232-94bd-b0bcaac003c2	f32a222c-9b32-47d2-8d29-b48be4a78128
0	6926	6926	Participant Node Managers Committee	7f48e0c8-5c96-49ec-b972-30748e339115	f6822eb1-b570-4566-98b0-894d4213510e
0	201	201	Plazi	ffb07bec-2d10-492d-9c37-361fe0b79427	f68b381d-d0dd-44e2-b9fe-6cf3c1aab1fa
5	5	0	Plazi	ffb07bec-2d10-492d-9c37-361fe0b79427	f787c5eb-e3e6-4439-9212-003267ab196f
13	13	0	Plazi	ffb07bec-2d10-492d-9c37-361fe0b79427	fbea3203-a10b-4e4f-b5f3-3d1387bc84c3
0	19	19	Plazi	ffb07bec-2d10-492d-9c37-361fe0b79427	fd413580-2960-463f-a924-8c27eaeafc6e
1	1	0	Plazi	ffb07bec-2d10-492d-9c37-361fe0b79427	fe0e811b-255d-4a15-859b-aec861ff4a84
291859	291859	0	National Biodiversity Network	d897a5b9-35ee-4232-94bd-b0bcaac003c2	fe3fae72-6524-4bbe-9026-93b42c69b95e
91579	91830	251	GBIF Brazil	cdc9736d-5ff7-4ece-9959-3c744360cdb3	fe8c1017-5941-4703-8f81-5023028a32ab
0	89	89	Participant Node Managers Committee	7f48e0c8-5c96-49ec-b972-30748e339115	fea73f75-d089-4152-ad70-551c90260626
4400	4400	0	VertNet	d205def7-82c3-472a-be4b-31d11dcd51fd	fee15ebc-27ce-4aff-b912-2657bbd493d2
5962	5962	0	National Biodiversity Network	d897a5b9-35ee-4232-94bd-b0bcaac003c2	02f47657-7ef6-4989-bb76-de1eb27cb8f9
1442	1442	0	South African Biodiversity Information Facility	7190b835-4e86-4b6e-85c1-19cc6677c250	0324faa2-894d-459c-b86a-bda617ef0690
163201	175173	11972	Canada Biodiversity Information Facility	8f83fc96-c966-4126-83f7-bf044dc49efa	0348540a-e644-4496-89d3-c257da9ad776
9	9	0	Plazi	ffb07bec-2d10-492d-9c37-361fe0b79427	0399874a-0b95-4e40-a3ca-46de61c7b422
14	14	0	Plazi	ffb07bec-2d10-492d-9c37-361fe0b79427	046743d9-4ee7-4cc0-aaf1-6e47e599543d
0	14	14	Plazi	ffb07bec-2d10-492d-9c37-361fe0b79427	049b6936-13d8-42d6-9468-2019ddf78d14
0	43	43	Plazi	ffb07bec-2d10-492d-9c37-361fe0b79427	04bf840b-8ba9-4059-8190-f2454630a714
7527	7527	0	Colombian Biodiversity Information System	7e865cba-7c46-417b-ade5-97f2cf5b7be0	09d5405e-ca86-45f2-afa7-93cc707f54aa
0	101092	101092	Belgian Biodiversity Platform	fb11cfe1-ebc3-45af-9159-17d9fddbcdac	0c4bf92b-95c9-4a2a-9756-67d98195459f
6	6	0	Plazi	ffb07bec-2d10-492d-9c37-361fe0b79427	0e9444d5-9938-46ed-8f44-5b775809d2bb
0	476	476	National Biodiversity Network	d897a5b9-35ee-4232-94bd-b0bcaac003c2	0f578d6c-2ae3-499e-8b5d-d691b5b36b62
32	32	0	National Biodiversity Network	d897a5b9-35ee-4232-94bd-b0bcaac003c2	16d3da47-eedb-4360-80f8-4f5b2533fece
0	27	27	Ocean Biodiversity Information System	ba0670b9-4186-41e6-8e70-f9cb3065551a	18fafd97-591e-451f-925a-beb6f69458ca
62	62	0	GBIF Norway	4f829580-180d-46a9-9c87-ed8ec959b545	20da1510-558c-448e-991c-07e99f1430b0
22696	23700	1004	GBIF Japan	db5705aa-6a6e-42f1-8942-d77b9f4896ea	218522cf-b0ed-4b0e-8dd9-e543e3cd4951
259	259	0	GBIF France	da44cd31-5901-4687-a106-6d1c7734ee3a	29782f30-7271-4383-8a08-e88ed9c87087
329	329	0	GBIF France	da44cd31-5901-4687-a106-6d1c7734ee3a	2eff1933-b05e-4bef-ba69-7630ae2b4f1a
81	81	0	Atlas of Living Australia	4a6f1b71-969e-4fc5-a693-282b05e1220c	32e8c7c1-b6a8-41b3-8379-6528200ffcff
1	1	0	Plazi	ffb07bec-2d10-492d-9c37-361fe0b79427	33ac870b-0314-4049-ad6b-943e21489a32
57	57	0	Plazi	ffb07bec-2d10-492d-9c37-361fe0b79427	3414318d-7570-49ac-9013-be4e1f1e6347
0	9	9	Ocean Biodiversity Information System	ba0670b9-4186-41e6-8e70-f9cb3065551a	346d5da5-f911-4184-9e63-acc80a226a29
1737	1737	0	GBIF France	da44cd31-5901-4687-a106-6d1c7734ee3a	350d3482-f9fe-45ba-8fd7-2a008385f633
832	832	0	Participant Node Managers Committee	7f48e0c8-5c96-49ec-b972-30748e339115	351c9d13-5c04-4cd0-99ed-18e98327b955
20	20	0	Plazi	ffb07bec-2d10-492d-9c37-361fe0b79427	3565d3bc-9313-4bc0-8b23-6394b02b6d50
28	28	0	Plazi	ffb07bec-2d10-492d-9c37-361fe0b79427	384caabe-ae5b-4c40-b147-ecb1e0c7af84
85	85	0	Ocean Biodiversity Information System	ba0670b9-4186-41e6-8e70-f9cb3065551a	3d726371-5f1b-4601-90cc-981c78710d69
16569	16569	0	GBIF Norway	4f829580-180d-46a9-9c87-ed8ec959b545	41690f55-ccbe-48ba-8238-01173f657072
196	196	0	GBIF France	da44cd31-5901-4687-a106-6d1c7734ee3a	4bb4882d-7c43-4bf4-ba35-59a1cc15689b
0	39	39	Plazi	ffb07bec-2d10-492d-9c37-361fe0b79427	4becfc46-f283-4a33-9f7a-2b4d041a7118
236	236	0	Participant Node Managers Committee	7f48e0c8-5c96-49ec-b972-30748e339115	4d05b629-7870-4bea-ad52-37a43d2b7e37
68	810	742	Indonesian Biodiversity Information Facility	2ebd91f6-f14f-4375-b525-c011a3774f03	4d236e9c-fa04-4a94-9356-382c9f7c84c0
0	5	5	Plazi	ffb07bec-2d10-492d-9c37-361fe0b79427	4e1573ae-765a-41d5-9cb6-5db91c4fcc9f
13	13	0	Plazi	ffb07bec-2d10-492d-9c37-361fe0b79427	4fa4fe99-5cb7-4433-86f4-3c9d97b5b9fd
35938	36887	949	U.S. Geological Survey	8618c64a-93e0-4300-b546-7249e5148ed2	51c49096-dc31-4077-b35c-4510a8ee1ee8
55649	55649	0	U.S. Geological Survey	8618c64a-93e0-4300-b546-7249e5148ed2	54ecad6c-0ffe-436b-948b-fbd922c338c7
155168	166282	11114	BioCASE	d8bbf693-a180-4995-94fe-6130795dcf2f	54f946aa-2ca9-4a51-9ee5-011219e0381e
0	3699	3699	Ocean Biodiversity Information System	ba0670b9-4186-41e6-8e70-f9cb3065551a	55188f88-bf72-4ba7-b5b9-d41796c58cb2
59894	59894	0	GBIF France	da44cd31-5901-4687-a106-6d1c7734ee3a	5629f624-487c-4317-bf46-86030aec1468
109	109	0	GBIF France	da44cd31-5901-4687-a106-6d1c7734ee3a	5a266987-02a1-4444-97bb-a63dea1a0081
324	324	0	GBIF France	da44cd31-5901-4687-a106-6d1c7734ee3a	5dfd3144-25b0-4a1c-9df6-91b9cc231ccc
5	5	0	Plazi	ffb07bec-2d10-492d-9c37-361fe0b79427	5e6563e0-8fb4-46db-8304-ec160a9d9e98
405	405	0	GBIF Uganda	71b40829-6a12-4c3d-8fee-5746f5e9cf8c	61316a81-20a4-47e0-8635-20ca6f2700f6
90	90	0	GBIF Germany	4f6826f2-4ff6-443d-b966-e6913bd24013	6388eabe-f762-11e1-a439-00145eb45e9a
144	144	0	GBIF Germany	4f6826f2-4ff6-443d-b966-e6913bd24013	6409578a-f762-11e1-a439-00145eb45e9a
45	45	0	GBIF Germany	4f6826f2-4ff6-443d-b966-e6913bd24013	648444a4-f762-11e1-a439-00145eb45e9a
109	105	-4	GBIF Germany	4f6826f2-4ff6-443d-b966-e6913bd24013	64fe42ea-f762-11e1-a439-00145eb45e9a
275	275	0	Colombian Biodiversity Information System	7e865cba-7c46-417b-ade5-97f2cf5b7be0	6523d1dd-6116-42c7-a118-eb7cae79a84a
389	389	0	GBIF Germany	4f6826f2-4ff6-443d-b966-e6913bd24013	655cafe2-f762-11e1-a439-00145eb45e9a
98	98	0	GBIF Germany	4f6826f2-4ff6-443d-b966-e6913bd24013	6623e698-f762-11e1-a439-00145eb45e9a
67	67	0	GBIF Germany	4f6826f2-4ff6-443d-b966-e6913bd24013	66d1db22-f762-11e1-a439-00145eb45e9a
67	67	0	GBIF Germany	4f6826f2-4ff6-443d-b966-e6913bd24013	67b947f0-f762-11e1-a439-00145eb45e9a
180	180	0	GBIF Germany	4f6826f2-4ff6-443d-b966-e6913bd24013	684f92aa-f762-11e1-a439-00145eb45e9a
8	8	0	GBIF Germany	4f6826f2-4ff6-443d-b966-e6913bd24013	69443bc0-f762-11e1-a439-00145eb45e9a
66	66	0	GBIF Germany	4f6826f2-4ff6-443d-b966-e6913bd24013	69a83634-f762-11e1-a439-00145eb45e9a
199	199	0	GBIF Germany	4f6826f2-4ff6-443d-b966-e6913bd24013	6a706e74-f762-11e1-a439-00145eb45e9a
1	1	0	Plazi	ffb07bec-2d10-492d-9c37-361fe0b79427	6a8fcb47-2a1b-4cdf-ad3a-e0e1d16206b6
4	4	0	GBIF Germany	4f6826f2-4ff6-443d-b966-e6913bd24013	6b45c682-f762-11e1-a439-00145eb45e9a
8339	8339	0	GBIF France	da44cd31-5901-4687-a106-6d1c7734ee3a	6de8fe45-fecc-4957-a2c1-9cd23879d215
0	8328	8328	GBIF France	da44cd31-5901-4687-a106-6d1c7734ee3a	6ed77238-57aa-4a3a-8a7e-2e5990df7324
0	165	165	Ocean Biodiversity Information System	ba0670b9-4186-41e6-8e70-f9cb3065551a	6eea7c9e-2312-41e5-a11a-fe000fe0e84b
0	9	9	Plazi	ffb07bec-2d10-492d-9c37-361fe0b79427	6f255430-06bc-4375-b9b2-31b37a96abef
8	8	0	GBIF Germany	4f6826f2-4ff6-443d-b966-e6913bd24013	6fd8aea8-f762-11e1-a439-00145eb45e9a
14	14	0	GBIF Germany	4f6826f2-4ff6-443d-b966-e6913bd24013	6fff2df8-f762-11e1-a439-00145eb45e9a
125	125	0	GBIF Germany	4f6826f2-4ff6-443d-b966-e6913bd24013	70f9d03c-f762-11e1-a439-00145eb45e9a
43128	43128	0	GBIF France	da44cd31-5901-4687-a106-6d1c7734ee3a	7126858d-9bfc-4097-b42d-c3b6e20a74ff
2747	2747	0	GBIF France	da44cd31-5901-4687-a106-6d1c7734ee3a	71439dd4-6ed5-4450-8b62-d2704b4c9606
102	102	0	GBIF Germany	4f6826f2-4ff6-443d-b966-e6913bd24013	71b1298a-f762-11e1-a439-00145eb45e9a
0	4139	4139	National Biodiversity Data Centre	422b00b2-6c94-4bb6-976b-c359916efdb8	71bc8e1a-0dbd-4a5f-8b3c-ef278252f6bb
0	4	4	Plazi	ffb07bec-2d10-492d-9c37-361fe0b79427	721ba390-318b-4e65-9f39-2050a952709e
39	39	0	GBIF Germany	4f6826f2-4ff6-443d-b966-e6913bd24013	735ae76c-f762-11e1-a439-00145eb45e9a
12	12	0	GBIF Germany	4f6826f2-4ff6-443d-b966-e6913bd24013	73816202-f762-11e1-a439-00145eb45e9a
51	51	0	GBIF Germany	4f6826f2-4ff6-443d-b966-e6913bd24013	7486dda8-f762-11e1-a439-00145eb45e9a
102	102	0	Biodiversity Information System of Mexico	b324e8e9-9a4c-44fa-8f1a-7f39ea7ab576	756fa11d-670b-4666-a1bd-05eb3d6ec158
0	847336	847336	GBIF Sweden	a0b3be64-6525-4387-ac67-a499950f92e1	78d97723-3ac0-460f-9d9e-b8e603489883
3	3	0	Plazi	ffb07bec-2d10-492d-9c37-361fe0b79427	79a9efac-fa67-4883-919e-67d0ce00256b
126	50	-76	GBIF Germany	4f6826f2-4ff6-443d-b966-e6913bd24013	79b4576a-f762-11e1-a439-00145eb45e9a
854	854	0	GBIF Germany	4f6826f2-4ff6-443d-b966-e6913bd24013	79d4a920-f762-11e1-a439-00145eb45e9a
204	204	0	Colombian Biodiversity Information System	7e865cba-7c46-417b-ade5-97f2cf5b7be0	79fb09c3-bf78-41cf-ad65-bcdce10e640d
202	202	0	Participant Node Managers Committee	7f48e0c8-5c96-49ec-b972-30748e339115	7afcfc1d-b370-4b00-823c-e9308f1fb5ca
6067	6067	0	Korean Biodiversity Information Facility	e0a1e772-0177-4800-94b4-2d023fe6cdf4	7b153a3e-f762-11e1-a439-00145eb45e9a
609	609	0	GBIF Germany	4f6826f2-4ff6-443d-b966-e6913bd24013	7d675880-f762-11e1-a439-00145eb45e9a
76	76	0	GBIF Germany	4f6826f2-4ff6-443d-b966-e6913bd24013	7d7c64f0-f762-11e1-a439-00145eb45e9a
270	270	0	GBIF Germany	4f6826f2-4ff6-443d-b966-e6913bd24013	7de8792e-f762-11e1-a439-00145eb45e9a
108	108	0	GBIF Germany	4f6826f2-4ff6-443d-b966-e6913bd24013	7e03998e-f762-11e1-a439-00145eb45e9a
850	850	0	Biodiversity Information System of Mexico	b324e8e9-9a4c-44fa-8f1a-7f39ea7ab576	7fb6f7a8-f762-11e1-a439-00145eb45e9a
625	625	0	Biodiversity Information System of Mexico	b324e8e9-9a4c-44fa-8f1a-7f39ea7ab576	80b92d60-f762-11e1-a439-00145eb45e9a
562	562	0	GBIF France	da44cd31-5901-4687-a106-6d1c7734ee3a	813a322f-5f7e-47a5-ac09-bf6b168fe0a8
0	5	5	Plazi	ffb07bec-2d10-492d-9c37-361fe0b79427	8239b79e-fc87-49cd-bca2-1d78e06bc7aa
60	60	0	GBIF Germany	4f6826f2-4ff6-443d-b966-e6913bd24013	8266657e-f762-11e1-a439-00145eb45e9a
114	114	0	GBIF Germany	4f6826f2-4ff6-443d-b966-e6913bd24013	826cc4e6-f762-11e1-a439-00145eb45e9a
13697	13697	0	National Biodiversity Network	d897a5b9-35ee-4232-94bd-b0bcaac003c2	829b13cb-cfa6-48d2-acf4-9c67abf708f0
423	423	0	GBIF Sweden	a0b3be64-6525-4387-ac67-a499950f92e1	83a7735c-b2b6-4e77-9790-7ef1c080700f
12844	12844	0	DanBIF - Danish Biodiversity Information Facility	4ddd294f-02b7-4359-ac33-0806a9ca9c6b	84d02250-f762-11e1-a439-00145eb45e9a
220286	220286	0	National Biodiversity Network	d897a5b9-35ee-4232-94bd-b0bcaac003c2	84d99434-1938-4583-8fc6-069b0b5bf69d
3110	3110	0	World Federation for Culture Collections	a6bdc523-5368-4e0f-9d2e-de1c262ac092	855f3634-f762-11e1-a439-00145eb45e9a
0	114	114	Plazi	ffb07bec-2d10-492d-9c37-361fe0b79427	8580cc30-497a-4a79-8ce0-953f7e5004d7
528	381	-147	GBIF Germany	4f6826f2-4ff6-443d-b966-e6913bd24013	87ddab84-f762-11e1-a439-00145eb45e9a
79	79	0	GBIF Germany	4f6826f2-4ff6-443d-b966-e6913bd24013	8827b968-f762-11e1-a439-00145eb45e9a
101	101	0	GBIF Germany	4f6826f2-4ff6-443d-b966-e6913bd24013	89c7ad50-f762-11e1-a439-00145eb45e9a
170	170	0	GBIF Germany	4f6826f2-4ff6-443d-b966-e6913bd24013	8a744664-f762-11e1-a439-00145eb45e9a
646	646	0	Ocean Biodiversity Information System	ba0670b9-4186-41e6-8e70-f9cb3065551a	8aa1297b-dbc2-4818-8af5-2040e81876f2
19	19	0	GBIF Germany	4f6826f2-4ff6-443d-b966-e6913bd24013	8b1fd8d0-f762-11e1-a439-00145eb45e9a
13	13	0	GBIF Germany	4f6826f2-4ff6-443d-b966-e6913bd24013	8bc7ab00-f762-11e1-a439-00145eb45e9a
74	74	0	GBIF Germany	4f6826f2-4ff6-443d-b966-e6913bd24013	8da1a1ec-f762-11e1-a439-00145eb45e9a
442	286	-156	GBIF Germany	4f6826f2-4ff6-443d-b966-e6913bd24013	8db6f682-f762-11e1-a439-00145eb45e9a
13	13	0	Plazi	ffb07bec-2d10-492d-9c37-361fe0b79427	90b5adf5-7394-4afa-b055-a3c6615ef4b7
10	8	-2	GBIF Germany	4f6826f2-4ff6-443d-b966-e6913bd24013	90d05494-f762-11e1-a439-00145eb45e9a
49	19	-30	GBIF Germany	4f6826f2-4ff6-443d-b966-e6913bd24013	90ee4210-f762-11e1-a439-00145eb45e9a
3	3	0	Plazi	ffb07bec-2d10-492d-9c37-361fe0b79427	90f648b3-5357-43bc-811a-cac5373067d7
69	58	-11	GBIF Germany	4f6826f2-4ff6-443d-b966-e6913bd24013	928c2196-f762-11e1-a439-00145eb45e9a
118	118	0	GBIF Germany	4f6826f2-4ff6-443d-b966-e6913bd24013	92d5d96c-f762-11e1-a439-00145eb45e9a
616	616	0	GBIF Germany	4f6826f2-4ff6-443d-b966-e6913bd24013	9440f7be-f762-11e1-a439-00145eb45e9a
0	10	10	Plazi	ffb07bec-2d10-492d-9c37-361fe0b79427	94494aec-9ed2-4f30-8b63-9f521556ad6f
833	812	-21	GBIF Germany	4f6826f2-4ff6-443d-b966-e6913bd24013	952bf4f8-f762-11e1-a439-00145eb45e9a
12	11	-1	GBIF Germany	4f6826f2-4ff6-443d-b966-e6913bd24013	957fc4ca-f762-11e1-a439-00145eb45e9a
57350	57350	0	U.S. Geological Survey	8618c64a-93e0-4300-b546-7249e5148ed2	95aef98e-f762-11e1-a439-00145eb45e9a
5316	5316	0	GBIF Spain	1f94b3ca-9345-4d65-afe2-4bace93aa0fe	962e2f2e-f762-11e1-a439-00145eb45e9a
37916	37916	0	Ocean Biodiversity Information System	ba0670b9-4186-41e6-8e70-f9cb3065551a	96385e98-93b5-4e4a-8081-6e30b738816a
77	77	0	GBIF Germany	4f6826f2-4ff6-443d-b966-e6913bd24013	9a7675ec-3607-4cb2-bd25-90afd97c5147
368	368	0	National Biodiversity Network	d897a5b9-35ee-4232-94bd-b0bcaac003c2	9b54bf07-7b6b-43e1-93d9-fcf8eb6be494
180	212	32	Belgian Biodiversity Platform	fb11cfe1-ebc3-45af-9159-17d9fddbcdac	9bd8310b-0914-411f-a4ba-0cefdd85df80
4	4	0	GBIF France	da44cd31-5901-4687-a106-6d1c7734ee3a	9bea0674-ed53-4f64-a239-9c805d11d9af
0	17	17	Ocean Biodiversity Information System	ba0670b9-4186-41e6-8e70-f9cb3065551a	a0342686-d6e3-4b5d-ab0b-1f56183c92f0
10	10	0	Plazi	ffb07bec-2d10-492d-9c37-361fe0b79427	a1a736f1-f8f4-4c04-bde5-9f0ac473b723
0	1	1	Plazi	ffb07bec-2d10-492d-9c37-361fe0b79427	a28e012f-a62e-467d-a341-7f32d381cd75
2	2	0	Plazi	ffb07bec-2d10-492d-9c37-361fe0b79427	a6125ed3-e38b-4e83-97d8-c17fbe0c8f4a
164	164	0	GBIF Spain	1f94b3ca-9345-4d65-afe2-4bace93aa0fe	ab51623c-d96f-4b94-a94b-d2cfaf240d7c
2212	2212	0	GBIF Germany	4f6826f2-4ff6-443d-b966-e6913bd24013	ac103da8-23c3-4d6e-891d-266923365893
87	87	0	National Biodiversity Network	d897a5b9-35ee-4232-94bd-b0bcaac003c2	ae3f9ca3-c18d-4aa7-ada0-d1966735960d
15000	32501	17501	GBIF Japan	db5705aa-6a6e-42f1-8942-d77b9f4896ea	b2fd674b-5eb0-41e9-8112-cd0f2c207812
450	450	0	South African Biodiversity Information Facility	7190b835-4e86-4b6e-85c1-19cc6677c250	b5cd47e0-0039-4092-a77f-7493b586a3e1
1	1	0	Plazi	ffb07bec-2d10-492d-9c37-361fe0b79427	b766fe95-3393-4cec-9e30-9bca038c9126
2	2	0	Participant Node Managers Committee	7f48e0c8-5c96-49ec-b972-30748e339115	baf72196-8e76-4dbe-9641-5be89e69ab54
2	2	0	Plazi	ffb07bec-2d10-492d-9c37-361fe0b79427	bfff3540-4e0b-4afb-a967-1f315f71b808
277	277	0	National Biodiversity Network	d897a5b9-35ee-4232-94bd-b0bcaac003c2	c085bd69-17c2-4f4f-b265-407744871000
0	3	3	Plazi	ffb07bec-2d10-492d-9c37-361fe0b79427	c113f879-889a-4376-8e2b-33bd24ff752b
34	34	0	National Biodiversity Network	d897a5b9-35ee-4232-94bd-b0bcaac003c2	c1f0bb0d-caa8-4370-b1bc-fbbe18eb1ad6
3	3	0	Plazi	ffb07bec-2d10-492d-9c37-361fe0b79427	c2ed94db-08ef-43ba-8d65-1986db5e54bc
0	3	3	Plazi	ffb07bec-2d10-492d-9c37-361fe0b79427	c4a1490d-15c3-446f-8676-e6c80096bcb6
3496	3496	0	GBIF Spain	1f94b3ca-9345-4d65-afe2-4bace93aa0fe	c4ab57b5-b2f5-477f-b3fb-b42092074054
0	10	10	Plazi	ffb07bec-2d10-492d-9c37-361fe0b79427	c66531b3-6276-44e8-b917-9492b5e0bff4
4	4	0	Plazi	ffb07bec-2d10-492d-9c37-361fe0b79427	c8756f54-d5c7-41b7-b912-d860d34854cf
29	29	0	Participant Node Managers Committee	7f48e0c8-5c96-49ec-b972-30748e339115	c9274174-dc6c-4dd4-b7ed-9462d74474df
102	102	0	Plazi	ffb07bec-2d10-492d-9c37-361fe0b79427	c953a470-a1b6-47b0-a403-9a6a828951e4
14	14	0	Plazi	ffb07bec-2d10-492d-9c37-361fe0b79427	cd55c657-9465-4ab3-9e76-d885c145caba
325	325	0	Biodiversity Information System of Mexico	b324e8e9-9a4c-44fa-8f1a-7f39ea7ab576	ce383525-0996-4ce4-bee0-b6fb6c7b6458
2	2	0	Plazi	ffb07bec-2d10-492d-9c37-361fe0b79427	cf66c1d6-d78a-4ee9-a888-c7be00c85421
4762	4895	133	GBIF Brazil	cdc9736d-5ff7-4ece-9959-3c744360cdb3	cfafda89-e151-4410-a878-972fe24e431b
0	7	7	Plazi	ffb07bec-2d10-492d-9c37-361fe0b79427	d1838535-e4a1-4c71-96be-186e5452af26
6	6	0	Plazi	ffb07bec-2d10-492d-9c37-361fe0b79427	d4eb9329-8cc9-42f3-b1a4-7711e034f981
7443	7443	0	GBIF Argentina	2426a871-9feb-40a1-96c6-0c593a76b835	d592283b-b00e-4a39-9499-289842ccddf1
0	149	149	Ocean Biodiversity Information System	ba0670b9-4186-41e6-8e70-f9cb3065551a	d61e1b45-da2a-4b22-b7d8-28c8e11bb17d
1101	1101	0	Colombian Biodiversity Information System	7e865cba-7c46-417b-ade5-97f2cf5b7be0	da285c2a-0cf0-4637-87d8-6e2b5cd8ea01
1083	1083	0	Colombian Biodiversity Information System	7e865cba-7c46-417b-ade5-97f2cf5b7be0	db9fd50a-169a-448c-85d3-863b0eb705f2
0	40	40	Plazi	ffb07bec-2d10-492d-9c37-361fe0b79427	dbcf8096-b2e5-405a-8851-c9278d1df30a
464	464	0	Colombian Biodiversity Information System	7e865cba-7c46-417b-ade5-97f2cf5b7be0	e02f7e8c-6906-45ab-aa8c-6887ca4c532e
3	3	0	Plazi	ffb07bec-2d10-492d-9c37-361fe0b79427	e0c0564b-cade-4563-8fdc-2922b20ca4b2
1	1	0	Plazi	ffb07bec-2d10-492d-9c37-361fe0b79427	e0dbf695-ed65-4307-934d-0bb87bde2994
75	75	0	GBIF France	da44cd31-5901-4687-a106-6d1c7734ee3a	e1d5da50-c35c-421f-b07d-48ba3e7211b0
3435	3435	0	Participant Node Managers Committee	7f48e0c8-5c96-49ec-b972-30748e339115	e2cde7e3-0b90-40ea-93ad-de06e6ed3a3c
63	63	0	GBIF Niger	dc9041d6-a5ae-4217-92ea-f7674794d760	e381b970-9b62-4664-a249-6023b6fa8ef9
0	6	6	Plazi	ffb07bec-2d10-492d-9c37-361fe0b79427	e3936c99-797b-486d-a187-e519d5142f02
167	167	0	GBIF France	da44cd31-5901-4687-a106-6d1c7734ee3a	e4b1c4e0-bf27-4f75-bd46-fc0869681278
7170	7170	0	GBIF Sweden	a0b3be64-6525-4387-ac67-a499950f92e1	e4c7e3cc-f4f9-49df-be45-e1732014b6b8
552	552	0	Colombian Biodiversity Information System	7e865cba-7c46-417b-ade5-97f2cf5b7be0	e53a70a1-501d-4f87-8dfa-08660f9b985a
5	5	0	Plazi	ffb07bec-2d10-492d-9c37-361fe0b79427	e56bac47-d0c1-4850-9975-75f3c9c55588
19421	20233	812	National Biodiversity Network	d897a5b9-35ee-4232-94bd-b0bcaac003c2	e8ce41f4-a58a-4ce9-90b7-93694071afcd
2	2	0	Plazi	ffb07bec-2d10-492d-9c37-361fe0b79427	e92bcf89-527e-4af1-910c-33308a67da07
4	4	0	Plazi	ffb07bec-2d10-492d-9c37-361fe0b79427	e98df155-1049-42c3-b779-f7272da2cc2f
2	2	0	Plazi	ffb07bec-2d10-492d-9c37-361fe0b79427	eab8abc5-ecee-42e7-a98c-66462af2272c
0	25	25	Ocean Biodiversity Information System	ba0670b9-4186-41e6-8e70-f9cb3065551a	eba22fac-b7b7-46a7-a381-e3d46eba361f
0	1	1	Plazi	ffb07bec-2d10-492d-9c37-361fe0b79427	ed0aeefc-207b-4564-b21f-cf624f8c4ac1
3970	3970	0	National Biodiversity Network	d897a5b9-35ee-4232-94bd-b0bcaac003c2	eee3f760-4ceb-4cd2-8962-3c7006070a8f
2	2	0	GBIF Finland	dd514216-5c7c-45f3-910d-797424cb5be6	f0aba469-fb2f-42a1-86f8-cbed1d9201df
132	132	0	Plazi	ffb07bec-2d10-492d-9c37-361fe0b79427	f503e20e-e3fb-41ac-bf17-bdaf221bc7c7
9	9	0	Plazi	ffb07bec-2d10-492d-9c37-361fe0b79427	f7faf31d-0bb6-4821-a72d-d09ff8701d8a
10	10	0	Plazi	ffb07bec-2d10-492d-9c37-361fe0b79427	f98c1e2e-ccfa-491d-a136-b9d4cf9cd54b
25	25	0	Plazi	ffb07bec-2d10-492d-9c37-361fe0b79427	fb0b7b8f-cabb-46a7-aef5-9b249a5de564
13562	13562	0	National Biodiversity Network	d897a5b9-35ee-4232-94bd-b0bcaac003c2	fb98e53c-add6-4870-b745-db11cbea753d
1120	1120	0	Netherlands Biodiversity Information Facility	0909d601-bda2-42df-9e63-a6d51847ebce	fd1a7c99-f7b8-4887-b36c-5bdbd13eae3b
2	2	0	Plazi	ffb07bec-2d10-492d-9c37-361fe0b79427	0278f8af-cfe4-4608-8c4c-61eda0158b7c
6336	6336	0	GBIF Japan	db5705aa-6a6e-42f1-8942-d77b9f4896ea	028af953-8d01-4b7d-a0a0-78a21c002763
7863	7863	0	National Biodiversity Network	d897a5b9-35ee-4232-94bd-b0bcaac003c2	039ece6c-1e6d-4441-8392-43ab8bb29c47
1	1	0	Plazi	ffb07bec-2d10-492d-9c37-361fe0b79427	05097f39-60c4-4fbf-bc07-89972a837139
74	74	0	GBIF Finland	dd514216-5c7c-45f3-910d-797424cb5be6	07bddb83-9f0c-4bc1-835e-e57bc6e17046
17	17	0	Plazi	ffb07bec-2d10-492d-9c37-361fe0b79427	0a67588b-3d73-4758-bdb8-d273a4b52b20
0	24	24	Plazi	ffb07bec-2d10-492d-9c37-361fe0b79427	11d04f7a-e744-4ac9-b0af-3cbf68f8cc92
32	32	0	Plazi	ffb07bec-2d10-492d-9c37-361fe0b79427	120e0bf4-0fd9-47c7-85fd-4dd9ff878245
33	33	0	Plazi	ffb07bec-2d10-492d-9c37-361fe0b79427	125703f8-ddaa-4f28-9673-97b7c469b05c
0	2	2	Plazi	ffb07bec-2d10-492d-9c37-361fe0b79427	151a5f33-096d-4052-8877-4d327f3874ea
97386	106245	8859	U.S. Geological Survey	8618c64a-93e0-4300-b546-7249e5148ed2	16630817-fd43-49d6-bfff-ae5ffa473724
1	1	0	Plazi	ffb07bec-2d10-492d-9c37-361fe0b79427	168df1fe-de0d-4314-a991-aef829ca2865
0	229	229	Plazi	ffb07bec-2d10-492d-9c37-361fe0b79427	172fa5c5-c0c4-4bd7-b710-d608237b8458
46	46	0	Atlas of Living Australia	4a6f1b71-969e-4fc5-a693-282b05e1220c	1864778a-0d5a-4b59-9396-33fdf6539b65
4402	4402	0	U.S. Geological Survey	8618c64a-93e0-4300-b546-7249e5148ed2	18cc26e0-a0b3-4ea5-865b-9159a5488624
1367	1367	0	National Biodiversity Network	d897a5b9-35ee-4232-94bd-b0bcaac003c2	1a83ba26-a32f-4474-9e86-4d3cfd6c7e0e
13280	13280	0	Colombian Biodiversity Information System	7e865cba-7c46-417b-ade5-97f2cf5b7be0	1bde5a67-a7e5-4ca5-8d85-a6be34f7ffff
81	81	0	Plazi	ffb07bec-2d10-492d-9c37-361fe0b79427	1cc76c39-6673-4dee-b36c-3cdef83c4042
33651	33651	0	National Biodiversity Network	d897a5b9-35ee-4232-94bd-b0bcaac003c2	20445ad1-227c-4e60-821a-e0e48b79dea4
7	7	0	Plazi	ffb07bec-2d10-492d-9c37-361fe0b79427	2a0ebabd-a207-48f7-a202-7e4c83ba1840
5	5	0	Plazi	ffb07bec-2d10-492d-9c37-361fe0b79427	2a5c89e9-de41-47fc-8d38-c1a10ae82c41
6	6	0	Plazi	ffb07bec-2d10-492d-9c37-361fe0b79427	2a9467e4-8f77-4813-bea2-16ec55176ed2
0	7994	7994	GBIF France	da44cd31-5901-4687-a106-6d1c7734ee3a	2b32cfea-cf4c-4cfb-ba5f-86362629899c
12200	12200	0	GBIF Germany	4f6826f2-4ff6-443d-b966-e6913bd24013	2cc6f37d-e92f-4845-ac47-6d7b1b58c399
0	16	16	Plazi	ffb07bec-2d10-492d-9c37-361fe0b79427	2e6ed467-8771-4d08-94d7-703fd6485133
106	106	0	GBIF France	da44cd31-5901-4687-a106-6d1c7734ee3a	3140bc4a-5979-4b29-83ec-8a8e5529fe50
13	13	0	Plazi	ffb07bec-2d10-492d-9c37-361fe0b79427	316e1968-2a32-462e-a554-99165078f1fc
92	92	0	Plazi	ffb07bec-2d10-492d-9c37-361fe0b79427	321b18d2-4300-4d8b-8bcc-877150f92275
230	230	0	GBIF Germany	4f6826f2-4ff6-443d-b966-e6913bd24013	33610b65-08fe-416d-8a39-c3299ec92bca
3	3	0	Plazi	ffb07bec-2d10-492d-9c37-361fe0b79427	33a17d32-75b4-423c-bc63-4bd22ae66a4f
0	62	62	Ocean Biodiversity Information System	ba0670b9-4186-41e6-8e70-f9cb3065551a	34009b33-814d-45c1-b0fd-25a560ce00f5
1953	1953	0	National Biodiversity Network	d897a5b9-35ee-4232-94bd-b0bcaac003c2	34df7c24-4ee3-4000-912c-b000db75335b
118	118	0	VertNet	d205def7-82c3-472a-be4b-31d11dcd51fd	355e5b39-9d5a-4adc-8332-91669857b81f
0	5	5	Plazi	ffb07bec-2d10-492d-9c37-361fe0b79427	38ef7708-7c79-46d9-8db9-f7d30bd89710
18571	18571	0	GBIF Brazil	cdc9736d-5ff7-4ece-9959-3c744360cdb3	3df5801a-f1b3-4863-beb2-1a4493c92c18
400	400	0	Korean Biodiversity Information Facility	e0a1e772-0177-4800-94b4-2d023fe6cdf4	411e7b68-fc89-4407-8611-70c092efcaec
0	12	12	Plazi	ffb07bec-2d10-492d-9c37-361fe0b79427	41eff14d-f441-45b1-8738-5b87b05115f2
0	10	10	Ocean Biodiversity Information System	ba0670b9-4186-41e6-8e70-f9cb3065551a	435b4c66-be6f-4117-b070-1e546dd62ae1
2914	2914	0	Belgian Biodiversity Platform	fb11cfe1-ebc3-45af-9159-17d9fddbcdac	48350ebf-c1e3-4f29-b905-a5342a3a5ce9
21694	21694	0	GBIF France	da44cd31-5901-4687-a106-6d1c7734ee3a	4b3541f2-92e0-4cc6-bb10-a2a2ffe61c60
0	5	5	Plazi	ffb07bec-2d10-492d-9c37-361fe0b79427	4b8c817a-8e60-44a2-92e0-e28fa91bd9a9
15	15	0	Plazi	ffb07bec-2d10-492d-9c37-361fe0b79427	4db858ad-5de0-4529-a5ff-a35159c909ba
0	20	20	Plazi	ffb07bec-2d10-492d-9c37-361fe0b79427	505449c5-72c1-482e-aa16-0ac8c7919dbb
2	2	0	Plazi	ffb07bec-2d10-492d-9c37-361fe0b79427	50c8d9a6-bee2-4598-a973-f47c96055f10
95116	95116	0	Participant Node Managers Committee	7f48e0c8-5c96-49ec-b972-30748e339115	514ccc41-0fd0-4a49-86b1-ae1c739eb5d0
0	4	4	Plazi	ffb07bec-2d10-492d-9c37-361fe0b79427	51667da1-d160-40ce-94d9-b0e1c3bda024
0	44	44	Plazi	ffb07bec-2d10-492d-9c37-361fe0b79427	51eea930-5f0d-43f6-8e03-3093edf36cd7
361010	380573	19563	National Biodiversity Network	d897a5b9-35ee-4232-94bd-b0bcaac003c2	52422715-c1db-40a0-ba16-b84a295d248a
21	21	0	Plazi	ffb07bec-2d10-492d-9c37-361fe0b79427	54070dc1-6bb8-41b6-85eb-11b80b22bb43
6718	6718	0	National Biodiversity Network	d897a5b9-35ee-4232-94bd-b0bcaac003c2	556dc4ad-2e1c-4c5e-9cbd-c435e44f5004
61	61	0	GBIF Spain	1f94b3ca-9345-4d65-afe2-4bace93aa0fe	55a88b14-6151-4ba0-a609-38112106daef
0	3	3	Plazi	ffb07bec-2d10-492d-9c37-361fe0b79427	5813d31b-2ad4-455c-9999-b731186d048d
0	9	9	Colombian Biodiversity Information System	7e865cba-7c46-417b-ade5-97f2cf5b7be0	5acfef52-fcd3-4223-8eab-9b38c71cbbe1
9	9	0	Taiwan Biodiversity Information Facility	e1b85abc-61f9-430f-ba79-6813dec53a0f	5b289cc5-3a0a-4b42-a3fe-ef911fe235fc
103	103	0	GBIF Guinea	b1cd2e84-c4ba-47bd-b72a-dfd1f92dce0a	5ba80225-cbaa-403c-ad6e-f1d2063b27ab
0	4	4	Plazi	ffb07bec-2d10-492d-9c37-361fe0b79427	5c008a0c-ca60-499f-9509-8a87963d62f7
13	13	0	Plazi	ffb07bec-2d10-492d-9c37-361fe0b79427	5c930447-089a-4f6b-a5e0-3f08d30b7c43
14	15	1	GBIF Brazil	cdc9736d-5ff7-4ece-9959-3c744360cdb3	5d54f54d-6fa5-4d01-92a8-6c77d64ff8bf
10615	10615	0	GBIF France	da44cd31-5901-4687-a106-6d1c7734ee3a	5d6d5aa7-2df9-4a3d-9a96-5fc7a988ab5f
13944	13944	0	GBIF France	da44cd31-5901-4687-a106-6d1c7734ee3a	5e48f65e-bd59-4a14-a21b-fcd761ac380f
652	652	0	Participant Node Managers Committee	7f48e0c8-5c96-49ec-b972-30748e339115	5eae3213-f054-4ddc-a6c8-3fa494b17907
181	181	0	GBIF Germany	4f6826f2-4ff6-443d-b966-e6913bd24013	61d41c70-f762-11e1-a439-00145eb45e9a
54	54	0	GBIF Germany	4f6826f2-4ff6-443d-b966-e6913bd24013	62497a74-f762-11e1-a439-00145eb45e9a
264	264	0	GBIF Finland	dd514216-5c7c-45f3-910d-797424cb5be6	6254b79a-5df5-4ae1-b1f0-2c8e8969b73e
93	93	0	GBIF Germany	4f6826f2-4ff6-443d-b966-e6913bd24013	6382673e-f762-11e1-a439-00145eb45e9a
73	73	0	GBIF Germany	4f6826f2-4ff6-443d-b966-e6913bd24013	640bf3e6-f762-11e1-a439-00145eb45e9a
61	61	0	GBIF Germany	4f6826f2-4ff6-443d-b966-e6913bd24013	64289546-f762-11e1-a439-00145eb45e9a
50	50	0	GBIF Germany	4f6826f2-4ff6-443d-b966-e6913bd24013	643e7730-f762-11e1-a439-00145eb45e9a
33	33	0	GBIF Germany	4f6826f2-4ff6-443d-b966-e6913bd24013	647bb5aa-f762-11e1-a439-00145eb45e9a
58	58	0	GBIF Germany	4f6826f2-4ff6-443d-b966-e6913bd24013	659864a6-f762-11e1-a439-00145eb45e9a
3990	3990	0	Colombian Biodiversity Information System	7e865cba-7c46-417b-ade5-97f2cf5b7be0	65fcc2fa-9c22-4e48-ab3d-9753f10b9ef1
109	109	0	GBIF Germany	4f6826f2-4ff6-443d-b966-e6913bd24013	6660a6a0-f762-11e1-a439-00145eb45e9a
151	151	0	GBIF Germany	4f6826f2-4ff6-443d-b966-e6913bd24013	66d321bc-f762-11e1-a439-00145eb45e9a
77	77	0	GBIF France	da44cd31-5901-4687-a106-6d1c7734ee3a	672ad193-24cc-42eb-ace9-8a94d298c298
35	35	0	GBIF Germany	4f6826f2-4ff6-443d-b966-e6913bd24013	673ecd04-f762-11e1-a439-00145eb45e9a
0	3	3	Plazi	ffb07bec-2d10-492d-9c37-361fe0b79427	68ca95c6-672d-4cd2-aba7-2361d03419d6
77171	77559	388	U.S. Geological Survey	8618c64a-93e0-4300-b546-7249e5148ed2	6958627a-e1cd-489f-b4f3-6e7760203b9d
37108	37108	0	Participant Node Managers Committee	7f48e0c8-5c96-49ec-b972-30748e339115	69e81d22-3207-4663-9a7d-418919d7d779
242	242	0	GBIF Germany	4f6826f2-4ff6-443d-b966-e6913bd24013	6a1349f6-f762-11e1-a439-00145eb45e9a
2	2	0	GBIF Germany	4f6826f2-4ff6-443d-b966-e6913bd24013	6adf21ca-f762-11e1-a439-00145eb45e9a
16	16	0	GBIF Germany	4f6826f2-4ff6-443d-b966-e6913bd24013	6b0837d6-f762-11e1-a439-00145eb45e9a
4	4	0	Plazi	ffb07bec-2d10-492d-9c37-361fe0b79427	6b3d3123-d1be-438e-920a-179b253a5ac4
4	4	0	GBIF Germany	4f6826f2-4ff6-443d-b966-e6913bd24013	6b60bb40-f762-11e1-a439-00145eb45e9a
2	2	0	Plazi	ffb07bec-2d10-492d-9c37-361fe0b79427	6b657bc6-1b54-4b0e-9dcd-9630a4849ad3
36	36	0	GBIF Germany	4f6826f2-4ff6-443d-b966-e6913bd24013	6b7a11ee-f762-11e1-a439-00145eb45e9a
47	47	0	Plazi	ffb07bec-2d10-492d-9c37-361fe0b79427	6d9c06e6-98d8-4523-86cb-3748d1c1ea4b
0	145	145	Ocean Biodiversity Information System	ba0670b9-4186-41e6-8e70-f9cb3065551a	6f5b4f5b-c198-429e-970b-a93caed3d14a
115	115	0	GBIF France	da44cd31-5901-4687-a106-6d1c7734ee3a	6fe1c1e5-383b-4f13-a844-d2b6f74a8310
8	8	0	GBIF Germany	4f6826f2-4ff6-443d-b966-e6913bd24013	6fec291a-f762-11e1-a439-00145eb45e9a
108	54	-54	GBIF Germany	4f6826f2-4ff6-443d-b966-e6913bd24013	707cbb10-f762-11e1-a439-00145eb45e9a
48	48	0	GBIF Germany	4f6826f2-4ff6-443d-b966-e6913bd24013	71472da0-f762-11e1-a439-00145eb45e9a
236	236	0	GBIF France	da44cd31-5901-4687-a106-6d1c7734ee3a	7395bdf3-79d7-4ab1-b2a8-f02a18d344b8
3253	3253	0	National Biodiversity Network	d897a5b9-35ee-4232-94bd-b0bcaac003c2	744505cc-d9a7-4b00-a3cb-77826a46614b
51	51	0	GBIF Germany	4f6826f2-4ff6-443d-b966-e6913bd24013	7475da30-f762-11e1-a439-00145eb45e9a
39	39	0	GBIF Germany	4f6826f2-4ff6-443d-b966-e6913bd24013	74ca6e60-f762-11e1-a439-00145eb45e9a
7601	20693	13092	U.S. Geological Survey	8618c64a-93e0-4300-b546-7249e5148ed2	7701aa4d-37e8-43f4-a8a7-6768ef027d34
6	6	0	Plazi	ffb07bec-2d10-492d-9c37-361fe0b79427	78768fda-3413-47cf-96fa-d43cc3cf9f08
17	17	0	Tanzania Biodiversity Information Facility	abd95ca6-3959-4db9-aaa6-2de1aeecf514	78b696d9-8f0d-41ab-9c23-1c3547da411d
4	4	0	GBIF Germany	4f6826f2-4ff6-443d-b966-e6913bd24013	78d2d2f4-f762-11e1-a439-00145eb45e9a
74	74	0	GBIF Germany	4f6826f2-4ff6-443d-b966-e6913bd24013	791fbace-f762-11e1-a439-00145eb45e9a
273	273	0	Biodiversity Information System of Mexico	b324e8e9-9a4c-44fa-8f1a-7f39ea7ab576	79f9f62d-71e5-4829-af65-bcf3c883a336
146	146	0	GBIF Germany	4f6826f2-4ff6-443d-b966-e6913bd24013	7b9574d4-762c-4f7f-bc07-cfd1a28e1559
657	657	0	GBIF Germany	4f6826f2-4ff6-443d-b966-e6913bd24013	7c0f1374-f762-11e1-a439-00145eb45e9a
0	11	11	Ocean Biodiversity Information System	ba0670b9-4186-41e6-8e70-f9cb3065551a	7c2bc74c-43d2-47a4-b174-25d056b27553
1218	798	-420	GBIF Germany	4f6826f2-4ff6-443d-b966-e6913bd24013	7c301cd6-f762-11e1-a439-00145eb45e9a
837	824	-13	GBIF Germany	4f6826f2-4ff6-443d-b966-e6913bd24013	7d472812-f762-11e1-a439-00145eb45e9a
2989	2989	0	GBIF Japan	db5705aa-6a6e-42f1-8942-d77b9f4896ea	7dff2b43-64f8-41f4-b022-8c371a6aef3f
8	8	0	Plazi	ffb07bec-2d10-492d-9c37-361fe0b79427	82058943-db9e-40c6-886e-eb8d9d227bd7
1244	668	-576	GBIF Germany	4f6826f2-4ff6-443d-b966-e6913bd24013	8240355c-f762-11e1-a439-00145eb45e9a
785	785	0	Ocean Biodiversity Information System	ba0670b9-4186-41e6-8e70-f9cb3065551a	83ab0f8e-f762-11e1-a439-00145eb45e9a
73	73	0	Canada Biodiversity Information Facility	8f83fc96-c966-4126-83f7-bf044dc49efa	8441659c-f762-11e1-a439-00145eb45e9a
10354	14887	4533	GBIF Japan	db5705aa-6a6e-42f1-8942-d77b9f4896ea	8615fad6-f762-11e1-a439-00145eb45e9a
1193	637	-556	Atlas of Living Australia	4a6f1b71-969e-4fc5-a693-282b05e1220c	8645653c-f762-11e1-a439-00145eb45e9a
133	90	-43	GBIF Germany	4f6826f2-4ff6-443d-b966-e6913bd24013	87601b92-f762-11e1-a439-00145eb45e9a
62621	62621	0	Biodiversity Information System of Mexico	b324e8e9-9a4c-44fa-8f1a-7f39ea7ab576	88cc32da-a6c3-4a54-9a8d-ffbc3f749706
1	1	0	Plazi	ffb07bec-2d10-492d-9c37-361fe0b79427	8909f9c6-42aa-4997-abf8-65bb4674ff2e
30	30	0	Plazi	ffb07bec-2d10-492d-9c37-361fe0b79427	89eda679-d9f7-4fe6-8bb4-c245614fca89
0	5	5	Plazi	ffb07bec-2d10-492d-9c37-361fe0b79427	8a655767-e325-4238-99b1-542ea34bdfce
123	123	0	GBIF Germany	4f6826f2-4ff6-443d-b966-e6913bd24013	8ac2b006-f762-11e1-a439-00145eb45e9a
135	135	0	GBIF Germany	4f6826f2-4ff6-443d-b966-e6913bd24013	8acf5220-f762-11e1-a439-00145eb45e9a
210	210	0	GBIF Germany	4f6826f2-4ff6-443d-b966-e6913bd24013	8d78f58a-f762-11e1-a439-00145eb45e9a
1	1	0	GBIF Germany	4f6826f2-4ff6-443d-b966-e6913bd24013	8dada30c-f762-11e1-a439-00145eb45e9a
1848	1017	-831	GBIF Germany	4f6826f2-4ff6-443d-b966-e6913bd24013	8f6c96f8-f762-11e1-a439-00145eb45e9a
1026690	1033850	7160	GBIF Finland	dd514216-5c7c-45f3-910d-797424cb5be6	902c8fe7-8f38-45b0-854e-c324fed36303
31	31	0	Biodiversity Information System of Mexico	b324e8e9-9a4c-44fa-8f1a-7f39ea7ab576	90711430-4260-422f-aeb2-26ce7f72f56c
240	136	-104	GBIF Germany	4f6826f2-4ff6-443d-b966-e6913bd24013	924a983e-f762-11e1-a439-00145eb45e9a
69	69	0	GBIF Germany	4f6826f2-4ff6-443d-b966-e6913bd24013	92c06ca8-f762-11e1-a439-00145eb45e9a
5	4	-1	GBIF Germany	4f6826f2-4ff6-443d-b966-e6913bd24013	93412c9e-f762-11e1-a439-00145eb45e9a
306	306	0	GBIF Germany	4f6826f2-4ff6-443d-b966-e6913bd24013	9509a894-f762-11e1-a439-00145eb45e9a
52	52	0	GBIF Germany	4f6826f2-4ff6-443d-b966-e6913bd24013	955433f0-f762-11e1-a439-00145eb45e9a
480	480	0	GBIF Germany	4f6826f2-4ff6-443d-b966-e6913bd24013	955d82ac-f762-11e1-a439-00145eb45e9a
32	32	0	GBIF Germany	4f6826f2-4ff6-443d-b966-e6913bd24013	95a350fc-f762-11e1-a439-00145eb45e9a
80	80	0	Atlas of Living Australia	4a6f1b71-969e-4fc5-a693-282b05e1220c	9654e40e-c632-40b4-ba1a-df0f4537b8bd
11098	11098	0	GBIF Spain	1f94b3ca-9345-4d65-afe2-4bace93aa0fe	96b9eec4-f762-11e1-a439-00145eb45e9a
9	9	0	Plazi	ffb07bec-2d10-492d-9c37-361fe0b79427	9c542879-5d13-4b39-ad43-d1897eade672
531075	531075	0	GBIF Sweden	a0b3be64-6525-4387-ac67-a499950f92e1	a2aab040-0680-11df-823c-b8a03c50a862
1	1	0	Plazi	ffb07bec-2d10-492d-9c37-361fe0b79427	a2d943e5-355c-42f9-b53d-276769d20dca
576	576	0	Participant Node Managers Committee	7f48e0c8-5c96-49ec-b972-30748e339115	a4542b83-ed0d-4b2b-8629-caa50849b895
1	1	0	Plazi	ffb07bec-2d10-492d-9c37-361fe0b79427	a5abdafe-7517-453f-a868-7e1e9d8af619
1	1	0	Plazi	ffb07bec-2d10-492d-9c37-361fe0b79427	a6b7b555-0a99-44ad-aaef-b6024327ff38
0	15	15	Plazi	ffb07bec-2d10-492d-9c37-361fe0b79427	aab53827-c0c9-4ee3-b95c-f95f0e3919d1
2	2	0	Plazi	ffb07bec-2d10-492d-9c37-361fe0b79427	ac89de0b-e84a-4405-9468-07f44e9659db
4000	4000	0	GBIF Japan	db5705aa-6a6e-42f1-8942-d77b9f4896ea	ae7b0b1d-2170-4624-8921-8d088d15b129
448	448	0	Plazi	ffb07bec-2d10-492d-9c37-361fe0b79427	ae92f91a-bca2-48b6-aa01-50854baae21a
2469	2469	0	Biodiversity Information System of Mexico	b324e8e9-9a4c-44fa-8f1a-7f39ea7ab576	aeeaaaae-e497-4b5c-acee-4734a696499a
73	73	0	GBIF Japan	db5705aa-6a6e-42f1-8942-d77b9f4896ea	af0b5125-9b39-4ce0-a858-8047cb86e001
534	534	0	GBIF Germany	4f6826f2-4ff6-443d-b966-e6913bd24013	b01f7c0a-5147-42a6-9ae5-870ec9a92b9e
22	22	0	Plazi	ffb07bec-2d10-492d-9c37-361fe0b79427	b12494e0-94b7-420f-9d46-1e3f5d5641f0
17033	17033	0	National Biodiversity Network	d897a5b9-35ee-4232-94bd-b0bcaac003c2	b1821021-4664-4a10-82f1-e908d5dcd419
3790	3955	165	GBIF Brazil	cdc9736d-5ff7-4ece-9959-3c744360cdb3	b20d3818-a2d8-4014-8992-41d692386822
5	5	0	Plazi	ffb07bec-2d10-492d-9c37-361fe0b79427	b2757491-7166-49e5-a272-276aa62cc529
0	1	1	Participant Node Managers Committee	7f48e0c8-5c96-49ec-b972-30748e339115	b6110ed9-61de-48f8-b21f-c3e576a958dd
5934	5934	0	GBIF Benin	efb9c00e-f802-45dd-8826-a52ec45b89ff	b737fdac-8e6c-40fb-b743-f226e2b2f9da
5	5	0	Plazi	ffb07bec-2d10-492d-9c37-361fe0b79427	b7d05555-2f04-4df4-be3c-a1194c3a0c22
51	51	0	National Biodiversity Network	d897a5b9-35ee-4232-94bd-b0bcaac003c2	b861873d-0fbf-409e-8c55-56197472963d
980	980	0	GBIF France	da44cd31-5901-4687-a106-6d1c7734ee3a	bdca0694-e24f-413d-b2d7-eff8dcc72a6f
2	2	0	Plazi	ffb07bec-2d10-492d-9c37-361fe0b79427	bdce4a6e-c507-498c-9e56-9c6df4bbf202
42	42	0	GBIF Brazil	cdc9736d-5ff7-4ece-9959-3c744360cdb3	be1690c2-5e11-40b3-9dc7-7556155347bf
114375	115579	1204	GBIF Sweden	a0b3be64-6525-4387-ac67-a499950f92e1	be77e203-486c-4651-91b9-8347968b728c
260	260	0	U.S. Geological Survey	8618c64a-93e0-4300-b546-7249e5148ed2	bf3999f6-ec2d-4a2f-ac97-84e4ba726350
7245	7245	0	GBIF Germany	4f6826f2-4ff6-443d-b966-e6913bd24013	c23c9745-aeb2-4bd0-a996-f8c52881bb91
1557	1557	0	National Biodiversity Network	d897a5b9-35ee-4232-94bd-b0bcaac003c2	c37de967-62a8-45a5-aabb-c4b8841bcc74
3	3	0	Plazi	ffb07bec-2d10-492d-9c37-361fe0b79427	c3af1e1e-8127-4cd0-8a04-c79434fcd5b2
36	36	0	GBIF France	da44cd31-5901-4687-a106-6d1c7734ee3a	c44b76a2-e648-4424-aa4d-991de96fadfd
6	6	0	Plazi	ffb07bec-2d10-492d-9c37-361fe0b79427	c4cfdf82-f7f0-42c0-b966-3f69d23daed3
15631	15631	0	GBIF Argentina	2426a871-9feb-40a1-96c6-0c593a76b835	c784b892-4893-4dac-a61d-bc4a458b1d88
181	213	32	U.S. Geological Survey	8618c64a-93e0-4300-b546-7249e5148ed2	c8e9fe8e-391b-44b9-ad94-a5d15f4b5788
6	6	0	Plazi	ffb07bec-2d10-492d-9c37-361fe0b79427	c9b1dca5-090b-4227-b41e-1f49f943bb54
681	681	0	GBIF Germany	4f6826f2-4ff6-443d-b966-e6913bd24013	cb7f5ddc-bc81-43e3-8d4f-6d3c4e65c35b
14110	14110	0	National Biodiversity Network	d897a5b9-35ee-4232-94bd-b0bcaac003c2	cddb8a18-c755-4ca6-9561-8dcbb8af82d7
4380	4380	0	GBIF Germany	4f6826f2-4ff6-443d-b966-e6913bd24013	d2d09a41-7e9f-4882-9a76-ab5e61e8e4c1
758	758	0	GBIF France	da44cd31-5901-4687-a106-6d1c7734ee3a	d5f2bf6a-bd53-450f-a697-ce2356c6c1a7
37500	87500	50000	GBIF Japan	db5705aa-6a6e-42f1-8942-d77b9f4896ea	dc692432-d85c-46cc-82bc-2fb1ff38decc
72	72	0	GBIF France	da44cd31-5901-4687-a106-6d1c7734ee3a	df788089-d7b5-412c-9d6e-4b2ecdd42428
3355	3355	0	Biodiversity Information System of Mexico	b324e8e9-9a4c-44fa-8f1a-7f39ea7ab576	e2c104fa-6002-41b0-acd0-8fd2a04e78de
264	264	0	GBIF Argentina	2426a871-9feb-40a1-96c6-0c593a76b835	e2e1303a-52b3-4760-9713-86075d8a23c9
31846	31970	124	Atlas of Living Australia	4a6f1b71-969e-4fc5-a693-282b05e1220c	e3e48696-f083-4c3a-8c5b-efb1589c54db
0	2	2	Plazi	ffb07bec-2d10-492d-9c37-361fe0b79427	e42d32bc-ed00-4197-bfcd-a558e041bb41
16097	16097	0	National Biodiversity Network	d897a5b9-35ee-4232-94bd-b0bcaac003c2	e50342e7-f2b2-496a-a033-2ce857eb06c4
11933	12359	426	Participant Node Managers Committee	7f48e0c8-5c96-49ec-b972-30748e339115	e6aa777f-f1f6-4bb7-af71-9ea2473efe35
10610	10610	0	Atlas of Living Australia	4a6f1b71-969e-4fc5-a693-282b05e1220c	e88f8fc3-043a-47fc-8e50-6cb631e5a46d
3	3	0	Plazi	ffb07bec-2d10-492d-9c37-361fe0b79427	ebad461f-833b-4fb2-a117-16ac93e9107c
6636	6636	0	National Biodiversity Network	d897a5b9-35ee-4232-94bd-b0bcaac003c2	ec0fd014-5578-4d4b-8a63-ab8f10149dc7
16	16	0	Plazi	ffb07bec-2d10-492d-9c37-361fe0b79427	eec03b6a-265e-42a3-a24c-2768daeb791a
2785010	2785010	0	National Biodiversity Network	d897a5b9-35ee-4232-94bd-b0bcaac003c2	f1929b90-79f5-47aa-b983-51f108eb491f
88	88	0	Plazi	ffb07bec-2d10-492d-9c37-361fe0b79427	f309b9a6-ba6b-4f63-96b6-caf37e4e2a21
1210	1210	0	Ocean Biodiversity Information System	ba0670b9-4186-41e6-8e70-f9cb3065551a	f33ccea7-0f86-45f8-8a28-f8c832ab29ba
0	358093	358093	National Biodiversity Network	d897a5b9-35ee-4232-94bd-b0bcaac003c2	f71cff20-c223-445a-9fb1-ff3a7466d993
59645	59669	24	Canada Biodiversity Information Facility	8f83fc96-c966-4126-83f7-bf044dc49efa	f86a681d-7db8-483b-819a-248def18b70a
1038	1038	0	GBIF Malawi	2a42e4d7-ad4a-41b3-84c4-de4aa7b74d35	f99a4d39-ac4b-4c79-baa8-1f29c6e6916a
756	756	0	GBIF France	da44cd31-5901-4687-a106-6d1c7734ee3a	f9f69819-36a1-4aa1-9363-043a212b66f5
77	77	0	GBIF France	da44cd31-5901-4687-a106-6d1c7734ee3a	00f1e93e-105d-4126-99e2-f58f1e98e5a0
107	107	0	National Biodiversity Network	d897a5b9-35ee-4232-94bd-b0bcaac003c2	06f26623-7c8f-4a9c-9727-f40846ae7e62
69	69	0	Colombian Biodiversity Information System	7e865cba-7c46-417b-ade5-97f2cf5b7be0	06fb4e08-6fe6-492b-a900-f00922e3890c
0	2	2	Plazi	ffb07bec-2d10-492d-9c37-361fe0b79427	08056e65-10fb-44e4-a577-2fb27c40cfc5
0	2	2	Plazi	ffb07bec-2d10-492d-9c37-361fe0b79427	08c86378-5aa3-4f72-849f-ac4060c014af
95	95	0	Colombian Biodiversity Information System	7e865cba-7c46-417b-ade5-97f2cf5b7be0	0b50e6ca-13eb-4f48-a9f1-fe6075e9aa39
117	117	0	GBIF France	da44cd31-5901-4687-a106-6d1c7734ee3a	0f588fa8-e014-42c7-b155-aa9f700b8027
100	100	0	Plazi	ffb07bec-2d10-492d-9c37-361fe0b79427	0fb4d524-292f-4f51-96b5-d648d600ed44
0	11	11	Plazi	ffb07bec-2d10-492d-9c37-361fe0b79427	10535245-a92e-4aa3-a4fc-f6b1acc80cc5
3	3	0	Plazi	ffb07bec-2d10-492d-9c37-361fe0b79427	13c4fdcf-ece4-462d-bb8c-7d0f6b819d5d
544	544	0	Colombian Biodiversity Information System	7e865cba-7c46-417b-ade5-97f2cf5b7be0	18c50a1b-0e2b-499a-ac7c-c70b9ecfd6a5
4358	5874	1516	Atlas of Living Australia	4a6f1b71-969e-4fc5-a693-282b05e1220c	19b8cae9-a4f2-49ca-b687-cc297726e462
5760	5760	0	GBIF France	da44cd31-5901-4687-a106-6d1c7734ee3a	1acd2f97-63ae-4d86-bdc6-a0e9105e5e3a
7	7	0	Plazi	ffb07bec-2d10-492d-9c37-361fe0b79427	1cd743eb-44c1-4a65-aa50-2ee46f963270
187	187	0	DanBIF - Danish Biodiversity Information Facility	4ddd294f-02b7-4359-ac33-0806a9ca9c6b	1d5a02be-1665-422d-9609-b90f9c88de4a
0	41	41	Ocean Biodiversity Information System	ba0670b9-4186-41e6-8e70-f9cb3065551a	1e899800-3983-47fa-a60f-f264441d736a
1249	1249	0	Ocean Biodiversity Information System	ba0670b9-4186-41e6-8e70-f9cb3065551a	1f7bb798-150d-44c2-b7a6-372f341e5ff4
0	69	69	Ocean Biodiversity Information System	ba0670b9-4186-41e6-8e70-f9cb3065551a	22399234-c203-4d01-8107-3f857b4b0c74
106	106	0	Plazi	ffb07bec-2d10-492d-9c37-361fe0b79427	23318f00-a004-48a0-acee-a5e469d5e423
0	9	9	Plazi	ffb07bec-2d10-492d-9c37-361fe0b79427	25a9c8d4-a695-4a1a-88b1-080201b8e616
0	8	8	Plazi	ffb07bec-2d10-492d-9c37-361fe0b79427	25f021d5-c95b-441a-b014-cae55dace166
92	92	0	Plazi	ffb07bec-2d10-492d-9c37-361fe0b79427	26464cf9-5139-4f0c-90ea-39e1aeb0ff36
407	407	0	Belgian Biodiversity Platform	fb11cfe1-ebc3-45af-9159-17d9fddbcdac	266628c1-56a0-46cb-b136-3b77dbc32268
37	37	0	GBIF France	da44cd31-5901-4687-a106-6d1c7734ee3a	2b5c2aaf-3aa9-47e4-a1e5-8f29412f85fe
8	8	0	Plazi	ffb07bec-2d10-492d-9c37-361fe0b79427	2b659fa4-3e94-4869-96e4-5016860ec9df
5368	5368	0	Netherlands Biodiversity Information Facility	0909d601-bda2-42df-9e63-a6d51847ebce	2deeb3ad-0390-4d2c-9623-c5abc6610b08
0	18131	18131	Biodiversity Information System of Mexico	b324e8e9-9a4c-44fa-8f1a-7f39ea7ab576	2e2e54d9-615a-4204-8f0c-467500fc0a63
3739	3739	0	National Biodiversity Network	d897a5b9-35ee-4232-94bd-b0bcaac003c2	2f59254d-ec45-4a4c-9dbd-079f02d7b413
3	3	0	Plazi	ffb07bec-2d10-492d-9c37-361fe0b79427	2fa13a05-5dd5-4b3b-aabb-36b1683d0aee
342184	349958	7774	South African Biodiversity Information Facility	7190b835-4e86-4b6e-85c1-19cc6677c250	2fd17f41-80ef-4c15-ac48-63ca89f4bb16
357	357	0	Participant Node Managers Committee	7f48e0c8-5c96-49ec-b972-30748e339115	31a29499-0189-4c72-975b-eede9114d550
9	9	0	Plazi	ffb07bec-2d10-492d-9c37-361fe0b79427	324b030a-18a2-4dac-9ddd-28c468aea7df
0	23	23	Ocean Biodiversity Information System	ba0670b9-4186-41e6-8e70-f9cb3065551a	3348f7f1-7dbf-4da5-bf2e-a99bf9c80648
4	4	0	Plazi	ffb07bec-2d10-492d-9c37-361fe0b79427	3478de6e-e446-449d-96d2-5115a69138c1
5199	5199	0	National Biodiversity Network	d897a5b9-35ee-4232-94bd-b0bcaac003c2	3692c933-aff2-41d5-9ff2-31f2a2c919f5
0	2258	2258	Participant Node Managers Committee	7f48e0c8-5c96-49ec-b972-30748e339115	3b5759e3-0a06-48e6-89b8-4f972b197768
11	11	0	Plazi	ffb07bec-2d10-492d-9c37-361fe0b79427	3d273a0d-b603-4dbc-b305-b72fd3724b3b
11371	13715	2344	Colombian Biodiversity Information System	7e865cba-7c46-417b-ade5-97f2cf5b7be0	3dac6c1a-ef35-4804-9a7e-df3fd20621b3
0	1	1	Plazi	ffb07bec-2d10-492d-9c37-361fe0b79427	455d660d-f2da-4c64-9ddf-e2fe3bc3a51b
6	6	0	Plazi	ffb07bec-2d10-492d-9c37-361fe0b79427	461bd7a3-c3e4-4525-8130-2dfb3c5656ad
5	5	0	Plazi	ffb07bec-2d10-492d-9c37-361fe0b79427	47aced42-44bc-4658-ae5e-c1c48b4847b4
1383	1383	0	Polish Biodiversity Information Network	2618bfdf-e194-4911-a241-80db3107bc51	490fd890-fd5e-11db-ace1-b8a03c50a862
31	31	0	Plazi	ffb07bec-2d10-492d-9c37-361fe0b79427	4b4cdca1-41f1-4236-bc69-bfd843262052
5	5	0	Plazi	ffb07bec-2d10-492d-9c37-361fe0b79427	4bedeb19-2f4c-4325-9ab4-22eace75b174
0	4	4	Plazi	ffb07bec-2d10-492d-9c37-361fe0b79427	4cd6154c-f508-4f30-9fba-3e100aae07d7
1	1	0	Plazi	ffb07bec-2d10-492d-9c37-361fe0b79427	4ded7345-d8d1-4764-8e54-6cd51f973789
7	7	0	Colombian Biodiversity Information System	7e865cba-7c46-417b-ade5-97f2cf5b7be0	512eeb9f-1c1c-4568-ab6c-df78cd20072e
0	3	3	Plazi	ffb07bec-2d10-492d-9c37-361fe0b79427	51ede4b9-4a14-4900-b50a-4c4aba057363
15	15	0	GBIF France	da44cd31-5901-4687-a106-6d1c7734ee3a	52ac320b-55cf-46bc-8a75-b559c3449b18
17	17	0	Plazi	ffb07bec-2d10-492d-9c37-361fe0b79427	532cf2b8-1585-41a6-bd05-7161b856af3c
216	216	0	GBIF Germany	4f6826f2-4ff6-443d-b966-e6913bd24013	55c415cb-253f-4f32-aa22-841256837b4b
2726	2726	0	Colombian Biodiversity Information System	7e865cba-7c46-417b-ade5-97f2cf5b7be0	56c3ef0a-a2f2-4f3f-8add-3bf004ce27ad
8	8	0	Plazi	ffb07bec-2d10-492d-9c37-361fe0b79427	570a1bff-0951-4cd8-a106-b76d9a14f9f3
0	11	11	Ocean Biodiversity Information System	ba0670b9-4186-41e6-8e70-f9cb3065551a	58256d15-4d5a-43af-a9b7-ab7bdf10d504
1355	1355	0	Atlas of Living Australia	4a6f1b71-969e-4fc5-a693-282b05e1220c	59df094c-e61d-4cc4-a779-970fab936dba
0	1	1	Plazi	ffb07bec-2d10-492d-9c37-361fe0b79427	5ac8ee20-3f8c-4620-8980-760fafbdfdc3
5	5	0	Plazi	ffb07bec-2d10-492d-9c37-361fe0b79427	5b1fda47-fc99-4095-b26a-f8bc1bfced0b
104	104	0	Society for the Management of Electronic Biodiversity Data	97818ee4-1461-4180-bf1d-b3201050124f	5c7bf05c-2890-48e8-9b65-a6060cb75d6d
1	1	0	Plazi	ffb07bec-2d10-492d-9c37-361fe0b79427	5d858531-6dfd-4f1d-bf86-bb3dcce0b899
1189	1189	0	Ocean Biodiversity Information System	ba0670b9-4186-41e6-8e70-f9cb3065551a	5f04cc93-43ce-4ee2-8fe7-93a0bf5b8702
3	3	0	Plazi	ffb07bec-2d10-492d-9c37-361fe0b79427	6065aef7-5475-407b-8222-812913517521
0	29	29	Ocean Biodiversity Information System	ba0670b9-4186-41e6-8e70-f9cb3065551a	609d9450-9d14-4d65-a761-28fc5686da1d
112	112	0	GBIF Germany	4f6826f2-4ff6-443d-b966-e6913bd24013	6115b42e-f762-11e1-a439-00145eb45e9a
162	162	0	GBIF Germany	4f6826f2-4ff6-443d-b966-e6913bd24013	6143645a-f762-11e1-a439-00145eb45e9a
5036	5036	0	GBIF France	da44cd31-5901-4687-a106-6d1c7734ee3a	615ef65c-061a-4494-99b0-66e0e688afef
195	195	0	GBIF Germany	4f6826f2-4ff6-443d-b966-e6913bd24013	6168ffc6-f762-11e1-a439-00145eb45e9a
120	120	0	GBIF Germany	4f6826f2-4ff6-443d-b966-e6913bd24013	620fd832-f762-11e1-a439-00145eb45e9a
22	22	0	GBIF Germany	4f6826f2-4ff6-443d-b966-e6913bd24013	62a9fcf0-f762-11e1-a439-00145eb45e9a
0	7	7	Plazi	ffb07bec-2d10-492d-9c37-361fe0b79427	630544ec-db9d-40be-b0a9-517eff31a37c
173	173	0	GBIF Germany	4f6826f2-4ff6-443d-b966-e6913bd24013	64027802-f762-11e1-a439-00145eb45e9a
29	29	0	GBIF Germany	4f6826f2-4ff6-443d-b966-e6913bd24013	64337ee8-f762-11e1-a439-00145eb45e9a
316	303	-13	GBIF Germany	4f6826f2-4ff6-443d-b966-e6913bd24013	659bee14-f762-11e1-a439-00145eb45e9a
11	11	0	Secretariat of the Pacific Regional Environment Programme	29c6a139-ea7f-41f5-8d9b-c55af8736182	663c1199-b99b-41cd-b55e-3f02feb788ea
173	173	0	GBIF Germany	4f6826f2-4ff6-443d-b966-e6913bd24013	6644bec2-f762-11e1-a439-00145eb45e9a
245	270	25	GBIF Japan	db5705aa-6a6e-42f1-8942-d77b9f4896ea	67ef125a-9252-4381-bb99-338d439e8700
0	10	10	Plazi	ffb07bec-2d10-492d-9c37-361fe0b79427	687811ca-2f85-4a24-a3e4-ff5760ca7d6a
9	9	0	Biodiversity Information System of Mexico	b324e8e9-9a4c-44fa-8f1a-7f39ea7ab576	692e5859-3ea6-4420-b6d9-d2cba8024f95
444	444	0	GBIF Germany	4f6826f2-4ff6-443d-b966-e6913bd24013	696a6f34-f762-11e1-a439-00145eb45e9a
11	11	0	Plazi	ffb07bec-2d10-492d-9c37-361fe0b79427	6b11c9bd-eae8-4973-bd53-5ebe9b658b1d
21	21	0	GBIF Germany	4f6826f2-4ff6-443d-b966-e6913bd24013	6b3af61c-f762-11e1-a439-00145eb45e9a
6990	6990	0	GBIF Benin	efb9c00e-f802-45dd-8826-a52ec45b89ff	6b54a741-6988-4d0c-a741-7008db603b8c
12	12	0	GBIF Germany	4f6826f2-4ff6-443d-b966-e6913bd24013	6bd1bb06-f762-11e1-a439-00145eb45e9a
277	277	0	GBIF Germany	4f6826f2-4ff6-443d-b966-e6913bd24013	6c0bdf98-f762-11e1-a439-00145eb45e9a
0	13	13	Plazi	ffb07bec-2d10-492d-9c37-361fe0b79427	6d03ed87-ad86-4744-9799-63b439f85862
0	58	58	Plazi	ffb07bec-2d10-492d-9c37-361fe0b79427	6e65e7d3-7a72-4da4-9739-5e3814593490
125	125	0	GBIF Germany	4f6826f2-4ff6-443d-b966-e6913bd24013	70806cec-f762-11e1-a439-00145eb45e9a
109	109	0	GBIF Germany	4f6826f2-4ff6-443d-b966-e6913bd24013	7102757a-f762-11e1-a439-00145eb45e9a
50	50	0	GBIF Germany	4f6826f2-4ff6-443d-b966-e6913bd24013	71a4fb9c-f762-11e1-a439-00145eb45e9a
376	375	-1	GBIF Germany	4f6826f2-4ff6-443d-b966-e6913bd24013	720e478c-f762-11e1-a439-00145eb45e9a
0	16	16	Plazi	ffb07bec-2d10-492d-9c37-361fe0b79427	7226548c-af21-4648-85ea-733acdfda22e
24	24	0	GBIF Germany	4f6826f2-4ff6-443d-b966-e6913bd24013	7239bd5e-f762-11e1-a439-00145eb45e9a
7	7	0	GBIF Germany	4f6826f2-4ff6-443d-b966-e6913bd24013	73ff4320-f762-11e1-a439-00145eb45e9a
744	744	0	GBIF Germany	4f6826f2-4ff6-443d-b966-e6913bd24013	74ce7dde-f762-11e1-a439-00145eb45e9a
37	37	0	GBIF Germany	4f6826f2-4ff6-443d-b966-e6913bd24013	75226ef8-f762-11e1-a439-00145eb45e9a
4	4	0	Plazi	ffb07bec-2d10-492d-9c37-361fe0b79427	769d6045-92f2-4697-b4a6-064435dd6901
7691	7691	0	Biodiversity Information System of Mexico	b324e8e9-9a4c-44fa-8f1a-7f39ea7ab576	77483bcb-6b64-4c8d-9d28-c989024b09a6
0	122	122	GBIF Norway	4f829580-180d-46a9-9c87-ed8ec959b545	782ad188-4dc3-4ba7-a04b-58d3e32b56d7
41	41	0	Plazi	ffb07bec-2d10-492d-9c37-361fe0b79427	78e71f21-bf4e-4cb6-9b39-ec297753e743
8	8	0	Plazi	ffb07bec-2d10-492d-9c37-361fe0b79427	7940f8b4-5f97-46d5-8de2-db7612758650
80	75	-5	GBIF Germany	4f6826f2-4ff6-443d-b966-e6913bd24013	7960af2a-f762-11e1-a439-00145eb45e9a
130	130	0	Plazi	ffb07bec-2d10-492d-9c37-361fe0b79427	7a021cff-06df-4146-90ff-f9613795778c
6	6	0	GBIF Germany	4f6826f2-4ff6-443d-b966-e6913bd24013	7a88d594-f762-11e1-a439-00145eb45e9a
0	1	1	Plazi	ffb07bec-2d10-492d-9c37-361fe0b79427	7b6c54fc-380d-430c-9870-71d5633afa73
168	168	0	GBIF Germany	4f6826f2-4ff6-443d-b966-e6913bd24013	7c40f844-f762-11e1-a439-00145eb45e9a
891	891	0	Participant Node Managers Committee	7f48e0c8-5c96-49ec-b972-30748e339115	7cab52c2-4042-4b73-a69c-2f34fe495575
1103	723	-380	GBIF Germany	4f6826f2-4ff6-443d-b966-e6913bd24013	7d621366-f762-11e1-a439-00145eb45e9a
0	31767	31767	Biodiversity Information System of Mexico	b324e8e9-9a4c-44fa-8f1a-7f39ea7ab576	7dcaa915-d51a-4376-b2b3-08fd7aca3f23
313	313	0	GBIF Portugal	673f7038-4262-4149-b753-5658a4e912f6	7df6557f-1996-4874-a08a-1ac5718ef413
395	395	0	GBIF France	da44cd31-5901-4687-a106-6d1c7734ee3a	7eafaab6-ab94-49a0-830c-15658bd39fe5
1284	1284	0	GBIF Benin	efb9c00e-f802-45dd-8826-a52ec45b89ff	7f41f92e-c7d9-421c-aeaf-aca304113010
220286	220286	0	U.S. Geological Survey	8618c64a-93e0-4300-b546-7249e5148ed2	7f6dd0f7-9ed4-49c0-bb71-b2a9c7fed9f1
3385	3385	0	Biodiversity Information System of Mexico	b324e8e9-9a4c-44fa-8f1a-7f39ea7ab576	7fca729c-f762-11e1-a439-00145eb45e9a
1217	1217	0	Biodiversity Information System of Mexico	b324e8e9-9a4c-44fa-8f1a-7f39ea7ab576	80a89392-f762-11e1-a439-00145eb45e9a
2097	1187	-910	GBIF Germany	4f6826f2-4ff6-443d-b966-e6913bd24013	81661386-f762-11e1-a439-00145eb45e9a
861	861	0	GBIF Germany	4f6826f2-4ff6-443d-b966-e6913bd24013	8209ba86-f762-11e1-a439-00145eb45e9a
1482	1482	0	Ocean Biodiversity Information System	ba0670b9-4186-41e6-8e70-f9cb3065551a	83ea4307-fd04-467c-af87-271a963841fc
6267818	7124660	856842	GBIF Switzerland	169eb292-376b-4cc6-8e31-9c2c432de0ad	83fdfd3d-3a25-4705-9fbe-3db1d1892b13
1237	1237	0	Ocean Biodiversity Information System	ba0670b9-4186-41e6-8e70-f9cb3065551a	84304262-f762-11e1-a439-00145eb45e9a
0	4	4	Plazi	ffb07bec-2d10-492d-9c37-361fe0b79427	85573ebe-ee52-4795-8eb8-2a8e00be3eb0
2532	2532	0	GBIF Germany	4f6826f2-4ff6-443d-b966-e6913bd24013	85cdfbfa-f762-11e1-a439-00145eb45e9a
0	136	136	Participant Node Managers Committee	7f48e0c8-5c96-49ec-b972-30748e339115	86edee65-e1c5-4348-a5ef-fcac71dbce74
4055	2954	-1101	GBIF Germany	4f6826f2-4ff6-443d-b966-e6913bd24013	86f4bd3e-f762-11e1-a439-00145eb45e9a
82	52	-30	GBIF Germany	4f6826f2-4ff6-443d-b966-e6913bd24013	871f8014-f762-11e1-a439-00145eb45e9a
31	31	0	Plazi	ffb07bec-2d10-492d-9c37-361fe0b79427	87c298c9-613c-4907-9836-131ec30b236e
131	131	0	GBIF Germany	4f6826f2-4ff6-443d-b966-e6913bd24013	88266874-f762-11e1-a439-00145eb45e9a
48	48	0	GBIF Germany	4f6826f2-4ff6-443d-b966-e6913bd24013	8a0b3c78-f762-11e1-a439-00145eb45e9a
47	47	0	Plazi	ffb07bec-2d10-492d-9c37-361fe0b79427	8a1b577e-5fce-489a-9777-32c9564a26b2
3	3	0	Plazi	ffb07bec-2d10-492d-9c37-361fe0b79427	8b1fcc72-58a4-41cc-b1e0-62ad79987d5b
0	41	41	Plazi	ffb07bec-2d10-492d-9c37-361fe0b79427	8d4fbb8d-b60b-4985-9599-fd161329d224
63	63	0	GBIF Germany	4f6826f2-4ff6-443d-b966-e6913bd24013	8d69d676-6f74-4ba6-a7e4-5df3d1707742
246	164	-82	GBIF Germany	4f6826f2-4ff6-443d-b966-e6913bd24013	8d89d9a4-f762-11e1-a439-00145eb45e9a
35	35	0	GBIF Japan	db5705aa-6a6e-42f1-8942-d77b9f4896ea	8daa0a17-dc87-41eb-a13a-1a6ca56894dc
0	26	26	Plazi	ffb07bec-2d10-492d-9c37-361fe0b79427	8db060a7-8799-4203-b2d3-10af003456f1
477	477	0	GBIF France	da44cd31-5901-4687-a106-6d1c7734ee3a	8ec973e2-e360-456c-83ad-ce23e8efee44
57	57	0	Plazi	ffb07bec-2d10-492d-9c37-361fe0b79427	8f8a5b41-f716-4645-bc76-c4c30b7947f6
2126593	2126593	0	National Biodiversity Network	d897a5b9-35ee-4232-94bd-b0bcaac003c2	912ac7b3-f473-435b-97d1-20b6ed0a6208
81	65	-16	GBIF Germany	4f6826f2-4ff6-443d-b966-e6913bd24013	912da892-f762-11e1-a439-00145eb45e9a
456	424	-32	GBIF Germany	4f6826f2-4ff6-443d-b966-e6913bd24013	917687a6-f762-11e1-a439-00145eb45e9a
2601	2687	86	GBIF Brazil	cdc9736d-5ff7-4ece-9959-3c744360cdb3	91fa0308-8901-45f2-a9df-b42f64b53c0e
835	835	0	GBIF France	da44cd31-5901-4687-a106-6d1c7734ee3a	92003106-25e2-407f-be8d-dd7f412aceca
433	449	16	GBIF Germany	4f6826f2-4ff6-443d-b966-e6913bd24013	92116a0a-f762-11e1-a439-00145eb45e9a
81	83	2	GBIF Germany	4f6826f2-4ff6-443d-b966-e6913bd24013	92cde45a-f762-11e1-a439-00145eb45e9a
2	2	0	GBIF Germany	4f6826f2-4ff6-443d-b966-e6913bd24013	93911682-f762-11e1-a439-00145eb45e9a
1026	1026	0	GBIF Spain	1f94b3ca-9345-4d65-afe2-4bace93aa0fe	94d8f41f-7204-4a89-82ae-e337710dd543
77	77	0	GBIF Chile	a8b16421-d80b-4ef3-8f22-098b01a89255	9613454d-e359-4172-9682-b7c148f8fc0a
99	99	0	GBIF Germany	4f6826f2-4ff6-443d-b966-e6913bd24013	96153eba-f762-11e1-a439-00145eb45e9a
0	26	26	Plazi	ffb07bec-2d10-492d-9c37-361fe0b79427	96162b7d-4474-4113-9703-d853773b9361
121	121	0	Atlas of Living Australia	4a6f1b71-969e-4fc5-a693-282b05e1220c	96a5456e-f762-11e1-a439-00145eb45e9a
10	10	0	Plazi	ffb07bec-2d10-492d-9c37-361fe0b79427	98cc6902-30ce-4a83-8018-fcead925a930
2	2	0	Plazi	ffb07bec-2d10-492d-9c37-361fe0b79427	997f6b83-698f-47b5-8cb7-cda9d85ab434
5	5	0	Plazi	ffb07bec-2d10-492d-9c37-361fe0b79427	9a19c75e-a62b-4143-adda-28789a95da5c
0	1068	1068	Ocean Biodiversity Information System	ba0670b9-4186-41e6-8e70-f9cb3065551a	9be55037-1e81-4870-aaea-ab89c29bf741
10	10	0	Plazi	ffb07bec-2d10-492d-9c37-361fe0b79427	9caf5715-83f7-4cd4-81bd-2bfad820f6d5
0	88	88	Plazi	ffb07bec-2d10-492d-9c37-361fe0b79427	a06d6982-ca06-4a79-8680-ac4cf79caa84
20027	20027	0	GBIF Brazil	cdc9736d-5ff7-4ece-9959-3c744360cdb3	a545ec47-00cd-4cbc-89ca-e48cf9b3a95b
27	27	0	Plazi	ffb07bec-2d10-492d-9c37-361fe0b79427	a6fad20b-7037-4fec-abad-93014894e0db
4344	4344	0	GBIF Uganda	71b40829-6a12-4c3d-8fee-5746f5e9cf8c	a93cc450-f6b9-4f5d-9b12-c49013cf4c79
0	5	5	Plazi	ffb07bec-2d10-492d-9c37-361fe0b79427	aa6886c6-0e65-44ea-93f9-d9ca90a53c7b
103	103	0	GBIF Germany	4f6826f2-4ff6-443d-b966-e6913bd24013	aa92ca28-c3fc-446c-a569-04ae3bf06b78
10	10	0	Plazi	ffb07bec-2d10-492d-9c37-361fe0b79427	ac6617b7-7364-4be9-9bc5-7189a6d0348e
13	13	0	GBIF France	da44cd31-5901-4687-a106-6d1c7734ee3a	af72cca1-2d5c-40e6-ba5d-cb8be51116c6
1	1	0	Plazi	ffb07bec-2d10-492d-9c37-361fe0b79427	b04b6421-6dcb-4711-b035-485c87123337
7518	7518	0	GBIF France	da44cd31-5901-4687-a106-6d1c7734ee3a	b161692c-95a1-4909-91bd-08c870bd0ca6
868	868	0	GBIF France	da44cd31-5901-4687-a106-6d1c7734ee3a	b190b00b-a8ed-4c35-98b7-5bb86f6dc469
0	1	1	Plazi	ffb07bec-2d10-492d-9c37-361fe0b79427	b228bfa2-f688-4541-a31f-d2ad994edd6d
22485	22485	0	GBIF Germany	4f6826f2-4ff6-443d-b966-e6913bd24013	b281d0c7-e700-4067-a47f-39eafda1b893
5	5	0	Plazi	ffb07bec-2d10-492d-9c37-361fe0b79427	b289d291-5da8-48a8-b283-a456bce4ec76
0	10	10	Plazi	ffb07bec-2d10-492d-9c37-361fe0b79427	bdcf9ea4-269b-4084-ba96-c8f391588323
255	255	0	Plazi	ffb07bec-2d10-492d-9c37-361fe0b79427	be792f86-9e77-414c-9e2f-767704ff704e
551	551	0	National Biodiversity Network	d897a5b9-35ee-4232-94bd-b0bcaac003c2	c04a8bc5-eccd-432c-b9b5-e86552e2a7f5
175	175	0	National Biodiversity Data Centre	422b00b2-6c94-4bb6-976b-c359916efdb8	c0ccca10-c7b8-11de-b279-f39805ee8d61
0	1368	1368	Colombian Biodiversity Information System	7e865cba-7c46-417b-ade5-97f2cf5b7be0	c182220b-8d5f-43e7-8375-9b54d71cee7b
742	742	0	GBIF France	da44cd31-5901-4687-a106-6d1c7734ee3a	c2f0a2a1-1584-4efc-9e8e-b8ad10c6edd3
1	1	0	Plazi	ffb07bec-2d10-492d-9c37-361fe0b79427	c3c19703-7ab0-443c-8775-4e3409b53172
283	283	0	Atlas of Living Australia	4a6f1b71-969e-4fc5-a693-282b05e1220c	c4065bee-6ad7-4bee-a14a-bd4171a9cf69
238	238	0	Colombian Biodiversity Information System	7e865cba-7c46-417b-ade5-97f2cf5b7be0	c41a275a-a13f-4d2f-909c-f5fe6ba47cea
3	3	0	Plazi	ffb07bec-2d10-492d-9c37-361fe0b79427	c6c56876-6d8f-4c85-892a-37ea32bab386
484	484	0	GBIF France	da44cd31-5901-4687-a106-6d1c7734ee3a	c7d36672-f718-4f82-9abe-9fea9bf4f950
0	4	4	Plazi	ffb07bec-2d10-492d-9c37-361fe0b79427	c8aae4cc-d304-4f86-9509-32906b543c0b
3772	3772	0	GBIF Spain	1f94b3ca-9345-4d65-afe2-4bace93aa0fe	cc0e6535-6bb4-4703-a32c-077f5e1176cd
1	1	0	Plazi	ffb07bec-2d10-492d-9c37-361fe0b79427	ce397603-2e1b-45d7-a660-ab4771887774
0	63	63	Plazi	ffb07bec-2d10-492d-9c37-361fe0b79427	ce83a1e1-c5fb-4b14-87a3-658d8f417ba8
177	177	0	Colombian Biodiversity Information System	7e865cba-7c46-417b-ade5-97f2cf5b7be0	ce8788c0-cde3-44be-ac1b-9d5798c795e5
73	73	0	Plazi	ffb07bec-2d10-492d-9c37-361fe0b79427	cefd46f6-f601-4ccf-bfbf-91b41c58937f
163	163	0	National Biodiversity Network	d897a5b9-35ee-4232-94bd-b0bcaac003c2	cf519c4d-3c2a-4ef1-9e3e-d643b75ce956
3	3	0	Plazi	ffb07bec-2d10-492d-9c37-361fe0b79427	d0bf1467-a87c-4578-acfd-c0cf4a8523ba
565	565	0	Colombian Biodiversity Information System	7e865cba-7c46-417b-ade5-97f2cf5b7be0	d19b5274-f6ce-4f54-86a6-a9f3daa3309d
19366	19366	0	GBIF Germany	4f6826f2-4ff6-443d-b966-e6913bd24013	d45b8e8a-1f32-40b0-a132-bd690bd90b30
12	12	0	Plazi	ffb07bec-2d10-492d-9c37-361fe0b79427	d550dc04-c72b-4e27-8348-5c6ae98ba144
61	61	0	Plazi	ffb07bec-2d10-492d-9c37-361fe0b79427	d7359d0a-1682-4d3a-933b-a5a0ccd5f57b
322	322	0	Plazi	ffb07bec-2d10-492d-9c37-361fe0b79427	d8c0dac0-6b03-43f4-be6d-1dc3d3d9cfa3
1571	1571	0	National Biodiversity Network	d897a5b9-35ee-4232-94bd-b0bcaac003c2	d9eeaa5a-57d4-4d21-9ee5-2d039b8670e4
27	27	0	Plazi	ffb07bec-2d10-492d-9c37-361fe0b79427	daf28c32-4733-4f63-a3a1-85ce4c73ef7e
1	1	0	Plazi	ffb07bec-2d10-492d-9c37-361fe0b79427	dc200aca-bb0d-4ffd-af22-d56fe08564c6
32	32	0	GBIF Germany	4f6826f2-4ff6-443d-b966-e6913bd24013	dc5aa964-d6bd-4810-8cde-b539f058fdfc
1	1	0	Plazi	ffb07bec-2d10-492d-9c37-361fe0b79427	de326de6-327f-4e00-a69d-c908067f9307
3	3	0	Plazi	ffb07bec-2d10-492d-9c37-361fe0b79427	deaa0090-d530-4358-a9fe-39b944ce5806
5462	5462	0	Participant Node Managers Committee	7f48e0c8-5c96-49ec-b972-30748e339115	e170dbd1-a67f-4514-841c-5296b290ca90
20	20	0	Plazi	ffb07bec-2d10-492d-9c37-361fe0b79427	e1e6067e-1c64-4c26-800f-3914c9d10904
0	4	4	Plazi	ffb07bec-2d10-492d-9c37-361fe0b79427	e22bbd95-78d9-4578-841f-ac29d6c38230
0	28	28	Participant Node Managers Committee	7f48e0c8-5c96-49ec-b972-30748e339115	e278834a-71c8-41e9-9a81-54132168d9c3
0	3	3	Plazi	ffb07bec-2d10-492d-9c37-361fe0b79427	e49ac3e5-55d5-45e1-a379-5cc27d32861d
276503	276503	0	U.S. Geological Survey	8618c64a-93e0-4300-b546-7249e5148ed2	e4d3fc77-1d94-495b-96ff-3fe8b8f7a3bd
0	5	5	Plazi	ffb07bec-2d10-492d-9c37-361fe0b79427	e65a83c9-69bc-4c11-bc50-16e60a41d706
277	277	0	Colombian Biodiversity Information System	7e865cba-7c46-417b-ade5-97f2cf5b7be0	ea2899ff-d8f3-4c44-ba54-d5cf7fa50125
9	9	0	Plazi	ffb07bec-2d10-492d-9c37-361fe0b79427	ec1a3c71-4548-4600-a302-37a4e767d202
0	12	12	Ocean Biodiversity Information System	ba0670b9-4186-41e6-8e70-f9cb3065551a	edbe941f-e13c-4dd0-8a10-0db167f0b603
651	651	0	GBIF France	da44cd31-5901-4687-a106-6d1c7734ee3a	eec78796-b97a-4edd-b1e7-16fd76006789
0	5	5	Plazi	ffb07bec-2d10-492d-9c37-361fe0b79427	f42652d2-5974-4cc4-afad-d98a87886aee
1	1	0	Plazi	ffb07bec-2d10-492d-9c37-361fe0b79427	f647228f-56ac-4beb-a736-acbb4b2a6c32
0	889	889	Ocean Biodiversity Information System	ba0670b9-4186-41e6-8e70-f9cb3065551a	f755288b-e29b-4ad2-869c-3611a6a60509
70047	80429	10382	U.S. Geological Survey	8618c64a-93e0-4300-b546-7249e5148ed2	fb639e31-52eb-4998-afb1-984ee12aca0f
229	229	0	GBIF France	da44cd31-5901-4687-a106-6d1c7734ee3a	fbf7fa47-b700-4aa0-9420-d5a3597898c1
0	45	45	Plazi	ffb07bec-2d10-492d-9c37-361fe0b79427	fc3a8901-c995-49e0-b8b5-6ec0c9727de4
0	271	271	Belgian Biodiversity Platform	fb11cfe1-ebc3-45af-9159-17d9fddbcdac	fd42b9d8-3ec2-490b-801b-bb6fae43727d
0	5	5	Plazi	ffb07bec-2d10-492d-9c37-361fe0b79427	01f4bc8a-74a9-4261-aae7-2f038166083a
27	27	0	Colombian Biodiversity Information System	7e865cba-7c46-417b-ade5-97f2cf5b7be0	023c7f99-d0c8-429a-998f-66ecfd84b3df
0	7	7	Plazi	ffb07bec-2d10-492d-9c37-361fe0b79427	0346d944-3f90-4e71-aee6-ddd208b16d68
5	5	0	Plazi	ffb07bec-2d10-492d-9c37-361fe0b79427	03edf7f4-e813-4db0-893f-2aa033d28cc7
12129	12129	0	National Biodiversity Network	d897a5b9-35ee-4232-94bd-b0bcaac003c2	05fd79d4-e4b4-486e-98dc-c21e38d224c6
60516	60516	0	U.S. Geological Survey	8618c64a-93e0-4300-b546-7249e5148ed2	083a4342-39f7-4fe0-a03c-d14ab3b9c5e2
468	468	0	Colombian Biodiversity Information System	7e865cba-7c46-417b-ade5-97f2cf5b7be0	09585c22-fcd2-4def-93fe-c5fa68c276c5
93444	93444	0	Belgian Biodiversity Platform	fb11cfe1-ebc3-45af-9159-17d9fddbcdac	09baff40-d4a3-11dc-8719-b8a03c50a862
0	42	42	Plazi	ffb07bec-2d10-492d-9c37-361fe0b79427	0a2d723c-d292-4f0c-9d00-6cdd176c49a6
0	53	53	Plazi	ffb07bec-2d10-492d-9c37-361fe0b79427	0a8bdd92-7bf8-44fb-8e8e-5c300df51a20
2147	2147	0	Netherlands Biodiversity Information Facility	0909d601-bda2-42df-9e63-a6d51847ebce	0b328835-ea95-4ec3-a0f4-dd2dba993f1f
0	3	3	Plazi	ffb07bec-2d10-492d-9c37-361fe0b79427	0c2a9e63-0385-4a7e-8125-b1a8cb2c987f
9	9	0	Plazi	ffb07bec-2d10-492d-9c37-361fe0b79427	0c8b54d6-d787-458d-8a1b-61dd9b5dcb88
0	83	83	Plazi	ffb07bec-2d10-492d-9c37-361fe0b79427	111f6060-421e-4f53-bfb2-63a7d605f1a4
0	231	231	Plazi	ffb07bec-2d10-492d-9c37-361fe0b79427	16b7d8d9-c520-44b2-a097-31067e1a9869
0	163	163	Colombian Biodiversity Information System	7e865cba-7c46-417b-ade5-97f2cf5b7be0	16bf6378-206a-43f7-8a04-965218d4b113
1	1	0	Plazi	ffb07bec-2d10-492d-9c37-361fe0b79427	170261c6-3ceb-43bd-8ccf-a9caccec72da
111	111	0	GBIF France	da44cd31-5901-4687-a106-6d1c7734ee3a	17c28618-1f41-43e7-8a8b-ca79fd129cb8
0	135	135	Belgian Biodiversity Platform	fb11cfe1-ebc3-45af-9159-17d9fddbcdac	18e74819-7bae-4337-806a-7c949c56afbe
527	527	0	GBIF France	da44cd31-5901-4687-a106-6d1c7734ee3a	1b384dec-afa8-4a36-811f-d4084bd5f1b1
14	14	0	Atlas of Living Australia	4a6f1b71-969e-4fc5-a693-282b05e1220c	1be46db6-0035-47f9-abaf-f0c018f7f573
31	31	0	Participant Node Managers Committee	7f48e0c8-5c96-49ec-b972-30748e339115	1e10d155-ea5e-4b2f-964b-fad943a1c93a
0	4	4	Plazi	ffb07bec-2d10-492d-9c37-361fe0b79427	1e6d2efe-706d-45bd-a536-a1cf9079d652
0	2	2	Plazi	ffb07bec-2d10-492d-9c37-361fe0b79427	1f23cc0d-e442-472c-96a2-7911c5939b12
3932	3932	0	Ocean Biodiversity Information System	ba0670b9-4186-41e6-8e70-f9cb3065551a	1fe2ac17-e8b3-4cd2-a2b7-b3490b569579
228	228	0	Participant Node Managers Committee	7f48e0c8-5c96-49ec-b972-30748e339115	241f7fac-0a12-4dac-a30a-05b7154418da
0	4	4	Plazi	ffb07bec-2d10-492d-9c37-361fe0b79427	29d75167-df26-40ef-a4c8-1de6a6bff8b0
308	308	0	GBIF France	da44cd31-5901-4687-a106-6d1c7734ee3a	2a1ecb70-00a2-46c3-bc8b-94d8f2eeb0bb
576	576	0	Atlas of Living Australia	4a6f1b71-969e-4fc5-a693-282b05e1220c	2a2bf4d1-5747-4c03-ae7b-328a7768345b
0	12	12	Ocean Biodiversity Information System	ba0670b9-4186-41e6-8e70-f9cb3065551a	2ab05d29-93e1-4e6e-8640-d4e4fb97ff1b
128	128	0	GBIF France	da44cd31-5901-4687-a106-6d1c7734ee3a	2ab2941b-3c00-408a-a7f3-5275ad7d1216
23	23	0	Plazi	ffb07bec-2d10-492d-9c37-361fe0b79427	2c655039-3efe-4cc4-a716-dc70df7d23cb
0	134	134	Plazi	ffb07bec-2d10-492d-9c37-361fe0b79427	2cdec455-6451-498e-8b07-252f4b84e6b4
1	1	0	Plazi	ffb07bec-2d10-492d-9c37-361fe0b79427	2d6af44e-8441-4523-a504-205617b13f43
1	1	0	Plazi	ffb07bec-2d10-492d-9c37-361fe0b79427	2e14cd95-689e-4e20-9cd2-58f2079c60c4
8	8	0	Plazi	ffb07bec-2d10-492d-9c37-361fe0b79427	2e15025d-5514-43c8-833b-526ac51ae5ba
0	3	3	Plazi	ffb07bec-2d10-492d-9c37-361fe0b79427	325df068-91ba-4416-abd2-3cba3d597032
6	6	0	Plazi	ffb07bec-2d10-492d-9c37-361fe0b79427	34826a1d-7146-4d75-9585-b226f798ffdb
1581	1581	0	Colombian Biodiversity Information System	7e865cba-7c46-417b-ade5-97f2cf5b7be0	34ca7b9c-6a2f-465e-9cac-7d71c792c670
1	1	0	Plazi	ffb07bec-2d10-492d-9c37-361fe0b79427	35792d9c-db1a-45f1-b983-f52105f8d004
0	6	6	Plazi	ffb07bec-2d10-492d-9c37-361fe0b79427	3897d44c-875a-44b0-9126-837b42c62212
0	4	4	Plazi	ffb07bec-2d10-492d-9c37-361fe0b79427	39d1c5b2-8a95-458a-b992-fc89b0a5c800
2500	2500	0	GBIF Benin	efb9c00e-f802-45dd-8826-a52ec45b89ff	3b20a827-4afe-428f-b84b-ac8c629c523d
22888	22888	0	National Biodiversity Network	d897a5b9-35ee-4232-94bd-b0bcaac003c2	3bb7e2f5-7d2d-42e8-b2b4-07439ccf9053
12	12	0	Plazi	ffb07bec-2d10-492d-9c37-361fe0b79427	3e77e5cf-7e8a-490d-a5f7-c571b90aea57
4269	4269	0	GBIF Spain	1f94b3ca-9345-4d65-afe2-4bace93aa0fe	40094017-77a9-415d-8e8d-86dea723f617
12181	12181	0	GBIF France	da44cd31-5901-4687-a106-6d1c7734ee3a	4145cd45-8a92-426d-be8b-bfbbf5209032
485	485	0	GBIF Kenya	2a44d626-9f7a-4120-8a7a-4ab5ac15ff2a	418884c8-68b0-4b4d-bd19-47451dc9de6e
50106	50106	0	Netherlands Biodiversity Information Facility	0909d601-bda2-42df-9e63-a6d51847ebce	421e6128-74cb-48ac-b76e-e419d39e2527
1	1	0	GBIF Germany	4f6826f2-4ff6-443d-b966-e6913bd24013	42b08620-3a0c-11e2-b0ce-00145eb45e9a
0	2	2	Plazi	ffb07bec-2d10-492d-9c37-361fe0b79427	46b9f254-f7fe-4d38-af26-03ec89818645
586	586	0	Plazi	ffb07bec-2d10-492d-9c37-361fe0b79427	48496621-de1a-4490-b866-1ae69d81ecbc
0	141	141	Colombian Biodiversity Information System	7e865cba-7c46-417b-ade5-97f2cf5b7be0	4862cc19-ad71-48c9-85ba-029e1b53a243
2	2	0	Plazi	ffb07bec-2d10-492d-9c37-361fe0b79427	491f4990-4c73-4dbd-9871-aac89a6293df
0	30	30	Plazi	ffb07bec-2d10-492d-9c37-361fe0b79427	4a1fd7f9-9585-4083-8588-2592be2f41e0
1137	1137	0	GBIF Germany	4f6826f2-4ff6-443d-b966-e6913bd24013	4b41ffb9-b9b9-41af-835c-718f918e2289
1755	1755	0	Atlas of Living Australia	4a6f1b71-969e-4fc5-a693-282b05e1220c	4b79a668-7e87-4154-ba53-51ee79a76599
9	9	0	Plazi	ffb07bec-2d10-492d-9c37-361fe0b79427	4bdc59ba-57b7-4497-97ce-6265a7033431
1785	1785	0	U.S. Geological Survey	8618c64a-93e0-4300-b546-7249e5148ed2	4ec02cdc-1266-473e-8609-dc280706ca7b
0	6	6	Plazi	ffb07bec-2d10-492d-9c37-361fe0b79427	52d3f5ee-85fe-444f-810f-f769d599a63a
418	418	0	GBIF Japan	db5705aa-6a6e-42f1-8942-d77b9f4896ea	5318e238-18f5-11e2-98fb-00145eb45e9a
64	64	0	Colombian Biodiversity Information System	7e865cba-7c46-417b-ade5-97f2cf5b7be0	5995e6ec-ec8e-4021-ab7b-37806367c48a
0	19	19	Plazi	ffb07bec-2d10-492d-9c37-361fe0b79427	5c45f2f9-cc85-4449-89bb-4604246d12af
1315	1315	0	Participant Node Managers Committee	7f48e0c8-5c96-49ec-b972-30748e339115	5c8ff6d3-b9dc-465a-b46a-dbb8ee30b26e
10	10	0	Participant Node Managers Committee	7f48e0c8-5c96-49ec-b972-30748e339115	5f1c7493-f17a-48bb-89cc-b92ff8edd239
122	122	0	GBIF Germany	4f6826f2-4ff6-443d-b966-e6913bd24013	61be0dc2-f762-11e1-a439-00145eb45e9a
16	16	0	GBIF Germany	4f6826f2-4ff6-443d-b966-e6913bd24013	63117506-f762-11e1-a439-00145eb45e9a
1	1	0	GBIF Germany	4f6826f2-4ff6-443d-b966-e6913bd24013	634151e0-f762-11e1-a439-00145eb45e9a
37	37	0	GBIF Germany	4f6826f2-4ff6-443d-b966-e6913bd24013	641c5150-f762-11e1-a439-00145eb45e9a
72	72	0	GBIF Germany	4f6826f2-4ff6-443d-b966-e6913bd24013	64df33f0-f762-11e1-a439-00145eb45e9a
11	11	0	Plazi	ffb07bec-2d10-492d-9c37-361fe0b79427	66476c49-1f53-451b-9c02-9fde16197b38
131	131	0	GBIF Germany	4f6826f2-4ff6-443d-b966-e6913bd24013	66b4e3aa-f762-11e1-a439-00145eb45e9a
180	180	0	GBIF Germany	4f6826f2-4ff6-443d-b966-e6913bd24013	678e181e-f762-11e1-a439-00145eb45e9a
1127	1127	0	National Biodiversity Network	d897a5b9-35ee-4232-94bd-b0bcaac003c2	6795cb33-9904-4fb9-9584-380c2f528b61
251819	251819	0	National Biodiversity Network	d897a5b9-35ee-4232-94bd-b0bcaac003c2	682ad111-d16c-4a31-8044-b7977bc8904a
145	145	0	GBIF Germany	4f6826f2-4ff6-443d-b966-e6913bd24013	6954d606-f762-11e1-a439-00145eb45e9a
18	18	0	GBIF Germany	4f6826f2-4ff6-443d-b966-e6913bd24013	6b1d2c22-f762-11e1-a439-00145eb45e9a
2	2	0	Plazi	ffb07bec-2d10-492d-9c37-361fe0b79427	6de1cdbb-5c8e-4f58-b9e0-1790503ef0a5
11	11	0	GBIF Germany	4f6826f2-4ff6-443d-b966-e6913bd24013	6fbf4fbc-f762-11e1-a439-00145eb45e9a
6	6	0	GBIF Germany	4f6826f2-4ff6-443d-b966-e6913bd24013	6fdf3282-f762-11e1-a439-00145eb45e9a
9	9	0	Plazi	ffb07bec-2d10-492d-9c37-361fe0b79427	7070ef91-15db-4b7e-a87d-72e7b0bdb192
106	106	0	GBIF Germany	4f6826f2-4ff6-443d-b966-e6913bd24013	70fda61c-f762-11e1-a439-00145eb45e9a
1360	1293	-67	GBIF Germany	4f6826f2-4ff6-443d-b966-e6913bd24013	71071fda-f762-11e1-a439-00145eb45e9a
93	93	0	Plazi	ffb07bec-2d10-492d-9c37-361fe0b79427	7207436d-9a85-412a-a439-6eaec7008b4b
44	44	0	GBIF Germany	4f6826f2-4ff6-443d-b966-e6913bd24013	723e9338-f762-11e1-a439-00145eb45e9a
93	93	0	Plazi	ffb07bec-2d10-492d-9c37-361fe0b79427	724cb358-6f18-4816-afc7-bb42cb9b6942
2712345	2712345	0	Atlas of Living Australia	4a6f1b71-969e-4fc5-a693-282b05e1220c	73d4365a-8868-4d84-a6fd-51098b968170
113	113	0	GBIF Germany	4f6826f2-4ff6-443d-b966-e6913bd24013	7513c1f0-f762-11e1-a439-00145eb45e9a
303	303	0	GBIF Germany	4f6826f2-4ff6-443d-b966-e6913bd24013	7744e8f0-f762-11e1-a439-00145eb45e9a
199	199	0	GBIF France	da44cd31-5901-4687-a106-6d1c7734ee3a	78a54d64-5c90-4fcb-8047-7715595407ad
880	880	0	GBIF Germany	4f6826f2-4ff6-443d-b966-e6913bd24013	78ca1948-f762-11e1-a439-00145eb45e9a
455003	467097	12094	U.S. Geological Survey	8618c64a-93e0-4300-b546-7249e5148ed2	7931dcab-94f1-46ce-8092-56e4335423de
0	3273	3273	Ocean Biodiversity Information System	ba0670b9-4186-41e6-8e70-f9cb3065551a	793d6df2-7d7d-4323-8de1-b38f24379fb7
1836	1836	0	GBIF Germany	4f6826f2-4ff6-443d-b966-e6913bd24013	7a04c5e2-f762-11e1-a439-00145eb45e9a
665	665	0	GBIF Germany	4f6826f2-4ff6-443d-b966-e6913bd24013	7b85cff6-f762-11e1-a439-00145eb45e9a
6	6	0	GBIF Germany	4f6826f2-4ff6-443d-b966-e6913bd24013	7d11e0bc-f762-11e1-a439-00145eb45e9a
20	20	0	Plazi	ffb07bec-2d10-492d-9c37-361fe0b79427	7d5d9964-5477-466e-a664-2b2e3cdd2819
2407	631	-1776	GBIF Germany	4f6826f2-4ff6-443d-b966-e6913bd24013	7f06d6ca-f762-11e1-a439-00145eb45e9a
78	78	0	GBIF Germany	4f6826f2-4ff6-443d-b966-e6913bd24013	7f12aa18-f762-11e1-a439-00145eb45e9a
7612	7612	0	Participant Node Managers Committee	7f48e0c8-5c96-49ec-b972-30748e339115	806eae29-ea28-409f-9d95-f7b1f06f0448
8	8	0	Plazi	ffb07bec-2d10-492d-9c37-361fe0b79427	80f30000-004b-48ab-845d-d5e227850f8d
2278	2278	0	National Biodiversity Network	d897a5b9-35ee-4232-94bd-b0bcaac003c2	81b3a27b-a462-435f-ad74-825c019e29cc
2042	2042	0	Canada Biodiversity Information Facility	8f83fc96-c966-4126-83f7-bf044dc49efa	846296d6-f762-11e1-a439-00145eb45e9a
70229	70229	0	DanBIF - Danish Biodiversity Information Facility	4ddd294f-02b7-4359-ac33-0806a9ca9c6b	84dbaec2-f762-11e1-a439-00145eb45e9a
2	2	0	Plazi	ffb07bec-2d10-492d-9c37-361fe0b79427	85f46966-7f3a-4fcd-8920-3d835e03cee2
4361	4361	0	GBIF Germany	4f6826f2-4ff6-443d-b966-e6913bd24013	88c85f80-f762-11e1-a439-00145eb45e9a
41676	41676	0	Ocean Biodiversity Information System	ba0670b9-4186-41e6-8e70-f9cb3065551a	892417e4-f762-11e1-a439-00145eb45e9a
194	194	0	GBIF Germany	4f6826f2-4ff6-443d-b966-e6913bd24013	8a63f00c-f762-11e1-a439-00145eb45e9a
0	2	2	Plazi	ffb07bec-2d10-492d-9c37-361fe0b79427	8a8cfeb2-a31b-4f35-a682-88f8e61c1f9c
281	281	0	Plazi	ffb07bec-2d10-492d-9c37-361fe0b79427	8c3d903d-6d82-45d1-a1c0-b29f5b97d0c1
11	7	-4	GBIF Germany	4f6826f2-4ff6-443d-b966-e6913bd24013	8d465cba-f762-11e1-a439-00145eb45e9a
4	4	0	GBIF Germany	4f6826f2-4ff6-443d-b966-e6913bd24013	8e203be2-f762-11e1-a439-00145eb45e9a
18	3	-15	GBIF Germany	4f6826f2-4ff6-443d-b966-e6913bd24013	8e3365f0-f762-11e1-a439-00145eb45e9a
44	34	-10	GBIF Germany	4f6826f2-4ff6-443d-b966-e6913bd24013	8f629090-f762-11e1-a439-00145eb45e9a
225	98	-127	GBIF Germany	4f6826f2-4ff6-443d-b966-e6913bd24013	8fb99656-f762-11e1-a439-00145eb45e9a
8	8	0	Plazi	ffb07bec-2d10-492d-9c37-361fe0b79427	903bdf26-783f-4f1d-930a-5e17aff6febd
652	652	0	Colombian Biodiversity Information System	7e865cba-7c46-417b-ade5-97f2cf5b7be0	91f84f39-f1e0-4e25-9b74-3b5261fed895
0	474	474	Plazi	ffb07bec-2d10-492d-9c37-361fe0b79427	91fec855-7fa9-4ad6-84d7-9b9d35e23e8b
16	16	0	GBIF Germany	4f6826f2-4ff6-443d-b966-e6913bd24013	924d3c92-f762-11e1-a439-00145eb45e9a
361	361	0	GBIF Germany	4f6826f2-4ff6-443d-b966-e6913bd24013	9326ef46-f762-11e1-a439-00145eb45e9a
1	1	0	Plazi	ffb07bec-2d10-492d-9c37-361fe0b79427	93d8b512-f031-4345-a6fe-83d6f563ced8
2866	2866	0	GBIF Spain	1f94b3ca-9345-4d65-afe2-4bace93aa0fe	95ca5a80-f762-11e1-a439-00145eb45e9a
11	11	0	Atlas of Living Australia	4a6f1b71-969e-4fc5-a693-282b05e1220c	95e15b18-f762-11e1-a439-00145eb45e9a
0	695	695	Ocean Biodiversity Information System	ba0670b9-4186-41e6-8e70-f9cb3065551a	99b85897-b625-47b1-a760-47523bee89f9
136	136	0	GBIF France	da44cd31-5901-4687-a106-6d1c7734ee3a	9f069d5a-0dc2-4832-8a76-03f85257f5df
94	94	0	Plazi	ffb07bec-2d10-492d-9c37-361fe0b79427	9f235b62-9469-46ae-9fc0-9a39bd53b690
0	8	8	Plazi	ffb07bec-2d10-492d-9c37-361fe0b79427	a0c3d86a-90d9-461e-b9db-e24143d6d581
212	212	0	Participant Node Managers Committee	7f48e0c8-5c96-49ec-b972-30748e339115	a1480b53-ae89-4997-ab2a-73b3981ca244
0	320	320	Plazi	ffb07bec-2d10-492d-9c37-361fe0b79427	a75d6e42-221a-4df9-9a7d-5f33dbff6a56
0	1	1	Plazi	ffb07bec-2d10-492d-9c37-361fe0b79427	a76d0e66-f869-4bc4-9566-843f4837919f
0	44	44	Plazi	ffb07bec-2d10-492d-9c37-361fe0b79427	aa9de9bf-dea4-4321-a51d-6c4f1f55032d
0	2	2	Participant Node Managers Committee	7f48e0c8-5c96-49ec-b972-30748e339115	abef7407-7f4c-462a-8420-a6fb4e380850
0	2	2	Plazi	ffb07bec-2d10-492d-9c37-361fe0b79427	acc2cc2a-1c8e-41c5-9bd6-039189a01293
26346	26346	0	GBIF Germany	4f6826f2-4ff6-443d-b966-e6913bd24013	ae3eff3a-7453-498c-bcdf-c22e1fcdec78
262	262	0	GBIF Peru	46e3639a-27f8-45af-bfbe-d19b77efb040	ae71b27c-448f-4ff8-be04-42e3d7c196bc
3604	3604	0	Atlas of Living Australia	4a6f1b71-969e-4fc5-a693-282b05e1220c	aea541ad-d8fa-42df-b5ed-ac0f26c977a7
764	764	0	GBIF Israel	8cb55387-7802-40e8-86d6-d357a583c596	aee51547-6e86-4dc9-b149-0df501253d4c
0	6	6	Plazi	ffb07bec-2d10-492d-9c37-361fe0b79427	b0261de0-373d-4ad9-a243-d5f9805cbe2a
3	3	0	Participant Node Managers Committee	7f48e0c8-5c96-49ec-b972-30748e339115	b0754a0c-19e8-4b00-be5d-f8cfb6ac077e
127	127	0	GBIF France	da44cd31-5901-4687-a106-6d1c7734ee3a	b0974289-9ee7-4913-ac1c-f0556301fc9c
2436	2436	0	Ocean Biodiversity Information System	ba0670b9-4186-41e6-8e70-f9cb3065551a	b7a56663-63df-4349-9804-56678d1a3f8d
0	2	2	Plazi	ffb07bec-2d10-492d-9c37-361fe0b79427	b7f850c6-980e-4b58-bf15-eb959580dac1
9	9	0	Plazi	ffb07bec-2d10-492d-9c37-361fe0b79427	b8e56edc-0d14-490a-88a8-a91801e5b678
567	567	0	GBIF France	da44cd31-5901-4687-a106-6d1c7734ee3a	b8e5b4e8-0a30-4a5b-8b23-60b864bd449d
0	15	15	Plazi	ffb07bec-2d10-492d-9c37-361fe0b79427	b9ba0812-b687-4c7e-88f4-0a1030ef1458
7	7	0	Plazi	ffb07bec-2d10-492d-9c37-361fe0b79427	b9f4e1d8-1795-48cb-b4c8-264754f4cc0b
6	6	0	Plazi	ffb07bec-2d10-492d-9c37-361fe0b79427	ba3eadbe-a0db-4f9c-955d-44a7ea1f7e09
119	119	0	GBIF Germany	4f6826f2-4ff6-443d-b966-e6913bd24013	bac86238-f116-4ef1-a96a-ccbba8c2fcba
0	612	612	Ocean Biodiversity Information System	ba0670b9-4186-41e6-8e70-f9cb3065551a	bce1139a-ed57-49b4-a670-0b283a8e4e19
20	20	0	Plazi	ffb07bec-2d10-492d-9c37-361fe0b79427	be9575c6-3e25-4bc4-82e4-a24ca354eeb9
0	146	146	Plazi	ffb07bec-2d10-492d-9c37-361fe0b79427	c2749822-3528-4493-afd4-3da8f03bd6e0
34636	36157	1521	GBIF Germany	4f6826f2-4ff6-443d-b966-e6913bd24013	c711c16e-8db5-4f66-aa06-03d9e472fbbc
1339711	1339711	0	Netherlands Biodiversity Information Facility	0909d601-bda2-42df-9e63-a6d51847ebce	c779b049-28f3-4daf-bbf4-0a40830819b6
0	4	4	Plazi	ffb07bec-2d10-492d-9c37-361fe0b79427	c793b397-abf5-4129-96d2-c335fe222b4e
4	4	0	Plazi	ffb07bec-2d10-492d-9c37-361fe0b79427	cb2bee87-7061-4c0a-900a-40a9fa2f7e61
28047	28047	0	National Biodiversity Network	d897a5b9-35ee-4232-94bd-b0bcaac003c2	cc1fd2f5-2e0e-4347-b506-a9b2d940fa3d
0	28	28	Plazi	ffb07bec-2d10-492d-9c37-361fe0b79427	ccbf0321-20dc-4799-8575-3f018b87afcc
6	6	0	Plazi	ffb07bec-2d10-492d-9c37-361fe0b79427	ce5f0aec-336b-4610-8d72-00e24ca4e89e
322	322	0	GBIF France	da44cd31-5901-4687-a106-6d1c7734ee3a	ceba06e5-fe4a-422f-a67d-7e5c2d1e847f
4	4	0	GBIF Germany	4f6826f2-4ff6-443d-b966-e6913bd24013	d0dd4abb-60b7-42e4-9fee-71e28089a95d
367	367	0	GBIF France	da44cd31-5901-4687-a106-6d1c7734ee3a	d0df4227-ea16-4f1d-9b54-8b2d3459dc65
2	2	0	Plazi	ffb07bec-2d10-492d-9c37-361fe0b79427	d7723b67-e566-4138-a5ce-8c0b0105fa70
0	27	27	Plazi	ffb07bec-2d10-492d-9c37-361fe0b79427	d897e6d8-2a1f-4e96-b575-4c4010bb9b56
1842	1842	0	GBIF France	da44cd31-5901-4687-a106-6d1c7734ee3a	d9bd5aa4-d230-4a02-bc2e-a0216c09a08c
0	275	275	Plazi	ffb07bec-2d10-492d-9c37-361fe0b79427	da9fec5c-5480-4c98-8739-bc52438ba5e9
52612	52612	0	DanBIF - Danish Biodiversity Information Facility	4ddd294f-02b7-4359-ac33-0806a9ca9c6b	dd3d3e63-118f-49c1-beb6-bdb34d2c7a2a
0	3	3	Plazi	ffb07bec-2d10-492d-9c37-361fe0b79427	de302c1b-e3bf-4f06-80d8-e09e7795c1d0
0	269257	269257	U.S. Geological Survey	8618c64a-93e0-4300-b546-7249e5148ed2	e24dcb47-89f9-4481-a8ac-c38ef26b2865
0	2	2	Plazi	ffb07bec-2d10-492d-9c37-361fe0b79427	e262c926-f4ae-4a2c-87ff-5478e60e7520
8406	8406	0	GBIF France	da44cd31-5901-4687-a106-6d1c7734ee3a	e406b10a-99f7-4ac5-8d19-ca3384373358
109	109	0	National Biodiversity Network	d897a5b9-35ee-4232-94bd-b0bcaac003c2	eb79ce26-907b-477d-a3f0-787210fbddc5
0	1523874	1523874	Canada Biodiversity Information Facility	8f83fc96-c966-4126-83f7-bf044dc49efa	ec186b76-898c-435b-9aea-ebbd5785a25f
43	43	0	Plazi	ffb07bec-2d10-492d-9c37-361fe0b79427	ed665a33-a603-46e9-a8aa-3c20288d0583
0	276	276	Plazi	ffb07bec-2d10-492d-9c37-361fe0b79427	f0b1c09e-298d-497d-b6de-cd74367c983e
16	16	0	Colombian Biodiversity Information System	7e865cba-7c46-417b-ade5-97f2cf5b7be0	f0fb8b34-2e2a-4197-aa89-7da06eb72016
0	657	657	Colombian Biodiversity Information System	7e865cba-7c46-417b-ade5-97f2cf5b7be0	f18a4216-4c5d-40eb-87d5-f2c919006ed4
319	319	0	GBIF France	da44cd31-5901-4687-a106-6d1c7734ee3a	f7674e46-e63a-4048-b977-8c0268ff64c0
37	37	0	Plazi	ffb07bec-2d10-492d-9c37-361fe0b79427	f7aee5da-a7ce-4660-b00c-b272b6204a19
222556	244355	21799	National Biodiversity Network	d897a5b9-35ee-4232-94bd-b0bcaac003c2	f7fd7255-5be6-48cf-b76a-821cb84aa93f
3	3	0	Plazi	ffb07bec-2d10-492d-9c37-361fe0b79427	f8ccd15f-6063-45e2-82ff-6fd9cc63f07f
469920	469908	-12	National Biodiversity Network	d897a5b9-35ee-4232-94bd-b0bcaac003c2	fae37d1f-5b7a-4fe2-8cfa-8948aefbcac2
8	8	0	Plazi	ffb07bec-2d10-492d-9c37-361fe0b79427	fb595a0b-8414-42c5-b376-a618d24a50ea
0	8105	8105	Participant Node Managers Committee	7f48e0c8-5c96-49ec-b972-30748e339115	fe127afe-2458-4e9a-8b06-f7f4730d4103
48	48	0	Plazi	ffb07bec-2d10-492d-9c37-361fe0b79427	ffa603fb-edd5-418f-af51-b91c5ef41acc
0	13	13	Plazi	ffb07bec-2d10-492d-9c37-361fe0b79427	0042d06a-8a95-4eb5-bf84-1453bdec29bb
0	495	495	Ocean Biodiversity Information System	ba0670b9-4186-41e6-8e70-f9cb3065551a	0109855a-08a8-4925-aed4-4ed175b06621
35	35	0	Plazi	ffb07bec-2d10-492d-9c37-361fe0b79427	056548c2-7356-451c-8100-adc191b6081a
183	183	0	GBIF Malawi	2a42e4d7-ad4a-41b3-84c4-de4aa7b74d35	06467573-6a21-444a-ace7-507d60323324
1016	1016	0	GBIF Malawi	2a42e4d7-ad4a-41b3-84c4-de4aa7b74d35	077cd59e-b198-43ed-97a3-2317aa68e671
537	537	0	GBIF New Zealand	4f9fd726-20dd-445e-89a1-8ed93792276f	080067a5-2645-487c-b768-08b3ba17ab8a
0	1	1	Plazi	ffb07bec-2d10-492d-9c37-361fe0b79427	08f3c09a-97e5-4ff9-8755-2055421fed5b
14	14	0	Plazi	ffb07bec-2d10-492d-9c37-361fe0b79427	099fdd02-495a-4cdc-90d5-af9a6e9d9bf7
114	99	-15	GBIF Germany	4f6826f2-4ff6-443d-b966-e6913bd24013	0ac3600f-0bc8-4659-bf3e-e8e9e6c2cd63
7	7	0	GBIF Japan	db5705aa-6a6e-42f1-8942-d77b9f4896ea	0c802932-0f37-4cdf-8dff-73c62e79912c
0	2	2	Plazi	ffb07bec-2d10-492d-9c37-361fe0b79427	0e6ff786-9ade-4aa8-940f-3346a7f26866
114	114	0	Plazi	ffb07bec-2d10-492d-9c37-361fe0b79427	10284664-323e-49f2-a19f-3ef15f718cc0
446	446	0	GBIF Germany	4f6826f2-4ff6-443d-b966-e6913bd24013	1057515c-85a2-40ac-bc6c-b1b5758cdf00
0	21	21	Plazi	ffb07bec-2d10-492d-9c37-361fe0b79427	106c1ebb-d129-48dd-859f-017a27bef1a7
2	2	0	Participant Node Managers Committee	7f48e0c8-5c96-49ec-b972-30748e339115	1372b1bf-9c86-401e-ae32-d37d5a019652
9	9	0	Plazi	ffb07bec-2d10-492d-9c37-361fe0b79427	1482948b-ee69-44e8-b185-6bb0b994169f
1119	1260	141	Participant Node Managers Committee	7f48e0c8-5c96-49ec-b972-30748e339115	148aefb6-cf88-443e-9780-b774ef7333e7
143	143	0	GBIF Brazil	cdc9736d-5ff7-4ece-9959-3c744360cdb3	157c50fe-d8c9-4cd9-b159-9dfee2ce08f4
328	328	0	GBIF France	da44cd31-5901-4687-a106-6d1c7734ee3a	169be958-6c5f-4b82-9b43-8931721f938b
12	12	0	Plazi	ffb07bec-2d10-492d-9c37-361fe0b79427	178cbcbe-f40f-4bb9-aa3e-763ffa5393b7
4857	4956	99	GBIF Brazil	cdc9736d-5ff7-4ece-9959-3c744360cdb3	197e1421-7932-46a9-b227-0405ed5a4304
0	2	2	Plazi	ffb07bec-2d10-492d-9c37-361fe0b79427	1a62c28d-2463-48f4-af25-b7845f175f24
6	6	0	Plazi	ffb07bec-2d10-492d-9c37-361fe0b79427	1af03d39-60ed-46dc-b422-7706bcca43f9
2587	2587	0	Colombian Biodiversity Information System	7e865cba-7c46-417b-ade5-97f2cf5b7be0	1d544329-f17e-43f7-9e98-8acea5c9be9d
7	7	0	Plazi	ffb07bec-2d10-492d-9c37-361fe0b79427	1dd366f3-9e6d-4dcf-a082-408a0ea91bc4
1223	1223	0	GBIF France	da44cd31-5901-4687-a106-6d1c7734ee3a	20cc2c2b-7eef-41d0-a5ad-2330e60acf6b
8	8	0	Plazi	ffb07bec-2d10-492d-9c37-361fe0b79427	21911204-80d5-439b-b1ca-f2db0588f024
0	10	10	Plazi	ffb07bec-2d10-492d-9c37-361fe0b79427	22ab8cd2-4c50-48e1-b414-b0807a6326ed
12	12	0	Plazi	ffb07bec-2d10-492d-9c37-361fe0b79427	23864f37-11de-411b-99fa-1cbdb15dde98
0	3	3	Plazi	ffb07bec-2d10-492d-9c37-361fe0b79427	255d4de2-3891-4201-9a11-34665f4f247f
3003	2992	-11	Biodiversity Information System of Mexico	b324e8e9-9a4c-44fa-8f1a-7f39ea7ab576	261f3489-e820-40d0-8245-094aede04672
1	1	0	Plazi	ffb07bec-2d10-492d-9c37-361fe0b79427	2685d708-7180-45f0-9c45-8e11aff18c53
85	85	0	Colombian Biodiversity Information System	7e865cba-7c46-417b-ade5-97f2cf5b7be0	280705b9-43aa-4bff-90e8-7242a9a21f26
336	336	0	GBIF Germany	4f6826f2-4ff6-443d-b966-e6913bd24013	28be9bc1-cd62-4ffb-a937-823c079ea1ad
250	250	0	National Biodiversity Network	d897a5b9-35ee-4232-94bd-b0bcaac003c2	2900e159-2011-4bb8-8231-6f58182f7b41
1341	1341	0	GBIF Chile	a8b16421-d80b-4ef3-8f22-098b01a89255	2d8cd725-c459-4139-a41a-5989b27ef293
45	45	0	GBIF France	da44cd31-5901-4687-a106-6d1c7734ee3a	2dcdc82d-d017-4fb0-9b78-9f05df429960
0	4	4	Plazi	ffb07bec-2d10-492d-9c37-361fe0b79427	32dbc22a-058b-4f84-be77-01ab35e0ce0b
589	422	-167	GBIF Germany	4f6826f2-4ff6-443d-b966-e6913bd24013	3314ccbd-0d0a-464f-89c5-99cee2ad8cb4
18	18	0	Plazi	ffb07bec-2d10-492d-9c37-361fe0b79427	3349b70b-0ab1-41be-b04e-cbb827e8aeae
5	5	0	GBIF Germany	4f6826f2-4ff6-443d-b966-e6913bd24013	33eca795-df97-49ee-a009-ea49766fa418
15407	15407	0	Colombian Biodiversity Information System	7e865cba-7c46-417b-ade5-97f2cf5b7be0	3bef6fb2-9a1f-4d8d-b5f3-d6d23885905c
99	99	0	Plazi	ffb07bec-2d10-492d-9c37-361fe0b79427	3e5cd781-3051-4527-bace-d222e83d8398
1	1	0	Plazi	ffb07bec-2d10-492d-9c37-361fe0b79427	3e97c343-2785-4b90-8c8a-641e9dfdb38e
1	1	0	Plazi	ffb07bec-2d10-492d-9c37-361fe0b79427	4085ca11-924d-439d-9db3-1d9c72f48a47
2558	2095	-463	GBIF Germany	4f6826f2-4ff6-443d-b966-e6913bd24013	470d1a14-15b7-44d8-9b2b-5ab03f77f7a4
0	167	167	National Biodiversity Network	d897a5b9-35ee-4232-94bd-b0bcaac003c2	486ba5e5-4e22-47b5-82f4-9d7c16879276
0	753	753	GBIF Argentina	2426a871-9feb-40a1-96c6-0c593a76b835	492408da-d566-43f4-9718-933ad1b5914d
0	1	1	Plazi	ffb07bec-2d10-492d-9c37-361fe0b79427	4a061fa8-3220-4701-b56e-7cf547917165
1	1	0	Plazi	ffb07bec-2d10-492d-9c37-361fe0b79427	4d17c805-4ede-480f-8026-c22d787b4382
0	17145	17145	GBIF Brazil	cdc9736d-5ff7-4ece-9959-3c744360cdb3	4ecf66f3-636f-4f86-8af4-2e4f6d23ebef
49998	51622	1624	GBIF Brazil	cdc9736d-5ff7-4ece-9959-3c744360cdb3	52b78a58-c84a-4370-bb14-b27a007d5da6
12	12	0	Plazi	ffb07bec-2d10-492d-9c37-361fe0b79427	5600128b-7356-4530-bf52-32f74f7fa9af
2	2	0	Plazi	ffb07bec-2d10-492d-9c37-361fe0b79427	5687d3cd-124a-450f-9e42-6272f23a94b4
2	2	0	Plazi	ffb07bec-2d10-492d-9c37-361fe0b79427	5763b409-7d67-410b-b0b2-1808a715ecb2
613	613	0	GBIF Finland	dd514216-5c7c-45f3-910d-797424cb5be6	59361789-d4da-4bea-b672-4d27cd6b12c2
0	7	7	Plazi	ffb07bec-2d10-492d-9c37-361fe0b79427	5d0fb569-f8ca-4552-949d-6b506ec71351
8493	7839	-654	Biodiversity Information System of Mexico	b324e8e9-9a4c-44fa-8f1a-7f39ea7ab576	5dbf40d0-0d2d-46af-a205-c83ff2e74098
0	62	62	Colombian Biodiversity Information System	7e865cba-7c46-417b-ade5-97f2cf5b7be0	5e577362-53c6-4ca6-b017-8d584e3ba48e
137	137	0	GBIF Germany	4f6826f2-4ff6-443d-b966-e6913bd24013	613eeefc-f762-11e1-a439-00145eb45e9a
15	15	0	Plazi	ffb07bec-2d10-492d-9c37-361fe0b79427	6277018b-a151-4a34-8d7a-901c420def78
0	4	4	Plazi	ffb07bec-2d10-492d-9c37-361fe0b79427	6303d7d7-7af1-492e-a328-5ed621fa16f9
3	3	0	GBIF Germany	4f6826f2-4ff6-443d-b966-e6913bd24013	6305b4a0-f762-11e1-a439-00145eb45e9a
447	447	0	GBIF Germany	4f6826f2-4ff6-443d-b966-e6913bd24013	637bc9ce-f762-11e1-a439-00145eb45e9a
147	143	-4	GBIF Germany	4f6826f2-4ff6-443d-b966-e6913bd24013	6594d8a4-f762-11e1-a439-00145eb45e9a
30	28	-2	GBIF Germany	4f6826f2-4ff6-443d-b966-e6913bd24013	65d983be-f762-11e1-a439-00145eb45e9a
9	9	0	Plazi	ffb07bec-2d10-492d-9c37-361fe0b79427	65f216f4-26f1-4a26-8656-1463b9fcaf01
158	158	0	GBIF Brazil	cdc9736d-5ff7-4ece-9959-3c744360cdb3	664bd5c2-5c7e-45d3-8fd9-4f19f6558198
34	34	0	GBIF Germany	4f6826f2-4ff6-443d-b966-e6913bd24013	677ff70c-f762-11e1-a439-00145eb45e9a
146	146	0	GBIF Germany	4f6826f2-4ff6-443d-b966-e6913bd24013	67fa033a-f762-11e1-a439-00145eb45e9a
29	29	0	GBIF Germany	4f6826f2-4ff6-443d-b966-e6913bd24013	6823a01e-f762-11e1-a439-00145eb45e9a
245	159	-86	GBIF Germany	4f6826f2-4ff6-443d-b966-e6913bd24013	68d9dad2-f762-11e1-a439-00145eb45e9a
146	146	0	GBIF Germany	4f6826f2-4ff6-443d-b966-e6913bd24013	69899a08-f762-11e1-a439-00145eb45e9a
2	2	0	Plazi	ffb07bec-2d10-492d-9c37-361fe0b79427	69ac963e-9d0b-4ba2-8136-81369e15f921
1	1	0	Plazi	ffb07bec-2d10-492d-9c37-361fe0b79427	6a9c16ca-d661-4057-9f7f-59f9967d5c1d
0	3	3	Plazi	ffb07bec-2d10-492d-9c37-361fe0b79427	6af84979-eaa4-4541-a464-8039655523c3
234	234	0	GBIF Germany	4f6826f2-4ff6-443d-b966-e6913bd24013	6c77b9de-f762-11e1-a439-00145eb45e9a
0	7	7	Plazi	ffb07bec-2d10-492d-9c37-361fe0b79427	6e8d5acc-6318-4e76-a10e-b13dba83c98b
0	2	2	Plazi	ffb07bec-2d10-492d-9c37-361fe0b79427	6f57a149-301e-46e2-adaf-e0b820ed4be0
9382	9382	0	GBIF Germany	4f6826f2-4ff6-443d-b966-e6913bd24013	6f7a0768-f762-11e1-a439-00145eb45e9a
9	9	0	GBIF Germany	4f6826f2-4ff6-443d-b966-e6913bd24013	6fba3bd0-f762-11e1-a439-00145eb45e9a
121	121	0	Colombian Biodiversity Information System	7e865cba-7c46-417b-ade5-97f2cf5b7be0	6fcaf879-9272-46ef-b531-880cc410598b
0	26	26	Plazi	ffb07bec-2d10-492d-9c37-361fe0b79427	70751e1e-652b-447d-864b-cf6db6bd9d88
78	78	0	GBIF Germany	4f6826f2-4ff6-443d-b966-e6913bd24013	70c31eca-f762-11e1-a439-00145eb45e9a
80	80	0	GBIF Germany	4f6826f2-4ff6-443d-b966-e6913bd24013	70fc5ca8-f762-11e1-a439-00145eb45e9a
224	224	0	Belgian Biodiversity Platform	fb11cfe1-ebc3-45af-9159-17d9fddbcdac	713e3cc9-4ae8-452f-91b2-081d9a0bd630
263846	263846	0	Belgian Biodiversity Platform	fb11cfe1-ebc3-45af-9159-17d9fddbcdac	71cfd412-6327-4ec7-8035-d8b2d0509ac5
11	11	0	GBIF Germany	4f6826f2-4ff6-443d-b966-e6913bd24013	72ba76a6-f762-11e1-a439-00145eb45e9a
222277	311595	89318	Ocean Biodiversity Information System	ba0670b9-4186-41e6-8e70-f9cb3065551a	72de3af4-1572-4f2d-8006-2bfa2007065c
1	1	0	Plazi	ffb07bec-2d10-492d-9c37-361fe0b79427	73087d02-3f6a-4672-a86f-44cba6cfe5cf
54	54	0	Plazi	ffb07bec-2d10-492d-9c37-361fe0b79427	737071f6-e466-4247-91c6-da15c1d71b32
0	430	430	Colombian Biodiversity Information System	7e865cba-7c46-417b-ade5-97f2cf5b7be0	73a3a5aa-0b69-48cb-9189-2af78455e7d9
17	17	0	GBIF Germany	4f6826f2-4ff6-443d-b966-e6913bd24013	783e2ad2-f762-11e1-a439-00145eb45e9a
91	91	0	GBIF Germany	4f6826f2-4ff6-443d-b966-e6913bd24013	78697336-f762-11e1-a439-00145eb45e9a
14	14	0	GBIF Germany	4f6826f2-4ff6-443d-b966-e6913bd24013	78b1b93e-f762-11e1-a439-00145eb45e9a
13	13	0	GBIF Germany	4f6826f2-4ff6-443d-b966-e6913bd24013	79099c3a-f762-11e1-a439-00145eb45e9a
259	202	-57	GBIF Germany	4f6826f2-4ff6-443d-b966-e6913bd24013	79754886-f762-11e1-a439-00145eb45e9a
0	6	6	Plazi	ffb07bec-2d10-492d-9c37-361fe0b79427	79ad2d23-537b-4120-9bc6-42aa53dc66fd
2	2	0	Plazi	ffb07bec-2d10-492d-9c37-361fe0b79427	7aa55602-ab38-4ef0-a12d-da3aa635a17d
5	5	0	GBIF Germany	4f6826f2-4ff6-443d-b966-e6913bd24013	7aaced6c-f762-11e1-a439-00145eb45e9a
770	770	0	Ocean Biodiversity Information System	ba0670b9-4186-41e6-8e70-f9cb3065551a	7b517a6c-f762-11e1-a439-00145eb45e9a
801	801	0	GBIF Germany	4f6826f2-4ff6-443d-b966-e6913bd24013	7b882de6-f762-11e1-a439-00145eb45e9a
26	26	0	GBIF Germany	4f6826f2-4ff6-443d-b966-e6913bd24013	7bc53ea2-f762-11e1-a439-00145eb45e9a
3	3	0	Plazi	ffb07bec-2d10-492d-9c37-361fe0b79427	7c5fb31d-f1df-409b-ad2c-658c8b6936ee
2	2	0	Plazi	ffb07bec-2d10-492d-9c37-361fe0b79427	7e8caa2f-e2ba-45ba-bc22-357dbbf822d0
503	503	0	Biodiversity Information System of Mexico	b324e8e9-9a4c-44fa-8f1a-7f39ea7ab576	7f77b3fe-f762-11e1-a439-00145eb45e9a
1157	1157	0	U.S. Geological Survey	8618c64a-93e0-4300-b546-7249e5148ed2	81e4afd9-0b61-483d-b7fa-0690f06c8e14
300	300	0	GBIF Germany	4f6826f2-4ff6-443d-b966-e6913bd24013	834c1ca7-a14b-4a7d-84c9-9cbb5ddbe50a
205	205	0	World Federation for Culture Collections	a6bdc523-5368-4e0f-9d2e-de1c262ac092	8563a8f4-f762-11e1-a439-00145eb45e9a
2103	2103	0	GBIF Portugal	673f7038-4262-4149-b753-5658a4e912f6	85a3c886-3312-45c9-b040-4d7634653246
0	17024	17024	Colombian Biodiversity Information System	7e865cba-7c46-417b-ade5-97f2cf5b7be0	86c06614-5b6c-4e8b-8272-52d31f8d50bb
13709	13709	0	GBIF France	da44cd31-5901-4687-a106-6d1c7734ee3a	87603385-f33f-4577-8e50-ab67f36faa35
1167	1167	0	Society for the Management of Electronic Biodiversity Data	97818ee4-1461-4180-bf1d-b3201050124f	876b1d7c-de82-4b7f-81a1-d663101784b2
0	1817	1817	GBIF Portugal	673f7038-4262-4149-b753-5658a4e912f6	8789cf7e-9265-4259-9020-3199dad26460
825	408	-417	GBIF Germany	4f6826f2-4ff6-443d-b966-e6913bd24013	87a49fce-f762-11e1-a439-00145eb45e9a
18	18	0	GBIF Germany	4f6826f2-4ff6-443d-b966-e6913bd24013	88a8ae10-f762-11e1-a439-00145eb45e9a
0	58	58	Ocean Biodiversity Information System	ba0670b9-4186-41e6-8e70-f9cb3065551a	8a2c47dd-2958-4127-819a-8a6dcfe70c8f
0	4	4	Plazi	ffb07bec-2d10-492d-9c37-361fe0b79427	8a797c3a-a8d4-4899-a1ee-e94d32e4a530
0	172	172	Ocean Biodiversity Information System	ba0670b9-4186-41e6-8e70-f9cb3065551a	8bd1df3e-4c6b-4e1f-afc3-a064a90a8bf9
1	1	0	Plazi	ffb07bec-2d10-492d-9c37-361fe0b79427	8c3f2f95-3ac5-44b3-8494-d57dcca77a3e
51	36	-15	GBIF Germany	4f6826f2-4ff6-443d-b966-e6913bd24013	8ca142de-f762-11e1-a439-00145eb45e9a
2	1	-1	GBIF Germany	4f6826f2-4ff6-443d-b966-e6913bd24013	8cb188ce-f762-11e1-a439-00145eb45e9a
46	12	-34	GBIF Germany	4f6826f2-4ff6-443d-b966-e6913bd24013	8dec40da-f762-11e1-a439-00145eb45e9a
4	4	0	Plazi	ffb07bec-2d10-492d-9c37-361fe0b79427	8eba416f-e2af-4cfe-96fb-fb6059a877ef
151	54	-97	GBIF Germany	4f6826f2-4ff6-443d-b966-e6913bd24013	8f4c49a2-f762-11e1-a439-00145eb45e9a
64	56	-8	GBIF Germany	4f6826f2-4ff6-443d-b966-e6913bd24013	8fc767ae-f762-11e1-a439-00145eb45e9a
2	2	0	Plazi	ffb07bec-2d10-492d-9c37-361fe0b79427	90b7301f-fd3f-4b73-afdc-97bf71e8a172
36	36	0	Participant Node Managers Committee	7f48e0c8-5c96-49ec-b972-30748e339115	91021aab-046a-47b0-84da-5049df511cd7
24	24	0	GBIF Germany	4f6826f2-4ff6-443d-b966-e6913bd24013	9283abb0-f762-11e1-a439-00145eb45e9a
56	53	-3	GBIF Germany	4f6826f2-4ff6-443d-b966-e6913bd24013	93041084-f762-11e1-a439-00145eb45e9a
212	217	5	GBIF Germany	4f6826f2-4ff6-443d-b966-e6913bd24013	9339c256-f762-11e1-a439-00145eb45e9a
15	15	0	Plazi	ffb07bec-2d10-492d-9c37-361fe0b79427	94e09348-a782-45ec-9c88-6584fc3da9c0
0	50	50	Participant Node Managers Committee	7f48e0c8-5c96-49ec-b972-30748e339115	951a8449-9d4e-44f6-8e29-cc9ecbabf0ed
132290	132289	-1	GBIF Finland	dd514216-5c7c-45f3-910d-797424cb5be6	953c46c5-363c-4bcb-a065-86d66f7ffa77
4489	4489	0	GBIF France	da44cd31-5901-4687-a106-6d1c7734ee3a	95d8dd9f-d0a9-4cfb-8cd4-04a3e02c0149
2204	2205	1	GBIF Germany	4f6826f2-4ff6-443d-b966-e6913bd24013	965cfbe2-f762-11e1-a439-00145eb45e9a
12	12	0	GBIF Sweden	a0b3be64-6525-4387-ac67-a499950f92e1	97f90523-b497-4eda-bc85-605fd247a734
690	690	0	GBIF France	da44cd31-5901-4687-a106-6d1c7734ee3a	996613d1-58b1-419d-9de6-89755ec584bc
11	11	0	Participant Node Managers Committee	7f48e0c8-5c96-49ec-b972-30748e339115	9af2981b-cc16-4c0c-86ae-ce04c279dbc6
12	12	0	Plazi	ffb07bec-2d10-492d-9c37-361fe0b79427	9dc6ca11-4803-4d45-8dc9-ec0fc4ad4bef
492	493	1	U.S. Geological Survey	8618c64a-93e0-4300-b546-7249e5148ed2	9fbac577-9e5f-41b2-9edb-c2ed1d2c7020
51637	51637	0	U.S. Geological Survey	8618c64a-93e0-4300-b546-7249e5148ed2	a267b6a7-91f9-457c-889a-481e7aa920b6
4	4	0	Plazi	ffb07bec-2d10-492d-9c37-361fe0b79427	a3f92703-00b4-4ef4-81e9-136c538017fc
409	409	0	Ocean Biodiversity Information System	ba0670b9-4186-41e6-8e70-f9cb3065551a	a59bc583-e35e-44b9-b96c-c3e14f8a2559
46682	44530	-2152	Biodiversity Information System of Mexico	b324e8e9-9a4c-44fa-8f1a-7f39ea7ab576	a5be4674-3ee0-4aab-9ce6-c602a7d71d18
1638	1638	0	Colombian Biodiversity Information System	7e865cba-7c46-417b-ade5-97f2cf5b7be0	aae52145-9f53-4872-ad91-0a0c99e4e9b8
1663	1663	0	DanBIF - Danish Biodiversity Information Facility	4ddd294f-02b7-4359-ac33-0806a9ca9c6b	acf5050c-3a41-4345-a660-652cb9462379
3	3	0	Plazi	ffb07bec-2d10-492d-9c37-361fe0b79427	b5b7f31d-a51a-41ab-9339-d955990a7a2e
468	468	0	GBIF France	da44cd31-5901-4687-a106-6d1c7734ee3a	bb1ef771-31b1-479a-af96-207f57623c23
2664	2664	0	GBIF Germany	4f6826f2-4ff6-443d-b966-e6913bd24013	bb53fa79-e001-4beb-9644-584ee4c29b9f
0	10	10	Plazi	ffb07bec-2d10-492d-9c37-361fe0b79427	bbf04a36-7745-4cd9-88dd-a82d65f2d04f
141860	141860	0	GBIF Brazil	cdc9736d-5ff7-4ece-9959-3c744360cdb3	bc81e05b-ed51-46ba-a0a4-90fbae9b5545
6	6	0	Plazi	ffb07bec-2d10-492d-9c37-361fe0b79427	bccefe3e-8531-44a0-aa87-b1544cf3622d
46710	46710	0	GBIF Sweden	a0b3be64-6525-4387-ac67-a499950f92e1	be07e8c1-0d79-4e39-9697-2a9ec687f8f8
1	1	0	Participant Node Managers Committee	7f48e0c8-5c96-49ec-b972-30748e339115	beba2b79-b0a7-4782-b055-b4b215357e73
58	58	0	GBIF France	da44cd31-5901-4687-a106-6d1c7734ee3a	bfca14f7-6f64-4cf1-b258-2ac4f4212ac2
29	29	0	Biodiversity Information System of Mexico	b324e8e9-9a4c-44fa-8f1a-7f39ea7ab576	c096e622-71b0-419b-b93e-07e29aa36fa7
2757	2757	0	National Biodiversity Network	d897a5b9-35ee-4232-94bd-b0bcaac003c2	c130a4f5-975c-4a60-9935-ee8a68502ef2
0	1	1	Plazi	ffb07bec-2d10-492d-9c37-361fe0b79427	c22b7ba9-f08a-42d8-ace1-c3d8bea5fcd8
36	36	0	Plazi	ffb07bec-2d10-492d-9c37-361fe0b79427	c5176d49-ee06-4e6e-946c-7895b400b5ea
4	4	0	Plazi	ffb07bec-2d10-492d-9c37-361fe0b79427	c53cbcf6-bd29-4108-99eb-2d9edcd27a56
0	450	450	Korean Biodiversity Information Facility	e0a1e772-0177-4800-94b4-2d023fe6cdf4	c5b99b0c-dcec-43a0-b7aa-d9131aeb9f21
280	260	-20	GBIF Germany	4f6826f2-4ff6-443d-b966-e6913bd24013	c9af1aea-59cc-4f91-be77-8ad8dc8ce5bb
0	10416	10416	Participant Node Managers Committee	7f48e0c8-5c96-49ec-b972-30748e339115	cb0ab16c-7589-4a44-80d0-30bae8c952ef
0	2	2	Plazi	ffb07bec-2d10-492d-9c37-361fe0b79427	ce674982-d2b4-4f48-a10f-fff99cfb45a3
0	324971	324971	U.S. Geological Survey	8618c64a-93e0-4300-b546-7249e5148ed2	cf3bdc30-370c-48d3-8fff-b587a39d72d6
0	77	77	Plazi	ffb07bec-2d10-492d-9c37-361fe0b79427	cfd5c06e-06f0-4f1f-ae4b-40b7b46f44a3
0	18	18	Plazi	ffb07bec-2d10-492d-9c37-361fe0b79427	d1c8718a-3b16-45c7-867d-c8ba4e9ff482
13860	13860	0	GBIF Portugal	673f7038-4262-4149-b753-5658a4e912f6	d2909e7e-201a-4665-bf68-62d7ceb86a43
118	118	0	GBIF Malawi	2a42e4d7-ad4a-41b3-84c4-de4aa7b74d35	d303d758-eb02-4d96-9a74-bbed85bf4a73
763	763	0	GBIF Spain	1f94b3ca-9345-4d65-afe2-4bace93aa0fe	d4ee751a-0016-4335-9c3c-bca5a4ef6b36
9	9	0	Plazi	ffb07bec-2d10-492d-9c37-361fe0b79427	d5598e58-1f16-478e-b6e1-dbbcfb827f60
177	177	0	Plazi	ffb07bec-2d10-492d-9c37-361fe0b79427	d7dbbc1f-416c-4365-a32b-a9618e6c1fe9
3	3	0	Plazi	ffb07bec-2d10-492d-9c37-361fe0b79427	d93e40d6-b232-44da-ae9d-c8c01c7aefa0
5	5	0	Plazi	ffb07bec-2d10-492d-9c37-361fe0b79427	dac99f74-3514-47c5-a5fe-e33ef247dde0
12	12	0	Plazi	ffb07bec-2d10-492d-9c37-361fe0b79427	dd471f6d-f3f2-4806-b03b-5b3b7c47d658
205	205	0	GBIF France	da44cd31-5901-4687-a106-6d1c7734ee3a	e36a9136-5618-44e7-9efd-27915f59c08a
17461	11943	-5518	Participant Node Managers Committee	7f48e0c8-5c96-49ec-b972-30748e339115	e4fd8292-95cb-4f49-a639-e59c89e82045
21318	21318	0	GBIF Portugal	673f7038-4262-4149-b753-5658a4e912f6	e5312aa2-3c05-4785-b1ba-944abfa37dca
215	215	0	GBIF France	da44cd31-5901-4687-a106-6d1c7734ee3a	e5e93769-81c3-43b3-bfb5-0ecdc3ac693d
3370	3370	0	Belgian Biodiversity Platform	fb11cfe1-ebc3-45af-9159-17d9fddbcdac	e624aa28-cbec-4c92-b303-9ed0791f4b8b
48	48	0	Plazi	ffb07bec-2d10-492d-9c37-361fe0b79427	e63bf0e7-dcd8-42a0-858c-606a75e91c0c
3786	3786	0	Belgian Biodiversity Platform	fb11cfe1-ebc3-45af-9159-17d9fddbcdac	e6fb3d46-977a-4deb-99be-e8493024feb2
66	66	0	GBIF Argentina	2426a871-9feb-40a1-96c6-0c593a76b835	e8c49ac2-aa03-4167-9ce5-a9ac53068de9
8	8	0	Plazi	ffb07bec-2d10-492d-9c37-361fe0b79427	ec35c1e2-098c-4422-a055-1d1d17950fc7
24284	24284	0	Participant Node Managers Committee	7f48e0c8-5c96-49ec-b972-30748e339115	edd76a7a-64e0-4008-a741-105ecd67e339
71	71	0	Secretariat of the Pacific Regional Environment Programme	29c6a139-ea7f-41f5-8d9b-c55af8736182	ee84e52c-e4d1-44de-a517-60f5aed0aa55
0	2	2	Plazi	ffb07bec-2d10-492d-9c37-361fe0b79427	eeb8f590-30c6-4f6a-bca2-bf8a06ac6fa0
4	4	0	Plazi	ffb07bec-2d10-492d-9c37-361fe0b79427	f5ea915e-8dff-49a1-8aa2-01c93e0a6f8a
9	9	0	Plazi	ffb07bec-2d10-492d-9c37-361fe0b79427	fc32164b-965a-4ed6-ac80-1015e48db264
6214	6214	0	GBIF Benin	efb9c00e-f802-45dd-8826-a52ec45b89ff	fe9fd170-3d00-413c-bbf1-3130e51f2635
0	3	3	Plazi	ffb07bec-2d10-492d-9c37-361fe0b79427	00805858-2f99-469a-9c36-47ab91216421
27	27	0	GBIF Brazil	cdc9736d-5ff7-4ece-9959-3c744360cdb3	0226cfa0-2284-4dbf-be05-cad350f50b61
0	17	17	Plazi	ffb07bec-2d10-492d-9c37-361fe0b79427	02be72df-b930-4f7a-9c69-60ed36d29347
0	24	24	Ocean Biodiversity Information System	ba0670b9-4186-41e6-8e70-f9cb3065551a	0413eb8c-a931-4aeb-8737-e93b9a845461
4	4	0	Participant Node Managers Committee	7f48e0c8-5c96-49ec-b972-30748e339115	0bb8a532-1b00-45e6-99ea-774b47eae650
0	13	13	Plazi	ffb07bec-2d10-492d-9c37-361fe0b79427	0c7614b2-dba9-4640-b42c-348382dfe59b
36	36	0	Plazi	ffb07bec-2d10-492d-9c37-361fe0b79427	10dcadc8-e35a-4113-b820-a506512a3622
0	126	126	Ocean Biodiversity Information System	ba0670b9-4186-41e6-8e70-f9cb3065551a	12689b74-4989-4c00-875d-82b7f7f09e52
3	3	0	Plazi	ffb07bec-2d10-492d-9c37-361fe0b79427	12c2a7d6-a7fd-4132-ba0f-22974f6c1f0d
0	73	73	Ocean Biodiversity Information System	ba0670b9-4186-41e6-8e70-f9cb3065551a	1707cdd2-7308-45e8-b786-4d13769e1020
0	3	3	Plazi	ffb07bec-2d10-492d-9c37-361fe0b79427	190eaa1b-7dac-4762-9251-ebe2a97cbe2f
0	5	5	Plazi	ffb07bec-2d10-492d-9c37-361fe0b79427	1a2d8925-03f9-443c-831d-20bf62955d8c
4632	4632	0	GBIF Japan	db5705aa-6a6e-42f1-8942-d77b9f4896ea	1be86384-0073-4a50-a82f-7ca99bde3df8
2262	2262	0	GBIF France	da44cd31-5901-4687-a106-6d1c7734ee3a	1ccb28a2-757b-43c7-9f16-3203d8e8db81
372	372	0	GBIF Argentina	2426a871-9feb-40a1-96c6-0c593a76b835	1df39810-9b90-4ed3-b013-b0b21dbd7703
3	3	0	Plazi	ffb07bec-2d10-492d-9c37-361fe0b79427	203da4bf-9fac-460b-8b88-91491e66d81f
380	380	0	GBIF France	da44cd31-5901-4687-a106-6d1c7734ee3a	260234ea-5f9c-4a80-88ea-0faf46f9e897
2	2	0	Plazi	ffb07bec-2d10-492d-9c37-361fe0b79427	26c9cff0-0389-4c91-bfce-fade8eb76f67
17114	17114	0	Polish Biodiversity Information Network	2618bfdf-e194-4911-a241-80db3107bc51	28074400-9169-11db-9f6d-b8a03c50a862
732	732	0	GBIF France	da44cd31-5901-4687-a106-6d1c7734ee3a	28126fd6-7201-4d21-89ec-0ee059e36781
755310	755310	0	GBIF France	da44cd31-5901-4687-a106-6d1c7734ee3a	28c7cc8e-3163-4c3d-ab4e-31ebd28b068d
879	879	0	Colombian Biodiversity Information System	7e865cba-7c46-417b-ade5-97f2cf5b7be0	2de3a537-f536-41c4-9884-40d6fe157e6a
178	178	0	GBIF Chile	a8b16421-d80b-4ef3-8f22-098b01a89255	35200844-6f8e-4cd6-9b42-cc908b41cf5e
0	2	2	Plazi	ffb07bec-2d10-492d-9c37-361fe0b79427	358a7527-b1df-4f4d-acf0-d85e46fc873a
1333	1333	0	GBIF Spain	1f94b3ca-9345-4d65-afe2-4bace93aa0fe	35c53a5b-df2a-464b-8707-605080548fa6
458	458	0	Netherlands Biodiversity Information Facility	0909d601-bda2-42df-9e63-a6d51847ebce	378651d7-c235-4205-a617-2939d6faa434
2	2	0	Plazi	ffb07bec-2d10-492d-9c37-361fe0b79427	3902ab42-0ef8-4596-93a6-30e64589d8cd
3	3	0	GBIF France	da44cd31-5901-4687-a106-6d1c7734ee3a	397ad06d-6458-4200-9adb-68f075321a4e
33	33	0	GBIF France	da44cd31-5901-4687-a106-6d1c7734ee3a	3e944dd9-87de-4ebb-a634-a25af615548d
53	53	0	Participant Node Managers Committee	7f48e0c8-5c96-49ec-b972-30748e339115	3fd69215-7a36-4522-bad9-85460a64d44f
15277	15277	0	National Biodiversity Network	d897a5b9-35ee-4232-94bd-b0bcaac003c2	41c25b8a-a94e-4aff-b03b-f5d54fd7d03f
0	497	497	Colombian Biodiversity Information System	7e865cba-7c46-417b-ade5-97f2cf5b7be0	41ee5397-5360-4089-a482-1312e9ef0d48
51	51	0	Plazi	ffb07bec-2d10-492d-9c37-361fe0b79427	44a52693-984e-4c6f-838a-b7b9ea950d45
916	916	0	National Biodiversity Network	d897a5b9-35ee-4232-94bd-b0bcaac003c2	45911491-53f5-48dc-ad09-bf09e05a6630
763	763	0	GBIF France	da44cd31-5901-4687-a106-6d1c7734ee3a	4f211020-9e97-4eed-b575-ce554fb109ad
57	57	0	Plazi	ffb07bec-2d10-492d-9c37-361fe0b79427	51ce4e31-e5c1-4dba-9967-be270c7c3481
65534	65534	0	GBIF Portugal	673f7038-4262-4149-b753-5658a4e912f6	52af34d4-303d-4ce1-8f29-5e9dc26312a6
0	3	3	Plazi	ffb07bec-2d10-492d-9c37-361fe0b79427	53339ee1-e53a-41a9-8edf-dce7e201bbed
50	50	0	Plazi	ffb07bec-2d10-492d-9c37-361fe0b79427	5384e263-638f-4bed-be42-801395516aef
13	13	0	Plazi	ffb07bec-2d10-492d-9c37-361fe0b79427	54f9ac43-e877-479c-a861-3a3fa6b933e0
0	162	162	Plazi	ffb07bec-2d10-492d-9c37-361fe0b79427	5566188f-1bd9-49b8-8862-d5a49752355f
1077	1077	0	GBIF France	da44cd31-5901-4687-a106-6d1c7734ee3a	5818223b-9b8e-432c-9fca-cb4c43387e6a
7962	7962	0	GBIF France	da44cd31-5901-4687-a106-6d1c7734ee3a	593cb5c7-4636-4e1e-8559-2797c4d94041
126	126	0	GBIF France	da44cd31-5901-4687-a106-6d1c7734ee3a	598d20cb-747f-4667-9718-de8f5c1bb66b
0	14021	14021	South African Biodiversity Information Facility	7190b835-4e86-4b6e-85c1-19cc6677c250	5c23cc27-be23-48fe-bd70-a0cef232138d
869	869	0	GBIF France	da44cd31-5901-4687-a106-6d1c7734ee3a	5e8f49af-b4c6-42fe-9483-f19207f03aea
2538	2538	0	GBIF Guinea	b1cd2e84-c4ba-47bd-b72a-dfd1f92dce0a	60b45fdd-246f-4bfd-999e-9fe187cc9c1f
23	23	0	Plazi	ffb07bec-2d10-492d-9c37-361fe0b79427	6251bf04-bedf-44cf-92b2-73e551eb56f6
74	74	0	GBIF Germany	4f6826f2-4ff6-443d-b966-e6913bd24013	6281f26e-f762-11e1-a439-00145eb45e9a
69	69	0	GBIF Germany	4f6826f2-4ff6-443d-b966-e6913bd24013	645fdc04-f762-11e1-a439-00145eb45e9a
40	40	0	GBIF Germany	4f6826f2-4ff6-443d-b966-e6913bd24013	657ea912-f762-11e1-a439-00145eb45e9a
91	91	0	GBIF Germany	4f6826f2-4ff6-443d-b966-e6913bd24013	65960404-f762-11e1-a439-00145eb45e9a
122	122	0	GBIF Germany	4f6826f2-4ff6-443d-b966-e6913bd24013	65e42a94-f762-11e1-a439-00145eb45e9a
0	91	91	Plazi	ffb07bec-2d10-492d-9c37-361fe0b79427	665c72da-8a91-438a-ac00-4d39ce709306
10	10	0	Plazi	ffb07bec-2d10-492d-9c37-361fe0b79427	667e411c-326a-43ca-82ab-ae8c13780339
8	8	0	Plazi	ffb07bec-2d10-492d-9c37-361fe0b79427	66a0b50e-47ae-443f-a2ef-84409dc5acd9
141	141	0	GBIF Germany	4f6826f2-4ff6-443d-b966-e6913bd24013	679828a4-f762-11e1-a439-00145eb45e9a
2629628	2629628	0	National Biodiversity Network	d897a5b9-35ee-4232-94bd-b0bcaac003c2	67c54f85-7910-4cbf-8de4-6f0b136a0e34
7486	6355	-1131	GBIF Germany	4f6826f2-4ff6-443d-b966-e6913bd24013	68624061-9435-478a-8441-794e0cc01306
1185	2687	1502	Participant Node Managers Committee	7f48e0c8-5c96-49ec-b972-30748e339115	6902be25-fe92-4519-a80b-a000b4b1348d
51	51	0	Plazi	ffb07bec-2d10-492d-9c37-361fe0b79427	6a0476c7-2cb6-4e43-b030-760b7a64d52a
544	544	0	GBIF France	da44cd31-5901-4687-a106-6d1c7734ee3a	6a13e891-e760-42d1-b3e2-c0f96412b696
18	18	0	GBIF Germany	4f6826f2-4ff6-443d-b966-e6913bd24013	6a764593-7765-4c96-ac84-d74f98f9a645
200	200	0	GBIF Japan	db5705aa-6a6e-42f1-8942-d77b9f4896ea	6c9729f5-0d66-426d-ace0-5348ae2ce711
192	192	0	GBIF Germany	4f6826f2-4ff6-443d-b966-e6913bd24013	6d1e1f0e-f762-11e1-a439-00145eb45e9a
13545	13545	0	National Biodiversity Network	d897a5b9-35ee-4232-94bd-b0bcaac003c2	6f2a2d94-6cf5-4d34-bbf9-b84a54bd6a9e
1066	766	-300	GBIF Germany	4f6826f2-4ff6-443d-b966-e6913bd24013	70475b78-f762-11e1-a439-00145eb45e9a
0	3	3	Plazi	ffb07bec-2d10-492d-9c37-361fe0b79427	71313cd6-a9b4-495e-9cbf-b3f270ce9512
106	106	0	GBIF Germany	4f6826f2-4ff6-443d-b966-e6913bd24013	7182de72-f762-11e1-a439-00145eb45e9a
32	32	0	GBIF Germany	4f6826f2-4ff6-443d-b966-e6913bd24013	72b1bbec-f762-11e1-a439-00145eb45e9a
9399	9399	0	National Biodiversity Network	d897a5b9-35ee-4232-94bd-b0bcaac003c2	7634ce91-06a9-48ce-9533-0532ab5392b2
746	746	0	Indonesian Biodiversity Information Facility	2ebd91f6-f14f-4375-b525-c011a3774f03	76471ac1-dde9-4b57-aa77-f305503bc4db
8	8	0	Plazi	ffb07bec-2d10-492d-9c37-361fe0b79427	768343b5-9faf-4ef0-8fd8-60a2f52892ae
8	8	0	Plazi	ffb07bec-2d10-492d-9c37-361fe0b79427	76a6d5bb-af44-4f09-a5d6-2b4508a700b2
195	195	0	GBIF France	da44cd31-5901-4687-a106-6d1c7734ee3a	780d5448-fd2a-4cad-ba16-d115ff5efd2c
4	4	0	GBIF Germany	4f6826f2-4ff6-443d-b966-e6913bd24013	7889ed96-f762-11e1-a439-00145eb45e9a
1490	1490	0	Participant Node Managers Committee	7f48e0c8-5c96-49ec-b972-30748e339115	78f2d5d4-ce97-46b2-9f97-6588dae1b3f8
11	11	0	GBIF Germany	4f6826f2-4ff6-443d-b966-e6913bd24013	78f54442-f762-11e1-a439-00145eb45e9a
19	19	0	GBIF Germany	4f6826f2-4ff6-443d-b966-e6913bd24013	7a6cbe9a-f762-11e1-a439-00145eb45e9a
1	1	0	GBIF Germany	4f6826f2-4ff6-443d-b966-e6913bd24013	7aa26702-f762-11e1-a439-00145eb45e9a
1498	1498	0	Ocean Biodiversity Information System	ba0670b9-4186-41e6-8e70-f9cb3065551a	7b49ab2a-f762-11e1-a439-00145eb45e9a
13519	13519	0	National Biodiversity Network	d897a5b9-35ee-4232-94bd-b0bcaac003c2	7bb358e4-6067-42f1-a3e3-7471dd854ce0
1289	1289	0	GBIF France	da44cd31-5901-4687-a106-6d1c7734ee3a	7bb7ea74-e69a-411b-bf8e-310180e591a9
2069684	2429086	359402	National Biodiversity Network	d897a5b9-35ee-4232-94bd-b0bcaac003c2	7d17a2b2-8751-41b5-ac9b-48effc1ea236
1188	1188	0	GBIF Germany	4f6826f2-4ff6-443d-b966-e6913bd24013	7d49e3ae-f762-11e1-a439-00145eb45e9a
60	60	0	GBIF Germany	4f6826f2-4ff6-443d-b966-e6913bd24013	7de5e6dc-f762-11e1-a439-00145eb45e9a
43162	43162	0	National Biodiversity Data Centre	422b00b2-6c94-4bb6-976b-c359916efdb8	80576d53-992a-41f3-a3e3-dfd0fa0242ee
3	3	0	GBIF Japan	db5705aa-6a6e-42f1-8942-d77b9f4896ea	80e59742-f762-11e1-a439-00145eb45e9a
2	2	0	Plazi	ffb07bec-2d10-492d-9c37-361fe0b79427	814e1417-dc77-4942-a67c-694e9800c10b
0	32	32	Plazi	ffb07bec-2d10-492d-9c37-361fe0b79427	820e1202-fc1b-426d-8eff-abb17d3209c8
49459	49459	0	Netherlands Biodiversity Information Facility	0909d601-bda2-42df-9e63-a6d51847ebce	82dc5194-f762-11e1-a439-00145eb45e9a
15455	15455	0	GBIF Spain	1f94b3ca-9345-4d65-afe2-4bace93aa0fe	837f8ba2-f762-11e1-a439-00145eb45e9a
184	184	0	GBIF Germany	4f6826f2-4ff6-443d-b966-e6913bd24013	842abafc-bebc-429f-aa26-744a30d7f025
54	54	0	Canada Biodiversity Information Facility	8f83fc96-c966-4126-83f7-bf044dc49efa	84507d0c-f762-11e1-a439-00145eb45e9a
84	84	0	Canada Biodiversity Information Facility	8f83fc96-c966-4126-83f7-bf044dc49efa	847096dc-f762-11e1-a439-00145eb45e9a
55504	56504	1000	GBIF Japan	db5705aa-6a6e-42f1-8942-d77b9f4896ea	8498cbf2-f762-11e1-a439-00145eb45e9a
2410	2410	0	GBIF Finland	dd514216-5c7c-45f3-910d-797424cb5be6	84ecc4aa-f762-11e1-a439-00145eb45e9a
9902	9902	0	World Federation for Culture Collections	a6bdc523-5368-4e0f-9d2e-de1c262ac092	855abc6c-f762-11e1-a439-00145eb45e9a
1833	1833	0	World Federation for Culture Collections	a6bdc523-5368-4e0f-9d2e-de1c262ac092	855bdbc4-f762-11e1-a439-00145eb45e9a
60311	60311	0	GBIF Spain	1f94b3ca-9345-4d65-afe2-4bace93aa0fe	858528da-f762-11e1-a439-00145eb45e9a
0	6	6	Plazi	ffb07bec-2d10-492d-9c37-361fe0b79427	863dd458-55e0-4583-9677-8eb735037a0f
732	732	0	GBIF Germany	4f6826f2-4ff6-443d-b966-e6913bd24013	86403148-f762-11e1-a439-00145eb45e9a
3946	2758	-1188	GBIF Germany	4f6826f2-4ff6-443d-b966-e6913bd24013	86ecad24-f762-11e1-a439-00145eb45e9a
915	915	0	Colombian Biodiversity Information System	7e865cba-7c46-417b-ade5-97f2cf5b7be0	8729d481-6cf8-4f36-b701-bd423bbd1d9f
175	175	0	GBIF Germany	4f6826f2-4ff6-443d-b966-e6913bd24013	882a6456-f762-11e1-a439-00145eb45e9a
20	20	0	GBIF Germany	4f6826f2-4ff6-443d-b966-e6913bd24013	8897c906-f762-11e1-a439-00145eb45e9a
0	3	3	Plazi	ffb07bec-2d10-492d-9c37-361fe0b79427	88ecdd06-5707-43d7-ad58-afff6f774383
0	201	201	Netherlands Biodiversity Information Facility	0909d601-bda2-42df-9e63-a6d51847ebce	88f53416-456f-4a4e-a343-c880cb328554
79	79	0	GBIF Germany	4f6826f2-4ff6-443d-b966-e6913bd24013	89d3f920-f762-11e1-a439-00145eb45e9a
245	245	0	GBIF Germany	4f6826f2-4ff6-443d-b966-e6913bd24013	8a4086da-f762-11e1-a439-00145eb45e9a
487	487	0	GBIF Germany	4f6826f2-4ff6-443d-b966-e6913bd24013	8be7baa8-f762-11e1-a439-00145eb45e9a
10	10	0	GBIF Germany	4f6826f2-4ff6-443d-b966-e6913bd24013	8c1b2b22-f762-11e1-a439-00145eb45e9a
18	18	0	GBIF Germany	4f6826f2-4ff6-443d-b966-e6913bd24013	8c8a4048-f762-11e1-a439-00145eb45e9a
894	611	-283	GBIF Germany	4f6826f2-4ff6-443d-b966-e6913bd24013	8e623a71-c549-4746-8a22-7a1496d5e86b
59	57	-2	GBIF Germany	4f6826f2-4ff6-443d-b966-e6913bd24013	8eb20fd6-f762-11e1-a439-00145eb45e9a
356	273	-83	GBIF Germany	4f6826f2-4ff6-443d-b966-e6913bd24013	8ebc11de-f762-11e1-a439-00145eb45e9a
223	100	-123	GBIF Germany	4f6826f2-4ff6-443d-b966-e6913bd24013	901745e4-f762-11e1-a439-00145eb45e9a
7	3	-4	GBIF Germany	4f6826f2-4ff6-443d-b966-e6913bd24013	908124c8-f762-11e1-a439-00145eb45e9a
303	210	-93	GBIF Germany	4f6826f2-4ff6-443d-b966-e6913bd24013	93165398-f762-11e1-a439-00145eb45e9a
0	4	4	Plazi	ffb07bec-2d10-492d-9c37-361fe0b79427	933fd9a4-b3c3-4791-a866-1a24fbaf6113
15	15	0	Plazi	ffb07bec-2d10-492d-9c37-361fe0b79427	953d63bf-63b2-4b9c-80f4-ad4816c29535
95059	113059	18000	GBIF Japan	db5705aa-6a6e-42f1-8942-d77b9f4896ea	96054000-f762-11e1-a439-00145eb45e9a
173	173	0	GBIF Germany	4f6826f2-4ff6-443d-b966-e6913bd24013	960f5d88-f762-11e1-a439-00145eb45e9a
1924	1924	0	GBIF Spain	1f94b3ca-9345-4d65-afe2-4bace93aa0fe	96bb21c2-f762-11e1-a439-00145eb45e9a
3	3	0	Plazi	ffb07bec-2d10-492d-9c37-361fe0b79427	992e0685-5956-43c7-966c-6cde1fe009af
126	126	0	Plazi	ffb07bec-2d10-492d-9c37-361fe0b79427	9b676605-0afb-4d17-a686-03c1c38b0da7
5	5	0	Plazi	ffb07bec-2d10-492d-9c37-361fe0b79427	9c539f3d-66f3-4396-aecb-1321865ba317
517	517	0	Colombian Biodiversity Information System	7e865cba-7c46-417b-ade5-97f2cf5b7be0	a047c140-1b16-41e0-9683-56c45a39c67e
2895	2895	0	Biodiversity Information System of Mexico	b324e8e9-9a4c-44fa-8f1a-7f39ea7ab576	a36e8f08-6c2a-4a0c-9b6b-b200250704f2
0	53	53	Plazi	ffb07bec-2d10-492d-9c37-361fe0b79427	a4981d7e-ecf0-47ae-a912-a2ec0bbd3139
1236	1236	0	Polish Biodiversity Information Network	2618bfdf-e194-4911-a241-80db3107bc51	a6517a30-13a6-11de-b2de-b8a03c50a862
70	70	0	Plazi	ffb07bec-2d10-492d-9c37-361fe0b79427	aaed3fae-c58b-4001-8faf-28cbc1ec5093
7721	26350	18629	National Biodiversity Data Centre	422b00b2-6c94-4bb6-976b-c359916efdb8	ac1e3e54-91e1-4f34-9b3f-7cd7d37ec0d6
0	6	6	Plazi	ffb07bec-2d10-492d-9c37-361fe0b79427	af1563dd-f9bc-490a-a39b-1e23757e0e7b
8	8	0	Plazi	ffb07bec-2d10-492d-9c37-361fe0b79427	b058eec5-7ce2-4a02-a228-7a5068db97ed
1102	1102	0	Colombian Biodiversity Information System	7e865cba-7c46-417b-ade5-97f2cf5b7be0	b1907aa0-00b4-4e42-9ae3-d1640927fa91
0	40	40	Ocean Biodiversity Information System	ba0670b9-4186-41e6-8e70-f9cb3065551a	b491843f-365b-49c7-bf71-204fbcdf7283
76	76	0	GBIF Brazil	cdc9736d-5ff7-4ece-9959-3c744360cdb3	b4cbb84b-84a8-4274-8fc4-6d745041d849
8391	8391	0	GBIF Sweden	a0b3be64-6525-4387-ac67-a499950f92e1	b7ef1d60-b0a0-11dd-aa14-b8a03c50a862
65	65	0	Colombian Biodiversity Information System	7e865cba-7c46-417b-ade5-97f2cf5b7be0	b8ba31ce-a95a-4a83-9469-c781e47abdd5
245	245	0	Belgian Biodiversity Platform	fb11cfe1-ebc3-45af-9159-17d9fddbcdac	b8d15ca7-726b-4a21-badb-097203f6db11
435474	548965	113491	GBIF Finland	dd514216-5c7c-45f3-910d-797424cb5be6	ba19fc1d-670c-426b-b99d-49f003792ac4
8	8	0	Plazi	ffb07bec-2d10-492d-9c37-361fe0b79427	bd8705a7-534c-40d2-a157-1acb8698a467
8957	8957	0	Biodiversity Information System of Mexico	b324e8e9-9a4c-44fa-8f1a-7f39ea7ab576	bdad918c-470b-4c4e-a146-6a39caacf989
1319	1319	0	National Biodiversity Network	d897a5b9-35ee-4232-94bd-b0bcaac003c2	bedf70a2-66a8-406d-a163-faf164215cf7
2378	2378	0	Participant Node Managers Committee	7f48e0c8-5c96-49ec-b972-30748e339115	c47e7a5b-692d-4e26-a32f-74b0188eb594
31	31	0	Plazi	ffb07bec-2d10-492d-9c37-361fe0b79427	c56b52d2-7116-4c12-999e-208038832eb8
0	13	13	Plazi	ffb07bec-2d10-492d-9c37-361fe0b79427	c75ec49f-fb11-4a2f-a5c2-a5e702dae99a
1999	1999	0	Ocean Biodiversity Information System	ba0670b9-4186-41e6-8e70-f9cb3065551a	ca8b71cb-8723-4f30-9810-2144450514c4
0	14	14	Plazi	ffb07bec-2d10-492d-9c37-361fe0b79427	cc547908-f4ee-4df9-b5bb-e58346030641
7328	7328	0	National Biodiversity Network	d897a5b9-35ee-4232-94bd-b0bcaac003c2	cce01da5-fba8-4fd9-ad28-ec7a82e14f31
40246	40246	0	GBIF Brazil	cdc9736d-5ff7-4ece-9959-3c744360cdb3	cde44dc3-3b14-49d9-840b-5073d5284e9e
5579	2815	-2764	Biodiversity Information System of Mexico	b324e8e9-9a4c-44fa-8f1a-7f39ea7ab576	d0d734c0-14f5-4f70-b915-5740cce60b07
3743	3743	0	GBIF France	da44cd31-5901-4687-a106-6d1c7734ee3a	d42d4718-b438-4565-aae5-6dd0dbdeff42
0	5	5	Plazi	ffb07bec-2d10-492d-9c37-361fe0b79427	d4c00e4d-4c3c-4d69-b8a6-3207a7351570
0	2	2	Plazi	ffb07bec-2d10-492d-9c37-361fe0b79427	d72c895f-f1d9-4171-b195-ffcdc7c35e9d
865	865	0	GBIF France	da44cd31-5901-4687-a106-6d1c7734ee3a	d8985124-0c96-4c95-9dcb-b7615bf96b1c
0	4654	4654	GBIF Benin	efb9c00e-f802-45dd-8826-a52ec45b89ff	da4c6e2e-923e-4c40-8aa4-7b52c41e90f7
1592	1592	0	GBIF France	da44cd31-5901-4687-a106-6d1c7734ee3a	dac6cf67-1c74-4b1f-abd9-169948c0a41d
781	1443	662	National Biodiversity Network	d897a5b9-35ee-4232-94bd-b0bcaac003c2	dce533af-6a50-4d6b-900b-7c60fb709559
939	939	0	GBIF France	da44cd31-5901-4687-a106-6d1c7734ee3a	e37e9e11-3e6b-49b6-89d6-7e62f48bdab1
10	10	0	Plazi	ffb07bec-2d10-492d-9c37-361fe0b79427	e40b6b52-d4a5-4900-aa8d-0fb759982e54
0	84	84	Ocean Biodiversity Information System	ba0670b9-4186-41e6-8e70-f9cb3065551a	e486afbd-3e08-48e1-a996-7e8d4db9b012
3	3	0	Plazi	ffb07bec-2d10-492d-9c37-361fe0b79427	e5164349-3dfb-491f-ae2a-af56edc829f0
6	6	0	Plazi	ffb07bec-2d10-492d-9c37-361fe0b79427	e6ab3306-5aea-483b-990a-050eb01c1acf
7	7	0	Plazi	ffb07bec-2d10-492d-9c37-361fe0b79427	ed19bdba-db4a-4caa-98ea-75450b624e21
2	2	0	Plazi	ffb07bec-2d10-492d-9c37-361fe0b79427	ee9eca00-798b-4b2c-8ee6-39ac472e450e
2699	2699	0	Participant Node Managers Committee	7f48e0c8-5c96-49ec-b972-30748e339115	f18fc494-4700-4c2a-ab27-16ecabed7806
1484	1484	0	GBIF France	da44cd31-5901-4687-a106-6d1c7734ee3a	f2cd661a-08d0-48fc-b96a-7e6f7a798df8
9	9	0	Participant Node Managers Committee	7f48e0c8-5c96-49ec-b972-30748e339115	f4a96009-f2f3-42d7-917c-8746096a69ee
1	1	0	Plazi	ffb07bec-2d10-492d-9c37-361fe0b79427	fb60dcdf-0479-435d-b911-6632aeed98d1
399	399	0	GBIF France	da44cd31-5901-4687-a106-6d1c7734ee3a	fb69e2bf-dfd0-460f-8709-7f4a3feadf07
119024	119024	0	GBIF Spain	1f94b3ca-9345-4d65-afe2-4bace93aa0fe	fb7d56ee-11aa-454f-8542-89e2ce0fa976
27	27	0	Colombian Biodiversity Information System	7e865cba-7c46-417b-ade5-97f2cf5b7be0	fbe39c56-2d0d-4d58-8d44-68c661044f24
64	64	0	Plazi	ffb07bec-2d10-492d-9c37-361fe0b79427	fdd9bfb7-b663-48a4-bb92-9842a8820d64
23	23	0	Plazi	ffb07bec-2d10-492d-9c37-361fe0b79427	01ef7a56-a2ba-4493-9182-a0ca2f9a32d2
3379	1417	-1962	GBIF Germany	4f6826f2-4ff6-443d-b966-e6913bd24013	02e39512-ccc8-4e30-aa5a-8e86b8952116
6060	6060	0	GBIF Argentina	2426a871-9feb-40a1-96c6-0c593a76b835	054ededa-61a6-4f83-85de-553d85a79ae1
0	473172	473172	National Biodiversity Network	d897a5b9-35ee-4232-94bd-b0bcaac003c2	0a013f89-5381-4578-9d82-5f28fd5f1ef6
11	11	0	Plazi	ffb07bec-2d10-492d-9c37-361fe0b79427	0a28c033-9ee8-448d-9696-949cf9a66832
2	2	0	Plazi	ffb07bec-2d10-492d-9c37-361fe0b79427	0d3456bf-150b-4cd2-ae80-e050a4852458
1872	1872	0	GBIF France	da44cd31-5901-4687-a106-6d1c7734ee3a	0d7413fd-1cdb-4435-b3c0-dc1218cc19ee
240252	240810	558	U.S. Geological Survey	8618c64a-93e0-4300-b546-7249e5148ed2	0daed095-478a-4af6-abf5-18acb790fbb2
111	111	0	Plazi	ffb07bec-2d10-492d-9c37-361fe0b79427	0e26b0d8-14bc-46b2-aac6-feed5d62b2d8
9702	9702	0	GBIF France	da44cd31-5901-4687-a106-6d1c7734ee3a	0eca5dd3-55ec-4c0e-ba89-972b40786343
388	388	0	GBIF France	da44cd31-5901-4687-a106-6d1c7734ee3a	0f925245-6ac9-4efb-b40f-0f89bf45e039
0	5	5	Plazi	ffb07bec-2d10-492d-9c37-361fe0b79427	10f10e00-d467-4320-b181-e4a1d63bb5a1
34	34	0	Plazi	ffb07bec-2d10-492d-9c37-361fe0b79427	11db72da-afa5-40db-ac32-481b9ec85a61
205	205	0	GBIF Finland	dd514216-5c7c-45f3-910d-797424cb5be6	190be3b4-e7fd-45b0-a6ba-c593eb688782
0	7	7	Ocean Biodiversity Information System	ba0670b9-4186-41e6-8e70-f9cb3065551a	1942ac26-3e00-4428-adc9-7bd4c424e0fb
8	8	0	Plazi	ffb07bec-2d10-492d-9c37-361fe0b79427	1af12ffa-1927-4450-99ef-0b4aff761baf
163	163	0	GBIF France	da44cd31-5901-4687-a106-6d1c7734ee3a	1c89d715-b0cf-4d5b-9e41-1a5afd73fe16
2	2	0	Plazi	ffb07bec-2d10-492d-9c37-361fe0b79427	1ff2d63e-6658-4645-8583-c901b133ddff
0	4	4	Plazi	ffb07bec-2d10-492d-9c37-361fe0b79427	20e9fca4-d11b-4f5e-b0aa-40ffd6edd0a1
84	84	0	Biodiversity Information System of Mexico	b324e8e9-9a4c-44fa-8f1a-7f39ea7ab576	234dff5f-bdfb-4385-98da-efa701689f09
33	33	0	Plazi	ffb07bec-2d10-492d-9c37-361fe0b79427	2799d706-42b3-4f91-913e-f9946c6672a4
2337	2337	0	GBIF Benin	efb9c00e-f802-45dd-8826-a52ec45b89ff	27f86b34-76dc-485d-a833-b158c6d79bf4
0	57	57	Plazi	ffb07bec-2d10-492d-9c37-361fe0b79427	281c9017-f55b-47bf-bea0-e511a7173605
367	367	0	GBIF France	da44cd31-5901-4687-a106-6d1c7734ee3a	2b977fd8-deb9-4a46-8432-c5770224980e
7	7	0	Indonesian Biodiversity Information Facility	2ebd91f6-f14f-4375-b525-c011a3774f03	2ce88946-0fb0-413a-b513-e87d735a0e29
3396	3396	0	National Biodiversity Network	d897a5b9-35ee-4232-94bd-b0bcaac003c2	320c348b-7470-4ef2-9e0a-36d4a527b7b3
90	90	0	Plazi	ffb07bec-2d10-492d-9c37-361fe0b79427	32b3202c-4ae3-4f7a-a0e5-b51cf2091097
1415900	1415900	0	Atlas of Living Australia	4a6f1b71-969e-4fc5-a693-282b05e1220c	358fbd61-739f-4102-afc9-9d468f571e4d
124	124	0	Plazi	ffb07bec-2d10-492d-9c37-361fe0b79427	36ada575-2ba9-4ce5-a53f-22662f764c76
0	2	2	Plazi	ffb07bec-2d10-492d-9c37-361fe0b79427	3d25137e-959e-4b79-bc0c-2db2f500ffcd
114823	148784	33961	National Biodiversity Network	d897a5b9-35ee-4232-94bd-b0bcaac003c2	3de01c29-b3d4-4eeb-bd5c-b2bb475566cc
3276500	3276500	0	Costa Rica Biodiversity Facility	3379bb09-1a58-41e7-9c57-e3b66c3eb5a0	3e9817c1-8302-4955-87e3-a408db0ea379
202	202	0	Colombian Biodiversity Information System	7e865cba-7c46-417b-ade5-97f2cf5b7be0	3f23233a-953f-40e2-b9fd-fae3eb326d74
8565	8565	0	Biodiversity Information System of Mexico	b324e8e9-9a4c-44fa-8f1a-7f39ea7ab576	3f4a64aa-dc08-4e07-8e5c-91c09dc8b6f7
0	2	2	Plazi	ffb07bec-2d10-492d-9c37-361fe0b79427	4017a03d-0516-45cb-86f3-88f395927dfc
2924	2064	-860	GBIF Germany	4f6826f2-4ff6-443d-b966-e6913bd24013	43b38da9-9b82-4696-a53b-200b85d813e8
0	2	2	Plazi	ffb07bec-2d10-492d-9c37-361fe0b79427	46f88908-07de-464d-a0ba-49282157b328
404	404	0	GBIF Germany	4f6826f2-4ff6-443d-b966-e6913bd24013	47270ce5-8807-4c99-af82-09878e9adb0d
24	24	0	Plazi	ffb07bec-2d10-492d-9c37-361fe0b79427	497df965-0e55-4236-8213-78dcf6dab5df
0	1	1	Ocean Biodiversity Information System	ba0670b9-4186-41e6-8e70-f9cb3065551a	4b8c7dd1-2e5f-443e-9df6-647e11afc0ff
320	280	-40	GBIF Germany	4f6826f2-4ff6-443d-b966-e6913bd24013	4e79f721-48ad-4205-9b37-ce8bc3a96236
385	385	0	GBIF Germany	4f6826f2-4ff6-443d-b966-e6913bd24013	50a55939-9b15-45b8-b28d-5370f86fa4d2
17	17	0	National Biodiversity Network	d897a5b9-35ee-4232-94bd-b0bcaac003c2	50d07dd9-6b13-4aeb-a970-491dd9cd4fee
3412	3412	0	Atlas of Living Australia	4a6f1b71-969e-4fc5-a693-282b05e1220c	52faffcb-cc8d-42d1-b6a0-2d0cb3fc5efa
0	6	6	Plazi	ffb07bec-2d10-492d-9c37-361fe0b79427	538966cc-0a2a-4a4c-8269-64e189aaa6c6
0	60	60	Plazi	ffb07bec-2d10-492d-9c37-361fe0b79427	54637182-8d50-4ef3-ad88-e3ee10f3d4cd
32	32	0	Plazi	ffb07bec-2d10-492d-9c37-361fe0b79427	547f83b3-4f25-4ace-ab43-bf66fbc06e9e
1004	1004	0	Colombian Biodiversity Information System	7e865cba-7c46-417b-ade5-97f2cf5b7be0	54fd51e3-e9c0-4f27-9a02-ebeec764c6f9
0	19887	19887	Participant Node Managers Committee	7f48e0c8-5c96-49ec-b972-30748e339115	56687a3d-b48f-44e5-b2b8-d55bafff2f33
1	1	0	Plazi	ffb07bec-2d10-492d-9c37-361fe0b79427	5828a520-1f47-4e2f-88aa-a35c55b20456
9	9	0	GBIF France	da44cd31-5901-4687-a106-6d1c7734ee3a	5888c533-f265-41c3-9078-bf0630ef4aa7
4268	4268	0	GBIF Argentina	2426a871-9feb-40a1-96c6-0c593a76b835	59392e0a-e20b-43b5-a9b4-dc81c393ff68
7	7	0	Plazi	ffb07bec-2d10-492d-9c37-361fe0b79427	5f17416e-6948-4003-8f66-129a3c2fa328
7	7	0	Plazi	ffb07bec-2d10-492d-9c37-361fe0b79427	5fc13647-f73b-4722-bdf7-271c5c643bd1
83	83	0	GBIF Germany	4f6826f2-4ff6-443d-b966-e6913bd24013	6147ea20-f762-11e1-a439-00145eb45e9a
29	29	0	GBIF Germany	4f6826f2-4ff6-443d-b966-e6913bd24013	6301f0cc-f762-11e1-a439-00145eb45e9a
7	7	0	Plazi	ffb07bec-2d10-492d-9c37-361fe0b79427	63d2151d-fe20-43df-94e8-2bbcbd97242a
192	192	0	GBIF Germany	4f6826f2-4ff6-443d-b966-e6913bd24013	642f5c46-f762-11e1-a439-00145eb45e9a
76	76	0	GBIF Germany	4f6826f2-4ff6-443d-b966-e6913bd24013	64415b80-f762-11e1-a439-00145eb45e9a
1234	1234	0	GBIF Germany	4f6826f2-4ff6-443d-b966-e6913bd24013	6570a5e2-f762-11e1-a439-00145eb45e9a
1337	1337	0	GBIF France	da44cd31-5901-4687-a106-6d1c7734ee3a	65b032af-4e0f-49a7-b6bc-909685aa4d95
1770	1770	0	U.S. Geological Survey	8618c64a-93e0-4300-b546-7249e5148ed2	65b917b5-fa35-4a4e-8f89-857eea810033
123	78	-45	GBIF Germany	4f6826f2-4ff6-443d-b966-e6913bd24013	660472b8-f762-11e1-a439-00145eb45e9a
99	99	0	GBIF Germany	4f6826f2-4ff6-443d-b966-e6913bd24013	688c3bce-f762-11e1-a439-00145eb45e9a
91	49	-42	GBIF Germany	4f6826f2-4ff6-443d-b966-e6913bd24013	68e1c724-f762-11e1-a439-00145eb45e9a
192	192	0	GBIF Germany	4f6826f2-4ff6-443d-b966-e6913bd24013	6950f694-f762-11e1-a439-00145eb45e9a
53	53	0	GBIF Germany	4f6826f2-4ff6-443d-b966-e6913bd24013	6991a54a-f762-11e1-a439-00145eb45e9a
33568	33568	0	Atlas of Living Australia	4a6f1b71-969e-4fc5-a693-282b05e1220c	6d4427fc-932b-4814-b323-ee7980788f3b
35	35	0	GBIF Germany	4f6826f2-4ff6-443d-b966-e6913bd24013	6d49495e-f762-11e1-a439-00145eb45e9a
7	7	0	GBIF Germany	4f6826f2-4ff6-443d-b966-e6913bd24013	6f8b7638-f762-11e1-a439-00145eb45e9a
4	4	0	GBIF Germany	4f6826f2-4ff6-443d-b966-e6913bd24013	6f91c6f0-f762-11e1-a439-00145eb45e9a
234	234	0	GBIF Germany	4f6826f2-4ff6-443d-b966-e6913bd24013	714057aa-f762-11e1-a439-00145eb45e9a
80	80	0	GBIF Germany	4f6826f2-4ff6-443d-b966-e6913bd24013	71855b7a-f762-11e1-a439-00145eb45e9a
95	95	0	Colombian Biodiversity Information System	7e865cba-7c46-417b-ade5-97f2cf5b7be0	7199e413-5901-44dc-9bae-82f5172e7b31
3455	3455	0	National Biodiversity Network	d897a5b9-35ee-4232-94bd-b0bcaac003c2	7234b3a2-037e-4df5-97ce-605ff53dfb1b
110	110	0	Plazi	ffb07bec-2d10-492d-9c37-361fe0b79427	72c56097-337c-42fa-90ee-2da90529b2d2
0	46	46	Plazi	ffb07bec-2d10-492d-9c37-361fe0b79427	7399d769-249a-47c9-b099-719ecd66851c
393	393	0	GBIF Germany	4f6826f2-4ff6-443d-b966-e6913bd24013	740c3102-f762-11e1-a439-00145eb45e9a
34	34	0	GBIF Germany	4f6826f2-4ff6-443d-b966-e6913bd24013	755047ec-f762-11e1-a439-00145eb45e9a
353	353	0	GBIF Germany	4f6826f2-4ff6-443d-b966-e6913bd24013	75aa1092-f762-11e1-a439-00145eb45e9a
11661	14656	2995	National Biodiversity Network	d897a5b9-35ee-4232-94bd-b0bcaac003c2	772d950d-2cf5-491e-bf31-b670e372b3fc
10	10	0	GBIF France	da44cd31-5901-4687-a106-6d1c7734ee3a	7810a75e-afc5-454e-a8c0-e1945f98f1f7
671	613	-58	GBIF Germany	4f6826f2-4ff6-443d-b966-e6913bd24013	7977da9c-f762-11e1-a439-00145eb45e9a
488	381	-107	GBIF Germany	4f6826f2-4ff6-443d-b966-e6913bd24013	79878b5e-f762-11e1-a439-00145eb45e9a
719	719	0	GBIF Germany	4f6826f2-4ff6-443d-b966-e6913bd24013	7eabf57a-f762-11e1-a439-00145eb45e9a
20995	21164	169	U.S. Geological Survey	8618c64a-93e0-4300-b546-7249e5148ed2	7eae038e-7a8e-492e-a4dc-43238cce7c52
708	708	0	Atlas of Living Australia	4a6f1b71-969e-4fc5-a693-282b05e1220c	7f5da78e-f762-11e1-a439-00145eb45e9a
296	216	-80	GBIF Germany	4f6826f2-4ff6-443d-b966-e6913bd24013	81d7ca76-f762-11e1-a439-00145eb45e9a
1830	1830	0	GBIF Germany	4f6826f2-4ff6-443d-b966-e6913bd24013	81fbd3e4-f762-11e1-a439-00145eb45e9a
2569	2569	0	GBIF Norway	4f829580-180d-46a9-9c87-ed8ec959b545	8287097d-cec6-4103-b23e-fb5374b1ee06
197	197	0	GBIF Spain	1f94b3ca-9345-4d65-afe2-4bace93aa0fe	8370042a-f762-11e1-a439-00145eb45e9a
588	588	0	Ocean Biodiversity Information System	ba0670b9-4186-41e6-8e70-f9cb3065551a	83fb5688-f762-11e1-a439-00145eb45e9a
609	453	-156	GBIF Germany	4f6826f2-4ff6-443d-b966-e6913bd24013	87f25868-f762-11e1-a439-00145eb45e9a
386	342	-44	GBIF Germany	4f6826f2-4ff6-443d-b966-e6913bd24013	884311f4-f762-11e1-a439-00145eb45e9a
2762	2762	0	Atlas of Living Australia	4a6f1b71-969e-4fc5-a693-282b05e1220c	895de76c-f762-11e1-a439-00145eb45e9a
149	149	0	GBIF Germany	4f6826f2-4ff6-443d-b966-e6913bd24013	8987bbdc-f762-11e1-a439-00145eb45e9a
93	93	0	GBIF Germany	4f6826f2-4ff6-443d-b966-e6913bd24013	8a4e1944-f762-11e1-a439-00145eb45e9a
8	5	-3	GBIF Germany	4f6826f2-4ff6-443d-b966-e6913bd24013	8cc2e97a-f762-11e1-a439-00145eb45e9a
0	475	475	Ocean Biodiversity Information System	ba0670b9-4186-41e6-8e70-f9cb3065551a	90c1a69a-0bc0-44ff-921b-66753ffdc8f2
618	561	-57	GBIF Germany	4f6826f2-4ff6-443d-b966-e6913bd24013	91660868-f762-11e1-a439-00145eb45e9a
53	53	0	GBIF Germany	4f6826f2-4ff6-443d-b966-e6913bd24013	932be1ae-f762-11e1-a439-00145eb45e9a
2499	2499	0	GBIF Germany	4f6826f2-4ff6-443d-b966-e6913bd24013	940d1c1e-f762-11e1-a439-00145eb45e9a
0	3	3	Plazi	ffb07bec-2d10-492d-9c37-361fe0b79427	94bcd2bf-87b9-4cde-a199-590859adc433
1	1	0	Plazi	ffb07bec-2d10-492d-9c37-361fe0b79427	95c92a35-4d40-4927-9b07-f3412606ba0b
45	45	0	GBIF Germany	4f6826f2-4ff6-443d-b966-e6913bd24013	9678447e-f762-11e1-a439-00145eb45e9a
0	8469	8469	Ocean Biodiversity Information System	ba0670b9-4186-41e6-8e70-f9cb3065551a	97a775fe-7e13-43bc-a6de-af9218b1dd93
15	15	0	National Biodiversity Network	d897a5b9-35ee-4232-94bd-b0bcaac003c2	9918369a-8cca-48b2-8684-3c434ca003ee
0	1	1	Plazi	ffb07bec-2d10-492d-9c37-361fe0b79427	9a99c973-7d53-4103-a955-f467ab2a7f8d
678	678	0	GBIF Norway	4f829580-180d-46a9-9c87-ed8ec959b545	9b914050-4a8e-45c0-b66d-ed0073e8b962
333	333	0	GBIF Argentina	2426a871-9feb-40a1-96c6-0c593a76b835	9f5d94c9-d440-48bf-86ae-9236070e83ec
1	1	0	Plazi	ffb07bec-2d10-492d-9c37-361fe0b79427	a381190d-7f50-4a66-bc33-3a0417c9f89f
5011	5011	0	Colombian Biodiversity Information System	7e865cba-7c46-417b-ade5-97f2cf5b7be0	a3fc724a-3055-40e6-82d1-7a44531ddff7
14248	14248	0	Biodiversity Information System of Mexico	b324e8e9-9a4c-44fa-8f1a-7f39ea7ab576	a4b86c5c-0b93-4fe5-96e8-d1af3166d45f
107	107	0	Plazi	ffb07bec-2d10-492d-9c37-361fe0b79427	a6cd54a1-9476-4ba4-9a29-6362590d223b
0	28	28	Ocean Biodiversity Information System	ba0670b9-4186-41e6-8e70-f9cb3065551a	a9b174f6-6792-44c3-b5d0-ff83f6c938bc
163	163	0	GBIF France	da44cd31-5901-4687-a106-6d1c7734ee3a	aa6757bf-590c-4cc5-a4d2-28ab50db7d7d
0	106	106	Ocean Biodiversity Information System	ba0670b9-4186-41e6-8e70-f9cb3065551a	aa7793b6-2f8b-4fc8-9ba6-7628f39aa7b2
673	673	0	GBIF Portugal	673f7038-4262-4149-b753-5658a4e912f6	ae52efd5-bfd4-4a81-ba12-813cace064f3
20	20	0	Plazi	ffb07bec-2d10-492d-9c37-361fe0b79427	af246500-837b-4269-8281-55466c5712e4
27	27	0	Plazi	ffb07bec-2d10-492d-9c37-361fe0b79427	af30d3ad-9481-430d-8d1f-08a63286281e
2	2	0	Plazi	ffb07bec-2d10-492d-9c37-361fe0b79427	af6c2517-d7b6-406e-8753-08921e71e59f
0	350	350	Korean Biodiversity Information Facility	e0a1e772-0177-4800-94b4-2d023fe6cdf4	b083c935-e95b-4a9c-8be9-3693a5e0b169
1793	1793	0	Polish Biodiversity Information Network	2618bfdf-e194-4911-a241-80db3107bc51	b2f6c000-13d9-11de-b2e1-b8a03c50a862
0	816	816	Colombian Biodiversity Information System	7e865cba-7c46-417b-ade5-97f2cf5b7be0	b4531a7f-e7c3-4c1d-a50f-212c76fd28a1
14112	14151	39	Canada Biodiversity Information Facility	8f83fc96-c966-4126-83f7-bf044dc49efa	b50dfef4-3f34-4829-9d6e-edd5fcdb2b29
0	2	2	Plazi	ffb07bec-2d10-492d-9c37-361fe0b79427	bd560313-d209-472f-a88c-23468ed36289
8	8	0	Plazi	ffb07bec-2d10-492d-9c37-361fe0b79427	bd9add32-702b-495c-9ed7-7ed98fb4c591
94	94	0	GBIF Malawi	2a42e4d7-ad4a-41b3-84c4-de4aa7b74d35	bde0e0f7-d5e7-4448-a612-6f58ea29a6ce
3	3	0	Participant Node Managers Committee	7f48e0c8-5c96-49ec-b972-30748e339115	c0306ec4-6f34-44a5-8fef-687ed876468c
2	2	0	Plazi	ffb07bec-2d10-492d-9c37-361fe0b79427	c147d251-d362-415c-934f-bffe5e85000c
0	4	4	Plazi	ffb07bec-2d10-492d-9c37-361fe0b79427	c33d5e3d-6302-4bcc-aafa-346c1718ca7d
606769	1000000	393231	U.S. Geological Survey	8618c64a-93e0-4300-b546-7249e5148ed2	c3969d4c-b9c1-439a-96be-ebf369f17a0c
2	2	0	Plazi	ffb07bec-2d10-492d-9c37-361fe0b79427	c4552bac-95ab-4910-ab2f-44308a444419
2	2	0	Plazi	ffb07bec-2d10-492d-9c37-361fe0b79427	c4d6f0ff-fcb0-44ee-b707-5b770923595b
0	1	1	Plazi	ffb07bec-2d10-492d-9c37-361fe0b79427	c7c14281-ebc9-4d29-b695-0c2a1d76b26f
28	28	0	GBIF France	da44cd31-5901-4687-a106-6d1c7734ee3a	c7d9eb03-aa2f-4892-9dbc-c91932500a67
3	3	0	Plazi	ffb07bec-2d10-492d-9c37-361fe0b79427	ca0d653d-32de-4c75-a95d-d9a4690d6fda
0	170	170	Plazi	ffb07bec-2d10-492d-9c37-361fe0b79427	cd5b6613-ec78-4ed6-83ca-bf37b4eef08f
5761	5761	0	National Biodiversity Network	d897a5b9-35ee-4232-94bd-b0bcaac003c2	d765b95b-7ba5-4ec5-88da-506f6c6a7c14
1100	1100	0	GBIF Japan	db5705aa-6a6e-42f1-8942-d77b9f4896ea	d9ef4308-35e8-4b30-a375-7ece5f39f1d0
0	3	3	Plazi	ffb07bec-2d10-492d-9c37-361fe0b79427	dbe13bcd-3bce-48da-a2a4-7db3d91076f0
1706	1621	-85	Biodiversity Information System of Mexico	b324e8e9-9a4c-44fa-8f1a-7f39ea7ab576	e2af6d99-7387-43aa-bd04-7c579a9befa5
3682	3682	0	Biodiversity Information System of Mexico	b324e8e9-9a4c-44fa-8f1a-7f39ea7ab576	e731aee1-da7b-4c30-97bf-f7c27581a71d
171	171	0	Colombian Biodiversity Information System	7e865cba-7c46-417b-ade5-97f2cf5b7be0	e8ad1dc8-7faa-4fe9-9d3f-64d1a2fc895e
1	1	0	Plazi	ffb07bec-2d10-492d-9c37-361fe0b79427	e8be10df-8dc0-4423-82ad-9c0a67cac7a1
3	3	0	GBIF France	da44cd31-5901-4687-a106-6d1c7734ee3a	ec7c1bec-7d2c-4a51-85cd-88ba698c778b
4	4	0	GBIF France	da44cd31-5901-4687-a106-6d1c7734ee3a	ee342779-1209-4810-9d1f-886b4b9f68be
67	67	0	Plazi	ffb07bec-2d10-492d-9c37-361fe0b79427	eee4f7b2-d86b-4f6e-80f6-2a23766cb538
4159	4159	0	U.S. Geological Survey	8618c64a-93e0-4300-b546-7249e5148ed2	f02c0b41-17f4-429d-8e14-8efb9f01c780
13	13	0	Plazi	ffb07bec-2d10-492d-9c37-361fe0b79427	f139da0a-6d73-47d2-9bae-740d4e28927b
454794	1360095	905301	GBIF Estonia	2c11b821-d22b-4c64-8cd3-c1578173b129	f1c4df18-12d6-40cb-ab51-5bb0d7f08d6e
152	152	0	Biodiversity Information System of Mexico	b324e8e9-9a4c-44fa-8f1a-7f39ea7ab576	f25059a7-ccb0-4c2e-a0f0-73b1d1155ad3
21	21	0	Plazi	ffb07bec-2d10-492d-9c37-361fe0b79427	f2525d50-2621-4e8c-b3da-9cd4341ccb51
2436	2436	0	Atlas of Living Australia	4a6f1b71-969e-4fc5-a693-282b05e1220c	f885d3e2-0310-43f5-a902-50dda62e6a68
0	393	393	Colombian Biodiversity Information System	7e865cba-7c46-417b-ade5-97f2cf5b7be0	f99d248e-7a3e-4bdd-9286-09ba74cdc347
5	5	0	Plazi	ffb07bec-2d10-492d-9c37-361fe0b79427	fbeb92be-3725-4897-bfbf-969aba9f23a1
5452	5452	0	GBIF Benin	efb9c00e-f802-45dd-8826-a52ec45b89ff	fc313d17-3233-47e1-90ef-2609542dedd3
0	27	27	Ocean Biodiversity Information System	ba0670b9-4186-41e6-8e70-f9cb3065551a	fd6dabc0-ae95-4762-8bd0-f1b9a33ae204
0	713	713	Colombian Biodiversity Information System	7e865cba-7c46-417b-ade5-97f2cf5b7be0	fda6432b-5ab6-4569-8cb1-6409cce89b38
0	204	204	Plazi	ffb07bec-2d10-492d-9c37-361fe0b79427	fffc3d5c-425a-47ab-9bb5-c4e1e130ce3c
17715	18553	838	GBIF Brazil	cdc9736d-5ff7-4ece-9959-3c744360cdb3	fffdea53-c113-4cdc-896e-a9c5fd726591
924	917	-7	GBIF Japan	db5705aa-6a6e-42f1-8942-d77b9f4896ea	02cc981e-d1d8-4ea6-9db5-dfb73acca024
0	1	1	Plazi	ffb07bec-2d10-492d-9c37-361fe0b79427	03e2aa8b-e28f-427d-9be9-b311e591c2f0
898	898	0	GBIF Germany	4f6826f2-4ff6-443d-b966-e6913bd24013	045dae4c-7896-4575-83a8-332b6237e5b0
14	14	0	Plazi	ffb07bec-2d10-492d-9c37-361fe0b79427	07060c15-139e-413a-8b41-e123e4232696
0	14	14	Plazi	ffb07bec-2d10-492d-9c37-361fe0b79427	0a1792b3-9106-4113-91f0-9431b5257276
1208	1208	0	GBIF Kenya	2a44d626-9f7a-4120-8a7a-4ab5ac15ff2a	0a4b733a-6f2a-41a5-aeee-53249dd9b861
14866	14866	0	GBIF Japan	db5705aa-6a6e-42f1-8942-d77b9f4896ea	0ac88789-10f8-4a09-9f08-675043501d50
14	14	0	Plazi	ffb07bec-2d10-492d-9c37-361fe0b79427	0d838ca1-52f1-4278-895d-68fc481b7558
374	374	0	National Biodiversity Data Centre	422b00b2-6c94-4bb6-976b-c359916efdb8	0e988b71-2cc1-4cd3-a026-ef14c056b05c
1268	1268	0	Belgian Biodiversity Platform	fb11cfe1-ebc3-45af-9159-17d9fddbcdac	107b20cf-4fa5-4304-b6dd-8d75a5b646d0
0	15	15	Plazi	ffb07bec-2d10-492d-9c37-361fe0b79427	12eb5059-1f7f-4fe2-810f-b0c62c150058
208879	208880	1	National Biodiversity Network	d897a5b9-35ee-4232-94bd-b0bcaac003c2	14e259a2-7985-4001-b799-1dc177067ab1
0	24	24	Plazi	ffb07bec-2d10-492d-9c37-361fe0b79427	15dd5092-94fc-4800-8d17-c73125575cf3
0	76429	76429	Netherlands Biodiversity Information Facility	0909d601-bda2-42df-9e63-a6d51847ebce	17298ce5-235a-4da7-ae6f-bd6cd26282ab
0	16	16	Plazi	ffb07bec-2d10-492d-9c37-361fe0b79427	173bfd95-4bde-44b8-a5e1-134445c9899e
10	10	0	Plazi	ffb07bec-2d10-492d-9c37-361fe0b79427	19a6c218-3f99-4f09-96cc-bf839b3f29b8
3075	11683	8608	Colombian Biodiversity Information System	7e865cba-7c46-417b-ade5-97f2cf5b7be0	1ca5dd25-ba19-4e22-9890-2755c51ecc4b
3	3	0	Plazi	ffb07bec-2d10-492d-9c37-361fe0b79427	1d04d057-203d-4366-8940-4050e2a71fb0
10	10	0	Plazi	ffb07bec-2d10-492d-9c37-361fe0b79427	1ef27490-18ab-4bc4-a189-7d650a7c51f7
438	438	0	Ocean Biodiversity Information System	ba0670b9-4186-41e6-8e70-f9cb3065551a	24aa45a4-dc45-4138-98e0-513fbedb8344
37771	37771	0	GBIF Brazil	cdc9736d-5ff7-4ece-9959-3c744360cdb3	267f93fe-9f32-4770-909e-a751a1020957
0	4	4	Plazi	ffb07bec-2d10-492d-9c37-361fe0b79427	29f7002d-7875-405f-b17e-68f75e2f071e
56490	56490	0	Atlas of Living Australia	4a6f1b71-969e-4fc5-a693-282b05e1220c	2a796d4b-d12f-4806-876a-4fbb5e0a63ca
773	780	7	National Biodiversity Network	d897a5b9-35ee-4232-94bd-b0bcaac003c2	2d4e76d7-2283-43bb-8029-c6a414badfd8
0	16	16	Plazi	ffb07bec-2d10-492d-9c37-361fe0b79427	2ec1ae47-aedd-48ac-ab1e-b1de987a00e6
0	3683	3683	Biodiversity Information System of Mexico	b324e8e9-9a4c-44fa-8f1a-7f39ea7ab576	2efa80a5-2a1f-4e07-9788-7ab0172bf0fa
0	32	32	Plazi	ffb07bec-2d10-492d-9c37-361fe0b79427	30557468-7467-4c99-b6fc-806f4be784e4
14069	14069	0	Society for the Management of Electronic Biodiversity Data	97818ee4-1461-4180-bf1d-b3201050124f	3236cdc4-2f4d-4bd6-b53f-54fd8d8a0aa8
528	528	0	GBIF Spain	1f94b3ca-9345-4d65-afe2-4bace93aa0fe	33a1cfe1-4e4c-4da0-925b-d67df32d72e8
259	259	0	GBIF France	da44cd31-5901-4687-a106-6d1c7734ee3a	35bf60cf-8c2f-4b87-8103-1cdb866226af
44419	44768	349	Atlas of Living Australia	4a6f1b71-969e-4fc5-a693-282b05e1220c	35e8d7cb-256c-4470-b2e6-79adadc308c5
0	45	45	Plazi	ffb07bec-2d10-492d-9c37-361fe0b79427	375e7a97-d2f2-423f-abaf-f7a6cf4d6e23
10	10	0	ASEAN Centre for Biodiversity	af2a0fa1-4c8e-4bdc-8954-b1a55e32b0f1	38f5b100-b377-4643-8a06-819225142345
0	370334	370334	National Biodiversity Network	d897a5b9-35ee-4232-94bd-b0bcaac003c2	3965d122-ad7d-463e-90be-7eaa006bea18
113	113	0	GBIF France	da44cd31-5901-4687-a106-6d1c7734ee3a	3cc251d9-5e0d-488b-bbf4-b2ecc6dab986
2815	2815	0	GBIF Norway	4f829580-180d-46a9-9c87-ed8ec959b545	3cfef28e-0d7b-4e19-a592-15afd82bd6fb
1	1	0	Plazi	ffb07bec-2d10-492d-9c37-361fe0b79427	3e00a944-44df-4b5c-a5a2-fcbf2dc7e756
0	8	8	Plazi	ffb07bec-2d10-492d-9c37-361fe0b79427	3e510cff-3389-494b-935d-56b7ae125654
0	5	5	Plazi	ffb07bec-2d10-492d-9c37-361fe0b79427	3eec390d-5e25-49b9-815a-84b5343eaf2d
21572	21572	0	Colombian Biodiversity Information System	7e865cba-7c46-417b-ade5-97f2cf5b7be0	411e0de5-320c-4819-ac38-52cc6adb2ff1
5	5	0	Plazi	ffb07bec-2d10-492d-9c37-361fe0b79427	42460f28-a0e4-4036-a048-10b7dcfc321e
29	29	0	Plazi	ffb07bec-2d10-492d-9c37-361fe0b79427	426b4c7a-438a-4d23-97ce-3aae23459f0d
197	197	0	Belgian Biodiversity Platform	fb11cfe1-ebc3-45af-9159-17d9fddbcdac	4309a5ab-7050-4387-9abb-7dd497c96904
137	137	0	Secretariat of the Pacific Regional Environment Programme	29c6a139-ea7f-41f5-8d9b-c55af8736182	4492c92d-3675-43d9-a14c-1eada2dbe8f9
227	227	0	GBIF Germany	4f6826f2-4ff6-443d-b966-e6913bd24013	4621e6c1-0f6d-46a8-bd1f-33f3d7f11071
184	184	0	GBIF France	da44cd31-5901-4687-a106-6d1c7734ee3a	462efe4a-103b-4a4a-b229-c18bec5c9431
0	19	19	Participant Node Managers Committee	7f48e0c8-5c96-49ec-b972-30748e339115	479fc9f0-5b95-4c20-aca1-c1f752739376
136	136	0	GBIF France	da44cd31-5901-4687-a106-6d1c7734ee3a	47bb76d6-a72a-467b-8c0b-034da0d02098
80	80	0	Plazi	ffb07bec-2d10-492d-9c37-361fe0b79427	496b64db-ed0b-43a2-bb95-8e75fcf30a7b
0	47591	47591	Atlas of Living Australia	4a6f1b71-969e-4fc5-a693-282b05e1220c	4b519869-cc09-49a5-8df8-2d61db7701e1
0	34	34	Plazi	ffb07bec-2d10-492d-9c37-361fe0b79427	4bd3436d-7f5d-4e04-92c8-5a74ee5e90b4
44123	44123	0	GBIF Brazil	cdc9736d-5ff7-4ece-9959-3c744360cdb3	4bda7e86-c7c0-440e-bed4-bde6c52a28c2
2	2	0	Plazi	ffb07bec-2d10-492d-9c37-361fe0b79427	4d2cfbeb-c65b-4328-b549-18e105856021
0	86	86	Colombian Biodiversity Information System	7e865cba-7c46-417b-ade5-97f2cf5b7be0	4d456575-b001-4c60-b583-3dbf2520562a
0	603	603	Plazi	ffb07bec-2d10-492d-9c37-361fe0b79427	4dbe8eb4-2a5b-4c17-8735-4849b4137127
215	215	0	Plazi	ffb07bec-2d10-492d-9c37-361fe0b79427	4ea5bf04-d609-4607-921f-701cdc5a2fd8
12793	20793	8000	GBIF Japan	db5705aa-6a6e-42f1-8942-d77b9f4896ea	5279e5e6-a368-43e6-8a3b-4f6bfff7753d
47	47	0	Plazi	ffb07bec-2d10-492d-9c37-361fe0b79427	540d050b-de90-4176-9b1f-034ad19eecba
106	106	0	GBIF Finland	dd514216-5c7c-45f3-910d-797424cb5be6	54dc30de-a2b4-45d7-9b3b-d3e273d9c17c
17	17	0	Ocean Biodiversity Information System	ba0670b9-4186-41e6-8e70-f9cb3065551a	57835641-1a48-49b9-8486-0d798f03d869
3	3	0	Plazi	ffb07bec-2d10-492d-9c37-361fe0b79427	598aeffb-d5ed-4fb8-bcd3-4920a0d735ab
1447	1447	0	Belgian Biodiversity Platform	fb11cfe1-ebc3-45af-9159-17d9fddbcdac	5a88d862-075a-4bcd-a726-c4f9cf58cf5f
49	49	0	Ocean Biodiversity Information System	ba0670b9-4186-41e6-8e70-f9cb3065551a	5dde9cca-4cb9-41e6-9dbf-f50861d65f83
4	4	0	Plazi	ffb07bec-2d10-492d-9c37-361fe0b79427	5e2cbe92-3130-45c1-8961-54ead97211a6
0	8	8	Plazi	ffb07bec-2d10-492d-9c37-361fe0b79427	5f46f8dc-d585-4b31-9582-31a5bbb6d062
5450	5450	0	GBIF France	da44cd31-5901-4687-a106-6d1c7734ee3a	5fbfc32a-2eee-4bdd-8ca4-e6fca275a7a8
109	109	0	GBIF Germany	4f6826f2-4ff6-443d-b966-e6913bd24013	6117ff72-f762-11e1-a439-00145eb45e9a
100	100	0	GBIF Germany	4f6826f2-4ff6-443d-b966-e6913bd24013	614c6f96-f762-11e1-a439-00145eb45e9a
39	39	0	GBIF Germany	4f6826f2-4ff6-443d-b966-e6913bd24013	6258c984-f762-11e1-a439-00145eb45e9a
24	24	0	GBIF Germany	4f6826f2-4ff6-443d-b966-e6913bd24013	629af58e-f762-11e1-a439-00145eb45e9a
51	51	0	GBIF Germany	4f6826f2-4ff6-443d-b966-e6913bd24013	62bf2df0-f762-11e1-a439-00145eb45e9a
5	5	0	Plazi	ffb07bec-2d10-492d-9c37-361fe0b79427	62f2b02b-0532-4959-b320-8be0868a8207
24469	24469	0	GBIF Spain	1f94b3ca-9345-4d65-afe2-4bace93aa0fe	635e4476-f762-11e1-a439-00145eb45e9a
52	52	0	GBIF Germany	4f6826f2-4ff6-443d-b966-e6913bd24013	637a826c-f762-11e1-a439-00145eb45e9a
0	21	21	Plazi	ffb07bec-2d10-492d-9c37-361fe0b79427	640aac64-3963-4435-8e04-7af89edd428b
214	214	0	GBIF Germany	4f6826f2-4ff6-443d-b966-e6913bd24013	6430b122-f762-11e1-a439-00145eb45e9a
1	1	0	GBIF Germany	4f6826f2-4ff6-443d-b966-e6913bd24013	649fba40-f762-11e1-a439-00145eb45e9a
569	565	-4	GBIF Germany	4f6826f2-4ff6-443d-b966-e6913bd24013	6571cb34-f762-11e1-a439-00145eb45e9a
0	1	1	Plazi	ffb07bec-2d10-492d-9c37-361fe0b79427	6612509e-1ab6-44f8-8435-b979fdffda40
130	130	0	GBIF Germany	4f6826f2-4ff6-443d-b966-e6913bd24013	67dcde5e-f762-11e1-a439-00145eb45e9a
49	49	0	GBIF Germany	4f6826f2-4ff6-443d-b966-e6913bd24013	67eb072c-f762-11e1-a439-00145eb45e9a
25	25	0	Plazi	ffb07bec-2d10-492d-9c37-361fe0b79427	68c1d18b-6538-4c9a-841d-b5d66ce216e9
66	66	0	Atlas of Living Australia	4a6f1b71-969e-4fc5-a693-282b05e1220c	6943fd00-8381-4dd8-a39a-3ba9851e92a2
146	69	-77	GBIF Germany	4f6826f2-4ff6-443d-b966-e6913bd24013	69f83350-f762-11e1-a439-00145eb45e9a
10345	8189	-2156	GBIF Germany	4f6826f2-4ff6-443d-b966-e6913bd24013	69fd59a2-f762-11e1-a439-00145eb45e9a
491	491	0	GBIF Germany	4f6826f2-4ff6-443d-b966-e6913bd24013	6a75ea7a-f762-11e1-a439-00145eb45e9a
49	49	0	GBIF Germany	4f6826f2-4ff6-443d-b966-e6913bd24013	6ba849ce-f762-11e1-a439-00145eb45e9a
16	16	0	GBIF Germany	4f6826f2-4ff6-443d-b966-e6913bd24013	6bb1ba40-f762-11e1-a439-00145eb45e9a
13099	13099	0	National Biodiversity Network	d897a5b9-35ee-4232-94bd-b0bcaac003c2	6bc07646-3f35-4287-bb47-7850f491a28c
202	202	0	GBIF Germany	4f6826f2-4ff6-443d-b966-e6913bd24013	6c169654-f762-11e1-a439-00145eb45e9a
10	10	0	Plazi	ffb07bec-2d10-492d-9c37-361fe0b79427	6c72ae83-e6bf-4ed6-a22a-e435bc24b306
4	4	0	Plazi	ffb07bec-2d10-492d-9c37-361fe0b79427	6c9a582f-f95d-46eb-b8cf-fb5107c8a7c6
45	45	0	GBIF Germany	4f6826f2-4ff6-443d-b966-e6913bd24013	6c9d6878-f762-11e1-a439-00145eb45e9a
377	377	0	GBIF Benin	efb9c00e-f802-45dd-8826-a52ec45b89ff	717c052a-3d7b-4d68-b09d-3ca95010164e
26	26	0	GBIF Germany	4f6826f2-4ff6-443d-b966-e6913bd24013	72ede194-f762-11e1-a439-00145eb45e9a
1272	1272	0	GBIF Germany	4f6826f2-4ff6-443d-b966-e6913bd24013	733411aa-f762-11e1-a439-00145eb45e9a
16195	16195	0	National Biodiversity Network	d897a5b9-35ee-4232-94bd-b0bcaac003c2	73846baa-cba6-48e0-94e0-9308dae5c6bb
33	33	0	GBIF Germany	4f6826f2-4ff6-443d-b966-e6913bd24013	742f59e8-f762-11e1-a439-00145eb45e9a
26	26	0	GBIF Germany	4f6826f2-4ff6-443d-b966-e6913bd24013	748309a8-f762-11e1-a439-00145eb45e9a
76704	76704	0	GBIF Portugal	673f7038-4262-4149-b753-5658a4e912f6	748721ea-db63-4798-afce-e1de26144e3c
59	59	0	GBIF Germany	4f6826f2-4ff6-443d-b966-e6913bd24013	74d64a28-f762-11e1-a439-00145eb45e9a
512	512	0	GBIF Germany	4f6826f2-4ff6-443d-b966-e6913bd24013	75400634-f762-11e1-a439-00145eb45e9a
100	100	0	GBIF Japan	db5705aa-6a6e-42f1-8942-d77b9f4896ea	7699d7ee-bcc2-4c67-b0b6-a82d8db4575b
3010	1750	-1260	GBIF Germany	4f6826f2-4ff6-443d-b966-e6913bd24013	79f072c2-f762-11e1-a439-00145eb45e9a
2	2	0	Plazi	ffb07bec-2d10-492d-9c37-361fe0b79427	7a6e3698-f6a7-4c53-9e45-4f0e9c2c9eaf
4392	4392	0	GBIF France	da44cd31-5901-4687-a106-6d1c7734ee3a	7a761036-ea6d-4d37-ac9a-79daa54d6ca2
24	24	0	Plazi	ffb07bec-2d10-492d-9c37-361fe0b79427	7b68a924-d04a-4ed9-87bf-71eae1c24f3e
42	42	0	GBIF Germany	4f6826f2-4ff6-443d-b966-e6913bd24013	7c87ebc8-f762-11e1-a439-00145eb45e9a
4	4	0	GBIF Germany	4f6826f2-4ff6-443d-b966-e6913bd24013	7cc65d9a-f762-11e1-a439-00145eb45e9a
0	235	235	Plazi	ffb07bec-2d10-492d-9c37-361fe0b79427	7e1d26e0-1470-4111-8a06-50d8f3ce8ec1
2	2	0	Plazi	ffb07bec-2d10-492d-9c37-361fe0b79427	7e64120d-129f-4088-9b29-5b7ef638ef3c
414	174	-240	GBIF Germany	4f6826f2-4ff6-443d-b966-e6913bd24013	7eeff77a-f762-11e1-a439-00145eb45e9a
101	101	0	GBIF Germany	4f6826f2-4ff6-443d-b966-e6913bd24013	7f20ae7e-f762-11e1-a439-00145eb45e9a
1293	1293	0	Biodiversity Information System of Mexico	b324e8e9-9a4c-44fa-8f1a-7f39ea7ab576	7fbce258-f762-11e1-a439-00145eb45e9a
5	4	-1	Plazi	ffb07bec-2d10-492d-9c37-361fe0b79427	7fbdd6a3-8010-4616-965d-241515af8423
1016	1016	0	Biodiversity Information System of Mexico	b324e8e9-9a4c-44fa-8f1a-7f39ea7ab576	7fe05cce-f762-11e1-a439-00145eb45e9a
580	295	-285	GBIF Germany	4f6826f2-4ff6-443d-b966-e6913bd24013	815ea0ce-f762-11e1-a439-00145eb45e9a
234	234	0	Plazi	ffb07bec-2d10-492d-9c37-361fe0b79427	81656d78-6689-4555-9a97-f8503ee08776
1702	851	-851	GBIF Germany	4f6826f2-4ff6-443d-b966-e6913bd24013	823eeecc-f762-11e1-a439-00145eb45e9a
5771	5771	0	Atlas of Living Australia	4a6f1b71-969e-4fc5-a693-282b05e1220c	82eee8cc-f762-11e1-a439-00145eb45e9a
11459	11459	0	GBIF Spain	1f94b3ca-9345-4d65-afe2-4bace93aa0fe	83771684-f762-11e1-a439-00145eb45e9a
75	75	0	Netherlands Biodiversity Information Facility	0909d601-bda2-42df-9e63-a6d51847ebce	84881ef8-a565-4124-9102-253954c419f4
24798	24798	0	DanBIF - Danish Biodiversity Information Facility	4ddd294f-02b7-4359-ac33-0806a9ca9c6b	84c6cb56-f762-11e1-a439-00145eb45e9a
3198	1840	-1358	Atlas of Living Australia	4a6f1b71-969e-4fc5-a693-282b05e1220c	85ff6f64-f762-11e1-a439-00145eb45e9a
1599	1268	-331	GBIF Germany	4f6826f2-4ff6-443d-b966-e6913bd24013	86c342cc-f762-11e1-a439-00145eb45e9a
1168	1168	0	GBIF Germany	4f6826f2-4ff6-443d-b966-e6913bd24013	87af2f02-f762-11e1-a439-00145eb45e9a
630	471	-159	GBIF Germany	4f6826f2-4ff6-443d-b966-e6913bd24013	87d34afe-f762-11e1-a439-00145eb45e9a
156	110	-46	GBIF Germany	4f6826f2-4ff6-443d-b966-e6913bd24013	88140332-f762-11e1-a439-00145eb45e9a
235	235	0	GBIF Germany	4f6826f2-4ff6-443d-b966-e6913bd24013	89dacc32-f762-11e1-a439-00145eb45e9a
19	19	0	GBIF France	da44cd31-5901-4687-a106-6d1c7734ee3a	8a20c92d-5e1e-4c4e-adbf-1f9d99c72ff1
0	1	1	Plazi	ffb07bec-2d10-492d-9c37-361fe0b79427	8aee52b0-b9d3-4ee0-b816-62fe126d3e3c
15	9	-6	GBIF Germany	4f6826f2-4ff6-443d-b966-e6913bd24013	8ca8c5e0-f762-11e1-a439-00145eb45e9a
50	50	0	GBIF Germany	4f6826f2-4ff6-443d-b966-e6913bd24013	8d76701c-f762-11e1-a439-00145eb45e9a
15	13	-2	GBIF Germany	4f6826f2-4ff6-443d-b966-e6913bd24013	8ef0751e-f762-11e1-a439-00145eb45e9a
167	59	-108	GBIF Germany	4f6826f2-4ff6-443d-b966-e6913bd24013	90f0c526-f762-11e1-a439-00145eb45e9a
33	33	0	GBIF Germany	4f6826f2-4ff6-443d-b966-e6913bd24013	91bddca0-f762-11e1-a439-00145eb45e9a
68	63	-5	GBIF Germany	4f6826f2-4ff6-443d-b966-e6913bd24013	92d31f10-f762-11e1-a439-00145eb45e9a
615	298	-317	GBIF Germany	4f6826f2-4ff6-443d-b966-e6913bd24013	93500ca0-f762-11e1-a439-00145eb45e9a
1	1	0	GBIF Germany	4f6826f2-4ff6-443d-b966-e6913bd24013	93a00674-f762-11e1-a439-00145eb45e9a
271	249	-22	GBIF Germany	4f6826f2-4ff6-443d-b966-e6913bd24013	945e3a86-f762-11e1-a439-00145eb45e9a
250	250	0	GBIF Germany	4f6826f2-4ff6-443d-b966-e6913bd24013	950afc4e-f762-11e1-a439-00145eb45e9a
133	133	0	GBIF Germany	4f6826f2-4ff6-443d-b966-e6913bd24013	955827c6-f762-11e1-a439-00145eb45e9a
512	512	0	GBIF Germany	4f6826f2-4ff6-443d-b966-e6913bd24013	9561cb1e-f762-11e1-a439-00145eb45e9a
0	81	81	Ocean Biodiversity Information System	ba0670b9-4186-41e6-8e70-f9cb3065551a	975cba89-3060-41dc-b6ab-785fa1f5b4f5
167	167	0	GBIF Germany	4f6826f2-4ff6-443d-b966-e6913bd24013	97c87ac4-f762-11e1-a439-00145eb45e9a
359044	359044	0	Korean Biodiversity Information Facility	e0a1e772-0177-4800-94b4-2d023fe6cdf4	9a5ffc6a-27fc-11e2-85e3-00145eb45e9a
0	7245	7245	Ocean Biodiversity Information System	ba0670b9-4186-41e6-8e70-f9cb3065551a	9aff7e69-911c-42a4-a0da-9756396f6eb8
0	1942	1942	Ocean Biodiversity Information System	ba0670b9-4186-41e6-8e70-f9cb3065551a	9f5eb59d-e736-40c9-85e5-22f8c449ee82
575	575	0	Biodiversity Information System of Mexico	b324e8e9-9a4c-44fa-8f1a-7f39ea7ab576	9fe437b9-1caf-4356-a074-4b2c4348959c
40	40	0	Plazi	ffb07bec-2d10-492d-9c37-361fe0b79427	a3144fc9-effa-4791-90c4-f283a693c43a
1589	1589	0	GBIF France	da44cd31-5901-4687-a106-6d1c7734ee3a	a5c1c9d8-337e-4230-b1ab-13e5417bbdb9
3036	3036	0	Participant Node Managers Committee	7f48e0c8-5c96-49ec-b972-30748e339115	a9b4672d-3772-4428-a923-42e0b6e04a45
87320	87320	0	GBIF France	da44cd31-5901-4687-a106-6d1c7734ee3a	aa79690b-018a-44b0-8ed4-2704ba530ade
193	193	0	GBIF Madagascar	2dbfc5c5-51b5-4494-9dfc-4d3f013a3b64	ab5f0353-364a-4e1a-bbaa-6de46cafe1b4
184	184	0	GBIF France	da44cd31-5901-4687-a106-6d1c7734ee3a	ad68b452-71a7-4566-a8c6-59d3ee2ca853
0	917	917	Ocean Biodiversity Information System	ba0670b9-4186-41e6-8e70-f9cb3065551a	ae1cd68b-da5f-4f51-aeb3-78ac0f72ba41
2428	2428	0	Colombian Biodiversity Information System	7e865cba-7c46-417b-ade5-97f2cf5b7be0	af56bf1f-7547-44fe-9254-e261a79fc764
51	51	0	GBIF France	da44cd31-5901-4687-a106-6d1c7734ee3a	b433a9b2-8ae6-4618-ae82-d9ef4d4b3d80
2	2	0	Plazi	ffb07bec-2d10-492d-9c37-361fe0b79427	b48eb8f1-7fe4-47dc-8891-6ac198784070
65	65	0	Plazi	ffb07bec-2d10-492d-9c37-361fe0b79427	b5e4dddc-60d0-408c-b6ec-9e3fd219b33d
801	801	0	GBIF France	da44cd31-5901-4687-a106-6d1c7734ee3a	ba891a87-f78a-461c-bed4-3288249c1813
1	1	0	Plazi	ffb07bec-2d10-492d-9c37-361fe0b79427	bd6e23e7-437f-4343-aba9-9e19f15fb5e1
5	5	0	Plazi	ffb07bec-2d10-492d-9c37-361fe0b79427	be1204f7-e9a6-43f5-9783-9760edf50a7a
211731	211731	0	U.S. Geological Survey	8618c64a-93e0-4300-b546-7249e5148ed2	be5507b9-7abf-4b69-afe1-5ca2b7561734
78	78	0	Colombian Biodiversity Information System	7e865cba-7c46-417b-ade5-97f2cf5b7be0	bec6a829-6575-4de2-91c8-0fbaeee39c83
15472	15472	0	National Biodiversity Network	d897a5b9-35ee-4232-94bd-b0bcaac003c2	bf61d71e-6bb1-414a-90f4-62abd5fddb18
0	1960	1960	GBIF Argentina	2426a871-9feb-40a1-96c6-0c593a76b835	c098beb4-9287-482e-9088-4a3decf389aa
24577	24577	0	Belgian Biodiversity Platform	fb11cfe1-ebc3-45af-9159-17d9fddbcdac	c0cc29de-f49f-4b66-b4ec-c83afbb7101d
0	49	49	Plazi	ffb07bec-2d10-492d-9c37-361fe0b79427	c148b91e-4700-4337-843c-f58d7a774dff
212	212	0	GBIF France	da44cd31-5901-4687-a106-6d1c7734ee3a	c414d33c-d181-46d3-b9cb-b6fc64f11d55
136	136	0	GBIF Sweden	a0b3be64-6525-4387-ac67-a499950f92e1	c4f40a22-0e4f-4b27-9ec7-c750604d6dc0
3709	2151	-1558	Biodiversity Information System of Mexico	b324e8e9-9a4c-44fa-8f1a-7f39ea7ab576	c6677d76-f416-4479-9175-c5ec9e8eda4a
25	25	0	Plazi	ffb07bec-2d10-492d-9c37-361fe0b79427	c695ce79-1da5-48d4-8b8b-3744cdcac470
13934	13934	0	U.S. Geological Survey	8618c64a-93e0-4300-b546-7249e5148ed2	c784ba5b-491f-4d1d-8a44-0dc457889087
32	32	0	GBIF Brazil	cdc9736d-5ff7-4ece-9959-3c744360cdb3	ca51faa6-179e-4c43-88d3-c9435671d222
0	145	145	Plazi	ffb07bec-2d10-492d-9c37-361fe0b79427	cb6aba32-f99a-4559-bcbb-8b56498dd2fa
0	38797	38797	National Biodiversity Network	d897a5b9-35ee-4232-94bd-b0bcaac003c2	cef450df-7155-4c9d-9eb3-7b9b4d868bfa
0	75	75	Plazi	ffb07bec-2d10-492d-9c37-361fe0b79427	cfe7c582-8024-4dae-8680-98a8acbf403d
945	945	0	Colombian Biodiversity Information System	7e865cba-7c46-417b-ade5-97f2cf5b7be0	cfefc59d-3349-4839-b053-9b4327634a06
1	1	0	GBIF France	da44cd31-5901-4687-a106-6d1c7734ee3a	d0185a04-e83e-47b6-8f91-eb36b86dac1d
19	19	0	Plazi	ffb07bec-2d10-492d-9c37-361fe0b79427	d2c163f1-4fb9-4425-a4ca-6f83853a5956
3	3	0	Plazi	ffb07bec-2d10-492d-9c37-361fe0b79427	d4078fef-6003-4ca4-b24a-159b7115d8c8
0	6	6	Plazi	ffb07bec-2d10-492d-9c37-361fe0b79427	d46af7eb-bf62-4022-8dbe-5c6f8c918820
0	2	2	Plazi	ffb07bec-2d10-492d-9c37-361fe0b79427	d5f004c5-d1ca-4db7-a9e4-8f4afbd1e7fa
9254	9254	0	Participant Node Managers Committee	7f48e0c8-5c96-49ec-b972-30748e339115	d97d8a15-3b12-4519-92bf-e4cf9e764514
0	2	2	Plazi	ffb07bec-2d10-492d-9c37-361fe0b79427	dca693a2-1326-480e-a611-979e3ebd104d
177494	177494	0	Colombian Biodiversity Information System	7e865cba-7c46-417b-ade5-97f2cf5b7be0	dd1be613-e22c-4e3a-86a3-bc055766aa7b
1100	1100	0	Participant Node Managers Committee	7f48e0c8-5c96-49ec-b972-30748e339115	dedb57d0-ad00-48dd-938a-422223c2bfc3
736	736	0	GBIF France	da44cd31-5901-4687-a106-6d1c7734ee3a	e0bff805-c3ad-4b0d-a7db-039d5da9e4b6
0	3	3	Plazi	ffb07bec-2d10-492d-9c37-361fe0b79427	e4f212da-6eab-43d4-8bed-048b749d447f
104785	105299	514	GBIF France	da44cd31-5901-4687-a106-6d1c7734ee3a	e553568e-2317-4592-8638-92e5ac93b40c
0	6867	6867	Ocean Biodiversity Information System	ba0670b9-4186-41e6-8e70-f9cb3065551a	e7f43a19-eb19-43e9-af43-f6ed07e6e4cd
1750	1750	0	National Biodiversity Network	d897a5b9-35ee-4232-94bd-b0bcaac003c2	e824fd94-5cf5-40b7-ad48-a9de7b2bcd6a
0	20	20	Plazi	ffb07bec-2d10-492d-9c37-361fe0b79427	e9baa250-ec84-440f-96bf-06b55f6738e3
965	965	0	GBIF Norway	4f829580-180d-46a9-9c87-ed8ec959b545	ea0bb0f7-84cc-4541-96a2-837003f31d99
2728	2728	0	Colombian Biodiversity Information System	7e865cba-7c46-417b-ade5-97f2cf5b7be0	ebab0e47-ba39-488a-b6ed-62415f212e08
4303	4303	0	Polish Biodiversity Information Network	2618bfdf-e194-4911-a241-80db3107bc51	eeb027e0-0e2e-11de-b8e6-b8a03c50a862
273	273	0	National Biodiversity Network	d897a5b9-35ee-4232-94bd-b0bcaac003c2	fe013393-3bda-4369-a8e4-015b89ba65fb
5	5	0	Plazi	ffb07bec-2d10-492d-9c37-361fe0b79427	09b802a1-bd70-4ce6-bb6e-54c4114d42c1
0	63	63	Ocean Biodiversity Information System	ba0670b9-4186-41e6-8e70-f9cb3065551a	09bf6e3f-2348-44a0-a5c2-73396ff86889
2691	2691	0	U.S. Geological Survey	8618c64a-93e0-4300-b546-7249e5148ed2	09e41efb-1457-4b7c-8576-70a4480fd2f2
10894	10894	0	Participant Node Managers Committee	7f48e0c8-5c96-49ec-b972-30748e339115	09efcc43-c674-4a70-b326-cd83f7463d1d
9056	9055	-1	National Biodiversity Network	d897a5b9-35ee-4232-94bd-b0bcaac003c2	0a0d4ca1-5bfd-4594-9d51-40b972308bf5
14	14	0	Plazi	ffb07bec-2d10-492d-9c37-361fe0b79427	0d36917d-0d28-4d50-b4e4-51258f53e42e
0	1	1	Plazi	ffb07bec-2d10-492d-9c37-361fe0b79427	0e5e56a2-be34-4299-abfa-10119efb9714
0	28	28	Colombian Biodiversity Information System	7e865cba-7c46-417b-ade5-97f2cf5b7be0	0f46ab2f-73b6-42fb-a5a7-1778e5a405d0
0	27	27	Plazi	ffb07bec-2d10-492d-9c37-361fe0b79427	11088aaa-ac64-4b8f-bb4f-5ab4dd5baa6f
12	12	0	Plazi	ffb07bec-2d10-492d-9c37-361fe0b79427	1203409a-4d81-43df-838f-63414ae7ff10
0	3	3	Plazi	ffb07bec-2d10-492d-9c37-361fe0b79427	12f83540-f94c-41ec-9e71-b11d0aa3c199
0	7	7	Plazi	ffb07bec-2d10-492d-9c37-361fe0b79427	15b8424b-0a65-4c16-8c37-139ba2c55ed9
26	26	0	Plazi	ffb07bec-2d10-492d-9c37-361fe0b79427	1a494273-e6a9-4368-9184-1ccaa399b56f
54	54	0	Plazi	ffb07bec-2d10-492d-9c37-361fe0b79427	20c15241-14d2-4fca-aa57-ff3919c3d9c8
139	139	0	Plazi	ffb07bec-2d10-492d-9c37-361fe0b79427	22b02e67-634f-4e71-a8fa-3392aff63985
0	432	432	Ocean Biodiversity Information System	ba0670b9-4186-41e6-8e70-f9cb3065551a	23e40cc4-c35f-46fe-b4d8-12923db2c3b4
4030	4125	95	U.S. Geological Survey	8618c64a-93e0-4300-b546-7249e5148ed2	2564e9e2-0248-4a3b-8344-24fc0956ed73
21	21	0	Belgian Biodiversity Platform	fb11cfe1-ebc3-45af-9159-17d9fddbcdac	257eb1eb-75a3-40cb-82a5-f8ecd8d8b523
8937	8937	0	GBIF Spain	1f94b3ca-9345-4d65-afe2-4bace93aa0fe	26d72d3b-4544-4645-aa56-27aa8a669c6f
0	21	21	Plazi	ffb07bec-2d10-492d-9c37-361fe0b79427	2764e649-f308-4e3b-aaa0-9d29e81a06f2
165	165	0	GBIF France	da44cd31-5901-4687-a106-6d1c7734ee3a	297813ec-9981-453d-8531-8ddde98b027b
0	192	192	Plazi	ffb07bec-2d10-492d-9c37-361fe0b79427	2b64b349-96cf-4bac-a12f-e1217197ec7a
0	2	2	Plazi	ffb07bec-2d10-492d-9c37-361fe0b79427	2c15ee5f-9e40-4393-aaae-2640bb685f73
5	5	0	Plazi	ffb07bec-2d10-492d-9c37-361fe0b79427	2dfee902-a7fc-472b-bf1d-27029b3504f3
133	133	0	GBIF France	da44cd31-5901-4687-a106-6d1c7734ee3a	326cbcf2-efd9-4522-8077-fc9ee4df0026
17062	17062	0	National Biodiversity Network	d897a5b9-35ee-4232-94bd-b0bcaac003c2	3427d02c-2723-47b5-913b-9193269f0a6d
58	58	0	Colombian Biodiversity Information System	7e865cba-7c46-417b-ade5-97f2cf5b7be0	342dd753-d406-499e-8f7a-41c1e228276d
4	4	0	Plazi	ffb07bec-2d10-492d-9c37-361fe0b79427	37689c7b-66d9-46bc-8c4c-2c5c2e6526ec
18615	18615	0	U.S. Geological Survey	8618c64a-93e0-4300-b546-7249e5148ed2	37eeb5de-fec3-404a-ba4f-62218ac6c860
1053	381	-672	GBIF Germany	4f6826f2-4ff6-443d-b966-e6913bd24013	3a31766e-2629-4473-a156-c5214b1bc66a
117	117	0	Plazi	ffb07bec-2d10-492d-9c37-361fe0b79427	3b0f294e-4bee-4f37-bb04-47431384b6a2
2	2	0	Plazi	ffb07bec-2d10-492d-9c37-361fe0b79427	3c9f44c6-59ff-4e7b-95e6-9c60bceb9ee5
1	1	0	Plazi	ffb07bec-2d10-492d-9c37-361fe0b79427	3ebee944-1e6e-45d8-bba7-986581409c12
44	44	0	Plazi	ffb07bec-2d10-492d-9c37-361fe0b79427	3f4e48f2-f9a0-434e-8ec3-be455a1ec995
15953	15953	0	GBIF Sweden	a0b3be64-6525-4387-ac67-a499950f92e1	40d2de00-0c6e-11dd-84d2-b8a03c50a862
1	1	0	Plazi	ffb07bec-2d10-492d-9c37-361fe0b79427	42150b60-b60f-47dd-8e4b-9bc1a193690d
4	4	0	GBIF Germany	4f6826f2-4ff6-443d-b966-e6913bd24013	43bae70d-3554-4d45-84ea-5b0e2d5ce29b
27	27	0	GBIF Germany	4f6826f2-4ff6-443d-b966-e6913bd24013	43d2d115-d07b-47b5-a612-591cedc99631
0	6	6	Plazi	ffb07bec-2d10-492d-9c37-361fe0b79427	465ef1aa-c9de-4ce2-9d75-2a178c9a3487
4	4	0	Plazi	ffb07bec-2d10-492d-9c37-361fe0b79427	47185d72-b411-4be9-944c-42aaa514e757
110	110	0	GBIF Portugal	673f7038-4262-4149-b753-5658a4e912f6	48cb0337-b711-4995-9da9-c5bae58e27e1
47	47	0	Plazi	ffb07bec-2d10-492d-9c37-361fe0b79427	4a2efe36-c48b-456b-9223-7b5793025a72
30	30	0	Colombian Biodiversity Information System	7e865cba-7c46-417b-ade5-97f2cf5b7be0	4c3caed5-5857-4e62-9a4d-a8100c0ce017
423	423	0	Participant Node Managers Committee	7f48e0c8-5c96-49ec-b972-30748e339115	4cdba584-5fe8-4d03-8565-64d9cc7ca5a0
2018	2018	0	Participant Node Managers Committee	7f48e0c8-5c96-49ec-b972-30748e339115	4ec9e37d-1af5-4dc2-9c2f-97fcf5f22867
6	6	0	Plazi	ffb07bec-2d10-492d-9c37-361fe0b79427	4fc425a1-dbd9-4a6c-8de0-4060ebeae7c4
0	14	14	Plazi	ffb07bec-2d10-492d-9c37-361fe0b79427	502e074b-7088-460f-9d12-3e0b04ba4ad4
12	12	0	Plazi	ffb07bec-2d10-492d-9c37-361fe0b79427	5325ec40-0957-41e7-a18e-f51c42c38ca7
369	369	0	GBIF France	da44cd31-5901-4687-a106-6d1c7734ee3a	53e1a951-1b67-4af7-a4ef-c766c306de90
1	1	0	Plazi	ffb07bec-2d10-492d-9c37-361fe0b79427	5456972f-d619-4209-81f3-626db882811a
0	152	152	Plazi	ffb07bec-2d10-492d-9c37-361fe0b79427	5676f8ca-c69e-461c-894d-2938f1f5cbbc
49	49	0	Plazi	ffb07bec-2d10-492d-9c37-361fe0b79427	5a130566-9c2b-4df1-9295-bb1cae1d1d2f
65	65	0	National Biodiversity Network	d897a5b9-35ee-4232-94bd-b0bcaac003c2	5a9ea7e8-9db0-48ff-83b2-72c04a57a6fc
2154	2154	0	GBIF France	da44cd31-5901-4687-a106-6d1c7734ee3a	5d0ce38b-4f2e-48c5-b86f-350bec2e4a2e
124	124	0	GBIF Germany	4f6826f2-4ff6-443d-b966-e6913bd24013	6109d80c-f762-11e1-a439-00145eb45e9a
1040	1040	0	GBIF Malawi	2a42e4d7-ad4a-41b3-84c4-de4aa7b74d35	6183f1f7-0513-4587-bee6-cad11e23002d
63	63	0	GBIF Germany	4f6826f2-4ff6-443d-b966-e6913bd24013	6236988c-f762-11e1-a439-00145eb45e9a
107	107	0	GBIF Germany	4f6826f2-4ff6-443d-b966-e6913bd24013	623a1ba6-f762-11e1-a439-00145eb45e9a
81	81	0	GBIF Germany	4f6826f2-4ff6-443d-b966-e6913bd24013	628fc2cc-f762-11e1-a439-00145eb45e9a
34	34	0	GBIF Germany	4f6826f2-4ff6-443d-b966-e6913bd24013	631a64ea-f762-11e1-a439-00145eb45e9a
596	596	0	GBIF Finland	dd514216-5c7c-45f3-910d-797424cb5be6	63756d9e-8701-4b86-9467-071d7228b2b9
20	15	-5	GBIF Germany	4f6826f2-4ff6-443d-b966-e6913bd24013	65bdefe6-f762-11e1-a439-00145eb45e9a
297	297	0	GBIF Germany	4f6826f2-4ff6-443d-b966-e6913bd24013	6649afae-f762-11e1-a439-00145eb45e9a
161	161	0	GBIF Germany	4f6826f2-4ff6-443d-b966-e6913bd24013	6651fb96-f762-11e1-a439-00145eb45e9a
79254	79254	0	U.S. Geological Survey	8618c64a-93e0-4300-b546-7249e5148ed2	6720aee6-2aad-446d-bb97-ba009d1b5666
169	169	0	GBIF Germany	4f6826f2-4ff6-443d-b966-e6913bd24013	67654c04-f762-11e1-a439-00145eb45e9a
164	164	0	GBIF Germany	4f6826f2-4ff6-443d-b966-e6913bd24013	67d913a0-f762-11e1-a439-00145eb45e9a
767	767	0	GBIF France	da44cd31-5901-4687-a106-6d1c7734ee3a	6897a0a6-e7c7-41ad-b6d2-61b19a2d6b3e
82	82	0	GBIF Germany	4f6826f2-4ff6-443d-b966-e6913bd24013	68ab35ce-f762-11e1-a439-00145eb45e9a
68	68	0	GBIF Germany	4f6826f2-4ff6-443d-b966-e6913bd24013	68b6c358-f762-11e1-a439-00145eb45e9a
1942	1942	0	GBIF France	da44cd31-5901-4687-a106-6d1c7734ee3a	68b9250c-742a-4d20-a388-e385b802bad8
2945	2945	0	GBIF Sweden	a0b3be64-6525-4387-ac67-a499950f92e1	6aa7c400-0c66-11dd-84d2-b8a03c50a862
2	2	0	Plazi	ffb07bec-2d10-492d-9c37-361fe0b79427	6b88d8ac-493f-46a7-87d2-e4ed6c2e6519
16	16	0	GBIF Germany	4f6826f2-4ff6-443d-b966-e6913bd24013	6bfc1dc4-f762-11e1-a439-00145eb45e9a
383	383	0	Colombian Biodiversity Information System	7e865cba-7c46-417b-ade5-97f2cf5b7be0	6c59c9b6-a3fa-4861-aab9-f188533298e7
118	118	0	GBIF Germany	4f6826f2-4ff6-443d-b966-e6913bd24013	6d572876-f762-11e1-a439-00145eb45e9a
2	2	0	Plazi	ffb07bec-2d10-492d-9c37-361fe0b79427	7022d827-656b-4ab0-a560-b4cbc3f572cf
119	119	0	GBIF Germany	4f6826f2-4ff6-443d-b966-e6913bd24013	70bdd9b0-f762-11e1-a439-00145eb45e9a
281	245	-36	GBIF Germany	4f6826f2-4ff6-443d-b966-e6913bd24013	7113689e-f762-11e1-a439-00145eb45e9a
1	1	0	Plazi	ffb07bec-2d10-492d-9c37-361fe0b79427	71b25e7e-0ba6-493d-ad4d-b0596f94b5f5
78	78	0	GBIF Germany	4f6826f2-4ff6-443d-b966-e6913bd24013	723c1b3a-f762-11e1-a439-00145eb45e9a
55	55	0	Plazi	ffb07bec-2d10-492d-9c37-361fe0b79427	72412182-ef97-4b7a-9a44-54d42ba532a1
58	58	0	GBIF Germany	4f6826f2-4ff6-443d-b966-e6913bd24013	7279e5aa-f762-11e1-a439-00145eb45e9a
187	187	0	GBIF Germany	4f6826f2-4ff6-443d-b966-e6913bd24013	746b694c-f762-11e1-a439-00145eb45e9a
0	1	1	Plazi	ffb07bec-2d10-492d-9c37-361fe0b79427	750194cf-4363-43e4-87ec-19ab59c840fa
755	755	0	GBIF France	da44cd31-5901-4687-a106-6d1c7734ee3a	7910b47b-3529-4529-a145-fd6c1cecb0fc
4	4	0	Plazi	ffb07bec-2d10-492d-9c37-361fe0b79427	795f30a3-6169-4562-8cba-407bcdada682
5	5	0	Plazi	ffb07bec-2d10-492d-9c37-361fe0b79427	796cc5ee-d357-4cd5-a7df-6bbaf52d0d8d
0	40	40	Plazi	ffb07bec-2d10-492d-9c37-361fe0b79427	79cf214d-c7d5-4053-a49c-07cfd914f6ad
128	32	-96	GBIF Germany	4f6826f2-4ff6-443d-b966-e6913bd24013	7a0f4eea-f762-11e1-a439-00145eb45e9a
2	2	0	Plazi	ffb07bec-2d10-492d-9c37-361fe0b79427	7a36859e-2b95-4aed-b54b-86c5a1cbc2f3
2903	2903	0	GBIF Germany	4f6826f2-4ff6-443d-b966-e6913bd24013	7bf7d9ac-f762-11e1-a439-00145eb45e9a
1371	1371	0	GBIF France	da44cd31-5901-4687-a106-6d1c7734ee3a	7bfc7c9e-a0d3-415e-8e54-5c92ffa19cb6
609	466	-143	GBIF Germany	4f6826f2-4ff6-443d-b966-e6913bd24013	7c8bc98c-f762-11e1-a439-00145eb45e9a
0	8	8	Plazi	ffb07bec-2d10-492d-9c37-361fe0b79427	7d1ef07f-737d-4128-9b34-4bd003bcac47
493	482	-11	GBIF Germany	4f6826f2-4ff6-443d-b966-e6913bd24013	7d489aa8-f762-11e1-a439-00145eb45e9a
696	456	-240	GBIF Germany	4f6826f2-4ff6-443d-b966-e6913bd24013	7d6f20b0-f762-11e1-a439-00145eb45e9a
1351	1351	0	GBIF Germany	4f6826f2-4ff6-443d-b966-e6913bd24013	7e991b08-f762-11e1-a439-00145eb45e9a
54586	66283	11697	U.S. Geological Survey	8618c64a-93e0-4300-b546-7249e5148ed2	7ed55b51-4336-4f74-a05a-274afffe771f
105	105	0	GBIF Germany	4f6826f2-4ff6-443d-b966-e6913bd24013	7edbf130-f762-11e1-a439-00145eb45e9a
1422	1422	0	Biodiversity Information System of Mexico	b324e8e9-9a4c-44fa-8f1a-7f39ea7ab576	7f8c8590-f762-11e1-a439-00145eb45e9a
3363	3363	0	Biodiversity Information System of Mexico	b324e8e9-9a4c-44fa-8f1a-7f39ea7ab576	80073902-f762-11e1-a439-00145eb45e9a
5513	5513	0	GBIF Japan	db5705aa-6a6e-42f1-8942-d77b9f4896ea	8122cb6c-f762-11e1-a439-00145eb45e9a
564	456	-108	GBIF Germany	4f6826f2-4ff6-443d-b966-e6913bd24013	8164ce04-f762-11e1-a439-00145eb45e9a
669	669	0	GBIF Germany	4f6826f2-4ff6-443d-b966-e6913bd24013	817c16fe-f762-11e1-a439-00145eb45e9a
275	275	0	GBIF France	da44cd31-5901-4687-a106-6d1c7734ee3a	817ea356-d2e0-4b1f-a391-a85f1435b718
3	3	0	Plazi	ffb07bec-2d10-492d-9c37-361fe0b79427	85257999-58b3-4ea2-9b44-d86f686122ca
2	2	0	Plazi	ffb07bec-2d10-492d-9c37-361fe0b79427	852c1d58-1843-4263-a5b6-b13da89e1463
198	198	0	GBIF France	da44cd31-5901-4687-a106-6d1c7734ee3a	85a10034-6f72-4ab9-a949-c20e365d4be3
654	654	0	GBIF Norway	4f829580-180d-46a9-9c87-ed8ec959b545	85b0b9ce-1fac-46a6-ac25-c4ea3645b7af
500	501	1	GBIF Germany	4f6826f2-4ff6-443d-b966-e6913bd24013	85ba542c-61a7-435b-9b96-43d8bd2b3aa3
1251	1251	0	GBIF Germany	4f6826f2-4ff6-443d-b966-e6913bd24013	863844d8-f762-11e1-a439-00145eb45e9a
508	356	-152	GBIF Germany	4f6826f2-4ff6-443d-b966-e6913bd24013	87e18984-f762-11e1-a439-00145eb45e9a
0	300	300	GBIF Japan	db5705aa-6a6e-42f1-8942-d77b9f4896ea	88609ef9-a3a7-453a-bc07-4886a3c4b8a6
15	15	0	GBIF Germany	4f6826f2-4ff6-443d-b966-e6913bd24013	8877d20e-f762-11e1-a439-00145eb45e9a
10	10	0	GBIF Germany	4f6826f2-4ff6-443d-b966-e6913bd24013	88879d92-f762-11e1-a439-00145eb45e9a
1010	1010	0	GBIF France	da44cd31-5901-4687-a106-6d1c7734ee3a	88e58275-27c8-4e52-9cf4-81b10168f2a6
773	773	0	GBIF Germany	4f6826f2-4ff6-443d-b966-e6913bd24013	89be485a-f762-11e1-a439-00145eb45e9a
150	150	0	GBIF Germany	4f6826f2-4ff6-443d-b966-e6913bd24013	89c513f6-f762-11e1-a439-00145eb45e9a
234	234	0	GBIF Germany	4f6826f2-4ff6-443d-b966-e6913bd24013	8a985fea-f762-11e1-a439-00145eb45e9a
27	20	-7	GBIF Germany	4f6826f2-4ff6-443d-b966-e6913bd24013	8d0ac8b2-f762-11e1-a439-00145eb45e9a
414	414	0	GBIF Brazil	cdc9736d-5ff7-4ece-9959-3c744360cdb3	8d982784-bc47-4e02-9432-dbef8f36b758
7131680	7549057	417377	GBIF Germany	4f6826f2-4ff6-443d-b966-e6913bd24013	8ea4250e-0ff0-44f8-812e-bffc3b9ba2a4
640	640	0	Biodiversity Information System of Mexico	b324e8e9-9a4c-44fa-8f1a-7f39ea7ab576	8f00dca9-bda9-4426-8066-82c915319650
101	101	0	Participant Node Managers Committee	7f48e0c8-5c96-49ec-b972-30748e339115	8f83518f-c8b1-431d-90b5-3655606eff36
129	102	-27	GBIF Germany	4f6826f2-4ff6-443d-b966-e6913bd24013	90bb9ec8-f762-11e1-a439-00145eb45e9a
267	211	-56	GBIF Germany	4f6826f2-4ff6-443d-b966-e6913bd24013	92dc833e-f762-11e1-a439-00145eb45e9a
0	5	5	Plazi	ffb07bec-2d10-492d-9c37-361fe0b79427	92fd172c-9d32-419f-9ea4-924f1cecb1b5
25	10	-15	GBIF Germany	4f6826f2-4ff6-443d-b966-e6913bd24013	934ecbec-f762-11e1-a439-00145eb45e9a
1	1	0	GBIF Germany	4f6826f2-4ff6-443d-b966-e6913bd24013	93834304-f762-11e1-a439-00145eb45e9a
45	45	0	GBIF Germany	4f6826f2-4ff6-443d-b966-e6913bd24013	95991682-f762-11e1-a439-00145eb45e9a
24	24	0	GBIF Germany	4f6826f2-4ff6-443d-b966-e6913bd24013	97852364-f762-11e1-a439-00145eb45e9a
0	21	21	Plazi	ffb07bec-2d10-492d-9c37-361fe0b79427	9797e168-d1b1-4c0a-8786-638b6f992159
1	1	0	Plazi	ffb07bec-2d10-492d-9c37-361fe0b79427	9943d5c6-76c7-4459-a06d-37ff57abb34c
0	2	2	Plazi	ffb07bec-2d10-492d-9c37-361fe0b79427	9c82b465-6bab-4552-9cfe-32735dd74d46
39	39	0	Plazi	ffb07bec-2d10-492d-9c37-361fe0b79427	9e0cb1dc-1a39-470d-8bdb-ce3fd619a6a0
0	2	2	Ocean Biodiversity Information System	ba0670b9-4186-41e6-8e70-f9cb3065551a	a0639cd1-0c02-4bf0-8714-2fc39617d465
148	124	-24	GBIF Germany	4f6826f2-4ff6-443d-b966-e6913bd24013	a1d4c17e-ed9b-4f25-8813-627bb504dde5
116	116	0	GBIF France	da44cd31-5901-4687-a106-6d1c7734ee3a	a38128a2-1e8e-41fb-993a-b7f9da247b13
17	17	0	Plazi	ffb07bec-2d10-492d-9c37-361fe0b79427	a6bd3b38-516d-45bd-a4f9-a3354e99d122
4	4	0	Plazi	ffb07bec-2d10-492d-9c37-361fe0b79427	a7b61d36-f75a-48c0-9343-551549ce4906
0	19999	19999	Colombian Biodiversity Information System	7e865cba-7c46-417b-ade5-97f2cf5b7be0	a9a819bb-b94e-4e06-bbbd-4cc1eb6f3b1c
807	807	0	Colombian Biodiversity Information System	7e865cba-7c46-417b-ade5-97f2cf5b7be0	aaf39fff-13a8-4c8e-96f7-b58fee2add74
10225	10225	0	GBIF France	da44cd31-5901-4687-a106-6d1c7734ee3a	ad78fc16-aa0d-4e4c-b002-25235cf97c41
13006	13006	0	GBIF Brazil	cdc9736d-5ff7-4ece-9959-3c744360cdb3	af6e6436-2507-43e7-b884-6838f655e14a
0	34	34	Plazi	ffb07bec-2d10-492d-9c37-361fe0b79427	afab8d69-27e6-4312-b09f-38a84037fbce
42	42	0	GBIF France	da44cd31-5901-4687-a106-6d1c7734ee3a	b07689e1-fd96-4ad1-bfa4-fdc9e10c5210
0	23	23	Plazi	ffb07bec-2d10-492d-9c37-361fe0b79427	b241f1e1-dcd0-46a6-aa5a-ece74210698b
26	26	0	Colombian Biodiversity Information System	7e865cba-7c46-417b-ade5-97f2cf5b7be0	b2427541-1125-4f66-be5e-e698bf7e6926
37	37	0	Plazi	ffb07bec-2d10-492d-9c37-361fe0b79427	c0796bd4-024d-4dce-9177-4a55f412cc63
0	129074	129074	GBIF Sweden	a0b3be64-6525-4387-ac67-a499950f92e1	c44ce8a6-ecd3-4516-b741-0268a35fd117
28	28	0	Plazi	ffb07bec-2d10-492d-9c37-361fe0b79427	c52aa161-e22d-4d56-9b7e-1ce03865e246
211	211	0	Plazi	ffb07bec-2d10-492d-9c37-361fe0b79427	c792028c-932d-41fd-b41a-d2a136c789ad
64240	64240	0	National Biodiversity Network	d897a5b9-35ee-4232-94bd-b0bcaac003c2	c9509108-dab4-426d-b62b-5c937b7719df
2	2	0	Plazi	ffb07bec-2d10-492d-9c37-361fe0b79427	cb36dcaf-14bb-4cab-a19c-6837fa75b20f
1	1	0	Plazi	ffb07bec-2d10-492d-9c37-361fe0b79427	cb462c79-5d46-4051-9a11-76b2262f554a
308	308	0	Ocean Biodiversity Information System	ba0670b9-4186-41e6-8e70-f9cb3065551a	cb811b65-8593-43d4-9ef7-699c4c40b50f
0	3	3	Ocean Biodiversity Information System	ba0670b9-4186-41e6-8e70-f9cb3065551a	cf16cf4c-21f4-4788-ace0-b90b212a713e
263	263	0	GBIF Germany	4f6826f2-4ff6-443d-b966-e6913bd24013	cf79b460-bd4f-4f11-8e5e-3b52d47a98c1
67	67	0	Plazi	ffb07bec-2d10-492d-9c37-361fe0b79427	d0dc8fdd-32b0-446a-9ff0-63562ba0d7ed
0	13074	13074	U.S. Geological Survey	8618c64a-93e0-4300-b546-7249e5148ed2	d235af7e-b96a-478f-a0df-29eb758b8192
7	7	0	Plazi	ffb07bec-2d10-492d-9c37-361fe0b79427	d313b890-7526-4a56-adfd-2e2c3b444dba
2	2	0	Plazi	ffb07bec-2d10-492d-9c37-361fe0b79427	d4e76375-b2f8-46fc-b19b-5331724bc8e6
0	9	9	Plazi	ffb07bec-2d10-492d-9c37-361fe0b79427	d5cb3a6b-824f-467d-b012-d037cab1ac57
0	6	6	Plazi	ffb07bec-2d10-492d-9c37-361fe0b79427	d6d2d99d-db64-4025-a012-16c5e122f18b
11273	11273	0	GBIF Norway	4f829580-180d-46a9-9c87-ed8ec959b545	d7e36e03-340d-4cba-904c-a2a3e662d3cd
14275	14232	-43	Biodiversity Information System of Mexico	b324e8e9-9a4c-44fa-8f1a-7f39ea7ab576	da5fcfbd-25a3-4af7-8cb5-c8f2c15a83a9
3750	3750	0	GBIF France	da44cd31-5901-4687-a106-6d1c7734ee3a	db9b82dc-1662-4557-bb6e-196c38f2c2c6
274	274	0	GBIF Germany	4f6826f2-4ff6-443d-b966-e6913bd24013	dd282bd6-6e30-4f02-bb36-6bdae0a46090
0	1575	1575	Ocean Biodiversity Information System	ba0670b9-4186-41e6-8e70-f9cb3065551a	dd41e547-08d2-42c9-9fa6-6ae5d54590e4
745	745	0	GBIF Germany	4f6826f2-4ff6-443d-b966-e6913bd24013	dd8af0a5-78de-49fa-a8ff-bcd7cb18c4cb
5	5	0	Participant Node Managers Committee	7f48e0c8-5c96-49ec-b972-30748e339115	e364eaaa-9c37-405d-8e8d-50323442704a
0	2	2	Participant Node Managers Committee	7f48e0c8-5c96-49ec-b972-30748e339115	e60b804f-323f-4ff7-9a69-f7b4746e5f05
10	10	0	Plazi	ffb07bec-2d10-492d-9c37-361fe0b79427	ed67d904-ad8b-443a-aa03-82f2ad344855
32	32	0	Tanzania Biodiversity Information Facility	abd95ca6-3959-4db9-aaa6-2de1aeecf514	f033f3b8-8e9f-476d-be36-9a826734007d
0	1	1	Plazi	ffb07bec-2d10-492d-9c37-361fe0b79427	f1c25468-63d1-4385-8b08-4550c70a2b41
10120	179052	168932	U.S. Geological Survey	8618c64a-93e0-4300-b546-7249e5148ed2	f46c93f2-123d-4dc3-a06e-b2faecfda2ce
854	854	0	GBIF France	da44cd31-5901-4687-a106-6d1c7734ee3a	f4a8260f-6cf6-481f-8e51-95fba62efbc9
1553	1486	-67	Biodiversity Information System of Mexico	b324e8e9-9a4c-44fa-8f1a-7f39ea7ab576	f6ed7903-0f14-4d30-bdd4-d4bb8f3e1698
2	2	0	GBIF Argentina	2426a871-9feb-40a1-96c6-0c593a76b835	f812b9ab-e291-4616-bd01-ea4ffa51254c
16	16	0	Plazi	ffb07bec-2d10-492d-9c37-361fe0b79427	f868e534-ada8-45c0-b823-b86cb4b301b8
8	8	0	Plazi	ffb07bec-2d10-492d-9c37-361fe0b79427	fa3160ac-e81a-48ef-9b06-53b37f71f659
459	459	0	GBIF Argentina	2426a871-9feb-40a1-96c6-0c593a76b835	fc5312a2-ccf2-4195-9f66-6de3fcc4dd3c
209	209	0	Colombian Biodiversity Information System	7e865cba-7c46-417b-ade5-97f2cf5b7be0	ff06f05b-7744-4c78-9efa-84189d4d920b
0	671	671	Plazi	ffb07bec-2d10-492d-9c37-361fe0b79427	010695ef-a142-42ad-81d7-2e7ed1f7e89e
2	2	0	Plazi	ffb07bec-2d10-492d-9c37-361fe0b79427	028656b0-ca8c-49ce-bf4c-cb5df6710deb
132035	132035	0	Atlas of Living Australia	4a6f1b71-969e-4fc5-a693-282b05e1220c	0471f28e-b58b-4c02-89e4-d2a1d621a9d8
5093	5093	0	National Biodiversity Network	d897a5b9-35ee-4232-94bd-b0bcaac003c2	08032774-7d16-4309-9636-381bb98548ce
0	10	10	Ocean Biodiversity Information System	ba0670b9-4186-41e6-8e70-f9cb3065551a	08e2eac7-17d1-4715-a409-e6b7d99e11de
0	20448	20448	GBIF Sweden	a0b3be64-6525-4387-ac67-a499950f92e1	093d659d-99e1-4bd0-9de7-6330b361ea54
3811	3811	0	Biodiversity Information System of Mexico	b324e8e9-9a4c-44fa-8f1a-7f39ea7ab576	0b5f0f86-5743-4f04-a19e-d8e0a983e55a
10	10	0	Plazi	ffb07bec-2d10-492d-9c37-361fe0b79427	1083fe4d-260c-49f8-b4f8-4b90a30e262f
12	12	0	Plazi	ffb07bec-2d10-492d-9c37-361fe0b79427	1bb8fd95-86d2-45d8-abc1-cb4e7d56c18e
0	34	34	Ocean Biodiversity Information System	ba0670b9-4186-41e6-8e70-f9cb3065551a	1f65d4a3-bb03-4dbe-b11f-b5eb82f242bb
11131	11131	0	GBIF Spain	1f94b3ca-9345-4d65-afe2-4bace93aa0fe	2444d607-5bbc-4b7a-a804-fd9fbaebd6c6
521	521	0	GBIF Germany	4f6826f2-4ff6-443d-b966-e6913bd24013	269fecc3-84ea-41df-ad64-40e26dba14cc
747	747	0	GBIF France	da44cd31-5901-4687-a106-6d1c7734ee3a	27a1a4ce-e1c6-4697-aecc-08791f4c7bb5
580	580	0	GBIF France	da44cd31-5901-4687-a106-6d1c7734ee3a	27d822a3-5b01-4fa0-9723-6474dd6c1063
855	855	0	GBIF Germany	4f6826f2-4ff6-443d-b966-e6913bd24013	283fa619-662a-4436-a759-92ee98cc4d2c
489	489	0	GBIF Spain	1f94b3ca-9345-4d65-afe2-4bace93aa0fe	29cd134d-99ac-4393-85ac-c03c1aa36452
0	67	67	Colombian Biodiversity Information System	7e865cba-7c46-417b-ade5-97f2cf5b7be0	2c039d30-1650-4652-8e80-939ac9384739
0	4	4	Plazi	ffb07bec-2d10-492d-9c37-361fe0b79427	2d748fbd-c489-46be-a3e7-1df052c48d9f
1463	1463	0	GBIF France	da44cd31-5901-4687-a106-6d1c7734ee3a	2e42b3dc-267f-444e-a917-080c254fec5d
1135	1135	0	GBIF Chile	a8b16421-d80b-4ef3-8f22-098b01a89255	2ecabd6b-ab23-43c1-b231-80dd2612536c
6	6	0	Plazi	ffb07bec-2d10-492d-9c37-361fe0b79427	2fdc41ca-97b1-4e90-bdd7-921797dff2c9
0	10	10	Plazi	ffb07bec-2d10-492d-9c37-361fe0b79427	30186aa6-d5ef-4204-907b-1b6bc37af396
2	2	0	Biodiversity Information System of Mexico	b324e8e9-9a4c-44fa-8f1a-7f39ea7ab576	318d1205-2603-49d3-b1a4-7698909828f8
45	45	0	Plazi	ffb07bec-2d10-492d-9c37-361fe0b79427	320c3599-381a-4150-beed-0642aa5d8fc2
2	2	0	Plazi	ffb07bec-2d10-492d-9c37-361fe0b79427	3a9d8f99-4dd2-43ec-aca7-e8730de8cfdd
65	65	0	Plazi	ffb07bec-2d10-492d-9c37-361fe0b79427	3eba6a5a-6f4b-4e46-be4e-d01b5f7b866d
7	7	0	Plazi	ffb07bec-2d10-492d-9c37-361fe0b79427	3ed3c647-2aac-4cde-ba53-ebf4a918b751
93613	93613	0	Atlas of Living Australia	4a6f1b71-969e-4fc5-a693-282b05e1220c	3fab912e-e927-4f1c-a97c-eb446cd609e0
193	193	0	Colombian Biodiversity Information System	7e865cba-7c46-417b-ade5-97f2cf5b7be0	43386ac1-772a-4be2-9f08-0f8aaef94f29
0	1	1	Plazi	ffb07bec-2d10-492d-9c37-361fe0b79427	43c4ba9f-1f5a-47d8-b4bb-a642f0d78bc5
0	17	17	Plazi	ffb07bec-2d10-492d-9c37-361fe0b79427	46db28ca-3880-4a34-bfea-004f3894cc45
0	48	48	Plazi	ffb07bec-2d10-492d-9c37-361fe0b79427	4913307f-1e58-4664-8422-3c3a2acc837d
1	1	0	Plazi	ffb07bec-2d10-492d-9c37-361fe0b79427	49b95524-5d2e-4835-ae04-78758d7dc851
138	138	0	Plazi	ffb07bec-2d10-492d-9c37-361fe0b79427	4a792ded-d181-427a-9d49-e7ef16cc7a9a
1721	1721	0	Ocean Biodiversity Information System	ba0670b9-4186-41e6-8e70-f9cb3065551a	4b607476-04ea-4dcf-831d-0ef6978eb69d
63	63	0	Ocean Biodiversity Information System	ba0670b9-4186-41e6-8e70-f9cb3065551a	4c063fa8-a70b-457b-88ef-5a6518cd8170
0	33	33	Plazi	ffb07bec-2d10-492d-9c37-361fe0b79427	4e7ef4a8-638c-4784-950c-fd767a69b926
10109	10109	0	GBIF France	da44cd31-5901-4687-a106-6d1c7734ee3a	4f0a9cb0-0079-4b22-b1fe-359b7e71a36a
41323	41323	0	National Biodiversity Network	d897a5b9-35ee-4232-94bd-b0bcaac003c2	4f454f2e-83c6-4a45-a150-f4b8bff2119b
365	365	0	Ghana Biodiversity Information Facility	b5633b75-6a86-4fdf-9cfc-506047fb9dc7	530c4e39-694b-454d-a1c9-586893e8ce8b
0	3	3	Plazi	ffb07bec-2d10-492d-9c37-361fe0b79427	534c9cc3-33ce-4476-9eb2-b7d031485104
2115	2115	0	GBIF Japan	db5705aa-6a6e-42f1-8942-d77b9f4896ea	53dc4cdc-18f5-11e2-98fb-00145eb45e9a
5	5	0	Plazi	ffb07bec-2d10-492d-9c37-361fe0b79427	5484cd48-8047-4454-8a0a-d5bf29392a60
8808	8808	0	Canadensys	4db9cfd2-1191-4b9d-b579-0b68ceabd968	56dfeacf-b9bf-4dbb-951a-a5a5200a0589
248	248	0	GBIF France	da44cd31-5901-4687-a106-6d1c7734ee3a	5732ec06-b100-4058-ba98-b64a3f19d838
0	6	6	Plazi	ffb07bec-2d10-492d-9c37-361fe0b79427	5be7d82f-c25e-4d85-9345-e1b170b58b31
4344	4344	0	Biodiversity Information System of Mexico	b324e8e9-9a4c-44fa-8f1a-7f39ea7ab576	5bfde5fb-4beb-45c9-922f-f897fe8cc710
0	6	6	Plazi	ffb07bec-2d10-492d-9c37-361fe0b79427	5ea13106-213e-4b25-9ef8-782ff3f82d8a
8423	8670	247	GBIF France	da44cd31-5901-4687-a106-6d1c7734ee3a	5ea28eaa-7e0c-417c-b525-9c737d18823f
23	23	0	GBIF Germany	4f6826f2-4ff6-443d-b966-e6913bd24013	61776a8e-f762-11e1-a439-00145eb45e9a
108	108	0	GBIF Germany	4f6826f2-4ff6-443d-b966-e6913bd24013	617e46ec-f762-11e1-a439-00145eb45e9a
9	9	0	GBIF Germany	4f6826f2-4ff6-443d-b966-e6913bd24013	61c3e846-f762-11e1-a439-00145eb45e9a
48	48	0	GBIF Germany	4f6826f2-4ff6-443d-b966-e6913bd24013	62237748-f762-11e1-a439-00145eb45e9a
68	68	0	Plazi	ffb07bec-2d10-492d-9c37-361fe0b79427	629da307-3103-42a9-a960-732841c67c14
17	17	0	GBIF Germany	4f6826f2-4ff6-443d-b966-e6913bd24013	631baba2-f762-11e1-a439-00145eb45e9a
4	4	0	GBIF Germany	4f6826f2-4ff6-443d-b966-e6913bd24013	6351356a-f762-11e1-a439-00145eb45e9a
104	104	0	GBIF Germany	4f6826f2-4ff6-443d-b966-e6913bd24013	63d56628-f762-11e1-a439-00145eb45e9a
7490	7490	0	GBIF France	da44cd31-5901-4687-a106-6d1c7734ee3a	64a043b0-6bd4-44bd-a6d5-8e5f472fbe3d
569	569	0	GBIF Germany	4f6826f2-4ff6-443d-b966-e6913bd24013	65522fc2-f762-11e1-a439-00145eb45e9a
13519	13519	0	National Biodiversity Network	d897a5b9-35ee-4232-94bd-b0bcaac003c2	65e9cc7e-6903-41c0-b30b-784f33c1df73
341	341	0	GBIF France	da44cd31-5901-4687-a106-6d1c7734ee3a	660813dc-5f18-42f7-8b28-bbf5ba3955cb
12164	12341	177	National Biodiversity Data Centre	422b00b2-6c94-4bb6-976b-c359916efdb8	6633ffa2-dc07-4d6f-a7e4-6f53d9d94dd7
23	23	0	GBIF Germany	4f6826f2-4ff6-443d-b966-e6913bd24013	673c5f88-f762-11e1-a439-00145eb45e9a
247	140	-107	GBIF Germany	4f6826f2-4ff6-443d-b966-e6913bd24013	68e4a642-f762-11e1-a439-00145eb45e9a
0	26	26	Plazi	ffb07bec-2d10-492d-9c37-361fe0b79427	69f4a6ac-2282-4d71-81ed-a0b081473273
40	40	0	GBIF Germany	4f6826f2-4ff6-443d-b966-e6913bd24013	6ac76fc6-f762-11e1-a439-00145eb45e9a
6	6	0	GBIF Germany	4f6826f2-4ff6-443d-b966-e6913bd24013	6b4f73a8-f762-11e1-a439-00145eb45e9a
8	8	0	Plazi	ffb07bec-2d10-492d-9c37-361fe0b79427	6dcb1d63-fecc-48d2-bec2-70ca54e7045e
13	13	0	GBIF Germany	4f6826f2-4ff6-443d-b966-e6913bd24013	70cde094-f762-11e1-a439-00145eb45e9a
349	61	-288	GBIF Germany	4f6826f2-4ff6-443d-b966-e6913bd24013	70e2fd12-f762-11e1-a439-00145eb45e9a
482	482	0	GBIF Germany	4f6826f2-4ff6-443d-b966-e6913bd24013	71395950-f762-11e1-a439-00145eb45e9a
0	13	13	Plazi	ffb07bec-2d10-492d-9c37-361fe0b79427	72669070-3bd6-41be-bd47-f386c83d0927
36	36	0	Plazi	ffb07bec-2d10-492d-9c37-361fe0b79427	72dd17e4-7c47-41d2-b49b-971d6b63ba7f
48	48	0	GBIF Germany	4f6826f2-4ff6-443d-b966-e6913bd24013	74f076b4-f762-11e1-a439-00145eb45e9a
150	150	0	GBIF Germany	4f6826f2-4ff6-443d-b966-e6913bd24013	754c27b6-f762-11e1-a439-00145eb45e9a
0	20	20	Plazi	ffb07bec-2d10-492d-9c37-361fe0b79427	77305956-1ea4-43ce-96f7-d0067d2c8080
14877	14877	0	National Biodiversity Network	d897a5b9-35ee-4232-94bd-b0bcaac003c2	773f9d05-e808-4ab9-86d8-d2e50be093d6
0	65	65	Atlas of Living Australia	4a6f1b71-969e-4fc5-a693-282b05e1220c	787f2a9c-2ba8-499c-aec0-5f81e7c8f5e6
130	96	-34	GBIF Germany	4f6826f2-4ff6-443d-b966-e6913bd24013	79633876-f762-11e1-a439-00145eb45e9a
2	2	0	Plazi	ffb07bec-2d10-492d-9c37-361fe0b79427	798ad3a2-4340-4802-abb7-1e0116da6f64
4	4	0	Plazi	ffb07bec-2d10-492d-9c37-361fe0b79427	79f65b69-99de-4acd-98cf-3b5b29106515
0	55	55	Plazi	ffb07bec-2d10-492d-9c37-361fe0b79427	7babc1d1-8f70-42ae-b407-f6d8859ebcbd
550	550	0	GBIF Germany	4f6826f2-4ff6-443d-b966-e6913bd24013	7be27cba-f762-11e1-a439-00145eb45e9a
0	1	1	Plazi	ffb07bec-2d10-492d-9c37-361fe0b79427	7cb57eb0-59b7-4983-800c-647f91fbc537
0	16	16	Plazi	ffb07bec-2d10-492d-9c37-361fe0b79427	7cc9ac0d-add8-45d8-803a-2f2fa50a9768
0	1	1	Plazi	ffb07bec-2d10-492d-9c37-361fe0b79427	7d017389-6552-47b2-8e7d-f1c72ff4b624
678	658	-20	GBIF Germany	4f6826f2-4ff6-443d-b966-e6913bd24013	7d7b0f1a-f762-11e1-a439-00145eb45e9a
657	657	0	GBIF Germany	4f6826f2-4ff6-443d-b966-e6913bd24013	7dbd74c2-f762-11e1-a439-00145eb45e9a
8	8	0	Plazi	ffb07bec-2d10-492d-9c37-361fe0b79427	7e67aad1-4b75-4cdd-b9a9-e2950ff82bcb
352	352	0	Colombian Biodiversity Information System	7e865cba-7c46-417b-ade5-97f2cf5b7be0	7fd2b397-105b-4bd3-8396-9e216e460a28
0	38	38	Ocean Biodiversity Information System	ba0670b9-4186-41e6-8e70-f9cb3065551a	803e4dfa-ebc5-4d71-baed-18f29c5fbc1f
8	8	0	GBIF Germany	4f6826f2-4ff6-443d-b966-e6913bd24013	814158e8-f762-11e1-a439-00145eb45e9a
5	5	0	GBIF Germany	4f6826f2-4ff6-443d-b966-e6913bd24013	815510cc-f762-11e1-a439-00145eb45e9a
2286	2279	-7	GBIF Germany	4f6826f2-4ff6-443d-b966-e6913bd24013	81d420d8-f762-11e1-a439-00145eb45e9a
661	661	0	GBIF France	da44cd31-5901-4687-a106-6d1c7734ee3a	82e3cee7-c06b-40ae-ab30-b3c911a2b713
106653	107370	717	U.S. Geological Survey	8618c64a-93e0-4300-b546-7249e5148ed2	830fd460-f762-11e1-a439-00145eb45e9a
33944	33944	0	GBIF Spain	1f94b3ca-9345-4d65-afe2-4bace93aa0fe	8354ecee-f762-11e1-a439-00145eb45e9a
157370	161344	3974	GBIF Spain	1f94b3ca-9345-4d65-afe2-4bace93aa0fe	838475f4-f762-11e1-a439-00145eb45e9a
898985	898985	0	Ocean Biodiversity Information System	ba0670b9-4186-41e6-8e70-f9cb3065551a	840ebec6-f762-11e1-a439-00145eb45e9a
1395	1395	0	Korean Biodiversity Information Facility	e0a1e772-0177-4800-94b4-2d023fe6cdf4	84392896-f762-11e1-a439-00145eb45e9a
13235	13234	-1	National Biodiversity Network	d897a5b9-35ee-4232-94bd-b0bcaac003c2	854d0c5a-0298-4a1b-9fff-adf953f3ce5e
123	123	0	Plazi	ffb07bec-2d10-492d-9c37-361fe0b79427	85506694-60e1-40dc-88df-229cd4c9421d
388	388	0	GBIF Germany	4f6826f2-4ff6-443d-b966-e6913bd24013	8558bb05-9876-41c8-a17f-37ebcd196cf1
11843	11843	0	GBIF Germany	4f6826f2-4ff6-443d-b966-e6913bd24013	858d51e0-f762-11e1-a439-00145eb45e9a
1701	1701	0	GBIF Germany	4f6826f2-4ff6-443d-b966-e6913bd24013	86417f58-f762-11e1-a439-00145eb45e9a
140	101	-39	GBIF Germany	4f6826f2-4ff6-443d-b966-e6913bd24013	8778ccdc-f762-11e1-a439-00145eb45e9a
246	246	0	Atlas of Living Australia	4a6f1b71-969e-4fc5-a693-282b05e1220c	88dfd534-f762-11e1-a439-00145eb45e9a
3329	3329	0	GBIF Spain	1f94b3ca-9345-4d65-afe2-4bace93aa0fe	8909d348-f762-11e1-a439-00145eb45e9a
88	88	0	National Biodiversity Network	d897a5b9-35ee-4232-94bd-b0bcaac003c2	8926226e-ceae-4bba-9808-bd13eb917f88
9608	9608	0	National Biodiversity Network	d897a5b9-35ee-4232-94bd-b0bcaac003c2	8be24340-cbb4-4e88-a9a9-5f029d623b20
34	27	-7	GBIF Germany	4f6826f2-4ff6-443d-b966-e6913bd24013	8c9455c4-f762-11e1-a439-00145eb45e9a
8	5	-3	GBIF Germany	4f6826f2-4ff6-443d-b966-e6913bd24013	8cab4838-f762-11e1-a439-00145eb45e9a
14	9	-5	GBIF Germany	4f6826f2-4ff6-443d-b966-e6913bd24013	8ce21f8e-f762-11e1-a439-00145eb45e9a
14	8	-6	GBIF Germany	4f6826f2-4ff6-443d-b966-e6913bd24013	8cee9bf6-f762-11e1-a439-00145eb45e9a
46	46	0	Plazi	ffb07bec-2d10-492d-9c37-361fe0b79427	8d28c61d-bf82-49ed-831e-77d6765637e4
306	306	0	Participant Node Managers Committee	7f48e0c8-5c96-49ec-b972-30748e339115	8d3f71b6-f08d-4afd-b335-32bfa1c3c5ba
720	557	-163	GBIF Germany	4f6826f2-4ff6-443d-b966-e6913bd24013	8d8f2be8-f762-11e1-a439-00145eb45e9a
9	7	-2	GBIF Germany	4f6826f2-4ff6-443d-b966-e6913bd24013	8da30776-f762-11e1-a439-00145eb45e9a
3	3	0	Plazi	ffb07bec-2d10-492d-9c37-361fe0b79427	8fb96591-16c2-4622-8761-31671602de5b
549	422	-127	GBIF Germany	4f6826f2-4ff6-443d-b966-e6913bd24013	8fd286b6-f762-11e1-a439-00145eb45e9a
450	359	-91	GBIF Germany	4f6826f2-4ff6-443d-b966-e6913bd24013	9099e364-f762-11e1-a439-00145eb45e9a
124	117	-7	GBIF Germany	4f6826f2-4ff6-443d-b966-e6913bd24013	914b1602-f762-11e1-a439-00145eb45e9a
1722	1722	0	GBIF Germany	4f6826f2-4ff6-443d-b966-e6913bd24013	92350b2c-f762-11e1-a439-00145eb45e9a
107	107	0	GBIF Germany	4f6826f2-4ff6-443d-b966-e6913bd24013	9262be82-f762-11e1-a439-00145eb45e9a
15	8	-7	GBIF Germany	4f6826f2-4ff6-443d-b966-e6913bd24013	93462d02-f762-11e1-a439-00145eb45e9a
3	3	0	GBIF Germany	4f6826f2-4ff6-443d-b966-e6913bd24013	93ebdff4-f762-11e1-a439-00145eb45e9a
912	912	0	GBIF Germany	4f6826f2-4ff6-443d-b966-e6913bd24013	941eadb2-f762-11e1-a439-00145eb45e9a
482	430	-52	GBIF Germany	4f6826f2-4ff6-443d-b966-e6913bd24013	9453d5b4-f762-11e1-a439-00145eb45e9a
300	300	0	GBIF Kenya	2a44d626-9f7a-4120-8a7a-4ab5ac15ff2a	95634901-8e40-4fb1-8af8-02eb0aa9b127
23836	23836	0	Korean Biodiversity Information Facility	e0a1e772-0177-4800-94b4-2d023fe6cdf4	988897b2-27fc-11e2-85e3-00145eb45e9a
0	5	5	Participant Node Managers Committee	7f48e0c8-5c96-49ec-b972-30748e339115	9a938d7c-0459-4788-a577-986c436ac7da
0	27	27	Plazi	ffb07bec-2d10-492d-9c37-361fe0b79427	9ce17d9d-483a-4c5b-95f2-2ecd8b27f7c7
3	3	0	Plazi	ffb07bec-2d10-492d-9c37-361fe0b79427	9d0977c1-83f5-4c9f-bd25-ff8f94b9f0c9
0	4	4	Ocean Biodiversity Information System	ba0670b9-4186-41e6-8e70-f9cb3065551a	9d9fb150-39c8-4185-b811-1f8167119ce5
2	2	0	Plazi	ffb07bec-2d10-492d-9c37-361fe0b79427	a2efe0a9-3c90-4adb-a74a-56d65e5eb115
0	13862	13862	U.S. Geological Survey	8618c64a-93e0-4300-b546-7249e5148ed2	a391a15f-033b-42fa-8bdc-b74014b05e28
2	2	0	Plazi	ffb07bec-2d10-492d-9c37-361fe0b79427	a78e8f94-e9bd-4ef8-9562-c237fead30b6
9	9	0	Plazi	ffb07bec-2d10-492d-9c37-361fe0b79427	ab020f87-34fa-4af8-806e-c008d3b085ba
33	33	0	Plazi	ffb07bec-2d10-492d-9c37-361fe0b79427	acdf8f3d-d29f-463e-a431-191275b69a80
0	3	3	Plazi	ffb07bec-2d10-492d-9c37-361fe0b79427	ad52e225-1760-4884-b7bb-25a03c75195a
366	366	0	Belgian Biodiversity Platform	fb11cfe1-ebc3-45af-9159-17d9fddbcdac	ae210cb8-a3ee-48c7-966a-a29e4a39f56f
495	495	0	Participant Node Managers Committee	7f48e0c8-5c96-49ec-b972-30748e339115	ae394d3b-5c98-4df4-beed-4b22b1bf059e
6120	17356	11236	GBIF France	da44cd31-5901-4687-a106-6d1c7734ee3a	aec988c9-b308-4758-9eb0-1ecf93749998
89	89	0	Plazi	ffb07bec-2d10-492d-9c37-361fe0b79427	b084cbe7-0fe6-4dd4-a948-ae519e54292b
2	2	0	Participant Node Managers Committee	7f48e0c8-5c96-49ec-b972-30748e339115	b1e6c5f1-7dd5-4c2b-9a86-367ec1e183af
66	66	0	GBIF Germany	4f6826f2-4ff6-443d-b966-e6913bd24013	b60b46be-25ba-470a-8675-849d896dbe65
0	700	700	Plazi	ffb07bec-2d10-492d-9c37-361fe0b79427	b65bb5a9-bbe7-49a4-af44-4b4c03121288
0	27341	27341	Ocean Biodiversity Information System	ba0670b9-4186-41e6-8e70-f9cb3065551a	b670372c-b09a-42b7-b27d-a314ef000669
20	20	0	Plazi	ffb07bec-2d10-492d-9c37-361fe0b79427	bc39a3b4-60d1-4b17-9240-a757b0d6fba0
25	25	0	Plazi	ffb07bec-2d10-492d-9c37-361fe0b79427	c0970f6b-7b5e-4072-8143-f90a5d044684
2536	2536	0	GBIF Germany	4f6826f2-4ff6-443d-b966-e6913bd24013	c0ec7b3a-b805-46d3-95cd-13066d2f67ae
36164	36164	0	Biodiversity Information System of Mexico	b324e8e9-9a4c-44fa-8f1a-7f39ea7ab576	c5938535-cbc1-4ef8-bd25-756e4c6b3985
187	187	0	U.S. Geological Survey	8618c64a-93e0-4300-b546-7249e5148ed2	c76e7c47-3439-4b09-9c4a-36ba3ff54101
45	45	0	Plazi	ffb07bec-2d10-492d-9c37-361fe0b79427	c95b6539-b89e-4dc5-8652-7f24c7ac7405
864	864	0	GBIF France	da44cd31-5901-4687-a106-6d1c7734ee3a	c967b599-fb9d-4fc9-bce2-ac927e0abbea
0	1	1	Plazi	ffb07bec-2d10-492d-9c37-361fe0b79427	caa2aa6f-9a61-4b6b-91ae-0f8ccb6a0841
1588	1588	0	National Biodiversity Network	d897a5b9-35ee-4232-94bd-b0bcaac003c2	cb84b328-8b26-4d8c-91cb-a23189541d10
312	312	0	GBIF Sweden	a0b3be64-6525-4387-ac67-a499950f92e1	cba86a10-3c4c-4032-a603-70ba2a5bf2f0
8195	8195	0	Colombian Biodiversity Information System	7e865cba-7c46-417b-ade5-97f2cf5b7be0	cc28549b-467f-448c-875e-881ca507aba8
0	286	286	Colombian Biodiversity Information System	7e865cba-7c46-417b-ade5-97f2cf5b7be0	cc2bcefe-6e6e-49b3-a795-cfcc154d204a
6	6	0	Plazi	ffb07bec-2d10-492d-9c37-361fe0b79427	cda2ab3f-6eed-42b0-8d00-3887f5d21336
0	48	48	Ocean Biodiversity Information System	ba0670b9-4186-41e6-8e70-f9cb3065551a	d085738b-f833-41c0-82ef-0fcd3fa63690
2	2	0	Plazi	ffb07bec-2d10-492d-9c37-361fe0b79427	d0e00239-42fa-495e-96fa-484352db58a5
28	28	0	National Biodiversity Network	d897a5b9-35ee-4232-94bd-b0bcaac003c2	d18e2338-0455-48b3-a85a-bd5e8de66b75
14	14	0	Plazi	ffb07bec-2d10-492d-9c37-361fe0b79427	d1ffa6d7-7a30-4e94-a57b-d6837a712c68
7	7	0	Plazi	ffb07bec-2d10-492d-9c37-361fe0b79427	d40df015-2946-4c1d-a251-c2b40b00e04a
0	11146	11146	Participant Node Managers Committee	7f48e0c8-5c96-49ec-b972-30748e339115	d52fad79-9ba7-432c-a595-1cede017e70d
30052	32553	2501	U.S. Geological Survey	8618c64a-93e0-4300-b546-7249e5148ed2	d6097f75-f99e-4c2a-b8a5-b0fc213ecbd0
5149	5149	0	National Biodiversity Network	d897a5b9-35ee-4232-94bd-b0bcaac003c2	d674d855-f574-414c-b290-707b4795655f
0	43	43	Ocean Biodiversity Information System	ba0670b9-4186-41e6-8e70-f9cb3065551a	d6db3f09-a04e-448b-a28c-bb4a03602b86
625	625	0	Biodiversity Information System of Mexico	b324e8e9-9a4c-44fa-8f1a-7f39ea7ab576	d8abadce-4111-4d60-83d9-48200d295e7a
98	98	0	GBIF Benin	efb9c00e-f802-45dd-8826-a52ec45b89ff	dcb5f313-ff74-41d0-a276-a67e915e8207
14473	14473	0	DanBIF - Danish Biodiversity Information Facility	4ddd294f-02b7-4359-ac33-0806a9ca9c6b	e0459621-92c2-40ac-9934-72b3b1384dc3
10	10	0	Plazi	ffb07bec-2d10-492d-9c37-361fe0b79427	e0ebf12d-e5fe-45d6-b26a-02ad99957e6f
0	6	6	Plazi	ffb07bec-2d10-492d-9c37-361fe0b79427	e2aa8f6c-d352-4c54-a1f7-6a18a912962f
4994	4994	0	National Biodiversity Network	d897a5b9-35ee-4232-94bd-b0bcaac003c2	e680270e-f446-4f39-96ce-6a108e4ec92e
0	5	5	Plazi	ffb07bec-2d10-492d-9c37-361fe0b79427	e699272b-c4df-4702-834b-8291510dc455
0	11	11	Plazi	ffb07bec-2d10-492d-9c37-361fe0b79427	e78df6f0-7e69-4747-ba37-bf14df288f98
21	21	0	Plazi	ffb07bec-2d10-492d-9c37-361fe0b79427	ea6a464d-2aaa-4865-8e05-a02487ce06b8
2072	2072	0	Belgian Biodiversity Platform	fb11cfe1-ebc3-45af-9159-17d9fddbcdac	f70a9c5a-d368-42c5-8482-e7b09d9c70c5
3	3	0	Plazi	ffb07bec-2d10-492d-9c37-361fe0b79427	f8b727ad-d5df-41f8-ba9a-9910d42abed1
53	53	0	Plazi	ffb07bec-2d10-492d-9c37-361fe0b79427	fd2d8509-cd69-426e-907a-edadf413c786
447	447	0	GBIF Spain	1f94b3ca-9345-4d65-afe2-4bace93aa0fe	00fd8b78-ed3f-45a8-a5aa-3d26e089a89d
26	26	0	Plazi	ffb07bec-2d10-492d-9c37-361fe0b79427	012e116b-117c-45e6-95e5-27e0698de2ca
0	27	27	Plazi	ffb07bec-2d10-492d-9c37-361fe0b79427	04e4649b-6e62-4f67-a3e5-744934aeb6e9
18	18	0	Plazi	ffb07bec-2d10-492d-9c37-361fe0b79427	065bf0fe-9b66-4860-9865-c4fdcce67077
0	2	2	Plazi	ffb07bec-2d10-492d-9c37-361fe0b79427	085e7429-bd44-4056-8eb3-42466ec5f177
7	7	0	Plazi	ffb07bec-2d10-492d-9c37-361fe0b79427	0bcee12d-5d3a-4d08-936e-2d0efadea777
26734	26734	0	GBIF India	59d15a9b-ba51-43c3-a53f-304fe6732c04	0bddc88d-8586-4889-9340-4a86eb63abe4
1808	1808	0	Netherlands Biodiversity Information Facility	0909d601-bda2-42df-9e63-a6d51847ebce	0d32a7f0-039c-4c8f-bea9-d7e55fd8e02b
17498	17498	0	U.S. Geological Survey	8618c64a-93e0-4300-b546-7249e5148ed2	111105f7-661d-416e-bb9d-9e291d5fdb1f
6639	6639	0	Participant Node Managers Committee	7f48e0c8-5c96-49ec-b972-30748e339115	11e43d34-3a92-4ed0-b735-6cb56a3169ca
258	258	0	Plazi	ffb07bec-2d10-492d-9c37-361fe0b79427	12a670a0-3b79-4d06-8299-cb195cfce715
140	140	0	GBIF Germany	4f6826f2-4ff6-443d-b966-e6913bd24013	14d52f61-d038-4444-9823-23218998919a
1	1	0	Plazi	ffb07bec-2d10-492d-9c37-361fe0b79427	181c7472-0c85-41bb-a123-58a3e8473c12
112	112	0	Plazi	ffb07bec-2d10-492d-9c37-361fe0b79427	18b7b01a-43f9-4707-b54a-d62d02ee7d34
1232	1232	0	GBIF France	da44cd31-5901-4687-a106-6d1c7734ee3a	1e3037ac-1a97-4c75-9496-19dc66ac9f8e
2212	2212	0	Netherlands Biodiversity Information Facility	0909d601-bda2-42df-9e63-a6d51847ebce	1eaf5f7a-8f76-43eb-82f3-44979a433f0e
6500	9500	3000	GBIF Japan	db5705aa-6a6e-42f1-8942-d77b9f4896ea	1f6939a2-10c8-4fc9-a7de-475bce03d4d7
19880	19880	0	GBIF France	da44cd31-5901-4687-a106-6d1c7734ee3a	23a73082-f8a1-4f47-8088-07c12b7fadf3
0	3	3	Participant Node Managers Committee	7f48e0c8-5c96-49ec-b972-30748e339115	269b5f51-a59a-4ef0-b232-6297366a6ff9
4371	4371	0	GBIF France	da44cd31-5901-4687-a106-6d1c7734ee3a	26b81418-1a24-417a-9ec1-9e1f5a160cf7
27	27	0	Biodiversity Information System of Mexico	b324e8e9-9a4c-44fa-8f1a-7f39ea7ab576	27306e22-4c7c-4695-8771-d91f076522b8
38	38	0	Plazi	ffb07bec-2d10-492d-9c37-361fe0b79427	29a9a4b1-787e-4fe2-a93f-0a57fd8617b9
18	18	0	Plazi	ffb07bec-2d10-492d-9c37-361fe0b79427	2b69ac82-e0a2-4124-9226-3003ae08eb58
20	20	0	GBIF Brazil	cdc9736d-5ff7-4ece-9959-3c744360cdb3	3063a4e0-6259-4717-88d5-74d950001a2e
54	54	0	Plazi	ffb07bec-2d10-492d-9c37-361fe0b79427	30edcc13-bdfb-418e-94d7-7b1afdd79879
25	25	0	Plazi	ffb07bec-2d10-492d-9c37-361fe0b79427	33d1cdcb-a25e-48a8-b935-362bc7275059
23	23	0	Plazi	ffb07bec-2d10-492d-9c37-361fe0b79427	353d2aa4-018e-4701-8f81-4707260dfefc
6	6	0	Plazi	ffb07bec-2d10-492d-9c37-361fe0b79427	37ed1d04-d9db-425c-8dc5-ca631b521e4c
0	50	50	Ocean Biodiversity Information System	ba0670b9-4186-41e6-8e70-f9cb3065551a	3964e104-0e0f-4a08-b7c1-1bf5f1bad8e4
16442	16442	0	U.S. Geological Survey	8618c64a-93e0-4300-b546-7249e5148ed2	3c89212d-104e-43ef-913a-bc71592551ff
340	340	0	Colombian Biodiversity Information System	7e865cba-7c46-417b-ade5-97f2cf5b7be0	3d90f12c-9217-4ad8-9133-bd3be05db5cd
0	5	5	Plazi	ffb07bec-2d10-492d-9c37-361fe0b79427	3e32406d-f049-4d51-bf23-6e998f846d19
172	172	0	Ocean Biodiversity Information System	ba0670b9-4186-41e6-8e70-f9cb3065551a	3e652fbf-04f3-4b32-8cc0-a90c54ebf743
478	485	7	Participant Node Managers Committee	7f48e0c8-5c96-49ec-b972-30748e339115	423aa01c-3759-48d4-8397-41579b19dd9b
220	69	-151	GBIF Germany	4f6826f2-4ff6-443d-b966-e6913bd24013	43289291-7a1b-4ccd-8171-74157cc2c196
10218	10218	0	Participant Node Managers Committee	7f48e0c8-5c96-49ec-b972-30748e339115	476e1608-b595-4dc1-a633-f37eb158d8ae
30053	31352	1299	National Biodiversity Network	d897a5b9-35ee-4232-94bd-b0bcaac003c2	4e19e2b8-9934-4b5a-a51f-62df5a9802e7
12	12	0	Participant Node Managers Committee	7f48e0c8-5c96-49ec-b972-30748e339115	4fbe8c40-8690-4b7e-99b1-60d5d90cab60
18	18	0	Plazi	ffb07bec-2d10-492d-9c37-361fe0b79427	504bf931-dfaa-4c1c-aef2-c22eb0d872d2
1554	1554	0	U.S. Geological Survey	8618c64a-93e0-4300-b546-7249e5148ed2	5231f12c-2057-4d86-9c86-c3cf7f326c19
337	337	0	GBIF Germany	4f6826f2-4ff6-443d-b966-e6913bd24013	523af044-96a0-4eec-8174-21526871b9d4
6	6	0	Plazi	ffb07bec-2d10-492d-9c37-361fe0b79427	53ad3f05-691d-4b34-8c76-8834d4908989
2	2	0	Participant Node Managers Committee	7f48e0c8-5c96-49ec-b972-30748e339115	54875967-54ba-483b-a17e-5a691719d6d3
0	3	3	Plazi	ffb07bec-2d10-492d-9c37-361fe0b79427	54953aaf-a88c-401c-b0f7-a4b6be5012df
2029	2029	0	ASEAN Centre for Biodiversity	af2a0fa1-4c8e-4bdc-8954-b1a55e32b0f1	5853051c-42f5-4246-bfde-4aaba3ef3bf8
233	233	0	Plazi	ffb07bec-2d10-492d-9c37-361fe0b79427	5b4badde-70a0-4197-af5e-4a7b691635f7
16572	16572	0	Belgian Biodiversity Platform	fb11cfe1-ebc3-45af-9159-17d9fddbcdac	5d637678-cb64-4863-a12b-78b4e1a56628
3	3	0	Plazi	ffb07bec-2d10-492d-9c37-361fe0b79427	5e67f491-f0ee-4236-93d7-bdebaceccb6e
22031	22031	0	GBIF Spain	1f94b3ca-9345-4d65-afe2-4bace93aa0fe	5f15bccf-9f93-41c9-8de3-34887b2a76c9
86	86	0	Plazi	ffb07bec-2d10-492d-9c37-361fe0b79427	5f6ec74f-acfe-4eea-98fb-9576e2305f20
38	38	0	Participant Node Managers Committee	7f48e0c8-5c96-49ec-b972-30748e339115	63161cbc-5b25-439a-b8b7-8d114ddada2f
3	3	0	GBIF Germany	4f6826f2-4ff6-443d-b966-e6913bd24013	634d3d5c-f762-11e1-a439-00145eb45e9a
19	18	-1	GBIF Germany	4f6826f2-4ff6-443d-b966-e6913bd24013	65b70230-f762-11e1-a439-00145eb45e9a
137	137	0	GBIF Germany	4f6826f2-4ff6-443d-b966-e6913bd24013	65e54cee-f762-11e1-a439-00145eb45e9a
589	475	-114	GBIF Germany	4f6826f2-4ff6-443d-b966-e6913bd24013	6621796c-f762-11e1-a439-00145eb45e9a
28	28	0	Plazi	ffb07bec-2d10-492d-9c37-361fe0b79427	6790c5bd-2f80-4161-bb6f-2330f95620ed
67	67	0	GBIF Germany	4f6826f2-4ff6-443d-b966-e6913bd24013	67be683e-f762-11e1-a439-00145eb45e9a
11675904	12462672	786768	DanBIF - Danish Biodiversity Information Facility	4ddd294f-02b7-4359-ac33-0806a9ca9c6b	67fabcac-a638-40a6-9bea-aeca8aced9f1
0	2	2	Plazi	ffb07bec-2d10-492d-9c37-361fe0b79427	68e7b016-424e-47a6-813a-1705cbed3de6
803	803	0	GBIF Germany	4f6826f2-4ff6-443d-b966-e6913bd24013	697a03b8-f762-11e1-a439-00145eb45e9a
1072	380	-692	GBIF Germany	4f6826f2-4ff6-443d-b966-e6913bd24013	69ef14dc-f762-11e1-a439-00145eb45e9a
0	2	2	Plazi	ffb07bec-2d10-492d-9c37-361fe0b79427	6a67bcc8-1bb3-41b2-8419-641126a9e64e
3902	3902	0	Scientific Committee on Antarctic Research	51e4e8ff-bff0-4996-8b27-9107d61b3478	6bf0f3b3-053d-435d-ac96-1074625b937c
9687	9687	0	GBIF Germany	4f6826f2-4ff6-443d-b966-e6913bd24013	6c9e2fa7-3725-4a82-bc03-6c4c1fb2a410
48	48	0	GBIF Germany	4f6826f2-4ff6-443d-b966-e6913bd24013	6ceb9b7e-f762-11e1-a439-00145eb45e9a
0	61	61	GBIF France	da44cd31-5901-4687-a106-6d1c7734ee3a	6d03bc1e-1893-48ee-8d47-fc9f95dba7dc
38	38	0	GBIF Germany	4f6826f2-4ff6-443d-b966-e6913bd24013	71bd453a-f762-11e1-a439-00145eb45e9a
0	2	2	Plazi	ffb07bec-2d10-492d-9c37-361fe0b79427	73631dea-9e08-4151-bf2b-06f8cefd2829
3	3	0	Plazi	ffb07bec-2d10-492d-9c37-361fe0b79427	738ac1ef-a475-41bb-9dea-e42e1f0d812e
8	8	0	Plazi	ffb07bec-2d10-492d-9c37-361fe0b79427	7463f14f-13dd-4a65-a52b-677c86846cc2
0	11	11	Plazi	ffb07bec-2d10-492d-9c37-361fe0b79427	7512ea34-0e4e-407d-baa0-c1df9aad90e1
108	108	0	GBIF Germany	4f6826f2-4ff6-443d-b966-e6913bd24013	758c5502-f762-11e1-a439-00145eb45e9a
126	126	0	GBIF Germany	4f6826f2-4ff6-443d-b966-e6913bd24013	75bfbd5c-f762-11e1-a439-00145eb45e9a
0	91	91	Ocean Biodiversity Information System	ba0670b9-4186-41e6-8e70-f9cb3065551a	76c0d92b-04a8-4c5d-9dbf-9d835149b6f5
0	23745	23745	DanBIF - Danish Biodiversity Information Facility	4ddd294f-02b7-4359-ac33-0806a9ca9c6b	78b270c5-a5fe-4f1d-b87e-eb0dd7b7ae02
2652	1700	-952	GBIF Germany	4f6826f2-4ff6-443d-b966-e6913bd24013	7a1a8d96-f762-11e1-a439-00145eb45e9a
2509	2509	0	GBIF Spain	1f94b3ca-9345-4d65-afe2-4bace93aa0fe	7a2d4cc4-f762-11e1-a439-00145eb45e9a
16	16	0	Plazi	ffb07bec-2d10-492d-9c37-361fe0b79427	7a2ff843-cb04-4e59-a663-58d3073b2fc3
629	629	0	GBIF Germany	4f6826f2-4ff6-443d-b966-e6913bd24013	7bbd7956-f762-11e1-a439-00145eb45e9a
754	494	-260	GBIF Germany	4f6826f2-4ff6-443d-b966-e6913bd24013	7c589dd2-f762-11e1-a439-00145eb45e9a
2	2	0	Plazi	ffb07bec-2d10-492d-9c37-361fe0b79427	8079e2d5-703c-49b6-807c-bd91345ba53c
0	3	3	Plazi	ffb07bec-2d10-492d-9c37-361fe0b79427	8442a09a-dcb2-4c42-9d74-057d2e7b5b95
1023	1023	0	Canada Biodiversity Information Facility	8f83fc96-c966-4126-83f7-bf044dc49efa	846ac3b0-f762-11e1-a439-00145eb45e9a
41477	41477	0	U.S. Geological Survey	8618c64a-93e0-4300-b546-7249e5148ed2	847aa410-f762-11e1-a439-00145eb45e9a
0	3	3	Plazi	ffb07bec-2d10-492d-9c37-361fe0b79427	8502da09-b243-47a9-9fa2-4b0112eb1047
802	802	0	Ocean Biodiversity Information System	ba0670b9-4186-41e6-8e70-f9cb3065551a	859a1f24-f762-11e1-a439-00145eb45e9a
3974	3974	0	Ocean Biodiversity Information System	ba0670b9-4186-41e6-8e70-f9cb3065551a	8927ad78-f762-11e1-a439-00145eb45e9a
62	62	0	Plazi	ffb07bec-2d10-492d-9c37-361fe0b79427	894f733e-8e3f-45e0-aa9b-b5e70faae067
110	110	0	Colombian Biodiversity Information System	7e865cba-7c46-417b-ade5-97f2cf5b7be0	8b491553-8a7f-49e4-abee-01ecebb1f5a7
83	83	0	GBIF Germany	4f6826f2-4ff6-443d-b966-e6913bd24013	8bb8c414-f762-11e1-a439-00145eb45e9a
37	23	-14	GBIF Germany	4f6826f2-4ff6-443d-b966-e6913bd24013	8c6e1d14-f762-11e1-a439-00145eb45e9a
276	276	0	GBIF New Zealand	4f9fd726-20dd-445e-89a1-8ed93792276f	8cd25ec8-a6e6-4fdb-a406-07ce729bd0c9
720	310	-410	GBIF Germany	4f6826f2-4ff6-443d-b966-e6913bd24013	91ab6ed0-f762-11e1-a439-00145eb45e9a
1	1	0	GBIF Germany	4f6826f2-4ff6-443d-b966-e6913bd24013	938ac3d6-f762-11e1-a439-00145eb45e9a
0	4	4	Plazi	ffb07bec-2d10-492d-9c37-361fe0b79427	949546cd-ee8d-4803-805d-ddabd1b371cd
1	1	0	Plazi	ffb07bec-2d10-492d-9c37-361fe0b79427	95cf5bec-8224-45bc-a584-7e1d3179b8b5
159	159	0	GBIF Germany	4f6826f2-4ff6-443d-b966-e6913bd24013	9610ceca-f762-11e1-a439-00145eb45e9a
0	1320	1320	GBIF Chile	a8b16421-d80b-4ef3-8f22-098b01a89255	9b7806e5-bd00-46c3-a5e1-3b3ee5c0e7f1
437	437	0	GBIF Brazil	cdc9736d-5ff7-4ece-9959-3c744360cdb3	9c63bc91-3b2b-4f5e-9eb8-037c3c11ca67
2500	2500	0	Korean Biodiversity Information Facility	e0a1e772-0177-4800-94b4-2d023fe6cdf4	9ee980a9-b373-4b8a-a5be-2926368e500e
0	6068	6068	Colombian Biodiversity Information System	7e865cba-7c46-417b-ade5-97f2cf5b7be0	a00debff-435f-477d-a282-4699631d5f7a
451	451	0	GBIF France	da44cd31-5901-4687-a106-6d1c7734ee3a	a01da936-91df-435d-8daf-bf2901ecc496
0	171	171	Ocean Biodiversity Information System	ba0670b9-4186-41e6-8e70-f9cb3065551a	a29805e7-cfe2-4fcd-8510-0373ea480e16
52	52	0	Plazi	ffb07bec-2d10-492d-9c37-361fe0b79427	a36889f4-ce38-49d0-a8c5-f0593505877a
79	79	0	GBIF Sweden	a0b3be64-6525-4387-ac67-a499950f92e1	a7159cc2-b973-465b-95be-139220afbb01
5656	5656	0	National Biodiversity Network	d897a5b9-35ee-4232-94bd-b0bcaac003c2	a73063f6-a43c-4021-a49c-7a6fd18fc635
13929	13929	0	GBIF Brazil	cdc9736d-5ff7-4ece-9959-3c744360cdb3	a883af65-4061-4150-b905-e3c3e0e0b4d1
0	10159	10159	Ocean Biodiversity Information System	ba0670b9-4186-41e6-8e70-f9cb3065551a	a93091b1-d98b-4d41-a4c0-381acfe35db1
0	6447	6447	Participant Node Managers Committee	7f48e0c8-5c96-49ec-b972-30748e339115	a96f7777-8222-4f17-be6d-295d8d067766
133	133	0	GBIF France	da44cd31-5901-4687-a106-6d1c7734ee3a	ab05f907-69ba-4506-a530-54979863662b
4431	4431	0	GBIF France	da44cd31-5901-4687-a106-6d1c7734ee3a	aec1b760-e78a-4317-b032-4f5670317abf
808	808	0	GBIF France	da44cd31-5901-4687-a106-6d1c7734ee3a	b0f9b3db-b408-4a2c-baae-dc2da08ea846
0	77	77	Plazi	ffb07bec-2d10-492d-9c37-361fe0b79427	b1eb9973-f581-4a60-9c87-68b7ae4b3591
743	743	0	Colombian Biodiversity Information System	7e865cba-7c46-417b-ade5-97f2cf5b7be0	b43bf4c6-5aa7-4584-b246-24588d3d9d4c
182	182	0	Atlas of Living Australia	4a6f1b71-969e-4fc5-a693-282b05e1220c	b58d2f54-4d35-405b-8982-c3b77c64ddd2
355	355	0	GBIF Germany	4f6826f2-4ff6-443d-b966-e6913bd24013	b8178afc-9e5b-4287-989d-576395d0a405
115	115	0	Plazi	ffb07bec-2d10-492d-9c37-361fe0b79427	b88bfa2d-4b83-41f8-a145-a95ca196960f
1	1	0	Plazi	ffb07bec-2d10-492d-9c37-361fe0b79427	b9a0984e-4431-4537-916a-141a6c8d7533
80	80	0	GBIF France	da44cd31-5901-4687-a106-6d1c7734ee3a	bad17466-7611-4b68-a80b-9b70e555add0
6879	6879	0	National Biodiversity Network	d897a5b9-35ee-4232-94bd-b0bcaac003c2	bc145cec-5b55-4842-9086-149103d63f1e
0	7	7	Plazi	ffb07bec-2d10-492d-9c37-361fe0b79427	bc9e21fb-d9df-44fa-a329-c0557fa713d3
0	713	713	GBIF Portugal	673f7038-4262-4149-b753-5658a4e912f6	bdfe1656-7b5a-4ee5-b334-72b2af17fd9d
14	14	0	Plazi	ffb07bec-2d10-492d-9c37-361fe0b79427	bf10fc3c-355f-4e4c-a8a9-8283c103785d
358	358	0	GBIF Germany	4f6826f2-4ff6-443d-b966-e6913bd24013	c16f4f39-f329-4763-bb77-b9856f185c1f
6	6	0	Plazi	ffb07bec-2d10-492d-9c37-361fe0b79427	c1873aba-db7d-42c4-b408-b172b04c4ca5
0	1	1	Plazi	ffb07bec-2d10-492d-9c37-361fe0b79427	c1a6f6c7-5239-4d16-b6e4-e846dcf6c46b
28	28	0	Plazi	ffb07bec-2d10-492d-9c37-361fe0b79427	c2067ab6-9fe9-419e-88c9-c49b3be94c4e
2	2	0	Participant Node Managers Committee	7f48e0c8-5c96-49ec-b972-30748e339115	c21fb84e-d228-46ec-a3a0-d90beedd3ea3
1	1	0	Participant Node Managers Committee	7f48e0c8-5c96-49ec-b972-30748e339115	c2e3d908-6cfa-4b10-9998-ab2337cdc38c
4	4	0	Plazi	ffb07bec-2d10-492d-9c37-361fe0b79427	c2faca07-00ed-422b-b79a-8d6795b74685
2	2	0	Plazi	ffb07bec-2d10-492d-9c37-361fe0b79427	c54f0533-c65e-4007-acda-5eb84ad4a321
0	199	199	Ocean Biodiversity Information System	ba0670b9-4186-41e6-8e70-f9cb3065551a	c56465bf-5c7d-44ac-bacc-9eee60960708
264	264	0	GBIF Malawi	2a42e4d7-ad4a-41b3-84c4-de4aa7b74d35	c63adab0-ef6a-4d44-9363-4d5a433cba20
172	172	0	GBIF France	da44cd31-5901-4687-a106-6d1c7734ee3a	c9147f19-8032-48df-8dfc-ee9571956634
2647	2647	0	Participant Node Managers Committee	7f48e0c8-5c96-49ec-b972-30748e339115	cadacd9e-2431-4dc1-a46e-c6dacac2b24e
120	120	0	Ocean Biodiversity Information System	ba0670b9-4186-41e6-8e70-f9cb3065551a	cce65821-97c9-4241-9274-22d93917d3a2
0	9307	9307	GBIF Benin	efb9c00e-f802-45dd-8826-a52ec45b89ff	cd4b5c0a-f6e2-4bd2-a1f1-c22ead95ee5d
11	11	0	Plazi	ffb07bec-2d10-492d-9c37-361fe0b79427	cdb643fa-8419-4258-991f-5de8ef53f90f
1	1	0	Plazi	ffb07bec-2d10-492d-9c37-361fe0b79427	cedd53a8-c054-4163-a32c-11df912227ae
3	3	0	Plazi	ffb07bec-2d10-492d-9c37-361fe0b79427	cf2958a4-a211-4e67-939c-5ea718685380
76	76	0	Plazi	ffb07bec-2d10-492d-9c37-361fe0b79427	cf4bc9c0-8ae1-4c20-b4bf-52ee84115b5d
50301	50301	0	Biodiversity Information System of Mexico	b324e8e9-9a4c-44fa-8f1a-7f39ea7ab576	d1ace6d5-cb8f-486b-8dbc-127bb1d679c1
11327	11327	0	GBIF France	da44cd31-5901-4687-a106-6d1c7734ee3a	d3297fee-3a7b-49b6-9142-a4d9a7f3d713
21	21	0	Plazi	ffb07bec-2d10-492d-9c37-361fe0b79427	d35cedde-4442-4a14-be2d-d5213a12ab29
15	15	0	Plazi	ffb07bec-2d10-492d-9c37-361fe0b79427	d3e2c92b-09de-471c-9393-d98ba770c531
19929	19929	0	National Biodiversity Network	d897a5b9-35ee-4232-94bd-b0bcaac003c2	d4eb19bc-fdce-415f-9a61-49b036009840
7	7	0	Plazi	ffb07bec-2d10-492d-9c37-361fe0b79427	d53c2985-17f2-40f0-a70b-d6d1f0ba9d9a
32	32	0	Colombian Biodiversity Information System	7e865cba-7c46-417b-ade5-97f2cf5b7be0	d5e29dca-92d7-43d1-9d74-7e8c4f4f585d
33	33	0	Plazi	ffb07bec-2d10-492d-9c37-361fe0b79427	d65ab678-3468-4fdc-8467-aad3940a4ae8
0	14	14	Plazi	ffb07bec-2d10-492d-9c37-361fe0b79427	d7a40f10-4145-499c-97be-3f9bc5088d2f
2914	2914	0	National Biodiversity Network	d897a5b9-35ee-4232-94bd-b0bcaac003c2	d7c42893-5da2-4983-9e59-6b6697c5ca8b
1009	1009	0	GBIF France	da44cd31-5901-4687-a106-6d1c7734ee3a	d823d849-7a00-4196-88d5-48f33565b641
1	1	0	Plazi	ffb07bec-2d10-492d-9c37-361fe0b79427	d8a22b0c-d1aa-43ce-8842-382c8eefc911
2	2	0	Plazi	ffb07bec-2d10-492d-9c37-361fe0b79427	d9eed8b0-bebd-4368-96cb-33161e94cd6d
0	11	11	Plazi	ffb07bec-2d10-492d-9c37-361fe0b79427	db93786e-c067-494a-ab4a-a7e30bccb1fb
1	1	0	Plazi	ffb07bec-2d10-492d-9c37-361fe0b79427	e011d40f-29a7-426f-b91b-2a6012a5a174
29	29	0	Plazi	ffb07bec-2d10-492d-9c37-361fe0b79427	e5af7f90-2ea8-4851-896d-1298c3b5139d
484	484	0	GBIF Germany	4f6826f2-4ff6-443d-b966-e6913bd24013	e6d33a0d-c54c-49d7-bb05-625b27d49217
17	17	0	Colombian Biodiversity Information System	7e865cba-7c46-417b-ade5-97f2cf5b7be0	e89f4cfd-5f73-4179-aefb-e33313d89212
66	66	0	GBIF Argentina	2426a871-9feb-40a1-96c6-0c593a76b835	ec18be5e-81c7-404f-9b5e-4828eccb6491
29961	29961	0	GBIF Norway	4f829580-180d-46a9-9c87-ed8ec959b545	ec1922d6-292e-4443-8bae-deba1092856b
0	12001	12001	GBIF Chile	a8b16421-d80b-4ef3-8f22-098b01a89255	ec4e6fa9-9bae-4e5b-af77-17cf0a1a6725
16	16	0	Plazi	ffb07bec-2d10-492d-9c37-361fe0b79427	eec249bd-6e6d-494b-99c8-c0d91c3be8ad
19612	19616	4	National Biodiversity Network	d897a5b9-35ee-4232-94bd-b0bcaac003c2	efde0b80-02d6-4e50-9e6a-4b4329bfeec6
1	1	0	GBIF France	da44cd31-5901-4687-a106-6d1c7734ee3a	f0162052-9636-4c9f-b0fc-fc9ec3fcd669
4685	4685	0	Colombian Biodiversity Information System	7e865cba-7c46-417b-ade5-97f2cf5b7be0	f04bedf8-9c2b-4816-a1fe-c68a1d607e06
0	4	4	Plazi	ffb07bec-2d10-492d-9c37-361fe0b79427	f11cd46a-68f3-4e20-80c6-4a35877dbbf5
154	154	0	Plazi	ffb07bec-2d10-492d-9c37-361fe0b79427	f2fc3833-3867-4879-9e6b-a23b04634e8e
12	12	0	Plazi	ffb07bec-2d10-492d-9c37-361fe0b79427	f2fd53f0-4029-4df6-bd91-d9b2ea0fc8c2
44365	44365	0	National Biodiversity Network	d897a5b9-35ee-4232-94bd-b0bcaac003c2	f4f5a942-d771-4f5f-97ae-24324ea94cf4
0	7	7	Plazi	ffb07bec-2d10-492d-9c37-361fe0b79427	f5739d78-7cb5-4373-82dd-09eb248f7c30
0	5	5	Plazi	ffb07bec-2d10-492d-9c37-361fe0b79427	f6e526b5-da1b-4f42-8ed5-0c70704d67fb
0	88	88	Ocean Biodiversity Information System	ba0670b9-4186-41e6-8e70-f9cb3065551a	f86bfaa5-7fad-4b02-8bab-745eb94f212b
185423	185423	0	GBIF France	da44cd31-5901-4687-a106-6d1c7734ee3a	f97eeccc-8409-4075-ab7c-8980f73c0d0d
14326	14326	0	GBIF France	da44cd31-5901-4687-a106-6d1c7734ee3a	fab1a7c1-c288-4cee-bea3-b682fe5d1608
50	50	0	Plazi	ffb07bec-2d10-492d-9c37-361fe0b79427	fb9d499d-fe53-4f29-b670-2b2bb67d6412
446	446	0	GBIF France	da44cd31-5901-4687-a106-6d1c7734ee3a	fedc7fdd-ebec-448c-937f-5534f884eab7
156	156	0	Colombian Biodiversity Information System	7e865cba-7c46-417b-ade5-97f2cf5b7be0	ff562a82-53c1-48ca-bfdc-19475197cf92
2	2	0	Plazi	ffb07bec-2d10-492d-9c37-361fe0b79427	0580c33e-86c1-485d-8050-28b5c367cbc1
0	12	12	Plazi	ffb07bec-2d10-492d-9c37-361fe0b79427	0693871c-eb19-4dd6-a9e0-6f57287bb331
0	274	274	GBIF Japan	db5705aa-6a6e-42f1-8942-d77b9f4896ea	07822a89-26a1-4e20-a733-08aae375638b
11429	11726	297	U.S. Geological Survey	8618c64a-93e0-4300-b546-7249e5148ed2	08502f36-77c5-4fca-aeda-3c306b5179f9
454	454	0	Biodiversity Information System of Mexico	b324e8e9-9a4c-44fa-8f1a-7f39ea7ab576	0923383b-1fc2-4900-a0eb-4e712d5a65d8
3	3	0	Plazi	ffb07bec-2d10-492d-9c37-361fe0b79427	0bc8f343-f65e-4b09-8a15-c7de66f249d8
0	2	2	Plazi	ffb07bec-2d10-492d-9c37-361fe0b79427	0cf13305-cbeb-4d7a-bf23-474b18442bbd
89	89	0	Plazi	ffb07bec-2d10-492d-9c37-361fe0b79427	0e48a26e-8d13-4016-8e18-de1ef7a9c2a9
458187	458187	0	National Biodiversity Data Centre	422b00b2-6c94-4bb6-976b-c359916efdb8	115f45ed-4334-4144-b5c5-669027e9b191
6	6	0	Plazi	ffb07bec-2d10-492d-9c37-361fe0b79427	11882ed8-9a3c-4473-a2c3-b69fc570aaac
31	31	0	Plazi	ffb07bec-2d10-492d-9c37-361fe0b79427	149953e2-6768-455f-afdc-ea5dacad1299
13	13	0	Plazi	ffb07bec-2d10-492d-9c37-361fe0b79427	14dc91cd-08e3-48ad-8af4-92eae908333a
5225	5200	-25	Biodiversity Information System of Mexico	b324e8e9-9a4c-44fa-8f1a-7f39ea7ab576	1d8ade61-ffe9-4950-a3d2-26c99ca28b15
0	7	7	Plazi	ffb07bec-2d10-492d-9c37-361fe0b79427	1e68a545-8007-4a65-a0c1-a91ab041e613
80	80	0	GBIF France	da44cd31-5901-4687-a106-6d1c7734ee3a	1f523a5d-5349-467c-a5ef-f688c38106b5
0	5	5	Plazi	ffb07bec-2d10-492d-9c37-361fe0b79427	20a0a9ef-f9e3-48cc-bdde-6fc03c8f8afe
529	529	0	GBIF Germany	4f6826f2-4ff6-443d-b966-e6913bd24013	22bc7ea9-a5a5-4faa-936f-d1d6215b1bb5
140	140	0	GBIF France	da44cd31-5901-4687-a106-6d1c7734ee3a	250791c8-eae3-436b-84fe-500d771d4bc0
20	20	0	Plazi	ffb07bec-2d10-492d-9c37-361fe0b79427	258540d4-5697-4211-b5ab-e5ee1b4866a5
1300	1300	0	National Biodiversity Network	d897a5b9-35ee-4232-94bd-b0bcaac003c2	2715ac80-d91e-4a60-8db5-b73973292308
0	25	25	Plazi	ffb07bec-2d10-492d-9c37-361fe0b79427	2870c8c7-8085-4f42-beea-20ad52b34cd8
291	291	0	Plazi	ffb07bec-2d10-492d-9c37-361fe0b79427	2a6a5c13-9291-4395-a8db-907381c8075e
20094	20094	0	National Biodiversity Network	d897a5b9-35ee-4232-94bd-b0bcaac003c2	2a8dde51-80f0-496b-8d2b-f74670b1d042
0	37	37	Plazi	ffb07bec-2d10-492d-9c37-361fe0b79427	2c0df9da-342b-4b9a-bfde-0a6a97fabc5b
27024	27024	0	Ocean Biodiversity Information System	ba0670b9-4186-41e6-8e70-f9cb3065551a	2d241a4e-8fce-4be6-9d59-e416f50d4566
0	2	2	Plazi	ffb07bec-2d10-492d-9c37-361fe0b79427	2de2ed1d-d01d-4794-87a7-8a8fca6d67a4
0	10	10	Plazi	ffb07bec-2d10-492d-9c37-361fe0b79427	30710da6-c570-4451-9af1-03597eb961d6
0	900	900	Korean Biodiversity Information Facility	e0a1e772-0177-4800-94b4-2d023fe6cdf4	30d624cf-a91f-47d0-9c55-25de89213e75
8	8	0	Plazi	ffb07bec-2d10-492d-9c37-361fe0b79427	321f64c9-b238-4e12-bb3a-376618d0091c
1	1	0	Plazi	ffb07bec-2d10-492d-9c37-361fe0b79427	3401c806-f2ed-4cd4-8449-0a169bc8d179
256	256	0	Colombian Biodiversity Information System	7e865cba-7c46-417b-ade5-97f2cf5b7be0	345d4cae-dee0-415b-ae42-af4058556e91
0	1	1	Plazi	ffb07bec-2d10-492d-9c37-361fe0b79427	3ab537ff-a436-454f-8ff4-320888ae57ae
1174	1174	0	National Biodiversity Network	d897a5b9-35ee-4232-94bd-b0bcaac003c2	3cc1bf3e-e503-4d2a-9b23-a54b9269ebbe
0	14	14	Plazi	ffb07bec-2d10-492d-9c37-361fe0b79427	3cea39ec-86b6-419b-8cdb-5baeedc4cc43
990	990	0	National Biodiversity Network	d897a5b9-35ee-4232-94bd-b0bcaac003c2	4328ef41-4c4b-4785-9fc3-8b5bfcb639c1
26918	26918	0	GBIF Japan	db5705aa-6a6e-42f1-8942-d77b9f4896ea	4560023d-c8cb-42d2-bfa5-2fa893f9175c
1817130	1817130	0	GBIF Norway	4f829580-180d-46a9-9c87-ed8ec959b545	492d63a8-4978-4bc7-acd8-7d0e3ac0e744
51	51	0	GBIF France	da44cd31-5901-4687-a106-6d1c7734ee3a	4d7f9de0-14de-4a91-930f-9741c824cdf0
5	5	0	GBIF France	da44cd31-5901-4687-a106-6d1c7734ee3a	4defbf0b-fa09-433b-a15b-ebbb94b0851e
2	2	0	Plazi	ffb07bec-2d10-492d-9c37-361fe0b79427	4ff891c9-9886-494e-8810-9c169fe39df1
1561	1561	0	GBIF France	da44cd31-5901-4687-a106-6d1c7734ee3a	530d548b-e415-46cc-844e-fb8d1299f710
1	1	0	Plazi	ffb07bec-2d10-492d-9c37-361fe0b79427	54c1703c-f366-41f6-b467-ff346a5cba4d
6	6	0	Plazi	ffb07bec-2d10-492d-9c37-361fe0b79427	559cdb43-c05a-4336-b8b5-c9dde799f2a9
2	2	0	Plazi	ffb07bec-2d10-492d-9c37-361fe0b79427	55eab727-20e9-4593-a2b9-92f2473f1b63
1591	1733	142	National Biodiversity Network	d897a5b9-35ee-4232-94bd-b0bcaac003c2	5850a253-4e7c-44ec-a784-87a52fd0556a
189518	189553	35	U.S. Geological Survey	8618c64a-93e0-4300-b546-7249e5148ed2	59825263-9f89-43a9-8f22-c22a6a53b8fc
92286	94298	2012	U.S. Geological Survey	8618c64a-93e0-4300-b546-7249e5148ed2	5b0cfab4-9145-4fe2-89e3-fcbc294aa5b2
228	228	0	GBIF France	da44cd31-5901-4687-a106-6d1c7734ee3a	5bdd5d38-85e0-4f20-a9d8-6b1df455acd8
2	2	0	Plazi	ffb07bec-2d10-492d-9c37-361fe0b79427	5c57ce0b-0dc3-4509-8068-a9817e8f908b
353	353	0	GBIF France	da44cd31-5901-4687-a106-6d1c7734ee3a	5c9aa10c-3d7f-46ab-b06f-11f49ca1a6d3
22	22	0	GBIF Germany	4f6826f2-4ff6-443d-b966-e6913bd24013	61fa0bd8-f762-11e1-a439-00145eb45e9a
16	16	0	GBIF Germany	4f6826f2-4ff6-443d-b966-e6913bd24013	62882bb6-f762-11e1-a439-00145eb45e9a
11	11	0	GBIF Germany	4f6826f2-4ff6-443d-b966-e6913bd24013	6323a578-f762-11e1-a439-00145eb45e9a
15	15	0	GBIF Germany	4f6826f2-4ff6-443d-b966-e6913bd24013	633570aa-f762-11e1-a439-00145eb45e9a
144	144	0	GBIF Germany	4f6826f2-4ff6-443d-b966-e6913bd24013	64158744-f762-11e1-a439-00145eb45e9a
127	127	0	GBIF Germany	4f6826f2-4ff6-443d-b966-e6913bd24013	644c6f02-f762-11e1-a439-00145eb45e9a
42	42	0	GBIF Germany	4f6826f2-4ff6-443d-b966-e6913bd24013	648b2968-f762-11e1-a439-00145eb45e9a
2	2	0	Plazi	ffb07bec-2d10-492d-9c37-361fe0b79427	64a446eb-b7c8-4685-a80b-70830e4419a4
0	25	25	Plazi	ffb07bec-2d10-492d-9c37-361fe0b79427	64bf7928-3aae-4bea-9b2e-c540760818b1
104	104	0	GBIF Germany	4f6826f2-4ff6-443d-b966-e6913bd24013	64e4aa74-f762-11e1-a439-00145eb45e9a
757	757	0	GBIF Germany	4f6826f2-4ff6-443d-b966-e6913bd24013	64f79aa8-f762-11e1-a439-00145eb45e9a
22	21	-1	GBIF Germany	4f6826f2-4ff6-443d-b966-e6913bd24013	65ca02b8-f762-11e1-a439-00145eb45e9a
43	37	-6	GBIF Germany	4f6826f2-4ff6-443d-b966-e6913bd24013	65cc816e-f762-11e1-a439-00145eb45e9a
0	3	3	Plazi	ffb07bec-2d10-492d-9c37-361fe0b79427	663c293f-d9a8-4ccd-a38c-76e1666ae440
32	32	0	GBIF Germany	4f6826f2-4ff6-443d-b966-e6913bd24013	674158f8-f762-11e1-a439-00145eb45e9a
111	111	0	GBIF Germany	4f6826f2-4ff6-443d-b966-e6913bd24013	688d95aa-f762-11e1-a439-00145eb45e9a
112	112	0	National Biodiversity Network	d897a5b9-35ee-4232-94bd-b0bcaac003c2	69350aed-a3b7-4713-963a-3d57e16ab1bd
110	110	0	GBIF Germany	4f6826f2-4ff6-443d-b966-e6913bd24013	69c98028-f762-11e1-a439-00145eb45e9a
6	6	0	Plazi	ffb07bec-2d10-492d-9c37-361fe0b79427	69e1e398-4dbc-41e1-accd-037dc729ee40
17	17	0	Plazi	ffb07bec-2d10-492d-9c37-361fe0b79427	6a763966-1f89-40a7-8b6c-f7acd747e4b0
2	2	0	GBIF Germany	4f6826f2-4ff6-443d-b966-e6913bd24013	6ad9d29c-f762-11e1-a439-00145eb45e9a
14	14	0	GBIF Germany	4f6826f2-4ff6-443d-b966-e6913bd24013	6c0943fa-f762-11e1-a439-00145eb45e9a
47	47	0	GBIF Germany	4f6826f2-4ff6-443d-b966-e6913bd24013	6c9e91b2-f762-11e1-a439-00145eb45e9a
0	3	3	Plazi	ffb07bec-2d10-492d-9c37-361fe0b79427	6cb29946-e99a-4ecc-a26c-47e7679a342c
4	4	0	Plazi	ffb07bec-2d10-492d-9c37-361fe0b79427	7002a007-634a-450e-a142-e9326167636d
3	3	0	Plazi	ffb07bec-2d10-492d-9c37-361fe0b79427	70ba7429-de3b-43a6-a271-9400944b8651
336	336	0	GBIF Germany	4f6826f2-4ff6-443d-b966-e6913bd24013	713ac344-f762-11e1-a439-00145eb45e9a
1953	1953	0	GBIF Germany	4f6826f2-4ff6-443d-b966-e6913bd24013	7219823c-f762-11e1-a439-00145eb45e9a
84	59	-25	GBIF Germany	4f6826f2-4ff6-443d-b966-e6913bd24013	722f1412-f762-11e1-a439-00145eb45e9a
1	1	0	Plazi	ffb07bec-2d10-492d-9c37-361fe0b79427	726bd2a8-d57a-4c4b-b2c0-053713adb218
2	2	0	GBIF Germany	4f6826f2-4ff6-443d-b966-e6913bd24013	733ca072-f762-11e1-a439-00145eb45e9a
4	4	0	GBIF Germany	4f6826f2-4ff6-443d-b966-e6913bd24013	73a21bfa-f762-11e1-a439-00145eb45e9a
152	152	0	GBIF Germany	4f6826f2-4ff6-443d-b966-e6913bd24013	74676874-f762-11e1-a439-00145eb45e9a
181207	183848	2641	U.S. Geological Survey	8618c64a-93e0-4300-b546-7249e5148ed2	7827f68d-c981-4023-bace-288a03434044
1127	1084	-43	GBIF Germany	4f6826f2-4ff6-443d-b966-e6913bd24013	7972ec26-f762-11e1-a439-00145eb45e9a
2	2	0	GBIF Germany	4f6826f2-4ff6-443d-b966-e6913bd24013	7a909fe0-f762-11e1-a439-00145eb45e9a
0	28	28	Ocean Biodiversity Information System	ba0670b9-4186-41e6-8e70-f9cb3065551a	7a98ec31-af78-4610-9764-5266251ea0f2
420	330	-90	GBIF Germany	4f6826f2-4ff6-443d-b966-e6913bd24013	7c9fc036-f762-11e1-a439-00145eb45e9a
1	1	0	Plazi	ffb07bec-2d10-492d-9c37-361fe0b79427	7cbbb845-2aae-45f8-acda-facd9e929699
1218	420	-798	GBIF Germany	4f6826f2-4ff6-443d-b966-e6913bd24013	7dc415e8-f762-11e1-a439-00145eb45e9a
42	42	0	GBIF Germany	4f6826f2-4ff6-443d-b966-e6913bd24013	7e4e51f2-4420-4fb3-9ccb-381fcdf0f907
990	990	0	GBIF France	da44cd31-5901-4687-a106-6d1c7734ee3a	7ebc26a4-effc-4332-82e9-bf035c0a06f1
3	3	0	Plazi	ffb07bec-2d10-492d-9c37-361fe0b79427	7f55261a-b138-438f-9f50-9aad1688bfb1
1309	1309	0	Biodiversity Information System of Mexico	b324e8e9-9a4c-44fa-8f1a-7f39ea7ab576	7fd67164-f762-11e1-a439-00145eb45e9a
11333	11333	0	Biodiversity Information System of Mexico	b324e8e9-9a4c-44fa-8f1a-7f39ea7ab576	80022480-f762-11e1-a439-00145eb45e9a
16264	16264	0	National Biodiversity Network	d897a5b9-35ee-4232-94bd-b0bcaac003c2	813da395-d324-44d8-9e7f-e9b10190a998
255	255	0	GBIF Germany	4f6826f2-4ff6-443d-b966-e6913bd24013	821b58a4-f762-11e1-a439-00145eb45e9a
9143	9143	0	GBIF Germany	4f6826f2-4ff6-443d-b966-e6913bd24013	8226d882-f762-11e1-a439-00145eb45e9a
4288	4288	0	GBIF Spain	1f94b3ca-9345-4d65-afe2-4bace93aa0fe	835727b6-f762-11e1-a439-00145eb45e9a
1142	1142	0	GBIF France	da44cd31-5901-4687-a106-6d1c7734ee3a	8402f25f-4a16-4817-859e-4fabe8c89579
21619	21619	0	DanBIF - Danish Biodiversity Information Facility	4ddd294f-02b7-4359-ac33-0806a9ca9c6b	84d3829c-f762-11e1-a439-00145eb45e9a
27123	27123	0	Biodiversity Information System of Mexico	b324e8e9-9a4c-44fa-8f1a-7f39ea7ab576	84fbcbee-f762-11e1-a439-00145eb45e9a
209	146	-63	GBIF Germany	4f6826f2-4ff6-443d-b966-e6913bd24013	881be1c4-f762-11e1-a439-00145eb45e9a
745	829	84	Belgian Biodiversity Platform	fb11cfe1-ebc3-45af-9159-17d9fddbcdac	89d08c4f-4727-45be-83d4-1fd96ddee81d
196	58	-138	GBIF Germany	4f6826f2-4ff6-443d-b966-e6913bd24013	8f152d00-f762-11e1-a439-00145eb45e9a
302	302	0	Colombian Biodiversity Information System	7e865cba-7c46-417b-ade5-97f2cf5b7be0	90485473-b608-42f3-bf21-15b34c46c24d
50	38	-12	GBIF Germany	4f6826f2-4ff6-443d-b966-e6913bd24013	90b28950-f762-11e1-a439-00145eb45e9a
149	69	-80	GBIF Germany	4f6826f2-4ff6-443d-b966-e6913bd24013	90f5d2dc-f762-11e1-a439-00145eb45e9a
112	64	-48	GBIF Germany	4f6826f2-4ff6-443d-b966-e6913bd24013	91c06d3a-f762-11e1-a439-00145eb45e9a
77	77	0	GBIF Germany	4f6826f2-4ff6-443d-b966-e6913bd24013	92197a92-f762-11e1-a439-00145eb45e9a
0	1	1	Plazi	ffb07bec-2d10-492d-9c37-361fe0b79427	92cd35a7-016d-41ea-a102-99dd1d682493
36	36	0	GBIF Germany	4f6826f2-4ff6-443d-b966-e6913bd24013	9335e302-f762-11e1-a439-00145eb45e9a
28	28	0	GBIF Germany	4f6826f2-4ff6-443d-b966-e6913bd24013	9396084a-f762-11e1-a439-00145eb45e9a
97	97	0	GBIF Germany	4f6826f2-4ff6-443d-b966-e6913bd24013	93ba7964-f762-11e1-a439-00145eb45e9a
199	199	0	U.S. Geological Survey	8618c64a-93e0-4300-b546-7249e5148ed2	944cdacb-0197-49a4-8a58-d889f257df0d
30	30	0	Plazi	ffb07bec-2d10-492d-9c37-361fe0b79427	94a0febe-8d5b-4f8c-a4e4-175ae92d3878
125650	125650	0	Belgian Biodiversity Platform	fb11cfe1-ebc3-45af-9159-17d9fddbcdac	958b1d2f-2d11-4e94-a828-c8e2d2c013ca
51384	70184	18800	GBIF Japan	db5705aa-6a6e-42f1-8942-d77b9f4896ea	95fd949a-f762-11e1-a439-00145eb45e9a
7	7	0	Plazi	ffb07bec-2d10-492d-9c37-361fe0b79427	96b86947-027d-4d56-915f-cc0cec1822ca
16	16	0	Plazi	ffb07bec-2d10-492d-9c37-361fe0b79427	96e57036-49da-47b3-8941-beaeae685662
30	30	0	Plazi	ffb07bec-2d10-492d-9c37-361fe0b79427	98bbab58-b835-4e6e-98a0-76cd3e07cd99
1	1	0	Plazi	ffb07bec-2d10-492d-9c37-361fe0b79427	99c5e021-c0f5-40d3-b1fe-65bfb0715bf1
388	388	0	Plazi	ffb07bec-2d10-492d-9c37-361fe0b79427	9c9571c7-60b7-403b-b5b9-d10530b90820
125	125	0	Participant Node Managers Committee	7f48e0c8-5c96-49ec-b972-30748e339115	9ccc719a-5c4d-46fd-abe7-41cb8a5c2c50
558	558	0	Colombian Biodiversity Information System	7e865cba-7c46-417b-ade5-97f2cf5b7be0	9ebca80a-2f06-4aad-b129-a588f297c02e
170	170	0	GBIF France	da44cd31-5901-4687-a106-6d1c7734ee3a	9f15655b-d156-4028-a5f5-fd7507c5b037
142013	142443	430	National Biodiversity Network	d897a5b9-35ee-4232-94bd-b0bcaac003c2	a0f95840-b052-48e2-abbf-8ba7b7c13feb
6673	6673	0	GBIF France	da44cd31-5901-4687-a106-6d1c7734ee3a	a2cb4ce8-0987-48f0-be38-40891ab55b0b
856	856	0	National Biodiversity Network	d897a5b9-35ee-4232-94bd-b0bcaac003c2	a718e280-eae6-44e4-bb95-ce4dfccf0060
2	2	0	Plazi	ffb07bec-2d10-492d-9c37-361fe0b79427	a7e349dc-b498-4233-ade4-a73f3271e501
754	754	0	GBIF France	da44cd31-5901-4687-a106-6d1c7734ee3a	a90b442c-f236-4e40-aa85-ba95e9d401fa
622	622	0	GBIF Argentina	2426a871-9feb-40a1-96c6-0c593a76b835	ad539911-52b6-4544-91a0-79143b3337a9
0	6	6	Plazi	ffb07bec-2d10-492d-9c37-361fe0b79427	b0e3126c-4b5a-413a-b46f-7456fffe326b
89	89	0	GBIF France	da44cd31-5901-4687-a106-6d1c7734ee3a	b2f6f36b-80d3-4a9c-bee2-39e1ebc29747
244	244	0	GBIF France	da44cd31-5901-4687-a106-6d1c7734ee3a	b403083d-2515-43e6-8907-fb46ee41ea4f
421	421	0	Taiwan Biodiversity Information Facility	e1b85abc-61f9-430f-ba79-6813dec53a0f	b5d15a8b-0500-4d8b-b156-9da14da494cc
0	475	475	Plazi	ffb07bec-2d10-492d-9c37-361fe0b79427	b95f0ec9-029c-4108-9a57-fee9ae452d38
56029	56029	0	U.S. Geological Survey	8618c64a-93e0-4300-b546-7249e5148ed2	bda5b6f2-a910-48c7-8dce-6aa24ae96470
85	85	0	Plazi	ffb07bec-2d10-492d-9c37-361fe0b79427	bf31986f-33c6-4a7b-8b58-736c352e54e4
2	2	0	Plazi	ffb07bec-2d10-492d-9c37-361fe0b79427	bf8c9f5e-a263-41fe-bdd5-5c3beeea05fc
2629	2629	0	GBIF Benin	efb9c00e-f802-45dd-8826-a52ec45b89ff	bfd83b14-c0d7-4646-a9e0-d0a7a37d0a98
0	60966	60966	U.S. Geological Survey	8618c64a-93e0-4300-b546-7249e5148ed2	c43384a9-8d9d-40c0-8cda-40ad47d2d69d
5649	5649	0	GBIF Estonia	2c11b821-d22b-4c64-8cd3-c1578173b129	c4a654a1-24ef-4e39-83f8-77817a593c27
0	56	56	Plazi	ffb07bec-2d10-492d-9c37-361fe0b79427	c4db30cf-a7d0-452f-b24f-5db66f6fe66d
132	132	0	GBIF France	da44cd31-5901-4687-a106-6d1c7734ee3a	c76152e9-7365-4f59-8cb7-9a1f9a0130ec
5	5	0	Plazi	ffb07bec-2d10-492d-9c37-361fe0b79427	c87af67b-d742-46ab-a2bf-825d79889732
0	46	46	Plazi	ffb07bec-2d10-492d-9c37-361fe0b79427	caa4f976-7615-4a54-af81-8f40e8e5bcdb
60492	97589	37097	National Biodiversity Network	d897a5b9-35ee-4232-94bd-b0bcaac003c2	cbde2a70-7a85-4370-b240-09e0738f76f9
511	511	0	Colombian Biodiversity Information System	7e865cba-7c46-417b-ade5-97f2cf5b7be0	ce5df8f3-b64c-4df9-aa2e-6f7c6022de83
0	5	5	Plazi	ffb07bec-2d10-492d-9c37-361fe0b79427	d038a13e-7b04-4cfb-91cd-76807824e84d
71	71	0	GBIF France	da44cd31-5901-4687-a106-6d1c7734ee3a	d23db9b4-2d1a-4efb-9a7b-ee47d08a69a3
754	754	0	GBIF France	da44cd31-5901-4687-a106-6d1c7734ee3a	d3e1f5c1-0062-452c-8427-97aaa7061391
71716	71716	0	U.S. Geological Survey	8618c64a-93e0-4300-b546-7249e5148ed2	d499aef2-b1d9-4890-aeb3-5f0d1237b513
46	52	6	Participant Node Managers Committee	7f48e0c8-5c96-49ec-b972-30748e339115	d8d39f7e-187f-4896-ae05-064bfe8bc029
619	619	0	Colombian Biodiversity Information System	7e865cba-7c46-417b-ade5-97f2cf5b7be0	d8e8b1bf-0b56-4cc0-bf75-c9283fad4aa2
490	490	0	Colombian Biodiversity Information System	7e865cba-7c46-417b-ade5-97f2cf5b7be0	daaf4d0d-6797-4b13-a0c6-0cf8592714e7
0	4	4	Plazi	ffb07bec-2d10-492d-9c37-361fe0b79427	dc28908b-e85f-49f9-9feb-a4b05e166823
352	352	0	Plazi	ffb07bec-2d10-492d-9c37-361fe0b79427	de5c3cc9-9773-4e79-aaaf-0e964d7262f8
0	4	4	Plazi	ffb07bec-2d10-492d-9c37-361fe0b79427	dffdc4cc-d108-4e27-a6c9-35042eb69b0e
0	51	51	Plazi	ffb07bec-2d10-492d-9c37-361fe0b79427	e1653faa-2c95-41bf-b729-8494fa0b5086
0	11	11	Plazi	ffb07bec-2d10-492d-9c37-361fe0b79427	e1daacda-87e9-479f-abeb-2431532b98d2
0	8361	8361	Ocean Biodiversity Information System	ba0670b9-4186-41e6-8e70-f9cb3065551a	e1dddb82-f1c0-4553-aa2e-1fd414658d01
2	2	0	Plazi	ffb07bec-2d10-492d-9c37-361fe0b79427	e798d6b3-ca6a-456a-a0af-ec2c72408720
423	423	0	Plazi	ffb07bec-2d10-492d-9c37-361fe0b79427	e82de321-5da8-45a5-8404-f42ef44753aa
149	149	0	Plazi	ffb07bec-2d10-492d-9c37-361fe0b79427	ea328adf-3a51-4f4a-8e0c-b9117e767c20
47828	79815	31987	Belgian Biodiversity Platform	fb11cfe1-ebc3-45af-9159-17d9fddbcdac	ea410929-015a-4093-9c7e-7be2482668c9
0	3	3	Plazi	ffb07bec-2d10-492d-9c37-361fe0b79427	ec00b8fb-4225-4d75-b874-c2b2be17c6ec
45	45	0	GBIF Portugal	673f7038-4262-4149-b753-5658a4e912f6	ec267ce7-77a2-44e6-a928-bd571f2d02d9
16	16	0	Plazi	ffb07bec-2d10-492d-9c37-361fe0b79427	ec561977-c515-476a-b1e0-3804a5067d47
0	4	4	Plazi	ffb07bec-2d10-492d-9c37-361fe0b79427	ec68093b-83d1-464f-9ddc-656ca1953ced
4	4	0	Plazi	ffb07bec-2d10-492d-9c37-361fe0b79427	edf7e603-d043-423f-a1f2-82ce9a6a84eb
1993	1993	0	Biodiversity Information System of Mexico	b324e8e9-9a4c-44fa-8f1a-7f39ea7ab576	f17bd412-21e1-4c2e-860e-2661af4c9cec
2170	2170	0	GBIF France	da44cd31-5901-4687-a106-6d1c7734ee3a	f4c0a4b5-733b-47ad-8bc5-39563a16372f
0	1	1	Plazi	ffb07bec-2d10-492d-9c37-361fe0b79427	f73db7bf-31a4-4d2c-85ef-55c99a91286a
13	13	0	Plazi	ffb07bec-2d10-492d-9c37-361fe0b79427	f84b5885-99a4-4dc2-88a5-9178868c6be6
5625	5625	0	Netherlands Biodiversity Information Facility	0909d601-bda2-42df-9e63-a6d51847ebce	faf313a1-9ae4-43f4-bfc9-974281feac0e
125385	130601	5216	GBIF Austria	1e789bc9-79fc-4e60-a49e-89dfc45a7188	fb8ae15d-e30c-44b4-8f61-0bb0c1d90ff9
0	36	36	Plazi	ffb07bec-2d10-492d-9c37-361fe0b79427	fc62c739-6617-414a-a42d-f0aec8e87abd
12	12	0	Plazi	ffb07bec-2d10-492d-9c37-361fe0b79427	ff94b904-0007-4e81-96c9-86570022fe0b
16422	16422	0	GBIF France	da44cd31-5901-4687-a106-6d1c7734ee3a	01d9098d-7dec-4235-b783-c537478cd4c2
0	8	8	Plazi	ffb07bec-2d10-492d-9c37-361fe0b79427	0243f82c-c5d9-4269-8352-4cea855f133c
58457	58457	0	GBIF France	da44cd31-5901-4687-a106-6d1c7734ee3a	040d0116-7d19-45bc-8fe5-3f24b5965748
118	118	0	GBIF Argentina	2426a871-9feb-40a1-96c6-0c593a76b835	0549aec6-5e7b-46a8-af80-76a3712c0ef6
7	7	0	Plazi	ffb07bec-2d10-492d-9c37-361fe0b79427	05b654e1-d3cf-4d00-8811-3cf8f4e4eab4
64	64	0	GBIF Germany	4f6826f2-4ff6-443d-b966-e6913bd24013	08015d18-e850-4d59-bb8f-36e92dad757c
0	10	10	Plazi	ffb07bec-2d10-492d-9c37-361fe0b79427	0c507929-0d02-4902-84c5-eadd78ccbb42
50	50	0	Plazi	ffb07bec-2d10-492d-9c37-361fe0b79427	0d3bf276-12c1-46c1-9d8d-25701c36e9db
668	668	0	National Biodiversity Network	d897a5b9-35ee-4232-94bd-b0bcaac003c2	0e2d604a-0ba5-4ed9-ae7a-31ceac2aa1fb
40	40	0	Biodiversity Information System of Mexico	b324e8e9-9a4c-44fa-8f1a-7f39ea7ab576	0f265f7c-e75e-4838-a4ea-a1664188ba04
381	381	0	Biodiversity Information System of Mexico	b324e8e9-9a4c-44fa-8f1a-7f39ea7ab576	0f94c521-af21-4e18-8eb4-0b01deb2ee6f
196	196	0	GBIF France	da44cd31-5901-4687-a106-6d1c7734ee3a	0ffe7e6a-f76c-4f25-858e-9f7ba49b1833
0	2	2	Plazi	ffb07bec-2d10-492d-9c37-361fe0b79427	1209aa0f-27c6-4c65-b408-ffe1c136cb2f
0	4	4	Plazi	ffb07bec-2d10-492d-9c37-361fe0b79427	132ef038-69b5-4d91-b569-f73c95ac888c
0	52	52	Plazi	ffb07bec-2d10-492d-9c37-361fe0b79427	175ae5f9-ca39-487d-af46-f19496ff498c
113	42	-71	GBIF Germany	4f6826f2-4ff6-443d-b966-e6913bd24013	1799287d-bc4a-4641-a26c-6d8213de9b69
0	2	2	Plazi	ffb07bec-2d10-492d-9c37-361fe0b79427	1d5bd792-db71-4962-b2f0-ec4505cc2225
1	1	0	Plazi	ffb07bec-2d10-492d-9c37-361fe0b79427	1d66d703-6d9f-4a50-a565-a67c895588da
1	1	0	Plazi	ffb07bec-2d10-492d-9c37-361fe0b79427	20d6f295-141d-4634-97b0-ae90dbefc0c5
162	162	0	Participant Node Managers Committee	7f48e0c8-5c96-49ec-b972-30748e339115	20e4f877-abac-42b7-a3ac-805752986ddd
202661	202722	61	GBIF France	da44cd31-5901-4687-a106-6d1c7734ee3a	217b0d4f-c87e-4063-b6c5-78277e40e866
0	161	161	Participant Node Managers Committee	7f48e0c8-5c96-49ec-b972-30748e339115	249ee8b0-183e-418e-8db5-ded1afc3a90b
122	122	0	GBIF Benin	efb9c00e-f802-45dd-8826-a52ec45b89ff	24d38186-449b-4c9f-b63b-9a5c14548b12
0	4258	4258	GBIF Benin	efb9c00e-f802-45dd-8826-a52ec45b89ff	270751ca-48fb-4d9f-96ce-0341f645f861
330	330	0	GBIF France	da44cd31-5901-4687-a106-6d1c7734ee3a	286f4782-2f06-41e2-8c09-002607f599d4
481	481	0	Participant Node Managers Committee	7f48e0c8-5c96-49ec-b972-30748e339115	2a096847-3148-4a09-a47c-ee42f573ae75
10	10	0	Plazi	ffb07bec-2d10-492d-9c37-361fe0b79427	2a43bafe-bc08-4970-a7b5-6d986ddcd28a
1881811	1905985	24174	Atlas of Living Australia	4a6f1b71-969e-4fc5-a693-282b05e1220c	2a513d16-f4ce-4252-974f-2486ce70b788
2022	804	-1218	Biodiversity Information System of Mexico	b324e8e9-9a4c-44fa-8f1a-7f39ea7ab576	3006c2fd-b596-4368-b3b0-fd06116251da
0	1	1	Plazi	ffb07bec-2d10-492d-9c37-361fe0b79427	32550857-8aab-4552-9c92-6344863ae9b0
6925	6925	0	Biodiversity Information System of Mexico	b324e8e9-9a4c-44fa-8f1a-7f39ea7ab576	32682bd4-45ff-472b-b4fa-eb75d271c1ce
102	102	0	Biodiversity Information System of Mexico	b324e8e9-9a4c-44fa-8f1a-7f39ea7ab576	3283bea4-1ca5-423e-bc2e-e907d0317522
12898	12898	0	Biodiversity Information System of Mexico	b324e8e9-9a4c-44fa-8f1a-7f39ea7ab576	34bdd863-0afd-407c-bde0-a1539263156e
133	133	0	Ocean Biodiversity Information System	ba0670b9-4186-41e6-8e70-f9cb3065551a	350e81e8-ff86-41bb-8c71-5a6875fe9144
19	19	0	Plazi	ffb07bec-2d10-492d-9c37-361fe0b79427	354248e3-5ec5-4afe-a742-d5413a68c022
1201	1201	0	Colombian Biodiversity Information System	7e865cba-7c46-417b-ade5-97f2cf5b7be0	3662247b-86f0-41de-82aa-f6b5e1712ed2
0	257	257	Participant Node Managers Committee	7f48e0c8-5c96-49ec-b972-30748e339115	37497bf7-31a0-4fd5-9591-2b47004f5ab9
0	14	14	Plazi	ffb07bec-2d10-492d-9c37-361fe0b79427	374bd415-ee0b-4c66-bbc5-6ffef299f395
91	93	2	Plazi	ffb07bec-2d10-492d-9c37-361fe0b79427	39c9ce8d-d95d-467e-9590-ab184d952201
6	6	0	Plazi	ffb07bec-2d10-492d-9c37-361fe0b79427	3c0608ce-ea43-4d9c-810d-293ab68d5509
1121	1121	0	GBIF Portugal	673f7038-4262-4149-b753-5658a4e912f6	3c66c8f5-a981-46ea-8b0f-6ae44f799220
4391	4391	0	Atlas of Living Australia	4a6f1b71-969e-4fc5-a693-282b05e1220c	3fa9349b-6507-4019-b956-fa3f989c854b
0	17318	17318	GBIF Switzerland	169eb292-376b-4cc6-8e31-9c2c432de0ad	400e13ce-82a1-424f-9f42-70ff70067bfb
20666	20666	0	GBIF France	da44cd31-5901-4687-a106-6d1c7734ee3a	426a7529-7b53-4dab-b1b9-c6038c8d74ad
52	52	0	Plazi	ffb07bec-2d10-492d-9c37-361fe0b79427	4558e00f-b58a-458a-8b21-573011271aa6
4	4	0	Plazi	ffb07bec-2d10-492d-9c37-361fe0b79427	45a79aa8-d6fb-4549-b586-6f5b379893eb
92	92	0	GBIF Germany	4f6826f2-4ff6-443d-b966-e6913bd24013	45eb40d7-4578-4c7b-af4b-33d49b27bb66
3	3	0	Plazi	ffb07bec-2d10-492d-9c37-361fe0b79427	467f5b03-bad6-4c53-8dde-d1b129a8df5a
1904	1904	0	Atlas of Living Australia	4a6f1b71-969e-4fc5-a693-282b05e1220c	46adbad7-187a-41e9-816f-b1e607aa275f
320	320	0	Colombian Biodiversity Information System	7e865cba-7c46-417b-ade5-97f2cf5b7be0	47590ea9-71b1-48e8-bf0e-e35f4557119b
382	382	0	Inter American Biodiversity Information Network	69f8ea9e-b2a6-4e5a-896f-3bf8fc23cc8d	4946ae59-8711-475c-8a76-3ef7e70b8b75
0	853	853	Ocean Biodiversity Information System	ba0670b9-4186-41e6-8e70-f9cb3065551a	4aa3c410-812d-43e5-b7c5-7ff3fe1c42f1
2	2	0	Plazi	ffb07bec-2d10-492d-9c37-361fe0b79427	4bf457c1-2d70-4229-8cf4-2dcb514f1b46
141	141	0	Plazi	ffb07bec-2d10-492d-9c37-361fe0b79427	4de0fe4e-219b-432f-9d36-43d2f4a41835
17	17	0	Plazi	ffb07bec-2d10-492d-9c37-361fe0b79427	52095bfb-73f8-4e0a-af11-ef61eb74cfcc
405	391	-14	GBIF Germany	4f6826f2-4ff6-443d-b966-e6913bd24013	56a513f3-6d4b-48b0-9075-47ce9f7f6675
0	3	3	Plazi	ffb07bec-2d10-492d-9c37-361fe0b79427	5742a25e-3de3-4a87-a689-5a88ea76605e
15	15	0	National Biodiversity Network	d897a5b9-35ee-4232-94bd-b0bcaac003c2	57c4af81-a3a4-4482-acaf-37ccf90e7c7c
5695	5695	0	Participant Node Managers Committee	7f48e0c8-5c96-49ec-b972-30748e339115	5958347d-0849-40a6-a83d-14963655753c
3	3	0	Plazi	ffb07bec-2d10-492d-9c37-361fe0b79427	5aa5a37c-ff28-4de4-be53-9649408c8418
16929	16929	0	Colombian Biodiversity Information System	7e865cba-7c46-417b-ade5-97f2cf5b7be0	5dfaf2ac-5980-4ec5-8490-4607fcd59123
0	28	28	Plazi	ffb07bec-2d10-492d-9c37-361fe0b79427	5ea9736c-f218-427e-b201-38b44425a2f3
99	99	0	GBIF Germany	4f6826f2-4ff6-443d-b966-e6913bd24013	61fc582a-f762-11e1-a439-00145eb45e9a
0	1	1	Plazi	ffb07bec-2d10-492d-9c37-361fe0b79427	628c8bc0-acba-467e-8878-ac221809c81f
67	67	0	GBIF Germany	4f6826f2-4ff6-443d-b966-e6913bd24013	62a4f78c-f762-11e1-a439-00145eb45e9a
742	742	0	GBIF France	da44cd31-5901-4687-a106-6d1c7734ee3a	65007a3b-c5fe-42b9-a2c0-103b6409b6d0
3	3	0	Plazi	ffb07bec-2d10-492d-9c37-361fe0b79427	656344c3-ba28-4ae6-8a53-9a209bddc5de
12	12	0	Plazi	ffb07bec-2d10-492d-9c37-361fe0b79427	66292f10-d487-47a0-b8a0-ed5eab57f723
161	161	0	GBIF Germany	4f6826f2-4ff6-443d-b966-e6913bd24013	665e4090-f762-11e1-a439-00145eb45e9a
0	6	6	Plazi	ffb07bec-2d10-492d-9c37-361fe0b79427	67b665b5-74e4-4d65-b375-a07f33a7aa75
84	26	-58	GBIF Germany	4f6826f2-4ff6-443d-b966-e6913bd24013	68f262ba-9afd-4397-83cd-344c8904fd86
49	49	0	GBIF Germany	4f6826f2-4ff6-443d-b966-e6913bd24013	6910b408-f762-11e1-a439-00145eb45e9a
78	78	0	GBIF Germany	4f6826f2-4ff6-443d-b966-e6913bd24013	6999d166-f762-11e1-a439-00145eb45e9a
455	455	0	National Biodiversity Network	d897a5b9-35ee-4232-94bd-b0bcaac003c2	6a669128-0776-444e-9b29-5be148db8999
20	20	0	GBIF Germany	4f6826f2-4ff6-443d-b966-e6913bd24013	6bf19bd8-f762-11e1-a439-00145eb45e9a
177	177	0	GBIF Germany	4f6826f2-4ff6-443d-b966-e6913bd24013	71841ec2-f762-11e1-a439-00145eb45e9a
491	491	0	GBIF Germany	4f6826f2-4ff6-443d-b966-e6913bd24013	71c75a52-f762-11e1-a439-00145eb45e9a
153	153	0	GBIF Germany	4f6826f2-4ff6-443d-b966-e6913bd24013	71fdea22-f762-11e1-a439-00145eb45e9a
13	13	0	GBIF Germany	4f6826f2-4ff6-443d-b966-e6913bd24013	73a639d8-f762-11e1-a439-00145eb45e9a
0	41	41	Plazi	ffb07bec-2d10-492d-9c37-361fe0b79427	73b8e644-f46f-4526-9b4e-b323f2205c8d
55909	55909	0	GBIF Spain	1f94b3ca-9345-4d65-afe2-4bace93aa0fe	765770cf-a2cf-4e5a-84e3-526a50754239
818	818	0	Atlas of Living Australia	4a6f1b71-969e-4fc5-a693-282b05e1220c	765feb50-40bd-4638-8e4f-a5f11b7a0676
47118	47118	0	National Biodiversity Network	d897a5b9-35ee-4232-94bd-b0bcaac003c2	76bc820a-323b-4b83-b87e-9e8e2159b68d
3165	3165	0	South African Biodiversity Information Facility	7190b835-4e86-4b6e-85c1-19cc6677c250	77b04b75-97f5-4d3c-9184-8cc5c12d71ae
3127	3127	0	GBIF France	da44cd31-5901-4687-a106-6d1c7734ee3a	782fd5d4-c87c-427e-be3c-a3f2a201052b
36	36	0	Plazi	ffb07bec-2d10-492d-9c37-361fe0b79427	78a8b898-f7fc-4e9a-9cb9-6a32a018b4f1
33	33	0	GBIF Germany	4f6826f2-4ff6-443d-b966-e6913bd24013	7a7ff85c-f762-11e1-a439-00145eb45e9a
4069	4069	0	Biodiversity Information System of Mexico	b324e8e9-9a4c-44fa-8f1a-7f39ea7ab576	7bd2f51a-33e2-45a7-bf33-0a172b1f5b8d
294	294	0	GBIF Germany	4f6826f2-4ff6-443d-b966-e6913bd24013	7bdfcb6e-f762-11e1-a439-00145eb45e9a
1188	1188	0	GBIF Germany	4f6826f2-4ff6-443d-b966-e6913bd24013	7c17f066-f762-11e1-a439-00145eb45e9a
1416	1180	-236	GBIF Germany	4f6826f2-4ff6-443d-b966-e6913bd24013	7c93b494-f762-11e1-a439-00145eb45e9a
448	448	0	GBIF Germany	4f6826f2-4ff6-443d-b966-e6913bd24013	7cd06146-f762-11e1-a439-00145eb45e9a
256	256	0	GBIF Germany	4f6826f2-4ff6-443d-b966-e6913bd24013	7db71a5a-f762-11e1-a439-00145eb45e9a
11	11	0	GBIF Germany	4f6826f2-4ff6-443d-b966-e6913bd24013	7ddccd72-f762-11e1-a439-00145eb45e9a
1941	1217	-724	GBIF Germany	4f6826f2-4ff6-443d-b966-e6913bd24013	7deb24a8-f762-11e1-a439-00145eb45e9a
323	323	0	Ocean Biodiversity Information System	ba0670b9-4186-41e6-8e70-f9cb3065551a	7e2ef7c8-f762-11e1-a439-00145eb45e9a
337	337	0	Atlas of Living Australia	4a6f1b71-969e-4fc5-a693-282b05e1220c	7f5a4c74-f762-11e1-a439-00145eb45e9a
916	916	0	Biodiversity Information System of Mexico	b324e8e9-9a4c-44fa-8f1a-7f39ea7ab576	7f82bf4c-f762-11e1-a439-00145eb45e9a
195	195	0	Biodiversity Information System of Mexico	b324e8e9-9a4c-44fa-8f1a-7f39ea7ab576	7fbe057a-f762-11e1-a439-00145eb45e9a
3189	3189	0	National Biodiversity Network	d897a5b9-35ee-4232-94bd-b0bcaac003c2	80551f8a-7a50-4f9b-9bf3-182314b5f8b5
19720	19720	0	Biodiversity Information System of Mexico	b324e8e9-9a4c-44fa-8f1a-7f39ea7ab576	80aee576-f762-11e1-a439-00145eb45e9a
12075	9602	-2473	Biodiversity Information System of Mexico	b324e8e9-9a4c-44fa-8f1a-7f39ea7ab576	80b401aa-f762-11e1-a439-00145eb45e9a
65481	65481	0	GBIF Germany	4f6826f2-4ff6-443d-b966-e6913bd24013	816e9038-f762-11e1-a439-00145eb45e9a
1350	720	-630	GBIF Germany	4f6826f2-4ff6-443d-b966-e6913bd24013	81f30ef8-f762-11e1-a439-00145eb45e9a
2	2	0	Plazi	ffb07bec-2d10-492d-9c37-361fe0b79427	8220491b-5980-4abe-b775-9fe2dada790d
660	462	-198	GBIF Germany	4f6826f2-4ff6-443d-b966-e6913bd24013	8243fa02-f762-11e1-a439-00145eb45e9a
1	1	0	Plazi	ffb07bec-2d10-492d-9c37-361fe0b79427	829a29de-aa93-4196-bb5d-79e9d6ce8744
187017	187017	0	U.S. Geological Survey	8618c64a-93e0-4300-b546-7249e5148ed2	831234b2-f762-11e1-a439-00145eb45e9a
107	107	0	GBIF Germany	4f6826f2-4ff6-443d-b966-e6913bd24013	83a65d52-1571-4f80-acfc-838501ba4ac7
4054	4054	0	Ocean Biodiversity Information System	ba0670b9-4186-41e6-8e70-f9cb3065551a	83ca97e6-f762-11e1-a439-00145eb45e9a
892	892	0	U.S. Geological Survey	8618c64a-93e0-4300-b546-7249e5148ed2	85199976-f762-11e1-a439-00145eb45e9a
2440	2440	0	GBIF Argentina	2426a871-9feb-40a1-96c6-0c593a76b835	85530bf4-67af-4c8e-a176-0ea3c322d9fc
0	51	51	Plazi	ffb07bec-2d10-492d-9c37-361fe0b79427	85c37acf-2892-423c-b6fa-3a430fa863a5
243	243	0	GBIF Germany	4f6826f2-4ff6-443d-b966-e6913bd24013	86859847-f90a-4c4f-8109-31faddf6318d
60	60	0	GBIF Germany	4f6826f2-4ff6-443d-b966-e6913bd24013	88196c1a-918a-45c1-aeb8-f00e0e31240d
160	61	-99	GBIF Germany	4f6826f2-4ff6-443d-b966-e6913bd24013	88b68f9e-f762-11e1-a439-00145eb45e9a
3	3	0	Participant Node Managers Committee	7f48e0c8-5c96-49ec-b972-30748e339115	88bcfa1b-e4d5-4d52-9feb-2231e8f03ff7
3154	3154	0	Colombian Biodiversity Information System	7e865cba-7c46-417b-ade5-97f2cf5b7be0	8af31dc9-a824-415a-aeee-5ef840d36933
10	10	0	GBIF Germany	4f6826f2-4ff6-443d-b966-e6913bd24013	8c1282ec-f762-11e1-a439-00145eb45e9a
60	49	-11	GBIF Germany	4f6826f2-4ff6-443d-b966-e6913bd24013	8c5b6ec6-f762-11e1-a439-00145eb45e9a
0	1	1	Plazi	ffb07bec-2d10-492d-9c37-361fe0b79427	8cb0c3e0-d9aa-4020-b0b5-fa55bdd5d4e0
8	7	-1	GBIF Germany	4f6826f2-4ff6-443d-b966-e6913bd24013	8d22898e-f762-11e1-a439-00145eb45e9a
1	1	0	GBIF Germany	4f6826f2-4ff6-443d-b966-e6913bd24013	8d3e2b26-f762-11e1-a439-00145eb45e9a
33	9	-24	GBIF Germany	4f6826f2-4ff6-443d-b966-e6913bd24013	8da71104-f762-11e1-a439-00145eb45e9a
967	338	-629	GBIF Germany	4f6826f2-4ff6-443d-b966-e6913bd24013	8df03b40-f762-11e1-a439-00145eb45e9a
15	15	0	GBIF Argentina	2426a871-9feb-40a1-96c6-0c593a76b835	8f78e60c-2e35-4911-bcc3-ebc9bb366289
359	142	-217	GBIF Germany	4f6826f2-4ff6-443d-b966-e6913bd24013	8fa588c8-f762-11e1-a439-00145eb45e9a
95	95	0	GBIF France	da44cd31-5901-4687-a106-6d1c7734ee3a	9021624b-3a0a-4ed0-b3c2-edfcb95c3178
239	223	-16	GBIF Germany	4f6826f2-4ff6-443d-b966-e6913bd24013	90e52360-f762-11e1-a439-00145eb45e9a
177	156	-21	GBIF Germany	4f6826f2-4ff6-443d-b966-e6913bd24013	91273566-f762-11e1-a439-00145eb45e9a
209	187	-22	GBIF Germany	4f6826f2-4ff6-443d-b966-e6913bd24013	916a3096-f762-11e1-a439-00145eb45e9a
51	51	0	GBIF Germany	4f6826f2-4ff6-443d-b966-e6913bd24013	91e2169c-f762-11e1-a439-00145eb45e9a
254	254	0	GBIF Germany	4f6826f2-4ff6-443d-b966-e6913bd24013	92581cde-f762-11e1-a439-00145eb45e9a
0	237	237	Ocean Biodiversity Information System	ba0670b9-4186-41e6-8e70-f9cb3065551a	93268b53-a0b9-4b79-b8c1-a292b1443ea7
28	27	-1	GBIF Germany	4f6826f2-4ff6-443d-b966-e6913bd24013	93a3e550-f762-11e1-a439-00145eb45e9a
0	12	12	Plazi	ffb07bec-2d10-492d-9c37-361fe0b79427	979a8e00-2b4e-43b0-9f6b-011052f6562c
114962	114961	-1	National Biodiversity Network	d897a5b9-35ee-4232-94bd-b0bcaac003c2	97eccb39-8a7b-4711-82ef-5f61afc1cf0c
775	775	0	GBIF France	da44cd31-5901-4687-a106-6d1c7734ee3a	99a01b10-0d4e-491b-96f1-fe34911c714b
0	3	3	Plazi	ffb07bec-2d10-492d-9c37-361fe0b79427	9bcb7dd2-d3b9-4fbd-9912-6e44b3dea144
0	54	54	Ocean Biodiversity Information System	ba0670b9-4186-41e6-8e70-f9cb3065551a	9c133f1e-a7d1-410c-8b72-1ec5bd89df54
0	638	638	GBIF France	da44cd31-5901-4687-a106-6d1c7734ee3a	9d6589bb-ef42-4ad8-9269-7052f1b3ae26
0	21	21	Plazi	ffb07bec-2d10-492d-9c37-361fe0b79427	9e07ac2c-b3c7-4b70-9f2f-e0e02c0aa185
2914	2914	0	GBIF France	da44cd31-5901-4687-a106-6d1c7734ee3a	a031de99-c6cc-4826-b8aa-18ce01116184
0	69	69	GBIF Norway	4f829580-180d-46a9-9c87-ed8ec959b545	a2262482-1465-4341-ab08-f23b7ba4d4ac
430	430	0	Colombian Biodiversity Information System	7e865cba-7c46-417b-ade5-97f2cf5b7be0	a52b045e-909b-4f34-b031-ef55eada0f03
917	917	0	GBIF Germany	4f6826f2-4ff6-443d-b966-e6913bd24013	a96642cc-218a-4570-b88c-245ff4482afd
1934	1934	0	GBIF France	da44cd31-5901-4687-a106-6d1c7734ee3a	a9c40665-83db-49fa-b075-72256f55eb35
238	238	0	GBIF France	da44cd31-5901-4687-a106-6d1c7734ee3a	aa19a6f1-a287-4856-91b3-7d7e0bd3b33a
243	243	0	Plazi	ffb07bec-2d10-492d-9c37-361fe0b79427	aae2e4ae-fbd7-41ab-bcf1-f1fe89a70fdf
49	49	0	GBIF Germany	4f6826f2-4ff6-443d-b966-e6913bd24013	aaf13ab5-1a3c-4bf7-ae38-a5e3926f7e0c
6	6	0	Plazi	ffb07bec-2d10-492d-9c37-361fe0b79427	b08daf04-10b5-4595-ba21-18a5bca77531
55	55	0	Plazi	ffb07bec-2d10-492d-9c37-361fe0b79427	b44a2581-743b-4bb2-9761-ebdd042fdad3
56	56	0	Plazi	ffb07bec-2d10-492d-9c37-361fe0b79427	ba3f3745-b877-49ec-a6d0-04872d9e0506
771375	771375	0	GBIF France	da44cd31-5901-4687-a106-6d1c7734ee3a	bd8ee748-4ae8-4956-98d9-c1b8e8b2b9c9
63	63	0	Plazi	ffb07bec-2d10-492d-9c37-361fe0b79427	c0cedb2c-ecab-4b9d-8e50-48b2c92ed10b
16423	16423	0	GBIF Brazil	cdc9736d-5ff7-4ece-9959-3c744360cdb3	c364f36b-28a0-4012-8a3b-9ec2e5ec3daf
11	11	0	Plazi	ffb07bec-2d10-492d-9c37-361fe0b79427	c5b81cd2-0466-48f5-b9e5-964001e74cfb
1485	330	-1155	GBIF Germany	4f6826f2-4ff6-443d-b966-e6913bd24013	c85cda45-6241-440a-9d74-13afe9010bb1
1	1	0	Plazi	ffb07bec-2d10-492d-9c37-361fe0b79427	ca129d49-fcde-4104-a503-4602b3bac0e2
1689	1689	0	GBIF Argentina	2426a871-9feb-40a1-96c6-0c593a76b835	ce6d4ae6-278f-4c15-a16a-266f4a599e21
436	436	0	GBIF Uruguay	a3ceb6dd-0a65-4f30-a385-30f6937c2096	ce8285ae-97a7-4c14-9a88-4b4a490a0555
5021	5021	0	Biodiversity Information System of Mexico	b324e8e9-9a4c-44fa-8f1a-7f39ea7ab576	cfd53985-562b-4ef5-867e-8adffabaa5f0
3820	5991	2171	GBIF Brazil	cdc9736d-5ff7-4ece-9959-3c744360cdb3	d2a9b26f-cc8f-46e7-bec9-ba99ec7f9781
0	12	12	Plazi	ffb07bec-2d10-492d-9c37-361fe0b79427	d3ef62b2-a97f-4840-804d-5b6329bcb024
1190	1190	0	South African Biodiversity Information Facility	7190b835-4e86-4b6e-85c1-19cc6677c250	d45cd682-b4a0-4118-bfc8-eea3fb752aff
186687	186687	0	National Biodiversity Network	d897a5b9-35ee-4232-94bd-b0bcaac003c2	d740f242-6c26-4229-9a8f-b63bfab63dc6
17	17	0	Plazi	ffb07bec-2d10-492d-9c37-361fe0b79427	d94dce40-6a5d-4769-8191-09e956bf25c8
1	1	0	Plazi	ffb07bec-2d10-492d-9c37-361fe0b79427	da366c53-046e-4993-9f7a-a246a59ec0b7
4	4	0	Plazi	ffb07bec-2d10-492d-9c37-361fe0b79427	db3fd15a-2d90-4f3f-87f8-10b8953e26a5
8070	7584	-486	Biodiversity Information System of Mexico	b324e8e9-9a4c-44fa-8f1a-7f39ea7ab576	dd08f438-2915-424a-a861-873eaa031b95
709117	709117	0	GBIF Germany	4f6826f2-4ff6-443d-b966-e6913bd24013	dee8edc4-b19a-11e2-886d-00145eb45e9a
54	54	0	GBIF Germany	4f6826f2-4ff6-443d-b966-e6913bd24013	e123f8a3-15ea-4e64-9250-ede7a04f9e7a
21	21	0	Participant Node Managers Committee	7f48e0c8-5c96-49ec-b972-30748e339115	e48fa103-8254-4845-be98-ed5cde6924c5
13	13	0	Plazi	ffb07bec-2d10-492d-9c37-361fe0b79427	e809cd3a-36bb-413d-9f19-70837d7db34b
1505	1505	0	Atlas of Living Australia	4a6f1b71-969e-4fc5-a693-282b05e1220c	e8b047d5-14de-4c08-b876-ee4d9e444bc2
0	18	18	Plazi	ffb07bec-2d10-492d-9c37-361fe0b79427	eaf76e53-0eb5-4c6d-a74b-47157278f49b
1620	1620	0	GBIF Germany	4f6826f2-4ff6-443d-b966-e6913bd24013	f035eabf-cacf-4c3b-b044-1543d2af9ee5
301	301	0	Colombian Biodiversity Information System	7e865cba-7c46-417b-ade5-97f2cf5b7be0	f4202f2a-e5bf-44a6-a0f1-cc0f3f3f4f3e
0	77	77	Ocean Biodiversity Information System	ba0670b9-4186-41e6-8e70-f9cb3065551a	f4cc557b-1c28-4a3e-a0b6-16c511005193
0	3	3	Plazi	ffb07bec-2d10-492d-9c37-361fe0b79427	f4d7fb98-abf1-418d-9ba7-ba5b66aecfc6
2722	2722	0	National Biodiversity Network	d897a5b9-35ee-4232-94bd-b0bcaac003c2	f4f9273d-2dbe-4f30-87b1-4aeaa4b4577b
6	6	0	Biodiversity Information System of Mexico	b324e8e9-9a4c-44fa-8f1a-7f39ea7ab576	f583cd67-3316-465e-89dc-90ca0ab32081
15464	15464	0	GBIF Germany	4f6826f2-4ff6-443d-b966-e6913bd24013	f5a6ade4-b414-4ebc-a84a-c6800a2df2da
1533	1591	58	GBIF Germany	4f6826f2-4ff6-443d-b966-e6913bd24013	f5db93fd-3e51-48a7-b97a-c5375a75a4ad
19814	19814	0	Biodiversity Information System of Mexico	b324e8e9-9a4c-44fa-8f1a-7f39ea7ab576	fa4c1edd-7d51-46ee-92c2-70667dc068ad
1386	756	-630	GBIF Germany	4f6826f2-4ff6-443d-b966-e6913bd24013	fa86ed7c-845a-4e7f-b257-3a5e045a6119
2311	2311	0	GBIF Portugal	673f7038-4262-4149-b753-5658a4e912f6	fc5d3109-95a2-47ae-8bfd-1667fc2b12cc
104	104	0	Colombian Biodiversity Information System	7e865cba-7c46-417b-ade5-97f2cf5b7be0	fe0fc5ec-e771-4afa-ac08-2211e4f9ff12
0	2456	2456	Ocean Biodiversity Information System	ba0670b9-4186-41e6-8e70-f9cb3065551a	ff3984d7-84bd-4f3a-b843-666faa4c1696
112354	112354	0	National Biodiversity Network	d897a5b9-35ee-4232-94bd-b0bcaac003c2	ff62a0eb-b835-40ef-9b83-567d48220a8e
149	149	0	GBIF Portugal	673f7038-4262-4149-b753-5658a4e912f6	03dfa40e-3887-4648-8fc2-e72e0bd09fbd
0	2156	2156	Atlas of Living Australia	4a6f1b71-969e-4fc5-a693-282b05e1220c	05326b55-3d88-4726-8f12-9158594e81d9
7	7	0	Plazi	ffb07bec-2d10-492d-9c37-361fe0b79427	063e049e-2e8f-426d-a0e4-07901e254f5c
0	7	7	Plazi	ffb07bec-2d10-492d-9c37-361fe0b79427	07036116-7c14-4e35-9816-39339d955e62
2199	2199	0	National Biodiversity Network	d897a5b9-35ee-4232-94bd-b0bcaac003c2	0a7c5a4e-db9b-4349-a793-ef4b3ef9e025
21	21	0	Plazi	ffb07bec-2d10-492d-9c37-361fe0b79427	0d2f4545-5d0c-4c02-b43e-31adfae5d5b7
0	3	3	Plazi	ffb07bec-2d10-492d-9c37-361fe0b79427	10b7f022-6131-4113-9d30-f699426f1188
0	19	19	Plazi	ffb07bec-2d10-492d-9c37-361fe0b79427	145ef675-a216-4d80-a39a-8407a4199c6f
0	4	4	Plazi	ffb07bec-2d10-492d-9c37-361fe0b79427	1562f328-8d9c-4172-9549-999080b2485c
156	156	0	GBIF France	da44cd31-5901-4687-a106-6d1c7734ee3a	178db2b3-112b-4146-abb2-87a13cf3a660
422	422	0	GBIF France	da44cd31-5901-4687-a106-6d1c7734ee3a	178f1599-b6a2-4f49-b10e-add00387711f
0	3	3	Plazi	ffb07bec-2d10-492d-9c37-361fe0b79427	18b010cc-8d6a-457b-8c78-cbd799d94cfb
0	49256	49256	National Biodiversity Data Centre	422b00b2-6c94-4bb6-976b-c359916efdb8	18cd7e06-40e8-49da-919f-66e553dda347
10767	10767	0	GBIF France	da44cd31-5901-4687-a106-6d1c7734ee3a	1c12eb6c-84b6-4db2-a8a8-8c297685e2eb
4039	4039	0	U.S. Geological Survey	8618c64a-93e0-4300-b546-7249e5148ed2	1c7d5b43-76a1-44bb-a766-8c77ed6d9f2b
77	77	0	Participant Node Managers Committee	7f48e0c8-5c96-49ec-b972-30748e339115	1f26981d-ad8e-4989-975e-aba3aa25c889
0	743	743	Indonesian Biodiversity Information Facility	2ebd91f6-f14f-4375-b525-c011a3774f03	21be2bd7-bf6c-44d8-8638-97272cd4395d
9833	7277	-2556	Biodiversity Information System of Mexico	b324e8e9-9a4c-44fa-8f1a-7f39ea7ab576	262ec79d-5ff8-4b1a-974f-5c19fcb2f1ee
3	3	0	Plazi	ffb07bec-2d10-492d-9c37-361fe0b79427	2656041e-a0d6-498b-b1b7-718810fe89b4
42	42	0	Plazi	ffb07bec-2d10-492d-9c37-361fe0b79427	2b95a851-e1bf-4bdd-9cce-441ddc4135d2
203	203	0	Plazi	ffb07bec-2d10-492d-9c37-361fe0b79427	2bdbfd60-8edf-4efc-9fc3-34649a0e3896
1	1	0	Plazi	ffb07bec-2d10-492d-9c37-361fe0b79427	2c5609dd-30f2-4bdf-b51e-56ef0534ba57
0	48	48	Plazi	ffb07bec-2d10-492d-9c37-361fe0b79427	2d8b2273-4e20-4eab-bdce-f3f281851929
0	111	111	Canada Biodiversity Information Facility	8f83fc96-c966-4126-83f7-bf044dc49efa	2dfd64e5-984a-4a2b-9509-cf839fef66bd
68	68	0	GBIF France	da44cd31-5901-4687-a106-6d1c7734ee3a	2e4e1c60-50cc-47b5-b768-3503ed816ef1
7	7	0	Plazi	ffb07bec-2d10-492d-9c37-361fe0b79427	30f3fb6e-6096-4540-906d-3153d5eb586d
0	5	5	Plazi	ffb07bec-2d10-492d-9c37-361fe0b79427	32987eb4-1b34-448b-a738-383773ad3815
1680	1680	0	Biodiversity Information System of Mexico	b324e8e9-9a4c-44fa-8f1a-7f39ea7ab576	3679494f-e9d3-4334-9cf7-02726df790ea
313	313	0	Colombian Biodiversity Information System	7e865cba-7c46-417b-ade5-97f2cf5b7be0	36cd5465-6625-4bf5-929d-e51a57583c9c
0	1	1	Plazi	ffb07bec-2d10-492d-9c37-361fe0b79427	3948d9fc-5ee3-4926-81cd-0aadc354835c
9	9	0	Plazi	ffb07bec-2d10-492d-9c37-361fe0b79427	3c782ba4-ed7e-4064-a613-2c95aae16bbe
0	13	13	Plazi	ffb07bec-2d10-492d-9c37-361fe0b79427	3eafcfe5-fec1-4f0c-a3db-a099caebd58c
25007	25007	0	GBIF France	da44cd31-5901-4687-a106-6d1c7734ee3a	41d66e74-20bb-4837-aa73-08a03aef9a70
0	10	10	Plazi	ffb07bec-2d10-492d-9c37-361fe0b79427	43176a74-35a1-4374-be20-746db4adcbf9
27353	27353	0	National Biodiversity Network	d897a5b9-35ee-4232-94bd-b0bcaac003c2	4769b578-3ec1-4f45-9090-ea9b2422e3db
90	90	0	GBIF France	da44cd31-5901-4687-a106-6d1c7734ee3a	47c1f414-e3d6-4035-a522-bde274d2afcd
14	14	0	Plazi	ffb07bec-2d10-492d-9c37-361fe0b79427	480966e4-4a9a-4965-91eb-e9b0b4813e15
1	1	0	Plazi	ffb07bec-2d10-492d-9c37-361fe0b79427	49a11228-6c4d-478f-b958-52610eaab951
6	6	0	Plazi	ffb07bec-2d10-492d-9c37-361fe0b79427	49d0010d-2c12-463c-a26a-7c8602521b41
49	49	0	Plazi	ffb07bec-2d10-492d-9c37-361fe0b79427	4aaaf651-5ec3-486e-9b68-44989ea0c86c
7000	7000	0	U.S. Geological Survey	8618c64a-93e0-4300-b546-7249e5148ed2	4ada1c77-3895-47d8-8dc9-9ce44e1df802
0	9	9	Plazi	ffb07bec-2d10-492d-9c37-361fe0b79427	4b05c457-181b-4ba6-a47c-653c41444542
28512	28512	0	National Biodiversity Network	d897a5b9-35ee-4232-94bd-b0bcaac003c2	4d14bc9c-8a73-4a3c-bb1e-692f4f8f5c96
148	148	0	GBIF Germany	4f6826f2-4ff6-443d-b966-e6913bd24013	509d4127-c7ea-40f3-8455-8fe80b6a892a
0	81071	81071	Colombian Biodiversity Information System	7e865cba-7c46-417b-ade5-97f2cf5b7be0	52ff421c-ce1a-4724-95af-9bf0d2df14a7
13968	19686	5718	U.S. Geological Survey	8618c64a-93e0-4300-b546-7249e5148ed2	5345b34d-82a4-44b7-9d82-5109df1ca243
64680	37160	-27520	GBIF Japan	db5705aa-6a6e-42f1-8942-d77b9f4896ea	53bf6dc4-18f5-11e2-98fb-00145eb45e9a
15973	15973	0	GBIF Norway	4f829580-180d-46a9-9c87-ed8ec959b545	57d403f4-9d00-4651-8e26-1f4e81a21181
22	22	0	GBIF Germany	4f6826f2-4ff6-443d-b966-e6913bd24013	5c93f877-c1ec-4772-953c-d2bb78dc2175
8447	8447	0	National Biodiversity Network	d897a5b9-35ee-4232-94bd-b0bcaac003c2	5e86deb2-c1aa-48bf-9d70-38ccb54f715d
18	18	0	GBIF France	da44cd31-5901-4687-a106-6d1c7734ee3a	5e881b29-46a1-4787-8c79-b0591bf2ea0f
91	91	0	GBIF France	da44cd31-5901-4687-a106-6d1c7734ee3a	6117539b-6691-4432-9be6-40388561548b
101	101	0	GBIF Germany	4f6826f2-4ff6-443d-b966-e6913bd24013	61645fd4-f762-11e1-a439-00145eb45e9a
45	45	0	GBIF Germany	4f6826f2-4ff6-443d-b966-e6913bd24013	618816ea-f762-11e1-a439-00145eb45e9a
59	59	0	GBIF Germany	4f6826f2-4ff6-443d-b966-e6913bd24013	61ce64ba-f762-11e1-a439-00145eb45e9a
21	21	0	GBIF Germany	4f6826f2-4ff6-443d-b966-e6913bd24013	628e7ff2-f762-11e1-a439-00145eb45e9a
1733	1733	0	GBIF Germany	4f6826f2-4ff6-443d-b966-e6913bd24013	658f0ed8-f762-11e1-a439-00145eb45e9a
86	86	0	GBIF Germany	4f6826f2-4ff6-443d-b966-e6913bd24013	66657c8e-f762-11e1-a439-00145eb45e9a
57	57	0	GBIF Germany	4f6826f2-4ff6-443d-b966-e6913bd24013	669bc172-f762-11e1-a439-00145eb45e9a
25	25	0	GBIF Germany	4f6826f2-4ff6-443d-b966-e6913bd24013	6815d8e4-f762-11e1-a439-00145eb45e9a
90	90	0	GBIF Germany	4f6826f2-4ff6-443d-b966-e6913bd24013	6863e34a-f762-11e1-a439-00145eb45e9a
0	107	107	Plazi	ffb07bec-2d10-492d-9c37-361fe0b79427	689c39ea-b0ff-4062-9714-c5d49389ebd1
116	74	-42	GBIF Germany	4f6826f2-4ff6-443d-b966-e6913bd24013	68db2414-f762-11e1-a439-00145eb45e9a
46528	46528	0	DanBIF - Danish Biodiversity Information Facility	4ddd294f-02b7-4359-ac33-0806a9ca9c6b	6995b180-5755-499d-bf3e-1c8d83b42ac3
0	13	13	Plazi	ffb07bec-2d10-492d-9c37-361fe0b79427	69b283bd-3fe9-4c81-9274-3360f7f9ede3
55219	55219	0	GBIF Spain	1f94b3ca-9345-4d65-afe2-4bace93aa0fe	6a7575fa-ae03-4ba3-b322-2da15b5033e2
10	10	0	Plazi	ffb07bec-2d10-492d-9c37-361fe0b79427	6a86d4dc-e30f-4a44-85c4-4a4847a44742
22	22	0	GBIF Germany	4f6826f2-4ff6-443d-b966-e6913bd24013	6aa547a2-f762-11e1-a439-00145eb45e9a
0	22	22	Plazi	ffb07bec-2d10-492d-9c37-361fe0b79427	6cf7dece-9a31-4cba-9497-664a0ffac9d8
0	6	6	Plazi	ffb07bec-2d10-492d-9c37-361fe0b79427	6dc6e822-ea77-4998-84df-108f3c1e19cd
5	5	0	Plazi	ffb07bec-2d10-492d-9c37-361fe0b79427	6e58b963-16c5-4143-bc52-b5e911af4f87
13	13	0	Plazi	ffb07bec-2d10-492d-9c37-361fe0b79427	6e9cff4b-1933-4022-99e2-b20ac41a65f1
0	3	3	Plazi	ffb07bec-2d10-492d-9c37-361fe0b79427	6ec7ad0f-4477-463e-b287-9fc7663fff61
6192	6192	0	National Biodiversity Network	d897a5b9-35ee-4232-94bd-b0bcaac003c2	6ef41d6f-2ba4-4afc-8b80-b16632ebe47d
0	2	2	Plazi	ffb07bec-2d10-492d-9c37-361fe0b79427	6f10efa2-8c42-4a8f-a30a-36969b81ebe2
3097	3097	0	GBIF France	da44cd31-5901-4687-a106-6d1c7734ee3a	6fb5f9aa-7688-4feb-a735-6353c93c53cf
0	46	46	Plazi	ffb07bec-2d10-492d-9c37-361fe0b79427	71a424f6-44db-4010-ab15-6a0b57f75b87
2406	2406	0	GBIF Spain	1f94b3ca-9345-4d65-afe2-4bace93aa0fe	71d6a0a2-f762-11e1-a439-00145eb45e9a
110	110	0	GBIF Germany	4f6826f2-4ff6-443d-b966-e6913bd24013	744489e4-f762-11e1-a439-00145eb45e9a
11	11	0	GBIF France	da44cd31-5901-4687-a106-6d1c7734ee3a	7581365e-0984-4ac9-8642-04686c671a1b
241	241	0	GBIF Germany	4f6826f2-4ff6-443d-b966-e6913bd24013	75cea1b4-f762-11e1-a439-00145eb45e9a
796	637	-159	GBIF Germany	4f6826f2-4ff6-443d-b966-e6913bd24013	7642f1fe-4e5a-4d28-b535-a4d48db3b92b
2740	2740	0	GBIF Spain	1f94b3ca-9345-4d65-afe2-4bace93aa0fe	766cfff5-853d-4fb0-a4f7-2f7ef121a757
4733	4733	0	GBIF France	da44cd31-5901-4687-a106-6d1c7734ee3a	769539e1-b8d3-4e85-8d15-ff2e579364d5
41	41	0	GBIF Germany	4f6826f2-4ff6-443d-b966-e6913bd24013	784a3386-f762-11e1-a439-00145eb45e9a
27	27	0	Plazi	ffb07bec-2d10-492d-9c37-361fe0b79427	78ece236-9809-4e22-b542-41160c5a5c8b
38	38	0	GBIF Germany	4f6826f2-4ff6-443d-b966-e6913bd24013	79290a5c-f762-11e1-a439-00145eb45e9a
29648	31775	2127	GBIF Germany	4f6826f2-4ff6-443d-b966-e6913bd24013	7b84c0a2-f762-11e1-a439-00145eb45e9a
26	26	0	GBIF Germany	4f6826f2-4ff6-443d-b966-e6913bd24013	7bcac5ac-f762-11e1-a439-00145eb45e9a
204	51	-153	GBIF Germany	4f6826f2-4ff6-443d-b966-e6913bd24013	7d90ebdc-f762-11e1-a439-00145eb45e9a
20	20	0	GBIF Germany	4f6826f2-4ff6-443d-b966-e6913bd24013	7e191e62-f762-11e1-a439-00145eb45e9a
794	754	-40	GBIF Germany	4f6826f2-4ff6-443d-b966-e6913bd24013	7e1f7de8-f762-11e1-a439-00145eb45e9a
1084	459	-625	GBIF Germany	4f6826f2-4ff6-443d-b966-e6913bd24013	7e66e570-f762-11e1-a439-00145eb45e9a
35	35	0	Biodiversity Information System of Mexico	b324e8e9-9a4c-44fa-8f1a-7f39ea7ab576	7f9e95a0-f762-11e1-a439-00145eb45e9a
906	906	0	Biodiversity Information System of Mexico	b324e8e9-9a4c-44fa-8f1a-7f39ea7ab576	7fad2d40-f762-11e1-a439-00145eb45e9a
1390	1390	0	Biodiversity Information System of Mexico	b324e8e9-9a4c-44fa-8f1a-7f39ea7ab576	80036d2c-f762-11e1-a439-00145eb45e9a
5	5	0	GBIF Germany	4f6826f2-4ff6-443d-b966-e6913bd24013	8259b55e-f762-11e1-a439-00145eb45e9a
3	3	0	Plazi	ffb07bec-2d10-492d-9c37-361fe0b79427	835e776e-2eea-409f-8c8e-3f4a1887a021
17573	17573	0	GBIF Spain	1f94b3ca-9345-4d65-afe2-4bace93aa0fe	8386db32-f762-11e1-a439-00145eb45e9a
1000	1000	0	GBIF Japan	db5705aa-6a6e-42f1-8942-d77b9f4896ea	868c0cb2-f762-11e1-a439-00145eb45e9a
265	265	0	National Biodiversity Network	d897a5b9-35ee-4232-94bd-b0bcaac003c2	876e5651-4e45-4c36-a665-04761e3b07c4
1141	887	-254	GBIF Germany	4f6826f2-4ff6-443d-b966-e6913bd24013	8823d0be-f762-11e1-a439-00145eb45e9a
289	289	0	GBIF Germany	4f6826f2-4ff6-443d-b966-e6913bd24013	89bcf7a2-f762-11e1-a439-00145eb45e9a
798	798	0	Scientific Committee on Antarctic Research	51e4e8ff-bff0-4996-8b27-9107d61b3478	89ed0b61-e110-4735-8774-8ac3a7fc3eb7
52	52	0	GBIF Germany	4f6826f2-4ff6-443d-b966-e6913bd24013	8a047410-f762-11e1-a439-00145eb45e9a
134	134	0	GBIF Germany	4f6826f2-4ff6-443d-b966-e6913bd24013	8abfe9ca-f762-11e1-a439-00145eb45e9a
27	22	-5	GBIF Germany	4f6826f2-4ff6-443d-b966-e6913bd24013	8c57778a-f762-11e1-a439-00145eb45e9a
10	5	-5	GBIF Germany	4f6826f2-4ff6-443d-b966-e6913bd24013	8c759d8c-f762-11e1-a439-00145eb45e9a
0	12	12	Plazi	ffb07bec-2d10-492d-9c37-361fe0b79427	8d0f9916-2e32-4811-866a-8e561c98c4ff
0	1328	1328	Participant Node Managers Committee	7f48e0c8-5c96-49ec-b972-30748e339115	8d8218b1-835d-43ef-ac2d-34c746277528
70546	70546	0	National Biodiversity Network	d897a5b9-35ee-4232-94bd-b0bcaac003c2	8daa6ada-eb9a-419b-913a-3c527800731b
0	17	17	Atlas of Living Australia	4a6f1b71-969e-4fc5-a693-282b05e1220c	8e0cd33a-fb8d-4464-96da-48a7897f98c5
171	171	0	GBIF Germany	4f6826f2-4ff6-443d-b966-e6913bd24013	8ec1b5c6-f762-11e1-a439-00145eb45e9a
2	2	0	GBIF Germany	4f6826f2-4ff6-443d-b966-e6913bd24013	901f65bc-f762-11e1-a439-00145eb45e9a
5354	5354	0	GBIF France	da44cd31-5901-4687-a106-6d1c7734ee3a	90426bd9-2928-46c9-a1cd-b86deca94d56
8	8	0	GBIF Germany	4f6826f2-4ff6-443d-b966-e6913bd24013	92d740ea-f762-11e1-a439-00145eb45e9a
0	2	2	Plazi	ffb07bec-2d10-492d-9c37-361fe0b79427	92f531c1-88a2-4a6b-886b-aafb5e4f6d8a
151	151	0	GBIF Germany	4f6826f2-4ff6-443d-b966-e6913bd24013	9330d0b0-f762-11e1-a439-00145eb45e9a
113	113	0	GBIF Germany	4f6826f2-4ff6-443d-b966-e6913bd24013	939c4a5c-f762-11e1-a439-00145eb45e9a
4177	4177	0	GBIF Germany	4f6826f2-4ff6-443d-b966-e6913bd24013	94acdc4f-95c1-4009-8612-656ae99d0943
14	14	0	GBIF Germany	4f6826f2-4ff6-443d-b966-e6913bd24013	94eae9c2-f762-11e1-a439-00145eb45e9a
0	98	98	Ocean Biodiversity Information System	ba0670b9-4186-41e6-8e70-f9cb3065551a	95430178-4eff-4f90-9fd1-12f47fb4841c
62	62	0	GBIF Germany	4f6826f2-4ff6-443d-b966-e6913bd24013	9552e93c-f762-11e1-a439-00145eb45e9a
1954698	1954698	0	GBIF Spain	1f94b3ca-9345-4d65-afe2-4bace93aa0fe	95e635d4-f762-11e1-a439-00145eb45e9a
65	65	0	GBIF Germany	4f6826f2-4ff6-443d-b966-e6913bd24013	9662f7f4-f762-11e1-a439-00145eb45e9a
0	9	9	Plazi	ffb07bec-2d10-492d-9c37-361fe0b79427	9684afb2-e20b-4188-9f94-4abe912c84fd
68	68	0	Plazi	ffb07bec-2d10-492d-9c37-361fe0b79427	96d0408b-bac5-4478-bb2b-d01b33c5459e
6	6	0	Plazi	ffb07bec-2d10-492d-9c37-361fe0b79427	97c4e80a-b0a1-4873-8825-979f04b863ff
3	3	0	Plazi	ffb07bec-2d10-492d-9c37-361fe0b79427	98468a52-0cd1-4116-bfdb-ce079fc2512b
13	13	0	Participant Node Managers Committee	7f48e0c8-5c96-49ec-b972-30748e339115	992a5c29-7903-42d5-ae48-ee3592429fc4
10	10	0	Plazi	ffb07bec-2d10-492d-9c37-361fe0b79427	99c5e241-0bc7-41eb-bf28-5dc9adbd660d
1101	1101	0	Biodiversity Information System of Mexico	b324e8e9-9a4c-44fa-8f1a-7f39ea7ab576	9a0983a1-55dc-4492-bd6c-4085a36dcddc
5	5	0	Plazi	ffb07bec-2d10-492d-9c37-361fe0b79427	9a1ccd2b-18a0-4a3b-9a71-af6a3498fbbc
339	339	0	Participant Node Managers Committee	7f48e0c8-5c96-49ec-b972-30748e339115	9c9fdc42-ca6d-448f-b94d-c696e91a8551
161	161	0	Colombian Biodiversity Information System	7e865cba-7c46-417b-ade5-97f2cf5b7be0	9ce80b03-2e8d-4c69-b842-2702ef5aae59
0	5	5	Plazi	ffb07bec-2d10-492d-9c37-361fe0b79427	9cf835cb-0b1d-475b-853e-1b3c4a1f8d4c
0	85	85	Plazi	ffb07bec-2d10-492d-9c37-361fe0b79427	9e73be91-fc4a-4e48-84ae-09453e2785a2
1	1	0	Plazi	ffb07bec-2d10-492d-9c37-361fe0b79427	9ed7693d-48db-4c49-a23b-dcf80d828baf
95	95	0	Plazi	ffb07bec-2d10-492d-9c37-361fe0b79427	a22e3d95-1179-4ba9-86e3-669ddc133827
20	20	0	Plazi	ffb07bec-2d10-492d-9c37-361fe0b79427	a7bdef97-ad23-4b5e-9b0e-81e2f3583246
3	3	0	Plazi	ffb07bec-2d10-492d-9c37-361fe0b79427	aa6a76e2-8352-42f5-9904-ad3128a8daae
2656	2656	0	National Biodiversity Network	d897a5b9-35ee-4232-94bd-b0bcaac003c2	ab0d4f36-9e0d-43f8-9f03-edb2bb0b1277
14	14	0	Plazi	ffb07bec-2d10-492d-9c37-361fe0b79427	acea2002-b0b5-42dd-b994-308136d19d5e
25	25	0	Plazi	ffb07bec-2d10-492d-9c37-361fe0b79427	ae0ff951-7852-49da-a304-ef4dc7d3d87a
3	3	0	Plazi	ffb07bec-2d10-492d-9c37-361fe0b79427	ae70ea6b-56d8-4cb7-95ce-3b99cc32ffd2
2	2	0	Plazi	ffb07bec-2d10-492d-9c37-361fe0b79427	b1745231-e1cf-4233-9ac1-5e6b16290017
14563	14563	0	National Biodiversity Network	d897a5b9-35ee-4232-94bd-b0bcaac003c2	b388474c-79b5-40a1-be79-b270fab02a6f
0	58	58	Plazi	ffb07bec-2d10-492d-9c37-361fe0b79427	b45bff74-c586-4ef6-9b6d-0dd539dd7f1f
189	189	0	Colombian Biodiversity Information System	7e865cba-7c46-417b-ade5-97f2cf5b7be0	b60d4528-6efc-4623-9f6b-1f8300f140ee
25	25	0	Plazi	ffb07bec-2d10-492d-9c37-361fe0b79427	ba998bbc-f1e9-48cb-b16a-678640344c9c
81908	81908	0	GBIF Spain	1f94b3ca-9345-4d65-afe2-4bace93aa0fe	bb30e03a-b746-49e4-bab9-decbf27abdf1
3	3	0	Plazi	ffb07bec-2d10-492d-9c37-361fe0b79427	bd60e9e8-2cb9-4bc8-9808-8b852bf4364f
15	15	0	Plazi	ffb07bec-2d10-492d-9c37-361fe0b79427	c037de53-704c-460e-96ff-23867526f71b
1292	912	-380	GBIF Germany	4f6826f2-4ff6-443d-b966-e6913bd24013	c15928b9-adb5-405d-afec-f3971228a504
3083	3083	0	GBIF Benin	efb9c00e-f802-45dd-8826-a52ec45b89ff	c349aada-38d4-4602-99c1-5939680ad9cb
2	2	0	Plazi	ffb07bec-2d10-492d-9c37-361fe0b79427	c43398cc-5d6e-4f20-86d5-7ed3ca704531
492	407	-85	Plazi	ffb07bec-2d10-492d-9c37-361fe0b79427	c5485455-7e73-4576-a5dd-ece493b0a087
0	26	26	Participant Node Managers Committee	7f48e0c8-5c96-49ec-b972-30748e339115	c5ee2810-2f42-44ce-8b75-bfe6944074a0
106	106	0	GBIF Guinea	b1cd2e84-c4ba-47bd-b72a-dfd1f92dce0a	c7cb536c-83e4-4a8b-a255-4619142378b1
150	150	0	Plazi	ffb07bec-2d10-492d-9c37-361fe0b79427	c83713b2-c7e2-47cd-9cb7-0370414a4520
1	1	0	Plazi	ffb07bec-2d10-492d-9c37-361fe0b79427	c9e20a3d-2f93-46b7-8abe-135273e757e1
247	247	0	Colombian Biodiversity Information System	7e865cba-7c46-417b-ade5-97f2cf5b7be0	ca0570b0-b758-4c93-bb01-c4f54775d03b
36	36	0	Plazi	ffb07bec-2d10-492d-9c37-361fe0b79427	ca79735b-9726-4a85-b3d7-c05f08a966bf
0	17	17	Plazi	ffb07bec-2d10-492d-9c37-361fe0b79427	cdb079cb-973c-4fc2-a16f-e06f5b6cc0f5
3	3	0	Plazi	ffb07bec-2d10-492d-9c37-361fe0b79427	ce6d084f-a28b-469b-961d-60f1f9facde5
6717	6656	-61	Biodiversity Information System of Mexico	b324e8e9-9a4c-44fa-8f1a-7f39ea7ab576	d056f586-b5a0-494c-990b-854ddfe18f77
3	3	0	Plazi	ffb07bec-2d10-492d-9c37-361fe0b79427	d072e293-85f1-4381-9707-5f9bda901f59
0	41	41	Ocean Biodiversity Information System	ba0670b9-4186-41e6-8e70-f9cb3065551a	d12786ae-e23d-4cc3-9f9e-a562dabde64e
0	955	955	Plazi	ffb07bec-2d10-492d-9c37-361fe0b79427	d3f24fd7-5da2-4ab8-928a-b519df8ec1c2
0	2	2	Plazi	ffb07bec-2d10-492d-9c37-361fe0b79427	d5564428-4d7a-4bca-9c71-3054d0bb654b
3	3	0	Plazi	ffb07bec-2d10-492d-9c37-361fe0b79427	d5b203f1-33ac-4a7c-aa08-faff8fda9442
8	8	0	Plazi	ffb07bec-2d10-492d-9c37-361fe0b79427	d603a743-e7ee-4bd2-a084-f77a19713ae3
26	26	0	Plazi	ffb07bec-2d10-492d-9c37-361fe0b79427	d6761c7f-7267-4d4a-b50f-8c25be953432
93	93	0	GBIF France	da44cd31-5901-4687-a106-6d1c7734ee3a	dc1fc701-243c-4c47-8697-1b4d6afd415d
148143	148143	0	Ocean Biodiversity Information System	ba0670b9-4186-41e6-8e70-f9cb3065551a	de465000-f2d4-41c5-8c90-afd41602759f
306	306	0	GBIF France	da44cd31-5901-4687-a106-6d1c7734ee3a	de469e14-b96a-4907-ac12-2545c384322e
3782	1116	-2666	GBIF Germany	4f6826f2-4ff6-443d-b966-e6913bd24013	dfb57886-8824-48c4-baaf-9e3732ea3cd2
2	2	0	Plazi	ffb07bec-2d10-492d-9c37-361fe0b79427	e186b71c-87cc-436f-9c2c-0448cea093f7
3	3	0	Plazi	ffb07bec-2d10-492d-9c37-361fe0b79427	e3d177b0-98c4-465c-a897-f5995098d91c
10	10	0	Plazi	ffb07bec-2d10-492d-9c37-361fe0b79427	e594aaf6-becd-489c-ade9-c0391183f309
0	5414	5414	Participant Node Managers Committee	7f48e0c8-5c96-49ec-b972-30748e339115	e5f82c34-0dbb-46a4-9c45-faccc8930034
159	159	0	Colombian Biodiversity Information System	7e865cba-7c46-417b-ade5-97f2cf5b7be0	e68841b5-385c-49d3-b4b4-7bd7d793764e
2	2	0	Plazi	ffb07bec-2d10-492d-9c37-361fe0b79427	e6ead60f-cead-4d74-a496-adafaf4b9018
5	5	0	Plazi	ffb07bec-2d10-492d-9c37-361fe0b79427	ea719b89-e716-4aad-b244-2548174c7642
262	262	0	GBIF Nigeria	6529bcb5-a542-4fda-be87-54a624515335	eb273c21-e94a-48df-a599-4f869502b4eb
25	25	0	Plazi	ffb07bec-2d10-492d-9c37-361fe0b79427	eb86cc65-285f-49a8-b39f-a79c137d3ac0
3	3	0	Plazi	ffb07bec-2d10-492d-9c37-361fe0b79427	ed21597b-d181-4b10-ae7c-4ff9df0f1062
321	321	0	Colombian Biodiversity Information System	7e865cba-7c46-417b-ade5-97f2cf5b7be0	ed3093d3-7f6b-4da7-8726-f800531a5d7f
0	13	13	Plazi	ffb07bec-2d10-492d-9c37-361fe0b79427	ee9bfd7b-3b05-4403-9af2-e54beaae5e69
0	82	82	Plazi	ffb07bec-2d10-492d-9c37-361fe0b79427	f1784e4b-8de8-4951-8f21-e453531a125c
0	46	46	Plazi	ffb07bec-2d10-492d-9c37-361fe0b79427	f2e0a8cb-0ebe-4c94-96e1-67803f77035e
839	839	0	GBIF Germany	4f6826f2-4ff6-443d-b966-e6913bd24013	f2faec4b-3598-4de5-b2f8-7bb8d437a78c
1	1	0	Plazi	ffb07bec-2d10-492d-9c37-361fe0b79427	f40808e1-f95c-40f4-bc75-47fcbe55c95b
1	1	0	Plazi	ffb07bec-2d10-492d-9c37-361fe0b79427	f4ae7788-f8bc-4c03-b3ce-4a84384b4ba5
0	6	6	Plazi	ffb07bec-2d10-492d-9c37-361fe0b79427	f572993a-25e4-44bf-80f8-2b9075a81a29
4382	4382	0	National Biodiversity Network	d897a5b9-35ee-4232-94bd-b0bcaac003c2	f608de8b-7b3b-486e-8635-2fbd2125234a
109	64	-45	GBIF Germany	4f6826f2-4ff6-443d-b966-e6913bd24013	f7f8fc1b-0540-44ca-a907-e0e3fe164ef0
3	3	0	Plazi	ffb07bec-2d10-492d-9c37-361fe0b79427	f8ed8b91-1839-4c42-871d-033a67c55a4b
45	45	0	National Biodiversity Network	d897a5b9-35ee-4232-94bd-b0bcaac003c2	f94d9259-dff1-461a-8fc3-7476be2cc149
9	9	0	Plazi	ffb07bec-2d10-492d-9c37-361fe0b79427	fb2cc09e-5c36-4abb-b316-8e447e68fcba
0	2	2	Plazi	ffb07bec-2d10-492d-9c37-361fe0b79427	fb934420-5ff6-4b95-a909-cfe02af48a88
9	9	0	Plazi	ffb07bec-2d10-492d-9c37-361fe0b79427	fd9edc0b-4e36-4fa6-b4e9-33599b22f984
20	20	0	Colombian Biodiversity Information System	7e865cba-7c46-417b-ade5-97f2cf5b7be0	00029085-9665-4ef8-8e1e-a61f48947d14
1107	1107	0	GBIF Portugal	673f7038-4262-4149-b753-5658a4e912f6	013f0b8f-e783-4afe-936a-6095d27dce60
12	12	0	Plazi	ffb07bec-2d10-492d-9c37-361fe0b79427	04551b91-834c-45a9-b978-3e80ebd269f9
0	194	194	Plazi	ffb07bec-2d10-492d-9c37-361fe0b79427	045b347a-4a5b-474f-b69f-1cd3fedf7678
0	1	1	Plazi	ffb07bec-2d10-492d-9c37-361fe0b79427	050e38c6-fc77-4fcf-a3ae-f235da02fd8c
2	2	0	Plazi	ffb07bec-2d10-492d-9c37-361fe0b79427	074c6ee6-2078-4a81-a9ee-2ad09eda55f2
1069	1069	0	National Biodiversity Network	d897a5b9-35ee-4232-94bd-b0bcaac003c2	0832ee1e-69e6-495e-9eb0-74af67f333f9
177814	177814	0	GBIF Norway	4f829580-180d-46a9-9c87-ed8ec959b545	09c38deb-8674-446e-8be8-3347f6c094ef
0	9	9	Plazi	ffb07bec-2d10-492d-9c37-361fe0b79427	0baa733e-6e79-4600-a069-3a1a9f87fbec
0	6	6	Plazi	ffb07bec-2d10-492d-9c37-361fe0b79427	0bd227f6-4487-4abb-a1ef-500074cb505f
0	746	746	Participant Node Managers Committee	7f48e0c8-5c96-49ec-b972-30748e339115	0beb6242-9b57-4d2a-a0a2-bfd202696017
0	1	1	Plazi	ffb07bec-2d10-492d-9c37-361fe0b79427	11d81de6-a98f-44a8-a709-72b41ae93d07
159	159	0	GBIF France	da44cd31-5901-4687-a106-6d1c7734ee3a	1227d605-9608-4017-b8ff-823345394340
5	5	0	Plazi	ffb07bec-2d10-492d-9c37-361fe0b79427	12394e68-e0ee-4794-ba25-6d3ee8f708cd
741	741	0	GBIF France	da44cd31-5901-4687-a106-6d1c7734ee3a	14792177-528a-4ef0-83ec-933f4428c6d0
3	3	0	Plazi	ffb07bec-2d10-492d-9c37-361fe0b79427	1579a53d-d43d-484a-b35b-b69db5b2ce6f
227	227	0	GBIF Germany	4f6826f2-4ff6-443d-b966-e6913bd24013	165af79d-00c9-434c-8882-387d232924cf
1	1	0	Participant Node Managers Committee	7f48e0c8-5c96-49ec-b972-30748e339115	167f0b87-f13e-4d5d-ba02-e13ba8d35504
0	21	21	Plazi	ffb07bec-2d10-492d-9c37-361fe0b79427	16de4a1e-812a-4cd1-bf5b-0962b94094d5
923	923	0	GBIF France	da44cd31-5901-4687-a106-6d1c7734ee3a	17171ffe-aa86-4b64-bd66-436ce65d301f
41524	56136	14612	National Biodiversity Network	d897a5b9-35ee-4232-94bd-b0bcaac003c2	1a20c977-7365-49d2-8100-5978d4e52234
14467	14458	-9	National Biodiversity Network	d897a5b9-35ee-4232-94bd-b0bcaac003c2	1b11a5e3-6991-44fd-848b-6fd9c1368c58
407	407	0	GBIF France	da44cd31-5901-4687-a106-6d1c7734ee3a	1b2ef9d5-4bec-44a6-8471-59fce469d979
0	2630	2630	GBIF Chile	a8b16421-d80b-4ef3-8f22-098b01a89255	1c2d9ae7-5518-40e2-8e12-1bc7e6a1d641
543	543	0	GBIF France	da44cd31-5901-4687-a106-6d1c7734ee3a	1ea700b0-994c-4333-b487-e4e7d7f635cb
0	34	34	Plazi	ffb07bec-2d10-492d-9c37-361fe0b79427	1f68120f-f2ce-465f-a4a7-d1dae86a80f9
5	5	0	Plazi	ffb07bec-2d10-492d-9c37-361fe0b79427	21295adb-2000-4eda-a04e-bf11cc0a63ff
2000	2000	0	Biodiversity Information System of Mexico	b324e8e9-9a4c-44fa-8f1a-7f39ea7ab576	2156d878-3a61-4e0a-b319-baf987a3539e
18	18	0	Plazi	ffb07bec-2d10-492d-9c37-361fe0b79427	22bf1c43-357e-4150-af87-98d6e8f5743e
823	823	0	GBIF France	da44cd31-5901-4687-a106-6d1c7734ee3a	230b1809-cd8c-44ad-9873-3b0caa7f740a
0	657	657	Ocean Biodiversity Information System	ba0670b9-4186-41e6-8e70-f9cb3065551a	23323902-f8ea-470c-967e-a0b0f849a742
3138	3138	0	Symbiota Support Hub	612b5a0b-908b-4b4e-b9bf-ca15dfdc94fa	27079a74-465d-455f-8bb2-e5bc1bb2d45d
861	861	0	Participant Node Managers Committee	7f48e0c8-5c96-49ec-b972-30748e339115	284d9f39-c990-4c77-b725-8261526cf68d
1134	1134	0	GBIF Germany	4f6826f2-4ff6-443d-b966-e6913bd24013	297bd796-8961-4586-bc6c-1e552ce966fe
603	603	0	GBIF France	da44cd31-5901-4687-a106-6d1c7734ee3a	29e6c582-3bf3-4efc-a0a6-4b4e8c0c7ff6
63782	63782	0	GBIF Brazil	cdc9736d-5ff7-4ece-9959-3c744360cdb3	2a629a9a-38d1-496b-afbf-b4ff3b8fae60
434	434	0	Colombian Biodiversity Information System	7e865cba-7c46-417b-ade5-97f2cf5b7be0	2a7258fc-e85c-4d37-b908-11d3d522f128
2	2	0	Plazi	ffb07bec-2d10-492d-9c37-361fe0b79427	2af670ee-e5c1-44ce-9bde-6eaa435dafab
19	19	0	Participant Node Managers Committee	7f48e0c8-5c96-49ec-b972-30748e339115	2c835770-d125-4d2c-8ac2-2d5beb044928
736	736	0	Biodiversity Information System of Mexico	b324e8e9-9a4c-44fa-8f1a-7f39ea7ab576	2d2213ca-a53c-4c9a-b69c-ec595d3e4bfa
0	15	15	Plazi	ffb07bec-2d10-492d-9c37-361fe0b79427	2f0e5269-a3b3-489e-a4c1-7e766cefb113
964	964	0	Colombian Biodiversity Information System	7e865cba-7c46-417b-ade5-97f2cf5b7be0	2f1f826c-c169-4479-8de3-8c7df4e7e04c
0	1	1	Plazi	ffb07bec-2d10-492d-9c37-361fe0b79427	31c6b6c1-e277-4725-a29d-4f09df14b345
0	432	432	Plazi	ffb07bec-2d10-492d-9c37-361fe0b79427	413bb30f-07f2-4bc3-bbdf-01d7e0af90c5
6	6	0	National Biodiversity Network	d897a5b9-35ee-4232-94bd-b0bcaac003c2	432454ee-d862-4c58-9f24-3144180f871c
2	2	0	GBIF France	da44cd31-5901-4687-a106-6d1c7734ee3a	433f1575-26fa-4841-864d-fcbd5cf65df8
2	2	0	Plazi	ffb07bec-2d10-492d-9c37-361fe0b79427	444aaba3-bae4-4eff-a72a-dea518bcc453
20889	20887	-2	National Biodiversity Network	d897a5b9-35ee-4232-94bd-b0bcaac003c2	491648cb-7e3a-42f4-8b86-fca1bcc82173
0	2	2	Plazi	ffb07bec-2d10-492d-9c37-361fe0b79427	4a416170-9bbe-42c1-8eeb-9311dfa6bf77
496	496	0	GBIF France	da44cd31-5901-4687-a106-6d1c7734ee3a	4b15c3ca-01e6-459f-bf0e-6d601eced2d7
6821	6821	0	GBIF Germany	4f6826f2-4ff6-443d-b966-e6913bd24013	4c266400-b0a3-11e2-a01d-00145eb45e9a
2	2	0	Plazi	ffb07bec-2d10-492d-9c37-361fe0b79427	4d3eeab0-3ed0-4cac-87d2-836086d988f5
26	26	0	Plazi	ffb07bec-2d10-492d-9c37-361fe0b79427	4e59688a-fdae-45a4-b845-933c2128f26e
1299	1299	0	Observation International	ad048418-7cd8-4070-a151-fe1c1f303129	4ea0d3ad-eab4-4c2c-87b4-8247eae6cec5
1696	1696	0	Netherlands Biodiversity Information Facility	0909d601-bda2-42df-9e63-a6d51847ebce	4eb871a4-6dc4-4db6-abf2-3ab553a41008
403	403	0	National Biodiversity Network	d897a5b9-35ee-4232-94bd-b0bcaac003c2	4f8b0628-7833-46e6-8871-9a50922b4665
33	33	0	Plazi	ffb07bec-2d10-492d-9c37-361fe0b79427	5002a2e0-25ad-4052-b7a8-04b44b755507
3234	1911	-1323	GBIF Germany	4f6826f2-4ff6-443d-b966-e6913bd24013	50858f88-192d-464b-8df3-613a49b44f63
0	19	19	Plazi	ffb07bec-2d10-492d-9c37-361fe0b79427	539c0af2-fb4b-495a-8698-adb94eb7e220
14	14	0	Plazi	ffb07bec-2d10-492d-9c37-361fe0b79427	583087fa-91cd-45fb-9a30-b871fd8cdfa4
1863	1863	0	U.S. Geological Survey	8618c64a-93e0-4300-b546-7249e5148ed2	588a6d6b-da58-4d99-8d98-84b4e6f4332f
19	19	0	GBIF Finland	dd514216-5c7c-45f3-910d-797424cb5be6	58f8b744-6609-4c1e-86c1-b6d9a26ea80d
5	5	0	Plazi	ffb07bec-2d10-492d-9c37-361fe0b79427	5934371f-867e-4f01-a97d-fb10afe72b45
11	11	0	Plazi	ffb07bec-2d10-492d-9c37-361fe0b79427	5937abdc-2908-43ba-8872-8f5d34574544
1	1	0	Participant Node Managers Committee	7f48e0c8-5c96-49ec-b972-30748e339115	5d2cdc99-e29f-473b-a71c-9f3a211c5fed
0	3	3	Plazi	ffb07bec-2d10-492d-9c37-361fe0b79427	5d409a91-3980-45fc-9aa0-c611e435cc4f
1	1	0	Plazi	ffb07bec-2d10-492d-9c37-361fe0b79427	5d8055c6-d033-477b-afcf-38cfa42db86c
611	611	0	Participant Node Managers Committee	7f48e0c8-5c96-49ec-b972-30748e339115	5fb59b97-5ae7-473a-bb66-c4da8703700f
54054	54054	0	Participant Node Managers Committee	7f48e0c8-5c96-49ec-b972-30748e339115	6043b710-f1a6-48bb-a473-8b32b1e43408
105	105	0	GBIF Germany	4f6826f2-4ff6-443d-b966-e6913bd24013	6157ca30-f762-11e1-a439-00145eb45e9a
0	3	3	Plazi	ffb07bec-2d10-492d-9c37-361fe0b79427	61a2eb56-835c-4492-9263-788ea1700aed
68	68	0	GBIF Germany	4f6826f2-4ff6-443d-b966-e6913bd24013	61f18300-f762-11e1-a439-00145eb45e9a
20	20	0	GBIF Germany	4f6826f2-4ff6-443d-b966-e6913bd24013	62e3e80c-f762-11e1-a439-00145eb45e9a
255	255	0	GBIF Spain	1f94b3ca-9345-4d65-afe2-4bace93aa0fe	635bba62-f762-11e1-a439-00145eb45e9a
146	146	0	GBIF Germany	4f6826f2-4ff6-443d-b966-e6913bd24013	63850264-f762-11e1-a439-00145eb45e9a
417	417	0	GBIF Germany	4f6826f2-4ff6-443d-b966-e6913bd24013	654fcac0-f762-11e1-a439-00145eb45e9a
260	243	-17	GBIF Germany	4f6826f2-4ff6-443d-b966-e6913bd24013	65daa992-f762-11e1-a439-00145eb45e9a
22	22	0	Plazi	ffb07bec-2d10-492d-9c37-361fe0b79427	67846749-8510-4ff2-85c1-d9a684cf72a8
4	4	0	GBIF Germany	4f6826f2-4ff6-443d-b966-e6913bd24013	68825f28-f762-11e1-a439-00145eb45e9a
12	12	0	GBIF Germany	4f6826f2-4ff6-443d-b966-e6913bd24013	68f11576-f762-11e1-a439-00145eb45e9a
692	692	0	GBIF Germany	4f6826f2-4ff6-443d-b966-e6913bd24013	6974eb9e-f762-11e1-a439-00145eb45e9a
88	88	0	GBIF Germany	4f6826f2-4ff6-443d-b966-e6913bd24013	69b728ba-f762-11e1-a439-00145eb45e9a
0	10	10	Plazi	ffb07bec-2d10-492d-9c37-361fe0b79427	6a459a8b-e0b7-4363-b5a3-fed81ae45147
0	30	30	Plazi	ffb07bec-2d10-492d-9c37-361fe0b79427	6be06381-fe28-43d2-8166-d40f1f1c35d0
43	43	0	Biodiversity Information System of Mexico	b324e8e9-9a4c-44fa-8f1a-7f39ea7ab576	6c978327-3e61-42c3-95a6-0eee8452f68c
53	53	0	GBIF Germany	4f6826f2-4ff6-443d-b966-e6913bd24013	6d4bdde0-f762-11e1-a439-00145eb45e9a
1195	1462	267	GBIF Spain	1f94b3ca-9345-4d65-afe2-4bace93aa0fe	6d6e8d0a-de6f-4553-8d40-c9465c3fe10e
9	9	0	Participant Node Managers Committee	7f48e0c8-5c96-49ec-b972-30748e339115	6e2660c3-8ec4-41bf-9c47-e120ca2a15f0
19051	19061	10	Canada Biodiversity Information Facility	8f83fc96-c966-4126-83f7-bf044dc49efa	7086bdef-e377-4ac5-872f-751b1d614ed2
2357	2357	0	GBIF Germany	4f6826f2-4ff6-443d-b966-e6913bd24013	70a4a2e2-f762-11e1-a439-00145eb45e9a
12608	12608	0	GBIF France	da44cd31-5901-4687-a106-6d1c7734ee3a	716225f1-1257-4b54-a364-b22c327f0a71
0	782	782	Ocean Biodiversity Information System	ba0670b9-4186-41e6-8e70-f9cb3065551a	731820d0-5054-4dec-b630-daed72751475
72	72	0	GBIF Germany	4f6826f2-4ff6-443d-b966-e6913bd24013	736902fc-f762-11e1-a439-00145eb45e9a
50	50	0	GBIF Germany	4f6826f2-4ff6-443d-b966-e6913bd24013	741bf826-f762-11e1-a439-00145eb45e9a
91	91	0	GBIF Germany	4f6826f2-4ff6-443d-b966-e6913bd24013	741fd5ea-f762-11e1-a439-00145eb45e9a
7	7	0	GBIF Germany	4f6826f2-4ff6-443d-b966-e6913bd24013	77716c0a-d500-42c2-a557-f16ae2e232f5
0	32	32	Plazi	ffb07bec-2d10-492d-9c37-361fe0b79427	792339e9-8e7a-4675-b5fd-238b6cfe7532
42	42	0	GBIF Germany	4f6826f2-4ff6-443d-b966-e6913bd24013	7a5195c4-7307-4504-a025-00a943ea4260
0	265	265	Plazi	ffb07bec-2d10-492d-9c37-361fe0b79427	7bde971d-69fe-4492-acf1-68fc1d57660c
480	100	-380	GBIF Germany	4f6826f2-4ff6-443d-b966-e6913bd24013	7bfa9192-f762-11e1-a439-00145eb45e9a
925	703	-222	GBIF Germany	4f6826f2-4ff6-443d-b966-e6913bd24013	7c342074-f762-11e1-a439-00145eb45e9a
66	66	0	GBIF Germany	4f6826f2-4ff6-443d-b966-e6913bd24013	7ca39486-f762-11e1-a439-00145eb45e9a
820	820	0	GBIF Germany	4f6826f2-4ff6-443d-b966-e6913bd24013	7de1e65e-f762-11e1-a439-00145eb45e9a
80	80	0	GBIF Germany	4f6826f2-4ff6-443d-b966-e6913bd24013	7e5b5368-f762-11e1-a439-00145eb45e9a
521	521	0	GBIF Germany	4f6826f2-4ff6-443d-b966-e6913bd24013	7e9d4c0a-f762-11e1-a439-00145eb45e9a
538	538	0	GBIF Germany	4f6826f2-4ff6-443d-b966-e6913bd24013	7f2b3e66-f762-11e1-a439-00145eb45e9a
118	101	-17	GBIF Germany	4f6826f2-4ff6-443d-b966-e6913bd24013	82246db8-f762-11e1-a439-00145eb45e9a
208	136	-72	GBIF Germany	4f6826f2-4ff6-443d-b966-e6913bd24013	82373132-f762-11e1-a439-00145eb45e9a
1410	1410	0	Biodiversity Information System of Mexico	b324e8e9-9a4c-44fa-8f1a-7f39ea7ab576	824793c7-372f-4f51-8eda-c0721c4bf1e5
0	203	203	Ocean Biodiversity Information System	ba0670b9-4186-41e6-8e70-f9cb3065551a	837025d8-aa9d-4d5f-a908-50714595c016
104	104	0	Plazi	ffb07bec-2d10-492d-9c37-361fe0b79427	838f8359-cca5-45ee-93d3-ef2640be64fe
43905	43905	0	GBIF Finland	dd514216-5c7c-45f3-910d-797424cb5be6	84329256-f762-11e1-a439-00145eb45e9a
27647	27647	0	National Biodiversity Network	d897a5b9-35ee-4232-94bd-b0bcaac003c2	84eb1bee-b0ad-4119-8a96-d42b52e95203
2178	2178	0	GBIF Germany	4f6826f2-4ff6-443d-b966-e6913bd24013	856f13d8-f762-11e1-a439-00145eb45e9a
5384	5378	-6	Participant Node Managers Committee	7f48e0c8-5c96-49ec-b972-30748e339115	85f9137e-8aec-4e0b-9ed6-0af4dbe491e8
267	267	0	GBIF Japan	db5705aa-6a6e-42f1-8942-d77b9f4896ea	86878e4e-f762-11e1-a439-00145eb45e9a
2	2	0	Plazi	ffb07bec-2d10-492d-9c37-361fe0b79427	86bfc9c3-6acf-4cc2-b1f2-6894aa4333d8
6357	3012	-3345	GBIF Germany	4f6826f2-4ff6-443d-b966-e6913bd24013	8750386c-f762-11e1-a439-00145eb45e9a
28	28	0	GBIF Germany	4f6826f2-4ff6-443d-b966-e6913bd24013	889e6fe0-f762-11e1-a439-00145eb45e9a
0	90	90	Plazi	ffb07bec-2d10-492d-9c37-361fe0b79427	88b4aa3d-deff-4fb9-a9eb-1aa9e2726140
316	316	0	Atlas of Living Australia	4a6f1b71-969e-4fc5-a693-282b05e1220c	895ca488-f762-11e1-a439-00145eb45e9a
2087	2087	0	GBIF Germany	4f6826f2-4ff6-443d-b966-e6913bd24013	898909e2-f762-11e1-a439-00145eb45e9a
6664	6664	0	National Biodiversity Network	d897a5b9-35ee-4232-94bd-b0bcaac003c2	8b74fc4b-bcf5-4514-aaeb-7c0f51ded0c2
35	35	0	GBIF Germany	4f6826f2-4ff6-443d-b966-e6913bd24013	8c344454-f762-11e1-a439-00145eb45e9a
0	10	10	Plazi	ffb07bec-2d10-492d-9c37-361fe0b79427	8c6932dc-5865-4ff9-9e78-6e75aaa84a1a
0	8	8	Participant Node Managers Committee	7f48e0c8-5c96-49ec-b972-30748e339115	8cd87da4-01c4-4ae5-834b-1b733bf8908e
16	16	0	GBIF Germany	4f6826f2-4ff6-443d-b966-e6913bd24013	8d15bb64-f762-11e1-a439-00145eb45e9a
149	149	0	GBIF France	da44cd31-5901-4687-a106-6d1c7734ee3a	8d238948-2919-4244-864e-c41cb63e6a23
0	42	42	Plazi	ffb07bec-2d10-492d-9c37-361fe0b79427	8e1ed74c-78bc-4ef3-bb36-959bdee75f30
34	34	0	Plazi	ffb07bec-2d10-492d-9c37-361fe0b79427	8ef6b90d-1914-43fe-80f5-d2a22dad6887
231	193	-38	GBIF Germany	4f6826f2-4ff6-443d-b966-e6913bd24013	90133fa8-f762-11e1-a439-00145eb45e9a
34	34	0	GBIF France	da44cd31-5901-4687-a106-6d1c7734ee3a	902d987e-0bc5-4592-8a29-c04ab84f0086
9	9	0	Plazi	ffb07bec-2d10-492d-9c37-361fe0b79427	905f17c1-fc1a-45bc-80e6-092c5c466b97
425	425	0	GBIF Germany	4f6826f2-4ff6-443d-b966-e6913bd24013	92b460ca-f762-11e1-a439-00145eb45e9a
12	12	0	GBIF Germany	4f6826f2-4ff6-443d-b966-e6913bd24013	93cc6dfe-f762-11e1-a439-00145eb45e9a
14	14	0	GBIF Germany	4f6826f2-4ff6-443d-b966-e6913bd24013	93defc12-f762-11e1-a439-00145eb45e9a
828	828	0	U.S. Geological Survey	8618c64a-93e0-4300-b546-7249e5148ed2	975a94f8-e567-4b9a-b32b-984fbf33595c
0	6	6	Plazi	ffb07bec-2d10-492d-9c37-361fe0b79427	99346232-9ed8-4a8c-9082-b5827bfa9270
24078	24079	1	GBIF France	da44cd31-5901-4687-a106-6d1c7734ee3a	995b2ca4-9b4d-4609-acd5-24d8297f0a4b
0	8	8	Plazi	ffb07bec-2d10-492d-9c37-361fe0b79427	9b50b0a3-b79d-48c9-b594-357e0161752d
3	3	0	Plazi	ffb07bec-2d10-492d-9c37-361fe0b79427	9d6bc827-8352-4088-b617-402e63b41a68
967	967	0	GBIF France	da44cd31-5901-4687-a106-6d1c7734ee3a	9d6d99e6-b5f4-403b-a9ad-76cb0610db60
2777	2777	0	GBIF Norway	4f829580-180d-46a9-9c87-ed8ec959b545	a01f491f-5807-4044-9613-04d1c8c7c5f4
4317	4317	0	GBIF France	da44cd31-5901-4687-a106-6d1c7734ee3a	a105f3c1-aea1-41db-9c85-67374df25325
89	89	0	Participant Node Managers Committee	7f48e0c8-5c96-49ec-b972-30748e339115	a1b218c2-4ad1-4d4a-8f85-7616146588a1
0	45	45	Colombian Biodiversity Information System	7e865cba-7c46-417b-ade5-97f2cf5b7be0	a4ec2538-0883-419e-98f4-9c29a602e33c
129	129	0	Plazi	ffb07bec-2d10-492d-9c37-361fe0b79427	a65cc45e-bc5a-4d3c-bbcf-cf5df03f71ef
5	5	0	Plazi	ffb07bec-2d10-492d-9c37-361fe0b79427	a6f0a2ca-a13e-4525-898c-a37de2665345
82	82	0	Plazi	ffb07bec-2d10-492d-9c37-361fe0b79427	a725007b-2d51-4c92-838a-9e8fd27484c8
1731	1731	0	Participant Node Managers Committee	7f48e0c8-5c96-49ec-b972-30748e339115	a8f27b2e-67a9-43cb-ad18-df43e0152c33
25987	26358	371	U.S. Geological Survey	8618c64a-93e0-4300-b546-7249e5148ed2	aaeac10a-b3ae-4e67-9411-6ad32bdabd25
593	593	0	Colombian Biodiversity Information System	7e865cba-7c46-417b-ade5-97f2cf5b7be0	acdf883a-82fc-4181-bbdc-6f47d46e8b6c
77	77	0	National Biodiversity Network	d897a5b9-35ee-4232-94bd-b0bcaac003c2	ad5eb389-d0b9-4529-b992-60d25e283177
11	11	0	Plazi	ffb07bec-2d10-492d-9c37-361fe0b79427	ae6798d5-e752-4b41-9528-407a8d56361a
89	89	0	Belgian Biodiversity Platform	fb11cfe1-ebc3-45af-9159-17d9fddbcdac	b0470224-8228-4d46-a13a-763049d81528
2146	2146	0	GBIF Finland	dd514216-5c7c-45f3-910d-797424cb5be6	b258e0d8-d282-4d84-898a-655c5375f645
0	3	3	Plazi	ffb07bec-2d10-492d-9c37-361fe0b79427	b356745f-6b52-4098-91c8-b2f17e5db399
13	13	0	Plazi	ffb07bec-2d10-492d-9c37-361fe0b79427	b5aab7ae-7bf6-49db-b7be-a746428731cf
0	1	1	Plazi	ffb07bec-2d10-492d-9c37-361fe0b79427	b79eb910-9baa-493c-8b38-73372bd587f0
0	5065	5065	Participant Node Managers Committee	7f48e0c8-5c96-49ec-b972-30748e339115	b93ec686-b0c6-40d7-a7bb-e0f505bbd0e9
0	8	8	Plazi	ffb07bec-2d10-492d-9c37-361fe0b79427	b9ad0c81-e330-4212-835b-8659a2b55aad
2482	2482	0	Biodiversity Information System of Mexico	b324e8e9-9a4c-44fa-8f1a-7f39ea7ab576	bb363544-a4cf-4c00-9e47-cb2b47aab97f
8795	8795	0	National Biodiversity Network	d897a5b9-35ee-4232-94bd-b0bcaac003c2	bb5b14fc-ff96-41d2-bd6a-c3baa8b76213
0	51250	51250	Ocean Biodiversity Information System	ba0670b9-4186-41e6-8e70-f9cb3065551a	bbd71c1c-c505-4669-8d81-afe56aca2779
0	56	56	Plazi	ffb07bec-2d10-492d-9c37-361fe0b79427	bd94b499-c7a6-418e-bb8f-3c5d59675260
399	399	0	GBIF Germany	4f6826f2-4ff6-443d-b966-e6913bd24013	be3dd114-cf23-48cf-9446-1ea5e941f4f6
0	9	9	Plazi	ffb07bec-2d10-492d-9c37-361fe0b79427	c245f397-3a3f-406b-86a3-dc616f32524c
3	3	0	Plazi	ffb07bec-2d10-492d-9c37-361fe0b79427	c29e71a9-8d1a-4bb7-9a9b-f69886448678
0	7	7	Plazi	ffb07bec-2d10-492d-9c37-361fe0b79427	c36d2a77-91cd-4d6c-b6e2-127b31e3595a
192	192	0	Plazi	ffb07bec-2d10-492d-9c37-361fe0b79427	c4351694-c2c4-4fac-9574-84893b5125fa
2691	2691	0	U.S. Geological Survey	8618c64a-93e0-4300-b546-7249e5148ed2	c8031f3d-0b10-46f3-a532-3b59ec8c4197
10	10	0	Plazi	ffb07bec-2d10-492d-9c37-361fe0b79427	c841eaae-923f-4f2c-8bb1-fc6351848681
0	20	20	Ocean Biodiversity Information System	ba0670b9-4186-41e6-8e70-f9cb3065551a	c92377e8-9ae9-4dc0-9d46-1d5e49e82464
15	15	0	Plazi	ffb07bec-2d10-492d-9c37-361fe0b79427	c9c5529c-329f-41a8-aeb2-cfc4d428fc92
10354	10354	0	GBIF France	da44cd31-5901-4687-a106-6d1c7734ee3a	cb0ee6f4-b98c-4431-a188-64f7351edd44
7	7	0	Plazi	ffb07bec-2d10-492d-9c37-361fe0b79427	cc018c8b-240e-4227-9c6d-8596bc90d47b
200	200	0	U.S. Geological Survey	8618c64a-93e0-4300-b546-7249e5148ed2	cd2a5dd5-423e-4214-ac9a-06c7d41b1bfb
0	802	802	Plazi	ffb07bec-2d10-492d-9c37-361fe0b79427	cdd9688e-9a3f-4602-992e-1f8693caab9b
0	1	1	Plazi	ffb07bec-2d10-492d-9c37-361fe0b79427	cecbf0ff-0a72-418b-b7b4-2efd853515ff
266	266	0	Colombian Biodiversity Information System	7e865cba-7c46-417b-ade5-97f2cf5b7be0	d0860cd6-2fe5-44e3-856a-5ea9e4bc108a
964	964	0	GBIF Spain	1f94b3ca-9345-4d65-afe2-4bace93aa0fe	d15c4775-92dd-48fa-88d4-1b26b957d941
282	551	269	U.S. Geological Survey	8618c64a-93e0-4300-b546-7249e5148ed2	d2757de8-d83f-4c9a-8695-7fd1901ebdc2
5	5	0	Plazi	ffb07bec-2d10-492d-9c37-361fe0b79427	d437db72-f130-4984-9278-17857ee8e6fb
3	3	0	Plazi	ffb07bec-2d10-492d-9c37-361fe0b79427	d443112e-fb27-42f3-b478-4c44f8090b18
4	4	0	Participant Node Managers Committee	7f48e0c8-5c96-49ec-b972-30748e339115	d7068326-e029-48e7-a0e6-b13e06d18d8b
97	97	0	GBIF Germany	4f6826f2-4ff6-443d-b966-e6913bd24013	d7bad1a6-c62f-4355-b807-6f859560d1d5
5	5	0	Plazi	ffb07bec-2d10-492d-9c37-361fe0b79427	d7ce61a6-6575-4dbf-804b-7399bfb9d1d9
1867	1867	0	GBIF France	da44cd31-5901-4687-a106-6d1c7734ee3a	d7d5efa1-2927-4892-bc56-6e6faab8e92a
47935	47935	0	GBIF Benin	efb9c00e-f802-45dd-8826-a52ec45b89ff	d853a7fd-73cb-4d02-829c-7ff59f9e494f
862	862	0	GBIF France	da44cd31-5901-4687-a106-6d1c7734ee3a	dc5a0f68-8c15-40f8-a1bb-64e873fcacd0
312	312	0	Colombian Biodiversity Information System	7e865cba-7c46-417b-ade5-97f2cf5b7be0	dc80705f-9c0c-4067-97e0-e1fe617943da
1	1	0	Plazi	ffb07bec-2d10-492d-9c37-361fe0b79427	de55da44-3fa9-4b4a-80da-41641abbde8e
2	2	0	Plazi	ffb07bec-2d10-492d-9c37-361fe0b79427	df0de00e-20bd-48de-b904-28e5c87b6bc0
15	15	0	GBIF France	da44cd31-5901-4687-a106-6d1c7734ee3a	e0f3996c-ffde-4f0c-8914-6fd6e041518f
0	1	1	Plazi	ffb07bec-2d10-492d-9c37-361fe0b79427	e4c110fd-fdb1-4fa2-b1a2-eeb5716813c6
126	126	0	GBIF Uganda	71b40829-6a12-4c3d-8fee-5746f5e9cf8c	e67d74f2-45c8-40c8-88bd-c2bcc94975ac
0	2	2	Plazi	ffb07bec-2d10-492d-9c37-361fe0b79427	e84b8a37-4b79-420e-92e1-abec644bcd3a
0	123	123	Colombian Biodiversity Information System	7e865cba-7c46-417b-ade5-97f2cf5b7be0	e85c7970-41e0-4db4-973b-e886390ded5b
25	25	0	Plazi	ffb07bec-2d10-492d-9c37-361fe0b79427	ea5796e1-de50-47b0-908a-2fbc88e25c98
159	159	0	Plazi	ffb07bec-2d10-492d-9c37-361fe0b79427	ea727a9b-324b-4c6b-a625-bc7cdd204473
0	36	36	Plazi	ffb07bec-2d10-492d-9c37-361fe0b79427	ea73ea53-7e6c-4e4e-8260-7da383dffc67
132	132	0	GBIF Argentina	2426a871-9feb-40a1-96c6-0c593a76b835	eb22db2f-5a68-4fca-94f1-6bb26a67756b
7914	7914	0	National Biodiversity Network	d897a5b9-35ee-4232-94bd-b0bcaac003c2	eb760660-436e-4069-ae46-12a5689658a1
24	24	0	GBIF Argentina	2426a871-9feb-40a1-96c6-0c593a76b835	ede83f39-cbd6-48d9-bcb5-982249e1a91b
182	182	0	GBIF Brazil	cdc9736d-5ff7-4ece-9959-3c744360cdb3	eeac757c-6587-4e9a-941f-54f34e9ef10b
0	65	65	GBIF France	da44cd31-5901-4687-a106-6d1c7734ee3a	f02a38e3-bbea-4dd7-b21e-18f7206d624b
0	1239	1239	Ocean Biodiversity Information System	ba0670b9-4186-41e6-8e70-f9cb3065551a	f088c22d-808a-4d0c-ab62-33b73b709946
0	2	2	Plazi	ffb07bec-2d10-492d-9c37-361fe0b79427	f0cddad3-4fb7-414c-8a5e-bd9b102fb92e
588	588	0	Colombian Biodiversity Information System	7e865cba-7c46-417b-ade5-97f2cf5b7be0	f26da880-ce86-4d5c-88f8-b3fc8ed369ee
0	3	3	Plazi	ffb07bec-2d10-492d-9c37-361fe0b79427	f966b3e0-45b3-4335-bbbf-928fb633c9c6
0	1	1	Plazi	ffb07bec-2d10-492d-9c37-361fe0b79427	fc5be416-4c77-46ba-9c7f-4292fb733b0c
3	3	0	Plazi	ffb07bec-2d10-492d-9c37-361fe0b79427	080903f9-fb09-4979-ab23-db718283e177
31515	32987	1472	GBIF Brazil	cdc9736d-5ff7-4ece-9959-3c744360cdb3	08a179fe-9cd1-4d33-afef-266dd55c59cf
137	137	0	Plazi	ffb07bec-2d10-492d-9c37-361fe0b79427	0cc3c3dc-24d1-49ea-b168-b04dfb963b3e
479	479	0	GBIF Germany	4f6826f2-4ff6-443d-b966-e6913bd24013	11195288-9d7f-4d20-8ead-2fdff6cb05fe
86	86	0	Biodiversity Information System of Mexico	b324e8e9-9a4c-44fa-8f1a-7f39ea7ab576	1352ce3d-a1a8-47da-8ef7-ac7bba2b1149
14510	14510	0	Biodiversity Information System of Mexico	b324e8e9-9a4c-44fa-8f1a-7f39ea7ab576	1a2b7ede-2c91-4952-afea-dfbf5cd3c677
0	5	5	Plazi	ffb07bec-2d10-492d-9c37-361fe0b79427	1da115fa-b68b-4605-9cf4-ae0a70bf3e9e
3031	3031	0	Atlas of Living Australia	4a6f1b71-969e-4fc5-a693-282b05e1220c	1f396a46-b83e-4255-a840-859985f73ded
92010	92010	0	National Biodiversity Network	d897a5b9-35ee-4232-94bd-b0bcaac003c2	216952bd-4392-4f48-bd5f-322486e2b35c
30	30	0	Plazi	ffb07bec-2d10-492d-9c37-361fe0b79427	22983034-74c3-4457-baa8-81a42706c074
25	25	0	Plazi	ffb07bec-2d10-492d-9c37-361fe0b79427	24069c0a-663f-4c5b-9927-ec773497f227
14	14	0	Plazi	ffb07bec-2d10-492d-9c37-361fe0b79427	24213782-d4ec-4a95-9ca4-be0a424b06f9
0	2	2	Plazi	ffb07bec-2d10-492d-9c37-361fe0b79427	24781bc6-0575-4c25-b85b-67af0b1a067b
361	281	-80	GBIF Germany	4f6826f2-4ff6-443d-b966-e6913bd24013	27e3eaeb-6d99-41be-b868-0ec6c7e1390a
26	26	0	Plazi	ffb07bec-2d10-492d-9c37-361fe0b79427	2987e575-c9b2-4491-b0cd-9a59629d93e2
283	283	0	GBIF France	da44cd31-5901-4687-a106-6d1c7734ee3a	29f482e9-4d1d-4b6d-8ee5-c7001082dbf4
6	6	0	Plazi	ffb07bec-2d10-492d-9c37-361fe0b79427	2f813356-cd98-4a77-b4dc-78a4b15bde56
55	55	0	GBIF Argentina	2426a871-9feb-40a1-96c6-0c593a76b835	30b16b55-3967-4ff1-a6db-2b828be1f75a
84	110	26	GBIF Japan	db5705aa-6a6e-42f1-8942-d77b9f4896ea	36e8f6f6-4532-4368-a0dc-80cd5f6b8fbc
30513	38903	8390	GBIF Norway	4f829580-180d-46a9-9c87-ed8ec959b545	374e0d4c-cf9f-4e1a-97a4-14123ee1bb7e
0	2	2	Plazi	ffb07bec-2d10-492d-9c37-361fe0b79427	37542e68-bc2a-4824-ad1f-2fc1ae5253d1
0	15	15	Plazi	ffb07bec-2d10-492d-9c37-361fe0b79427	390495f8-06aa-4387-a57c-d8771fe0d7ac
0	2875	2875	GBIF Germany	4f6826f2-4ff6-443d-b966-e6913bd24013	3e49114e-f9fa-4419-999b-b15440f967e6
17	17	0	Participant Node Managers Committee	7f48e0c8-5c96-49ec-b972-30748e339115	3e9c9135-2f82-42f3-8983-9f9dfa27cac1
6383	6383	0	National Biodiversity Network	d897a5b9-35ee-4232-94bd-b0bcaac003c2	415f27b8-65e5-4cb3-878d-649ac43350d1
996	996	0	National Biodiversity Network	d897a5b9-35ee-4232-94bd-b0bcaac003c2	42a917c3-f589-4967-a05c-7bd401e9c3e7
10	10	0	Participant Node Managers Committee	7f48e0c8-5c96-49ec-b972-30748e339115	42e5cb6a-3aef-4cc5-8bf2-b7ef9b325c3a
0	3	3	Plazi	ffb07bec-2d10-492d-9c37-361fe0b79427	44264bff-6da8-4e94-ad38-2e7ff803cac2
1004	1004	0	GBIF France	da44cd31-5901-4687-a106-6d1c7734ee3a	4521e9af-e6c4-4f0c-9701-f2cd0c279b32
177	177	0	GBIF France	da44cd31-5901-4687-a106-6d1c7734ee3a	470ba34d-d6bc-4075-8bec-aca5406babcc
635	635	0	Atlas of Living Australia	4a6f1b71-969e-4fc5-a693-282b05e1220c	4b09a9fa-7189-45e3-af0c-e31e909c5001
0	8	8	Plazi	ffb07bec-2d10-492d-9c37-361fe0b79427	4d774473-a092-446a-8901-cfce227bb6bb
258	88	-170	Biodiversity Information System of Mexico	b324e8e9-9a4c-44fa-8f1a-7f39ea7ab576	56b40d17-9023-4f73-a342-a1e59175c094
1183	1183	0	GBIF Argentina	2426a871-9feb-40a1-96c6-0c593a76b835	59e256fe-2444-479c-b754-7e94d1cefcef
25262	25262	0	National Biodiversity Network	d897a5b9-35ee-4232-94bd-b0bcaac003c2	5aa58782-b0dc-434b-879f-7ebd4b079457
19	19	0	GBIF France	da44cd31-5901-4687-a106-6d1c7734ee3a	60bb0501-2cd3-4e75-8265-da4af17f6693
3	3	0	Plazi	ffb07bec-2d10-492d-9c37-361fe0b79427	6120b578-2257-4568-afd9-33e8f695815e
59	59	0	GBIF Germany	4f6826f2-4ff6-443d-b966-e6913bd24013	62036e26-f762-11e1-a439-00145eb45e9a
11	11	0	GBIF Germany	4f6826f2-4ff6-443d-b966-e6913bd24013	6346ab0e-f762-11e1-a439-00145eb45e9a
1176	1176	0	National Biodiversity Data Centre	422b00b2-6c94-4bb6-976b-c359916efdb8	6388f283-7569-40c8-8e94-7e449fe0e966
66	66	0	GBIF Germany	4f6826f2-4ff6-443d-b966-e6913bd24013	64734910-f762-11e1-a439-00145eb45e9a
774	774	0	Participant Node Managers Committee	7f48e0c8-5c96-49ec-b972-30748e339115	67f45b1a-de35-4728-a4e9-ad1f0114c43c
23337	23337	0	DanBIF - Danish Biodiversity Information Facility	4ddd294f-02b7-4359-ac33-0806a9ca9c6b	68c5c38b-4023-4093-b658-0453c2159195
20	20	0	GBIF Germany	4f6826f2-4ff6-443d-b966-e6913bd24013	68f3a5a2-f762-11e1-a439-00145eb45e9a
0	3	3	Plazi	ffb07bec-2d10-492d-9c37-361fe0b79427	696df93e-6421-47e3-9fcc-c2a63fbae36f
6	6	0	GBIF France	da44cd31-5901-4687-a106-6d1c7734ee3a	696fa992-cdd3-4359-912f-90ea190a48e2
134	134	0	Plazi	ffb07bec-2d10-492d-9c37-361fe0b79427	6a9d1e6c-413c-4d86-a0ed-25794f202b06
0	5	5	Plazi	ffb07bec-2d10-492d-9c37-361fe0b79427	6bcb0395-4e84-4ae3-b13b-3774817eac53
12	12	0	GBIF Germany	4f6826f2-4ff6-443d-b966-e6913bd24013	6c79046a-f762-11e1-a439-00145eb45e9a
13979	13979	0	GBIF Germany	4f6826f2-4ff6-443d-b966-e6913bd24013	6d837ace-1934-492b-bbfa-b3ef4a01f007
27	27	0	GBIF Germany	4f6826f2-4ff6-443d-b966-e6913bd24013	700bb528-f762-11e1-a439-00145eb45e9a
0	566	566	Ocean Biodiversity Information System	ba0670b9-4186-41e6-8e70-f9cb3065551a	701a7c42-abd6-403e-acc7-100663d84ed5
1	1	0	GBIF Japan	db5705aa-6a6e-42f1-8942-d77b9f4896ea	7021e80f-cfa7-4c39-ab83-b4478ced695b
72774	72774	0	GBIF Brazil	cdc9736d-5ff7-4ece-9959-3c744360cdb3	70621b53-09ae-4153-b51a-436e106a1139
242	242	0	GBIF Germany	4f6826f2-4ff6-443d-b966-e6913bd24013	719c947a-f762-11e1-a439-00145eb45e9a
0	3	3	Plazi	ffb07bec-2d10-492d-9c37-361fe0b79427	724cd8a5-13f2-4484-b409-9c77061ce444
0	1	1	Plazi	ffb07bec-2d10-492d-9c37-361fe0b79427	726fece5-64f8-45f8-9752-543a3658c5cd
140	140	0	GBIF Germany	4f6826f2-4ff6-443d-b966-e6913bd24013	73bef810-f762-11e1-a439-00145eb45e9a
57	57	0	GBIF Germany	4f6826f2-4ff6-443d-b966-e6913bd24013	74e9e574-f762-11e1-a439-00145eb45e9a
221	221	0	GBIF Germany	4f6826f2-4ff6-443d-b966-e6913bd24013	757cada0-f762-11e1-a439-00145eb45e9a
0	10	10	Plazi	ffb07bec-2d10-492d-9c37-361fe0b79427	76237eae-1f32-433c-af17-2164c6744894
0	206	206	Plazi	ffb07bec-2d10-492d-9c37-361fe0b79427	76e094f4-016c-4e1b-a920-e964bf15f08c
15	15	0	GBIF Germany	4f6826f2-4ff6-443d-b966-e6913bd24013	790b4a8a-f762-11e1-a439-00145eb45e9a
1551	594	-957	GBIF Germany	4f6826f2-4ff6-443d-b966-e6913bd24013	7a0a3aea-f762-11e1-a439-00145eb45e9a
2777	2777	0	GBIF Japan	db5705aa-6a6e-42f1-8942-d77b9f4896ea	7ae22a54-f762-11e1-a439-00145eb45e9a
2420	2420	0	Korean Biodiversity Information Facility	e0a1e772-0177-4800-94b4-2d023fe6cdf4	7b070fd6-f762-11e1-a439-00145eb45e9a
1139	1139	0	Korean Biodiversity Information Facility	e0a1e772-0177-4800-94b4-2d023fe6cdf4	7b28e160-f762-11e1-a439-00145eb45e9a
0	56	56	Plazi	ffb07bec-2d10-492d-9c37-361fe0b79427	7b3c97a4-e148-4faf-bf92-7e6ec9813e30
966	966	0	GBIF Germany	4f6826f2-4ff6-443d-b966-e6913bd24013	7c08967a-f762-11e1-a439-00145eb45e9a
0	19	19	Ocean Biodiversity Information System	ba0670b9-4186-41e6-8e70-f9cb3065551a	7d69de9a-568c-4597-b41e-b674ce7a16af
3213	3276	63	GBIF Germany	4f6826f2-4ff6-443d-b966-e6913bd24013	7e25752c-f762-11e1-a439-00145eb45e9a
156	156	0	Biodiversity Information System of Mexico	b324e8e9-9a4c-44fa-8f1a-7f39ea7ab576	7fa83dee-f762-11e1-a439-00145eb45e9a
396	396	0	Colombian Biodiversity Information System	7e865cba-7c46-417b-ade5-97f2cf5b7be0	7fe5d3bf-ae8d-4388-a31c-1fe98d20fef3
569	569	0	GBIF Benin	efb9c00e-f802-45dd-8826-a52ec45b89ff	8029ab0b-07b7-4288-bd7a-b5e00b0cb574
0	504	504	Plazi	ffb07bec-2d10-492d-9c37-361fe0b79427	80d33caa-2379-4f5e-ba98-6d1cc29a7906
295	295	0	GBIF Germany	4f6826f2-4ff6-443d-b966-e6913bd24013	81c16344-f762-11e1-a439-00145eb45e9a
30246	30246	0	GBIF Spain	1f94b3ca-9345-4d65-afe2-4bace93aa0fe	835177da-f762-11e1-a439-00145eb45e9a
5	5	0	Plazi	ffb07bec-2d10-492d-9c37-361fe0b79427	83e57102-072d-4b03-87d0-74f8caeac392
0	194	194	Plazi	ffb07bec-2d10-492d-9c37-361fe0b79427	84244b59-c18e-4ad3-8e5d-c8f096b2870b
447	447	0	Korean Biodiversity Information Facility	e0a1e772-0177-4800-94b4-2d023fe6cdf4	843672e0-f762-11e1-a439-00145eb45e9a
384	384	0	Atlas of Living Australia	4a6f1b71-969e-4fc5-a693-282b05e1220c	84424664-1c22-48da-83ee-6ad3460229e0
327	327	0	GBIF New Zealand	4f9fd726-20dd-445e-89a1-8ed93792276f	868bbb5d-e7e2-4920-a0ff-82b00a4d274a
899	899	0	GBIF Germany	4f6826f2-4ff6-443d-b966-e6913bd24013	86bc988c-f762-11e1-a439-00145eb45e9a
671	577	-94	GBIF Germany	4f6826f2-4ff6-443d-b966-e6913bd24013	872dd5c4-f762-11e1-a439-00145eb45e9a
0	30	30	Ocean Biodiversity Information System	ba0670b9-4186-41e6-8e70-f9cb3065551a	874eb228-c58a-4104-8997-8790aa86ba62
13	13	0	GBIF Germany	4f6826f2-4ff6-443d-b966-e6913bd24013	888a3430-f762-11e1-a439-00145eb45e9a
398	398	0	GBIF Germany	4f6826f2-4ff6-443d-b966-e6913bd24013	8995784e-f762-11e1-a439-00145eb45e9a
457	457	0	GBIF Finland	dd514216-5c7c-45f3-910d-797424cb5be6	89b487bc-6b66-482c-a087-1393d1edec9e
44	44	0	GBIF Germany	4f6826f2-4ff6-443d-b966-e6913bd24013	89ea22cc-f762-11e1-a439-00145eb45e9a
105	105	0	GBIF Germany	4f6826f2-4ff6-443d-b966-e6913bd24013	89efc696-f762-11e1-a439-00145eb45e9a
410	410	0	GBIF Germany	4f6826f2-4ff6-443d-b966-e6913bd24013	8a32eae8-f762-11e1-a439-00145eb45e9a
672	1250	578	Symbiota Support Hub	612b5a0b-908b-4b4e-b9bf-ca15dfdc94fa	8b0665a6-e35f-4d57-a493-481111d15f14
367	367	0	National Biodiversity Network	d897a5b9-35ee-4232-94bd-b0bcaac003c2	8bf1d38a-850c-4603-a23e-3f8cd5bd972c
10	10	0	GBIF Germany	4f6826f2-4ff6-443d-b966-e6913bd24013	8c162ffa-f762-11e1-a439-00145eb45e9a
2	2	0	GBIF Germany	4f6826f2-4ff6-443d-b966-e6913bd24013	8d28c1e6-f762-11e1-a439-00145eb45e9a
14	8	-6	GBIF Germany	4f6826f2-4ff6-443d-b966-e6913bd24013	8d33797e-f762-11e1-a439-00145eb45e9a
297	297	0	GBIF Germany	4f6826f2-4ff6-443d-b966-e6913bd24013	8d4cffb6-f762-11e1-a439-00145eb45e9a
744	707	-37	GBIF Germany	4f6826f2-4ff6-443d-b966-e6913bd24013	8db04530-f762-11e1-a439-00145eb45e9a
0	5	5	Plazi	ffb07bec-2d10-492d-9c37-361fe0b79427	8e62fe79-f950-4c2a-a12e-523d0c7fd39a
5	5	0	GBIF France	da44cd31-5901-4687-a106-6d1c7734ee3a	8f2a52f1-4b3b-477a-ba3f-c034b65ef05b
110	82	-28	GBIF Germany	4f6826f2-4ff6-443d-b966-e6913bd24013	8f8876a2-f762-11e1-a439-00145eb45e9a
108	55	-53	GBIF Germany	4f6826f2-4ff6-443d-b966-e6913bd24013	9041da5c-f762-11e1-a439-00145eb45e9a
383	383	0	GBIF Uruguay	a3ceb6dd-0a65-4f30-a385-30f6937c2096	90a5be66-f51f-4a7e-9ffe-3137c7d3e0c3
90	90	0	GBIF France	da44cd31-5901-4687-a106-6d1c7734ee3a	90b20b73-9671-4fbb-806a-769ec40d4516
2	2	0	Plazi	ffb07bec-2d10-492d-9c37-361fe0b79427	90fc5197-9eed-4a6a-9651-d42133075f8d
52	52	0	Plazi	ffb07bec-2d10-492d-9c37-361fe0b79427	92c8c8c3-48ce-4f99-b6f8-3a25c52c22d5
6	6	0	Plazi	ffb07bec-2d10-492d-9c37-361fe0b79427	92e72cd6-60b8-4a39-ab1f-a6d1a513f961
474	456	-18	GBIF Germany	4f6826f2-4ff6-443d-b966-e6913bd24013	935789c6-f762-11e1-a439-00145eb45e9a
72	72	0	GBIF Germany	4f6826f2-4ff6-443d-b966-e6913bd24013	93ebfc8f-c27a-4451-9ec2-f73af2dcc18e
139	139	0	GBIF France	da44cd31-5901-4687-a106-6d1c7734ee3a	93fdeede-5c2a-43eb-96e2-274a370c5a6b
145	100	-45	GBIF Germany	4f6826f2-4ff6-443d-b966-e6913bd24013	94689be8-4b65-4f56-af53-0f95d3f9d8cb
16	16	0	Plazi	ffb07bec-2d10-492d-9c37-361fe0b79427	959b13ea-8bec-4b77-b018-e50130773cf3
7089	7089	0	Atlas of Living Australia	4a6f1b71-969e-4fc5-a693-282b05e1220c	95e5bfce-0e65-4f60-aecf-e78b9a830449
349	349	0	GBIF Germany	4f6826f2-4ff6-443d-b966-e6913bd24013	97bc7c9c-f762-11e1-a439-00145eb45e9a
492	246	-246	Colombian Biodiversity Information System	7e865cba-7c46-417b-ade5-97f2cf5b7be0	988dadb5-135f-4b82-8cea-77722e2942e6
4036	4036	0	Biodiversity Information System of Mexico	b324e8e9-9a4c-44fa-8f1a-7f39ea7ab576	994a7d7c-a974-46fa-9240-1c2a8393dbc8
31	31	0	Secretariat of the Pacific Regional Environment Programme	29c6a139-ea7f-41f5-8d9b-c55af8736182	99cccf3d-791b-4e06-bd3e-a0cdf230242e
1937	1937	0	U.S. Geological Survey	8618c64a-93e0-4300-b546-7249e5148ed2	99e6b736-3119-4081-9467-a9c8a4a7a01b
29	29	0	GBIF France	da44cd31-5901-4687-a106-6d1c7734ee3a	9a39c4d6-15e1-4bd2-9c72-255fec19ce34
67	67	0	GBIF Argentina	2426a871-9feb-40a1-96c6-0c593a76b835	9de4cba0-e19a-4a47-9936-966e5cc8c22b
57	57	0	GBIF Argentina	2426a871-9feb-40a1-96c6-0c593a76b835	9df935e4-666c-4093-a239-59af9dfce963
186	186	0	ASEAN Centre for Biodiversity	af2a0fa1-4c8e-4bdc-8954-b1a55e32b0f1	9e853a94-bf3f-4e68-8bcf-0772312089e9
31	31	0	Participant Node Managers Committee	7f48e0c8-5c96-49ec-b972-30748e339115	a015770c-a808-4211-a6ba-4d29b6176976
66	66	0	GBIF France	da44cd31-5901-4687-a106-6d1c7734ee3a	a04c670a-dee1-4aeb-a26c-4e308fe02a0f
0	376	376	Plazi	ffb07bec-2d10-492d-9c37-361fe0b79427	a0cfeafa-f549-47b5-889c-6a4809010eca
202	202	0	GBIF France	da44cd31-5901-4687-a106-6d1c7734ee3a	a2a40aaa-3318-4099-84bf-705e228f1899
0	2	2	Plazi	ffb07bec-2d10-492d-9c37-361fe0b79427	a3876c73-615d-4cd3-88d7-779d2175638f
464	464	0	GBIF France	da44cd31-5901-4687-a106-6d1c7734ee3a	a5612f53-6ff2-4e1e-906a-a2807e2c8ab2
0	3000	3000	Colombian Biodiversity Information System	7e865cba-7c46-417b-ade5-97f2cf5b7be0	a6966bdd-8a69-41bd-b1a5-531def2e8032
2	2	0	Plazi	ffb07bec-2d10-492d-9c37-361fe0b79427	a9bf749d-af41-4363-85dd-991cced46e38
13	13	0	Plazi	ffb07bec-2d10-492d-9c37-361fe0b79427	aa92fcc0-ec82-4a5b-8880-9f9c9fbe75a5
43	43	0	GBIF Finland	dd514216-5c7c-45f3-910d-797424cb5be6	ac48c9ff-e471-476d-b826-9a2cee4caa66
56	56	0	National Biodiversity Network	d897a5b9-35ee-4232-94bd-b0bcaac003c2	acc4e8a3-2e31-4c36-991d-f2f3c2beb25a
27	27	0	Plazi	ffb07bec-2d10-492d-9c37-361fe0b79427	ad4878aa-a20b-466e-b960-8e5568368f3e
5	5	0	Plazi	ffb07bec-2d10-492d-9c37-361fe0b79427	ae0e2d5c-00a0-445d-b07a-4000a6a9f61f
0	56127	56127	U.S. Geological Survey	8618c64a-93e0-4300-b546-7249e5148ed2	b0515413-6d32-490a-83a0-f8c08f002c70
15	15	0	Plazi	ffb07bec-2d10-492d-9c37-361fe0b79427	b0b0d04b-3c76-4ab2-a583-4435bafe49b5
16	16	0	National Biodiversity Network	d897a5b9-35ee-4232-94bd-b0bcaac003c2	b376ec09-985f-49ce-b252-dfc256ab8a3a
0	2	2	Plazi	ffb07bec-2d10-492d-9c37-361fe0b79427	b4863c50-4cd7-44d5-aa1b-f550bffc07ef
4	4	0	Plazi	ffb07bec-2d10-492d-9c37-361fe0b79427	b5540ef3-598a-4f52-84c6-eec946bbf32a
448	448	0	GBIF France	da44cd31-5901-4687-a106-6d1c7734ee3a	b7f60df5-b773-4284-8991-06a20a570632
9	9	0	Plazi	ffb07bec-2d10-492d-9c37-361fe0b79427	b9169552-5ac7-45b7-b8d8-89f7d673f9a3
495	495	0	GBIF Sweden	a0b3be64-6525-4387-ac67-a499950f92e1	bb13d5bf-2acd-4fc5-88f5-bc947fbb0f72
0	11	11	Plazi	ffb07bec-2d10-492d-9c37-361fe0b79427	bc8f2c1d-4989-4f44-b206-a09f02e0373b
0	25	25	Plazi	ffb07bec-2d10-492d-9c37-361fe0b79427	bcbaad29-72ca-4381-a6a0-eb99bbfaea33
1988	1988	0	Participant Node Managers Committee	7f48e0c8-5c96-49ec-b972-30748e339115	bcef6116-2794-42cb-9667-876a3e0b9044
3	3	0	Plazi	ffb07bec-2d10-492d-9c37-361fe0b79427	bd2c4db5-d193-48cc-b856-2e8a2f506d47
446	446	0	Colombian Biodiversity Information System	7e865cba-7c46-417b-ade5-97f2cf5b7be0	c448d964-8660-4a56-9ac1-a59af9f6b749
0	217	217	Plazi	ffb07bec-2d10-492d-9c37-361fe0b79427	c7efa945-0e70-48aa-b2d4-e09beeffeb2b
0	3	3	Plazi	ffb07bec-2d10-492d-9c37-361fe0b79427	c9a44e78-200e-49c5-b4c1-65b5f1839221
0	5	5	Plazi	ffb07bec-2d10-492d-9c37-361fe0b79427	ca7c6941-4e88-4a1c-924a-32def88faf29
36323	36323	0	DanBIF - Danish Biodiversity Information Facility	4ddd294f-02b7-4359-ac33-0806a9ca9c6b	cd4eb3ec-0a18-42b4-bda4-155716ddd7b1
0	5318	5318	U.S. Geological Survey	8618c64a-93e0-4300-b546-7249e5148ed2	ceaedba5-2105-41e4-8991-6b4c8bd7a85e
3238	3238	0	GBIF Madagascar	2dbfc5c5-51b5-4494-9dfc-4d3f013a3b64	d06771c1-2276-49b8-81ba-f7be0887d0bd
299	299	0	GBIF Brazil	cdc9736d-5ff7-4ece-9959-3c744360cdb3	d0a90634-21fb-4c76-9081-98bf3930ad7c
74	74	0	Indonesian Biodiversity Information Facility	2ebd91f6-f14f-4375-b525-c011a3774f03	d13e5b4c-e838-4244-8ac1-dfe1d75e2f48
0	653	653	GBIF France	da44cd31-5901-4687-a106-6d1c7734ee3a	d51718bc-3888-4f2e-a73a-ca589a9bdacb
0	1	1	Participant Node Managers Committee	7f48e0c8-5c96-49ec-b972-30748e339115	d82168d0-b006-4cc1-9b70-1d9c2001da74
66	66	0	Plazi	ffb07bec-2d10-492d-9c37-361fe0b79427	da88b1f4-9cb0-4a79-ad9d-8c291d360c06
4	4	0	Plazi	ffb07bec-2d10-492d-9c37-361fe0b79427	db2b3bd4-2e27-4918-8fff-226b303c65b9
0	1	1	Plazi	ffb07bec-2d10-492d-9c37-361fe0b79427	db889bab-85e8-4560-b26d-6460669e59f9
438	438	0	Colombian Biodiversity Information System	7e865cba-7c46-417b-ade5-97f2cf5b7be0	dba87678-ffa3-4a06-a2f7-cf4892e1e057
2	2	0	Plazi	ffb07bec-2d10-492d-9c37-361fe0b79427	ddd3f84b-a2af-4c5f-8895-ffe568cb711d
8892	8892	0	DanBIF - Danish Biodiversity Information Facility	4ddd294f-02b7-4359-ac33-0806a9ca9c6b	de53bdc9-8575-4746-9369-a66c35e5b8bc
6188	6188	0	Participant Node Managers Committee	7f48e0c8-5c96-49ec-b972-30748e339115	e0288317-74ec-4cc6-b374-39038f407803
4	4	0	Plazi	ffb07bec-2d10-492d-9c37-361fe0b79427	e0e210ad-4bfb-4e92-8867-0cd91864c185
5643	5643	0	National Biodiversity Network	d897a5b9-35ee-4232-94bd-b0bcaac003c2	e14ee6ea-df50-453c-8319-69907ed7843a
56146	56146	0	U.S. Geological Survey	8618c64a-93e0-4300-b546-7249e5148ed2	e26068ea-aad4-4734-9219-d7d1805e8391
35	35	0	Plazi	ffb07bec-2d10-492d-9c37-361fe0b79427	e3832ce6-9087-4b97-8a9e-22f6912ea6d7
1	1	0	Plazi	ffb07bec-2d10-492d-9c37-361fe0b79427	e39a9333-f0b8-4b2d-b0b1-ff53ae849ae0
23	23	0	Plazi	ffb07bec-2d10-492d-9c37-361fe0b79427	e4049a32-efd8-41a3-9121-56a528bdfa58
0	15	15	Plazi	ffb07bec-2d10-492d-9c37-361fe0b79427	e5357784-291f-425f-9d1d-e99e943724db
1799	1799	0	Biodiversity Information System of Mexico	b324e8e9-9a4c-44fa-8f1a-7f39ea7ab576	e9ba8fcf-8aac-4c98-a415-a25e9bacd54c
2	2	0	Participant Node Managers Committee	7f48e0c8-5c96-49ec-b972-30748e339115	ecc8c8c5-10e0-4418-86c3-6024b83639c4
3553	3553	0	Ocean Biodiversity Information System	ba0670b9-4186-41e6-8e70-f9cb3065551a	f0c3a31b-df3b-4670-ac1d-0c58d13e1420
0	4	4	Plazi	ffb07bec-2d10-492d-9c37-361fe0b79427	f134d440-3989-4f1d-ba53-3c98a2bc211f
70	70	0	GBIF Brazil	cdc9736d-5ff7-4ece-9959-3c744360cdb3	f28312b7-457b-4c40-a269-a66709ad3f80
468	468	0	GBIF Finland	dd514216-5c7c-45f3-910d-797424cb5be6	f3c29b0c-294b-41cd-a64c-4ab3c423210c
0	1858	1858	Indonesian Biodiversity Information Facility	2ebd91f6-f14f-4375-b525-c011a3774f03	f4b6dedb-5a10-4512-bcd2-0c72a8f9e394
0	750	750	Korean Biodiversity Information Facility	e0a1e772-0177-4800-94b4-2d023fe6cdf4	f6aa9830-7f34-4a52-8c19-cde31152d7de
608761	631569	22808	U.S. Geological Survey	8618c64a-93e0-4300-b546-7249e5148ed2	f934f8e2-32ca-46a7-b2f8-b032a4740454
402	402	0	GBIF France	da44cd31-5901-4687-a106-6d1c7734ee3a	fa975e73-b7b7-4b4f-865b-52fac34a3c9a
97	97	0	U.S. Geological Survey	8618c64a-93e0-4300-b546-7249e5148ed2	0150c79f-35f3-447f-a40f-24ee9f1fb9d3
296	296	0	Plazi	ffb07bec-2d10-492d-9c37-361fe0b79427	020059ec-0af5-44c5-8eb0-6a2874d9197d
2	2	0	Plazi	ffb07bec-2d10-492d-9c37-361fe0b79427	027053c2-d1ce-4699-b6a2-a5a5033878de
2	2	0	Plazi	ffb07bec-2d10-492d-9c37-361fe0b79427	041040fe-877d-4842-a15a-1865284ea73d
0	6	6	Plazi	ffb07bec-2d10-492d-9c37-361fe0b79427	04220044-bd93-49c0-890a-6475ca93fa58
1285	1285	0	GBIF France	da44cd31-5901-4687-a106-6d1c7734ee3a	05ee34c9-e001-43fa-b79c-07450bca5631
0	12156	12156	Ocean Biodiversity Information System	ba0670b9-4186-41e6-8e70-f9cb3065551a	07eccf22-84fe-4a53-bc08-724f5176c42d
0	1	1	Plazi	ffb07bec-2d10-492d-9c37-361fe0b79427	09d3cfb2-9360-4616-a754-de670e634ea2
830	830	0	Colombian Biodiversity Information System	7e865cba-7c46-417b-ade5-97f2cf5b7be0	09ef3c88-d559-4d31-9bfb-56b6fb1feb57
0	3084	3084	U.S. Geological Survey	8618c64a-93e0-4300-b546-7249e5148ed2	0f6a3163-4efb-47ab-a4f1-2f548098665f
12370	12370	0	South African Biodiversity Information Facility	7190b835-4e86-4b6e-85c1-19cc6677c250	10112b19-2e18-4129-b472-18df75dce84c
0	5	5	Plazi	ffb07bec-2d10-492d-9c37-361fe0b79427	1018798b-693a-4cb5-815a-de55ebe95504
1	1	0	Plazi	ffb07bec-2d10-492d-9c37-361fe0b79427	1077941c-553e-42dc-a62f-1403c9541939
15482	15482	0	National Biodiversity Network	d897a5b9-35ee-4232-94bd-b0bcaac003c2	119cad52-5a86-40e9-a246-c2118310fca5
0	2	2	Plazi	ffb07bec-2d10-492d-9c37-361fe0b79427	11b7eefe-d496-4ef1-b678-7d9ac6c62437
0	56053	56053	Canada Biodiversity Information Facility	8f83fc96-c966-4126-83f7-bf044dc49efa	1677f287-3666-49b8-90f2-12a63ca58438
96726	96726	0	U.S. Geological Survey	8618c64a-93e0-4300-b546-7249e5148ed2	17d312c2-9ab3-4aca-a383-6af5fb79dca0
0	45	45	Plazi	ffb07bec-2d10-492d-9c37-361fe0b79427	19ec59cf-a6ba-4760-8a7f-dac3e88b0775
0	14	14	Plazi	ffb07bec-2d10-492d-9c37-361fe0b79427	1d6299e9-5c62-4abd-be37-59efcb217cbf
0	49	49	Plazi	ffb07bec-2d10-492d-9c37-361fe0b79427	21631464-616c-4f0b-bcf7-9361eead4caa
613	613	0	Colombian Biodiversity Information System	7e865cba-7c46-417b-ade5-97f2cf5b7be0	243bb217-84a5-43d5-adca-af481ab6ab8f
265	265	0	GBIF Germany	4f6826f2-4ff6-443d-b966-e6913bd24013	24f22bcd-dde2-479a-8cb5-d0f2a75608a7
0	32	32	Colombian Biodiversity Information System	7e865cba-7c46-417b-ade5-97f2cf5b7be0	26b6e581-d5a6-4815-88ef-026838174d28
4	4	0	Plazi	ffb07bec-2d10-492d-9c37-361fe0b79427	26d47cb1-af56-4ed2-a8f2-bebf0846cd45
3	3	0	Plazi	ffb07bec-2d10-492d-9c37-361fe0b79427	2b7c2955-10df-4443-8bea-3bdb2efb92c7
57	57	0	GBIF France	da44cd31-5901-4687-a106-6d1c7734ee3a	2f9322fc-05af-4568-b8ec-f76d05f792a8
3	3	0	Plazi	ffb07bec-2d10-492d-9c37-361fe0b79427	2f97ef62-e4b2-4ebe-86fa-6974d1fada98
267972	294133	26161	GBIF Norway	4f829580-180d-46a9-9c87-ed8ec959b545	33591b80-0e31-480c-82ce-2f57211b10e6
22137	22137	0	National Biodiversity Network	d897a5b9-35ee-4232-94bd-b0bcaac003c2	33614778-513a-4ec0-814d-125021cca5fe
6199	6199	0	National Biodiversity Network	d897a5b9-35ee-4232-94bd-b0bcaac003c2	373004b4-fe93-49f3-9724-d5ed81864e65
767	767	0	National Biodiversity Network	d897a5b9-35ee-4232-94bd-b0bcaac003c2	3b45e79d-df3f-4f3f-a0c9-a3a3f0ca2d46
1	1	0	Plazi	ffb07bec-2d10-492d-9c37-361fe0b79427	3b6aee2f-dc81-4c60-bf42-d2b8c1693a35
6	6	0	Plazi	ffb07bec-2d10-492d-9c37-361fe0b79427	4367eeb8-a62e-452f-9bdb-d568ac46f67d
1769	899	-870	GBIF Germany	4f6826f2-4ff6-443d-b966-e6913bd24013	48be1492-6dfd-45b8-a118-27c33a63d80a
635	6937	6302	Colombian Biodiversity Information System	7e865cba-7c46-417b-ade5-97f2cf5b7be0	497ac759-6e4c-4b1c-811d-01e8d35acdd3
13777	13777	0	Indonesian Biodiversity Information Facility	2ebd91f6-f14f-4375-b525-c011a3774f03	4ba838f7-a61e-4bcd-ad2b-bdc01d6485ea
284967	284966	-1	National Biodiversity Network	d897a5b9-35ee-4232-94bd-b0bcaac003c2	4f174243-a6e2-4ab3-99cb-129d2a6267e7
807	807	0	GBIF France	da44cd31-5901-4687-a106-6d1c7734ee3a	510b8030-6293-4bd9-812d-c195a9915a74
0	24	24	Ocean Biodiversity Information System	ba0670b9-4186-41e6-8e70-f9cb3065551a	518c731a-33e1-480a-8862-da76cecdbaf9
18	18	0	Plazi	ffb07bec-2d10-492d-9c37-361fe0b79427	54438cfa-5f3a-4ee3-85c8-00e453a6d641
0	1268	1268	Ocean Biodiversity Information System	ba0670b9-4186-41e6-8e70-f9cb3065551a	55837cfe-2501-4a04-b61e-9941a38a92aa
7	7	0	Plazi	ffb07bec-2d10-492d-9c37-361fe0b79427	574b87d7-3c74-4274-9f5d-c0708faf0e29
5	5	0	Plazi	ffb07bec-2d10-492d-9c37-361fe0b79427	58bd0a34-478a-4c5d-b1c6-efb610eba18d
0	7	7	Plazi	ffb07bec-2d10-492d-9c37-361fe0b79427	5a99fe1c-4682-49da-aef9-e44d71712ae5
0	2	2	Plazi	ffb07bec-2d10-492d-9c37-361fe0b79427	601d4544-4775-454a-a797-677f0212775b
2413	2413	0	GBIF India	59d15a9b-ba51-43c3-a53f-304fe6732c04	6115006c-ec2f-4bfd-9315-115879785446
91	91	0	GBIF Germany	4f6826f2-4ff6-443d-b966-e6913bd24013	612aeea2-f762-11e1-a439-00145eb45e9a
9	9	0	Plazi	ffb07bec-2d10-492d-9c37-361fe0b79427	615c9773-687b-4234-9f8e-71a99be3b696
54	54	0	GBIF Germany	4f6826f2-4ff6-443d-b966-e6913bd24013	6194e7b2-f762-11e1-a439-00145eb45e9a
117	117	0	GBIF Germany	4f6826f2-4ff6-443d-b966-e6913bd24013	61c2c40c-f762-11e1-a439-00145eb45e9a
124	124	0	GBIF Germany	4f6826f2-4ff6-443d-b966-e6913bd24013	61d1c844-f762-11e1-a439-00145eb45e9a
107	107	0	GBIF Germany	4f6826f2-4ff6-443d-b966-e6913bd24013	61e9f5ae-f762-11e1-a439-00145eb45e9a
60	60	0	GBIF Germany	4f6826f2-4ff6-443d-b966-e6913bd24013	621fa58c-f762-11e1-a439-00145eb45e9a
207	207	0	GBIF Germany	4f6826f2-4ff6-443d-b966-e6913bd24013	62438092-f762-11e1-a439-00145eb45e9a
57	57	0	GBIF Germany	4f6826f2-4ff6-443d-b966-e6913bd24013	62ca9b9a-f762-11e1-a439-00145eb45e9a
134	134	0	GBIF Germany	4f6826f2-4ff6-443d-b966-e6913bd24013	63ded71c-f762-11e1-a439-00145eb45e9a
132	132	0	GBIF Germany	4f6826f2-4ff6-443d-b966-e6913bd24013	63e03378-f762-11e1-a439-00145eb45e9a
1530	1530	0	GBIF Germany	4f6826f2-4ff6-443d-b966-e6913bd24013	63f651f3-b227-442b-9902-f048edf7ecd9
30	30	0	GBIF Germany	4f6826f2-4ff6-443d-b966-e6913bd24013	64b776e4-f762-11e1-a439-00145eb45e9a
1	1	0	Plazi	ffb07bec-2d10-492d-9c37-361fe0b79427	6618da28-8a57-4813-983b-9f49a557de63
6	6	0	Plazi	ffb07bec-2d10-492d-9c37-361fe0b79427	66710da6-058b-423f-ad8b-712a66ae63ec
68	68	0	GBIF Germany	4f6826f2-4ff6-443d-b966-e6913bd24013	67b6b54e-f762-11e1-a439-00145eb45e9a
252	252	0	GBIF Germany	4f6826f2-4ff6-443d-b966-e6913bd24013	6832c454-f762-11e1-a439-00145eb45e9a
94	94	0	GBIF Germany	4f6826f2-4ff6-443d-b966-e6913bd24013	68adc3ca-f762-11e1-a439-00145eb45e9a
213	213	0	GBIF Germany	4f6826f2-4ff6-443d-b966-e6913bd24013	68bd0786-f762-11e1-a439-00145eb45e9a
469	469	0	GBIF Germany	4f6826f2-4ff6-443d-b966-e6913bd24013	696fb32c-f762-11e1-a439-00145eb45e9a
79	79	0	GBIF Germany	4f6826f2-4ff6-443d-b966-e6913bd24013	6ccb4ea0-f762-11e1-a439-00145eb45e9a
54	54	0	GBIF Germany	4f6826f2-4ff6-443d-b966-e6913bd24013	6ce1c2c0-f762-11e1-a439-00145eb45e9a
4	4	0	GBIF Germany	4f6826f2-4ff6-443d-b966-e6913bd24013	6fb8f8e2-f762-11e1-a439-00145eb45e9a
1	1	0	Plazi	ffb07bec-2d10-492d-9c37-361fe0b79427	71990c5e-7aaa-472f-9682-bd0eee875e75
1634	1634	0	GBIF Germany	4f6826f2-4ff6-443d-b966-e6913bd24013	72309d40-0c1f-47d6-8008-33e687b7df7a
1356	1356	0	GBIF Kenya	2a44d626-9f7a-4120-8a7a-4ab5ac15ff2a	7233a2ba-b5ef-44e2-b13c-983f504447bc
7	7	0	Plazi	ffb07bec-2d10-492d-9c37-361fe0b79427	7245b739-d300-49ee-b17f-b972f1a65aa5
342	342	0	GBIF Germany	4f6826f2-4ff6-443d-b966-e6913bd24013	734e4b88-f762-11e1-a439-00145eb45e9a
38	29	-9	GBIF Germany	4f6826f2-4ff6-443d-b966-e6913bd24013	73f77348-f762-11e1-a439-00145eb45e9a
25	25	0	GBIF Germany	4f6826f2-4ff6-443d-b966-e6913bd24013	7460bf4c-f762-11e1-a439-00145eb45e9a
384	384	0	GBIF Germany	4f6826f2-4ff6-443d-b966-e6913bd24013	74f1cfbe-f762-11e1-a439-00145eb45e9a
17394	17394	0	GBIF France	da44cd31-5901-4687-a106-6d1c7734ee3a	7536c922-e591-4bab-ae06-cb7753b170b0
57	57	0	GBIF Germany	4f6826f2-4ff6-443d-b966-e6913bd24013	75481ffe-f762-11e1-a439-00145eb45e9a
45	45	0	GBIF Norway	4f829580-180d-46a9-9c87-ed8ec959b545	77567a5b-e663-4daf-9566-caf36a7e6998
0	89	89	Ocean Biodiversity Information System	ba0670b9-4186-41e6-8e70-f9cb3065551a	78510af3-f408-4a4f-a608-956b18bce7b0
12	12	0	GBIF France	da44cd31-5901-4687-a106-6d1c7734ee3a	78a484de-5772-419e-9241-cdba1ba7ccfe
166	166	0	GBIF Norway	4f829580-180d-46a9-9c87-ed8ec959b545	78a8380d-8e09-4190-8628-21fc8cf56d09
214	214	0	GBIF Germany	4f6826f2-4ff6-443d-b966-e6913bd24013	78bf14a8-f762-11e1-a439-00145eb45e9a
11	11	0	GBIF Germany	4f6826f2-4ff6-443d-b966-e6913bd24013	7903e39e-f762-11e1-a439-00145eb45e9a
3	3	0	Plazi	ffb07bec-2d10-492d-9c37-361fe0b79427	799cf10e-6ad8-4df5-b810-08356ab2a748
590	590	0	Ocean Biodiversity Information System	ba0670b9-4186-41e6-8e70-f9cb3065551a	7cff3567-b9bd-41f3-8d9b-aec6893dfeb9
0	5	5	Plazi	ffb07bec-2d10-492d-9c37-361fe0b79427	7f02da24-d61d-43d1-bb86-97378f30aa6b
1436	1436	0	GBIF Germany	4f6826f2-4ff6-443d-b966-e6913bd24013	7f1a65a0-f762-11e1-a439-00145eb45e9a
4760	4760	0	National Biodiversity Network	d897a5b9-35ee-4232-94bd-b0bcaac003c2	8054fe88-04bb-4c03-b8aa-fbbd99b05a4a
0	17	17	Plazi	ffb07bec-2d10-492d-9c37-361fe0b79427	8085e8be-ef29-40ee-92f9-586de1ffd54a
7161	7081	-80	Biodiversity Information System of Mexico	b324e8e9-9a4c-44fa-8f1a-7f39ea7ab576	80ba7738-f762-11e1-a439-00145eb45e9a
408	408	0	GBIF Japan	db5705aa-6a6e-42f1-8942-d77b9f4896ea	80ea3f40-f762-11e1-a439-00145eb45e9a
1794	1794	0	Atlas of Living Australia	4a6f1b71-969e-4fc5-a693-282b05e1220c	82e0ee52-f762-11e1-a439-00145eb45e9a
7548	7548	0	GBIF Finland	dd514216-5c7c-45f3-910d-797424cb5be6	83d36270-e4ac-11de-ad5c-e0ddf866799d
963	963	0	Canada Biodiversity Information Facility	8f83fc96-c966-4126-83f7-bf044dc49efa	84687bdc-f762-11e1-a439-00145eb45e9a
6	6	0	Plazi	ffb07bec-2d10-492d-9c37-361fe0b79427	84973bd6-9d66-4172-8f50-2a482edccf2a
7926	7926	0	Canada Biodiversity Information Facility	8f83fc96-c966-4126-83f7-bf044dc49efa	84a80b12-f762-11e1-a439-00145eb45e9a
129323	129323	0	GBIF Germany	4f6826f2-4ff6-443d-b966-e6913bd24013	85739778-f762-11e1-a439-00145eb45e9a
634258	634258	0	U.S. Geological Survey	8618c64a-93e0-4300-b546-7249e5148ed2	8648fdbe-f762-11e1-a439-00145eb45e9a
157	157	0	GBIF Germany	4f6826f2-4ff6-443d-b966-e6913bd24013	88338c8e-f762-11e1-a439-00145eb45e9a
14	14	0	Plazi	ffb07bec-2d10-492d-9c37-361fe0b79427	8893798f-110f-432d-a0db-2d3965ca2d6f
0	9640	9640	GBIF Portugal	673f7038-4262-4149-b753-5658a4e912f6	8956ea59-442e-43b9-aeee-7aaef84a87f4
40	40	0	GBIF Germany	4f6826f2-4ff6-443d-b966-e6913bd24013	8a7ca05c-f762-11e1-a439-00145eb45e9a
183	183	0	GBIF Germany	4f6826f2-4ff6-443d-b966-e6913bd24013	8a900192-f762-11e1-a439-00145eb45e9a
4476	4476	0	National Biodiversity Network	d897a5b9-35ee-4232-94bd-b0bcaac003c2	8c6e3780-823e-46ee-a39f-5d3bc1a4ab00
44	44	0	GBIF Germany	4f6826f2-4ff6-443d-b966-e6913bd24013	8c96dbdc-f762-11e1-a439-00145eb45e9a
136	99	-37	GBIF Germany	4f6826f2-4ff6-443d-b966-e6913bd24013	8cc1ac36-f762-11e1-a439-00145eb45e9a
109	109	0	GBIF Germany	4f6826f2-4ff6-443d-b966-e6913bd24013	8cd6fb86-f762-11e1-a439-00145eb45e9a
23	23	0	GBIF Germany	4f6826f2-4ff6-443d-b966-e6913bd24013	8d47acfa-f762-11e1-a439-00145eb45e9a
4	4	0	GBIF Germany	4f6826f2-4ff6-443d-b966-e6913bd24013	8ee97a5c-f762-11e1-a439-00145eb45e9a
131	125	-6	GBIF Germany	4f6826f2-4ff6-443d-b966-e6913bd24013	8fa7f928-f762-11e1-a439-00145eb45e9a
100	55	-45	GBIF Germany	4f6826f2-4ff6-443d-b966-e6913bd24013	9075ad5a-f762-11e1-a439-00145eb45e9a
120	106	-14	GBIF Germany	4f6826f2-4ff6-443d-b966-e6913bd24013	91288970-f762-11e1-a439-00145eb45e9a
14	9	-5	GBIF Germany	4f6826f2-4ff6-443d-b966-e6913bd24013	913d716e-f762-11e1-a439-00145eb45e9a
16	12	-4	GBIF Germany	4f6826f2-4ff6-443d-b966-e6913bd24013	9195faa0-f762-11e1-a439-00145eb45e9a
32	15	-17	GBIF Germany	4f6826f2-4ff6-443d-b966-e6913bd24013	91e8a11a-f762-11e1-a439-00145eb45e9a
14	14	0	GBIF Germany	4f6826f2-4ff6-443d-b966-e6913bd24013	940062d0-f762-11e1-a439-00145eb45e9a
5	5	0	Plazi	ffb07bec-2d10-492d-9c37-361fe0b79427	9412b298-1ceb-4e63-9ff3-ae43235a009f
290	290	0	Plazi	ffb07bec-2d10-492d-9c37-361fe0b79427	94ff507e-8f96-48b3-b3a5-77595fc9be40
198	198	0	Participant Node Managers Committee	7f48e0c8-5c96-49ec-b972-30748e339115	957c25e8-d52d-4b38-b400-aea0ef729c0c
0	2	2	Plazi	ffb07bec-2d10-492d-9c37-361fe0b79427	95bb7685-add2-41f9-8444-6727fdcc941c
30	30	0	Atlas of Living Australia	4a6f1b71-969e-4fc5-a693-282b05e1220c	969e8a30-f762-11e1-a439-00145eb45e9a
4	4	0	Plazi	ffb07bec-2d10-492d-9c37-361fe0b79427	96f46c2b-86ec-4cbe-b54d-e7f0201adbf3
2663	2663	0	Atlas of Living Australia	4a6f1b71-969e-4fc5-a693-282b05e1220c	989a39ef-6e04-4439-83db-78bc286f19fa
13	13	0	Plazi	ffb07bec-2d10-492d-9c37-361fe0b79427	9ced6560-a1f3-4105-89b7-fbf5fba4e20c
61	61	0	Plazi	ffb07bec-2d10-492d-9c37-361fe0b79427	9cfb392b-d6e9-431d-bcc4-598698ad1763
34	34	0	Plazi	ffb07bec-2d10-492d-9c37-361fe0b79427	a046214e-7a94-4669-a6e3-495747d5158c
8	8	0	Plazi	ffb07bec-2d10-492d-9c37-361fe0b79427	a13d1c51-26ae-42f4-a0d6-9bae125c38d5
28	28	0	Atlas of Living Australia	4a6f1b71-969e-4fc5-a693-282b05e1220c	a20a695a-df93-4bd8-98dd-33e1a37e2f7f
4	4	0	Plazi	ffb07bec-2d10-492d-9c37-361fe0b79427	a27f5125-b319-41fb-9fc6-4508fd96183c
0	7	7	Plazi	ffb07bec-2d10-492d-9c37-361fe0b79427	a2b4ffb5-baab-44bd-91c4-76a6816e98e2
0	29550	29550	Ocean Biodiversity Information System	ba0670b9-4186-41e6-8e70-f9cb3065551a	a44840ed-11c8-4e7f-8470-fbee5948b537
0	1	1	Plazi	ffb07bec-2d10-492d-9c37-361fe0b79427	a57abbfb-6505-4fc2-ba7e-601d04827f06
1	1	0	Plazi	ffb07bec-2d10-492d-9c37-361fe0b79427	a5e07020-bde2-4147-b51e-7b159c30812d
0	3834	3834	Canada Biodiversity Information Facility	8f83fc96-c966-4126-83f7-bf044dc49efa	a62c37c4-6fbe-4a93-8c87-c67dda36436c
923	953	30	GBIF Brazil	cdc9736d-5ff7-4ece-9959-3c744360cdb3	a6b72897-dc8f-4325-8450-10bbe31a580a
6	6	0	GBIF Malawi	2a42e4d7-ad4a-41b3-84c4-de4aa7b74d35	a76c9ca3-67ac-4ff6-96d0-6eb0fe27de70
0	4	4	Plazi	ffb07bec-2d10-492d-9c37-361fe0b79427	a7ef425a-8153-40bb-9190-009cc1316c60
1	1	0	Plazi	ffb07bec-2d10-492d-9c37-361fe0b79427	ab36d8ef-e3ee-4e18-8399-8d611eae4239
0	9	9	Ocean Biodiversity Information System	ba0670b9-4186-41e6-8e70-f9cb3065551a	ab8f9149-a33a-452a-9137-f42e3998b044
0	2905	2905	GBIF Portugal	673f7038-4262-4149-b753-5658a4e912f6	ad0d8f88-60b5-4f42-8a8f-c7d8b84cd23c
1	1	0	Colombian Biodiversity Information System	7e865cba-7c46-417b-ade5-97f2cf5b7be0	ad9574bd-5078-4a43-a534-e7669ca7b86f
0	6	6	Plazi	ffb07bec-2d10-492d-9c37-361fe0b79427	adb56cdf-a1be-4add-a755-7ed13c6e48f6
0	17	17	Plazi	ffb07bec-2d10-492d-9c37-361fe0b79427	aea7d978-e7e9-460a-b618-c7ece0e0534c
10	10	0	Plazi	ffb07bec-2d10-492d-9c37-361fe0b79427	aebfbe64-4abc-4c7b-b4e0-88698bef5eb1
9539	9539	0	National Biodiversity Network	d897a5b9-35ee-4232-94bd-b0bcaac003c2	af09cf7c-9122-4351-899f-8baf903e07cd
140	140	0	Plazi	ffb07bec-2d10-492d-9c37-361fe0b79427	af76ca28-44a6-4c79-9919-6d501851f3a0
0	13	13	Plazi	ffb07bec-2d10-492d-9c37-361fe0b79427	b5bd33f4-df29-4eae-9955-954a70a03482
1267	1267	0	National Biodiversity Network	d897a5b9-35ee-4232-94bd-b0bcaac003c2	b745c9fa-b58a-40f9-a335-df82adca3655
101	101	0	National Biodiversity Network	d897a5b9-35ee-4232-94bd-b0bcaac003c2	c40816f6-5146-4f46-83a3-c4cf638ca37e
894	625	-269	GBIF Germany	4f6826f2-4ff6-443d-b966-e6913bd24013	c43ec296-a4b6-4c63-aff6-1786019d4c32
33	33	0	GBIF Argentina	2426a871-9feb-40a1-96c6-0c593a76b835	c79c4f3b-37fb-4851-addb-b9077a50fd38
28	28	0	GBIF France	da44cd31-5901-4687-a106-6d1c7734ee3a	c7c6a3b6-b09c-422d-b6f8-d305004892da
450	450	0	GBIF Finland	dd514216-5c7c-45f3-910d-797424cb5be6	c7f97c25-a449-47f7-9eaf-56e41b1ac266
346830	346830	0	GBIF France	da44cd31-5901-4687-a106-6d1c7734ee3a	c967b7f3-1724-45cc-9488-129b24087e0c
2	2	0	Plazi	ffb07bec-2d10-492d-9c37-361fe0b79427	ca3c2f8f-1409-484b-b024-f49b874822c3
0	2	2	Plazi	ffb07bec-2d10-492d-9c37-361fe0b79427	ca547796-4111-44db-8cd9-bf11c915862c
273	273	0	GBIF Germany	4f6826f2-4ff6-443d-b966-e6913bd24013	cbf6e92e-afdb-47ee-8571-224e3d9f1d5c
4	4	0	Plazi	ffb07bec-2d10-492d-9c37-361fe0b79427	cdbef615-74d3-4849-9f0e-74575fe19353
5	5	0	Plazi	ffb07bec-2d10-492d-9c37-361fe0b79427	d0c4470f-b3b1-4cc9-bf47-22f92463d1ec
1	1	0	Plazi	ffb07bec-2d10-492d-9c37-361fe0b79427	d29893c4-d196-44be-9d52-78ddeef7c34d
1017	1017	0	GBIF France	da44cd31-5901-4687-a106-6d1c7734ee3a	d87dbd87-d7d7-418e-8c0d-1dee00bc8a88
17185	17238	53	GBIF France	da44cd31-5901-4687-a106-6d1c7734ee3a	d9474ec2-061c-4858-bfdd-e10ba6aca397
0	2	2	Plazi	ffb07bec-2d10-492d-9c37-361fe0b79427	db4f30de-dcd4-46d3-bb04-cb2a09cb353c
111	111	0	GBIF France	da44cd31-5901-4687-a106-6d1c7734ee3a	db627a7c-396d-4d7f-808a-bf95bedf8648
49	49	0	GBIF Sweden	a0b3be64-6525-4387-ac67-a499950f92e1	db79501e-a326-4f21-bcd4-fa34bc71ce93
550	550	0	Colombian Biodiversity Information System	7e865cba-7c46-417b-ade5-97f2cf5b7be0	de8fec01-4cf7-4062-a6e8-ec489184b992
740601	789753	49152	U.S. Geological Survey	8618c64a-93e0-4300-b546-7249e5148ed2	df8e3fb8-3da7-4104-a866-748f6da20a3c
17	17	0	Plazi	ffb07bec-2d10-492d-9c37-361fe0b79427	e0744d3e-e89d-4019-ae7f-78e0b37bd656
17	17	0	Plazi	ffb07bec-2d10-492d-9c37-361fe0b79427	e1ab583f-5629-4f9d-8335-72709b591273
86	86	0	GBIF France	da44cd31-5901-4687-a106-6d1c7734ee3a	e1d01290-e84b-4564-a8f0-ddefc1db3d29
3487	3487	0	GBIF Brazil	cdc9736d-5ff7-4ece-9959-3c744360cdb3	e2aec6ff-2d47-453e-a5b2-62ce21aad973
141	141	0	Plazi	ffb07bec-2d10-492d-9c37-361fe0b79427	e3e34ef4-41ee-40db-b940-bb22a2ae3ad8
45	45	0	Colombian Biodiversity Information System	7e865cba-7c46-417b-ade5-97f2cf5b7be0	e53f6bc3-641d-4378-82d1-0a74f497f90d
0	8	8	Plazi	ffb07bec-2d10-492d-9c37-361fe0b79427	e5daa704-bb72-473a-8aa0-f43bf98d7f13
10687	10687	0	Ocean Biodiversity Information System	ba0670b9-4186-41e6-8e70-f9cb3065551a	ebedfe50-dd03-4028-9506-7d43f83878cd
172	172	0	GBIF Sweden	a0b3be64-6525-4387-ac67-a499950f92e1	eed0fa74-c8a5-4289-9001-d8bd86bed1ff
48	48	0	Plazi	ffb07bec-2d10-492d-9c37-361fe0b79427	eef4aa32-6fc9-44a7-b1df-ef1b6691fa26
0	1	1	Plazi	ffb07bec-2d10-492d-9c37-361fe0b79427	f08db410-31c1-4f76-a485-ac676eb6c5cf
88	88	0	Plazi	ffb07bec-2d10-492d-9c37-361fe0b79427	f0dd7b70-5bc1-4a25-9d38-ddf68afed9dd
21	36	15	GBIF Japan	db5705aa-6a6e-42f1-8942-d77b9f4896ea	f17d98e6-85ca-4f4c-8920-50c68166fcdb
3	3	0	Plazi	ffb07bec-2d10-492d-9c37-361fe0b79427	f2476be8-21f2-4a7b-bee5-e50b17793f84
9	9	0	Plazi	ffb07bec-2d10-492d-9c37-361fe0b79427	f2ea6903-8250-4cef-b245-7d0358639a32
10307	10307	0	Ocean Biodiversity Information System	ba0670b9-4186-41e6-8e70-f9cb3065551a	f55751e3-ac05-4f11-b70f-7b81cb397452
7	7	0	Plazi	ffb07bec-2d10-492d-9c37-361fe0b79427	f6b72893-383e-488f-bab3-51496f6fe5b5
36396	36396	0	Atlas of Living Australia	4a6f1b71-969e-4fc5-a693-282b05e1220c	f8f683a8-ab6c-4c4b-a6ec-53b23d5404d0
21	21	0	Plazi	ffb07bec-2d10-492d-9c37-361fe0b79427	f9bd2276-e9f7-4173-acea-b5341cf3f62c
103	103	0	GBIF Argentina	2426a871-9feb-40a1-96c6-0c593a76b835	fb413cf5-fa81-4496-8fe6-41c3baa026ce
2	2	0	Plazi	ffb07bec-2d10-492d-9c37-361fe0b79427	ff058d92-6fee-434a-b608-1cd8cf4b2c42
7	7	0	Plazi	ffb07bec-2d10-492d-9c37-361fe0b79427	043cd50d-f1b9-400f-8c6b-8ba62b24a72c
477	477	0	Belgian Biodiversity Platform	fb11cfe1-ebc3-45af-9159-17d9fddbcdac	08a4ed1f-8586-4437-b3c9-95989eb40fd4
840	840	0	GBIF France	da44cd31-5901-4687-a106-6d1c7734ee3a	0975a2ac-7b5f-4262-a0f4-7d3e318ab6ad
0	17	17	Plazi	ffb07bec-2d10-492d-9c37-361fe0b79427	0ee12a7b-2f44-40aa-9dc4-5fdb7bc23295
12	12	0	Plazi	ffb07bec-2d10-492d-9c37-361fe0b79427	10b5d8f0-30c1-4227-b17b-fb8d865ddd06
64689	65535	846	GBIF Brazil	cdc9736d-5ff7-4ece-9959-3c744360cdb3	121275a3-dcce-44f4-9868-37326e9f64ef
7	7	0	Plazi	ffb07bec-2d10-492d-9c37-361fe0b79427	16c42bc5-8d00-477e-98a0-cf4c2f4b4cca
2807	2807	0	National Biodiversity Network	d897a5b9-35ee-4232-94bd-b0bcaac003c2	1a635d8e-8a8a-4850-9d44-66a6d5f68885
779	779	0	GBIF Norway	4f829580-180d-46a9-9c87-ed8ec959b545	1b21db41-8572-4fd1-8c29-b5d891cf6220
0	185	185	Plazi	ffb07bec-2d10-492d-9c37-361fe0b79427	1b50774e-3be8-4997-9f39-45e6f5d66cae
4712	4712	0	GBIF France	da44cd31-5901-4687-a106-6d1c7734ee3a	1cfc1912-b20c-4a51-8935-999d3580e398
12	12	0	Plazi	ffb07bec-2d10-492d-9c37-361fe0b79427	1d28d909-84e0-41bd-8ea1-34498c05c0f3
0	93	93	Canada Biodiversity Information Facility	8f83fc96-c966-4126-83f7-bf044dc49efa	21276ae8-ac03-4ae2-a3d3-37e9886c15ea
14	14	0	Plazi	ffb07bec-2d10-492d-9c37-361fe0b79427	23fe26d8-e90c-48e4-b30e-12e10fe08578
2	2	0	Plazi	ffb07bec-2d10-492d-9c37-361fe0b79427	244e9b7a-0cca-4e09-bf94-d122c05de1b3
2	2	0	Plazi	ffb07bec-2d10-492d-9c37-361fe0b79427	260812b0-97a3-4b8e-96e1-ca48699a41b1
5602	5602	0	National Biodiversity Network	d897a5b9-35ee-4232-94bd-b0bcaac003c2	277891f7-406d-4594-9054-16f6f834bd1f
22066	22066	0	National Biodiversity Network	d897a5b9-35ee-4232-94bd-b0bcaac003c2	2820bc94-1909-4ee8-8af0-206fa1157dd7
0	5	5	Plazi	ffb07bec-2d10-492d-9c37-361fe0b79427	28692c5a-455b-4bd9-a959-62b8957134dd
1051	1051	0	U.S. Geological Survey	8618c64a-93e0-4300-b546-7249e5148ed2	2b87bd63-7431-4ba1-a728-4821d20e282e
122	122	0	Colombian Biodiversity Information System	7e865cba-7c46-417b-ade5-97f2cf5b7be0	2bd4874a-949b-45ca-afcb-87285eb15038
72	72	0	Plazi	ffb07bec-2d10-492d-9c37-361fe0b79427	2c7fe9b1-f5a7-4169-bcc0-d544c884e01f
13	13	0	Plazi	ffb07bec-2d10-492d-9c37-361fe0b79427	2f791191-ae08-4795-b02f-6a4ed2e3e15d
0	444	444	National Biodiversity Network	d897a5b9-35ee-4232-94bd-b0bcaac003c2	324bd978-c52b-4307-ae27-8e2f0e07b3f4
1439	1439	0	National Biodiversity Network	d897a5b9-35ee-4232-94bd-b0bcaac003c2	345d33dc-e7f7-4da8-980d-e7e66acab754
1	1	0	Plazi	ffb07bec-2d10-492d-9c37-361fe0b79427	37f15e5e-613d-4b9a-9972-7d0040664f7c
23	23	0	Plazi	ffb07bec-2d10-492d-9c37-361fe0b79427	392c4688-2c0a-49c5-935e-30f7b2167da1
0	29	29	Plazi	ffb07bec-2d10-492d-9c37-361fe0b79427	3a4c4b89-14b9-4a6c-8379-6c8349805201
0	172	172	Plazi	ffb07bec-2d10-492d-9c37-361fe0b79427	3ba10b86-da39-40e8-898c-ee3dfa6f0f05
2489	2489	0	National Biodiversity Network	d897a5b9-35ee-4232-94bd-b0bcaac003c2	3d7d13e8-f87c-40e2-8c00-6eb67d4a8102
75	75	0	Plazi	ffb07bec-2d10-492d-9c37-361fe0b79427	3dd25cc6-4170-43f4-a908-4be1dd3d4cb3
308	308	0	Participant Node Managers Committee	7f48e0c8-5c96-49ec-b972-30748e339115	3f1b425d-0ed1-4089-aef3-ddddaa6cfbd1
204	204	0	GBIF Germany	4f6826f2-4ff6-443d-b966-e6913bd24013	3ff06696-819a-11e2-bad2-00145eb45e9a
10	10	0	Plazi	ffb07bec-2d10-492d-9c37-361fe0b79427	4023827c-f856-4f43-bcf2-59a07cb2d0cc
0	1	1	Plazi	ffb07bec-2d10-492d-9c37-361fe0b79427	40d3084e-f2a5-483c-8497-724c72414a59
15310	15310	0	National Biodiversity Network	d897a5b9-35ee-4232-94bd-b0bcaac003c2	40f02566-08c7-45fc-93b4-ab41e71b4d06
11961	11961	0	GBIF Norway	4f829580-180d-46a9-9c87-ed8ec959b545	418a6571-b6c1-4db0-b90e-8f36bde4c80e
66	66	0	National Biodiversity Network	d897a5b9-35ee-4232-94bd-b0bcaac003c2	439e017b-c952-490b-9b5a-1e190e55bb15
45	45	0	Plazi	ffb07bec-2d10-492d-9c37-361fe0b79427	4569c2ca-cbbb-49cb-8460-494916d5f3d8
2224	2224	0	GBIF Argentina	2426a871-9feb-40a1-96c6-0c593a76b835	4716b85e-7a3f-4d9e-b97c-539162514313
0	24013	24013	Colombian Biodiversity Information System	7e865cba-7c46-417b-ade5-97f2cf5b7be0	4864a414-6138-432a-9197-0405afce96bf
0	4	4	Plazi	ffb07bec-2d10-492d-9c37-361fe0b79427	49ba7cdc-c314-4f30-a076-c3a52049a1e1
0	6	6	Plazi	ffb07bec-2d10-492d-9c37-361fe0b79427	4b35f4f2-e111-4162-997b-f607da4bbb44
19388	19388	0	GBIF Brazil	cdc9736d-5ff7-4ece-9959-3c744360cdb3	4c0c4e7f-6a80-4632-9a9d-7a5fc9501c5d
2	2	0	Plazi	ffb07bec-2d10-492d-9c37-361fe0b79427	4e294d60-fb79-4ea2-8b41-3f5e9c0a0d6e
7	7	0	Plazi	ffb07bec-2d10-492d-9c37-361fe0b79427	4e6de710-4a08-43b2-898c-6d5781e1b155
2912	2912	0	GBIF France	da44cd31-5901-4687-a106-6d1c7734ee3a	4ee0b4a2-7769-417f-abd7-0c8c04a9d44a
1	1	0	Plazi	ffb07bec-2d10-492d-9c37-361fe0b79427	4f80927b-5289-4d6c-8bd2-30d59347a052
17	17	0	Plazi	ffb07bec-2d10-492d-9c37-361fe0b79427	53525486-c356-4dd1-9bf8-a3265dfbf841
0	17	17	Plazi	ffb07bec-2d10-492d-9c37-361fe0b79427	54e62fed-bc2f-41a6-ac96-d29f44b53e7f
28	28	0	Plazi	ffb07bec-2d10-492d-9c37-361fe0b79427	5c472480-b92a-4403-ab49-6f4b3f603f18
0	1	1	Plazi	ffb07bec-2d10-492d-9c37-361fe0b79427	5d0504d4-664e-4a41-8a98-3f735c95f29d
18	18	0	Biodiversity Information System of Mexico	b324e8e9-9a4c-44fa-8f1a-7f39ea7ab576	5f11d7d9-f1a3-46ec-ad87-ff8b5d76e66f
57	57	0	GBIF Germany	4f6826f2-4ff6-443d-b966-e6913bd24013	615d892a-f762-11e1-a439-00145eb45e9a
96	96	0	GBIF Germany	4f6826f2-4ff6-443d-b966-e6913bd24013	6267347e-f762-11e1-a439-00145eb45e9a
46	46	0	GBIF Germany	4f6826f2-4ff6-443d-b966-e6913bd24013	6286e1d4-f762-11e1-a439-00145eb45e9a
0	4	4	Plazi	ffb07bec-2d10-492d-9c37-361fe0b79427	6301a2d9-9836-4a31-b3ca-e4f42d527ecc
1295	1295	0	GBIF France	da44cd31-5901-4687-a106-6d1c7734ee3a	6315464b-b634-49af-a4ce-1f19bca4e078
701	701	0	Participant Node Managers Committee	7f48e0c8-5c96-49ec-b972-30748e339115	639e7857-14e9-4cc8-98c9-7af17484116f
36	36	0	GBIF Germany	4f6826f2-4ff6-443d-b966-e6913bd24013	6434e1fc-f762-11e1-a439-00145eb45e9a
29	29	0	GBIF Germany	4f6826f2-4ff6-443d-b966-e6913bd24013	661a31ca-f762-11e1-a439-00145eb45e9a
57	57	0	GBIF Germany	4f6826f2-4ff6-443d-b966-e6913bd24013	667b94c4-f762-11e1-a439-00145eb45e9a
0	87	87	Participant Node Managers Committee	7f48e0c8-5c96-49ec-b972-30748e339115	667e38d0-8625-4df6-b3c3-dde744a9586c
77	77	0	GBIF Germany	4f6826f2-4ff6-443d-b966-e6913bd24013	67b2216e-f762-11e1-a439-00145eb45e9a
515	515	0	U.S. Geological Survey	8618c64a-93e0-4300-b546-7249e5148ed2	69043db3-22c3-4853-a7e4-72df876a300c
167	167	0	GBIF Germany	4f6826f2-4ff6-443d-b966-e6913bd24013	697b5484-f762-11e1-a439-00145eb45e9a
99	99	0	GBIF Germany	4f6826f2-4ff6-443d-b966-e6913bd24013	69d1ec4a-f762-11e1-a439-00145eb45e9a
7	7	0	Plazi	ffb07bec-2d10-492d-9c37-361fe0b79427	6b67185d-1e5e-414a-acc9-54e613b86464
3	3	0	Plazi	ffb07bec-2d10-492d-9c37-361fe0b79427	6b69d172-98dd-4dc0-bc29-9829e0f2df6b
140	140	0	GBIF Germany	4f6826f2-4ff6-443d-b966-e6913bd24013	6c129a18-f762-11e1-a439-00145eb45e9a
11	11	0	Plazi	ffb07bec-2d10-492d-9c37-361fe0b79427	6c584361-1962-45ae-9bbf-3716dba0ec5b
0	5	5	Plazi	ffb07bec-2d10-492d-9c37-361fe0b79427	6d063090-0054-4b7b-8c02-24058d294a77
1547	1547	0	GBIF Benin	efb9c00e-f802-45dd-8826-a52ec45b89ff	709b3aba-b05c-4741-9447-20f8b24330b7
8273	12342	4069	GBIF Germany	4f6826f2-4ff6-443d-b966-e6913bd24013	71f5f308-f762-11e1-a439-00145eb45e9a
147	147	0	Plazi	ffb07bec-2d10-492d-9c37-361fe0b79427	72f57e78-d531-481f-935e-8ab604837d7d
10	10	0	GBIF Germany	4f6826f2-4ff6-443d-b966-e6913bd24013	7350d222-f762-11e1-a439-00145eb45e9a
13	13	0	Plazi	ffb07bec-2d10-492d-9c37-361fe0b79427	73740f1a-188c-49fe-a135-5f9b874d1764
4	4	0	GBIF Germany	4f6826f2-4ff6-443d-b966-e6913bd24013	7379a058-f762-11e1-a439-00145eb45e9a
10	10	0	GBIF Germany	4f6826f2-4ff6-443d-b966-e6913bd24013	7380176c-f762-11e1-a439-00145eb45e9a
40	40	0	GBIF Germany	4f6826f2-4ff6-443d-b966-e6913bd24013	740337b4-f762-11e1-a439-00145eb45e9a
820	820	0	GBIF Germany	4f6826f2-4ff6-443d-b966-e6913bd24013	74c7cc5a-f762-11e1-a439-00145eb45e9a
18	18	0	GBIF Germany	4f6826f2-4ff6-443d-b966-e6913bd24013	78b9914a-f762-11e1-a439-00145eb45e9a
285	285	0	GBIF Germany	4f6826f2-4ff6-443d-b966-e6913bd24013	79cd882a-f762-11e1-a439-00145eb45e9a
314	314	0	GBIF Germany	4f6826f2-4ff6-443d-b966-e6913bd24013	79e9faf0-f762-11e1-a439-00145eb45e9a
9	9	0	GBIF Germany	4f6826f2-4ff6-443d-b966-e6913bd24013	7ac87d3e-f762-11e1-a439-00145eb45e9a
106179	108669	2490	National Biodiversity Network	d897a5b9-35ee-4232-94bd-b0bcaac003c2	7adf20e0-c955-11de-95c0-b8a03c50a862
52394	52394	0	GBIF Japan	db5705aa-6a6e-42f1-8942-d77b9f4896ea	7adffacc-f762-11e1-a439-00145eb45e9a
1011	1011	0	GBIF Germany	4f6826f2-4ff6-443d-b966-e6913bd24013	7c855b9c-f762-11e1-a439-00145eb45e9a
2	2	0	Plazi	ffb07bec-2d10-492d-9c37-361fe0b79427	7cb29624-842c-4c50-8c8c-9c0df17dc878
165	165	0	GBIF Germany	4f6826f2-4ff6-443d-b966-e6913bd24013	7d1af5bc-f762-11e1-a439-00145eb45e9a
2130	2130	0	GBIF Germany	4f6826f2-4ff6-443d-b966-e6913bd24013	7d76f506-f913-48a4-89a9-da08c04ec816
110	110	0	GBIF Germany	4f6826f2-4ff6-443d-b966-e6913bd24013	7dc7fb54-f762-11e1-a439-00145eb45e9a
136	136	0	GBIF Germany	4f6826f2-4ff6-443d-b966-e6913bd24013	7e5cb6cc-f762-11e1-a439-00145eb45e9a
1639	521	-1118	GBIF Germany	4f6826f2-4ff6-443d-b966-e6913bd24013	7f0994a0-f762-11e1-a439-00145eb45e9a
125	40	-85	GBIF Germany	4f6826f2-4ff6-443d-b966-e6913bd24013	7f49f748-f762-11e1-a439-00145eb45e9a
22568	7507	-15061	Participant Node Managers Committee	7f48e0c8-5c96-49ec-b972-30748e339115	81a55a32-e89b-4959-8e49-0481c4d31973
4	4	0	Plazi	ffb07bec-2d10-492d-9c37-361fe0b79427	820a3d60-33c3-4934-9ce2-0ebef4de8532
395	318	-77	GBIF Germany	4f6826f2-4ff6-443d-b966-e6913bd24013	8223194a-f762-11e1-a439-00145eb45e9a
56	56	0	GBIF Germany	4f6826f2-4ff6-443d-b966-e6913bd24013	8267b028-f762-11e1-a439-00145eb45e9a
0	2779	2779	Participant Node Managers Committee	7f48e0c8-5c96-49ec-b972-30748e339115	83739c4e-c55c-467c-9286-680f74f6cd81
25959	25959	0	Canada Biodiversity Information Facility	8f83fc96-c966-4126-83f7-bf044dc49efa	8464c76c-f762-11e1-a439-00145eb45e9a
261	261	0	GBIF France	da44cd31-5901-4687-a106-6d1c7734ee3a	869102fa-99dc-4fe4-b6e9-de614b2377e2
579	427	-152	GBIF Germany	4f6826f2-4ff6-443d-b966-e6913bd24013	86fa0b36-f762-11e1-a439-00145eb45e9a
370	370	0	Biodiversity Information System of Mexico	b324e8e9-9a4c-44fa-8f1a-7f39ea7ab576	87c37671-724b-45de-bbd4-7e0a669ca172
172	128	-44	GBIF Germany	4f6826f2-4ff6-443d-b966-e6913bd24013	882295f0-f762-11e1-a439-00145eb45e9a
347	290	-57	GBIF Germany	4f6826f2-4ff6-443d-b966-e6913bd24013	884d8e72-f762-11e1-a439-00145eb45e9a
0	3	3	Plazi	ffb07bec-2d10-492d-9c37-361fe0b79427	88868602-6066-47a7-9790-a9166e09d50f
0	2	2	Plazi	ffb07bec-2d10-492d-9c37-361fe0b79427	88c1d8ec-225f-4792-bb97-dc96aa55c744
473	473	0	Belgian Biodiversity Platform	fb11cfe1-ebc3-45af-9159-17d9fddbcdac	89628349-916f-46a9-9d6f-113ef603f3d8
1970	1970	0	Participant Node Managers Committee	7f48e0c8-5c96-49ec-b972-30748e339115	89f30480-54fd-4de2-ba51-c2249274add0
236	236	0	GBIF Germany	4f6826f2-4ff6-443d-b966-e6913bd24013	8a41e912-f762-11e1-a439-00145eb45e9a
118	34	-84	GBIF Germany	4f6826f2-4ff6-443d-b966-e6913bd24013	8a6f094c-599d-40cd-bc17-81a7b1306921
9	9	0	Plazi	ffb07bec-2d10-492d-9c37-361fe0b79427	8b28e118-be14-4eb1-8997-033c50d8d5dd
8	8	0	GBIF Germany	4f6826f2-4ff6-443d-b966-e6913bd24013	8bcb4486-f762-11e1-a439-00145eb45e9a
95	95	0	GBIF Germany	4f6826f2-4ff6-443d-b966-e6913bd24013	8c23f248-f762-11e1-a439-00145eb45e9a
3	3	0	GBIF Germany	4f6826f2-4ff6-443d-b966-e6913bd24013	8c3a81de-f762-11e1-a439-00145eb45e9a
0	4	4	Plazi	ffb07bec-2d10-492d-9c37-361fe0b79427	8cc10a55-f2b0-4999-a9ef-02b2903569b8
101	101	0	GBIF Germany	4f6826f2-4ff6-443d-b966-e6913bd24013	8d713386-f762-11e1-a439-00145eb45e9a
959	959	0	National Biodiversity Network	d897a5b9-35ee-4232-94bd-b0bcaac003c2	8e688eba-83ce-4501-9a02-a5261730be95
46217	46217	0	GBIF France	da44cd31-5901-4687-a106-6d1c7734ee3a	8e9c7b26-44c5-4d7b-ad70-eee51cb5d1dd
237	232	-5	GBIF Germany	4f6826f2-4ff6-443d-b966-e6913bd24013	8ec73082-f762-11e1-a439-00145eb45e9a
15224	15657	433	U.S. Geological Survey	8618c64a-93e0-4300-b546-7249e5148ed2	91025c69-111a-45c0-8440-59cb9efbdff7
57	31	-26	GBIF Germany	4f6826f2-4ff6-443d-b966-e6913bd24013	918f3210-f762-11e1-a439-00145eb45e9a
1477	1477	0	GBIF Germany	4f6826f2-4ff6-443d-b966-e6913bd24013	91da513c-f762-11e1-a439-00145eb45e9a
78	78	0	GBIF Guinea	b1cd2e84-c4ba-47bd-b72a-dfd1f92dce0a	9285b435-b3dc-47e1-ba0c-ffd11e2aee85
2	2	0	Plazi	ffb07bec-2d10-492d-9c37-361fe0b79427	93210fd7-9e59-4d05-91a1-d23a9ff514ea
486	486	0	GBIF France	da44cd31-5901-4687-a106-6d1c7734ee3a	9450ec8a-43a6-45a0-93f7-c54bbf7de0fc
776	776	0	GBIF Germany	4f6826f2-4ff6-443d-b966-e6913bd24013	9523fdf2-f762-11e1-a439-00145eb45e9a
2035	2035	0	GBIF Japan	db5705aa-6a6e-42f1-8942-d77b9f4896ea	960158b4-f762-11e1-a439-00145eb45e9a
143	143	0	Biodiversity Information System of Mexico	b324e8e9-9a4c-44fa-8f1a-7f39ea7ab576	98af4b5e-c2e6-4d84-9b22-2fdfcc2f7921
578	578	0	Biodiversity Information System of Mexico	b324e8e9-9a4c-44fa-8f1a-7f39ea7ab576	9927adc3-5ea6-46a8-8eca-d7af64ee6fc0
50	50	0	Colombian Biodiversity Information System	7e865cba-7c46-417b-ade5-97f2cf5b7be0	9a6c17ba-58f6-4186-83a1-7ca3386deb73
0	2	2	Plazi	ffb07bec-2d10-492d-9c37-361fe0b79427	9c0d1bc5-ef52-4ac2-868a-404f96e14820
20740	20740	0	GBIF Portugal	673f7038-4262-4149-b753-5658a4e912f6	9cbf3150-88a4-4d74-a36b-872ee74d9c28
739	739	0	GBIF Benin	efb9c00e-f802-45dd-8826-a52ec45b89ff	9cc68a7f-df2d-49d6-b797-94c99a2cafe8
7075	7075	0	GBIF Germany	4f6826f2-4ff6-443d-b966-e6913bd24013	9cd0014c-b7b1-4ed1-bef7-0225acfa4ef2
0	30	30	Plazi	ffb07bec-2d10-492d-9c37-361fe0b79427	9d036143-8637-4992-995a-09763a6c8860
72	72	0	Plazi	ffb07bec-2d10-492d-9c37-361fe0b79427	a10d2e30-ef6d-4f66-ad3b-485d6a953263
2	2	0	Plazi	ffb07bec-2d10-492d-9c37-361fe0b79427	a438c895-d898-411c-95f5-964d0a6d4f0b
45	45	0	Plazi	ffb07bec-2d10-492d-9c37-361fe0b79427	a466da4f-5778-4f8b-8c2f-47dfc2dd2344
1	1	0	Plazi	ffb07bec-2d10-492d-9c37-361fe0b79427	a568c0d2-1434-47ec-ba93-01d9d068d117
84981	84981	0	GBIF Norway	4f829580-180d-46a9-9c87-ed8ec959b545	a639542a-654a-427b-9cf1-bde1953bbb52
58	58	0	GBIF Finland	dd514216-5c7c-45f3-910d-797424cb5be6	a645735e-30e2-40f7-9c8c-4b0755cfed79
738	738	0	Biodiversity Information System of Mexico	b324e8e9-9a4c-44fa-8f1a-7f39ea7ab576	a7793424-dc57-4d4d-ad91-9890b76ebc15
68	68	0	Plazi	ffb07bec-2d10-492d-9c37-361fe0b79427	a94be2b4-e3c7-4a35-a5e8-5776197d8ca6
14257	14257	0	GBIF France	da44cd31-5901-4687-a106-6d1c7734ee3a	ad65ebe8-817e-4624-92bb-d3dd6c5fd94f
0	2	2	Plazi	ffb07bec-2d10-492d-9c37-361fe0b79427	ae9676ff-95f2-40b4-98e4-f03756fb3371
74123	74130	7	GBIF Brazil	cdc9736d-5ff7-4ece-9959-3c744360cdb3	af0ac0ba-b895-47a2-ac64-30517f109c33
2940	2940	0	National Biodiversity Network	d897a5b9-35ee-4232-94bd-b0bcaac003c2	b16a6ba5-623a-486f-b4f3-3f81aeb0fbab
0	24	24	Plazi	ffb07bec-2d10-492d-9c37-361fe0b79427	b3381a22-4859-40e6-ba5e-b966903d7fe5
25974	25974	0	Taiwan Biodiversity Information Facility	e1b85abc-61f9-430f-ba79-6813dec53a0f	b6ca9b0b-b6eb-46c5-b623-cd479a71e566
2	2	0	Plazi	ffb07bec-2d10-492d-9c37-361fe0b79427	b8a740ad-cd85-4a4d-855a-5de3be00e526
57	57	0	Plazi	ffb07bec-2d10-492d-9c37-361fe0b79427	be802d18-f06f-4e22-9856-8b037f21ca52
84	84	0	Plazi	ffb07bec-2d10-492d-9c37-361fe0b79427	becfaa49-3068-4113-80b3-27c271186bf0
325	325	0	GBIF France	da44cd31-5901-4687-a106-6d1c7734ee3a	c07343b3-4345-4901-993b-341a6d7a3514
196	196	0	Plazi	ffb07bec-2d10-492d-9c37-361fe0b79427	c2a3a65e-90ff-4bba-af4d-91d82594f636
63	63	0	Ocean Biodiversity Information System	ba0670b9-4186-41e6-8e70-f9cb3065551a	c58a2850-d3f4-47f7-9008-2201cdf40fbe
33	33	0	Plazi	ffb07bec-2d10-492d-9c37-361fe0b79427	c6200cd2-2c64-4789-8bc3-46432a377e0a
1	1	0	Plazi	ffb07bec-2d10-492d-9c37-361fe0b79427	c6c9d194-3b2a-4ffa-8e8f-1550e634b78b
1491	1491	0	Atlas of Living Australia	4a6f1b71-969e-4fc5-a693-282b05e1220c	c83a2438-0703-47fa-8b95-17d84e8c762f
0	547	547	Plazi	ffb07bec-2d10-492d-9c37-361fe0b79427	c8b3885d-e7f5-45c7-ab7d-8911e37fd50c
200	200	0	Plazi	ffb07bec-2d10-492d-9c37-361fe0b79427	c8d905a3-01d4-4d5f-a904-fad72add2ae1
0	7178	7178	Belgian Biodiversity Platform	fb11cfe1-ebc3-45af-9159-17d9fddbcdac	c9e31c10-6986-4795-8244-30ad2486d0bb
31173	31173	0	GBIF Brazil	cdc9736d-5ff7-4ece-9959-3c744360cdb3	cb692845-d58d-4171-a544-bfbf6d93f1da
0	602	602	Ocean Biodiversity Information System	ba0670b9-4186-41e6-8e70-f9cb3065551a	cb6a64b7-d290-4b7c-a23c-052882c96d83
5289	5289	0	GBIF Japan	db5705aa-6a6e-42f1-8942-d77b9f4896ea	cd723649-af30-4626-934f-65a7b3e4cf4f
56	56	0	Plazi	ffb07bec-2d10-492d-9c37-361fe0b79427	ce20a323-b9fa-4223-924c-0fdd5f6ac36d
150	150	0	Biodiversity Information System of Mexico	b324e8e9-9a4c-44fa-8f1a-7f39ea7ab576	cede09b8-360f-4663-bfdc-81ff6b09dbfb
0	29	29	Plazi	ffb07bec-2d10-492d-9c37-361fe0b79427	d04aa5ef-c604-457c-92e8-e8c9a88a1eef
4816	4816	0	Atlas of Living Australia	4a6f1b71-969e-4fc5-a693-282b05e1220c	d0c7a825-fbcc-4ca3-8afd-178f4c458ebf
2	2	0	Plazi	ffb07bec-2d10-492d-9c37-361fe0b79427	d58ba133-017e-434e-bda9-94fc51f9b995
15338	15338	0	GBIF France	da44cd31-5901-4687-a106-6d1c7734ee3a	d6172663-73c4-4dfa-b483-36f454936a37
79	79	0	GBIF Nigeria	6529bcb5-a542-4fda-be87-54a624515335	d87bb066-1087-4416-93a0-9bb622c97f60
0	202	202	Ocean Biodiversity Information System	ba0670b9-4186-41e6-8e70-f9cb3065551a	d9c4fc62-453a-4721-8517-e6cf6bff2301
0	79	79	Colombian Biodiversity Information System	7e865cba-7c46-417b-ade5-97f2cf5b7be0	dd5b188d-9520-48a6-a194-6705f0c32481
99	99	0	GBIF Togo	c9659a3e-07e9-4fcb-83c6-de8b9009a02e	e22ffa14-e998-4fc7-8352-fd5551a7a2ef
6	6	0	Plazi	ffb07bec-2d10-492d-9c37-361fe0b79427	e47cac7f-2a7d-4235-b34d-0a5987af08f7
706	707	1	Colombian Biodiversity Information System	7e865cba-7c46-417b-ade5-97f2cf5b7be0	e681d294-4bbe-4020-8d48-3d18fdbea659
0	495	495	GBIF Norway	4f829580-180d-46a9-9c87-ed8ec959b545	e697326b-48d3-44ee-8b8d-0c9ee26c16d7
2197	2197	0	Colombian Biodiversity Information System	7e865cba-7c46-417b-ade5-97f2cf5b7be0	f007d79c-aedf-4789-ae66-839cbedc1f82
5	5	0	Plazi	ffb07bec-2d10-492d-9c37-361fe0b79427	f1660ccc-b220-4e88-928e-774a3d7f358c
3	3	0	Plazi	ffb07bec-2d10-492d-9c37-361fe0b79427	f1a3f02a-d3bd-4be8-a9c1-d65aa34935e7
0	110	110	Plazi	ffb07bec-2d10-492d-9c37-361fe0b79427	f6358454-a183-429b-9c35-b59108c92c99
0	53	53	Plazi	ffb07bec-2d10-492d-9c37-361fe0b79427	fac47ab2-e232-4fd1-90fc-f490adfcb9fb
0	5	5	Plazi	ffb07bec-2d10-492d-9c37-361fe0b79427	fecf494b-a277-42aa-b190-b6570ded194b
2925	2925	0	GBIF France	da44cd31-5901-4687-a106-6d1c7734ee3a	06c7cc28-7705-4881-ae8c-37d373b988d2
3	3	0	Plazi	ffb07bec-2d10-492d-9c37-361fe0b79427	0934339b-a512-436e-b2da-d9d262ae132c
3008	3008	0	Atlas of Living Australia	4a6f1b71-969e-4fc5-a693-282b05e1220c	0a6a9256-73be-4f7c-83af-a29db0a222c6
1592	1592	0	GBIF Argentina	2426a871-9feb-40a1-96c6-0c593a76b835	0bfb889b-4875-4f8c-a423-45a4c2d83bb3
4681	4681	0	National Biodiversity Network	d897a5b9-35ee-4232-94bd-b0bcaac003c2	11314af8-aad0-4414-a961-e91b88fd4abb
18694	18694	0	National Biodiversity Network	d897a5b9-35ee-4232-94bd-b0bcaac003c2	1485db6c-a95f-4dc1-b48b-6d58bd129ca7
485	485	0	Taiwan Biodiversity Information Facility	e1b85abc-61f9-430f-ba79-6813dec53a0f	1597d710-98a2-11de-b4da-b8a03c50a862
0	25	25	Plazi	ffb07bec-2d10-492d-9c37-361fe0b79427	15db085c-4e89-4de4-8aa1-6f052fa10318
364003	364003	0	DanBIF - Danish Biodiversity Information Facility	4ddd294f-02b7-4359-ac33-0806a9ca9c6b	172f1923-eff1-4d81-8bd3-6023b2224bcb
0	700	700	Ocean Biodiversity Information System	ba0670b9-4186-41e6-8e70-f9cb3065551a	179e86ce-e2c3-493a-9046-77a4d309db40
1452	1452	0	GBIF Portugal	673f7038-4262-4149-b753-5658a4e912f6	1b4c5921-cba9-4c46-9cfe-9dea3e3e30db
15	15	0	Plazi	ffb07bec-2d10-492d-9c37-361fe0b79427	1de8c3eb-b3bc-40eb-9e86-a9f78a8f2161
2	2	0	Plazi	ffb07bec-2d10-492d-9c37-361fe0b79427	26f0a42d-fada-45ce-a362-9c090a6dfc51
4	4	0	Plazi	ffb07bec-2d10-492d-9c37-361fe0b79427	271f8735-1aa3-4f63-a742-aef356f505e1
46	46	0	Plazi	ffb07bec-2d10-492d-9c37-361fe0b79427	28715dfb-d0e9-4da8-a9a7-6ee9d6ecd150
26154	26154	0	National Biodiversity Network	d897a5b9-35ee-4232-94bd-b0bcaac003c2	289fd9b6-3f70-497b-8505-9ebfc565fa10
965	965	0	GBIF Portugal	673f7038-4262-4149-b753-5658a4e912f6	296407fd-6661-4ac8-afa0-f480d5e1d4de
106513	106513	0	National Biodiversity Network	d897a5b9-35ee-4232-94bd-b0bcaac003c2	29ce88ff-5cf1-47fd-af44-8477c52c910c
20400	25753	5353	Participant Node Managers Committee	7f48e0c8-5c96-49ec-b972-30748e339115	2dda31ff-f776-452f-9a4b-d5229f6e3494
448	448	0	GBIF Germany	4f6826f2-4ff6-443d-b966-e6913bd24013	2ec89f62-a165-4f9f-80ff-ea475845996f
1	1	0	Plazi	ffb07bec-2d10-492d-9c37-361fe0b79427	3029fd16-4e07-46e3-89dc-9701f80d7533
9	9	0	Plazi	ffb07bec-2d10-492d-9c37-361fe0b79427	303765bf-2b25-4f0f-8e34-c1968243e834
0	4	4	Plazi	ffb07bec-2d10-492d-9c37-361fe0b79427	30867afc-5ebd-4c4e-a008-1a7f423b8b81
7	7	0	Participant Node Managers Committee	7f48e0c8-5c96-49ec-b972-30748e339115	31b10f4d-944b-44cd-ae88-4ce5a68c4ee8
0	22	22	Plazi	ffb07bec-2d10-492d-9c37-361fe0b79427	33084500-c877-4f9a-9db2-d9027d58c197
0	1333	1333	GBIF Japan	db5705aa-6a6e-42f1-8942-d77b9f4896ea	33da76ec-65fa-4f06-ac26-691bc8c6f609
0	779	779	GBIF Portugal	673f7038-4262-4149-b753-5658a4e912f6	363fc663-62e4-45c2-ab9e-9cb53351d795
6698	6698	0	GBIF France	da44cd31-5901-4687-a106-6d1c7734ee3a	37e43705-ea27-40b8-b38a-5bc0adf03f6d
0	3291	3291	Colombian Biodiversity Information System	7e865cba-7c46-417b-ade5-97f2cf5b7be0	390c485e-5e4a-4e9e-aae9-ae50a5a98b5f
9	9	0	Plazi	ffb07bec-2d10-492d-9c37-361fe0b79427	3ca9acbb-9081-42c7-880c-5847a55c42a6
0	57	57	Plazi	ffb07bec-2d10-492d-9c37-361fe0b79427	3d028511-6e46-4869-9496-5b8ea23f3702
0	293	293	Participant Node Managers Committee	7f48e0c8-5c96-49ec-b972-30748e339115	3e8022de-bd6e-4368-8b9b-cb21a863a8f2
0	10	10	Plazi	ffb07bec-2d10-492d-9c37-361fe0b79427	3f0509a8-409e-409a-baa7-762255ba61b8
33	33	0	Plazi	ffb07bec-2d10-492d-9c37-361fe0b79427	47813581-d217-4a19-8848-a3e9cf2ddaf4
1125	1406	281	GBIF Estonia	2c11b821-d22b-4c64-8cd3-c1578173b129	4ef3ef22-0b36-44f2-9021-6514732ed247
59	59	0	Plazi	ffb07bec-2d10-492d-9c37-361fe0b79427	4f2bbc27-03f2-46a2-a461-9995a8a5a5fd
0	2	2	Plazi	ffb07bec-2d10-492d-9c37-361fe0b79427	4f71d212-b4ac-448c-b727-ead23daba3cb
1965	1965	0	Society for the Management of Electronic Biodiversity Data	97818ee4-1461-4180-bf1d-b3201050124f	5221e970-757c-43cb-bdd4-2f085bf36ae4
0	32	32	Ocean Biodiversity Information System	ba0670b9-4186-41e6-8e70-f9cb3065551a	5268ceb1-e1cb-4eb2-a47d-0ff74346a84d
0	6	6	Plazi	ffb07bec-2d10-492d-9c37-361fe0b79427	53415ca5-e9cb-4749-a80b-cd748165c458
392	392	0	GBIF France	da44cd31-5901-4687-a106-6d1c7734ee3a	56e1198e-188f-4e30-8196-2abc1a6b01af
17398	19761	2363	U.S. Geological Survey	8618c64a-93e0-4300-b546-7249e5148ed2	596bde6d-0df5-46cb-8eef-92dc3f169ceb
1	1	0	Plazi	ffb07bec-2d10-492d-9c37-361fe0b79427	5cdd6d34-ed86-401a-8a34-ec188643e0a0
10056	10056	0	Biodiversity Information System of Mexico	b324e8e9-9a4c-44fa-8f1a-7f39ea7ab576	5e874d56-5dd9-474b-a02b-e077624f2db2
308	308	0	GBIF Germany	4f6826f2-4ff6-443d-b966-e6913bd24013	61a22378-f762-11e1-a439-00145eb45e9a
1	1	0	Plazi	ffb07bec-2d10-492d-9c37-361fe0b79427	624a98b1-69db-46bf-b287-e5efd712e05b
21	21	0	Plazi	ffb07bec-2d10-492d-9c37-361fe0b79427	62cba2ff-77e1-42fa-b362-17a22409af07
725	736	11	GBIF Germany	4f6826f2-4ff6-443d-b966-e6913bd24013	63035610-b62f-11e2-afcb-00145eb45e9a
69	69	0	GBIF Germany	4f6826f2-4ff6-443d-b966-e6913bd24013	63a8dfe0-f762-11e1-a439-00145eb45e9a
96	96	0	GBIF Germany	4f6826f2-4ff6-443d-b966-e6913bd24013	63be55aa-f762-11e1-a439-00145eb45e9a
39	39	0	GBIF France	da44cd31-5901-4687-a106-6d1c7734ee3a	63d2f49e-1161-4271-83d0-145a13f79936
54	54	0	GBIF Germany	4f6826f2-4ff6-443d-b966-e6913bd24013	640aa9c8-f762-11e1-a439-00145eb45e9a
659	659	0	GBIF Germany	4f6826f2-4ff6-443d-b966-e6913bd24013	6556da36-f762-11e1-a439-00145eb45e9a
1657	1657	0	Biodiversity Information System of Mexico	b324e8e9-9a4c-44fa-8f1a-7f39ea7ab576	67300fcb-1dd9-4823-ac77-418c1d485184
3	3	0	Plazi	ffb07bec-2d10-492d-9c37-361fe0b79427	680cff4f-f249-46bf-a2e4-3987ddff285e
57	57	0	GBIF Germany	4f6826f2-4ff6-443d-b966-e6913bd24013	6821319e-f762-11e1-a439-00145eb45e9a
103	103	0	GBIF Germany	4f6826f2-4ff6-443d-b966-e6913bd24013	68709f9a-f762-11e1-a439-00145eb45e9a
170	170	0	National Biodiversity Network	d897a5b9-35ee-4232-94bd-b0bcaac003c2	69f68599-681c-49b9-bf08-7613331d0323
59	37	-22	GBIF Germany	4f6826f2-4ff6-443d-b966-e6913bd24013	69fad2fe-f762-11e1-a439-00145eb45e9a
237	237	0	GBIF Germany	4f6826f2-4ff6-443d-b966-e6913bd24013	6a079ad4-f762-11e1-a439-00145eb45e9a
348	348	0	National Biodiversity Network	d897a5b9-35ee-4232-94bd-b0bcaac003c2	6cb824fd-7c2e-491b-85c9-156f1c4f9b29
26	26	0	GBIF Germany	4f6826f2-4ff6-443d-b966-e6913bd24013	6cb9c90a-f762-11e1-a439-00145eb45e9a
51	51	0	GBIF Germany	4f6826f2-4ff6-443d-b966-e6913bd24013	6cdccefa-f762-11e1-a439-00145eb45e9a
9	9	0	Plazi	ffb07bec-2d10-492d-9c37-361fe0b79427	6cfac628-b07b-421d-9102-f47c8306fd58
0	3	3	Ocean Biodiversity Information System	ba0670b9-4186-41e6-8e70-f9cb3065551a	6d2f1155-51f9-4584-abcc-30fbd3ec1873
36175	36175	0	Participant Node Managers Committee	7f48e0c8-5c96-49ec-b972-30748e339115	6f40c8ec-2b95-47d5-9064-eda6a8ddf3fb
60	60	0	Plazi	ffb07bec-2d10-492d-9c37-361fe0b79427	711e535f-366e-4764-9420-fb037cdc5e6a
0	3	3	Plazi	ffb07bec-2d10-492d-9c37-361fe0b79427	71409b97-0770-4e5a-bb9c-4d44f65d7e06
288657	288657	0	National Biodiversity Network	d897a5b9-35ee-4232-94bd-b0bcaac003c2	73393ec0-632e-4878-8077-76426fbeb9f1
0	5	5	Plazi	ffb07bec-2d10-492d-9c37-361fe0b79427	737e33ca-4d43-4320-9c3e-e5e942ceb079
7357	7357	0	GBIF Germany	4f6826f2-4ff6-443d-b966-e6913bd24013	74c448b3-65b2-4ea7-b1f2-b3868032642a
15	15	0	GBIF Germany	4f6826f2-4ff6-443d-b966-e6913bd24013	7527d41a-f762-11e1-a439-00145eb45e9a
393	393	0	GBIF Germany	4f6826f2-4ff6-443d-b966-e6913bd24013	759a8528-f762-11e1-a439-00145eb45e9a
0	38	38	Ocean Biodiversity Information System	ba0670b9-4186-41e6-8e70-f9cb3065551a	762d3e3f-5105-448a-bc12-713081212b2a
38	38	0	GBIF Germany	4f6826f2-4ff6-443d-b966-e6913bd24013	777218de-f762-11e1-a439-00145eb45e9a
748	656	-92	GBIF Germany	4f6826f2-4ff6-443d-b966-e6913bd24013	7983ee68-f762-11e1-a439-00145eb45e9a
1129	1129	0	GBIF Japan	db5705aa-6a6e-42f1-8942-d77b9f4896ea	7a574f10-f762-11e1-a439-00145eb45e9a
110	110	0	GBIF Germany	4f6826f2-4ff6-443d-b966-e6913bd24013	7a7d7c80-f762-11e1-a439-00145eb45e9a
5	5	0	Plazi	ffb07bec-2d10-492d-9c37-361fe0b79427	7b947e52-2ba7-40b8-b4b9-fd41c22d5237
102	102	0	GBIF Germany	4f6826f2-4ff6-443d-b966-e6913bd24013	7bffc7a2-f762-11e1-a439-00145eb45e9a
1001	1001	0	GBIF Germany	4f6826f2-4ff6-443d-b966-e6913bd24013	7d65fd8c-f762-11e1-a439-00145eb45e9a
874	874	0	GBIF Germany	4f6826f2-4ff6-443d-b966-e6913bd24013	7d8925a4-200a-4efb-9352-df0969af477c
37	37	0	GBIF Germany	4f6826f2-4ff6-443d-b966-e6913bd24013	7ed1ac5c-f762-11e1-a439-00145eb45e9a
2691	2691	0	U.S. Geological Survey	8618c64a-93e0-4300-b546-7249e5148ed2	7eded672-0e16-4774-bee3-663d8f5f98f0
253310	253310	0	GBIF Portugal	673f7038-4262-4149-b753-5658a4e912f6	7fe3eb5c-42bd-49d7-a30b-82c353ef6575
1	1	0	GBIF Japan	db5705aa-6a6e-42f1-8942-d77b9f4896ea	80de3f56-f762-11e1-a439-00145eb45e9a
4	4	0	GBIF Japan	db5705aa-6a6e-42f1-8942-d77b9f4896ea	810951aa-f762-11e1-a439-00145eb45e9a
17625	17625	0	GBIF Japan	db5705aa-6a6e-42f1-8942-d77b9f4896ea	81275e16-f762-11e1-a439-00145eb45e9a
8085	4725	-3360	GBIF Germany	4f6826f2-4ff6-443d-b966-e6913bd24013	81dcb518-f762-11e1-a439-00145eb45e9a
12327	12327	0	National Biodiversity Network	d897a5b9-35ee-4232-94bd-b0bcaac003c2	8211ef89-8082-4af3-8388-2e75e8265369
23146	23146	0	Canada Biodiversity Information Facility	8f83fc96-c966-4126-83f7-bf044dc49efa	82d21102-f762-11e1-a439-00145eb45e9a
591	591	0	Canada Biodiversity Information Facility	8f83fc96-c966-4126-83f7-bf044dc49efa	84572b02-f762-11e1-a439-00145eb45e9a
17788	17788	0	DanBIF - Danish Biodiversity Information Facility	4ddd294f-02b7-4359-ac33-0806a9ca9c6b	84da8240-f762-11e1-a439-00145eb45e9a
366	366	0	Atlas of Living Australia	4a6f1b71-969e-4fc5-a693-282b05e1220c	8647dc9a-f762-11e1-a439-00145eb45e9a
16786	22786	6000	GBIF Japan	db5705aa-6a6e-42f1-8942-d77b9f4896ea	869e4288-f762-11e1-a439-00145eb45e9a
0	30	30	Plazi	ffb07bec-2d10-492d-9c37-361fe0b79427	880cb736-92eb-42c0-b026-54b62378344f
928	311	-617	GBIF Germany	4f6826f2-4ff6-443d-b966-e6913bd24013	8941c1b8-f762-11e1-a439-00145eb45e9a
0	27867	27867	Belgian Biodiversity Platform	fb11cfe1-ebc3-45af-9159-17d9fddbcdac	8a5cbaec-2839-4471-9e1d-98df301095dd
4	4	0	GBIF Germany	4f6826f2-4ff6-443d-b966-e6913bd24013	8b84ce8e-f762-11e1-a439-00145eb45e9a
646	646	0	Colombian Biodiversity Information System	7e865cba-7c46-417b-ade5-97f2cf5b7be0	8c78c8b9-1d13-404a-a39a-784ef1927540
2365	2365	0	GBIF Brazil	cdc9736d-5ff7-4ece-9959-3c744360cdb3	8cc8f167-d9eb-4b50-905a-34895bb13325
2	2	0	Plazi	ffb07bec-2d10-492d-9c37-361fe0b79427	8d6783eb-cfb7-4a21-beee-187bb7ba97bc
357	357	0	Biodiversity Information System of Mexico	b324e8e9-9a4c-44fa-8f1a-7f39ea7ab576	8db1d1fa-4ae8-4c9c-843b-afa0e9bd398e
700	514	-186	GBIF Germany	4f6826f2-4ff6-443d-b966-e6913bd24013	8e79efa2-f762-11e1-a439-00145eb45e9a
147	147	0	Ocean Biodiversity Information System	ba0670b9-4186-41e6-8e70-f9cb3065551a	8e7c73bf-613d-4c7a-bacc-bf9c92ed760f
14	13	-1	GBIF Germany	4f6826f2-4ff6-443d-b966-e6913bd24013	8faa85f8-f762-11e1-a439-00145eb45e9a
0	14	14	Plazi	ffb07bec-2d10-492d-9c37-361fe0b79427	902e5ff5-977c-4d69-a5b7-b67287bdb23f
137	99	-38	GBIF Germany	4f6826f2-4ff6-443d-b966-e6913bd24013	90433406-f762-11e1-a439-00145eb45e9a
5	4	-1	GBIF Germany	4f6826f2-4ff6-443d-b966-e6913bd24013	9107ba92-f762-11e1-a439-00145eb45e9a
54356	55054	698	GBIF Brazil	cdc9736d-5ff7-4ece-9959-3c744360cdb3	9129ec89-afa7-45af-8b73-509f1f8942ab
48	36	-12	GBIF Germany	4f6826f2-4ff6-443d-b966-e6913bd24013	91e60aa4-f762-11e1-a439-00145eb45e9a
9	8	-1	GBIF Germany	4f6826f2-4ff6-443d-b966-e6913bd24013	9277c87c-f762-11e1-a439-00145eb45e9a
289	289	0	GBIF Germany	4f6826f2-4ff6-443d-b966-e6913bd24013	932f911e-f762-11e1-a439-00145eb45e9a
94	94	0	GBIF Germany	4f6826f2-4ff6-443d-b966-e6913bd24013	95300c82-f762-11e1-a439-00145eb45e9a
1939	1948	9	GBIF Germany	4f6826f2-4ff6-443d-b966-e6913bd24013	954c2e4e-f762-11e1-a439-00145eb45e9a
653	653	0	Netherlands Biodiversity Information Facility	0909d601-bda2-42df-9e63-a6d51847ebce	95e3042f-f48d-4a04-8251-f755bebeced6
0	135	135	GBIF Portugal	673f7038-4262-4149-b753-5658a4e912f6	963a25a6-839c-4bff-9889-97fc8385f564
21261	21261	0	GBIF Switzerland	169eb292-376b-4cc6-8e31-9c2c432de0ad	963de00e-f762-11e1-a439-00145eb45e9a
0	1	1	Plazi	ffb07bec-2d10-492d-9c37-361fe0b79427	9741fd36-1a70-4837-b387-cd9a3da05d96
83	83	0	GBIF France	da44cd31-5901-4687-a106-6d1c7734ee3a	9b3d9909-64ab-4404-9555-7578557edbc0
68746	75428	6682	U.S. Geological Survey	8618c64a-93e0-4300-b546-7249e5148ed2	9be3b97c-bc8c-490c-8021-dc7c75408076
11	31	20	Plazi	ffb07bec-2d10-492d-9c37-361fe0b79427	9c8d5683-76c1-4938-aede-b7ad5391b6b2
65	65	0	Colombian Biodiversity Information System	7e865cba-7c46-417b-ade5-97f2cf5b7be0	9d022797-7aa4-40f4-9070-6688bc6adf14
111	111	0	GBIF France	da44cd31-5901-4687-a106-6d1c7734ee3a	a1d39ae3-63bb-4183-a1b5-28e2358c1191
0	16	16	Plazi	ffb07bec-2d10-492d-9c37-361fe0b79427	a5dbdb8c-cd93-4473-a877-7fa75fe3de7b
1479	1479	0	GBIF Spain	1f94b3ca-9345-4d65-afe2-4bace93aa0fe	ac3508f8-6b4f-4680-9df7-3f4210abd7ef
36657	36657	0	Chinese Academy of Sciences	e760dc6f-dd68-474d-ab41-bd3588571793	af7d2594-6d4e-47e9-9f30-b7ebb3110f7b
0	1	1	Plazi	ffb07bec-2d10-492d-9c37-361fe0b79427	b08076dd-5f59-4436-838c-5c9ceb7c84e4
55	55	0	National Biodiversity Network	d897a5b9-35ee-4232-94bd-b0bcaac003c2	b19a2611-fd69-44fa-be86-ccfb945d7294
250	250	0	Atlas of Living Australia	4a6f1b71-969e-4fc5-a693-282b05e1220c	b6455ad6-a663-4047-8f9c-02dd5ab61ea6
31	31	0	Plazi	ffb07bec-2d10-492d-9c37-361fe0b79427	b67114df-ddee-49d9-a264-a3c20bded320
226	226	0	National Biodiversity Network	d897a5b9-35ee-4232-94bd-b0bcaac003c2	b87b2913-b9ad-4ec5-8272-0978994acce4
27	27	0	Plazi	ffb07bec-2d10-492d-9c37-361fe0b79427	bb7c32d5-a504-498b-bf8a-e458550a8782
6	6	0	Plazi	ffb07bec-2d10-492d-9c37-361fe0b79427	bc734cb4-fc74-4e84-82a7-715d00735b7a
1353	1353	0	National Biodiversity Data Centre	422b00b2-6c94-4bb6-976b-c359916efdb8	be6e251d-cdf4-4784-8054-9f4be19ce3d9
174	174	0	GBIF France	da44cd31-5901-4687-a106-6d1c7734ee3a	becd9b3a-f280-4175-b66e-599a1de2cb67
3	3	0	Plazi	ffb07bec-2d10-492d-9c37-361fe0b79427	bf2ccc12-55ee-438a-a34b-90882d3e4e34
5406	5406	0	GBIF Argentina	2426a871-9feb-40a1-96c6-0c593a76b835	c0dbd91f-ca35-42bd-94ab-2c7419d7b2c6
7	7	0	GBIF France	da44cd31-5901-4687-a106-6d1c7734ee3a	c20a769a-1788-4a65-8922-2af0a12b9e0a
5420	5420	0	GBIF France	da44cd31-5901-4687-a106-6d1c7734ee3a	c401bd5e-ad81-4de4-8473-8b705c922562
61	61	0	Plazi	ffb07bec-2d10-492d-9c37-361fe0b79427	c4072224-34c3-4b12-9415-a59d7c9484b6
18	18	0	GBIF Sweden	a0b3be64-6525-4387-ac67-a499950f92e1	c5ef4e20-62a1-46c9-b398-b5cbe39771d1
123	123	0	Participant Node Managers Committee	7f48e0c8-5c96-49ec-b972-30748e339115	c78a3da3-439d-4e92-aea8-57e1a250bb46
924700	924700	0	National Biodiversity Network	d897a5b9-35ee-4232-94bd-b0bcaac003c2	cd6e21c8-9e8a-493a-8a76-fbf7862069e5
14579	16497	1918	Belgian Biodiversity Platform	fb11cfe1-ebc3-45af-9159-17d9fddbcdac	cdc76698-d92d-4a0b-b8d5-04ba3b22defd
0	13742	13742	Participant Node Managers Committee	7f48e0c8-5c96-49ec-b972-30748e339115	d2875a50-0304-469d-b19e-78dc08007931
181	181	0	Plazi	ffb07bec-2d10-492d-9c37-361fe0b79427	d4c93468-24c8-4e71-8992-e4e1aad3f674
62427	62427	0	National Biodiversity Network	d897a5b9-35ee-4232-94bd-b0bcaac003c2	d575bb70-0830-43b6-8974-6f25529fc26f
0	58	58	Plazi	ffb07bec-2d10-492d-9c37-361fe0b79427	d7238c35-357f-4920-a5a4-2c89c82c85f9
3	3	0	Plazi	ffb07bec-2d10-492d-9c37-361fe0b79427	d955552b-d666-468b-904e-f8830baba1fd
10	10	0	Plazi	ffb07bec-2d10-492d-9c37-361fe0b79427	da55c113-c729-427c-81c9-ec2866160d62
7961	7961	0	National Biodiversity Network	d897a5b9-35ee-4232-94bd-b0bcaac003c2	e0965074-67c1-46c0-9360-f8e4f98867b1
66	66	0	Plazi	ffb07bec-2d10-492d-9c37-361fe0b79427	e0970aec-3eb5-4b39-a85f-2b23900cd153
6645	6645	0	National Biodiversity Data Centre	422b00b2-6c94-4bb6-976b-c359916efdb8	ebabb49d-8838-4097-ac73-3895ec3161c5
0	12	12	Plazi	ffb07bec-2d10-492d-9c37-361fe0b79427	ec2bd4d1-7689-41b0-82d7-c96327cef478
32236	32236	0	Polish Biodiversity Information Network	2618bfdf-e194-4911-a241-80db3107bc51	eca72f80-3330-11de-8db7-b8a03c50a862
0	3	3	Ocean Biodiversity Information System	ba0670b9-4186-41e6-8e70-f9cb3065551a	f297b7fe-bb2c-4d88-bb3c-101bbf7ca8d1
2	2	0	Plazi	ffb07bec-2d10-492d-9c37-361fe0b79427	f3b69bf6-f514-486a-ba89-4d7678090239
0	34	34	Plazi	ffb07bec-2d10-492d-9c37-361fe0b79427	f4cb3f8a-03a4-4173-acef-e13274ef48ad
104	104	0	GBIF Brazil	cdc9736d-5ff7-4ece-9959-3c744360cdb3	f9e9c4eb-9c7d-427a-9d78-9a05538db2ba
0	3	3	Plazi	ffb07bec-2d10-492d-9c37-361fe0b79427	fd069d4d-bfe7-4696-bd5c-6edd19bd00dd
0	2657	2657	Colombian Biodiversity Information System	7e865cba-7c46-417b-ade5-97f2cf5b7be0	fd518602-8e94-454d-aeea-5e93d203b8af
0	142	142	Ocean Biodiversity Information System	ba0670b9-4186-41e6-8e70-f9cb3065551a	fdbb52e3-573c-49a8-b522-d78c8b0f6872
210	210	0	GBIF Germany	4f6826f2-4ff6-443d-b966-e6913bd24013	feb785c7-a296-4b28-9491-29e51e6465b2
51	51	0	GBIF France	da44cd31-5901-4687-a106-6d1c7734ee3a	ff2c4ada-3a17-42a1-acfd-5785373ad4a4
0	50	50	Plazi	ffb07bec-2d10-492d-9c37-361fe0b79427	0627f17d-d68b-4905-ac5f-f04fd49570c3
12565129	12354427	-210702	Atlas of Living Australia	4a6f1b71-969e-4fc5-a693-282b05e1220c	0645ccdb-e001-4ab0-9729-51f1755e007e
4	4	0	Colombian Biodiversity Information System	7e865cba-7c46-417b-ade5-97f2cf5b7be0	078abddb-e053-447c-a59a-64decdf85899
2	2	0	Plazi	ffb07bec-2d10-492d-9c37-361fe0b79427	085040a1-1453-4ce3-8d67-48da1f451b85
0	73	73	Plazi	ffb07bec-2d10-492d-9c37-361fe0b79427	086b1f35-7629-458d-84fc-cad50c34e236
252	252	0	National Biodiversity Network	d897a5b9-35ee-4232-94bd-b0bcaac003c2	0abaf978-6842-4945-8da9-c431aa5c3fcc
667	667	0	Canadensys	4db9cfd2-1191-4b9d-b579-0b68ceabd968	0b8c3b99-1126-45b0-94bc-1abefbcff273
6	6	0	Plazi	ffb07bec-2d10-492d-9c37-361fe0b79427	0ff3b724-fbb2-458f-a55b-d28910952a66
60510	60510	0	Atlas of Living Australia	4a6f1b71-969e-4fc5-a693-282b05e1220c	1084c169-c39a-4749-94aa-32159777d828
1056	1056	0	Ocean Biodiversity Information System	ba0670b9-4186-41e6-8e70-f9cb3065551a	1133cad4-e60c-4d60-8c01-fccd29a5d384
13	13	0	Plazi	ffb07bec-2d10-492d-9c37-361fe0b79427	1278cc52-0468-44fe-98fc-7453d6092c7c
0	195	195	Plazi	ffb07bec-2d10-492d-9c37-361fe0b79427	14855a29-30cf-4dd0-b6e9-519c0e817d68
336	88	-248	GBIF Germany	4f6826f2-4ff6-443d-b966-e6913bd24013	15093642-5f8d-435f-ac13-4c485e9c1e96
59	59	0	Colombian Biodiversity Information System	7e865cba-7c46-417b-ade5-97f2cf5b7be0	154ae7d4-44e3-4016-9620-9018e83ee85b
580	580	0	GBIF France	da44cd31-5901-4687-a106-6d1c7734ee3a	157e7669-3074-4446-bc67-8829d483d25b
0	258	258	Colombian Biodiversity Information System	7e865cba-7c46-417b-ade5-97f2cf5b7be0	1641e2af-0532-4a7b-b300-3177a0a4a65d
0	14	14	Plazi	ffb07bec-2d10-492d-9c37-361fe0b79427	164a0cbc-f72c-47ea-9179-b19ebd10a5b4
0	1374	1374	Atlas of Living Australia	4a6f1b71-969e-4fc5-a693-282b05e1220c	1a87c0c3-57be-4d31-b13a-a86c6cba98d3
0	230	230	Biodiversity Information System of Mexico	b324e8e9-9a4c-44fa-8f1a-7f39ea7ab576	1fe44b74-b1e3-46df-83c1-99ad22bdd97b
26	26	0	Plazi	ffb07bec-2d10-492d-9c37-361fe0b79427	22169f39-80e9-4958-8d3e-cebf1868f452
85	85	0	Plazi	ffb07bec-2d10-492d-9c37-361fe0b79427	2647dc6d-1d7d-46c2-b8f7-0616241c6b44
798	798	0	GBIF Brazil	cdc9736d-5ff7-4ece-9959-3c744360cdb3	26e2dd6e-e6bf-4560-8caa-f29e3a5df6f3
255092	255092	0	Canada Biodiversity Information Facility	8f83fc96-c966-4126-83f7-bf044dc49efa	275319e1-f91c-406f-b239-62cb9d4185cb
27224	27389	165	U.S. Geological Survey	8618c64a-93e0-4300-b546-7249e5148ed2	297ecc07-da20-4ebf-9f41-4f80330b4b33
11	11	0	Plazi	ffb07bec-2d10-492d-9c37-361fe0b79427	29a71195-6181-41da-b3df-8fdcba4f3cd7
7	7	0	Plazi	ffb07bec-2d10-492d-9c37-361fe0b79427	2e8b5af7-a7c0-4b2f-a02b-936e9a8584fa
310	310	0	GBIF Norway	4f829580-180d-46a9-9c87-ed8ec959b545	2eb9c40b-4516-418f-a6d5-d019098d217e
0	1036	1036	Belgian Biodiversity Platform	fb11cfe1-ebc3-45af-9159-17d9fddbcdac	30ae587e-eb14-4bd4-868d-61fb59885b12
27	27	0	Colombian Biodiversity Information System	7e865cba-7c46-417b-ade5-97f2cf5b7be0	30c5dca1-99c5-4f9b-8b18-7620560938a1
0	2	2	Plazi	ffb07bec-2d10-492d-9c37-361fe0b79427	317ca6e5-f638-41dd-a402-596cc01e23ab
7	7	0	GBIF Brazil	cdc9736d-5ff7-4ece-9959-3c744360cdb3	323140e2-5f61-4aac-8817-2d4a4554f0c6
3	3	0	Plazi	ffb07bec-2d10-492d-9c37-361fe0b79427	32674c7b-0e71-4a31-877b-19b8398cf62a
4	4	0	Plazi	ffb07bec-2d10-492d-9c37-361fe0b79427	33d3c80d-ac66-4196-9653-cc74045cdae1
13	13	0	Plazi	ffb07bec-2d10-492d-9c37-361fe0b79427	346009f4-8587-4e43-bc9d-abbef21910fe
0	27	27	Plazi	ffb07bec-2d10-492d-9c37-361fe0b79427	354f246a-4138-4116-966f-d4db99749c31
1	1	0	Plazi	ffb07bec-2d10-492d-9c37-361fe0b79427	360b2666-767a-4a93-846d-fbb5e107c3f3
0	8161358	8161358	National Biodiversity Network	d897a5b9-35ee-4232-94bd-b0bcaac003c2	36555a0c-8361-42c4-9f78-805816266f2e
0	1	1	Plazi	ffb07bec-2d10-492d-9c37-361fe0b79427	36ca09b9-901c-4ae7-8dd3-176732084282
4	4	0	Plazi	ffb07bec-2d10-492d-9c37-361fe0b79427	3d5828a9-6095-4e3d-b4d7-5a1e9542bcda
33	33	0	Plazi	ffb07bec-2d10-492d-9c37-361fe0b79427	412cbaf4-4381-4538-bd37-9e0672f2fc6c
8	8	0	Plazi	ffb07bec-2d10-492d-9c37-361fe0b79427	41d9ff23-1bbd-426a-94dd-af487da76059
0	1	1	Plazi	ffb07bec-2d10-492d-9c37-361fe0b79427	4230f888-1e02-4af9-af99-7ac1a909a647
7	7	0	GBIF Germany	4f6826f2-4ff6-443d-b966-e6913bd24013	431441d8-3a0c-11e2-b0ce-00145eb45e9a
0	11273	11273	GBIF Benin	efb9c00e-f802-45dd-8826-a52ec45b89ff	436c8c67-f230-4b05-9f11-08b2bc098ec9
66671	66671	0	Atlas of Living Australia	4a6f1b71-969e-4fc5-a693-282b05e1220c	456619c2-c56e-4d4b-86df-ddc80750bda8
875	218	-657	GBIF Germany	4f6826f2-4ff6-443d-b966-e6913bd24013	4722766d-8000-49bb-a0a4-a5c10eebdadb
4	4	0	Plazi	ffb07bec-2d10-492d-9c37-361fe0b79427	49beaa35-b426-43bc-84c4-a1df1f05246e
25	25	0	Plazi	ffb07bec-2d10-492d-9c37-361fe0b79427	4b84979a-e3de-4956-b9c7-91e178dd46b1
266	266	0	GBIF Finland	dd514216-5c7c-45f3-910d-797424cb5be6	4b8c707f-d006-45a6-be88-c584ec90ee66
8848	8848	0	GBIF Portugal	673f7038-4262-4149-b753-5658a4e912f6	4bddb917-faa3-4d4f-a29b-4f5ba5b8512a
13	13	0	GBIF Malawi	2a42e4d7-ad4a-41b3-84c4-de4aa7b74d35	4c42a3cc-b7f3-42b9-a4af-6535b3e75bbd
0	4	4	Plazi	ffb07bec-2d10-492d-9c37-361fe0b79427	4cc7222a-42c6-4e4b-a2c4-4e0cf9eba1b8
107792	107792	0	Canada Biodiversity Information Facility	8f83fc96-c966-4126-83f7-bf044dc49efa	4e5552d1-5eaf-40a3-b48b-01f92da22f17
0	6	6	Plazi	ffb07bec-2d10-492d-9c37-361fe0b79427	4fae0731-7c2c-42e6-8246-74b1b8b06ff3
0	4	4	Plazi	ffb07bec-2d10-492d-9c37-361fe0b79427	5089de7d-198f-4cbe-a6d4-1b269a9a1736
993	993	0	GBIF Germany	4f6826f2-4ff6-443d-b966-e6913bd24013	526dd73a-2552-4f3f-824f-82653555407c
19	19	0	Plazi	ffb07bec-2d10-492d-9c37-361fe0b79427	55b8b573-dbb6-46d2-a514-8e6cf2e69b30
30345	30699	354	U.S. Geological Survey	8618c64a-93e0-4300-b546-7249e5148ed2	5a6977c1-ece6-44b8-b71d-43cb1d4e0919
3575	3575	0	GBIF France	da44cd31-5901-4687-a106-6d1c7734ee3a	5b9da4e8-bb56-4689-b670-0105cf050fcd
1	1	0	Plazi	ffb07bec-2d10-492d-9c37-361fe0b79427	5c6be4fd-4abc-4289-a32d-81abc21a11a5
19	19	0	GBIF France	da44cd31-5901-4687-a106-6d1c7734ee3a	5cdc3b69-50ef-41e4-a1e8-c29d8f815f7f
92822	92822	0	Canada Biodiversity Information Facility	8f83fc96-c966-4126-83f7-bf044dc49efa	61bf28a5-29e5-4a58-86d7-3e7ed74ec048
70	70	0	GBIF Germany	4f6826f2-4ff6-443d-b966-e6913bd24013	6232fd76-f762-11e1-a439-00145eb45e9a
0	25	25	Plazi	ffb07bec-2d10-492d-9c37-361fe0b79427	632316a9-f916-4a28-874a-d4b519438cce
44	44	0	Plazi	ffb07bec-2d10-492d-9c37-361fe0b79427	64c1a738-381b-4ba2-bc35-317d756e6a29
441	441	0	GBIF Germany	4f6826f2-4ff6-443d-b966-e6913bd24013	64f3363e-f762-11e1-a439-00145eb45e9a
1082	1082	0	GBIF Germany	4f6826f2-4ff6-443d-b966-e6913bd24013	65339e28-add7-11e2-8fbc-00145eb45e9a
995	969	-26	GBIF Germany	4f6826f2-4ff6-443d-b966-e6913bd24013	654006bc-f762-11e1-a439-00145eb45e9a
65	62	-3	GBIF Germany	4f6826f2-4ff6-443d-b966-e6913bd24013	65859d9e-f762-11e1-a439-00145eb45e9a
215	215	0	GBIF Germany	4f6826f2-4ff6-443d-b966-e6913bd24013	664283aa-f762-11e1-a439-00145eb45e9a
20	20	0	GBIF Germany	4f6826f2-4ff6-443d-b966-e6913bd24013	6676a9a0-f762-11e1-a439-00145eb45e9a
126	126	0	GBIF Germany	4f6826f2-4ff6-443d-b966-e6913bd24013	6734f144-f762-11e1-a439-00145eb45e9a
7	7	0	Plazi	ffb07bec-2d10-492d-9c37-361fe0b79427	679f5107-e0b4-4e9d-b0cb-0bca5d83e2ff
38	38	0	GBIF France	da44cd31-5901-4687-a106-6d1c7734ee3a	68436cbb-da76-4d53-9f46-b8d69b5fef9a
47	47	0	GBIF Germany	4f6826f2-4ff6-443d-b966-e6913bd24013	68b2d658-f762-11e1-a439-00145eb45e9a
350	233	-117	GBIF Germany	4f6826f2-4ff6-443d-b966-e6913bd24013	69480304-f762-11e1-a439-00145eb45e9a
102	102	0	GBIF Germany	4f6826f2-4ff6-443d-b966-e6913bd24013	6984735c-f762-11e1-a439-00145eb45e9a
202	202	0	Belgian Biodiversity Platform	fb11cfe1-ebc3-45af-9159-17d9fddbcdac	6ab7c956-21c6-4dc1-a155-e1b22f2f419b
5	5	0	Plazi	ffb07bec-2d10-492d-9c37-361fe0b79427	6c08048c-feef-4a05-866b-8c90b301fed1
2157	2157	0	Observation International	ad048418-7cd8-4070-a151-fe1c1f303129	6ec63232-a552-4c8d-9932-5caecefdace4
196	196	0	GBIF France	da44cd31-5901-4687-a106-6d1c7734ee3a	6f7b53e4-73bb-4c16-8ca8-554a78f47dee
14	14	0	GBIF Germany	4f6826f2-4ff6-443d-b966-e6913bd24013	6fe85a56-f762-11e1-a439-00145eb45e9a
1280	1280	0	GBIF France	da44cd31-5901-4687-a106-6d1c7734ee3a	7154d3a7-371d-43f4-a342-ea5ad84837af
51	51	0	GBIF Germany	4f6826f2-4ff6-443d-b966-e6913bd24013	71b39dc8-f762-11e1-a439-00145eb45e9a
48	32	-16	GBIF Germany	4f6826f2-4ff6-443d-b966-e6913bd24013	723041fc-f762-11e1-a439-00145eb45e9a
221	221	0	Plazi	ffb07bec-2d10-492d-9c37-361fe0b79427	72477336-5f60-4526-898b-57fddd2a60e2
0	2	2	Plazi	ffb07bec-2d10-492d-9c37-361fe0b79427	72d30546-2881-4346-9550-26c73b7ad474
32	32	0	GBIF Germany	4f6826f2-4ff6-443d-b966-e6913bd24013	72d38cc2-f762-11e1-a439-00145eb45e9a
19	19	0	GBIF Madagascar	2dbfc5c5-51b5-4494-9dfc-4d3f013a3b64	740ef63e-f9ab-43a6-a6f5-af0c8c2700e0
81	81	0	GBIF Germany	4f6826f2-4ff6-443d-b966-e6913bd24013	741aaade-f762-11e1-a439-00145eb45e9a
3722	3722	0	GBIF Brazil	cdc9736d-5ff7-4ece-9959-3c744360cdb3	7683d8bd-359c-4055-9e44-1d81ae0253fe
25	25	0	GBIF Germany	4f6826f2-4ff6-443d-b966-e6913bd24013	77736a2c-f762-11e1-a439-00145eb45e9a
64	64	0	GBIF Germany	4f6826f2-4ff6-443d-b966-e6913bd24013	77f42cee-02ea-4a4b-aab8-b73af985eb01
4	4	0	GBIF Germany	4f6826f2-4ff6-443d-b966-e6913bd24013	78806afa-f762-11e1-a439-00145eb45e9a
20	20	0	Plazi	ffb07bec-2d10-492d-9c37-361fe0b79427	7a1afb26-e06c-43fc-bc68-fff2a45859c0
609	609	0	GBIF France	da44cd31-5901-4687-a106-6d1c7734ee3a	7b49b6a9-a2bc-44ba-a6e9-8653521036a0
200	200	0	GBIF Germany	4f6826f2-4ff6-443d-b966-e6913bd24013	7bbadb56-f762-11e1-a439-00145eb45e9a
78	78	0	Plazi	ffb07bec-2d10-492d-9c37-361fe0b79427	7c4524ba-bd3a-4f71-84b8-2285ff4c0916
396	324	-72	GBIF Germany	4f6826f2-4ff6-443d-b966-e6913bd24013	7c65a162-f762-11e1-a439-00145eb45e9a
5	5	0	Plazi	ffb07bec-2d10-492d-9c37-361fe0b79427	7e1b65df-50d8-41a6-8248-8738a3ff3a02
16604	16604	0	GBIF Spain	1f94b3ca-9345-4d65-afe2-4bace93aa0fe	7e31baf8-f762-11e1-a439-00145eb45e9a
2171	671	-1500	GBIF Germany	4f6826f2-4ff6-443d-b966-e6913bd24013	7efaced4-f762-11e1-a439-00145eb45e9a
876	624	-252	Biodiversity Information System of Mexico	b324e8e9-9a4c-44fa-8f1a-7f39ea7ab576	7fb5c784-f762-11e1-a439-00145eb45e9a
318	318	0	Netherlands Biodiversity Information Facility	0909d601-bda2-42df-9e63-a6d51847ebce	806df471-8b78-4166-a186-ba07c7c957ec
252	252	0	Colombian Biodiversity Information System	7e865cba-7c46-417b-ade5-97f2cf5b7be0	80702d10-eaef-45e1-9419-ca3df36ec86f
9271	9271	0	Atlas of Living Australia	4a6f1b71-969e-4fc5-a693-282b05e1220c	82ec8f46-f762-11e1-a439-00145eb45e9a
4919	4919	0	GBIF France	da44cd31-5901-4687-a106-6d1c7734ee3a	85a97a5f-751a-49ca-ad7d-238a80c0d30c
641	641	0	Atlas of Living Australia	4a6f1b71-969e-4fc5-a693-282b05e1220c	87f387c3-cebd-43dc-9f88-c0ffab09766f
32	32	0	Plazi	ffb07bec-2d10-492d-9c37-361fe0b79427	8874d4e3-3222-4abc-801d-d8c53429c7f8
1760	1760	0	Participant Node Managers Committee	7f48e0c8-5c96-49ec-b972-30748e339115	891af376-b9b7-4547-b17d-e1d2e6b8d96b
11	11	0	Plazi	ffb07bec-2d10-492d-9c37-361fe0b79427	892554a9-032d-4aee-a5d1-da1a46043dfa
32	32	0	Plazi	ffb07bec-2d10-492d-9c37-361fe0b79427	89ad98bf-c070-4f7d-8b85-fa67a52f0996
1587	1587	0	GBIF Germany	4f6826f2-4ff6-443d-b966-e6913bd24013	89e0691c-f762-11e1-a439-00145eb45e9a
4	4	0	GBIF Germany	4f6826f2-4ff6-443d-b966-e6913bd24013	8b899f0e-f762-11e1-a439-00145eb45e9a
241	241	0	GBIF Germany	4f6826f2-4ff6-443d-b966-e6913bd24013	8beb9c4a-f762-11e1-a439-00145eb45e9a
10	10	0	GBIF Germany	4f6826f2-4ff6-443d-b966-e6913bd24013	8c18ab40-f762-11e1-a439-00145eb45e9a
21	21	0	GBIF Germany	4f6826f2-4ff6-443d-b966-e6913bd24013	8c550310-f762-11e1-a439-00145eb45e9a
61	58	-3	GBIF Germany	4f6826f2-4ff6-443d-b966-e6913bd24013	8cc7f988-f762-11e1-a439-00145eb45e9a
572	572	0	GBIF Germany	4f6826f2-4ff6-443d-b966-e6913bd24013	91fc3fd6-f762-11e1-a439-00145eb45e9a
12102	12313	211	GBIF Brazil	cdc9736d-5ff7-4ece-9959-3c744360cdb3	93145a4c-b47e-438e-9177-5e7e42895823
6	6	0	GBIF Germany	4f6826f2-4ff6-443d-b966-e6913bd24013	9579eaa0-f762-11e1-a439-00145eb45e9a
38004	38004	0	GBIF Japan	db5705aa-6a6e-42f1-8942-d77b9f4896ea	9603ec46-f762-11e1-a439-00145eb45e9a
32561	32561	0	National Biodiversity Network	d897a5b9-35ee-4232-94bd-b0bcaac003c2	965169e4-f762-11e1-a439-00145eb45e9a
2618	2618	0	Biodiversity Information System of Mexico	b324e8e9-9a4c-44fa-8f1a-7f39ea7ab576	96adf006-f762-11e1-a439-00145eb45e9a
3439	3439	0	Biodiversity Information System of Mexico	b324e8e9-9a4c-44fa-8f1a-7f39ea7ab576	96af2dd6-f762-11e1-a439-00145eb45e9a
0	5	5	Plazi	ffb07bec-2d10-492d-9c37-361fe0b79427	9721e940-30f7-4173-bed6-75e381da44d8
0	32	32	Plazi	ffb07bec-2d10-492d-9c37-361fe0b79427	9a86aaf2-edfc-4134-8581-34a1afa16b48
874	874	0	Biodiversity Information System of Mexico	b324e8e9-9a4c-44fa-8f1a-7f39ea7ab576	9b495024-aa9e-4ac5-a33a-d589f4d7ce81
3358	3358	0	Biodiversity Information System of Mexico	b324e8e9-9a4c-44fa-8f1a-7f39ea7ab576	9c41cbeb-e8d5-4c25-a3d1-a82972b61391
2	2	0	Plazi	ffb07bec-2d10-492d-9c37-361fe0b79427	9cf72b53-5262-443b-a06c-a630d3cee1be
5	5	0	Plazi	ffb07bec-2d10-492d-9c37-361fe0b79427	9dedc1eb-775b-4c1e-9b6d-aa136be7cf7e
2109	2109	0	National Biodiversity Data Centre	422b00b2-6c94-4bb6-976b-c359916efdb8	a14a8920-c7b8-11de-b279-8cf3c22b2ff2
2	2	0	Plazi	ffb07bec-2d10-492d-9c37-361fe0b79427	a34f4a4a-d0b1-4467-ac30-4c080def443c
2287	2287	0	GBIF Spain	1f94b3ca-9345-4d65-afe2-4bace93aa0fe	a4442622-3162-4b2e-b47b-29828f7bb853
0	665	665	Colombian Biodiversity Information System	7e865cba-7c46-417b-ade5-97f2cf5b7be0	a4ec6a92-c24f-4e55-98d8-96b45121ae38
0	3	3	Plazi	ffb07bec-2d10-492d-9c37-361fe0b79427	a5b1aa19-4c23-4c40-ba42-288737a62004
376	376	0	Atlas of Living Australia	4a6f1b71-969e-4fc5-a693-282b05e1220c	a5ceb80a-02ac-4904-b182-6e0bd3cd9fa9
0	459854	459854	GBIF Switzerland	169eb292-376b-4cc6-8e31-9c2c432de0ad	aa5a1c3c-2fd1-40eb-9845-95b96dfb5bd2
114	114	0	Participant Node Managers Committee	7f48e0c8-5c96-49ec-b972-30748e339115	ad835740-09c4-4444-a27e-d067617c5c22
152	122	-30	GBIF Germany	4f6826f2-4ff6-443d-b966-e6913bd24013	af60e4a0-6f58-4294-a81f-098c1147ad8b
0	5	5	Plazi	ffb07bec-2d10-492d-9c37-361fe0b79427	b1d0ab65-82d6-48b8-a0b5-6538bb0ca779
38	38	0	Plazi	ffb07bec-2d10-492d-9c37-361fe0b79427	b29d1ff4-40ea-4de8-bb3b-9e63bd717d27
1286	1286	0	GBIF France	da44cd31-5901-4687-a106-6d1c7734ee3a	b2ac8447-a776-471c-9a70-1d6d609c4a3e
226	226	0	National Biodiversity Network	d897a5b9-35ee-4232-94bd-b0bcaac003c2	b58ce527-9d44-4907-9f27-f6526f9a26fb
12506	12506	0	U.S. Geological Survey	8618c64a-93e0-4300-b546-7249e5148ed2	bea28c6b-4282-4e0e-894d-7c65d050ffa9
43066	43066	0	GBIF Spain	1f94b3ca-9345-4d65-afe2-4bace93aa0fe	bf1f0776-7aad-4db1-83f8-1d988514e86a
3971	3971	0	GBIF France	da44cd31-5901-4687-a106-6d1c7734ee3a	bfb47005-1157-41af-a0f5-12ed643e81f5
706679	706679	0	GBIF Sweden	a0b3be64-6525-4387-ac67-a499950f92e1	c1a13bf0-0c71-11dd-84d4-b8a03c50a862
7	7	0	Plazi	ffb07bec-2d10-492d-9c37-361fe0b79427	c38de8c6-ca80-4229-b1b9-cc274f1bf1d0
813	813	0	Canada Biodiversity Information Facility	8f83fc96-c966-4126-83f7-bf044dc49efa	c84310f0-a629-47ff-96b5-51373acdfdcc
222	222	0	Colombian Biodiversity Information System	7e865cba-7c46-417b-ade5-97f2cf5b7be0	ca7efba5-63c2-46bb-8b4c-7ab2e74d13f0
29	29	0	Plazi	ffb07bec-2d10-492d-9c37-361fe0b79427	cb7585af-33bc-4b5e-a748-cbba9d080a34
133	133	0	GBIF France	da44cd31-5901-4687-a106-6d1c7734ee3a	cbc00f84-664c-4695-91ce-fccb93e5d3ee
4923	4923	0	GBIF France	da44cd31-5901-4687-a106-6d1c7734ee3a	d066e3e0-0455-4724-bd4f-e4516a406957
4555	4555	0	Canada Biodiversity Information Facility	8f83fc96-c966-4126-83f7-bf044dc49efa	d3aa0bbe-b7f7-47fc-bd82-952c7cb24355
0	45	45	Plazi	ffb07bec-2d10-492d-9c37-361fe0b79427	d54724ea-8a90-466d-8af2-91dfdf89190b
1261906	1261906	0	National Biodiversity Network	d897a5b9-35ee-4232-94bd-b0bcaac003c2	d56e1889-ab4e-4637-8446-558579902075
3	3	0	Participant Node Managers Committee	7f48e0c8-5c96-49ec-b972-30748e339115	d5a08d01-4ac6-435e-8056-eb7e82a498b3
23	23	0	GBIF France	da44cd31-5901-4687-a106-6d1c7734ee3a	d8dff96c-d98a-48a0-a5c9-1f95447beba0
1075	1075	0	GBIF France	da44cd31-5901-4687-a106-6d1c7734ee3a	d9294fdb-1100-4ff8-935f-d64c182fe7ac
223718	223718	0	GBIF France	da44cd31-5901-4687-a106-6d1c7734ee3a	da216795-b3ad-41c2-ac4e-3d8faf4743d2
5	5	0	Plazi	ffb07bec-2d10-492d-9c37-361fe0b79427	db165956-43bc-4a36-bc9e-266d6b721561
2	2	0	Plazi	ffb07bec-2d10-492d-9c37-361fe0b79427	dbcb95c1-89d0-4b7f-b773-4e1ae11b0f4e
0	23289	23289	Ocean Biodiversity Information System	ba0670b9-4186-41e6-8e70-f9cb3065551a	df2c00e9-93e3-4ffb-9a33-d1a8e692138c
71	71	0	Participant Node Managers Committee	7f48e0c8-5c96-49ec-b972-30748e339115	e1e131bc-b21e-4427-b59c-bd9f5ff8faae
3637	3637	0	GBIF Finland	dd514216-5c7c-45f3-910d-797424cb5be6	e2032ac4-b998-47ea-a30a-2608e6a7f7f5
24	24	0	Plazi	ffb07bec-2d10-492d-9c37-361fe0b79427	e31270aa-00c1-49fc-b98b-d09a9d6ae35e
3681	3791	110	Taiwan Biodiversity Information Facility	e1b85abc-61f9-430f-ba79-6813dec53a0f	e355bd5a-8ed9-4498-9bb6-4b0dcbdc5d09
11637	11637	0	Belgian Biodiversity Platform	fb11cfe1-ebc3-45af-9159-17d9fddbcdac	ea95fd9b-58dc-4e48-b51f-9380e9804607
7374	7868	494	GBIF Brazil	cdc9736d-5ff7-4ece-9959-3c744360cdb3	ead9eb73-a012-4206-976a-c911ef4fc956
26161	26474	313	GBIF Brazil	cdc9736d-5ff7-4ece-9959-3c744360cdb3	ed8e1590-62b5-48a8-8654-4ecc13554f57
5860	5860	0	Belgian Biodiversity Platform	fb11cfe1-ebc3-45af-9159-17d9fddbcdac	f4230399-51b8-4862-8991-93d6ba11406f
279	279	0	GBIF France	da44cd31-5901-4687-a106-6d1c7734ee3a	f9008b85-3067-4ab6-8156-6cba3076a842
1020	1020	0	Colombian Biodiversity Information System	7e865cba-7c46-417b-ade5-97f2cf5b7be0	f91c043a-2a56-4e6e-87b6-2b71a4881fb6
36280	36280	0	GBIF Portugal	673f7038-4262-4149-b753-5658a4e912f6	fa9cdd61-de9d-4524-b824-7414e266e1df
6247	6247	0	GBIF Benin	efb9c00e-f802-45dd-8826-a52ec45b89ff	fc7cca53-4b48-415a-9d31-9c9b71659697
17	17	0	Plazi	ffb07bec-2d10-492d-9c37-361fe0b79427	fe7a7555-9b2a-44a8-b387-21ca7ccd29d8
0	34059	34059	Ocean Biodiversity Information System	ba0670b9-4186-41e6-8e70-f9cb3065551a	01d9d254-b18c-458e-b6e1-fc569edb7f09
60507	60507	0	Atlas of Living Australia	4a6f1b71-969e-4fc5-a693-282b05e1220c	03ce64e0-7906-465f-afa8-1bfb6597aeaa
0	2	2	Plazi	ffb07bec-2d10-492d-9c37-361fe0b79427	041c79d9-b278-474c-881e-7c87717ceafc
1156	1156	0	BioCASE	d8bbf693-a180-4995-94fe-6130795dcf2f	0592122a-21c4-4085-abe1-b91f9c5622b8
4	4	0	Plazi	ffb07bec-2d10-492d-9c37-361fe0b79427	06f7a2e0-66f8-46d1-8dfc-01342ff5ea67
4	4	0	Plazi	ffb07bec-2d10-492d-9c37-361fe0b79427	08df7139-dcb3-4385-8d39-e6451816934a
0	579422	579422	GBIF Portugal	673f7038-4262-4149-b753-5658a4e912f6	0fe87daf-ed3c-4544-9d41-e187c408ee71
37	37	0	Plazi	ffb07bec-2d10-492d-9c37-361fe0b79427	0ffab461-7a40-4216-88cf-a1727e05ccdf
250336	250336	0	GBIF France	da44cd31-5901-4687-a106-6d1c7734ee3a	147834a9-fbff-4357-b8b8-e755c62df2ce
9634639	9634639	0	GBIF France	da44cd31-5901-4687-a106-6d1c7734ee3a	14d5676a-2c54-4f94-9023-1e8dcd822aa0
4	4	0	Plazi	ffb07bec-2d10-492d-9c37-361fe0b79427	1651b80f-9bcf-400e-a33c-a7f7c27d5cf4
599	599	0	Plazi	ffb07bec-2d10-492d-9c37-361fe0b79427	16b58925-3626-4d0c-8fab-4dbd7477d3c6
385	385	0	GBIF Germany	4f6826f2-4ff6-443d-b966-e6913bd24013	183ce21c-7775-46f0-8d72-da3fff9339e2
38	38	0	Plazi	ffb07bec-2d10-492d-9c37-361fe0b79427	191af5b6-65aa-46bf-82a8-257a9e90d215
48	48	0	Plazi	ffb07bec-2d10-492d-9c37-361fe0b79427	19721b2c-e043-4635-a299-6b1517b4e649
639	639	0	GBIF France	da44cd31-5901-4687-a106-6d1c7734ee3a	19b9bc3b-5b0b-45b8-a861-7e705ec4005a
59	59	0	GBIF Germany	4f6826f2-4ff6-443d-b966-e6913bd24013	1a7e0789-e93c-4ba5-804a-59230b7a0944
0	4	4	Plazi	ffb07bec-2d10-492d-9c37-361fe0b79427	1d3f9980-f695-45e8-a7ab-8fa0cf6692e7
2	2	0	Plazi	ffb07bec-2d10-492d-9c37-361fe0b79427	205d8218-277f-4d7d-88a3-81280684a3b2
1154	1154	0	GBIF France	da44cd31-5901-4687-a106-6d1c7734ee3a	26400b2d-98fd-4785-9a3e-3b019d7269f8
59	59	0	South African Biodiversity Information Facility	7190b835-4e86-4b6e-85c1-19cc6677c250	28974207-7d4f-498a-ac68-bb036acc0010
0	675	675	Ocean Biodiversity Information System	ba0670b9-4186-41e6-8e70-f9cb3065551a	28bf3cf9-3d61-4548-8a73-9a0423e45896
639	639	0	GBIF Finland	dd514216-5c7c-45f3-910d-797424cb5be6	2b93481f-3277-4305-ab73-f17fe29b430f
80	80	0	National Biodiversity Network	d897a5b9-35ee-4232-94bd-b0bcaac003c2	2c9ef75a-56b4-4e70-a6ca-1be739f24673
11174	11174	0	National Biodiversity Network	d897a5b9-35ee-4232-94bd-b0bcaac003c2	2d312e17-bd09-45ec-834c-9a372a0c7e8e
438	438	0	GBIF France	da44cd31-5901-4687-a106-6d1c7734ee3a	2d3db36b-e295-474a-8bb3-af8a42217b46
0	8	8	Ocean Biodiversity Information System	ba0670b9-4186-41e6-8e70-f9cb3065551a	2f76ecab-8c07-4328-a661-3faeb7aa8510
918	918	0	Colombian Biodiversity Information System	7e865cba-7c46-417b-ade5-97f2cf5b7be0	2fb91891-0466-44c1-ae72-bad4d372a1bf
7	7	0	Plazi	ffb07bec-2d10-492d-9c37-361fe0b79427	32922542-73d5-4797-b9f3-3d750bbb35d4
2	2	0	Plazi	ffb07bec-2d10-492d-9c37-361fe0b79427	3712472b-2fc6-4695-b882-ecaf18b27145
10844	10844	0	GBIF France	da44cd31-5901-4687-a106-6d1c7734ee3a	3db52012-62cf-40bf-822e-f59466139e3c
193	193	0	Colombian Biodiversity Information System	7e865cba-7c46-417b-ade5-97f2cf5b7be0	3e8cc719-e0e9-45ec-8341-4b80ae0e6eb3
58	58	0	GBIF France	da44cd31-5901-4687-a106-6d1c7734ee3a	41012039-2f27-4428-bbaa-ef3fc7eb5ec1
899	899	0	National Biodiversity Network	d897a5b9-35ee-4232-94bd-b0bcaac003c2	41ee2f9b-33b2-4d72-9f91-42cc5a3a24dd
1410	1410	0	National Biodiversity Network	d897a5b9-35ee-4232-94bd-b0bcaac003c2	430fea04-64f9-4959-bdc2-f5f0835eecb3
551	551	0	National Biodiversity Network	d897a5b9-35ee-4232-94bd-b0bcaac003c2	46ca4a17-659a-4afa-bea6-4f2780033c16
76	76	0	GBIF France	da44cd31-5901-4687-a106-6d1c7734ee3a	46f2e389-8132-4221-83a2-f8ec889bb0cc
0	59	59	Plazi	ffb07bec-2d10-492d-9c37-361fe0b79427	48083722-1c8f-4f45-aa00-9a0e19f22a42
1	1	0	Plazi	ffb07bec-2d10-492d-9c37-361fe0b79427	48f25ad8-5841-4eab-a32a-f03853045968
178089	190683	12594	Atlas of Living Australia	4a6f1b71-969e-4fc5-a693-282b05e1220c	4ffe66a0-6c8b-11de-8226-b8a03c50a862
1	1	0	Plazi	ffb07bec-2d10-492d-9c37-361fe0b79427	508342ee-23e0-409c-9510-582c11f8872d
3	3	0	Plazi	ffb07bec-2d10-492d-9c37-361fe0b79427	566f9922-d257-41d4-acdc-2afbdcf1b495
0	2	2	Plazi	ffb07bec-2d10-492d-9c37-361fe0b79427	57b642d6-957d-4b5e-a03c-a3627fb84123
49	49	0	Plazi	ffb07bec-2d10-492d-9c37-361fe0b79427	5831016f-7cf2-4480-a537-c1bf3768319f
672	588	-84	GBIF Germany	4f6826f2-4ff6-443d-b966-e6913bd24013	589ce77a-27eb-4b8c-a0e8-f35f932c23f5
11	11	0	Plazi	ffb07bec-2d10-492d-9c37-361fe0b79427	58cea2d1-846c-4754-999e-bb49270cfb85
2860	2860	0	GBIF Argentina	2426a871-9feb-40a1-96c6-0c593a76b835	5a84d194-423e-44f8-9704-0f12f414d532
124	124	0	Colombian Biodiversity Information System	7e865cba-7c46-417b-ade5-97f2cf5b7be0	5acc286f-760c-4ac8-bdb7-5a13219f9a3b
13	13	0	Plazi	ffb07bec-2d10-492d-9c37-361fe0b79427	5c65d395-a86d-4156-8a1a-d1696e69ba9c
13	13	0	Plazi	ffb07bec-2d10-492d-9c37-361fe0b79427	5cb659af-30d9-4180-aa50-1f4664684e09
0	5	5	Plazi	ffb07bec-2d10-492d-9c37-361fe0b79427	5eadfec4-49ac-484f-a3b2-a41ed1268493
106	106	0	GBIF Germany	4f6826f2-4ff6-443d-b966-e6913bd24013	61ba908e-f762-11e1-a439-00145eb45e9a
64	64	0	GBIF Germany	4f6826f2-4ff6-443d-b966-e6913bd24013	62fd6f02-f762-11e1-a439-00145eb45e9a
2	2	0	GBIF Germany	4f6826f2-4ff6-443d-b966-e6913bd24013	63529798-f762-11e1-a439-00145eb45e9a
0	15	15	Plazi	ffb07bec-2d10-492d-9c37-361fe0b79427	65624457-9eba-46fa-93dc-dfadc60cb618
0	87	87	Plazi	ffb07bec-2d10-492d-9c37-361fe0b79427	659cda52-73c7-4d57-9032-9e7e523428dc
37	37	0	GBIF Germany	4f6826f2-4ff6-443d-b966-e6913bd24013	66981216-f762-11e1-a439-00145eb45e9a
118	118	0	GBIF Germany	4f6826f2-4ff6-443d-b966-e6913bd24013	66ac2e36-f762-11e1-a439-00145eb45e9a
343	200	-143	GBIF Germany	4f6826f2-4ff6-443d-b966-e6913bd24013	68dc5cd0-f762-11e1-a439-00145eb45e9a
9	9	0	GBIF Germany	4f6826f2-4ff6-443d-b966-e6913bd24013	69407d64-f762-11e1-a439-00145eb45e9a
102	102	0	GBIF Germany	4f6826f2-4ff6-443d-b966-e6913bd24013	6a366a94-f762-11e1-a439-00145eb45e9a
8	8	0	GBIF Germany	4f6826f2-4ff6-443d-b966-e6913bd24013	6acb69a0-f762-11e1-a439-00145eb45e9a
18	18	0	GBIF Germany	4f6826f2-4ff6-443d-b966-e6913bd24013	6b84e9fc-f762-11e1-a439-00145eb45e9a
0	1159	1159	Atlas of Living Australia	4a6f1b71-969e-4fc5-a693-282b05e1220c	6ba0b82f-f940-4de0-8bfb-83f0f908493b
4	4	0	Plazi	ffb07bec-2d10-492d-9c37-361fe0b79427	6c0df66a-6b1d-469d-a2bd-80b7016813ea
16	16	0	Plazi	ffb07bec-2d10-492d-9c37-361fe0b79427	6c80324b-cd81-430e-8b5b-e13e1203b858
4	4	0	Plazi	ffb07bec-2d10-492d-9c37-361fe0b79427	6e15d95e-e470-45ed-87ac-ade99f113680
11	11	0	Plazi	ffb07bec-2d10-492d-9c37-361fe0b79427	70d743db-654b-4050-a05f-a5c71b54e14e
9	9	0	Plazi	ffb07bec-2d10-492d-9c37-361fe0b79427	71b9a22f-03d6-4703-864f-e4a84936ae82
17	17	0	Plazi	ffb07bec-2d10-492d-9c37-361fe0b79427	7520908e-3595-4ed3-96f8-9a0fffb45439
1396	1396	0	Ocean Biodiversity Information System	ba0670b9-4186-41e6-8e70-f9cb3065551a	758c44fb-18f7-4f21-a9d7-a0fe8519f633
551	551	0	GBIF Germany	4f6826f2-4ff6-443d-b966-e6913bd24013	758d917e-f762-11e1-a439-00145eb45e9a
1	1	0	Plazi	ffb07bec-2d10-492d-9c37-361fe0b79427	779367c5-5673-4fff-a992-a1c7082d0733
27	27	0	Plazi	ffb07bec-2d10-492d-9c37-361fe0b79427	77e441b5-2bdc-4c26-b6fc-b007d8d9ca25
13	13	0	GBIF Germany	4f6826f2-4ff6-443d-b966-e6913bd24013	78b70150-f762-11e1-a439-00145eb45e9a
6874	6874	0	U.S. Geological Survey	8618c64a-93e0-4300-b546-7249e5148ed2	78dcfcbd-03c4-4d47-8618-830aac6f2ee5
489	393	-96	GBIF Germany	4f6826f2-4ff6-443d-b966-e6913bd24013	79a1d838-f762-11e1-a439-00145eb45e9a
3338	3337	-1	GBIF Norway	4f829580-180d-46a9-9c87-ed8ec959b545	7aa3a91c-eafe-44f5-adfb-d48fca1a3db5
7	7	0	Plazi	ffb07bec-2d10-492d-9c37-361fe0b79427	7c38e471-8dce-4834-9f95-7aafd96f99eb
0	285	285	Plazi	ffb07bec-2d10-492d-9c37-361fe0b79427	7cc10985-736c-4010-baa8-73ebd090ef8b
155	155	0	GBIF Germany	4f6826f2-4ff6-443d-b966-e6913bd24013	7cf4f592-f762-11e1-a439-00145eb45e9a
86	89	3	GBIF Germany	4f6826f2-4ff6-443d-b966-e6913bd24013	7d171ba4-f762-11e1-a439-00145eb45e9a
155	155	0	GBIF Germany	4f6826f2-4ff6-443d-b966-e6913bd24013	7d922ef2-f762-11e1-a439-00145eb45e9a
47	47	0	Plazi	ffb07bec-2d10-492d-9c37-361fe0b79427	7dda3f39-7ee4-40be-a268-75056e3d2a9a
174	174	0	GBIF Germany	4f6826f2-4ff6-443d-b966-e6913bd24013	7df2ed6e-f762-11e1-a439-00145eb45e9a
370	370	0	GBIF Germany	4f6826f2-4ff6-443d-b966-e6913bd24013	7ec8cc68-f762-11e1-a439-00145eb45e9a
420	420	0	GBIF Germany	4f6826f2-4ff6-443d-b966-e6913bd24013	7f29f74a-f762-11e1-a439-00145eb45e9a
7	7	0	Plazi	ffb07bec-2d10-492d-9c37-361fe0b79427	80a9157d-3178-4f1b-9c98-436636c4d4d0
1032	1032	0	Biodiversity Information System of Mexico	b324e8e9-9a4c-44fa-8f1a-7f39ea7ab576	80c9cd0a-f762-11e1-a439-00145eb45e9a
9	9	0	GBIF Japan	db5705aa-6a6e-42f1-8942-d77b9f4896ea	80f2abe4-f762-11e1-a439-00145eb45e9a
460	480	20	GBIF Germany	4f6826f2-4ff6-443d-b966-e6913bd24013	81ac5a62-f762-11e1-a439-00145eb45e9a
1246	1246	0	GBIF Germany	4f6826f2-4ff6-443d-b966-e6913bd24013	8280ea98-f762-11e1-a439-00145eb45e9a
238898	238898	0	GBIF Spain	1f94b3ca-9345-4d65-afe2-4bace93aa0fe	834a4794-f762-11e1-a439-00145eb45e9a
29477	29477	0	Canada Biodiversity Information Facility	8f83fc96-c966-4126-83f7-bf044dc49efa	84472eb4-f762-11e1-a439-00145eb45e9a
9899	9899	0	DanBIF - Danish Biodiversity Information Facility	4ddd294f-02b7-4359-ac33-0806a9ca9c6b	84c91672-f762-11e1-a439-00145eb45e9a
0	3	3	Ocean Biodiversity Information System	ba0670b9-4186-41e6-8e70-f9cb3065551a	84f5f6f0-1b75-4d84-b8a3-de0d069709b1
268	268	0	GBIF Germany	4f6826f2-4ff6-443d-b966-e6913bd24013	85cb5094-f762-11e1-a439-00145eb45e9a
2268	1843	-425	GBIF Germany	4f6826f2-4ff6-443d-b966-e6913bd24013	874c4f68-f762-11e1-a439-00145eb45e9a
470	470	0	GBIF Germany	4f6826f2-4ff6-443d-b966-e6913bd24013	87add31e-f762-11e1-a439-00145eb45e9a
198	198	0	GBIF Germany	4f6826f2-4ff6-443d-b966-e6913bd24013	883b3b82-f762-11e1-a439-00145eb45e9a
11	11	0	Plazi	ffb07bec-2d10-492d-9c37-361fe0b79427	88631109-85a1-4d88-90d9-d74cc5909d2f
9858	9858	0	GBIF Spain	1f94b3ca-9345-4d65-afe2-4bace93aa0fe	88af1796-f762-11e1-a439-00145eb45e9a
188	188	0	GBIF Germany	4f6826f2-4ff6-443d-b966-e6913bd24013	89ae0cf6-f762-11e1-a439-00145eb45e9a
977	977	0	GBIF Germany	4f6826f2-4ff6-443d-b966-e6913bd24013	89fd770a-f762-11e1-a439-00145eb45e9a
640	640	0	Belgian Biodiversity Platform	fb11cfe1-ebc3-45af-9159-17d9fddbcdac	8a91ff89-2dcc-4cfc-a4fb-a8ab97f28102
37	37	0	GBIF Germany	4f6826f2-4ff6-443d-b966-e6913bd24013	8bc02088-f762-11e1-a439-00145eb45e9a
12	9	-3	GBIF Germany	4f6826f2-4ff6-443d-b966-e6913bd24013	8cce1a8e-f762-11e1-a439-00145eb45e9a
6	4	-2	GBIF Germany	4f6826f2-4ff6-443d-b966-e6913bd24013	8ce36128-f762-11e1-a439-00145eb45e9a
11	10	-1	GBIF Germany	4f6826f2-4ff6-443d-b966-e6913bd24013	8d008bea-f762-11e1-a439-00145eb45e9a
0	34	34	Plazi	ffb07bec-2d10-492d-9c37-361fe0b79427	8daef198-cdae-415e-ba12-ed75776a50dc
6	6	0	GBIF Germany	4f6826f2-4ff6-443d-b966-e6913bd24013	8e243756-f762-11e1-a439-00145eb45e9a
30	30	0	Participant Node Managers Committee	7f48e0c8-5c96-49ec-b972-30748e339115	8e8f2105-24bf-4304-a66b-9596705d3c81
35	27	-8	GBIF Germany	4f6826f2-4ff6-443d-b966-e6913bd24013	8f47364c-f762-11e1-a439-00145eb45e9a
202	60	-142	GBIF Germany	4f6826f2-4ff6-443d-b966-e6913bd24013	8fa2ff04-f762-11e1-a439-00145eb45e9a
0	1000	1000	Korean Biodiversity Information Facility	e0a1e772-0177-4800-94b4-2d023fe6cdf4	9017ceec-c1de-4423-a082-e1d116b09cc5
5	2	-3	GBIF Germany	4f6826f2-4ff6-443d-b966-e6913bd24013	90e67dc8-f762-11e1-a439-00145eb45e9a
177	177	0	National Biodiversity Network	d897a5b9-35ee-4232-94bd-b0bcaac003c2	9261d82a-1247-41e4-b40c-4724577137ac
247	247	0	GBIF Germany	4f6826f2-4ff6-443d-b966-e6913bd24013	92f7984a-f762-11e1-a439-00145eb45e9a
1	1	0	GBIF Germany	4f6826f2-4ff6-443d-b966-e6913bd24013	93938f7a-f762-11e1-a439-00145eb45e9a
1937	1869	-68	GBIF Germany	4f6826f2-4ff6-443d-b966-e6913bd24013	944b5d26-f762-11e1-a439-00145eb45e9a
4507	4507	0	South African Biodiversity Information Facility	7190b835-4e86-4b6e-85c1-19cc6677c250	961572c9-2cca-4473-8c6e-9d288ef6ca29
32698	32698	0	GBIF France	da44cd31-5901-4687-a106-6d1c7734ee3a	96296645-bae3-4114-be50-90bd6398097d
17	17	0	Plazi	ffb07bec-2d10-492d-9c37-361fe0b79427	985a60d8-15f9-4a4d-a806-53f1e835651e
0	691	691	GBIF France	da44cd31-5901-4687-a106-6d1c7734ee3a	9a9cd17c-361d-4d6a-ba0f-9a487cd8f93a
0	1	1	Plazi	ffb07bec-2d10-492d-9c37-361fe0b79427	9bf62239-1304-4a29-b3b3-0632a684dcf6
161	161	0	GBIF France	da44cd31-5901-4687-a106-6d1c7734ee3a	9d9882e8-48f9-464d-b4b7-8b08e1f2fce3
0	168	168	Participant Node Managers Committee	7f48e0c8-5c96-49ec-b972-30748e339115	9e412c95-389c-4383-847d-cf03a0762383
0	58	58	Plazi	ffb07bec-2d10-492d-9c37-361fe0b79427	9e67d3d2-ed4b-4976-b342-0b8397b443fe
9622	9622	0	Atlas of Living Australia	4a6f1b71-969e-4fc5-a693-282b05e1220c	9efcb014-623f-48d5-89e4-afabb713a8fe
5	5	0	Plazi	ffb07bec-2d10-492d-9c37-361fe0b79427	9f268323-4d26-4c00-8e89-c674e972a0d5
3	3	0	Plazi	ffb07bec-2d10-492d-9c37-361fe0b79427	a2d497c6-5ab2-4ec1-b881-86a094560923
1	1	0	Plazi	ffb07bec-2d10-492d-9c37-361fe0b79427	a3562962-0e5a-4d95-bd98-ae6cc0bf03e8
17	17	0	Plazi	ffb07bec-2d10-492d-9c37-361fe0b79427	a385b0b0-2e1d-4f4a-9ed3-f872c197e501
127	127	0	Plazi	ffb07bec-2d10-492d-9c37-361fe0b79427	a4915bfc-b1da-4d24-ae32-fb8b928b4844
21	21	0	Plazi	ffb07bec-2d10-492d-9c37-361fe0b79427	a8e66c96-836f-4fb3-bd2f-a7aadc2b80bf
2	2	0	Plazi	ffb07bec-2d10-492d-9c37-361fe0b79427	ae29b145-77e4-4ead-85f2-4f5ceabb94fa
2	2	0	Plazi	ffb07bec-2d10-492d-9c37-361fe0b79427	b1eaefaf-c0cf-4527-bd3f-dc374e43cf35
0	5532	5532	Ocean Biodiversity Information System	ba0670b9-4186-41e6-8e70-f9cb3065551a	b4469a23-f5a7-48e2-a32e-6e30353ea6a0
11	16	5	U.S. Geological Survey	8618c64a-93e0-4300-b546-7249e5148ed2	b4ec1f9f-6787-415c-b6eb-4681620942b5
21	21	0	Plazi	ffb07bec-2d10-492d-9c37-361fe0b79427	b6786141-b3af-4df8-838b-6ecea1fd2810
2	2	0	Plazi	ffb07bec-2d10-492d-9c37-361fe0b79427	b6e0d24a-7e5c-4894-9742-f7a57b3f4592
52	52	0	Participant Node Managers Committee	7f48e0c8-5c96-49ec-b972-30748e339115	b83909b4-2562-41c4-a67e-1e191786ea0a
15	15	0	Plazi	ffb07bec-2d10-492d-9c37-361fe0b79427	bb837a7a-0555-4c18-9db3-91d5a2087b62
993	993	0	GBIF Portugal	673f7038-4262-4149-b753-5658a4e912f6	bc3c6698-36c5-48e6-9ea9-e0830b6ee79e
141	141	0	Plazi	ffb07bec-2d10-492d-9c37-361fe0b79427	c0c8f32b-4a6e-4b70-a282-a0b610737fbe
32	32	0	Colombian Biodiversity Information System	7e865cba-7c46-417b-ade5-97f2cf5b7be0	c0eee375-b253-4d41-a2ee-b2ee05ac02be
0	8	8	Plazi	ffb07bec-2d10-492d-9c37-361fe0b79427	c227c1c6-8de6-4ace-a88e-f5ca80131789
0	1	1	Plazi	ffb07bec-2d10-492d-9c37-361fe0b79427	c23a0cd0-62b0-47b8-bca5-c7d2b507ad83
899	899	0	GBIF Germany	4f6826f2-4ff6-443d-b966-e6913bd24013	c3a07142-1a44-4ff1-857a-e0a6b5d94a04
384	384	0	GBIF Germany	4f6826f2-4ff6-443d-b966-e6913bd24013	c6761fc8-0f00-4c9c-a86c-d17c02c7eb99
958	958	0	GBIF France	da44cd31-5901-4687-a106-6d1c7734ee3a	ca89b39c-c521-4263-b4f4-1d208f9c2730
210	210	0	Atlas of Living Australia	4a6f1b71-969e-4fc5-a693-282b05e1220c	cbd1b8af-9457-483c-b0dd-6916ef98e6cb
9	9	0	GBIF France	da44cd31-5901-4687-a106-6d1c7734ee3a	ccddcd57-342b-4a13-888b-a37fca1b9906
25	25	0	Plazi	ffb07bec-2d10-492d-9c37-361fe0b79427	d1b4add2-e5bc-4d08-9502-274bab438721
1533	1533	0	GBIF France	da44cd31-5901-4687-a106-6d1c7734ee3a	d1e2be73-413a-4f4e-87d5-3210cac2c18a
16	16	0	U.S. Geological Survey	8618c64a-93e0-4300-b546-7249e5148ed2	d1f72831-9e1c-4742-bb9b-a09ea0438c71
25592	25592	0	GBIF Peru	46e3639a-27f8-45af-bfbe-d19b77efb040	d4b72404-5c42-49ea-ab78-9edb3c8957b6
1322	1322	0	Atlas of Living Australia	4a6f1b71-969e-4fc5-a693-282b05e1220c	d510984b-1cf9-43ba-94d0-a949f43d82f8
2	2	0	Participant Node Managers Committee	7f48e0c8-5c96-49ec-b972-30748e339115	d6c2d094-4369-429f-833c-9d3cb0261023
8	8	0	Plazi	ffb07bec-2d10-492d-9c37-361fe0b79427	d8b0deec-8771-4e1f-9900-9869715df1c6
38	38	0	Plazi	ffb07bec-2d10-492d-9c37-361fe0b79427	d922f25d-1252-4379-8e0f-39124631c5d8
0	51	51	Plazi	ffb07bec-2d10-492d-9c37-361fe0b79427	dbf1660e-0b0f-4ef5-95c7-a3adb83fcbe9
2	2	0	Plazi	ffb07bec-2d10-492d-9c37-361fe0b79427	ddf30015-d3f1-40dd-b5c8-245868656e4a
2849	2849	0	GBIF France	da44cd31-5901-4687-a106-6d1c7734ee3a	deec913d-9a81-4904-a972-aed476d31c6d
275	275	0	GBIF Germany	4f6826f2-4ff6-443d-b966-e6913bd24013	e5313b4b-4b53-451f-b298-39325a082982
17	17	0	Plazi	ffb07bec-2d10-492d-9c37-361fe0b79427	e6661714-406c-4c7d-afae-9a5adae9644a
0	17173	17173	Korean Biodiversity Information Facility	e0a1e772-0177-4800-94b4-2d023fe6cdf4	e66992e4-10ea-4413-b9f5-a10fc40d5bd6
0	1557	1557	Colombian Biodiversity Information System	7e865cba-7c46-417b-ade5-97f2cf5b7be0	e6ba4cec-27df-4a1c-9dad-fd99e248d52a
7	7	0	Plazi	ffb07bec-2d10-492d-9c37-361fe0b79427	e9842926-ae93-45e6-813d-248b81b6054d
1279	1279	0	Participant Node Managers Committee	7f48e0c8-5c96-49ec-b972-30748e339115	eb13bdda-e770-409b-9795-44eafc3b9c1e
239167	291512	52345	GBIF Japan	db5705aa-6a6e-42f1-8942-d77b9f4896ea	edeee57f-9e48-4202-b387-9cb5224e7b1b
86524	86524	0	Participant Node Managers Committee	7f48e0c8-5c96-49ec-b972-30748e339115	f5617d90-84bd-4f8e-8b5d-b8b816e065c8
3	3	0	Plazi	ffb07bec-2d10-492d-9c37-361fe0b79427	f5dcdd87-3d51-49a4-b1f5-845a92ea3e51
30	1143	1113	GBIF Germany	4f6826f2-4ff6-443d-b966-e6913bd24013	f75f5833-50ee-486c-85f5-69cb6100c8e0
0	8	8	Plazi	ffb07bec-2d10-492d-9c37-361fe0b79427	f8fbfc34-9c76-4ee9-98e6-ee9631f41042
3072	3072	0	National Biodiversity Network	d897a5b9-35ee-4232-94bd-b0bcaac003c2	fc2396a4-06f1-4884-8f90-f39ea79f8dcb
2294	2294	0	GBIF Germany	4f6826f2-4ff6-443d-b966-e6913bd24013	fdf43248-84a3-463a-94c7-1a4d20f98985
10217	10217	0	National Biodiversity Network	d897a5b9-35ee-4232-94bd-b0bcaac003c2	febbedff-5914-466d-a7a9-acc028a13b8b
0	22	22	Plazi	ffb07bec-2d10-492d-9c37-361fe0b79427	010a0e1c-44b3-4649-8bc8-92cb88a7eb0d
0	56	56	Colombian Biodiversity Information System	7e865cba-7c46-417b-ade5-97f2cf5b7be0	0156e25e-2774-4e5d-a6be-09e2586b4f37
1	1	0	Plazi	ffb07bec-2d10-492d-9c37-361fe0b79427	032f8938-8e15-4263-9a42-199e4b80cc87
67	67	0	Plazi	ffb07bec-2d10-492d-9c37-361fe0b79427	05d1bac2-fe53-42ba-a04d-bc4828adaf4e
4	4	0	Plazi	ffb07bec-2d10-492d-9c37-361fe0b79427	063b0bc8-3175-4bf0-8923-8d192361941f
3	3	0	Plazi	ffb07bec-2d10-492d-9c37-361fe0b79427	0b5f9b4e-fceb-4175-a008-07b6aaa8a228
21	21	0	Plazi	ffb07bec-2d10-492d-9c37-361fe0b79427	0c346a51-4fa5-4479-887a-7d7b92b17918
0	26	26	Plazi	ffb07bec-2d10-492d-9c37-361fe0b79427	0ffa72e0-c3b8-4c3c-8b64-a39dab962daa
34143	78429	44286	National Biodiversity Network	d897a5b9-35ee-4232-94bd-b0bcaac003c2	100a9054-e46c-4302-b059-3a8836df1cf7
498	498	0	GBIF Norway	4f829580-180d-46a9-9c87-ed8ec959b545	101f5645-c5c0-4981-a1a2-3d2bb1853edf
12094	12094	0	National Biodiversity Network	d897a5b9-35ee-4232-94bd-b0bcaac003c2	10b3645a-c6c6-412f-b06b-8d623aa82ad1
0	8	8	Plazi	ffb07bec-2d10-492d-9c37-361fe0b79427	10c31d8a-b94a-4873-b88c-1ea898c59426
422	422	0	GBIF Argentina	2426a871-9feb-40a1-96c6-0c593a76b835	10e614c8-1c11-45a6-b013-e73c7b0b8930
1	1	0	Plazi	ffb07bec-2d10-492d-9c37-361fe0b79427	117a8196-14ee-4a49-8fd1-b0582ad904e0
354	354	0	Participant Node Managers Committee	7f48e0c8-5c96-49ec-b972-30748e339115	11a962e1-9109-4f7a-a56f-6783de1dc8cc
68	68	0	GBIF France	da44cd31-5901-4687-a106-6d1c7734ee3a	13e74632-2469-402e-84b9-1f2539f3326d
3	3	0	Plazi	ffb07bec-2d10-492d-9c37-361fe0b79427	18135709-8e5a-46bb-af35-f5e44f910de8
10	10	0	Plazi	ffb07bec-2d10-492d-9c37-361fe0b79427	18df27be-d100-4d62-bf13-8442f78aabe7
11	11	0	National Biodiversity Network	d897a5b9-35ee-4232-94bd-b0bcaac003c2	193ce34d-1967-442a-a867-a42207d639ec
8	8	0	Plazi	ffb07bec-2d10-492d-9c37-361fe0b79427	1940a11e-c89d-40d8-a747-bbb07867c1ba
99	99	0	Biodiversity Information System of Mexico	b324e8e9-9a4c-44fa-8f1a-7f39ea7ab576	1a8dfdf9-431c-48f8-a3d1-9a56c62fc4ae
310	310	0	GBIF Germany	4f6826f2-4ff6-443d-b966-e6913bd24013	1b32b50b-caa7-4535-a87d-4f32fcc7f7ed
0	987	987	Ocean Biodiversity Information System	ba0670b9-4186-41e6-8e70-f9cb3065551a	1cabadb9-d436-4d9b-b760-a36c5f9c62fa
0	3	3	Plazi	ffb07bec-2d10-492d-9c37-361fe0b79427	2557f804-d6ce-43a3-9a7a-18fd36c99f88
39	39	0	Plazi	ffb07bec-2d10-492d-9c37-361fe0b79427	2628fac4-bc07-4024-acd5-ed13c3b276f9
187319	187859	540	Atlas of Living Australia	4a6f1b71-969e-4fc5-a693-282b05e1220c	2651f9da-9999-4cd2-9f17-293a977ffe58
0	16	16	Plazi	ffb07bec-2d10-492d-9c37-361fe0b79427	2b1a0177-edaa-4be4-b335-1a111e880bf9
1	1	0	Plazi	ffb07bec-2d10-492d-9c37-361fe0b79427	2e96b52b-396b-4d42-8a7b-72b24f9c500e
169	169	0	GBIF France	da44cd31-5901-4687-a106-6d1c7734ee3a	2ffb49c7-7f06-463b-bad5-a6c608ee5b98
12973	38141	25168	GBIF France	da44cd31-5901-4687-a106-6d1c7734ee3a	33e3780b-d539-4e5e-b82f-1662b5941a9e
0	23	23	Plazi	ffb07bec-2d10-492d-9c37-361fe0b79427	39b6c74a-8bd5-49f0-8e23-b9ab57c7d162
1043	1056	13	GBIF Germany	4f6826f2-4ff6-443d-b966-e6913bd24013	3c57ed85-e109-4e4f-92ea-8c007cde0903
914	914	0	GBIF France	da44cd31-5901-4687-a106-6d1c7734ee3a	410f6ef1-36f6-4d26-8905-e149c9f6a09b
0	960	960	GBIF Spain	1f94b3ca-9345-4d65-afe2-4bace93aa0fe	438f6a2c-1aa1-43a9-82bc-ba56247ecd2d
4	4	0	GBIF France	da44cd31-5901-4687-a106-6d1c7734ee3a	458c4729-d410-43cb-b222-3f81ce831191
241	244	3	GBIF Japan	db5705aa-6a6e-42f1-8942-d77b9f4896ea	45b97671-efd8-4a0c-9fff-5fa910f799c5
11251	11251	0	GBIF Peru	46e3639a-27f8-45af-bfbe-d19b77efb040	4747636a-d019-4f30-a0c2-c930b864ad7e
114	114	0	Plazi	ffb07bec-2d10-492d-9c37-361fe0b79427	49bea467-fac6-484a-9902-05483dec9a52
1	1	0	Plazi	ffb07bec-2d10-492d-9c37-361fe0b79427	4b3b7a51-decf-422f-9f6d-d6a5850d2261
0	1146	1146	Plazi	ffb07bec-2d10-492d-9c37-361fe0b79427	4b976ba3-1a7b-4dd5-8afb-630b7cc8a695
0	423	423	Belgian Biodiversity Platform	fb11cfe1-ebc3-45af-9159-17d9fddbcdac	4bf72815-0a9c-4626-9a5d-15c888c04932
7	7	0	Plazi	ffb07bec-2d10-492d-9c37-361fe0b79427	5006e921-fa87-45cb-9f17-b76b3e0ce7ab
0	24	24	Plazi	ffb07bec-2d10-492d-9c37-361fe0b79427	5247e933-3152-40d5-ae19-cce84a3dad7f
205	205	0	Plazi	ffb07bec-2d10-492d-9c37-361fe0b79427	537cc788-42c7-46ad-86e1-74e539b0ce74
1	1	0	GBIF Japan	db5705aa-6a6e-42f1-8942-d77b9f4896ea	5411820d-a4e0-4a7a-be0b-d73dde0db121
6	6	0	Plazi	ffb07bec-2d10-492d-9c37-361fe0b79427	56d995e5-e1d4-4ce2-ae5e-cb3b2ff8ef1c
603	603	0	Colombian Biodiversity Information System	7e865cba-7c46-417b-ade5-97f2cf5b7be0	56dbf6cd-a106-4afb-9ba4-37f2f3c20acf
0	10	10	Plazi	ffb07bec-2d10-492d-9c37-361fe0b79427	599d1f50-ec72-472b-bf86-545ab9964231
1	1	0	Plazi	ffb07bec-2d10-492d-9c37-361fe0b79427	5bf3517e-3121-45f8-950a-3e6d7391bdef
183	183	0	GBIF France	da44cd31-5901-4687-a106-6d1c7734ee3a	5f643049-1ace-42ea-8756-b4656171cc53
8	8	0	Plazi	ffb07bec-2d10-492d-9c37-361fe0b79427	612343eb-2f73-4265-b5dd-25ae1a5f14b1
359	359	0	GBIF Germany	4f6826f2-4ff6-443d-b966-e6913bd24013	637d1838-f762-11e1-a439-00145eb45e9a
0	12	12	National Biodiversity Network	d897a5b9-35ee-4232-94bd-b0bcaac003c2	63b3fe19-ad89-4c22-b346-37f817e97fe4
36	36	0	GBIF Germany	4f6826f2-4ff6-443d-b966-e6913bd24013	643a4778-f762-11e1-a439-00145eb45e9a
13	13	0	GBIF Germany	4f6826f2-4ff6-443d-b966-e6913bd24013	648f44da-f762-11e1-a439-00145eb45e9a
72	72	0	GBIF Germany	4f6826f2-4ff6-443d-b966-e6913bd24013	64cbcd7e-f762-11e1-a439-00145eb45e9a
40	40	0	Plazi	ffb07bec-2d10-492d-9c37-361fe0b79427	6531d570-f61a-49ae-a7a2-8167a41981fc
83	83	0	GBIF Germany	4f6826f2-4ff6-443d-b966-e6913bd24013	662e84fe-f762-11e1-a439-00145eb45e9a
211	211	0	GBIF Germany	4f6826f2-4ff6-443d-b966-e6913bd24013	663c93aa-f762-11e1-a439-00145eb45e9a
1620	1620	0	National Biodiversity Network	d897a5b9-35ee-4232-94bd-b0bcaac003c2	6721656b-fb64-43a5-97cc-827ea700ef77
58	58	0	GBIF Germany	4f6826f2-4ff6-443d-b966-e6913bd24013	68bbc4e8-f762-11e1-a439-00145eb45e9a
2945	2945	0	Colombian Biodiversity Information System	7e865cba-7c46-417b-ade5-97f2cf5b7be0	6954c356-7c79-4569-ae4e-b9dd09fc5cf1
185	185	0	GBIF Germany	4f6826f2-4ff6-443d-b966-e6913bd24013	69dbd67e-f762-11e1-a439-00145eb45e9a
753	436	-317	GBIF Germany	4f6826f2-4ff6-443d-b966-e6913bd24013	6a433cec-f762-11e1-a439-00145eb45e9a
242	242	0	Colombian Biodiversity Information System	7e865cba-7c46-417b-ade5-97f2cf5b7be0	6ab92616-e7f9-47a9-8dd6-d7d129fafd08
8	8	0	GBIF Germany	4f6826f2-4ff6-443d-b966-e6913bd24013	6ad7379e-f762-11e1-a439-00145eb45e9a
88	88	0	GBIF Germany	4f6826f2-4ff6-443d-b966-e6913bd24013	6d60f9f0-f762-11e1-a439-00145eb45e9a
17	61	44	Plazi	ffb07bec-2d10-492d-9c37-361fe0b79427	7041b3d5-5413-49e1-930a-c561f88a3b36
1257	796	-461	GBIF Germany	4f6826f2-4ff6-443d-b966-e6913bd24013	710c0a5e-f762-11e1-a439-00145eb45e9a
10	10	0	GBIF Germany	4f6826f2-4ff6-443d-b966-e6913bd24013	73983e46-f762-11e1-a439-00145eb45e9a
3	3	0	GBIF Germany	4f6826f2-4ff6-443d-b966-e6913bd24013	743b6f12-f762-11e1-a439-00145eb45e9a
10	10	0	GBIF France	da44cd31-5901-4687-a106-6d1c7734ee3a	762e6b74-e481-491e-9809-b03356438e93
33	33	0	Participant Node Managers Committee	7f48e0c8-5c96-49ec-b972-30748e339115	767212b5-6535-4f84-9844-bce20b7ab44e
10	10	0	GBIF Germany	4f6826f2-4ff6-443d-b966-e6913bd24013	783f7338-f762-11e1-a439-00145eb45e9a
4	4	0	GBIF Germany	4f6826f2-4ff6-443d-b966-e6913bd24013	7884aa7a-f762-11e1-a439-00145eb45e9a
19	19	0	GBIF Germany	4f6826f2-4ff6-443d-b966-e6913bd24013	78a7816c-f762-11e1-a439-00145eb45e9a
348	348	0	Ocean Biodiversity Information System	ba0670b9-4186-41e6-8e70-f9cb3065551a	7b60c440-f762-11e1-a439-00145eb45e9a
909	909	0	GBIF Germany	4f6826f2-4ff6-443d-b966-e6913bd24013	7c2b04f8-f762-11e1-a439-00145eb45e9a
578	265	-313	GBIF Germany	4f6826f2-4ff6-443d-b966-e6913bd24013	7d38f828-f762-11e1-a439-00145eb45e9a
0	3	3	Plazi	ffb07bec-2d10-492d-9c37-361fe0b79427	7ead527f-c1b2-4eba-a13c-942aa7a36d28
1419	1419	0	Biodiversity Information System of Mexico	b324e8e9-9a4c-44fa-8f1a-7f39ea7ab576	7fee23ae-f762-11e1-a439-00145eb45e9a
751	751	0	Biodiversity Information System of Mexico	b324e8e9-9a4c-44fa-8f1a-7f39ea7ab576	8076a2ec-f762-11e1-a439-00145eb45e9a
842	842	0	GBIF Japan	db5705aa-6a6e-42f1-8942-d77b9f4896ea	8105f15e-f762-11e1-a439-00145eb45e9a
9	9	0	GBIF France	da44cd31-5901-4687-a106-6d1c7734ee3a	82b70398-1fc4-49ce-a828-4f6f2c7f3aa5
3618	3618	0	GBIF Spain	1f94b3ca-9345-4d65-afe2-4bace93aa0fe	836c3a66-f762-11e1-a439-00145eb45e9a
0	159	159	Plazi	ffb07bec-2d10-492d-9c37-361fe0b79427	8498d050-113a-4658-9b4c-db8087b12c81
49262	49262	0	U.S. Geological Survey	8618c64a-93e0-4300-b546-7249e5148ed2	84b26828-f762-11e1-a439-00145eb45e9a
82	82	0	Plazi	ffb07bec-2d10-492d-9c37-361fe0b79427	85c6241d-5e5a-4022-945f-e207d31458ef
38536	38536	0	GBIF Germany	4f6826f2-4ff6-443d-b966-e6913bd24013	85c8e444-f762-11e1-a439-00145eb45e9a
504	504	0	GBIF Germany	4f6826f2-4ff6-443d-b966-e6913bd24013	863a8ee6-f762-11e1-a439-00145eb45e9a
1404	585	-819	GBIF Germany	4f6826f2-4ff6-443d-b966-e6913bd24013	86710210-af2b-4158-8a3d-f2f8b6da9918
10609	10609	0	Atlas of Living Australia	4a6f1b71-969e-4fc5-a693-282b05e1220c	8805b51e-d8e8-41d0-8976-d653d39c7a91
1846	1846	0	Colombian Biodiversity Information System	7e865cba-7c46-417b-ade5-97f2cf5b7be0	8ac9b3f9-383e-4401-bb17-fdd802057087
0	12	12	Plazi	ffb07bec-2d10-492d-9c37-361fe0b79427	8c5d3216-1ffb-4db3-84ab-ac52addb5ea2
325	89	-236	GBIF Germany	4f6826f2-4ff6-443d-b966-e6913bd24013	8dd6e2ee-f762-11e1-a439-00145eb45e9a
0	686	686	Plazi	ffb07bec-2d10-492d-9c37-361fe0b79427	8ddfc41f-28aa-48b4-a24d-25ba06447ef0
1425	1203	-222	GBIF Germany	4f6826f2-4ff6-443d-b966-e6913bd24013	8ebeef8a-f762-11e1-a439-00145eb45e9a
0	10	10	Plazi	ffb07bec-2d10-492d-9c37-361fe0b79427	92429688-b121-4e17-bc40-6b920a2bb90f
0	66	66	Plazi	ffb07bec-2d10-492d-9c37-361fe0b79427	9298158c-3c02-4ba2-ab8a-87c7f9c8e70b
0	8	8	Plazi	ffb07bec-2d10-492d-9c37-361fe0b79427	92b7b550-4d8a-41e5-a00a-788a742e31c0
118	118	0	GBIF France	da44cd31-5901-4687-a106-6d1c7734ee3a	92cd366b-531d-478b-ad92-d2c346ac226c
252	252	0	GBIF Germany	4f6826f2-4ff6-443d-b966-e6913bd24013	92ee30e8-f762-11e1-a439-00145eb45e9a
2	2	0	GBIF Germany	4f6826f2-4ff6-443d-b966-e6913bd24013	93924f3e-f762-11e1-a439-00145eb45e9a
7	7	0	GBIF Germany	4f6826f2-4ff6-443d-b966-e6913bd24013	93ed2d46-f762-11e1-a439-00145eb45e9a
0	590	590	Colombian Biodiversity Information System	7e865cba-7c46-417b-ade5-97f2cf5b7be0	93f5f4ee-f582-4f43-b698-3980021da182
0	129557	129557	Ocean Biodiversity Information System	ba0670b9-4186-41e6-8e70-f9cb3065551a	96bb53c5-01ae-48fc-b5c2-26c549a50089
0	67	67	Colombian Biodiversity Information System	7e865cba-7c46-417b-ade5-97f2cf5b7be0	9830bc9d-de46-4500-b8fb-c184197034aa
5	5	0	Plazi	ffb07bec-2d10-492d-9c37-361fe0b79427	98ec7064-b44b-4189-a94d-0f615e62050b
0	3	3	Plazi	ffb07bec-2d10-492d-9c37-361fe0b79427	9b153288-07a7-4d4d-afee-b554e7956098
4930	4930	0	Participant Node Managers Committee	7f48e0c8-5c96-49ec-b972-30748e339115	9c30b6b3-177b-49f4-bfeb-91e1da24ecd4
114	114	0	National Biodiversity Network	d897a5b9-35ee-4232-94bd-b0bcaac003c2	9cf65d8e-f5ee-4e52-a88a-ab16c4bb78de
1748	1748	0	GBIF Germany	4f6826f2-4ff6-443d-b966-e6913bd24013	a0e2c619-55f5-4f28-a437-7bb8b1974f3c
5	5	0	Plazi	ffb07bec-2d10-492d-9c37-361fe0b79427	a1f1580f-0c8c-4811-a2e4-e18106b065ba
0	17	17	Plazi	ffb07bec-2d10-492d-9c37-361fe0b79427	a47cc407-dd54-4fc0-bd37-f1db30f37b24
0	16	16	Plazi	ffb07bec-2d10-492d-9c37-361fe0b79427	a5c57795-c8e2-4a5c-a9bf-1507344df8a4
7	7	0	Plazi	ffb07bec-2d10-492d-9c37-361fe0b79427	a6dcda0b-452e-43c3-9c84-a769ec073c42
0	685	685	Colombian Biodiversity Information System	7e865cba-7c46-417b-ade5-97f2cf5b7be0	a76afee5-56f7-4ccd-a359-c7c55956d9fc
62	62	0	Plazi	ffb07bec-2d10-492d-9c37-361fe0b79427	a92de231-d898-4cd1-b6ec-4e08287a3b67
12320	8512	-3808	GBIF Germany	4f6826f2-4ff6-443d-b966-e6913bd24013	aadb029a-4e87-4e3a-86ed-e93cc1f49369
0	24	24	Participant Node Managers Committee	7f48e0c8-5c96-49ec-b972-30748e339115	ab3fc902-60b0-4efb-a7f9-8fb415c56974
24	24	0	GBIF Japan	db5705aa-6a6e-42f1-8942-d77b9f4896ea	ac227953-5203-4a23-bfed-9d448211748c
1230	1230	0	GBIF Israel	8cb55387-7802-40e8-86d6-d357a583c596	ac7fa85b-c5fa-4ec1-ae29-5b6c70b2a53a
140	140	0	GBIF Sweden	a0b3be64-6525-4387-ac67-a499950f92e1	acca288a-3cfc-420b-a072-19fe1347baff
4	4	0	Plazi	ffb07bec-2d10-492d-9c37-361fe0b79427	af05b956-3ee4-40cc-8817-2c4077cdceab
11282	11282	0	National Biodiversity Network	d897a5b9-35ee-4232-94bd-b0bcaac003c2	b005b9fb-85ed-4950-b96c-6b200cf559d6
0	19	19	Plazi	ffb07bec-2d10-492d-9c37-361fe0b79427	b2f74aea-802a-48ea-95c5-36fb3f34bc82
606	606	0	Colombian Biodiversity Information System	7e865cba-7c46-417b-ade5-97f2cf5b7be0	b9d58ff4-ce6b-4d56-8287-3eb8361b3dc8
680	680	0	GBIF Uganda	71b40829-6a12-4c3d-8fee-5746f5e9cf8c	b9e46a41-3eac-4ad1-b6c1-ad09b7ba9c45
272	272	0	National Biodiversity Data Centre	422b00b2-6c94-4bb6-976b-c359916efdb8	bc52b3a0-c7b8-11de-b279-e0ae3d96e092
1	1	0	Plazi	ffb07bec-2d10-492d-9c37-361fe0b79427	bd59d82f-d7dd-477b-be36-854fa2512013
654	654	0	National Biodiversity Network	d897a5b9-35ee-4232-94bd-b0bcaac003c2	bf51c1f0-b4ff-47cb-add3-96b6ae7e8ea7
0	2	2	Plazi	ffb07bec-2d10-492d-9c37-361fe0b79427	c1708d79-189c-4e26-9b79-2baf694d26d7
0	2	2	Plazi	ffb07bec-2d10-492d-9c37-361fe0b79427	c29d923b-7987-4317-9822-ee89e4f6aff1
3	3	0	Plazi	ffb07bec-2d10-492d-9c37-361fe0b79427	c7e34905-41fb-4c55-ac80-4f62eef0a8f8
108	108	0	Plazi	ffb07bec-2d10-492d-9c37-361fe0b79427	c80bd1b6-a3cc-4c22-94fd-e231913ac8d5
7507	7507	0	Biodiversity Information System of Mexico	b324e8e9-9a4c-44fa-8f1a-7f39ea7ab576	c8a26d4e-b5a5-4dd9-9fff-7cd31779be93
20265	20265	0	Colombian Biodiversity Information System	7e865cba-7c46-417b-ade5-97f2cf5b7be0	cc5e1e3d-0850-4cde-a282-656657752e13
0	3	3	Participant Node Managers Committee	7f48e0c8-5c96-49ec-b972-30748e339115	cea0f6d1-2abb-47ba-bc10-8a7f53ddbe55
85	85	0	Colombian Biodiversity Information System	7e865cba-7c46-417b-ade5-97f2cf5b7be0	cf6ad89b-1cd6-4c62-9e92-2a8600425bd8
5	5	0	Plazi	ffb07bec-2d10-492d-9c37-361fe0b79427	cfdad3e6-ce41-4fae-b737-91c16d0b4632
0	6	6	Plazi	ffb07bec-2d10-492d-9c37-361fe0b79427	d01e415e-f8de-47ff-96f3-b9540c2f3504
23	23	0	Plazi	ffb07bec-2d10-492d-9c37-361fe0b79427	d2324e91-2793-440d-9456-27405a4c2fac
0	11	11	Plazi	ffb07bec-2d10-492d-9c37-361fe0b79427	d415ae04-415a-42c4-9db2-efd8b72fffcf
2	2	0	Plazi	ffb07bec-2d10-492d-9c37-361fe0b79427	d4305623-8b4d-4bf9-a57d-abe46cb2975d
124	124	0	GBIF Germany	4f6826f2-4ff6-443d-b966-e6913bd24013	d431798d-c432-41f3-98f4-a76b73f8b773
4	4	0	Plazi	ffb07bec-2d10-492d-9c37-361fe0b79427	d4a84d4a-1ff2-4786-9229-f8790e7091ab
4402	4402	0	GBIF Japan	db5705aa-6a6e-42f1-8942-d77b9f4896ea	d5cb0742-0160-49f7-b942-27292ee93969
35	35	0	Atlas of Living Australia	4a6f1b71-969e-4fc5-a693-282b05e1220c	d6cc1310-7aba-4c80-90ec-45cb395592cf
38668	38668	0	U.S. Geological Survey	8618c64a-93e0-4300-b546-7249e5148ed2	d762b508-7a70-441b-94ad-48fd77593275
88722	92838	4116	GBIF France	da44cd31-5901-4687-a106-6d1c7734ee3a	da6a07ed-9eee-460d-9448-910f542c1a7b
5	5	0	Plazi	ffb07bec-2d10-492d-9c37-361fe0b79427	db3f2d50-6dc5-4623-bbf7-07bafdbc3ee5
3	3	0	Plazi	ffb07bec-2d10-492d-9c37-361fe0b79427	dbd3ed30-fca5-4bce-ac48-0d778e1dc39c
582	582	0	GBIF Uganda	71b40829-6a12-4c3d-8fee-5746f5e9cf8c	dc250489-881a-49b4-9d58-89521b25ed2e
77	77	0	GBIF France	da44cd31-5901-4687-a106-6d1c7734ee3a	dc9fe9de-8abc-46d6-9238-f04e86c0aaca
0	37	37	Plazi	ffb07bec-2d10-492d-9c37-361fe0b79427	dd6866c0-c326-4347-8419-b2e688a89062
4115	4115	0	Biodiversity Information System of Mexico	b324e8e9-9a4c-44fa-8f1a-7f39ea7ab576	dd7e0efe-fbe8-4650-b0b8-fe7015c59d1c
166	166	0	Colombian Biodiversity Information System	7e865cba-7c46-417b-ade5-97f2cf5b7be0	e185fc08-7c31-4ebe-8f64-f3ead804dd90
0	835	835	Ocean Biodiversity Information System	ba0670b9-4186-41e6-8e70-f9cb3065551a	e274aa05-369b-4055-8336-62b5fc5e0860
85	85	0	GBIF Argentina	2426a871-9feb-40a1-96c6-0c593a76b835	e2d513b3-abf1-46bd-aef9-a14610ba08a9
0	780	780	Colombian Biodiversity Information System	7e865cba-7c46-417b-ade5-97f2cf5b7be0	e5eac53b-292f-40f2-bcd6-1da494207033
92766	126702	33936	U.S. Geological Survey	8618c64a-93e0-4300-b546-7249e5148ed2	e90a588b-0eed-4077-8a4f-7e61da35b3f8
278	278	0	GBIF France	da44cd31-5901-4687-a106-6d1c7734ee3a	e9259974-4dbb-4799-aad0-acc30fb55da6
278	278	0	National Biodiversity Network	d897a5b9-35ee-4232-94bd-b0bcaac003c2	edac2605-bbf8-4c9f-a80b-30927f21b896
818	818	0	GBIF Germany	4f6826f2-4ff6-443d-b966-e6913bd24013	f2c88ec8-50fc-472f-8b90-ae548d04b09e
0	7	7	Plazi	ffb07bec-2d10-492d-9c37-361fe0b79427	f571c633-612e-4cbc-95e3-6071482cf61f
0	66	66	Plazi	ffb07bec-2d10-492d-9c37-361fe0b79427	f8a1acf7-cc2d-4e6b-8f1d-3367bfcbabd9
2432	2432	0	National Biodiversity Network	d897a5b9-35ee-4232-94bd-b0bcaac003c2	f8fc226c-18ee-4cbd-a368-50348ed02124
0	6	6	Plazi	ffb07bec-2d10-492d-9c37-361fe0b79427	f94ef047-c4e2-4bfb-a75c-058388dcc8eb
0	33	33	Ocean Biodiversity Information System	ba0670b9-4186-41e6-8e70-f9cb3065551a	fa939ded-6b94-4bee-9d4e-ef0be0287cee
100	100	0	U.S. Geological Survey	8618c64a-93e0-4300-b546-7249e5148ed2	fa9940cd-4d70-493f-81ad-f4fa80495a6a
0	129	129	Plazi	ffb07bec-2d10-492d-9c37-361fe0b79427	fbb326c8-8f97-44f4-a648-ec9f935ee293
13	13	0	Plazi	ffb07bec-2d10-492d-9c37-361fe0b79427	fbbbe27e-4b65-497a-b0a9-bc8674251d6f
0	61	61	Colombian Biodiversity Information System	7e865cba-7c46-417b-ade5-97f2cf5b7be0	fc390012-d34f-47b9-8889-8c378f675058
206	206	0	Participant Node Managers Committee	7f48e0c8-5c96-49ec-b972-30748e339115	fd7e75a3-174b-4ebf-9fab-e69cef2a35e5
7	7	0	Plazi	ffb07bec-2d10-492d-9c37-361fe0b79427	fec6f37f-b17e-4cf7-8688-0b0896be8e9b
139	139	0	U.S. Geological Survey	8618c64a-93e0-4300-b546-7249e5148ed2	026508fe-4d89-48c9-91e3-ea9ae5baa484
0	19220	19220	GBIF Norway	4f829580-180d-46a9-9c87-ed8ec959b545	02f57aa9-12ae-4c8c-9d9f-f8b3245cf31a
1470	1470	0	South African Biodiversity Information Facility	7190b835-4e86-4b6e-85c1-19cc6677c250	0582ce1f-fd36-4971-8f6f-4c10fce9e8f8
34	34	0	Participant Node Managers Committee	7f48e0c8-5c96-49ec-b972-30748e339115	0751b002-8da2-436d-981f-a02ac44783bf
0	3	3	Plazi	ffb07bec-2d10-492d-9c37-361fe0b79427	0bf4c020-2726-4d2a-aff0-7a5164aae728
0	129	129	Plazi	ffb07bec-2d10-492d-9c37-361fe0b79427	1139acad-4f50-4a53-b4b3-6d55d7363f06
402	402	0	Plazi	ffb07bec-2d10-492d-9c37-361fe0b79427	1386b8e6-b03e-43dc-b6f7-2295814ab8b2
0	2	2	Plazi	ffb07bec-2d10-492d-9c37-361fe0b79427	16e5823d-f3a2-456b-beed-30de97c87230
810	810	0	GBIF Germany	4f6826f2-4ff6-443d-b966-e6913bd24013	17b34187-b993-41d4-a234-47cbc826a6a8
53	53	0	GBIF Norway	4f829580-180d-46a9-9c87-ed8ec959b545	17f79205-db87-4c0e-9a35-fcd26cbe3755
131	131	0	GBIF Japan	db5705aa-6a6e-42f1-8942-d77b9f4896ea	196d4689-8cfc-40e3-adf8-0e9b35c513c1
52	52	0	Plazi	ffb07bec-2d10-492d-9c37-361fe0b79427	1b6492a4-da08-453c-942f-7bd80815962b
80	80	0	GBIF France	da44cd31-5901-4687-a106-6d1c7734ee3a	1c713e5f-3d61-42d9-922c-45e6feab853b
3535	3535	0	Colombian Biodiversity Information System	7e865cba-7c46-417b-ade5-97f2cf5b7be0	1ccde8b1-a675-4208-ad70-9c0dfb6b7abc
0	4	4	Plazi	ffb07bec-2d10-492d-9c37-361fe0b79427	1d585192-b93c-4b42-b63b-a834bbb23e27
4	4	0	Plazi	ffb07bec-2d10-492d-9c37-361fe0b79427	217068cd-a4a7-44ca-b765-c278fd3bbfcf
0	1	1	Plazi	ffb07bec-2d10-492d-9c37-361fe0b79427	243d3880-9e54-493f-92c3-fc7eefc5e7c7
17	17	0	GBIF Guinea	b1cd2e84-c4ba-47bd-b72a-dfd1f92dce0a	244de083-48f9-4000-b8bf-8988e5d063aa
0	109	109	Ocean Biodiversity Information System	ba0670b9-4186-41e6-8e70-f9cb3065551a	262dab2f-89b6-409e-8268-72ca452c5ae5
110	110	0	Plazi	ffb07bec-2d10-492d-9c37-361fe0b79427	264fca2e-af6c-427c-8edd-853280f9b607
0	215	215	Plazi	ffb07bec-2d10-492d-9c37-361fe0b79427	2b8d4fa0-557a-4d9c-a11e-c87fbe3a3cf8
24	24	0	Plazi	ffb07bec-2d10-492d-9c37-361fe0b79427	2e85af1d-8c73-498a-a572-ee29db2ffdf5
1854	1854	0	GBIF Norway	4f829580-180d-46a9-9c87-ed8ec959b545	2f2c251e-a69f-444b-af7e-6b7ad808f74f
7169	7169	0	Polish Biodiversity Information Network	2618bfdf-e194-4911-a241-80db3107bc51	31f53a30-9169-11db-9f6d-b8a03c50a862
1	1	0	Plazi	ffb07bec-2d10-492d-9c37-361fe0b79427	375cee24-65e7-49f8-b2f1-42c4a24934c3
9837	9837	0	Ocean Biodiversity Information System	ba0670b9-4186-41e6-8e70-f9cb3065551a	376d3822-d7f9-463a-a8fd-03f16892c8be
1	1	0	Plazi	ffb07bec-2d10-492d-9c37-361fe0b79427	37a397a9-1193-4ad9-b060-3fbcd340e923
0	8195	8195	Belgian Biodiversity Platform	fb11cfe1-ebc3-45af-9159-17d9fddbcdac	385ceabb-2f71-4baf-8623-ae25ff6dcda2
228	228	0	GBIF Germany	4f6826f2-4ff6-443d-b966-e6913bd24013	3961c11a-9b90-4bc6-9142-3d2f88186bb6
3	3	0	Plazi	ffb07bec-2d10-492d-9c37-361fe0b79427	3ae49396-1d0d-41ad-ae0a-c5e99af3c0af
0	6842	6842	East Asia Biodiversity Conservation Network	06139ec9-4933-4f4e-8151-1d36ad9ae171	3bbc8dfd-d4c5-4573-a549-a22d5312b790
2226	2226	0	National Biodiversity Network	d897a5b9-35ee-4232-94bd-b0bcaac003c2	3e08f988-ceaa-454a-b275-df12f77ca9dc
21	21	0	Participant Node Managers Committee	7f48e0c8-5c96-49ec-b972-30748e339115	3e58d2f8-36b0-4856-9169-a65e127eb5ba
2	2	0	Plazi	ffb07bec-2d10-492d-9c37-361fe0b79427	3f01a867-8b43-446c-83f8-aa2dc2e6d682
0	5	5	Participant Node Managers Committee	7f48e0c8-5c96-49ec-b972-30748e339115	3f254e70-d5a0-4871-8c28-30a2004db17d
0	14	14	Ocean Biodiversity Information System	ba0670b9-4186-41e6-8e70-f9cb3065551a	41e59d9a-0f95-4140-8764-5bae3e32e085
4	4	0	Plazi	ffb07bec-2d10-492d-9c37-361fe0b79427	435f32ef-0710-4429-ba79-2fb0da57a79f
6146	6146	0	GBIF Benin	efb9c00e-f802-45dd-8826-a52ec45b89ff	441c8c19-d61b-4d2b-aa90-26031d337366
164923	164923	0	U.S. Geological Survey	8618c64a-93e0-4300-b546-7249e5148ed2	44bcde48-ac71-46f2-bf73-24fc3c008b6c
282	282	0	Atlas of Living Australia	4a6f1b71-969e-4fc5-a693-282b05e1220c	46881d90-bf4d-49f4-bbb5-a1af323e00d3
5372	5364	-8	U.S. Geological Survey	8618c64a-93e0-4300-b546-7249e5148ed2	4837d6b0-19fe-4fe4-9ddf-b62dd17a060e
10744	10744	0	National Biodiversity Network	d897a5b9-35ee-4232-94bd-b0bcaac003c2	4bc14221-60af-43e5-8e92-0c2b262b9945
0	1	1	Plazi	ffb07bec-2d10-492d-9c37-361fe0b79427	514be374-fa52-45ab-abd1-d21e21d4496b
0	20	20	Plazi	ffb07bec-2d10-492d-9c37-361fe0b79427	52a44564-8315-48cc-8506-e2f040355735
308	308	0	Colombian Biodiversity Information System	7e865cba-7c46-417b-ade5-97f2cf5b7be0	5355d3bf-9225-455b-9a54-5b2524b15287
158171	158171	0	U.S. Geological Survey	8618c64a-93e0-4300-b546-7249e5148ed2	5378e1cf-522d-4469-8776-b709579b4a3e
0	1689	1689	Ocean Biodiversity Information System	ba0670b9-4186-41e6-8e70-f9cb3065551a	567afc7d-bc80-465a-beed-13dac452a73e
0	2	2	Plazi	ffb07bec-2d10-492d-9c37-361fe0b79427	5a13b875-12b3-4def-a8e3-abcc8ea2c7d9
6	6	0	Plazi	ffb07bec-2d10-492d-9c37-361fe0b79427	5b78366e-1b6c-4154-ad68-bd9f7e70a536
24	24	0	Plazi	ffb07bec-2d10-492d-9c37-361fe0b79427	5bf69a45-52b6-41ac-bbf1-fb88679d00d9
362	408	46	GBIF Japan	db5705aa-6a6e-42f1-8942-d77b9f4896ea	5dbe754a-7acd-43de-ae4c-ed563437937f
7696	7696	0	National Biodiversity Network	d897a5b9-35ee-4232-94bd-b0bcaac003c2	6054f489-147b-4168-acbc-805f4158383b
1	1	0	Plazi	ffb07bec-2d10-492d-9c37-361fe0b79427	60a61c3a-2eea-4deb-83c8-1ca90dd5e983
18	18	0	GBIF Germany	4f6826f2-4ff6-443d-b966-e6913bd24013	61cc298e-f762-11e1-a439-00145eb45e9a
159	159	0	GBIF New Zealand	4f9fd726-20dd-445e-89a1-8ed93792276f	620d16d3-6e0c-4a95-ab33-3dd574aa92c8
305	305	0	GBIF Germany	4f6826f2-4ff6-443d-b966-e6913bd24013	6373dcf0-f762-11e1-a439-00145eb45e9a
103	103	0	GBIF Germany	4f6826f2-4ff6-443d-b966-e6913bd24013	63d17608-f762-11e1-a439-00145eb45e9a
72	72	0	GBIF Germany	4f6826f2-4ff6-443d-b966-e6913bd24013	668e7206-f762-11e1-a439-00145eb45e9a
2063	2063	0	National Biodiversity Network	d897a5b9-35ee-4232-94bd-b0bcaac003c2	67bb72d9-267e-48fc-bb1c-858025c2f832
390	390	0	GBIF Germany	4f6826f2-4ff6-443d-b966-e6913bd24013	691e83b2-f762-11e1-a439-00145eb45e9a
12	12	0	Plazi	ffb07bec-2d10-492d-9c37-361fe0b79427	69cd7636-9ec1-4c3b-98ce-d6ce90bc7042
75	75	0	GBIF Germany	4f6826f2-4ff6-443d-b966-e6913bd24013	6a9ebfc2-f762-11e1-a439-00145eb45e9a
42	42	0	GBIF Germany	4f6826f2-4ff6-443d-b966-e6913bd24013	6aafccea-f762-11e1-a439-00145eb45e9a
16	16	0	GBIF Germany	4f6826f2-4ff6-443d-b966-e6913bd24013	6afd6a68-f762-11e1-a439-00145eb45e9a
16	16	0	GBIF Germany	4f6826f2-4ff6-443d-b966-e6913bd24013	6b01741e-f762-11e1-a439-00145eb45e9a
4	4	0	GBIF Germany	4f6826f2-4ff6-443d-b966-e6913bd24013	6b61ff32-f762-11e1-a439-00145eb45e9a
10	10	0	GBIF Germany	4f6826f2-4ff6-443d-b966-e6913bd24013	6c03fe0e-f762-11e1-a439-00145eb45e9a
44	44	0	GBIF Germany	4f6826f2-4ff6-443d-b966-e6913bd24013	6d39e8a6-f762-11e1-a439-00145eb45e9a
2	2	0	Plazi	ffb07bec-2d10-492d-9c37-361fe0b79427	6d6ea0e4-8a8e-49c0-9853-a378a06dba74
7	7	0	GBIF Germany	4f6826f2-4ff6-443d-b966-e6913bd24013	6f8a32c8-f762-11e1-a439-00145eb45e9a
4434	4434	0	National Biodiversity Data Centre	422b00b2-6c94-4bb6-976b-c359916efdb8	7106ea48-649c-484f-bf99-39837959287c
136	136	0	GBIF Germany	4f6826f2-4ff6-443d-b966-e6913bd24013	71bade1c-f762-11e1-a439-00145eb45e9a
157	157	0	GBIF Germany	4f6826f2-4ff6-443d-b966-e6913bd24013	71e0f48d-4e0c-4235-b755-607d5ef12d1e
24	24	0	GBIF Germany	4f6826f2-4ff6-443d-b966-e6913bd24013	7201c5f2-f762-11e1-a439-00145eb45e9a
516	516	0	GBIF Germany	4f6826f2-4ff6-443d-b966-e6913bd24013	73354b24-f762-11e1-a439-00145eb45e9a
3	3	0	GBIF Germany	4f6826f2-4ff6-443d-b966-e6913bd24013	73653e4c-f762-11e1-a439-00145eb45e9a
23	23	0	GBIF Germany	4f6826f2-4ff6-443d-b966-e6913bd24013	73bc0fa6-f762-11e1-a439-00145eb45e9a
991	991	0	GBIF France	da44cd31-5901-4687-a106-6d1c7734ee3a	7479a971-a940-40a2-b40e-4434573fe4c3
28	28	0	GBIF Germany	4f6826f2-4ff6-443d-b966-e6913bd24013	74ad5276-f762-11e1-a439-00145eb45e9a
46	43	-3	GBIF Germany	4f6826f2-4ff6-443d-b966-e6913bd24013	758702b4-f762-11e1-a439-00145eb45e9a
0	19	19	Plazi	ffb07bec-2d10-492d-9c37-361fe0b79427	759d42e0-6739-4f1c-bd23-fb3f4d88b89e
116	116	0	GBIF Germany	4f6826f2-4ff6-443d-b966-e6913bd24013	75b3880c-f762-11e1-a439-00145eb45e9a
214	214	0	GBIF Germany	4f6826f2-4ff6-443d-b966-e6913bd24013	75d8d88c-f762-11e1-a439-00145eb45e9a
4	4	0	Plazi	ffb07bec-2d10-492d-9c37-361fe0b79427	764b09b3-7645-431a-ae1f-18f0a37726f3
5	5	0	Plazi	ffb07bec-2d10-492d-9c37-361fe0b79427	77690e3f-3f08-490a-b0e8-0bbcac1fa05c
4	4	0	Colombian Biodiversity Information System	7e865cba-7c46-417b-ade5-97f2cf5b7be0	7769142c-903a-4648-8aa2-d7e8eaf394e8
7	7	0	Plazi	ffb07bec-2d10-492d-9c37-361fe0b79427	77f10a08-3baa-4944-812c-80051e816748
1133	874	-259	GBIF Germany	4f6826f2-4ff6-443d-b966-e6913bd24013	79582f44-f762-11e1-a439-00145eb45e9a
3077	3077	0	National Biodiversity Network	d897a5b9-35ee-4232-94bd-b0bcaac003c2	79c59307-5753-4ad6-a1a3-44e920a91bb3
215	215	0	Korean Biodiversity Information Facility	e0a1e772-0177-4800-94b4-2d023fe6cdf4	7aecd33c-f762-11e1-a439-00145eb45e9a
9	9	0	Plazi	ffb07bec-2d10-492d-9c37-361fe0b79427	7b722f40-e6b4-4b77-aa83-303b0050df5e
2398	2398	0	GBIF Germany	4f6826f2-4ff6-443d-b966-e6913bd24013	7c79aa18-f762-11e1-a439-00145eb45e9a
23	23	0	GBIF Germany	4f6826f2-4ff6-443d-b966-e6913bd24013	7cfcf058-f762-11e1-a439-00145eb45e9a
2310	756	-1554	GBIF Germany	4f6826f2-4ff6-443d-b966-e6913bd24013	7d9c5eb8-f762-11e1-a439-00145eb45e9a
144	144	0	GBIF Germany	4f6826f2-4ff6-443d-b966-e6913bd24013	7de73154-f762-11e1-a439-00145eb45e9a
211	211	0	GBIF France	da44cd31-5901-4687-a106-6d1c7734ee3a	7e78adf1-dec0-4309-84cb-c80fbb305a76
1347	1347	0	GBIF Germany	4f6826f2-4ff6-443d-b966-e6913bd24013	7f010902-f762-11e1-a439-00145eb45e9a
10157	10157	0	Biodiversity Information System of Mexico	b324e8e9-9a4c-44fa-8f1a-7f39ea7ab576	800ea6f6-f762-11e1-a439-00145eb45e9a
196	196	0	Biodiversity Information System of Mexico	b324e8e9-9a4c-44fa-8f1a-7f39ea7ab576	804d6fee-f762-11e1-a439-00145eb45e9a
366	366	0	GBIF Switzerland	169eb292-376b-4cc6-8e31-9c2c432de0ad	82b0f51c-f762-11e1-a439-00145eb45e9a
1	1	0	Plazi	ffb07bec-2d10-492d-9c37-361fe0b79427	8405f201-4366-4ec6-9265-a67cf04b3402
10760	10760	0	Canada Biodiversity Information Facility	8f83fc96-c966-4126-83f7-bf044dc49efa	8471a720-f762-11e1-a439-00145eb45e9a
1645	1645	0	World Federation for Culture Collections	a6bdc523-5368-4e0f-9d2e-de1c262ac092	855e1074-f762-11e1-a439-00145eb45e9a
683018	683018	0	Bioversity International	b8a5be24-9225-4ba5-b664-159308a4b537	85818aea-f762-11e1-a439-00145eb45e9a
176	176	0	GBIF Pakistan	e3715f62-66fe-4ecc-8c9e-7531ed0bd14c	8654a006-f762-11e1-a439-00145eb45e9a
445	445	0	National Biodiversity Network	d897a5b9-35ee-4232-94bd-b0bcaac003c2	86653843-d46c-4924-9cbe-34737366a5b3
0	4	4	Plazi	ffb07bec-2d10-492d-9c37-361fe0b79427	8872c843-c80e-4644-a9d4-71ebf26a550b
11	11	0	GBIF Germany	4f6826f2-4ff6-443d-b966-e6913bd24013	8883b074-f762-11e1-a439-00145eb45e9a
182	182	0	GBIF Germany	4f6826f2-4ff6-443d-b966-e6913bd24013	89399024-f762-11e1-a439-00145eb45e9a
5783	5783	0	GBIF Slovenia	53e3f6b9-81f8-41e3-9e51-2666a5e0ae6a	8958b49a-f762-11e1-a439-00145eb45e9a
212	212	0	GBIF Germany	4f6826f2-4ff6-443d-b966-e6913bd24013	897d23e8-f762-11e1-a439-00145eb45e9a
571	571	0	GBIF Germany	4f6826f2-4ff6-443d-b966-e6913bd24013	89d2b04c-f762-11e1-a439-00145eb45e9a
167	167	0	GBIF Germany	4f6826f2-4ff6-443d-b966-e6913bd24013	8ac85056-f762-11e1-a439-00145eb45e9a
0	15327	15327	Colombian Biodiversity Information System	7e865cba-7c46-417b-ade5-97f2cf5b7be0	8c145caa-8dca-40e6-b082-741e0d6b8f83
42	24	-18	GBIF Germany	4f6826f2-4ff6-443d-b966-e6913bd24013	8d06729e-f762-11e1-a439-00145eb45e9a
4	1	-3	GBIF Germany	4f6826f2-4ff6-443d-b966-e6913bd24013	8d16f9a2-f762-11e1-a439-00145eb45e9a
13	8	-5	GBIF Germany	4f6826f2-4ff6-443d-b966-e6913bd24013	8dc58396-f762-11e1-a439-00145eb45e9a
0	76	76	Plazi	ffb07bec-2d10-492d-9c37-361fe0b79427	8ddfacbb-c42b-4385-b70b-ea5bd759c377
46	33	-13	GBIF Germany	4f6826f2-4ff6-443d-b966-e6913bd24013	8e1a7450-f762-11e1-a439-00145eb45e9a
12	12	0	GBIF Germany	4f6826f2-4ff6-443d-b966-e6913bd24013	8efba1c8-f762-11e1-a439-00145eb45e9a
0	152	152	Colombian Biodiversity Information System	7e865cba-7c46-417b-ade5-97f2cf5b7be0	8f17d468-0a66-422b-9eb7-bfe195ebd2e6
1627	1627	0	Albertine Rift Conservation Society	90a939d3-e99c-4f6d-915f-2616423b3735	8fbdc3e6-eaa0-4ad8-8733-ad433976a448
7	4	-3	GBIF Germany	4f6826f2-4ff6-443d-b966-e6913bd24013	904c3f92-f762-11e1-a439-00145eb45e9a
0	14712	14712	GBIF Spain	1f94b3ca-9345-4d65-afe2-4bace93aa0fe	90cc5e31-5b36-4814-abc6-205cb3beb92c
134	134	0	Plazi	ffb07bec-2d10-492d-9c37-361fe0b79427	91537cca-a1d8-4ff3-9023-fba938ccc846
10	4	-6	GBIF Germany	4f6826f2-4ff6-443d-b966-e6913bd24013	91909e5c-f762-11e1-a439-00145eb45e9a
0	4635	4635	Ocean Biodiversity Information System	ba0670b9-4186-41e6-8e70-f9cb3065551a	91a26b5b-8cc6-490a-a1bc-bf37e672ac72
59	60	1	GBIF Germany	4f6826f2-4ff6-443d-b966-e6913bd24013	92d894d6-f762-11e1-a439-00145eb45e9a
247	247	0	Plazi	ffb07bec-2d10-492d-9c37-361fe0b79427	9314cc58-f79b-4a7e-b6d4-3955d0824401
0	4	4	Ocean Biodiversity Information System	ba0670b9-4186-41e6-8e70-f9cb3065551a	938ef872-7f29-488a-b2cf-a0095fed1d18
624	624	0	GBIF Germany	4f6826f2-4ff6-443d-b966-e6913bd24013	9417978e-f762-11e1-a439-00145eb45e9a
70	70	0	Atlas of Living Australia	4a6f1b71-969e-4fc5-a693-282b05e1220c	95e29b40-f762-11e1-a439-00145eb45e9a
20	20	0	GBIF Germany	4f6826f2-4ff6-443d-b966-e6913bd24013	9763ea6e-f762-11e1-a439-00145eb45e9a
0	11	11	Plazi	ffb07bec-2d10-492d-9c37-361fe0b79427	97d9d905-b4c2-4be0-9886-eb21c200d2b8
555	555	0	Biodiversity Information System of Mexico	b324e8e9-9a4c-44fa-8f1a-7f39ea7ab576	985eec8a-e9e3-4117-8231-fdebe0634a90
5	5	0	Plazi	ffb07bec-2d10-492d-9c37-361fe0b79427	98d54212-95e2-4a33-8c03-a9ab7b4aab9b
7158	7158	0	National Biodiversity Network	d897a5b9-35ee-4232-94bd-b0bcaac003c2	996ba8be-13a1-4361-9c37-559f9ea58399
854	854	0	National Biodiversity Network	d897a5b9-35ee-4232-94bd-b0bcaac003c2	999a3480-0c0f-4aeb-8627-38f913b6c2b8
9002	9002	0	National Biodiversity Network	d897a5b9-35ee-4232-94bd-b0bcaac003c2	9b2ee681-59b3-43d1-9872-2bdaf619fc2b
18246	18246	0	GBIF France	da44cd31-5901-4687-a106-6d1c7734ee3a	9cddd069-9d94-43fc-83ce-07ea99874346
0	11	11	Plazi	ffb07bec-2d10-492d-9c37-361fe0b79427	9dea5a78-3d8a-4900-bb4e-3f9560fe3ef6
30207	30207	0	Korean Biodiversity Information Facility	e0a1e772-0177-4800-94b4-2d023fe6cdf4	9e055800-e83e-4769-82c2-a0602bf3d4b9
37	37	0	Plazi	ffb07bec-2d10-492d-9c37-361fe0b79427	a141fa76-cc88-4901-944a-306171e41413
0	1	1	Plazi	ffb07bec-2d10-492d-9c37-361fe0b79427	a20dc041-9fac-4659-a6a8-ce4791cdd81c
41	41	0	Plazi	ffb07bec-2d10-492d-9c37-361fe0b79427	a3eb6b94-cade-4698-a578-f3310af2b3e1
242	242	0	South African Biodiversity Information Facility	7190b835-4e86-4b6e-85c1-19cc6677c250	a46be9dd-adc0-4422-8cb5-467fb5d9a3d4
1	1	0	Participant Node Managers Committee	7f48e0c8-5c96-49ec-b972-30748e339115	a559a528-6b83-4818-81f6-939708b85bc2
159	159	0	GBIF France	da44cd31-5901-4687-a106-6d1c7734ee3a	a5a803d2-c6eb-486b-b806-7a93434baffb
7032	7032	0	GBIF Norway	4f829580-180d-46a9-9c87-ed8ec959b545	a60ba16c-b79d-4de5-b697-7bc1df464529
286	285	-1	GBIF Germany	4f6826f2-4ff6-443d-b966-e6913bd24013	a65e824b-9189-491e-8e7d-8473570d1905
3497	4263	766	National Biodiversity Network	d897a5b9-35ee-4232-94bd-b0bcaac003c2	a7c1e188-5a04-47fb-8fe1-6a3bcbb1b98c
0	1	1	Plazi	ffb07bec-2d10-492d-9c37-361fe0b79427	ab05a0bd-5d5c-4175-a2c8-61a10cf04d08
0	2	2	Plazi	ffb07bec-2d10-492d-9c37-361fe0b79427	abdb5ee1-9745-432e-86ca-b4b341136678
0	62	62	Plazi	ffb07bec-2d10-492d-9c37-361fe0b79427	ac540bdb-8587-411a-8ab1-a2115525c618
22	22	0	Plazi	ffb07bec-2d10-492d-9c37-361fe0b79427	ac8dfde6-c270-402e-835d-cd37633fdfca
9	9	0	Plazi	ffb07bec-2d10-492d-9c37-361fe0b79427	af825f01-156e-4a46-9626-f285833d202e
101	101	0	Plazi	ffb07bec-2d10-492d-9c37-361fe0b79427	b12d6994-cac1-454f-be24-3eaeaeec7166
1	1	0	Plazi	ffb07bec-2d10-492d-9c37-361fe0b79427	b40ac715-4b38-420e-9218-8e2f03f6f7f5
11339	11339	0	National Biodiversity Network	d897a5b9-35ee-4232-94bd-b0bcaac003c2	b72a2bea-f329-4ada-addc-b2147b5059b0
123	123	0	GBIF France	da44cd31-5901-4687-a106-6d1c7734ee3a	bb8c8cc6-0af4-4155-8ffd-221f916de988
30	30	0	Plazi	ffb07bec-2d10-492d-9c37-361fe0b79427	bc040c13-0b57-44fc-9a7f-c236756231b3
24	24	0	Plazi	ffb07bec-2d10-492d-9c37-361fe0b79427	bdee0f31-fe1b-4ecc-9c4f-e4db6be3152c
232	232	0	National Biodiversity Network	d897a5b9-35ee-4232-94bd-b0bcaac003c2	bee4da22-e049-4085-a4ec-20174849bc44
0	542	542	Plazi	ffb07bec-2d10-492d-9c37-361fe0b79427	bf24ff1f-569a-4222-afe1-8527c83d8003
1490	1490	0	Biodiversity Information System of Mexico	b324e8e9-9a4c-44fa-8f1a-7f39ea7ab576	c065ec9e-e74f-463b-97d3-5c5fab5b0700
2	2	0	Plazi	ffb07bec-2d10-492d-9c37-361fe0b79427	c2dff4ed-1d3e-479b-ad7a-883bd6bacb86
629671	629666	-5	National Biodiversity Network	d897a5b9-35ee-4232-94bd-b0bcaac003c2	c3c56ab1-706c-4e7f-85f8-f6f860e203f2
0	17	17	Plazi	ffb07bec-2d10-492d-9c37-361fe0b79427	c3c8e635-5111-4051-9dd8-dc00f8595b87
0	8345	8345	Participant Node Managers Committee	7f48e0c8-5c96-49ec-b972-30748e339115	c880ef4f-dead-4fc6-ad6a-5c9929d5a9df
797	595	-202	GBIF Germany	4f6826f2-4ff6-443d-b966-e6913bd24013	cc22fdf0-4a65-4a29-ab6f-1cbd000bb144
95	95	0	GBIF Finland	dd514216-5c7c-45f3-910d-797424cb5be6	cc9fbdfd-9211-494c-b36e-dbd446c70b01
0	1	1	Plazi	ffb07bec-2d10-492d-9c37-361fe0b79427	cdda6583-c457-44cf-8128-e6a17e39433c
73	73	0	Plazi	ffb07bec-2d10-492d-9c37-361fe0b79427	cf4afb1e-da33-46d0-a3de-3e5092b4de01
0	21	21	Plazi	ffb07bec-2d10-492d-9c37-361fe0b79427	dcb72bb7-896e-44b1-bd40-21f311643008
639	639	0	GBIF France	da44cd31-5901-4687-a106-6d1c7734ee3a	ddaf56d8-8d92-457e-b4c4-62a2802672f6
1252	1252	0	National Biodiversity Network	d897a5b9-35ee-4232-94bd-b0bcaac003c2	e336c199-0a34-4a59-b991-9dbb8b10ca26
33	33	0	Plazi	ffb07bec-2d10-492d-9c37-361fe0b79427	e3ac0934-a6ef-4a3e-b3d5-606c348e73dc
3	3	0	Plazi	ffb07bec-2d10-492d-9c37-361fe0b79427	e5646187-d56d-4e50-9cb9-9104a026b833
2	2	0	Plazi	ffb07bec-2d10-492d-9c37-361fe0b79427	e67b87e9-2476-498d-a686-2e92f50dbdee
2020	2020	0	Colombian Biodiversity Information System	7e865cba-7c46-417b-ade5-97f2cf5b7be0	e7753fee-b13d-4e6d-85c7-d85ddeeefef6
0	2	2	Plazi	ffb07bec-2d10-492d-9c37-361fe0b79427	e775e4a9-160b-4f44-bb30-2a439b2df873
2	2	0	Plazi	ffb07bec-2d10-492d-9c37-361fe0b79427	e9c8de3b-29ac-47e7-98de-3c62d709d52a
12	12	0	Plazi	ffb07bec-2d10-492d-9c37-361fe0b79427	eb3a7406-3dae-4b7b-85cc-d53a1ec73b04
0	1	1	Plazi	ffb07bec-2d10-492d-9c37-361fe0b79427	f1163bf4-9ad7-4515-a885-c77d79115fc8
2000	2000	0	Participant Node Managers Committee	7f48e0c8-5c96-49ec-b972-30748e339115	f1f71b62-12c3-4d76-8b7f-2234153b8f15
2	2	0	Plazi	ffb07bec-2d10-492d-9c37-361fe0b79427	f37631bf-3efe-4ebe-af46-986e044eb693
0	102	102	Participant Node Managers Committee	7f48e0c8-5c96-49ec-b972-30748e339115	f436cbeb-8000-43a6-8473-2227cdba4516
7	7	0	Plazi	ffb07bec-2d10-492d-9c37-361fe0b79427	f492ad9b-a83d-4d8e-bdf9-20ef759b75c1
1	1	0	Plazi	ffb07bec-2d10-492d-9c37-361fe0b79427	f9d4e0e3-9e60-47c5-9ad0-b1339758d187
504	504	0	Colombian Biodiversity Information System	7e865cba-7c46-417b-ade5-97f2cf5b7be0	fbaea48e-35ff-490c-a108-20ae943ea03f
0	2	2	Plazi	ffb07bec-2d10-492d-9c37-361fe0b79427	fbde24ea-866d-417a-a800-e9a690ad3317
1	1	0	Atlas of Living Australia	4a6f1b71-969e-4fc5-a693-282b05e1220c	fce24703-ad84-453c-8b52-f0763eb71d2d
990	990	0	GBIF Argentina	2426a871-9feb-40a1-96c6-0c593a76b835	fcefd388-fcf1-49ee-9410-da0e6f811a41
38	38	0	Plazi	ffb07bec-2d10-492d-9c37-361fe0b79427	ff3a6b3a-471b-4cec-ac1c-9bdc40131802
34	34	0	Plazi	ffb07bec-2d10-492d-9c37-361fe0b79427	01acc338-bb99-4ab9-bb38-9fe4453d2eb4
4944	4944	0	GBIF Brazil	cdc9736d-5ff7-4ece-9959-3c744360cdb3	02faa0b5-13d0-48d0-8479-757c496ac6a5
16448	16445	-3	National Biodiversity Network	d897a5b9-35ee-4232-94bd-b0bcaac003c2	07609307-26f9-490f-89ea-4e74497e3c0d
5	5	0	Plazi	ffb07bec-2d10-492d-9c37-361fe0b79427	077db1be-027c-4393-bcaf-94397b0e5dec
2	2	0	Plazi	ffb07bec-2d10-492d-9c37-361fe0b79427	08bf274e-c590-462f-8d09-6c965a303c5a
4	4	0	Plazi	ffb07bec-2d10-492d-9c37-361fe0b79427	0b398d4f-281a-411a-a6b1-594366399e7f
15	15	0	GBIF France	da44cd31-5901-4687-a106-6d1c7734ee3a	0c816b1f-0f18-4899-8684-cc645d89c4b6
0	6114	6114	Ocean Biodiversity Information System	ba0670b9-4186-41e6-8e70-f9cb3065551a	0d697041-98bf-47ca-a95c-33f8e5a6d8b7
57	57	0	Plazi	ffb07bec-2d10-492d-9c37-361fe0b79427	0ec981e7-8ef8-4b1a-b1a4-2380e6583cce
11192	11192	0	National Biodiversity Network	d897a5b9-35ee-4232-94bd-b0bcaac003c2	116f7655-c1cc-475e-a567-2f5f2b358f73
41	41	0	GBIF Sweden	a0b3be64-6525-4387-ac67-a499950f92e1	12effb89-3275-4fca-ae70-a62ba998ca8b
0	55	55	Plazi	ffb07bec-2d10-492d-9c37-361fe0b79427	13846ea1-7b83-4f5e-9690-acc423f5a086
103	103	0	Plazi	ffb07bec-2d10-492d-9c37-361fe0b79427	16fd41f9-a7b3-4075-bea3-fbde425155c0
524	524	0	GBIF Uruguay	a3ceb6dd-0a65-4f30-a385-30f6937c2096	17d66199-d8d3-431a-a8c4-9ff9cde9425c
712	712	0	GBIF France	da44cd31-5901-4687-a106-6d1c7734ee3a	1ad1c7e8-8136-40a9-b21e-9b8291da7382
0	234	234	Plazi	ffb07bec-2d10-492d-9c37-361fe0b79427	1ad9a0ab-ccd4-4047-9a29-f2dd287dc3e3
7	7	0	Plazi	ffb07bec-2d10-492d-9c37-361fe0b79427	1b582aa9-0afa-47c9-a574-c7d6dad03b19
2	2	0	Plazi	ffb07bec-2d10-492d-9c37-361fe0b79427	1d9a3bc7-33d3-4bc5-a633-bb054aebd38e
0	1	1	Plazi	ffb07bec-2d10-492d-9c37-361fe0b79427	1f3dfc25-364e-480e-88bf-79c4c8cac278
99	99	0	Plazi	ffb07bec-2d10-492d-9c37-361fe0b79427	24f01fb7-9777-4a53-94d6-71a7a926267a
12202	12202	0	National Biodiversity Network	d897a5b9-35ee-4232-94bd-b0bcaac003c2	26aa44a9-6842-4adb-87b9-f60a17105f2e
2	2	0	Plazi	ffb07bec-2d10-492d-9c37-361fe0b79427	2728c080-5a96-4c30-9a77-a0a9655106bb
186	186	0	GBIF Japan	db5705aa-6a6e-42f1-8942-d77b9f4896ea	27f6f342-4445-40ba-abf3-10bc592baae6
0	48	48	Plazi	ffb07bec-2d10-492d-9c37-361fe0b79427	2883d728-9246-4b55-b0be-2b774fedcc7d
3	3	0	Plazi	ffb07bec-2d10-492d-9c37-361fe0b79427	2c54ebbf-7e7b-4ebd-a354-e478349bc240
3	3	0	Plazi	ffb07bec-2d10-492d-9c37-361fe0b79427	339e40fa-d510-4f27-afb4-c8f09746fcdf
37	37	0	Belgian Biodiversity Platform	fb11cfe1-ebc3-45af-9159-17d9fddbcdac	36c180bb-01da-49c3-ba46-dfe65801fb20
2	2	0	Plazi	ffb07bec-2d10-492d-9c37-361fe0b79427	3924ca0a-bf26-42ae-a71d-a93f62d90f06
0	4	4	Plazi	ffb07bec-2d10-492d-9c37-361fe0b79427	3ae3826f-eafe-4454-80ba-d725770dc7dd
15195	15195	0	GBIF New Zealand	4f9fd726-20dd-445e-89a1-8ed93792276f	3c02253e-da74-49dd-b059-c693727406fd
117	117	0	Plazi	ffb07bec-2d10-492d-9c37-361fe0b79427	3c438ae3-9ea0-4eda-b893-acf6d5756c90
41758	41758	0	U.S. Geological Survey	8618c64a-93e0-4300-b546-7249e5148ed2	3cdabf9a-99da-4383-b6cc-10afee5fb854
309	309	0	Colombian Biodiversity Information System	7e865cba-7c46-417b-ade5-97f2cf5b7be0	3dead38a-225a-4852-9ab8-2dc5fe49d637
147	147	0	Participant Node Managers Committee	7f48e0c8-5c96-49ec-b972-30748e339115	3e2de040-779b-4679-86ce-4ee908417d32
21	21	0	Plazi	ffb07bec-2d10-492d-9c37-361fe0b79427	3f9875b0-e7fb-4dbf-a066-8e4bf455b142
31	31	0	Plazi	ffb07bec-2d10-492d-9c37-361fe0b79427	41cb435c-1867-4d73-9f58-fdd326298e5e
257102	259575	2473	Atlas of Living Australia	4a6f1b71-969e-4fc5-a693-282b05e1220c	42301ebf-d36a-4e4f-a061-d37d778c2365
571	571	0	Participant Node Managers Committee	7f48e0c8-5c96-49ec-b972-30748e339115	436c8809-e588-46f4-8b7a-18b20c017b0d
454838	454838	0	National Biodiversity Network	d897a5b9-35ee-4232-94bd-b0bcaac003c2	458acc40-a815-4fa3-859b-66c84e324907
0	13786	13786	GBIF Finland	dd514216-5c7c-45f3-910d-797424cb5be6	47cac062-7224-4570-8141-c822320627fd
53	53	0	National Biodiversity Network	d897a5b9-35ee-4232-94bd-b0bcaac003c2	49f8c381-6429-427b-8c8c-5e414e8fe36b
13	13	0	Plazi	ffb07bec-2d10-492d-9c37-361fe0b79427	4cd755c5-c421-4654-8656-25eec5aea645
7	7	0	Plazi	ffb07bec-2d10-492d-9c37-361fe0b79427	4f05546b-c6a7-46c8-9a43-6bf103a03cfc
417	417	0	GBIF France	da44cd31-5901-4687-a106-6d1c7734ee3a	51cf7c4a-9cfc-4338-9a03-8d49570ddbed
1627	1627	0	GBIF France	da44cd31-5901-4687-a106-6d1c7734ee3a	59512bd8-f7f9-4d60-a652-92355fe2396e
21	21	0	Plazi	ffb07bec-2d10-492d-9c37-361fe0b79427	5a6c9f1c-072b-45da-9672-e623479fa21c
36	36	0	GBIF Brazil	cdc9736d-5ff7-4ece-9959-3c744360cdb3	5bc1642a-0b2a-45b6-a170-6772d03a2de5
6	6	0	Plazi	ffb07bec-2d10-492d-9c37-361fe0b79427	5d4c94cd-6652-4da8-829f-577cd3798f1b
2	2	0	Plazi	ffb07bec-2d10-492d-9c37-361fe0b79427	5e7d9dbd-6461-40a9-844f-fa3dd14088e2
6	6	0	Plazi	ffb07bec-2d10-492d-9c37-361fe0b79427	62912763-9710-4c81-88ea-5d8c9f9a3bdb
12	12	0	GBIF Germany	4f6826f2-4ff6-443d-b966-e6913bd24013	6331966a-f762-11e1-a439-00145eb45e9a
15	15	0	GBIF Germany	4f6826f2-4ff6-443d-b966-e6913bd24013	63342d4e-f762-11e1-a439-00145eb45e9a
0	169	169	Ocean Biodiversity Information System	ba0670b9-4186-41e6-8e70-f9cb3065551a	63414252-94c8-40e0-8c93-d4ea0a0744e3
287	287	0	GBIF Germany	4f6826f2-4ff6-443d-b966-e6913bd24013	639d0b52-f762-11e1-a439-00145eb45e9a
109	109	0	GBIF Germany	4f6826f2-4ff6-443d-b966-e6913bd24013	63f61620-f762-11e1-a439-00145eb45e9a
66	66	0	GBIF Germany	4f6826f2-4ff6-443d-b966-e6913bd24013	6436454c-f762-11e1-a439-00145eb45e9a
345	323	-22	GBIF Germany	4f6826f2-4ff6-443d-b966-e6913bd24013	65391c1c-f762-11e1-a439-00145eb45e9a
475	475	0	GBIF Germany	4f6826f2-4ff6-443d-b966-e6913bd24013	65548862-f762-11e1-a439-00145eb45e9a
87	87	0	GBIF Germany	4f6826f2-4ff6-443d-b966-e6913bd24013	6617cfac-f762-11e1-a439-00145eb45e9a
120	120	0	GBIF Germany	4f6826f2-4ff6-443d-b966-e6913bd24013	6682c410-f762-11e1-a439-00145eb45e9a
173	173	0	GBIF Germany	4f6826f2-4ff6-443d-b966-e6913bd24013	695eef60-f762-11e1-a439-00145eb45e9a
144	144	0	GBIF Germany	4f6826f2-4ff6-443d-b966-e6913bd24013	6961799c-f762-11e1-a439-00145eb45e9a
616	616	0	GBIF Germany	4f6826f2-4ff6-443d-b966-e6913bd24013	697caa0a-f762-11e1-a439-00145eb45e9a
2	2	0	Participant Node Managers Committee	7f48e0c8-5c96-49ec-b972-30748e339115	6a6a0e09-4414-4625-9883-9eb2ee33d9fd
18	18	0	GBIF Germany	4f6826f2-4ff6-443d-b966-e6913bd24013	6c07e96a-f762-11e1-a439-00145eb45e9a
0	4	4	Plazi	ffb07bec-2d10-492d-9c37-361fe0b79427	6d7754df-a997-4ee5-914d-301c80d0c226
5600	5600	0	Colombian Biodiversity Information System	7e865cba-7c46-417b-ade5-97f2cf5b7be0	707cb1ed-19e4-41b0-9ffa-d9251e2e03bf
17	17	0	Colombian Biodiversity Information System	7e865cba-7c46-417b-ade5-97f2cf5b7be0	733befdf-60a6-433a-96bc-1d0d7a372653
190	190	0	GBIF Germany	4f6826f2-4ff6-443d-b966-e6913bd24013	734f9182-f762-11e1-a439-00145eb45e9a
56	56	0	GBIF Germany	4f6826f2-4ff6-443d-b966-e6913bd24013	74557d01-7001-4862-860c-bd188f20ab15
82	82	0	GBIF Germany	4f6826f2-4ff6-443d-b966-e6913bd24013	74733bae-f762-11e1-a439-00145eb45e9a
231	231	0	GBIF Germany	4f6826f2-4ff6-443d-b966-e6913bd24013	75c72eac-f762-11e1-a439-00145eb45e9a
69	69	0	GBIF Germany	4f6826f2-4ff6-443d-b966-e6913bd24013	78c3c4ee-f762-11e1-a439-00145eb45e9a
33403	33403	0	GBIF Spain	1f94b3ca-9345-4d65-afe2-4bace93aa0fe	7a4bd518-f762-11e1-a439-00145eb45e9a
4	4	0	GBIF Germany	4f6826f2-4ff6-443d-b966-e6913bd24013	7a6b7c38-f762-11e1-a439-00145eb45e9a
73864	73864	0	National Biodiversity Network	d897a5b9-35ee-4232-94bd-b0bcaac003c2	7a8bd8ec-3ba7-4c31-8753-7a6ef27fdc50
175	175	0	GBIF Germany	4f6826f2-4ff6-443d-b966-e6913bd24013	7aa6487c-f762-11e1-a439-00145eb45e9a
0	2	2	Plazi	ffb07bec-2d10-492d-9c37-361fe0b79427	7aae0259-bdcc-492d-a708-d4375ac7eb69
589	589	0	Korean Biodiversity Information Facility	e0a1e772-0177-4800-94b4-2d023fe6cdf4	7b084162-f762-11e1-a439-00145eb45e9a
4127	4127	0	Ocean Biodiversity Information System	ba0670b9-4186-41e6-8e70-f9cb3065551a	7ba26ff7-d8cb-4d95-912c-38cd8223c983
1515	1515	0	GBIF Germany	4f6826f2-4ff6-443d-b966-e6913bd24013	7ba35058-f762-11e1-a439-00145eb45e9a
128	128	0	GBIF Germany	4f6826f2-4ff6-443d-b966-e6913bd24013	7cbd69b0-f762-11e1-a439-00145eb45e9a
67112	67112	0	GBIF Japan	db5705aa-6a6e-42f1-8942-d77b9f4896ea	7d033570-ffe0-4858-97f5-7ae75fb68b0e
84	80	-4	GBIF Germany	4f6826f2-4ff6-443d-b966-e6913bd24013	7d0a2ac0-f762-11e1-a439-00145eb45e9a
304	304	0	GBIF Germany	4f6826f2-4ff6-443d-b966-e6913bd24013	7e8c0fe4-f762-11e1-a439-00145eb45e9a
105523	105523	0	GBIF Spain	1f94b3ca-9345-4d65-afe2-4bace93aa0fe	7f24aff6-f762-11e1-a439-00145eb45e9a
115	115	0	Plazi	ffb07bec-2d10-492d-9c37-361fe0b79427	7f765e78-ebc4-4294-8a36-0a2ead654acf
637	388	-249	Biodiversity Information System of Mexico	b324e8e9-9a4c-44fa-8f1a-7f39ea7ab576	801db6be-f762-11e1-a439-00145eb45e9a
472	278	-194	GBIF Germany	4f6826f2-4ff6-443d-b966-e6913bd24013	81979e38-f762-11e1-a439-00145eb45e9a
199	199	0	GBIF France	da44cd31-5901-4687-a106-6d1c7734ee3a	82a78a57-1a9e-4635-96a8-d2b4adea2e20
8474604	8474604	0	Belgian Biodiversity Platform	fb11cfe1-ebc3-45af-9159-17d9fddbcdac	83e20573-f7dd-4852-9159-21566e1e691e
603	603	0	Atlas of Living Australia	4a6f1b71-969e-4fc5-a693-282b05e1220c	86b65c92-f762-11e1-a439-00145eb45e9a
375	375	0	GBIF France	da44cd31-5901-4687-a106-6d1c7734ee3a	86b82c19-242a-485e-993e-6fd812fb6ee8
1017	1017	0	GBIF France	da44cd31-5901-4687-a106-6d1c7734ee3a	87105de6-a81b-4180-be5b-7d833d979398
943	327	-616	GBIF Germany	4f6826f2-4ff6-443d-b966-e6913bd24013	8839fb1d-714f-4115-ac53-87b778d73dd8
0	78	78	Plazi	ffb07bec-2d10-492d-9c37-361fe0b79427	894e59f0-76d0-4ad0-9089-db914e0d9a78
3	3	0	Plazi	ffb07bec-2d10-492d-9c37-361fe0b79427	8ac11dee-d223-429c-a414-19374054f558
710	710	0	Biodiversity Information System of Mexico	b324e8e9-9a4c-44fa-8f1a-7f39ea7ab576	8b26c7ae-a33a-4cc8-bfd7-875ef99bcc9b
312	312	0	GBIF Germany	4f6826f2-4ff6-443d-b966-e6913bd24013	8be19c0e-f762-11e1-a439-00145eb45e9a
0	2	2	Participant Node Managers Committee	7f48e0c8-5c96-49ec-b972-30748e339115	8c11f8c0-b5d8-4738-b630-4c96e38ba8ff
0	5	5	Plazi	ffb07bec-2d10-492d-9c37-361fe0b79427	8e549dbe-957f-47cc-91ff-dea6e2fc272a
35	16	-19	GBIF Germany	4f6826f2-4ff6-443d-b966-e6913bd24013	8e69638a-f762-11e1-a439-00145eb45e9a
83	67	-16	GBIF Germany	4f6826f2-4ff6-443d-b966-e6913bd24013	8ecfa79e-f762-11e1-a439-00145eb45e9a
7099	7099	0	Ocean Biodiversity Information System	ba0670b9-4186-41e6-8e70-f9cb3065551a	8f1defbf-bda6-4d08-9727-8bbfef86614f
645	558	-87	GBIF Germany	4f6826f2-4ff6-443d-b966-e6913bd24013	8f54e940-f762-11e1-a439-00145eb45e9a
0	5	5	Plazi	ffb07bec-2d10-492d-9c37-361fe0b79427	90f6f9e0-4cdd-4e1b-82b0-5c976e702317
308	308	0	GBIF Germany	4f6826f2-4ff6-443d-b966-e6913bd24013	91a37dba-f762-11e1-a439-00145eb45e9a
0	1	1	Plazi	ffb07bec-2d10-492d-9c37-361fe0b79427	9213d13d-8030-494b-bee2-052439e65d2f
645	645	0	GBIF Germany	4f6826f2-4ff6-443d-b966-e6913bd24013	92541f4e-f762-11e1-a439-00145eb45e9a
6	6	0	GBIF Germany	4f6826f2-4ff6-443d-b966-e6913bd24013	927611ee-f762-11e1-a439-00145eb45e9a
536	536	0	GBIF Germany	4f6826f2-4ff6-443d-b966-e6913bd24013	94300b66-f762-11e1-a439-00145eb45e9a
34140	34140	0	GBIF Spain	1f94b3ca-9345-4d65-afe2-4bace93aa0fe	96cf337e-f762-11e1-a439-00145eb45e9a
1388	1388	0	Colombian Biodiversity Information System	7e865cba-7c46-417b-ade5-97f2cf5b7be0	96daa04a-747e-498a-a645-224eb3d0bda3
129	129	0	GBIF France	da44cd31-5901-4687-a106-6d1c7734ee3a	9b05603d-e18c-464f-bd18-5d2317bd9a7a
3752	3752	0	National Biodiversity Network	d897a5b9-35ee-4232-94bd-b0bcaac003c2	9cc11743-ff00-45ec-a4a2-035d67ad8eda
3469	3469	0	Participant Node Managers Committee	7f48e0c8-5c96-49ec-b972-30748e339115	9d805d19-e529-4142-91a3-155c24c16bb2
574	574	0	South African Biodiversity Information Facility	7190b835-4e86-4b6e-85c1-19cc6677c250	9dcea2da-79ce-43a6-89a7-30473ba09226
3	3	0	Plazi	ffb07bec-2d10-492d-9c37-361fe0b79427	9f591632-961c-4e3d-83ac-74cfb01de68b
41	41	0	Colombian Biodiversity Information System	7e865cba-7c46-417b-ade5-97f2cf5b7be0	9ffd7d8d-6c6a-4231-8150-1280dd10c674
8281	8281	0	National Biodiversity Network	d897a5b9-35ee-4232-94bd-b0bcaac003c2	a0c4459f-6c73-44ff-9fd0-ae000acc4cf2
68	68	0	GBIF France	da44cd31-5901-4687-a106-6d1c7734ee3a	a1633430-edeb-4cbd-8ab9-5179e44f5ed1
172	147	-25	GBIF Germany	4f6826f2-4ff6-443d-b966-e6913bd24013	a1c5bacb-122e-4206-9a72-4ef8ae049d96
444	444	0	Participant Node Managers Committee	7f48e0c8-5c96-49ec-b972-30748e339115	a4b78c0c-97ef-47b6-acfa-6b3a6c9a0cce
0	11662	11662	GBIF Portugal	673f7038-4262-4149-b753-5658a4e912f6	a63e80d5-8d90-42d9-82e9-5fc7e3dc0252
10	10	0	Plazi	ffb07bec-2d10-492d-9c37-361fe0b79427	a73b94ca-14ed-48f6-833d-ef44674c3fbe
29992	31306	1314	U.S. Geological Survey	8618c64a-93e0-4300-b546-7249e5148ed2	a8e22479-28d2-4a8a-ae1c-2d40d80c1f9a
605	605	0	National Biodiversity Network	d897a5b9-35ee-4232-94bd-b0bcaac003c2	a92bba18-07cc-42d2-aa50-891bcd2084c7
11396	11396	0	GBIF Brazil	cdc9736d-5ff7-4ece-9959-3c744360cdb3	a98a63c9-206f-467b-9f85-40f4fa22599f
38	38	0	GBIF France	da44cd31-5901-4687-a106-6d1c7734ee3a	aa8e0457-8113-4f00-ba2f-2ac35a745468
22	22	0	Plazi	ffb07bec-2d10-492d-9c37-361fe0b79427	aae4bad3-b9cc-4c24-b8c1-f2f94b427ff7
26041	26041	0	GBIF Germany	4f6826f2-4ff6-443d-b966-e6913bd24013	ab12168f-cd7d-484a-9f58-44ca34afe762
7534	7534	0	National Biodiversity Network	d897a5b9-35ee-4232-94bd-b0bcaac003c2	aed8833c-7f66-4ed9-8ee8-ef93d063cbc4
1769	1769	0	GBIF Germany	4f6826f2-4ff6-443d-b966-e6913bd24013	afcd713b-be63-4eeb-95d7-8a3b57eb8372
0	3	3	Plazi	ffb07bec-2d10-492d-9c37-361fe0b79427	b10a81a2-3936-425a-92b6-9e52fd7be1e7
0	26	26	Ocean Biodiversity Information System	ba0670b9-4186-41e6-8e70-f9cb3065551a	b9d04f72-219c-4d93-ab43-2bd9b090a2e1
0	447	447	Participant Node Managers Committee	7f48e0c8-5c96-49ec-b972-30748e339115	bb8def4d-7111-491a-9408-51f182806944
470	470	0	Atlas of Living Australia	4a6f1b71-969e-4fc5-a693-282b05e1220c	bd29ef54-c4a9-4df5-8996-8790fd99c581
228	228	0	Biodiversity Information System of Mexico	b324e8e9-9a4c-44fa-8f1a-7f39ea7ab576	bfc6a410-40e8-4e9f-aa62-37ecd7d8430b
5	5	0	Colombian Biodiversity Information System	7e865cba-7c46-417b-ade5-97f2cf5b7be0	c021ecd7-6369-4cdd-86fb-cda2b930ff42
0	38	38	Ocean Biodiversity Information System	ba0670b9-4186-41e6-8e70-f9cb3065551a	c14d8fb6-05ef-4acc-a378-6455b860275e
7	7	0	Plazi	ffb07bec-2d10-492d-9c37-361fe0b79427	c2c14377-a720-4287-9345-039a43b01590
2048	2048	0	Atlas of Living Australia	4a6f1b71-969e-4fc5-a693-282b05e1220c	c8bc80f2-e9e3-4431-9998-6202be1132f3
104	104	0	GBIF France	da44cd31-5901-4687-a106-6d1c7734ee3a	c9f33f34-692f-4ac3-88af-454e2b3fa7f5
1177	1177	0	GBIF France	da44cd31-5901-4687-a106-6d1c7734ee3a	ca0b53d1-7c0d-42c8-86a9-e0548bc4a39a
0	3	3	Ocean Biodiversity Information System	ba0670b9-4186-41e6-8e70-f9cb3065551a	cd874e73-d36d-4387-a824-0def824c47ad
37	37	0	GBIF France	da44cd31-5901-4687-a106-6d1c7734ee3a	ce4d140d-9605-411d-aa8d-d605c97b18f1
0	8	8	Plazi	ffb07bec-2d10-492d-9c37-361fe0b79427	ce6eb74d-6590-47d5-ba3a-a730db9a3baa
2	2	0	Plazi	ffb07bec-2d10-492d-9c37-361fe0b79427	d0856db7-46d2-4db0-8d30-dcf7f8f42d14
252	252	0	Secretariat of the Pacific Regional Environment Programme	29c6a139-ea7f-41f5-8d9b-c55af8736182	d099efc1-98a8-44e0-9f75-3f9bd41c9a28
13	13	0	Colombian Biodiversity Information System	7e865cba-7c46-417b-ade5-97f2cf5b7be0	d1406ed9-6184-4ede-918e-ec7fb427656e
0	20	20	Plazi	ffb07bec-2d10-492d-9c37-361fe0b79427	d1bc0523-8f85-4c56-94a2-f9b82752d50e
18	18	0	Plazi	ffb07bec-2d10-492d-9c37-361fe0b79427	d48e028f-1b68-41ca-b206-57a747b8a894
2	2	0	Plazi	ffb07bec-2d10-492d-9c37-361fe0b79427	d7c05492-4e5b-457d-9736-93c7e713031b
0	44	44	Ocean Biodiversity Information System	ba0670b9-4186-41e6-8e70-f9cb3065551a	d8a9e80a-0f71-432f-abf8-02a13b0413fb
0	6	6	Plazi	ffb07bec-2d10-492d-9c37-361fe0b79427	dee39772-3bec-41db-9ad4-4278a2be4fec
17	17	0	Plazi	ffb07bec-2d10-492d-9c37-361fe0b79427	dfe018cb-a9a3-4189-a161-69ff8cbfbe7b
148	148	0	Polish Biodiversity Information Network	2618bfdf-e194-4911-a241-80db3107bc51	e0d68640-13d9-11de-b2e1-b8a03c50a862
20	20	0	Colombian Biodiversity Information System	7e865cba-7c46-417b-ade5-97f2cf5b7be0	e4a4f8a7-9b3b-4848-8d7a-5b33a024952f
609	609	0	Participant Node Managers Committee	7f48e0c8-5c96-49ec-b972-30748e339115	e8e51f6b-2c6a-416f-b2bd-235faee6399f
0	360	360	Ocean Biodiversity Information System	ba0670b9-4186-41e6-8e70-f9cb3065551a	e8fb9aa4-ee32-4b17-ad85-757cab0081e5
7924	9394	1470	GBIF Spain	1f94b3ca-9345-4d65-afe2-4bace93aa0fe	e95d0010-b3f1-11de-82f8-b8a03c50a862
1139	1139	0	GBIF Norway	4f829580-180d-46a9-9c87-ed8ec959b545	eba5d1aa-35dd-4f0c-b1dc-304f6b44d3b3
14911	14911	0	GBIF Uganda	71b40829-6a12-4c3d-8fee-5746f5e9cf8c	f26cab28-9d52-4e97-b22b-f9fc179745b2
3	3	0	Plazi	ffb07bec-2d10-492d-9c37-361fe0b79427	f4f3bc28-64d2-4695-ad8b-67fb0bd084b3
69	69	0	GBIF Germany	4f6826f2-4ff6-443d-b966-e6913bd24013	f6deea56-0fbe-4f43-a315-43a64ebca7ad
139	139	0	Colombian Biodiversity Information System	7e865cba-7c46-417b-ade5-97f2cf5b7be0	f8999bf6-c87c-4b57-b09c-1a17b0842ebb
3	3	0	Plazi	ffb07bec-2d10-492d-9c37-361fe0b79427	f9d268e1-262b-4d9a-a97f-ffd1495e9eae
0	1	1	Plazi	ffb07bec-2d10-492d-9c37-361fe0b79427	fd7aea21-4b8e-43ed-97b2-aedfe030cd90
0	1	1	Plazi	ffb07bec-2d10-492d-9c37-361fe0b79427	feb77dc2-cf10-49e2-88e0-65fa19c5e5ea
1003	1003	0	Colombian Biodiversity Information System	7e865cba-7c46-417b-ade5-97f2cf5b7be0	0057a720-17c9-4658-971e-9578f3577cf5
34	34	0	Plazi	ffb07bec-2d10-492d-9c37-361fe0b79427	027ed27d-5035-4646-93a6-c23b565f3d20
504	504	0	Biodiversity Information System of Mexico	b324e8e9-9a4c-44fa-8f1a-7f39ea7ab576	029723b6-7060-4bcc-93cf-a5246e946152
3422	3422	0	National Biodiversity Network	d897a5b9-35ee-4232-94bd-b0bcaac003c2	04bfc6da-0b01-4b89-9e8c-21fd2cc7ab9f
0	16	16	Plazi	ffb07bec-2d10-492d-9c37-361fe0b79427	06d92cb0-9da1-4165-8183-02b4320b89f5
518	518	0	National Biodiversity Network	d897a5b9-35ee-4232-94bd-b0bcaac003c2	07b7e603-aacb-4b57-b69b-f4ccb527488d
12289	12289	0	U.S. Geological Survey	8618c64a-93e0-4300-b546-7249e5148ed2	07e9980a-a9f6-4a35-9df6-26371459e570
0	115	115	GBIF Benin	efb9c00e-f802-45dd-8826-a52ec45b89ff	0805c106-c8a0-46ad-8655-61f402a4101a
0	84	84	Colombian Biodiversity Information System	7e865cba-7c46-417b-ade5-97f2cf5b7be0	084b6a64-6a4c-4540-bab4-dce18d5056e5
0	2	2	Plazi	ffb07bec-2d10-492d-9c37-361fe0b79427	0ac57fd4-d0a9-401a-ab3e-12d67fca6bc1
1372	1372	0	National Biodiversity Network	d897a5b9-35ee-4232-94bd-b0bcaac003c2	0cb6de60-ff42-4bbc-9236-b119e85ff953
4	4	0	Participant Node Managers Committee	7f48e0c8-5c96-49ec-b972-30748e339115	0cb8f76b-0d38-49bf-b86c-fa10e8f7a4ce
7	7	0	Plazi	ffb07bec-2d10-492d-9c37-361fe0b79427	0df366c3-95b8-4d2c-8472-8b1cc95835a2
0	31	31	Ocean Biodiversity Information System	ba0670b9-4186-41e6-8e70-f9cb3065551a	10afdbf8-f0e7-44e1-9df2-5520fce7c7fc
6600	6600	0	GBIF France	da44cd31-5901-4687-a106-6d1c7734ee3a	10b1f2ee-2a7a-4603-8ef8-209541ca539c
0	10	10	Plazi	ffb07bec-2d10-492d-9c37-361fe0b79427	168c0360-cbda-4efe-8864-7489ed4b9579
8463	8463	0	Tanzania Biodiversity Information Facility	abd95ca6-3959-4db9-aaa6-2de1aeecf514	18799ce9-1a66-40fc-ad18-5ac54cd3417b
7	7	0	Plazi	ffb07bec-2d10-492d-9c37-361fe0b79427	19b5de7f-7032-4f10-95da-eeba641e11dc
157	157	0	Colombian Biodiversity Information System	7e865cba-7c46-417b-ade5-97f2cf5b7be0	1abb010f-6a79-439f-9cb1-66f210c74c71
5	5	0	Plazi	ffb07bec-2d10-492d-9c37-361fe0b79427	1bf38cf6-ccfe-414f-9868-d631de74a11c
10	10	0	Plazi	ffb07bec-2d10-492d-9c37-361fe0b79427	1cc73ffe-a6f6-49e2-a0ba-b685f0f1f0cb
2	2	0	Plazi	ffb07bec-2d10-492d-9c37-361fe0b79427	20152fe9-34a6-4cdd-850b-d8c825b5e95b
273	273	0	Participant Node Managers Committee	7f48e0c8-5c96-49ec-b972-30748e339115	2086dcfa-cd62-4336-82d1-79d82f5d1857
1065	979	-86	Biodiversity Information System of Mexico	b324e8e9-9a4c-44fa-8f1a-7f39ea7ab576	20ae569a-b65c-4e7f-8f2c-e2f99f561f38
17168	17168	0	National Biodiversity Network	d897a5b9-35ee-4232-94bd-b0bcaac003c2	214ed137-c1c1-406b-8270-e2eb49cdc45e
6	6	0	Plazi	ffb07bec-2d10-492d-9c37-361fe0b79427	22dffc69-ec9e-4d31-9acf-ccd5cb437fad
0	2	2	Plazi	ffb07bec-2d10-492d-9c37-361fe0b79427	23da3bbf-51d3-4727-b32b-8c63d7203185
44	44	0	Participant Node Managers Committee	7f48e0c8-5c96-49ec-b972-30748e339115	2528643b-e86e-49c2-b1e0-f56c7c986818
1539	1539	0	Atlas of Living Australia	4a6f1b71-969e-4fc5-a693-282b05e1220c	2eb32bde-d5a9-433d-8c68-40fe0813938e
1061	1061	0	GBIF Finland	dd514216-5c7c-45f3-910d-797424cb5be6	30d93881-56ca-47dc-8651-42cdc7f2a251
12	12	0	Plazi	ffb07bec-2d10-492d-9c37-361fe0b79427	338fd90c-fb7d-4144-b0f1-49961a59b03c
3	3	0	Plazi	ffb07bec-2d10-492d-9c37-361fe0b79427	361f5fc5-8f69-4803-a3b5-3c9ad44e3f7a
0	4448	4448	Biodiversity Information System of Mexico	b324e8e9-9a4c-44fa-8f1a-7f39ea7ab576	3a881652-f923-412f-8716-0a0f6ef060c9
0	1141	1141	Ocean Biodiversity Information System	ba0670b9-4186-41e6-8e70-f9cb3065551a	3c420b0a-65de-4463-a0ad-c78cb099e510
5	5	0	Plazi	ffb07bec-2d10-492d-9c37-361fe0b79427	3d502879-6e8a-45d7-b59b-f34d64214a5f
0	27	27	Plazi	ffb07bec-2d10-492d-9c37-361fe0b79427	3d8639f0-544a-4ca5-83a8-b729cf1c3e56
0	82	82	Plazi	ffb07bec-2d10-492d-9c37-361fe0b79427	4353db42-e7ee-458d-9410-9516fc5ec8ce
162	162	0	Plazi	ffb07bec-2d10-492d-9c37-361fe0b79427	4ac60f8a-bbba-494e-b8ad-61bd8b85797c
2	2	0	Plazi	ffb07bec-2d10-492d-9c37-361fe0b79427	4d12b597-c33f-46a7-a2f2-7f9fb473ea8e
81	81	0	GBIF France	da44cd31-5901-4687-a106-6d1c7734ee3a	4e0bb227-bda7-438d-a510-2769e55399d6
82	82	0	GBIF France	da44cd31-5901-4687-a106-6d1c7734ee3a	5032dcad-d276-4e89-8dbf-08152d746a50
13	11	-2	GBIF Germany	4f6826f2-4ff6-443d-b966-e6913bd24013	5034f397-080c-4f48-a45c-83d38d6a4f53
171555	198340	26785	National Biodiversity Network	d897a5b9-35ee-4232-94bd-b0bcaac003c2	51b7fe74-b4d9-4027-bd75-8425bfcf5300
20	20	0	Plazi	ffb07bec-2d10-492d-9c37-361fe0b79427	543b652a-0a3f-4e5c-a698-4075c1efc89e
86659	86659	0	South African Biodiversity Information Facility	7190b835-4e86-4b6e-85c1-19cc6677c250	590471f8-1497-4158-ab7f-b9294b656cda
12	12	0	Plazi	ffb07bec-2d10-492d-9c37-361fe0b79427	5bbbe694-ed96-4093-9837-42f6ff3963a3
0	40	40	Ocean Biodiversity Information System	ba0670b9-4186-41e6-8e70-f9cb3065551a	5cd3bb74-29e6-4077-9b68-0128e7a5e933
399	399	0	National Biodiversity Network	d897a5b9-35ee-4232-94bd-b0bcaac003c2	5d531e64-b4e9-4b4e-b9f0-21768389763f
0	462	462	Ocean Biodiversity Information System	ba0670b9-4186-41e6-8e70-f9cb3065551a	62622d1b-01ec-4c2d-ac78-d224c9a13d2f
154508	210069	55561	Belgian Biodiversity Platform	fb11cfe1-ebc3-45af-9159-17d9fddbcdac	629befd5-fb45-4365-95c4-d07e72479b37
274	274	0	GBIF Germany	4f6826f2-4ff6-443d-b966-e6913bd24013	639f9fac-f762-11e1-a439-00145eb45e9a
95	95	0	GBIF Germany	4f6826f2-4ff6-443d-b966-e6913bd24013	64c1151e-f762-11e1-a439-00145eb45e9a
82	82	0	GBIF Germany	4f6826f2-4ff6-443d-b966-e6913bd24013	65820fd0-f762-11e1-a439-00145eb45e9a
1133	679	-454	GBIF Germany	4f6826f2-4ff6-443d-b966-e6913bd24013	660d1d28-f762-11e1-a439-00145eb45e9a
6514	6514	0	GBIF Benin	efb9c00e-f802-45dd-8826-a52ec45b89ff	672303ae-0589-4308-9e34-5f386167e60e
4084	4084	0	Ocean Biodiversity Information System	ba0670b9-4186-41e6-8e70-f9cb3065551a	67891a7d-e2d4-4a82-969b-42116915d167
98	98	0	GBIF Germany	4f6826f2-4ff6-443d-b966-e6913bd24013	67acdbaa-f762-11e1-a439-00145eb45e9a
0	1	1	Plazi	ffb07bec-2d10-492d-9c37-361fe0b79427	67ad4c3f-8247-48c6-be2b-93d4618e3354
99	99	0	GBIF Germany	4f6826f2-4ff6-443d-b966-e6913bd24013	68fee7aa-f762-11e1-a439-00145eb45e9a
189	189	0	GBIF Germany	4f6826f2-4ff6-443d-b966-e6913bd24013	695c679a-f762-11e1-a439-00145eb45e9a
2284	2284	0	Atlas of Living Australia	4a6f1b71-969e-4fc5-a693-282b05e1220c	6affc398-dfcb-4ac1-86a1-d8b9566e2dac
32	32	0	GBIF Germany	4f6826f2-4ff6-443d-b966-e6913bd24013	6c7ce94a-f762-11e1-a439-00145eb45e9a
20327	20327	0	GBIF France	da44cd31-5901-4687-a106-6d1c7734ee3a	6df9e520-9cb1-4c92-bbee-565b64edcc0e
6017	6017	0	GBIF Germany	4f6826f2-4ff6-443d-b966-e6913bd24013	6f456a23-2a7a-4fb6-8462-5dcd2f8eb7ff
4	4	0	Plazi	ffb07bec-2d10-492d-9c37-361fe0b79427	709abdc2-9cad-4c9b-9786-7816ac10a9fb
428	428	0	GBIF Germany	4f6826f2-4ff6-443d-b966-e6913bd24013	711d3fa4-f762-11e1-a439-00145eb45e9a
6164	6164	0	GBIF France	da44cd31-5901-4687-a106-6d1c7734ee3a	72d25812-af76-4ef0-9206-0f3c25d1aada
88	88	0	GBIF Germany	4f6826f2-4ff6-443d-b966-e6913bd24013	733a35bc-f762-11e1-a439-00145eb45e9a
1	1	0	Plazi	ffb07bec-2d10-492d-9c37-361fe0b79427	73cb5294-c1e6-412d-bca9-cfd1232081c7
11	11	0	GBIF Germany	4f6826f2-4ff6-443d-b966-e6913bd24013	7464aeae-f762-11e1-a439-00145eb45e9a
163	163	0	GBIF Germany	4f6826f2-4ff6-443d-b966-e6913bd24013	74baad72-f762-11e1-a439-00145eb45e9a
21	21	0	GBIF Germany	4f6826f2-4ff6-443d-b966-e6913bd24013	7555878e-f762-11e1-a439-00145eb45e9a
21	21	0	GBIF Germany	4f6826f2-4ff6-443d-b966-e6913bd24013	75e32cd8-f762-11e1-a439-00145eb45e9a
0	2	2	Plazi	ffb07bec-2d10-492d-9c37-361fe0b79427	77893af4-4ee0-4db3-a6f4-5362478e4c56
161	161	0	GBIF France	da44cd31-5901-4687-a106-6d1c7734ee3a	7811434c-31db-48e2-a796-9af1317746a5
7	7	0	Plazi	ffb07bec-2d10-492d-9c37-361fe0b79427	78508a0a-bf03-4b3a-8f05-d844b6930c55
38	38	0	GBIF Germany	4f6826f2-4ff6-443d-b966-e6913bd24013	79230b52-f762-11e1-a439-00145eb45e9a
621	548	-73	GBIF Germany	4f6826f2-4ff6-443d-b966-e6913bd24013	798c6944-f762-11e1-a439-00145eb45e9a
2	2	0	Plazi	ffb07bec-2d10-492d-9c37-361fe0b79427	79e58d19-1ef3-4fe9-b140-a22b18e6a079
0	104	104	Plazi	ffb07bec-2d10-492d-9c37-361fe0b79427	7a0ded71-ddb1-49e5-9c2c-10c01fd03a1f
0	7	7	Plazi	ffb07bec-2d10-492d-9c37-361fe0b79427	7a3869c4-e8ab-4def-ab1e-7bed085eafd9
4781	5072	291	GBIF Germany	4f6826f2-4ff6-443d-b966-e6913bd24013	7a681cd5-9781-489f-a43b-dfd117967550
10134	10134	0	Atlas of Living Australia	4a6f1b71-969e-4fc5-a693-282b05e1220c	7a78957a-ec61-4ff2-bd45-830006371692
7	7	0	GBIF Germany	4f6826f2-4ff6-443d-b966-e6913bd24013	7a945eaa-f762-11e1-a439-00145eb45e9a
146	146	0	GBIF Spain	1f94b3ca-9345-4d65-afe2-4bace93aa0fe	7ac0504d-0230-4029-afbe-04657ae47c48
130	130	0	GBIF Germany	4f6826f2-4ff6-443d-b966-e6913bd24013	7ca108e2-f762-11e1-a439-00145eb45e9a
4	4	0	Plazi	ffb07bec-2d10-492d-9c37-361fe0b79427	7d3f249a-79dc-49f3-a1e1-32fbd8641f3d
500	493	-7	GBIF Germany	4f6826f2-4ff6-443d-b966-e6913bd24013	7d4b3c40-f762-11e1-a439-00145eb45e9a
110	109	-1	Biodiversity Information System of Mexico	b324e8e9-9a4c-44fa-8f1a-7f39ea7ab576	7e9847b1-59c3-4a64-b785-d9f926aa465e
118	118	0	GBIF Germany	4f6826f2-4ff6-443d-b966-e6913bd24013	7ef946fe-f762-11e1-a439-00145eb45e9a
7185	110	-7075	Biodiversity Information System of Mexico	b324e8e9-9a4c-44fa-8f1a-7f39ea7ab576	7f94ede8-f762-11e1-a439-00145eb45e9a
478	478	0	Biodiversity Information System of Mexico	b324e8e9-9a4c-44fa-8f1a-7f39ea7ab576	8066f6da-f762-11e1-a439-00145eb45e9a
388	388	0	National Biodiversity Network	d897a5b9-35ee-4232-94bd-b0bcaac003c2	83c5db8e-ade3-4269-9f33-00f85d90355a
60	60	0	Plazi	ffb07bec-2d10-492d-9c37-361fe0b79427	84b25e0d-fbfe-4068-a30e-74a7610ad19b
22227	22227	0	GBIF Germany	4f6826f2-4ff6-443d-b966-e6913bd24013	863efcc4-f762-11e1-a439-00145eb45e9a
5293	2651	-2642	GBIF Germany	4f6826f2-4ff6-443d-b966-e6913bd24013	870d4584-f762-11e1-a439-00145eb45e9a
4072	4072	0	GBIF Germany	4f6826f2-4ff6-443d-b966-e6913bd24013	886049b4-d276-4e8c-baee-5e876bb6eaa1
30	30	0	GBIF Germany	4f6826f2-4ff6-443d-b966-e6913bd24013	8873c5a6-f762-11e1-a439-00145eb45e9a
420	420	0	Colombian Biodiversity Information System	7e865cba-7c46-417b-ade5-97f2cf5b7be0	88b18c03-c4a6-4634-ac41-ad290ad32242
272	272	0	GBIF Germany	4f6826f2-4ff6-443d-b966-e6913bd24013	8a19969c-f762-11e1-a439-00145eb45e9a
91	91	0	GBIF Germany	4f6826f2-4ff6-443d-b966-e6913bd24013	8aa3b0c0-f762-11e1-a439-00145eb45e9a
10	10	0	GBIF Germany	4f6826f2-4ff6-443d-b966-e6913bd24013	8c09ac1c-f762-11e1-a439-00145eb45e9a
23	15	-8	GBIF Germany	4f6826f2-4ff6-443d-b966-e6913bd24013	8ccce38a-f762-11e1-a439-00145eb45e9a
209	209	0	GBIF Germany	4f6826f2-4ff6-443d-b966-e6913bd24013	8e29de0e-f762-11e1-a439-00145eb45e9a
383	160	-223	GBIF Germany	4f6826f2-4ff6-443d-b966-e6913bd24013	8e48d854-f762-11e1-a439-00145eb45e9a
849	662	-187	GBIF Germany	4f6826f2-4ff6-443d-b966-e6913bd24013	8ffaf470-f762-11e1-a439-00145eb45e9a
11586	7399	-4187	GBIF Germany	4f6826f2-4ff6-443d-b966-e6913bd24013	90aebdb6-f762-11e1-a439-00145eb45e9a
86	85	-1	GBIF Germany	4f6826f2-4ff6-443d-b966-e6913bd24013	927c284a-f762-11e1-a439-00145eb45e9a
1251	1098	-153	GBIF Germany	4f6826f2-4ff6-443d-b966-e6913bd24013	9452379a-f762-11e1-a439-00145eb45e9a
0	6	6	Plazi	ffb07bec-2d10-492d-9c37-361fe0b79427	94d0ef93-59f9-4447-a01b-d344343d8032
75728	76162	434	GBIF Germany	4f6826f2-4ff6-443d-b966-e6913bd24013	96596036-f762-11e1-a439-00145eb45e9a
188	188	0	GBIF Spain	1f94b3ca-9345-4d65-afe2-4bace93aa0fe	96b8c4ae-f762-11e1-a439-00145eb45e9a
159	159	0	U.S. Geological Survey	8618c64a-93e0-4300-b546-7249e5148ed2	96ceb34f-842a-4018-9350-cb6f94556ed6
9	9	0	Plazi	ffb07bec-2d10-492d-9c37-361fe0b79427	98e47881-cd39-4b69-a385-2d5fe5bf56cf
418	418	0	Secretariat of the Pacific Regional Environment Programme	29c6a139-ea7f-41f5-8d9b-c55af8736182	99e0ec37-cec9-44f2-a6dc-b13a2fda011f
1	1	0	Plazi	ffb07bec-2d10-492d-9c37-361fe0b79427	9a23e0ce-ffdb-4ec1-9796-403ffb9ada90
25	25	0	Plazi	ffb07bec-2d10-492d-9c37-361fe0b79427	9ad96f8f-b1bf-40f6-9b53-9b5fcdb7d8f3
3	3	0	Plazi	ffb07bec-2d10-492d-9c37-361fe0b79427	9b0e9dea-64ae-4e27-8da8-46d82329323c
20575	20575	0	GBIF Argentina	2426a871-9feb-40a1-96c6-0c593a76b835	9f17221a-195b-4005-8773-683fcdf559e8
175734	175734	0	National Biodiversity Network	d897a5b9-35ee-4232-94bd-b0bcaac003c2	a4b65ad0-4873-4f93-9dd0-f9f8101aede8
79	79	0	GBIF France	da44cd31-5901-4687-a106-6d1c7734ee3a	a9084584-f333-4a69-8199-dcd68139902e
0	21	21	Ocean Biodiversity Information System	ba0670b9-4186-41e6-8e70-f9cb3065551a	a9cddd83-c7b2-4b14-998a-6fee47efbea9
9	9	0	Plazi	ffb07bec-2d10-492d-9c37-361fe0b79427	aba71a8b-878a-4b8e-ac64-3b8b97cb3e5b
12	12	0	Plazi	ffb07bec-2d10-492d-9c37-361fe0b79427	ae160f91-246d-4e3a-ab97-90db87794d20
1042	1042	0	GBIF France	da44cd31-5901-4687-a106-6d1c7734ee3a	ae54b8b9-dae8-480b-ac65-8f3d58d61f62
20	20	0	Plazi	ffb07bec-2d10-492d-9c37-361fe0b79427	b0d827d3-4b2d-440a-8de9-3d2957cf9258
0	5	5	Plazi	ffb07bec-2d10-492d-9c37-361fe0b79427	b23ab62f-9076-4570-b3c7-e1969269eafd
796	796	0	National Biodiversity Network	d897a5b9-35ee-4232-94bd-b0bcaac003c2	b23f9eb6-2585-4cb5-85c5-5ba39040838f
1897	1897	0	GBIF Norway	4f829580-180d-46a9-9c87-ed8ec959b545	b9b2019d-fd2d-4a17-931a-8b5e050a38bd
1	1	0	Plazi	ffb07bec-2d10-492d-9c37-361fe0b79427	babfb9f7-0cf7-4870-9335-de67ce169173
0	9	9	Plazi	ffb07bec-2d10-492d-9c37-361fe0b79427	bbd8e99f-37ba-4407-8166-79551b3e91b7
403	403	0	Colombian Biodiversity Information System	7e865cba-7c46-417b-ade5-97f2cf5b7be0	bd87ead7-eb08-40ec-8ea3-1a61c134ec56
0	892	892	National Biodiversity Network	d897a5b9-35ee-4232-94bd-b0bcaac003c2	bef724f0-f355-4c31-a09e-a870416aa8b0
115	115	0	Plazi	ffb07bec-2d10-492d-9c37-361fe0b79427	c198bacd-03af-4af3-9649-310ea6340000
0	2632	2632	GBIF Portugal	673f7038-4262-4149-b753-5658a4e912f6	c1e31227-6595-4797-b75a-d9d9f75e4cca
0	84	84	Plazi	ffb07bec-2d10-492d-9c37-361fe0b79427	c2c78f5e-a257-4126-98ba-42e9d944da50
5	5	0	Plazi	ffb07bec-2d10-492d-9c37-361fe0b79427	c3601d57-e9b3-4e98-8619-a162b914f9e0
0	279	279	Colombian Biodiversity Information System	7e865cba-7c46-417b-ade5-97f2cf5b7be0	c4bb4961-24cb-4017-b9d2-7a48e5dbf296
0	1	1	Ocean Biodiversity Information System	ba0670b9-4186-41e6-8e70-f9cb3065551a	c903e62f-83d1-4ae1-9db3-06d11f782b20
45581	46392	811	U.S. Geological Survey	8618c64a-93e0-4300-b546-7249e5148ed2	c9076cd3-349f-4068-a5c7-bc34449c3916
228	228	0	GBIF France	da44cd31-5901-4687-a106-6d1c7734ee3a	ca26e80e-257c-451d-a5c8-cd1d193728f7
0	30	30	Plazi	ffb07bec-2d10-492d-9c37-361fe0b79427	ca6eee6a-a7b3-44d1-a27f-aeef975d43b9
3	3	0	Plazi	ffb07bec-2d10-492d-9c37-361fe0b79427	ccd44efa-6abc-4376-bd30-e87f97782538
5923	5923	0	Atlas of Living Australia	4a6f1b71-969e-4fc5-a693-282b05e1220c	cd174407-5632-4090-ba61-9ff3fe41bc03
4	4	0	Plazi	ffb07bec-2d10-492d-9c37-361fe0b79427	cdae16b5-d07e-49eb-8871-ca7ed9dda760
70	70	0	GBIF France	da44cd31-5901-4687-a106-6d1c7734ee3a	d0df5fa2-b9c0-4f98-9900-5ac4ced3eea9
75	75	0	Plazi	ffb07bec-2d10-492d-9c37-361fe0b79427	d58d0d44-7889-4739-9e2d-b1a0bc9780b9
32725	32725	0	South African Biodiversity Information Facility	7190b835-4e86-4b6e-85c1-19cc6677c250	d5c0a2dc-a87c-4bcd-8b07-2c1d60f40167
0	4	4	Plazi	ffb07bec-2d10-492d-9c37-361fe0b79427	d78fa904-b6d9-4ea9-b378-0a26923280c7
0	428	428	GBIF Japan	db5705aa-6a6e-42f1-8942-d77b9f4896ea	d82f41e8-619f-4059-9efb-83e81a4639d5
66	66	0	Plazi	ffb07bec-2d10-492d-9c37-361fe0b79427	d8341546-2e59-43e5-b4b3-5bae0dfe6462
1	1	0	Plazi	ffb07bec-2d10-492d-9c37-361fe0b79427	d8bd4969-2e1c-4875-8368-f620eb7147f8
15	15	0	Plazi	ffb07bec-2d10-492d-9c37-361fe0b79427	da73eda4-e16a-4040-8114-779dbb619c3a
1740	1740	0	National Biodiversity Network	d897a5b9-35ee-4232-94bd-b0bcaac003c2	db81497e-6d4d-4973-8a6b-59674d86bcc7
597	597	0	GBIF Germany	4f6826f2-4ff6-443d-b966-e6913bd24013	dc0e0e60-b048-4442-8d16-43f99e41b6be
8	8	0	Plazi	ffb07bec-2d10-492d-9c37-361fe0b79427	dc9ca2ac-e161-40f7-9195-005bbb39fd6e
41973	41973	0	Participant Node Managers Committee	7f48e0c8-5c96-49ec-b972-30748e339115	dd6ef36f-3345-4c9e-9188-161de0668127
0	124	124	Plazi	ffb07bec-2d10-492d-9c37-361fe0b79427	de9f0011-899b-4265-8330-33220b678a9b
0	4	4	Plazi	ffb07bec-2d10-492d-9c37-361fe0b79427	debedfa0-34ac-41f2-beb2-7b7db0785a4d
22625	22625	0	GBIF Finland	dd514216-5c7c-45f3-910d-797424cb5be6	e0507994-aa35-4ec0-be28-92d4a3c11f75
18	18	0	Plazi	ffb07bec-2d10-492d-9c37-361fe0b79427	e27754a5-c75e-4cd4-974c-6179b205d4fc
143	131	-12	GBIF Germany	4f6826f2-4ff6-443d-b966-e6913bd24013	e7d74b7a-232d-430b-bc75-e8fb60d316e3
0	5708	5708	U.S. Geological Survey	8618c64a-93e0-4300-b546-7249e5148ed2	e7fee724-8575-4f00-8d82-d9f5d6e220c2
4	4	0	Plazi	ffb07bec-2d10-492d-9c37-361fe0b79427	e805d477-ca64-4ea3-8990-285677f540b1
2	2	0	Plazi	ffb07bec-2d10-492d-9c37-361fe0b79427	e928bd5d-45b5-4d59-ae56-f38a2b108449
31	31	0	Plazi	ffb07bec-2d10-492d-9c37-361fe0b79427	ea102704-86a3-47e5-8320-3424157f7232
511	511	0	GBIF France	da44cd31-5901-4687-a106-6d1c7734ee3a	ec672054-fde4-4046-9faa-5d7740782636
16157	15719	-438	Biodiversity Information System of Mexico	b324e8e9-9a4c-44fa-8f1a-7f39ea7ab576	ee9e05bb-878a-4222-b2ab-a114b6b9ac62
148701	148701	0	Atlas of Living Australia	4a6f1b71-969e-4fc5-a693-282b05e1220c	f38cc07c-49a8-4ca4-8882-5cdde1733c12
82900	86991	4091	U.S. Geological Survey	8618c64a-93e0-4300-b546-7249e5148ed2	f56df26e-73f5-4d37-bfed-3d46c0834e82
362	362	0	Biodiversity Information System of Mexico	b324e8e9-9a4c-44fa-8f1a-7f39ea7ab576	f7e9c171-bb78-4934-84f6-93707d0d028e
20223	20223	0	National Biodiversity Network	d897a5b9-35ee-4232-94bd-b0bcaac003c2	fbb29a6e-8975-4138-b7e1-2aacd85b47b9
0	1	1	Plazi	ffb07bec-2d10-492d-9c37-361fe0b79427	01c940a7-0d58-4fec-9474-8f4d8dff5543
3	3	0	Plazi	ffb07bec-2d10-492d-9c37-361fe0b79427	02f2e34f-46b2-40e9-a287-850d7cdf7300
311	311	0	GBIF France	da44cd31-5901-4687-a106-6d1c7734ee3a	040ae1dc-e79f-4a62-b28e-4ba355c050dc
41	41	0	Plazi	ffb07bec-2d10-492d-9c37-361fe0b79427	057c438d-59af-40d6-84b8-77bf28b7dcb9
18	18	0	Plazi	ffb07bec-2d10-492d-9c37-361fe0b79427	07d197b5-f9c3-45a4-b589-f48c8db0d23d
6	6	0	Plazi	ffb07bec-2d10-492d-9c37-361fe0b79427	084c13ba-beda-4b0f-8680-c1a359e77260
36	36	0	Biodiversity Information System of Mexico	b324e8e9-9a4c-44fa-8f1a-7f39ea7ab576	0f670eab-9d21-4caf-91aa-d2cea1c22e69
447	447	0	GBIF Uganda	71b40829-6a12-4c3d-8fee-5746f5e9cf8c	0f6fa9ec-7c0c-4cd9-af6a-ae282a0172e9
48	48	0	GBIF Norway	4f829580-180d-46a9-9c87-ed8ec959b545	1033dac1-8ed3-467d-a097-52d0a4b7dc26
0	2	2	Plazi	ffb07bec-2d10-492d-9c37-361fe0b79427	12176670-5037-4df4-bd36-fac23bc16de1
0	2	2	Plazi	ffb07bec-2d10-492d-9c37-361fe0b79427	14c83ec6-f28c-4208-9644-25554028c295
3	3	0	Plazi	ffb07bec-2d10-492d-9c37-361fe0b79427	167edaa1-d9a0-438f-9c42-d4ac47034ece
6021	6021	0	Biodiversity Information System of Mexico	b324e8e9-9a4c-44fa-8f1a-7f39ea7ab576	1b9566d1-636d-4af3-b9a8-813efe9f3263
158	158	0	Atlas of Living Australia	4a6f1b71-969e-4fc5-a693-282b05e1220c	1bc719fd-c4e1-410f-b8c1-518cc1addcb5
0	214	214	Ocean Biodiversity Information System	ba0670b9-4186-41e6-8e70-f9cb3065551a	20d4adea-d073-4f58-893a-ba720b04f93d
395	316	-79	GBIF Germany	4f6826f2-4ff6-443d-b966-e6913bd24013	2585f991-0aee-47f4-89da-c628d6f9e0f9
0	1	1	Plazi	ffb07bec-2d10-492d-9c37-361fe0b79427	282437aa-9ef6-4e43-bb0d-49654af4cbf9
0	10095	10095	Participant Node Managers Committee	7f48e0c8-5c96-49ec-b972-30748e339115	288e1f4c-7c09-4604-ad19-920a61c55462
494	494	0	GBIF France	da44cd31-5901-4687-a106-6d1c7734ee3a	29cea010-47bf-4bbe-bae2-ee785bba1688
0	8	8	Plazi	ffb07bec-2d10-492d-9c37-361fe0b79427	2d904341-c140-443f-90fa-561040e2c816
0	36	36	Plazi	ffb07bec-2d10-492d-9c37-361fe0b79427	2db066bb-70d2-4ae3-9c6d-357970724db5
41	41	0	GBIF Germany	4f6826f2-4ff6-443d-b966-e6913bd24013	3312e199-67b2-4a10-9858-61214204b182
53	53	0	GBIF Brazil	cdc9736d-5ff7-4ece-9959-3c744360cdb3	35014baf-5683-4267-b19d-8953f1fd3383
692	692	0	Biodiversity Information System of Mexico	b324e8e9-9a4c-44fa-8f1a-7f39ea7ab576	3909a041-4aa4-46d6-a547-baa95c513741
752	752	0	GBIF France	da44cd31-5901-4687-a106-6d1c7734ee3a	390b6899-a3e4-4a0b-8730-af8d026a69bc
4	4	0	GBIF Germany	4f6826f2-4ff6-443d-b966-e6913bd24013	391565fc-a3bd-11e2-95b8-00145eb45e9a
13	13	0	Plazi	ffb07bec-2d10-492d-9c37-361fe0b79427	39415d80-2528-4d6d-98cf-5642a382dc20
0	7	7	Plazi	ffb07bec-2d10-492d-9c37-361fe0b79427	397cf303-fa5e-489c-85da-5dc129c1b3cc
70	70	0	GBIF France	da44cd31-5901-4687-a106-6d1c7734ee3a	3b089806-1a8a-4f85-a3d2-93a41390d6db
3669111	3669111	0	GBIF Finland	dd514216-5c7c-45f3-910d-797424cb5be6	3b301884-51b9-443f-b63c-47feeccfb89f
1	1	0	Plazi	ffb07bec-2d10-492d-9c37-361fe0b79427	3ce7bcc7-28bc-454c-912f-efc9936aac93
4	4	0	Plazi	ffb07bec-2d10-492d-9c37-361fe0b79427	3e4dd305-99b2-49b6-8c82-b3543ec3c551
0	6	6	Ocean Biodiversity Information System	ba0670b9-4186-41e6-8e70-f9cb3065551a	3f972727-f5a0-448f-9cab-24cbb3a18454
2	2	0	Plazi	ffb07bec-2d10-492d-9c37-361fe0b79427	400a02d8-44e6-4c5e-b8f8-b76a60b588aa
0	3	3	Plazi	ffb07bec-2d10-492d-9c37-361fe0b79427	402f8d2b-37a5-4903-81cc-2c8c9de96dfc
1606317	1645756	39439	Atlas of Living Australia	4a6f1b71-969e-4fc5-a693-282b05e1220c	40c0f670-ee87-4576-be9d-2725e0b47035
1734	1736	2	U.S. Geological Survey	8618c64a-93e0-4300-b546-7249e5148ed2	44165940-fa60-466f-935e-d76180e6ef8e
6035	6035	0	Atlas of Living Australia	4a6f1b71-969e-4fc5-a693-282b05e1220c	470cccd6-0a5b-4839-a2d1-8ae5d0bf9926
6873	6873	0	Belgian Biodiversity Platform	fb11cfe1-ebc3-45af-9159-17d9fddbcdac	484ba7d4-531e-4dc4-bc52-99a8c363fdcd
10	10	0	Ocean Biodiversity Information System	ba0670b9-4186-41e6-8e70-f9cb3065551a	4a65dba1-ff0d-4e72-aa3c-e76e48856930
629	629	0	National Biodiversity Network	d897a5b9-35ee-4232-94bd-b0bcaac003c2	4bf3fdf7-5a89-4da4-8994-108a8ecfaf7b
89	89	0	GBIF Finland	dd514216-5c7c-45f3-910d-797424cb5be6	4fb3e6d6-67b7-4b1d-8846-407d4fbf8ce3
409	409	0	GBIF Spain	1f94b3ca-9345-4d65-afe2-4bace93aa0fe	511ef04b-9224-47cb-9701-dd20dedcc754
5	5	0	Plazi	ffb07bec-2d10-492d-9c37-361fe0b79427	5196e325-fe1a-4d0c-9108-ce785053acad
42	42	0	Plazi	ffb07bec-2d10-492d-9c37-361fe0b79427	53c92371-9369-4586-b04a-85279ec7d276
38	38	0	Colombian Biodiversity Information System	7e865cba-7c46-417b-ade5-97f2cf5b7be0	540af75b-9984-49be-b771-fa6e4cd16ee3
39	39	0	Plazi	ffb07bec-2d10-492d-9c37-361fe0b79427	55d069c2-c90f-48a7-836d-cc7f9eadc20b
277	277	0	Plazi	ffb07bec-2d10-492d-9c37-361fe0b79427	561159e3-982f-4eb4-8824-5459de071493
1	1	0	Plazi	ffb07bec-2d10-492d-9c37-361fe0b79427	561420ef-a053-4cce-9c02-53f37b197228
3012	3180	168	GBIF Japan	db5705aa-6a6e-42f1-8942-d77b9f4896ea	59672332-f617-4a7b-9633-0221bb2ea65c
806417	812370	5953	Atlas of Living Australia	4a6f1b71-969e-4fc5-a693-282b05e1220c	5a3b50fa-c882-4129-9405-38e54c0a73f3
23215	23215	0	Society for the Management of Electronic Biodiversity Data	97818ee4-1461-4180-bf1d-b3201050124f	5d2f6092-6dcd-496b-abba-6d9e95ccc801
0	4	4	Plazi	ffb07bec-2d10-492d-9c37-361fe0b79427	5d88b954-f310-495d-8426-b22535d4b9f2
224	224	0	GBIF Germany	4f6826f2-4ff6-443d-b966-e6913bd24013	5e7ce2af-f147-4577-a543-70bdeab1ebe3
12	12	0	Plazi	ffb07bec-2d10-492d-9c37-361fe0b79427	616a39e4-4e38-4b13-a7d1-5ddd4cb7a62d
107	107	0	GBIF Germany	4f6826f2-4ff6-443d-b966-e6913bd24013	61bcecbc-f762-11e1-a439-00145eb45e9a
964	964	0	GBIF Germany	4f6826f2-4ff6-443d-b966-e6913bd24013	6383ba1c-f762-11e1-a439-00145eb45e9a
115	115	0	GBIF Germany	4f6826f2-4ff6-443d-b966-e6913bd24013	63eca77a-f762-11e1-a439-00145eb45e9a
0	624	624	Ocean Biodiversity Information System	ba0670b9-4186-41e6-8e70-f9cb3065551a	6536ef77-75fe-4936-8057-20490a0f5756
53	52	-1	GBIF Germany	4f6826f2-4ff6-443d-b966-e6913bd24013	658a5370-f762-11e1-a439-00145eb45e9a
690	690	0	GBIF Germany	4f6826f2-4ff6-443d-b966-e6913bd24013	658de468-f762-11e1-a439-00145eb45e9a
338	199	-139	GBIF Germany	4f6826f2-4ff6-443d-b966-e6913bd24013	6614265e-f762-11e1-a439-00145eb45e9a
336	336	0	GBIF Germany	4f6826f2-4ff6-443d-b966-e6913bd24013	6618fa26-f762-11e1-a439-00145eb45e9a
0	13536	13536	GBIF Benin	efb9c00e-f802-45dd-8826-a52ec45b89ff	6690ea02-c607-42a3-871b-da00586cbe54
0	68	68	Plazi	ffb07bec-2d10-492d-9c37-361fe0b79427	66e919e0-7499-4c7b-8f3f-a69da266bcba
56	56	0	GBIF Germany	4f6826f2-4ff6-443d-b966-e6913bd24013	67865d72-f762-11e1-a439-00145eb45e9a
5	5	0	Plazi	ffb07bec-2d10-492d-9c37-361fe0b79427	687fbc4b-b882-4c11-8a09-8f341b82b849
0	9	9	Plazi	ffb07bec-2d10-492d-9c37-361fe0b79427	69694ecd-c20e-4dc3-9038-d778f9848d07
34	34	0	GBIF Germany	4f6826f2-4ff6-443d-b966-e6913bd24013	6ab25f5a-f762-11e1-a439-00145eb45e9a
18	18	0	GBIF Germany	4f6826f2-4ff6-443d-b966-e6913bd24013	6b1a8706-f762-11e1-a439-00145eb45e9a
55	55	0	Plazi	ffb07bec-2d10-492d-9c37-361fe0b79427	6be1c5ca-ab1b-4c69-8da2-b510a5ed3842
0	17	17	Plazi	ffb07bec-2d10-492d-9c37-361fe0b79427	6c3f6d8c-32e5-4e6c-979f-a7a7d388373b
46	46	0	GBIF Germany	4f6826f2-4ff6-443d-b966-e6913bd24013	6cd7eff2-f762-11e1-a439-00145eb45e9a
306	306	0	National Biodiversity Data Centre	422b00b2-6c94-4bb6-976b-c359916efdb8	6e21cfd9-34ed-4983-bab4-0e912a5770bd
0	1	1	Plazi	ffb07bec-2d10-492d-9c37-361fe0b79427	6eceed44-a680-4420-9117-895ea169d8f7
98734	119726	20992	GBIF Japan	db5705aa-6a6e-42f1-8942-d77b9f4896ea	6fe80778-1b03-4f2c-a822-e62a998f321b
5	5	0	Plazi	ffb07bec-2d10-492d-9c37-361fe0b79427	7070edc8-3ef3-4cc8-8bc4-03f9735e23dc
180	180	0	GBIF Germany	4f6826f2-4ff6-443d-b966-e6913bd24013	71b87690-f762-11e1-a439-00145eb45e9a
7	7	0	GBIF Germany	4f6826f2-4ff6-443d-b966-e6913bd24013	72acacb0-f762-11e1-a439-00145eb45e9a
345	345	0	GBIF Germany	4f6826f2-4ff6-443d-b966-e6913bd24013	72c07c9a-f762-11e1-a439-00145eb45e9a
74	74	0	Plazi	ffb07bec-2d10-492d-9c37-361fe0b79427	73528878-8635-489f-b332-6f17b747c0cb
163	163	0	GBIF Germany	4f6826f2-4ff6-443d-b966-e6913bd24013	73f4a8d4-f762-11e1-a439-00145eb45e9a
162	162	0	GBIF Germany	4f6826f2-4ff6-443d-b966-e6913bd24013	74636da0-f762-11e1-a439-00145eb45e9a
5	5	0	Plazi	ffb07bec-2d10-492d-9c37-361fe0b79427	77a97faa-24fe-4724-9305-a90765c44f54
6	6	0	Plazi	ffb07bec-2d10-492d-9c37-361fe0b79427	77f63a52-6b4c-459d-9e73-c20ca6bf169e
16501	16501	0	GBIF Germany	4f6826f2-4ff6-443d-b966-e6913bd24013	78706ad8-f762-11e1-a439-00145eb45e9a
8	8	0	GBIF Germany	4f6826f2-4ff6-443d-b966-e6913bd24013	7907f7d6-f762-11e1-a439-00145eb45e9a
903	903	0	GBIF Germany	4f6826f2-4ff6-443d-b966-e6913bd24013	7930df8e-f762-11e1-a439-00145eb45e9a
87279	87279	0	Taiwan Biodiversity Information Facility	e1b85abc-61f9-430f-ba79-6813dec53a0f	79ae93e0-a2b8-11de-9f79-b8a03c50a862
269	269	0	GBIF Germany	4f6826f2-4ff6-443d-b966-e6913bd24013	7a15844a-f762-11e1-a439-00145eb45e9a
2065	2065	0	GBIF Germany	4f6826f2-4ff6-443d-b966-e6913bd24013	7ba47d0c-f762-11e1-a439-00145eb45e9a
1428	1428	0	GBIF France	da44cd31-5901-4687-a106-6d1c7734ee3a	7d5170c5-0d99-4f43-8f9c-bd18eb5ef7b5
0	4	4	Plazi	ffb07bec-2d10-492d-9c37-361fe0b79427	7d8ded68-c6c4-48ff-968e-da28e3c7b5c8
667	667	0	GBIF Germany	4f6826f2-4ff6-443d-b966-e6913bd24013	7df81758-f762-11e1-a439-00145eb45e9a
45	25	-20	GBIF Germany	4f6826f2-4ff6-443d-b966-e6913bd24013	7e427db6-f762-11e1-a439-00145eb45e9a
720	300	-420	GBIF Germany	4f6826f2-4ff6-443d-b966-e6913bd24013	7ebf715e-f762-11e1-a439-00145eb45e9a
228	228	0	Atlas of Living Australia	4a6f1b71-969e-4fc5-a693-282b05e1220c	7f56df30-f762-11e1-a439-00145eb45e9a
202	202	0	GBIF Spain	1f94b3ca-9345-4d65-afe2-4bace93aa0fe	81165620-f762-11e1-a439-00145eb45e9a
2240	1736	-504	GBIF Germany	4f6826f2-4ff6-443d-b966-e6913bd24013	81e2ee4c-f762-11e1-a439-00145eb45e9a
15	15	0	GBIF Germany	4f6826f2-4ff6-443d-b966-e6913bd24013	820c28ac-f762-11e1-a439-00145eb45e9a
0	28	28	Plazi	ffb07bec-2d10-492d-9c37-361fe0b79427	82985cce-d71c-4d8f-b64b-3f13a558636e
395358	395358	0	GBIF Switzerland	169eb292-376b-4cc6-8e31-9c2c432de0ad	82ae8174-f762-11e1-a439-00145eb45e9a
952	952	0	National Biodiversity Network	d897a5b9-35ee-4232-94bd-b0bcaac003c2	83513d20-f18e-4de1-ad39-456b2027dbc2
63	63	0	GBIF Spain	1f94b3ca-9345-4d65-afe2-4bace93aa0fe	836ebbe2-f762-11e1-a439-00145eb45e9a
74	74	0	Plazi	ffb07bec-2d10-492d-9c37-361fe0b79427	83729b88-092c-4daf-8c3c-1aa7996fab06
6050	6050	0	GBIF Spain	1f94b3ca-9345-4d65-afe2-4bace93aa0fe	8380d926-f762-11e1-a439-00145eb45e9a
202	202	0	National Biodiversity Network	d897a5b9-35ee-4232-94bd-b0bcaac003c2	8428e2bd-55ea-4b96-89d3-fc750e24e5f2
11572	11572	0	Ocean Biodiversity Information System	ba0670b9-4186-41e6-8e70-f9cb3065551a	842f0c9e-f762-11e1-a439-00145eb45e9a
16088	16088	0	Canada Biodiversity Information Facility	8f83fc96-c966-4126-83f7-bf044dc49efa	84750258-f762-11e1-a439-00145eb45e9a
928561	928561	0	U.S. Geological Survey	8618c64a-93e0-4300-b546-7249e5148ed2	864c8736-f762-11e1-a439-00145eb45e9a
4639	4639	0	U.S. Geological Survey	8618c64a-93e0-4300-b546-7249e5148ed2	873f843b-7c49-4f00-a842-9107f79213ca
6	6	0	Plazi	ffb07bec-2d10-492d-9c37-361fe0b79427	89be9393-6222-4590-8e9b-12090fafb09a
219	219	0	GBIF Germany	4f6826f2-4ff6-443d-b966-e6913bd24013	8a865214-f762-11e1-a439-00145eb45e9a
10	4	-6	GBIF Germany	4f6826f2-4ff6-443d-b966-e6913bd24013	8ce49caa-f762-11e1-a439-00145eb45e9a
15	12	-3	GBIF Germany	4f6826f2-4ff6-443d-b966-e6913bd24013	8d034664-f762-11e1-a439-00145eb45e9a
1	1	0	Plazi	ffb07bec-2d10-492d-9c37-361fe0b79427	8e254953-d10f-4e33-aed8-9d0dab2953c2
66	52	-14	GBIF Germany	4f6826f2-4ff6-443d-b966-e6913bd24013	8fd65e8a-f762-11e1-a439-00145eb45e9a
13	9	-4	GBIF Germany	4f6826f2-4ff6-443d-b966-e6913bd24013	916b8a5e-f762-11e1-a439-00145eb45e9a
528	528	0	GBIF Germany	4f6826f2-4ff6-443d-b966-e6913bd24013	919e144c-f762-11e1-a439-00145eb45e9a
77	77	0	GBIF Germany	4f6826f2-4ff6-443d-b966-e6913bd24013	9265c67c-f762-11e1-a439-00145eb45e9a
5	5	0	Plazi	ffb07bec-2d10-492d-9c37-361fe0b79427	92bd3b92-5be7-419b-ad51-301d63c4b0f1
0	1567	1567	GBIF France	da44cd31-5901-4687-a106-6d1c7734ee3a	92cc96d0-9952-48ce-826f-3ecb72b1ccf1
364	364	0	GBIF Germany	4f6826f2-4ff6-443d-b966-e6913bd24013	9306c5a4-f762-11e1-a439-00145eb45e9a
2	2	0	GBIF Germany	4f6826f2-4ff6-443d-b966-e6913bd24013	938857e0-f762-11e1-a439-00145eb45e9a
263	269	6	GBIF Germany	4f6826f2-4ff6-443d-b966-e6913bd24013	94f1a0fa-f762-11e1-a439-00145eb45e9a
0	6	6	Plazi	ffb07bec-2d10-492d-9c37-361fe0b79427	95162697-db5d-4e65-ae89-ccf6aa1ac03d
1	1	0	Plazi	ffb07bec-2d10-492d-9c37-361fe0b79427	9525704a-0535-4e62-9f30-fc0fb7c25a60
0	253	253	Colombian Biodiversity Information System	7e865cba-7c46-417b-ade5-97f2cf5b7be0	96b147ba-4672-49b3-b829-79cf499ef086
6702	6702	0	National Biodiversity Network	d897a5b9-35ee-4232-94bd-b0bcaac003c2	98b65a0d-22ec-477b-a0aa-d95f1aa0ca61
0	180	180	Plazi	ffb07bec-2d10-492d-9c37-361fe0b79427	9b3e85f1-1856-49bc-8cde-b2d197897698
66	66	0	GBIF Argentina	2426a871-9feb-40a1-96c6-0c593a76b835	9d457aad-ab00-4840-8f4a-4a91834525b4
41	41	0	Plazi	ffb07bec-2d10-492d-9c37-361fe0b79427	9dd2669a-236e-4ede-bc1a-4548f7d2c2f4
0	2	2	Plazi	ffb07bec-2d10-492d-9c37-361fe0b79427	9ff37989-fe94-4548-86ca-2b7647a831c1
1550	1550	0	Atlas of Living Australia	4a6f1b71-969e-4fc5-a693-282b05e1220c	a16a504d-de4b-4a26-9590-ab18da7e41f9
2060	2060	0	GBIF Germany	4f6826f2-4ff6-443d-b966-e6913bd24013	a3409503-838e-4664-9540-03240664743f
0	10537	10537	Biodiversity Information System of Mexico	b324e8e9-9a4c-44fa-8f1a-7f39ea7ab576	a4305468-d94d-4244-b146-738e52d8a6e9
17	17	0	GBIF Malawi	2a42e4d7-ad4a-41b3-84c4-de4aa7b74d35	a4934120-5e8f-4d83-bb99-1715f4f53635
33616	33616	0	Ocean Biodiversity Information System	ba0670b9-4186-41e6-8e70-f9cb3065551a	a5ed684f-e948-4ffd-a09f-9ddfa504effa
1355	1334	-21	Participant Node Managers Committee	7f48e0c8-5c96-49ec-b972-30748e339115	a85dfdfc-345c-4b02-ba1e-140ca992b662
94	94	0	GBIF Germany	4f6826f2-4ff6-443d-b966-e6913bd24013	a9aec242-8efb-4d5b-ad26-4dd4db12b754
0	2	2	Plazi	ffb07bec-2d10-492d-9c37-361fe0b79427	ace285f1-f04e-45d4-b04f-14108c117e2c
0	16	16	Ocean Biodiversity Information System	ba0670b9-4186-41e6-8e70-f9cb3065551a	ae159394-310f-4319-8647-285f43952373
944	987	43	GBIF Japan	db5705aa-6a6e-42f1-8942-d77b9f4896ea	b0023a4f-de9c-4a46-a021-222ddcc93d21
1285	1285	0	National Biodiversity Network	d897a5b9-35ee-4232-94bd-b0bcaac003c2	b07821e4-9b49-4149-87fa-c5d4f9b9708d
6	6	0	ASEAN Centre for Biodiversity	af2a0fa1-4c8e-4bdc-8954-b1a55e32b0f1	b09d988e-8a4f-4600-8f64-bff18fe3d957
2	2	0	Plazi	ffb07bec-2d10-492d-9c37-361fe0b79427	b2e284c1-70c1-4e2e-a6ef-cff807e570b5
178	178	0	Colombian Biodiversity Information System	7e865cba-7c46-417b-ade5-97f2cf5b7be0	b8aa8ffc-35c1-4a79-b7c4-780802b7cf60
2677	2677	0	National Biodiversity Network	d897a5b9-35ee-4232-94bd-b0bcaac003c2	bb0e22fa-c4a0-4411-a607-c8fae221bbb1
5426	5426	0	GBIF France	da44cd31-5901-4687-a106-6d1c7734ee3a	bb2584cf-bfcb-4806-a873-ba15b005048f
30	30	0	Plazi	ffb07bec-2d10-492d-9c37-361fe0b79427	bc3175fc-8f7f-4b44-9377-d1fd2dfeba84
0	1305	1305	Participant Node Managers Committee	7f48e0c8-5c96-49ec-b972-30748e339115	bd26b03c-2cdf-47d6-8e30-7d4b7186c492
0	27	27	Plazi	ffb07bec-2d10-492d-9c37-361fe0b79427	c2d59cb8-6001-48c9-b41d-96af31028066
0	16	16	Plazi	ffb07bec-2d10-492d-9c37-361fe0b79427	c36e980f-7d7d-4b7d-a253-d3d4dc73de11
0	29	29	Plazi	ffb07bec-2d10-492d-9c37-361fe0b79427	c3d0536a-78ea-49ef-b366-40d77d404e2d
4	4	0	Colombian Biodiversity Information System	7e865cba-7c46-417b-ade5-97f2cf5b7be0	c3e21e0e-4d9c-43b2-909f-70a7fe5d903b
2	2	0	Plazi	ffb07bec-2d10-492d-9c37-361fe0b79427	c42428ae-69a2-4880-bcc0-a3daa821b5f6
14	14	0	Plazi	ffb07bec-2d10-492d-9c37-361fe0b79427	c61cc62d-3741-4897-9b6e-47996358bc06
2180	2180	0	GBIF Norway	4f829580-180d-46a9-9c87-ed8ec959b545	c6dc7a32-b0d6-4ae5-838c-085bfad3b4d3
1032	1032	0	GBIF Switzerland	169eb292-376b-4cc6-8e31-9c2c432de0ad	c72d40da-9245-44e5-91a6-febbf6496322
3403	3403	0	Canadensys	4db9cfd2-1191-4b9d-b579-0b68ceabd968	ca16e061-b737-4876-9a67-9938f3aa6c8f
1541	1541	0	GBIF Germany	4f6826f2-4ff6-443d-b966-e6913bd24013	cabd8752-e823-4e06-8eca-c28d8299bf90
64	64	0	Plazi	ffb07bec-2d10-492d-9c37-361fe0b79427	cad447bb-0619-4742-80fd-2c305053e4aa
25	25	0	Plazi	ffb07bec-2d10-492d-9c37-361fe0b79427	cf5561c6-3239-4d22-881e-4d4a07883bc3
431	431	0	Colombian Biodiversity Information System	7e865cba-7c46-417b-ade5-97f2cf5b7be0	cf633c2d-7006-4bc9-bff3-1b8a0c1124c9
3	3	0	GBIF Argentina	2426a871-9feb-40a1-96c6-0c593a76b835	cfe55cbb-3c21-4649-8001-3e67ae702889
0	22	22	Ocean Biodiversity Information System	ba0670b9-4186-41e6-8e70-f9cb3065551a	d1ae4fec-e81f-4147-b518-52f882c6451f
2	2	0	Plazi	ffb07bec-2d10-492d-9c37-361fe0b79427	d1f4c672-a490-4c05-8124-803b5d99a165
10061	10061	0	National Biodiversity Network	d897a5b9-35ee-4232-94bd-b0bcaac003c2	d2f4cb78-093a-48fd-ac63-76e151a2bbbc
2	2	0	Plazi	ffb07bec-2d10-492d-9c37-361fe0b79427	d491e4d8-b7df-45d5-a191-346527bcdfe9
530	530	0	GBIF France	da44cd31-5901-4687-a106-6d1c7734ee3a	d4b26364-88f1-416e-8301-e6d73fc27052
19228	19228	0	GBIF France	da44cd31-5901-4687-a106-6d1c7734ee3a	d58ae86d-caff-42a6-b276-fadd7ab1e574
0	1	1	Plazi	ffb07bec-2d10-492d-9c37-361fe0b79427	d608df15-16f8-4582-b2c8-4e9476a3cc67
1276	1276	0	Colombian Biodiversity Information System	7e865cba-7c46-417b-ade5-97f2cf5b7be0	d75ef2bb-a01a-4899-8bca-d70421343f27
70	70	0	GBIF Brazil	cdc9736d-5ff7-4ece-9959-3c744360cdb3	d9309bc6-e48c-4a92-a0a5-cb538a8096cd
1503	1503	0	Colombian Biodiversity Information System	7e865cba-7c46-417b-ade5-97f2cf5b7be0	d981c07d-bc43-40a2-be1f-e786e25106ac
16	16	0	Plazi	ffb07bec-2d10-492d-9c37-361fe0b79427	da79b654-bd50-4715-8ed3-80fa7a00d469
5787	5787	0	GBIF Germany	4f6826f2-4ff6-443d-b966-e6913bd24013	dc70aa06-ada2-11e2-8fbc-00145eb45e9a
118	118	0	Plazi	ffb07bec-2d10-492d-9c37-361fe0b79427	dd42758b-fc68-4ddb-a7ca-62244d591379
6444	6444	0	National Biodiversity Network	d897a5b9-35ee-4232-94bd-b0bcaac003c2	de8221ff-6110-46e3-aec4-b61133f5b38c
2	2	0	GBIF France	da44cd31-5901-4687-a106-6d1c7734ee3a	dedd38d1-be22-4d5a-bbb3-68977e0daa37
0	68	68	National Biodiversity Network	d897a5b9-35ee-4232-94bd-b0bcaac003c2	def5f1ab-0299-4f17-8dce-5ad153cc3969
0	912	912	Ocean Biodiversity Information System	ba0670b9-4186-41e6-8e70-f9cb3065551a	dff0a4d0-f3b7-4455-a49d-497ae22b52af
3	3	0	Plazi	ffb07bec-2d10-492d-9c37-361fe0b79427	e0b357c8-e3b7-4493-b74f-ac40de7336f9
2	2	0	Plazi	ffb07bec-2d10-492d-9c37-361fe0b79427	e19b6b64-b0ad-4a54-be72-029aa3fc672a
0	5	5	Plazi	ffb07bec-2d10-492d-9c37-361fe0b79427	e316c224-2abc-4026-b36f-52ddd65be1e5
0	119267	119267	U.S. Geological Survey	8618c64a-93e0-4300-b546-7249e5148ed2	e5d9d04e-ffd1-4395-9b10-76034f0c619c
1098	1098	0	Atlas of Living Australia	4a6f1b71-969e-4fc5-a693-282b05e1220c	e697698b-17ec-48a3-aa60-273b24640013
3	3	0	Plazi	ffb07bec-2d10-492d-9c37-361fe0b79427	e6ff1717-8c1e-46d1-bcf9-caec6e19e40f
0	3	3	Plazi	ffb07bec-2d10-492d-9c37-361fe0b79427	e74c14a1-adcd-492c-8d1f-5208568d14d5
2803	2803	0	GBIF France	da44cd31-5901-4687-a106-6d1c7734ee3a	e7ab8694-c34a-4658-b5c4-eb25e358ee47
0	1766	1766	Plazi	ffb07bec-2d10-492d-9c37-361fe0b79427	e9fcfa2b-72cd-4826-a7e5-c33cd37bf00e
50954	52286	1332	BioCASE	d8bbf693-a180-4995-94fe-6130795dcf2f	ea04653c-58f5-4f14-9ed0-39f85871f1db
2246	2246	0	GBIF Benin	efb9c00e-f802-45dd-8826-a52ec45b89ff	ed5fc1c1-5a36-4ae0-a208-b7b89c8aacf7
2884	2884	0	Biodiversity Information System of Mexico	b324e8e9-9a4c-44fa-8f1a-7f39ea7ab576	ee6be9b3-f850-4a0b-bddc-73c13a078e52
5539	5539	0	GBIF Portugal	673f7038-4262-4149-b753-5658a4e912f6	eea28fcf-a2a4-40bc-a9f9-e22743f19363
9435714	9435714	0	GBIF Spain	1f94b3ca-9345-4d65-afe2-4bace93aa0fe	f06fef3c-6ea6-4345-b724-a1b8e490dc55
0	2	2	Plazi	ffb07bec-2d10-492d-9c37-361fe0b79427	f2fedf43-472c-4104-bd88-b8f43086368c
317934	317934	0	GBIF Argentina	2426a871-9feb-40a1-96c6-0c593a76b835	f5de707d-eba1-4f1a-b1df-1a7fa27b1bc7
163	163	0	Participant Node Managers Committee	7f48e0c8-5c96-49ec-b972-30748e339115	f6b08eda-661d-4dc9-8b3d-4a737d87cca6
599	599	0	Biodiversity Information System of Mexico	b324e8e9-9a4c-44fa-8f1a-7f39ea7ab576	f733e216-d50a-470b-a0c8-c35a80141bdc
4736	4736	0	Atlas of Living Australia	4a6f1b71-969e-4fc5-a693-282b05e1220c	f74dfed8-d09b-4b18-8443-c20754410e16
13	13	0	Plazi	ffb07bec-2d10-492d-9c37-361fe0b79427	fcc61792-8ac6-498b-933f-41298412fd32
0	4	4	Plazi	ffb07bec-2d10-492d-9c37-361fe0b79427	fda28adc-c9ac-435c-8a75-bc9a452d1336
124	124	0	Biodiversity Information System of Mexico	b324e8e9-9a4c-44fa-8f1a-7f39ea7ab576	feea925c-a7fa-467f-bd50-7e3931213e31
0	9	9	Plazi	ffb07bec-2d10-492d-9c37-361fe0b79427	ffb3e7d0-4160-4dc4-8d01-cb5af702bd4c
0	50	50	Plazi	ffb07bec-2d10-492d-9c37-361fe0b79427	03a9be04-f633-4adc-8397-058c282f216b
0	103	103	Plazi	ffb07bec-2d10-492d-9c37-361fe0b79427	0654df2f-76be-46e0-9ef8-bec985748e0c
0	561976	561976	GBIF Portugal	673f7038-4262-4149-b753-5658a4e912f6	066c8a43-ce9f-4cf3-a428-44fb698f079b
2490	2490	0	Biodiversity Information System of Mexico	b324e8e9-9a4c-44fa-8f1a-7f39ea7ab576	082cd887-844e-4545-a15e-02578d3a672d
53	48	-5	GBIF Germany	4f6826f2-4ff6-443d-b966-e6913bd24013	0e07b735-000f-4ca5-b7f1-b88addbb79c6
39	39	0	Plazi	ffb07bec-2d10-492d-9c37-361fe0b79427	0ff4f2ea-dc22-4d23-aa8d-12be8542e9aa
2	2	0	Plazi	ffb07bec-2d10-492d-9c37-361fe0b79427	12408039-68f1-44c0-9aa4-7542340b1f30
4	4	0	Plazi	ffb07bec-2d10-492d-9c37-361fe0b79427	134fa0f5-ddf1-495f-a206-87e7b98aff44
11	11	0	Plazi	ffb07bec-2d10-492d-9c37-361fe0b79427	1a4215e4-efe9-441a-b421-eb004d8e9570
115	115	0	Participant Node Managers Committee	7f48e0c8-5c96-49ec-b972-30748e339115	1bd56795-0669-4e5b-a3a4-41527fc4e66c
6	6	0	Plazi	ffb07bec-2d10-492d-9c37-361fe0b79427	2197832f-5711-4616-a37e-da1ce0594800
18	18	0	GBIF France	da44cd31-5901-4687-a106-6d1c7734ee3a	2297b816-459a-4025-9a9b-2f63da29e54e
229	229	0	GBIF Norway	4f829580-180d-46a9-9c87-ed8ec959b545	2372eba1-a784-48a3-980e-ae7798f12c7d
1	1	0	Plazi	ffb07bec-2d10-492d-9c37-361fe0b79427	264af183-e8ff-4d6f-9b42-b18f800af618
1151	1151	0	Colombian Biodiversity Information System	7e865cba-7c46-417b-ade5-97f2cf5b7be0	278b1d5c-d7a9-4f7a-9651-69cddbb5b94e
0	6	6	Participant Node Managers Committee	7f48e0c8-5c96-49ec-b972-30748e339115	2887c45e-7a73-4bee-8a22-4ef799a2cb1d
32	32	0	Plazi	ffb07bec-2d10-492d-9c37-361fe0b79427	31283f24-de4e-4e42-a292-6c43c8107a6f
807	807	0	National Biodiversity Network	d897a5b9-35ee-4232-94bd-b0bcaac003c2	325b810f-39e0-4222-9160-5b111b1c60a0
11519	1500	-10019	Biodiversity Information System of Mexico	b324e8e9-9a4c-44fa-8f1a-7f39ea7ab576	32d48308-ed92-4cd8-bd45-9b767596c1f2
0	116	116	Ocean Biodiversity Information System	ba0670b9-4186-41e6-8e70-f9cb3065551a	36c32d38-301e-4259-a536-e374e75c72eb
2	2	0	GBIF Japan	db5705aa-6a6e-42f1-8942-d77b9f4896ea	37b63595-14ca-4d38-a758-892122df20d4
0	4	4	Plazi	ffb07bec-2d10-492d-9c37-361fe0b79427	3d6ccde8-8bb5-4942-adea-012df612c00c
6	6	0	Plazi	ffb07bec-2d10-492d-9c37-361fe0b79427	3ddd3cdb-eb4d-414f-8907-bcf8127808ae
6	6	0	Plazi	ffb07bec-2d10-492d-9c37-361fe0b79427	3f507f9b-c34e-417f-8e59-9b44dd95cfbd
78174	78174	0	National Biodiversity Network	d897a5b9-35ee-4232-94bd-b0bcaac003c2	419070cf-9dd8-44d9-b135-9dac70c99461
0	1	1	Plazi	ffb07bec-2d10-492d-9c37-361fe0b79427	41a242cc-d9ec-4de9-aa6f-46fa18b2d5a1
20	20	0	Plazi	ffb07bec-2d10-492d-9c37-361fe0b79427	41f6280e-96a0-41b9-af1e-2a5355d2fec8
65	65	0	GBIF France	da44cd31-5901-4687-a106-6d1c7734ee3a	4367882e-714d-4268-a657-5dd7680eff15
513	513	0	GBIF France	da44cd31-5901-4687-a106-6d1c7734ee3a	45ac6d5c-fa14-4300-b2dc-27a48fa70f63
2	2	0	Plazi	ffb07bec-2d10-492d-9c37-361fe0b79427	473de193-123e-49c7-95d8-011c75406e30
326	326	0	Ocean Biodiversity Information System	ba0670b9-4186-41e6-8e70-f9cb3065551a	48374879-e066-4ff0-8b8e-c7c56d53926b
3	3	0	Plazi	ffb07bec-2d10-492d-9c37-361fe0b79427	48c4c168-7dfc-46df-9de4-f7417c3043e6
75	75	0	Plazi	ffb07bec-2d10-492d-9c37-361fe0b79427	48d67ec7-59cb-4b6c-b2b0-a37142dc3aae
29513	29513	0	U.S. Geological Survey	8618c64a-93e0-4300-b546-7249e5148ed2	49c45996-3726-468e-be35-eb37cb5b8e45
0	3	3	Ocean Biodiversity Information System	ba0670b9-4186-41e6-8e70-f9cb3065551a	4abbf4b1-0f56-4bef-ad22-9a45772c56c4
2994	2994	0	Belgian Biodiversity Platform	fb11cfe1-ebc3-45af-9159-17d9fddbcdac	4d23ed91-bfbd-4e60-8589-aac3c8af2d30
2563	2563	0	Participant Node Managers Committee	7f48e0c8-5c96-49ec-b972-30748e339115	4ef10600-d213-4777-835d-9e134f5f6335
6	6	0	Plazi	ffb07bec-2d10-492d-9c37-361fe0b79427	4ffcf039-158f-4843-8a62-a4b4169a1992
2389	1876	-513	GBIF Germany	4f6826f2-4ff6-443d-b966-e6913bd24013	50496dc9-8515-4bbf-887b-5d47baadba46
5015	5015	0	GBIF France	da44cd31-5901-4687-a106-6d1c7734ee3a	50d9be1e-93e7-446d-a8c8-6e30dbc1f646
2	2	0	Plazi	ffb07bec-2d10-492d-9c37-361fe0b79427	5183353a-133b-4453-a274-1f75169c9002
0	10	10	Plazi	ffb07bec-2d10-492d-9c37-361fe0b79427	5430ee81-c966-434d-8889-56d32a6de359
0	1	1	Ocean Biodiversity Information System	ba0670b9-4186-41e6-8e70-f9cb3065551a	565aec49-e0a6-4eb4-b70c-9a8ce9ac88a9
14	14	0	Plazi	ffb07bec-2d10-492d-9c37-361fe0b79427	56c3893b-2b50-4969-9dc1-b806fd94114a
780	780	0	Colombian Biodiversity Information System	7e865cba-7c46-417b-ade5-97f2cf5b7be0	570510ec-5dd3-4c0d-9911-473f53788a00
59	59	0	Plazi	ffb07bec-2d10-492d-9c37-361fe0b79427	5722d23f-3533-4621-9ce8-8fec0f035a56
0	8	8	Plazi	ffb07bec-2d10-492d-9c37-361fe0b79427	57352731-ce41-4161-9cd1-7a6879158de2
84521	84521	0	GBIF Israel	8cb55387-7802-40e8-86d6-d357a583c596	5a6b5bd4-cf31-4d5f-9a85-a331b7178a77
0	5	5	Plazi	ffb07bec-2d10-492d-9c37-361fe0b79427	5b5646c4-f7c3-48d0-8f8d-73269c9ef6e9
591	591	0	Taiwan Biodiversity Information Facility	e1b85abc-61f9-430f-ba79-6813dec53a0f	5bdda925-9237-40ef-ab40-a39a226352e4
0	13	13	Plazi	ffb07bec-2d10-492d-9c37-361fe0b79427	5e4f90e6-bed3-4335-85ba-f7dcdbee7f9e
5704	5704	0	National Biodiversity Network	d897a5b9-35ee-4232-94bd-b0bcaac003c2	5ecea5a3-9682-4ded-aa0a-3211383df616
2039	2039	0	Colombian Biodiversity Information System	7e865cba-7c46-417b-ade5-97f2cf5b7be0	5f11d83e-4276-4cc0-93f4-86918b390383
6860	6860	0	GBIF Japan	db5705aa-6a6e-42f1-8942-d77b9f4896ea	60807e2a-422e-48a4-b79d-eeb35820a8bb
94	94	0	GBIF Germany	4f6826f2-4ff6-443d-b966-e6913bd24013	6129c392-f762-11e1-a439-00145eb45e9a
271	271	0	GBIF Germany	4f6826f2-4ff6-443d-b966-e6913bd24013	615a1d6c-f762-11e1-a439-00145eb45e9a
506	506	0	GBIF Germany	4f6826f2-4ff6-443d-b966-e6913bd24013	61ab6690-f762-11e1-a439-00145eb45e9a
1894	1894	0	Colombian Biodiversity Information System	7e865cba-7c46-417b-ade5-97f2cf5b7be0	623a1b22-f957-47dd-8e84-9bc5c8c3a6c2
0	5	5	Participant Node Managers Committee	7f48e0c8-5c96-49ec-b972-30748e339115	6313816b-c74d-4ed3-b0a3-8420aa674532
717	717	0	Participant Node Managers Committee	7f48e0c8-5c96-49ec-b972-30748e339115	643006ae-90d9-4284-8ed6-499e75fba0c8
9	9	0	Plazi	ffb07bec-2d10-492d-9c37-361fe0b79427	6489a4fd-f3c7-4e9a-9a0d-639c0227ff79
24	24	0	Plazi	ffb07bec-2d10-492d-9c37-361fe0b79427	65b49fb4-4956-42e4-bdfa-b3b0c5fc7f5f
145	141	-4	GBIF Germany	4f6826f2-4ff6-443d-b966-e6913bd24013	65df4eb6-f762-11e1-a439-00145eb45e9a
9	9	0	Plazi	ffb07bec-2d10-492d-9c37-361fe0b79427	65ff8808-27b5-43df-af44-fc56857e8906
1342	1342	0	National Biodiversity Network	d897a5b9-35ee-4232-94bd-b0bcaac003c2	662214cd-ba7a-4eab-af87-477d12ea1176
95	95	0	GBIF Germany	4f6826f2-4ff6-443d-b966-e6913bd24013	6677e0b8-f762-11e1-a439-00145eb45e9a
123	123	0	GBIF Germany	4f6826f2-4ff6-443d-b966-e6913bd24013	672ebf22-f762-11e1-a439-00145eb45e9a
45	45	0	GBIF Germany	4f6826f2-4ff6-443d-b966-e6913bd24013	67851cd2-f762-11e1-a439-00145eb45e9a
5	5	0	Plazi	ffb07bec-2d10-492d-9c37-361fe0b79427	678541eb-a27d-4dc5-b316-ebe8e0a5abed
0	28	28	Ocean Biodiversity Information System	ba0670b9-4186-41e6-8e70-f9cb3065551a	6aed4bdd-3513-43fb-9b15-8c8933b165a4
0	4	4	Plazi	ffb07bec-2d10-492d-9c37-361fe0b79427	6b56cf11-c948-4884-8f92-b34983fc0e70
53	53	0	GBIF Germany	4f6826f2-4ff6-443d-b966-e6913bd24013	6d38a69e-f762-11e1-a439-00145eb45e9a
0	1	1	Plazi	ffb07bec-2d10-492d-9c37-361fe0b79427	6d80c4cb-d0e1-4282-a8cd-83886bea159e
3	3	0	Plazi	ffb07bec-2d10-492d-9c37-361fe0b79427	6d83ffd5-ef95-42b3-8d96-9368302ff5c9
3	3	0	Plazi	ffb07bec-2d10-492d-9c37-361fe0b79427	6e765cd7-2cda-4459-b87f-e74f8dfe502e
3	3	0	Plazi	ffb07bec-2d10-492d-9c37-361fe0b79427	70f90013-3e3c-4726-b157-cd4b0f4ef21a
1451	1451	0	Biodiversity Information System of Mexico	b324e8e9-9a4c-44fa-8f1a-7f39ea7ab576	7144a7d6-4341-4f06-b2e5-35e44b606f7a
221	221	0	GBIF Germany	4f6826f2-4ff6-443d-b966-e6913bd24013	7149e310-f762-11e1-a439-00145eb45e9a
5735	5735	0	Colombian Biodiversity Information System	7e865cba-7c46-417b-ade5-97f2cf5b7be0	71d88365-78c6-4906-a4a9-87b940707181
63293	63331	38	U.S. Geological Survey	8618c64a-93e0-4300-b546-7249e5148ed2	72d3505f-70c4-4743-a872-7f8010498fb9
9	9	0	Plazi	ffb07bec-2d10-492d-9c37-361fe0b79427	736d22cc-aba2-4e9f-9239-ae16c6526334
9	9	0	GBIF Germany	4f6826f2-4ff6-443d-b966-e6913bd24013	73cc3868-f762-11e1-a439-00145eb45e9a
2236	2236	0	GBIF France	da44cd31-5901-4687-a106-6d1c7734ee3a	74f58e6a-81cf-466d-a6e2-8e8500a9551d
392	252	-140	GBIF Germany	4f6826f2-4ff6-443d-b966-e6913bd24013	74f747e4-ff7d-44e7-acbe-1502ee288b39
136	136	0	GBIF Germany	4f6826f2-4ff6-443d-b966-e6913bd24013	75b4c4ba-f762-11e1-a439-00145eb45e9a
0	9	9	Plazi	ffb07bec-2d10-492d-9c37-361fe0b79427	7a218524-9d40-45bb-a1bc-910b4efd15b9
42	42	0	GBIF Germany	4f6826f2-4ff6-443d-b966-e6913bd24013	7a68e482-f762-11e1-a439-00145eb45e9a
67198	76998	9800	GBIF Japan	db5705aa-6a6e-42f1-8942-d77b9f4896ea	7aded4b2-f762-11e1-a439-00145eb45e9a
3708	3708	0	Korean Biodiversity Information Facility	e0a1e772-0177-4800-94b4-2d023fe6cdf4	7b0153e8-f762-11e1-a439-00145eb45e9a
1344	928	-416	GBIF Germany	4f6826f2-4ff6-443d-b966-e6913bd24013	7bd25830-f762-11e1-a439-00145eb45e9a
630	630	0	GBIF Germany	4f6826f2-4ff6-443d-b966-e6913bd24013	7c0dbccc-f762-11e1-a439-00145eb45e9a
569	569	0	GBIF Germany	4f6826f2-4ff6-443d-b966-e6913bd24013	7c4a44c6-f762-11e1-a439-00145eb45e9a
4	4	0	Plazi	ffb07bec-2d10-492d-9c37-361fe0b79427	7d2e7b0e-4205-41b3-8257-846b80522896
8	8	0	Ocean Biodiversity Information System	ba0670b9-4186-41e6-8e70-f9cb3065551a	7e3d591b-3eb5-4bf2-9dbe-00eb66c9975d
0	1	1	Plazi	ffb07bec-2d10-492d-9c37-361fe0b79427	7f96e023-0951-4539-af1a-2542893c3848
2848	2848	0	GBIF Germany	4f6826f2-4ff6-443d-b966-e6913bd24013	815fd610-f762-11e1-a439-00145eb45e9a
543	543	0	GBIF Germany	4f6826f2-4ff6-443d-b966-e6913bd24013	8193f0da-f762-11e1-a439-00145eb45e9a
47	47	0	Ocean Biodiversity Information System	ba0670b9-4186-41e6-8e70-f9cb3065551a	8919516a-f762-11e1-a439-00145eb45e9a
364	364	0	GBIF Germany	4f6826f2-4ff6-443d-b966-e6913bd24013	89a04454-f762-11e1-a439-00145eb45e9a
135	135	0	GBIF Germany	4f6826f2-4ff6-443d-b966-e6913bd24013	8ad21ee2-f762-11e1-a439-00145eb45e9a
0	37	37	Netherlands Biodiversity Information Facility	0909d601-bda2-42df-9e63-a6d51847ebce	8ad85291-8e3e-4cdc-8be9-ac1c552b9e02
20	20	0	GBIF Germany	4f6826f2-4ff6-443d-b966-e6913bd24013	8c468e30-1dcf-400e-9606-7ff4bf2c6e58
536	328	-208	GBIF Germany	4f6826f2-4ff6-443d-b966-e6913bd24013	8da45252-f762-11e1-a439-00145eb45e9a
0	261	261	Atlas of Living Australia	4a6f1b71-969e-4fc5-a693-282b05e1220c	8dcd9007-4e5b-4319-928e-8fb72d628361
20	13	-7	GBIF Germany	4f6826f2-4ff6-443d-b966-e6913bd24013	8e3e134c-f762-11e1-a439-00145eb45e9a
153	109	-44	GBIF Germany	4f6826f2-4ff6-443d-b966-e6913bd24013	8e653594-f762-11e1-a439-00145eb45e9a
2020	1413	-607	GBIF Germany	4f6826f2-4ff6-443d-b966-e6913bd24013	8f2ee8bc-f762-11e1-a439-00145eb45e9a
371	289	-82	GBIF Germany	4f6826f2-4ff6-443d-b966-e6913bd24013	8f58880c-f762-11e1-a439-00145eb45e9a
3	3	0	Plazi	ffb07bec-2d10-492d-9c37-361fe0b79427	8f6fdca0-5e71-4c51-b4fe-237621ecb8f2
228	122	-106	GBIF Germany	4f6826f2-4ff6-443d-b966-e6913bd24013	8f706ada-f762-11e1-a439-00145eb45e9a
27	18	-9	GBIF Germany	4f6826f2-4ff6-443d-b966-e6913bd24013	91359520-f762-11e1-a439-00145eb45e9a
94	90	-4	GBIF Germany	4f6826f2-4ff6-443d-b966-e6913bd24013	914c7484-f762-11e1-a439-00145eb45e9a
1	1	0	Plazi	ffb07bec-2d10-492d-9c37-361fe0b79427	918e60e7-493d-4d0c-aa39-ce564d1f54a8
928	928	0	Participant Node Managers Committee	7f48e0c8-5c96-49ec-b972-30748e339115	9324c04c-7ac6-4b69-b98c-4472c51c73c5
23	23	0	Plazi	ffb07bec-2d10-492d-9c37-361fe0b79427	974fe412-0658-41ad-bb31-cd2c52bf34f2
93	93	0	GBIF Germany	4f6826f2-4ff6-443d-b966-e6913bd24013	9790a1e9-f5c3-4da3-975a-f746666130b0
0	1698	1698	Atlas of Living Australia	4a6f1b71-969e-4fc5-a693-282b05e1220c	9db19baa-73bb-482d-966d-375846f2c7dd
0	5	5	Ocean Biodiversity Information System	ba0670b9-4186-41e6-8e70-f9cb3065551a	9e43a19f-ae0e-41da-b1de-a91215ade961
0	6	6	Participant Node Managers Committee	7f48e0c8-5c96-49ec-b972-30748e339115	9e4479d8-69a4-4d6c-91ee-1fc48e70cc19
475072	505339	30267	GBIF Sweden	a0b3be64-6525-4387-ac67-a499950f92e1	9e932f70-0c61-11dd-84ce-b8a03c50a862
12	12	0	Plazi	ffb07bec-2d10-492d-9c37-361fe0b79427	a1481992-dbc6-4d01-b03f-f414260ec51b
0	1	1	Plazi	ffb07bec-2d10-492d-9c37-361fe0b79427	a3f3bdaf-6c0f-4d3d-b47e-acd368b1d67f
0	10	10	Plazi	ffb07bec-2d10-492d-9c37-361fe0b79427	a4c1b33e-e026-4c37-8632-04b8402ff337
714	714	0	GBIF Germany	4f6826f2-4ff6-443d-b966-e6913bd24013	a53a53ee-1f0a-472a-8cd1-d1c42c6b3c0a
115079	115687	608	U.S. Geological Survey	8618c64a-93e0-4300-b546-7249e5148ed2	a92de2e1-647c-43f2-a8b7-ab1c1a6453dd
1420	1420	0	National Biodiversity Network	d897a5b9-35ee-4232-94bd-b0bcaac003c2	ab837fe5-80f7-452f-a2e6-ec69f3d1e6e8
0	3	3	Plazi	ffb07bec-2d10-492d-9c37-361fe0b79427	abe666bf-f37e-4916-81b9-5572d3645128
0	60	60	Plazi	ffb07bec-2d10-492d-9c37-361fe0b79427	abec7bf7-4de7-4d60-ba0f-c54a56fd2fd3
1203	1203	0	Participant Node Managers Committee	7f48e0c8-5c96-49ec-b972-30748e339115	ae330c1c-212c-47ee-8078-be7274779ff1
3291911	3291911	0	Atlas of Living Australia	4a6f1b71-969e-4fc5-a693-282b05e1220c	b05a19cf-dcf2-4ef9-bbbb-ad0ecbd2917c
8	8	0	Plazi	ffb07bec-2d10-492d-9c37-361fe0b79427	b0b81783-6875-45d3-b980-6ba4bdcd972b
3803	3803	0	Belgian Biodiversity Platform	fb11cfe1-ebc3-45af-9159-17d9fddbcdac	b24d3bd0-e6d9-11dc-8b77-b8a03c50a862
0	70	70	Participant Node Managers Committee	7f48e0c8-5c96-49ec-b972-30748e339115	b2bd4dd4-aa79-403a-b7fa-274c1f8f0383
0	4	4	Plazi	ffb07bec-2d10-492d-9c37-361fe0b79427	b3669508-765e-44a4-99b4-fefe16289429
6111	6141	30	GBIF Brazil	cdc9736d-5ff7-4ece-9959-3c744360cdb3	b5adf05f-7dd4-45b0-9aad-5948c4c42899
178	178	0	GBIF France	da44cd31-5901-4687-a106-6d1c7734ee3a	bc4004f0-2a37-48db-94c2-9381190adbe0
0	4	4	Plazi	ffb07bec-2d10-492d-9c37-361fe0b79427	bd1f1341-51cd-468c-aedd-0db2a60d44c1
0	3	3	Ocean Biodiversity Information System	ba0670b9-4186-41e6-8e70-f9cb3065551a	be04bfee-c519-4004-92b3-44dffde2e2dd
3681	3681	0	GBIF Benin	efb9c00e-f802-45dd-8826-a52ec45b89ff	be454edf-e4b7-444d-9f49-cfb54efeacaf
25	25	0	Plazi	ffb07bec-2d10-492d-9c37-361fe0b79427	beb5af6a-378d-4eea-b7bb-cd6bb86b51a7
214114	214114	0	Atlas of Living Australia	4a6f1b71-969e-4fc5-a693-282b05e1220c	beed1b50-8c73-11dc-aaed-b8a03c50a862
6	6	0	Plazi	ffb07bec-2d10-492d-9c37-361fe0b79427	bfd41e0f-ff57-423f-910b-8fa72710ac7f
53	53	0	Plazi	ffb07bec-2d10-492d-9c37-361fe0b79427	c0fbeef1-c4b2-406c-89f9-8de87f89381c
34171	34171	0	National Biodiversity Network	d897a5b9-35ee-4232-94bd-b0bcaac003c2	c566cd39-824e-4139-8b98-55564dadca96
578	578	0	Biodiversity Information System of Mexico	b324e8e9-9a4c-44fa-8f1a-7f39ea7ab576	c7a3af38-7fbf-424f-841c-853108ff5f66
4	4	0	Plazi	ffb07bec-2d10-492d-9c37-361fe0b79427	c919e523-2601-4d1c-9ca4-d2f41cd5d2ac
15835	15835	0	DanBIF - Danish Biodiversity Information Facility	4ddd294f-02b7-4359-ac33-0806a9ca9c6b	cb643105-2e6b-403d-a23b-2c8128d1f97c
277	277	0	Albertine Rift Conservation Society	90a939d3-e99c-4f6d-915f-2616423b3735	cc9bd573-9c96-4532-a723-52ce1d155b36
0	5	5	Plazi	ffb07bec-2d10-492d-9c37-361fe0b79427	cd6d1254-8cfc-4d73-b4df-bc50abbb91e4
55920	56014	94	GBIF Brazil	cdc9736d-5ff7-4ece-9959-3c744360cdb3	d0318a4e-8d55-4da6-b912-e90dd6ed960b
56	56	0	GBIF France	da44cd31-5901-4687-a106-6d1c7734ee3a	d130ed17-c0a6-4445-9fbe-ffc0ae827a19
2	2	0	Plazi	ffb07bec-2d10-492d-9c37-361fe0b79427	d200d36f-17ff-4180-adde-d4e8db9f2312
0	5	5	Plazi	ffb07bec-2d10-492d-9c37-361fe0b79427	d24cea67-3510-4515-a57a-02676b85a1f5
1	1	0	GBIF France	da44cd31-5901-4687-a106-6d1c7734ee3a	d534bdfd-cc73-40c2-8020-715658274ba0
1	1	0	Plazi	ffb07bec-2d10-492d-9c37-361fe0b79427	d8fd6aa2-41b6-4d26-8581-72373256d634
3	3	0	Participant Node Managers Committee	7f48e0c8-5c96-49ec-b972-30748e339115	da38edde-3b90-4d0e-8b46-e733c0ba1fe2
0	112	112	Ocean Biodiversity Information System	ba0670b9-4186-41e6-8e70-f9cb3065551a	da395b19-58eb-41d9-b3b5-2a434e143160
106	106	0	GBIF Spain	1f94b3ca-9345-4d65-afe2-4bace93aa0fe	de415da2-e5bb-4859-81ed-183806e22092
45	45	0	GBIF France	da44cd31-5901-4687-a106-6d1c7734ee3a	e03254f4-6920-4182-b41d-17a17f353f91
0	332	332	Plazi	ffb07bec-2d10-492d-9c37-361fe0b79427	e1297bcb-24e9-4306-8210-068cc6f5f482
0	3	3	Plazi	ffb07bec-2d10-492d-9c37-361fe0b79427	e222644f-8679-4aa2-9147-a240101ef7be
259	259	0	GBIF France	da44cd31-5901-4687-a106-6d1c7734ee3a	e2782efe-1978-42e4-ade6-38604babdf3c
0	2	2	Plazi	ffb07bec-2d10-492d-9c37-361fe0b79427	e34dbee5-a76b-4a12-8508-613b2d24064a
205	205	0	Colombian Biodiversity Information System	7e865cba-7c46-417b-ade5-97f2cf5b7be0	e598f892-71b7-48f3-a1b2-7e36ff2a0756
0	12	12	Plazi	ffb07bec-2d10-492d-9c37-361fe0b79427	e6f5543a-429c-448f-b8f2-0bcfc6f3d2ad
0	15	15	Plazi	ffb07bec-2d10-492d-9c37-361fe0b79427	e7161a51-3797-4a55-a0ad-98cb27f2070b
6	6	0	Plazi	ffb07bec-2d10-492d-9c37-361fe0b79427	e8b2f285-d4ba-469b-b4ea-1bb85efae660
0	7	7	Plazi	ffb07bec-2d10-492d-9c37-361fe0b79427	e9b014f6-3d7e-4abd-947b-af0cdacdfa6c
0	1	1	Plazi	ffb07bec-2d10-492d-9c37-361fe0b79427	eaae5424-9670-4a08-94ed-9d74cfc61785
37	37	0	Colombian Biodiversity Information System	7e865cba-7c46-417b-ade5-97f2cf5b7be0	eff81d05-65d9-495b-b679-87548fd3e20a
0	12	12	Plazi	ffb07bec-2d10-492d-9c37-361fe0b79427	f10e29e9-418c-44d5-845a-705c942bfa66
1422	1422	0	Atlas of Living Australia	4a6f1b71-969e-4fc5-a693-282b05e1220c	f2d200d5-914c-408f-821a-9ba0001465af
20487	20487	0	Colombian Biodiversity Information System	7e865cba-7c46-417b-ade5-97f2cf5b7be0	f885c8c7-8312-4e4d-a9f4-7e5b30a0a2d1
44	44	0	Colombian Biodiversity Information System	7e865cba-7c46-417b-ade5-97f2cf5b7be0	f8b0b52b-0383-44dd-9940-851e80bf6131
143	143	0	GBIF Brazil	cdc9736d-5ff7-4ece-9959-3c744360cdb3	f99eba58-668d-47f1-bf3d-e53dc88ad395
39	39	0	Plazi	ffb07bec-2d10-492d-9c37-361fe0b79427	f9c85cf8-face-43cf-a85a-8535f36056b1
0	2	2	Plazi	ffb07bec-2d10-492d-9c37-361fe0b79427	ffcaeacd-96c9-41ed-af96-25f54b4c369d
38	38	0	Plazi	ffb07bec-2d10-492d-9c37-361fe0b79427	008c2ce6-d9ae-424c-9e2b-0d16d9da40e7
9	9	0	Plazi	ffb07bec-2d10-492d-9c37-361fe0b79427	03227ac2-d243-4a4a-92f3-2e2e61fa1c98
437	437	0	Ghana Biodiversity Information Facility	b5633b75-6a86-4fdf-9cfc-506047fb9dc7	087b83f9-cbb6-4b54-828d-204d90169732
0	1160	1160	Plazi	ffb07bec-2d10-492d-9c37-361fe0b79427	0a027439-c601-4533-bd03-f0e5d4442801
131	131	0	GBIF France	da44cd31-5901-4687-a106-6d1c7734ee3a	0f135867-0c9d-4275-ba95-2e6babe87584
175	175	0	Biodiversity Information System of Mexico	b324e8e9-9a4c-44fa-8f1a-7f39ea7ab576	0f158594-69e0-4364-9a04-bcb6126cb97e
80	80	0	Ocean Biodiversity Information System	ba0670b9-4186-41e6-8e70-f9cb3065551a	11aec408-f323-454a-8057-9f9fc3552064
66	66	0	GBIF Finland	dd514216-5c7c-45f3-910d-797424cb5be6	18e4ee37-4737-477a-a1df-6840e1ad4553
0	2	2	Plazi	ffb07bec-2d10-492d-9c37-361fe0b79427	1cdb2158-5c89-49e3-ba8b-b6dbf34ee2a9
0	8	8	Plazi	ffb07bec-2d10-492d-9c37-361fe0b79427	1e9005b3-eebe-4cde-8807-181213fc7c60
0	6	6	Plazi	ffb07bec-2d10-492d-9c37-361fe0b79427	1f7cb507-ec2c-4ce0-8534-fd7372321487
24	24	0	Plazi	ffb07bec-2d10-492d-9c37-361fe0b79427	20c949bc-62ff-4204-af75-45a82db4f1ee
94	94	0	GBIF France	da44cd31-5901-4687-a106-6d1c7734ee3a	20d7e790-8c38-4614-957b-ff05c5a81000
80783	80783	0	National Biodiversity Network	d897a5b9-35ee-4232-94bd-b0bcaac003c2	230071a6-1388-4fb7-a399-695932faec71
0	31	31	Plazi	ffb07bec-2d10-492d-9c37-361fe0b79427	2807cd4e-e316-485a-bd19-0e73f1d44026
10	10	0	Plazi	ffb07bec-2d10-492d-9c37-361fe0b79427	2a8284ff-38a9-4831-b11f-f89793722e61
3	3	0	Plazi	ffb07bec-2d10-492d-9c37-361fe0b79427	2b4edea6-ee80-4af1-bc9c-9ff9df332148
189	189	0	GBIF Argentina	2426a871-9feb-40a1-96c6-0c593a76b835	330705ca-2dc2-43e4-b5be-0f49107656d9
2	2	0	Plazi	ffb07bec-2d10-492d-9c37-361fe0b79427	353025dd-629e-45a9-9e35-2965e6912c65
16	16	0	Plazi	ffb07bec-2d10-492d-9c37-361fe0b79427	37e9039c-2b46-40e0-94e0-fcf0b2210298
1587	1587	0	National Biodiversity Network	d897a5b9-35ee-4232-94bd-b0bcaac003c2	3a6f594c-11e5-4d7e-8fe7-80ab91c41b30
1	1	0	Plazi	ffb07bec-2d10-492d-9c37-361fe0b79427	3c08d078-0824-4dce-bc6f-bca1fda81d56
29105	30923	1818	GBIF Japan	db5705aa-6a6e-42f1-8942-d77b9f4896ea	3c1a56f8-b63a-492f-bb77-babb497204fb
0	22	22	Plazi	ffb07bec-2d10-492d-9c37-361fe0b79427	3efb1a4f-0515-49ba-9d61-b7c1b4326613
1114	1114	0	GBIF Finland	dd514216-5c7c-45f3-910d-797424cb5be6	3f754072-f6af-42ae-812c-22830062b341
0	3618	3618	Canada Biodiversity Information Facility	8f83fc96-c966-4126-83f7-bf044dc49efa	418b54fd-12af-4a8e-b707-dea11244d2c7
7718	7740	22	GBIF Brazil	cdc9736d-5ff7-4ece-9959-3c744360cdb3	45a34757-f7fa-4989-a9fc-e98629361c43
7249	7249	0	GBIF Brazil	cdc9736d-5ff7-4ece-9959-3c744360cdb3	46a95f2f-4f0c-4002-8e1a-68724e63f01d
2	2	0	Plazi	ffb07bec-2d10-492d-9c37-361fe0b79427	4719aa64-931f-4a25-bf4f-5801aedbacd3
0	2	2	Plazi	ffb07bec-2d10-492d-9c37-361fe0b79427	49f30ee2-ec23-4971-83d8-4478ff91702a
4	4	0	Plazi	ffb07bec-2d10-492d-9c37-361fe0b79427	4fbfd0a9-020b-4b60-97f7-c431a2cff81d
12	12	0	Plazi	ffb07bec-2d10-492d-9c37-361fe0b79427	514142e5-e3b6-4c12-8ecb-aaab91a75170
59	59	0	Ocean Biodiversity Information System	ba0670b9-4186-41e6-8e70-f9cb3065551a	544aabb8-bd2a-44ef-8917-a3b9c70bb837
554	554	0	National Biodiversity Network	d897a5b9-35ee-4232-94bd-b0bcaac003c2	56a5cb72-db94-42f5-9f71-de81e56588b7
0	5	5	Plazi	ffb07bec-2d10-492d-9c37-361fe0b79427	581c57f2-da1f-4130-8f8a-01fe88b2e6bc
1752	1752	0	GBIF Mauritania	a48482b4-725f-49e9-934d-2f572deaa361	58385d86-3281-494f-86a2-1e5c423146d2
112	305353	305241	Belgian Biodiversity Platform	fb11cfe1-ebc3-45af-9159-17d9fddbcdac	5ca32e22-1f1b-4478-ba7f-1916c4e88d67
90	90	0	GBIF Germany	4f6826f2-4ff6-443d-b966-e6913bd24013	6133cfcc-f762-11e1-a439-00145eb45e9a
26	26	0	GBIF Germany	4f6826f2-4ff6-443d-b966-e6913bd24013	63047036-f762-11e1-a439-00145eb45e9a
44	44	0	GBIF Germany	4f6826f2-4ff6-443d-b966-e6913bd24013	632768a2-f762-11e1-a439-00145eb45e9a
4	4	0	Plazi	ffb07bec-2d10-492d-9c37-361fe0b79427	65a1ee38-6495-4b60-a716-869a031f9695
26	20	-6	GBIF Germany	4f6826f2-4ff6-443d-b966-e6913bd24013	65cb4fa6-f762-11e1-a439-00145eb45e9a
7541	7541	0	GBIF Brazil	cdc9736d-5ff7-4ece-9959-3c744360cdb3	65d98c1d-a081-4b40-bc4b-81eae69a48e6
83	83	0	GBIF Germany	4f6826f2-4ff6-443d-b966-e6913bd24013	6630c6ce-f762-11e1-a439-00145eb45e9a
80	80	0	GBIF Germany	4f6826f2-4ff6-443d-b966-e6913bd24013	6753ce3e-f762-11e1-a439-00145eb45e9a
116	116	0	GBIF Germany	4f6826f2-4ff6-443d-b966-e6913bd24013	6836b6f4-f762-11e1-a439-00145eb45e9a
400	232	-168	GBIF Germany	4f6826f2-4ff6-443d-b966-e6913bd24013	68d8a748-f762-11e1-a439-00145eb45e9a
18	18	0	GBIF Germany	4f6826f2-4ff6-443d-b966-e6913bd24013	6b12912c-f762-11e1-a439-00145eb45e9a
0	1	1	Plazi	ffb07bec-2d10-492d-9c37-361fe0b79427	6b4c64d6-8993-4dfb-a6b5-d33a6807a517
4	4	0	GBIF Germany	4f6826f2-4ff6-443d-b966-e6913bd24013	6b5f4d96-f762-11e1-a439-00145eb45e9a
26	26	0	GBIF Germany	4f6826f2-4ff6-443d-b966-e6913bd24013	6b6b6f9a-f762-11e1-a439-00145eb45e9a
20	20	0	Plazi	ffb07bec-2d10-492d-9c37-361fe0b79427	6ce56f9f-7709-40cd-ab83-3ec2a9bc8c28
195	195	0	GBIF Germany	4f6826f2-4ff6-443d-b966-e6913bd24013	6d284df8-f762-11e1-a439-00145eb45e9a
50	50	0	GBIF France	da44cd31-5901-4687-a106-6d1c7734ee3a	6d74699d-22b9-43f2-a2d2-b4d76f5fc2ca
5	5	0	Plazi	ffb07bec-2d10-492d-9c37-361fe0b79427	6dc9e3d4-9de7-4ad8-8c69-105a3011740c
2	2	0	Plazi	ffb07bec-2d10-492d-9c37-361fe0b79427	6e6d464e-547d-4099-aada-4a7641505907
723	723	0	GBIF Argentina	2426a871-9feb-40a1-96c6-0c593a76b835	6e815053-68b9-4ca4-bb10-b2e2a1f05e53
3	3	0	GBIF Germany	4f6826f2-4ff6-443d-b966-e6913bd24013	6fbe0a8a-f762-11e1-a439-00145eb45e9a
12	12	0	GBIF Germany	4f6826f2-4ff6-443d-b966-e6913bd24013	6fed6d48-f762-11e1-a439-00145eb45e9a
33	33	0	GBIF Germany	4f6826f2-4ff6-443d-b966-e6913bd24013	7006b5b4-f762-11e1-a439-00145eb45e9a
602	602	0	GBIF Germany	4f6826f2-4ff6-443d-b966-e6913bd24013	70235647-7885-42a5-8d0d-b105b40ea532
7883	11744	3861	GBIF Germany	4f6826f2-4ff6-443d-b966-e6913bd24013	71f84ac2-f762-11e1-a439-00145eb45e9a
129	129	0	GBIF France	da44cd31-5901-4687-a106-6d1c7734ee3a	7253ec2e-dc84-4e74-8c09-15584d175d6a
17	17	0	GBIF Germany	4f6826f2-4ff6-443d-b966-e6913bd24013	74ae9096-f762-11e1-a439-00145eb45e9a
32	31	-1	GBIF Germany	4f6826f2-4ff6-443d-b966-e6913bd24013	74bc06f4-f762-11e1-a439-00145eb45e9a
40	40	0	GBIF France	da44cd31-5901-4687-a106-6d1c7734ee3a	75954158-e0a9-4fe1-8826-6b03f9b5d415
1	1	0	Plazi	ffb07bec-2d10-492d-9c37-361fe0b79427	75f859ce-4da6-4513-871e-e1fb3b41a55f
672	672	0	GBIF Togo	c9659a3e-07e9-4fcb-83c6-de8b9009a02e	76ce538f-412d-48c3-a4ac-8b4af5ead610
3	3	0	GBIF Germany	4f6826f2-4ff6-443d-b966-e6913bd24013	7890a2ee-f762-11e1-a439-00145eb45e9a
36	36	0	Plazi	ffb07bec-2d10-492d-9c37-361fe0b79427	7a12aaad-a568-4920-91cf-af3e9407eadc
0	46	46	Plazi	ffb07bec-2d10-492d-9c37-361fe0b79427	7ae3a9d3-4277-4941-9028-3f6b4f7db671
13	13	0	Ocean Biodiversity Information System	ba0670b9-4186-41e6-8e70-f9cb3065551a	7b657080-f762-11e1-a439-00145eb45e9a
1750	1750	0	National Biodiversity Network	d897a5b9-35ee-4232-94bd-b0bcaac003c2	7c8a9d50-c2c3-4d41-a0a8-6e62bd7f9cfb
322	322	0	National Biodiversity Network	d897a5b9-35ee-4232-94bd-b0bcaac003c2	7f2e73d0-b0b2-4947-8876-ea12264a7a15
2	2	0	Plazi	ffb07bec-2d10-492d-9c37-361fe0b79427	7fcc91e2-3f4d-4de8-a3a5-3a53692b3ab5
855	855	0	Biodiversity Information System of Mexico	b324e8e9-9a4c-44fa-8f1a-7f39ea7ab576	8013ca82-f762-11e1-a439-00145eb45e9a
780	780	0	Participant Node Managers Committee	7f48e0c8-5c96-49ec-b972-30748e339115	80ea955b-3905-4049-961f-a1dd1e9d5659
24	24	0	GBIF France	da44cd31-5901-4687-a106-6d1c7734ee3a	81944e26-8048-4f5d-b6f8-515eef779444
66	66	0	Plazi	ffb07bec-2d10-492d-9c37-361fe0b79427	8236cdde-2a32-4af1-bb69-404fec3f27c3
46	46	0	Plazi	ffb07bec-2d10-492d-9c37-361fe0b79427	82df40cd-3f56-4670-a315-dac70429c733
218767	218767	0	Atlas of Living Australia	4a6f1b71-969e-4fc5-a693-282b05e1220c	82e6a41e-f762-11e1-a439-00145eb45e9a
1321	1321	0	DanBIF - Danish Biodiversity Information Facility	4ddd294f-02b7-4359-ac33-0806a9ca9c6b	84d4a910-f762-11e1-a439-00145eb45e9a
49536	56099	6563	U.S. Geological Survey	8618c64a-93e0-4300-b546-7249e5148ed2	861d3d64-f762-11e1-a439-00145eb45e9a
2210	1814	-396	GBIF Germany	4f6826f2-4ff6-443d-b966-e6913bd24013	86c1d162-f762-11e1-a439-00145eb45e9a
0	34	34	Plazi	ffb07bec-2d10-492d-9c37-361fe0b79427	87dcf476-dd02-4e6f-94f1-3f611d12ddd7
0	5	5	Plazi	ffb07bec-2d10-492d-9c37-361fe0b79427	87f0f0aa-a0f3-435d-b7c6-58fb5619de6a
2128	2128	0	GBIF Spain	1f94b3ca-9345-4d65-afe2-4bace93aa0fe	8908a9a0-f762-11e1-a439-00145eb45e9a
2	2	0	Plazi	ffb07bec-2d10-492d-9c37-361fe0b79427	892bcc0c-1516-4a00-bf87-6571cc961061
0	25	25	Ocean Biodiversity Information System	ba0670b9-4186-41e6-8e70-f9cb3065551a	892fb382-71df-4fb1-9a05-7299bcf4c73b
59016	59016	0	National Biodiversity Network	d897a5b9-35ee-4232-94bd-b0bcaac003c2	8a37280c-9310-4ce9-835c-5a14d35b84aa
37520	37842	322	National Biodiversity Network	d897a5b9-35ee-4232-94bd-b0bcaac003c2	8ae2de05-84b2-444a-a64d-4fae46f281d6
10	10	0	GBIF Germany	4f6826f2-4ff6-443d-b966-e6913bd24013	8c17647e-f762-11e1-a439-00145eb45e9a
1	1	0	GBIF Germany	4f6826f2-4ff6-443d-b966-e6913bd24013	8c499d5e-f762-11e1-a439-00145eb45e9a
8	5	-3	GBIF Germany	4f6826f2-4ff6-443d-b966-e6913bd24013	8d524c6e-f762-11e1-a439-00145eb45e9a
65	65	0	GBIF Germany	4f6826f2-4ff6-443d-b966-e6913bd24013	8d62d3fe-f762-11e1-a439-00145eb45e9a
244	223	-21	GBIF Germany	4f6826f2-4ff6-443d-b966-e6913bd24013	8f614cda-f762-11e1-a439-00145eb45e9a
271	203	-68	GBIF Germany	4f6826f2-4ff6-443d-b966-e6913bd24013	8fb0bd6a-f762-11e1-a439-00145eb45e9a
0	309	309	Plazi	ffb07bec-2d10-492d-9c37-361fe0b79427	903b427b-6b4f-4f0b-9270-1459a7e5be1e
174	153	-21	GBIF Germany	4f6826f2-4ff6-443d-b966-e6913bd24013	9129ddfc-f762-11e1-a439-00145eb45e9a
59	54	-5	GBIF Germany	4f6826f2-4ff6-443d-b966-e6913bd24013	91587482-f762-11e1-a439-00145eb45e9a
0	131	131	Colombian Biodiversity Information System	7e865cba-7c46-417b-ade5-97f2cf5b7be0	9197e55c-462d-460a-8177-6a6ef2afa0f5
150	150	0	GBIF Germany	4f6826f2-4ff6-443d-b966-e6913bd24013	91d23bf3-c4a2-456c-a666-d256bb0f8d8c
80	55	-25	GBIF Germany	4f6826f2-4ff6-443d-b966-e6913bd24013	9321a3a6-f762-11e1-a439-00145eb45e9a
155	155	0	Colombian Biodiversity Information System	7e865cba-7c46-417b-ade5-97f2cf5b7be0	948c51dd-066e-4cdb-9554-d0ac54afb128
13	13	0	Plazi	ffb07bec-2d10-492d-9c37-361fe0b79427	94cdd5b4-1428-46bc-ae1b-cea7e0976cfb
621	325	-296	GBIF Germany	4f6826f2-4ff6-443d-b966-e6913bd24013	95765a37-4f4f-4e2a-ac52-a9ddc3eb2bd9
48878	48878	0	GBIF Finland	dd514216-5c7c-45f3-910d-797424cb5be6	95ad2dbd-a847-4ef6-8b86-1fa38d94e5fc
0	2	2	Plazi	ffb07bec-2d10-492d-9c37-361fe0b79427	95c4617e-463e-4fd3-9fee-8019e7d1364f
126	126	0	GBIF Togo	c9659a3e-07e9-4fcb-83c6-de8b9009a02e	966b3e29-f1e4-4190-badd-100bc989788f
47	47	0	Participant Node Managers Committee	7f48e0c8-5c96-49ec-b972-30748e339115	967a00a1-297b-478c-8c86-cf801e93a6af
5	5	0	Plazi	ffb07bec-2d10-492d-9c37-361fe0b79427	972b9715-b982-4f19-b54c-602eadf55f52
0	1231	1231	Ocean Biodiversity Information System	ba0670b9-4186-41e6-8e70-f9cb3065551a	97e32c9a-9f3a-417d-8b20-3846e3cf5901
6	6	0	Plazi	ffb07bec-2d10-492d-9c37-361fe0b79427	9a59fa03-efa0-4c74-8ac5-7b8c454b66fb
30	30	0	Plazi	ffb07bec-2d10-492d-9c37-361fe0b79427	9b05d547-bf04-4d25-ae26-03140d447255
28	28	0	GBIF Argentina	2426a871-9feb-40a1-96c6-0c593a76b835	9d978b15-63a3-4e5b-bc89-f9a6eddc7311
213	213	0	National Biodiversity Network	d897a5b9-35ee-4232-94bd-b0bcaac003c2	9e0c4168-e899-4c8e-b40e-773263706b00
0	443	443	Belgian Biodiversity Platform	fb11cfe1-ebc3-45af-9159-17d9fddbcdac	a320cf57-74e2-43d6-9373-5cf43a4374bb
0	1	1	Plazi	ffb07bec-2d10-492d-9c37-361fe0b79427	a56ac4f2-67f1-45bb-8e06-49252b8fc4b8
51	51	0	Plazi	ffb07bec-2d10-492d-9c37-361fe0b79427	a96b3ef7-5c39-4d0b-8d35-43706a9802c0
99	99	0	GBIF Germany	4f6826f2-4ff6-443d-b966-e6913bd24013	ab3d8d49-2b70-4756-b32b-fb6c043a3f2b
1	1	0	Plazi	ffb07bec-2d10-492d-9c37-361fe0b79427	ab49358f-1755-47dd-8bbb-7a71714b545c
0	17	17	Ocean Biodiversity Information System	ba0670b9-4186-41e6-8e70-f9cb3065551a	abd1b4fd-d1ed-4728-87c9-4ba157484446
1374	1438	64	GBIF Germany	4f6826f2-4ff6-443d-b966-e6913bd24013	acec505b-6e54-4061-abf5-0da5131242f7
3487	3487	0	Colombian Biodiversity Information System	7e865cba-7c46-417b-ade5-97f2cf5b7be0	ae7cf7d9-85dc-4578-9f5f-40d760ab013b
7208	7208	0	Atlas of Living Australia	4a6f1b71-969e-4fc5-a693-282b05e1220c	aeb6345b-aa74-44b8-989b-1b6fe7be6ab5
6	6	0	Plazi	ffb07bec-2d10-492d-9c37-361fe0b79427	b4a229d0-eaa2-4a87-a6e8-1a480c1c06da
1477	1477	0	GBIF Guinea	b1cd2e84-c4ba-47bd-b72a-dfd1f92dce0a	b5f88be8-335b-471c-9532-5430c45290a7
155	155	0	GBIF Germany	4f6826f2-4ff6-443d-b966-e6913bd24013	b8e9909b-4af2-4e67-8ac3-aa6e0d602e4c
8	8	0	Participant Node Managers Committee	7f48e0c8-5c96-49ec-b972-30748e339115	bb52f707-524e-4861-afb3-95873ded3bbd
0	4	4	Plazi	ffb07bec-2d10-492d-9c37-361fe0b79427	bbf97b57-5639-45ff-b294-5b0d78dfad67
350	350	0	Canada Biodiversity Information Facility	8f83fc96-c966-4126-83f7-bf044dc49efa	c425d6ff-a277-4faa-a982-380af9aeee18
275	275	0	GBIF Norway	4f829580-180d-46a9-9c87-ed8ec959b545	c487db8c-c128-437f-9110-ff745b8b00a9
11428	11428	0	GBIF France	da44cd31-5901-4687-a106-6d1c7734ee3a	c7f9181c-2344-4e3a-b414-eb5710b5807c
25	25	0	Plazi	ffb07bec-2d10-492d-9c37-361fe0b79427	c8b5a550-0994-4b37-9de2-82ed07a64a99
0	312	312	Ocean Biodiversity Information System	ba0670b9-4186-41e6-8e70-f9cb3065551a	c911249c-5bdc-4847-8653-d7b81f11b7cc
60521	61316	795	GBIF Brazil	cdc9736d-5ff7-4ece-9959-3c744360cdb3	c9bc6b8d-a4ff-4a47-9cff-d0d1b9e548c7
131782	133118	1336	GBIF Brazil	cdc9736d-5ff7-4ece-9959-3c744360cdb3	cbf8c968-37d6-45be-bf5c-e22914a384dc
2	2	0	Plazi	ffb07bec-2d10-492d-9c37-361fe0b79427	cdbd0162-6a7a-4b77-809e-262f8194fa17
412	412	0	GBIF France	da44cd31-5901-4687-a106-6d1c7734ee3a	ce4edf3d-ba67-4e4d-b48a-3ecff3d4846a
0	24	24	Plazi	ffb07bec-2d10-492d-9c37-361fe0b79427	ceb40045-70f8-4933-91a1-a696aea66ebe
3	3	0	Plazi	ffb07bec-2d10-492d-9c37-361fe0b79427	d23ed98d-8e82-4c94-be62-d8f720a2db78
2213	2213	0	GBIF France	da44cd31-5901-4687-a106-6d1c7734ee3a	d67d398d-e252-4cbe-9f04-934415445008
0	13652	13652	Polish Biodiversity Information Network	2618bfdf-e194-4911-a241-80db3107bc51	da4214de-9415-4ccd-8da5-1b456c73a144
2228	2228	0	GBIF Kenya	2a44d626-9f7a-4120-8a7a-4ab5ac15ff2a	dc67ba75-6a7c-44ef-83f7-81bce6a7aef1
2	2	0	Plazi	ffb07bec-2d10-492d-9c37-361fe0b79427	de897366-9622-4bf7-84d2-b37c3699766d
1	1	0	Plazi	ffb07bec-2d10-492d-9c37-361fe0b79427	e063d8d1-d076-401d-b07d-81cb528c2cd6
4066	4066	0	South African Biodiversity Information Facility	7190b835-4e86-4b6e-85c1-19cc6677c250	e87e0415-bdb2-45eb-8954-b6b4454e1852
10	10	0	Plazi	ffb07bec-2d10-492d-9c37-361fe0b79427	e8ff0779-19d0-4b3b-bb17-4309196cbb44
0	99	99	Ocean Biodiversity Information System	ba0670b9-4186-41e6-8e70-f9cb3065551a	e913d179-d16e-4520-8df1-923951d90bc4
2311	2311	0	GBIF Brazil	cdc9736d-5ff7-4ece-9959-3c744360cdb3	eb509ab6-3bd8-479b-a255-46ec514fe6af
979	979	0	GBIF Finland	dd514216-5c7c-45f3-910d-797424cb5be6	ebed02c3-302d-49ed-b583-b26214d74046
12233	12233	0	Atlas of Living Australia	4a6f1b71-969e-4fc5-a693-282b05e1220c	edb501e5-93b6-45b2-b2be-b4705587a78b
25	25	0	Plazi	ffb07bec-2d10-492d-9c37-361fe0b79427	efa6b23f-be6e-4c2d-9c56-e0f4b1eaa1f0
170	170	0	National Biodiversity Network	d897a5b9-35ee-4232-94bd-b0bcaac003c2	f3a952cc-b6f4-4e2b-91f7-e2261377c0e8
66	66	0	Korean Biodiversity Information Facility	e0a1e772-0177-4800-94b4-2d023fe6cdf4	f50752fe-f0f0-4cf0-a466-32812d7990d1
21	21	0	Colombian Biodiversity Information System	7e865cba-7c46-417b-ade5-97f2cf5b7be0	f97568bd-5ceb-4f14-83ab-12a584392a80
2485	2485	0	Netherlands Biodiversity Information Facility	0909d601-bda2-42df-9e63-a6d51847ebce	faa6afd5-a315-4f4c-a966-8b0227fb57e4
4	4	0	Plazi	ffb07bec-2d10-492d-9c37-361fe0b79427	fab22d73-8d78-4b0c-b4b9-bea7e4571abc
30	30	0	Plazi	ffb07bec-2d10-492d-9c37-361fe0b79427	feabbf19-bfad-4221-926e-bff60860abb6
4	4	0	GBIF Finland	dd514216-5c7c-45f3-910d-797424cb5be6	00ad9524-ba7f-4450-977e-1563713924f4
602	602	0	GBIF Germany	4f6826f2-4ff6-443d-b966-e6913bd24013	0120e66b-f53a-4b8a-be18-80cedeb14302
15300	15300	0	Biodiversity Information System of Mexico	b324e8e9-9a4c-44fa-8f1a-7f39ea7ab576	012ce6fa-5b67-4871-9a5c-5a187ccf54a3
214	214	0	Canada Biodiversity Information Facility	8f83fc96-c966-4126-83f7-bf044dc49efa	02a5ee56-59ae-48f9-9c2a-a47d0b1f24d4
506	506	0	Colombian Biodiversity Information System	7e865cba-7c46-417b-ade5-97f2cf5b7be0	03114105-322a-42d1-9973-7467c42c858b
1515	1515	0	GBIF Norway	4f829580-180d-46a9-9c87-ed8ec959b545	04930329-93ce-4f80-8d67-423a526a736b
86	86	0	GBIF France	da44cd31-5901-4687-a106-6d1c7734ee3a	057f5884-34b8-41af-b09d-937be2244ae6
391	391	0	GBIF Germany	4f6826f2-4ff6-443d-b966-e6913bd24013	07048277-d860-47ff-b74c-a285c3ab9f9d
10	10	0	Plazi	ffb07bec-2d10-492d-9c37-361fe0b79427	0b7119cd-4a70-4008-bf13-ff36bb857874
4198	3319	-879	GBIF Germany	4f6826f2-4ff6-443d-b966-e6913bd24013	0c5d5de6-9687-4438-aaf8-93a83a1a5507
5381	858	-4523	GBIF Germany	4f6826f2-4ff6-443d-b966-e6913bd24013	0ddc0b54-adfd-41f8-aa00-4ea429d0a692
374	374	0	GBIF France	da44cd31-5901-4687-a106-6d1c7734ee3a	1059a468-d596-4a6a-bbf6-486aa56c1f53
158	158	0	Colombian Biodiversity Information System	7e865cba-7c46-417b-ade5-97f2cf5b7be0	1218270e-e724-4abf-aae4-19402bf02e11
79	79	0	National Biodiversity Network	d897a5b9-35ee-4232-94bd-b0bcaac003c2	127edf82-e8d6-4c50-9c6a-dfa6c3924fdb
2258	2258	0	National Biodiversity Network	d897a5b9-35ee-4232-94bd-b0bcaac003c2	15f7a6a7-a684-42b1-a05f-4de243e389c4
81	81	0	GBIF France	da44cd31-5901-4687-a106-6d1c7734ee3a	17c78112-641b-43f6-80a9-f5622bf62257
356	356	0	Colombian Biodiversity Information System	7e865cba-7c46-417b-ade5-97f2cf5b7be0	18bfcd97-719b-4a7e-9122-20340d5aa846
3	3	0	Plazi	ffb07bec-2d10-492d-9c37-361fe0b79427	192c8351-9f23-4350-ae38-75405264b53e
27	27	0	Plazi	ffb07bec-2d10-492d-9c37-361fe0b79427	195fa4b8-0cfa-4f61-b6b1-3a949817b2aa
21034	21034	0	U.S. Geological Survey	8618c64a-93e0-4300-b546-7249e5148ed2	1984c441-b52a-4ced-ba2f-9a2c4fa1898b
38	38	0	Plazi	ffb07bec-2d10-492d-9c37-361fe0b79427	1c547898-775b-4533-9dfa-fcf512783bb8
0	19	19	Plazi	ffb07bec-2d10-492d-9c37-361fe0b79427	1c7cfd85-98d0-455b-b8b5-85f0a92ad02d
46	64	18	U.S. Geological Survey	8618c64a-93e0-4300-b546-7249e5148ed2	1c99ecf5-672b-4af9-a532-8b28af9999bc
24	24	0	Plazi	ffb07bec-2d10-492d-9c37-361fe0b79427	1cf4a9f3-3009-4abe-a993-5bacf7508661
90634	90634	0	National Biodiversity Network	d897a5b9-35ee-4232-94bd-b0bcaac003c2	1d31211e-350e-492a-a597-34d24bbc1769
0	5	5	Plazi	ffb07bec-2d10-492d-9c37-361fe0b79427	1f56991c-4562-4000-9460-7739d2ecdb74
0	53	53	Ocean Biodiversity Information System	ba0670b9-4186-41e6-8e70-f9cb3065551a	1f56aead-2e7c-4543-9b9f-67362fcabfc6
4030	4030	0	GBIF Spain	1f94b3ca-9345-4d65-afe2-4bace93aa0fe	1fef1ead-3d02-495e-8ff1-6aeb01123408
0	250	250	GBIF Argentina	2426a871-9feb-40a1-96c6-0c593a76b835	20b5d77b-1f11-465b-9a6a-453a2b4463b0
52	52	0	GBIF France	da44cd31-5901-4687-a106-6d1c7734ee3a	22081870-a6e5-42c5-864b-220df2d103a6
874	874	0	GBIF France	da44cd31-5901-4687-a106-6d1c7734ee3a	2d151fcc-32ad-4d83-aaaa-1f463c700161
4647	4647	0	GBIF Sweden	a0b3be64-6525-4387-ac67-a499950f92e1	2d6e8496-2337-42f7-91e8-89fba6bc1e69
0	3	3	Plazi	ffb07bec-2d10-492d-9c37-361fe0b79427	2dc1cbd5-7490-4775-ab21-775cf2c259c7
0	18	18	Plazi	ffb07bec-2d10-492d-9c37-361fe0b79427	309b7d1b-0d42-4503-be63-fd13a9b29045
255	255	0	Colombian Biodiversity Information System	7e865cba-7c46-417b-ade5-97f2cf5b7be0	32364170-e240-4024-b1cf-164a1fe2b755
239	238	-1	Biodiversity Information System of Mexico	b324e8e9-9a4c-44fa-8f1a-7f39ea7ab576	3807b7c3-d2b5-4855-b1ed-f30b0371bc87
40	40	0	Ocean Biodiversity Information System	ba0670b9-4186-41e6-8e70-f9cb3065551a	387fc606-c85e-4423-8b23-202dfe723c08
1264	1264	0	GBIF Argentina	2426a871-9feb-40a1-96c6-0c593a76b835	39d0651c-12d5-4b6e-a816-1cf9228e7f23
374	374	0	GBIF Uganda	71b40829-6a12-4c3d-8fee-5746f5e9cf8c	3bf5f330-ee33-4622-a9ae-e1a3de64d439
1	1	0	Plazi	ffb07bec-2d10-492d-9c37-361fe0b79427	3d039193-efdc-421c-8bc2-85f3ef7cdd40
0	3	3	Plazi	ffb07bec-2d10-492d-9c37-361fe0b79427	3de41046-fff8-458c-8b77-9b0b6dd51632
3404	2277	-1127	Biodiversity Information System of Mexico	b324e8e9-9a4c-44fa-8f1a-7f39ea7ab576	3df8b088-b7d4-4621-aa32-dd17460736db
0	120	120	Ocean Biodiversity Information System	ba0670b9-4186-41e6-8e70-f9cb3065551a	3ee5d83d-006f-43cf-b971-18f0cfaafa2d
0	19	19	Ocean Biodiversity Information System	ba0670b9-4186-41e6-8e70-f9cb3065551a	400ec8e1-c8f5-42ed-9890-47bf22efba5a
1	1	0	Participant Node Managers Committee	7f48e0c8-5c96-49ec-b972-30748e339115	41e719e4-15f2-4e25-9d97-647811680e08
1145	2177	1032	Indonesian Biodiversity Information Facility	2ebd91f6-f14f-4375-b525-c011a3774f03	442647f8-8883-462d-901f-115f0753969d
3	3	0	Plazi	ffb07bec-2d10-492d-9c37-361fe0b79427	44e3a2f4-eeab-4983-9eaa-9b8abd60cedf
0	17	17	Plazi	ffb07bec-2d10-492d-9c37-361fe0b79427	461cf867-c572-4e17-b117-73c9fa4c217b
2	2	0	Plazi	ffb07bec-2d10-492d-9c37-361fe0b79427	48538d4e-ef4b-40ef-bff3-e01a344cce31
9	9	0	Plazi	ffb07bec-2d10-492d-9c37-361fe0b79427	4ae1c583-d8b5-4d9e-8f71-8833d697e0ea
2	2	0	Plazi	ffb07bec-2d10-492d-9c37-361fe0b79427	4ca65833-f67d-429c-9448-7bba127c917b
10	10	0	GBIF France	da44cd31-5901-4687-a106-6d1c7734ee3a	4ce30128-62e8-4756-a200-b9ed35a54121
6087	6087	0	GBIF France	da44cd31-5901-4687-a106-6d1c7734ee3a	4dcfa4f3-7ebe-47d6-bd93-a85315c9f180
0	369	369	U.S. Geological Survey	8618c64a-93e0-4300-b546-7249e5148ed2	4e61cc4a-6bfd-4816-b2b8-b066e21b6235
70111	70111	0	GBIF Japan	db5705aa-6a6e-42f1-8942-d77b9f4896ea	505aa19e-7ba5-48e7-8946-5a90ae9d37e3
4	4	0	Plazi	ffb07bec-2d10-492d-9c37-361fe0b79427	51315b1a-dcc4-41e2-aff7-f90478fed976
600083	600083	0	National Biodiversity Network	d897a5b9-35ee-4232-94bd-b0bcaac003c2	523590f0-f87d-4fed-acd2-6873bdce0a8c
31	31	0	Plazi	ffb07bec-2d10-492d-9c37-361fe0b79427	52e08bcc-8aba-4487-b781-22a1f42a9c8a
8	8	0	Plazi	ffb07bec-2d10-492d-9c37-361fe0b79427	55ab330e-0468-42ed-aeb0-7850751cf989
611	406	-205	GBIF Germany	4f6826f2-4ff6-443d-b966-e6913bd24013	56a359db-69bb-490f-a530-400206ab63a4
5772	5772	0	GBIF Finland	dd514216-5c7c-45f3-910d-797424cb5be6	5b5deb76-1e5e-446c-9d92-6cb2ddbc9d39
68	68	0	Plazi	ffb07bec-2d10-492d-9c37-361fe0b79427	5c26c99a-2324-4ff9-ae49-d6992f6328b4
216215	216233	18	U.S. Geological Survey	8618c64a-93e0-4300-b546-7249e5148ed2	5d6c10bd-ea31-4363-8b79-58c96d859f5b
26184	26184	0	U.S. Geological Survey	8618c64a-93e0-4300-b546-7249e5148ed2	5e015b88-67d3-474b-8e96-a537c9ef0210
25883	25883	0	Society for the Management of Electronic Biodiversity Data	97818ee4-1461-4180-bf1d-b3201050124f	5fe48e2c-a83d-43b7-952a-e1e62c49ad23
0	4	4	Plazi	ffb07bec-2d10-492d-9c37-361fe0b79427	60db7558-f7f5-4861-9081-ae83762d2840
13	13	0	GBIF Germany	4f6826f2-4ff6-443d-b966-e6913bd24013	6279628e-f762-11e1-a439-00145eb45e9a
0	4	4	Plazi	ffb07bec-2d10-492d-9c37-361fe0b79427	62f1520c-9954-46e4-9435-bbe554380f59
91	91	0	Plazi	ffb07bec-2d10-492d-9c37-361fe0b79427	63257f64-79ba-4237-86d2-151af268a7c7
3	3	0	Plazi	ffb07bec-2d10-492d-9c37-361fe0b79427	63d35c77-1116-4dc9-a30c-073ae11fde42
110	110	0	GBIF Germany	4f6826f2-4ff6-443d-b966-e6913bd24013	645a4348-f762-11e1-a439-00145eb45e9a
157	157	0	GBIF Germany	4f6826f2-4ff6-443d-b966-e6913bd24013	64a8e85e-f762-11e1-a439-00145eb45e9a
47	47	0	GBIF Germany	4f6826f2-4ff6-443d-b966-e6913bd24013	64d55f2e-f762-11e1-a439-00145eb45e9a
47	47	0	GBIF Argentina	2426a871-9feb-40a1-96c6-0c593a76b835	666a19c0-a02c-42a4-99b2-40e4f23af2fe
3	3	0	Plazi	ffb07bec-2d10-492d-9c37-361fe0b79427	66e1304d-acfd-4330-9031-54e5c595557e
347	347	0	GBIF France	da44cd31-5901-4687-a106-6d1c7734ee3a	66ffde73-76f9-48e4-bcf5-ab4d6089265f
47	47	0	GBIF Germany	4f6826f2-4ff6-443d-b966-e6913bd24013	67731604-f762-11e1-a439-00145eb45e9a
51	51	0	GBIF Germany	4f6826f2-4ff6-443d-b966-e6913bd24013	677c31e4-f762-11e1-a439-00145eb45e9a
41	41	0	GBIF Germany	4f6826f2-4ff6-443d-b966-e6913bd24013	677eb202-f762-11e1-a439-00145eb45e9a
117	117	0	GBIF Germany	4f6826f2-4ff6-443d-b966-e6913bd24013	6874b3aa-f762-11e1-a439-00145eb45e9a
0	3	3	Plazi	ffb07bec-2d10-492d-9c37-361fe0b79427	692b092c-96f2-451d-8555-19c60983ef12
137	137	0	GBIF Germany	4f6826f2-4ff6-443d-b966-e6913bd24013	698314c6-f762-11e1-a439-00145eb45e9a
898	859	-39	GBIF Germany	4f6826f2-4ff6-443d-b966-e6913bd24013	6a047b60-f762-11e1-a439-00145eb45e9a
190	190	0	GBIF Germany	4f6826f2-4ff6-443d-b966-e6913bd24013	6a17a898-f762-11e1-a439-00145eb45e9a
982	982	0	GBIF Germany	4f6826f2-4ff6-443d-b966-e6913bd24013	6a25dd78-f762-11e1-a439-00145eb45e9a
10165	10165	0	GBIF France	da44cd31-5901-4687-a106-6d1c7734ee3a	6a36ed65-630e-481f-864e-e06db1f8620b
2	2	0	GBIF Germany	4f6826f2-4ff6-443d-b966-e6913bd24013	6adc940a-f762-11e1-a439-00145eb45e9a
28	28	0	GBIF Germany	4f6826f2-4ff6-443d-b966-e6913bd24013	6b56191a-f762-11e1-a439-00145eb45e9a
0	2443	2443	Ocean Biodiversity Information System	ba0670b9-4186-41e6-8e70-f9cb3065551a	6d2ef77f-a802-4071-9ecd-bccf015fd9cf
6445	6445	0	U.S. Geological Survey	8618c64a-93e0-4300-b546-7249e5148ed2	6da969ce-0833-4bb6-a4e6-5013a50eefef
178	175	-3	Biodiversity Information System of Mexico	b324e8e9-9a4c-44fa-8f1a-7f39ea7ab576	6ef46ac2-8d5d-4a5b-a4f8-ea055d0e745d
10	10	0	GBIF Germany	4f6826f2-4ff6-443d-b966-e6913bd24013	6ffdee0c-f762-11e1-a439-00145eb45e9a
18	18	0	GBIF Germany	4f6826f2-4ff6-443d-b966-e6913bd24013	70d36460-f762-11e1-a439-00145eb45e9a
94	94	0	GBIF Germany	4f6826f2-4ff6-443d-b966-e6913bd24013	716fe722-f762-11e1-a439-00145eb45e9a
39	39	0	GBIF Germany	4f6826f2-4ff6-443d-b966-e6913bd24013	71cc5020-f762-11e1-a439-00145eb45e9a
5423	5423	0	Atlas of Living Australia	4a6f1b71-969e-4fc5-a693-282b05e1220c	71e33e4e-3579-48be-bc68-996e67571072
7	7	0	GBIF Germany	4f6826f2-4ff6-443d-b966-e6913bd24013	71fcba9e-f762-11e1-a439-00145eb45e9a
41	41	0	GBIF France	da44cd31-5901-4687-a106-6d1c7734ee3a	728aae95-c347-4a16-b7fa-e865f035a6d7
2	2	0	GBIF Germany	4f6826f2-4ff6-443d-b966-e6913bd24013	74483d00-f762-11e1-a439-00145eb45e9a
4	4	0	GBIF Germany	4f6826f2-4ff6-443d-b966-e6913bd24013	7523c924-f762-11e1-a439-00145eb45e9a
27	27	0	GBIF Germany	4f6826f2-4ff6-443d-b966-e6913bd24013	75352de0-f762-11e1-a439-00145eb45e9a
0	6	6	Ocean Biodiversity Information System	ba0670b9-4186-41e6-8e70-f9cb3065551a	772a3bea-e4b1-4619-9846-8255d8fc1fd5
845	845	0	GBIF Germany	4f6826f2-4ff6-443d-b966-e6913bd24013	7768fe66-f762-11e1-a439-00145eb45e9a
130	130	0	GBIF Germany	4f6826f2-4ff6-443d-b966-e6913bd24013	78bc214e-f762-11e1-a439-00145eb45e9a
14465	14465	0	GBIF Spain	1f94b3ca-9345-4d65-afe2-4bace93aa0fe	791a7459-7b58-444c-af46-84db6f8576ef
382	382	0	GBIF Germany	4f6826f2-4ff6-443d-b966-e6913bd24013	793d0bce-f762-11e1-a439-00145eb45e9a
8	8	0	Plazi	ffb07bec-2d10-492d-9c37-361fe0b79427	79e9cc4d-86d4-4b44-ab77-13f5d6ee26dc
422	422	0	Ocean Biodiversity Information System	ba0670b9-4186-41e6-8e70-f9cb3065551a	7b5c5572-f762-11e1-a439-00145eb45e9a
1820	1365	-455	GBIF Germany	4f6826f2-4ff6-443d-b966-e6913bd24013	7bb34f44-f762-11e1-a439-00145eb45e9a
166	166	0	GBIF Argentina	2426a871-9feb-40a1-96c6-0c593a76b835	7d7e2ea6-a832-4d70-ad5d-376e3b99d210
1850	1850	0	GBIF Germany	4f6826f2-4ff6-443d-b966-e6913bd24013	7e22379a-f762-11e1-a439-00145eb45e9a
6107	4970	-1137	GBIF Germany	4f6826f2-4ff6-443d-b966-e6913bd24013	7e7eeb02-f762-11e1-a439-00145eb45e9a
0	1	1	Plazi	ffb07bec-2d10-492d-9c37-361fe0b79427	7ef852ef-7de5-4c99-a52c-041164e15a07
0	31	31	Plazi	ffb07bec-2d10-492d-9c37-361fe0b79427	7f2d2fe5-8875-4048-9191-b6ef16320fdb
417	417	0	GBIF France	da44cd31-5901-4687-a106-6d1c7734ee3a	7f6907d2-dac6-449c-be50-2493cb6ee15d
10	10	0	Plazi	ffb07bec-2d10-492d-9c37-361fe0b79427	8042fd7c-13a2-4d1b-adfc-ecd8c146afe9
12	12	0	Plazi	ffb07bec-2d10-492d-9c37-361fe0b79427	80828eb9-49cf-4af9-a596-3ce4d936c62a
810	794	-16	Biodiversity Information System of Mexico	b324e8e9-9a4c-44fa-8f1a-7f39ea7ab576	80bbcc0a-f762-11e1-a439-00145eb45e9a
16742	16742	0	Belgian Biodiversity Platform	fb11cfe1-ebc3-45af-9159-17d9fddbcdac	8124cd73-ac84-43d2-ab39-1d80dc346525
9	9	0	GBIF Germany	4f6826f2-4ff6-443d-b966-e6913bd24013	81564532-f762-11e1-a439-00145eb45e9a
330	330	0	GBIF Germany	4f6826f2-4ff6-443d-b966-e6913bd24013	81f7fd3c-f762-11e1-a439-00145eb45e9a
532	532	0	GBIF Benin	efb9c00e-f802-45dd-8826-a52ec45b89ff	826b42a2-5794-4c97-97ce-4b2dfd218a1c
26841	26841	0	U.S. Geological Survey	8618c64a-93e0-4300-b546-7249e5148ed2	847bbbde-f762-11e1-a439-00145eb45e9a
0	7	7	Plazi	ffb07bec-2d10-492d-9c37-361fe0b79427	84f6c00b-9633-4481-a98e-e06b766c39c7
4	4	0	GBIF Germany	4f6826f2-4ff6-443d-b966-e6913bd24013	879f533e-f762-11e1-a439-00145eb45e9a
6	6	0	Plazi	ffb07bec-2d10-492d-9c37-361fe0b79427	89bb5cb0-a77c-4f35-b0d6-fb63d0138c96
11	11	0	Plazi	ffb07bec-2d10-492d-9c37-361fe0b79427	8acfb4ea-c855-4bf4-beba-7fad6e4ffd4a
222	222	0	GBIF Germany	4f6826f2-4ff6-443d-b966-e6913bd24013	8cd5ba82-f762-11e1-a439-00145eb45e9a
7	7	0	Plazi	ffb07bec-2d10-492d-9c37-361fe0b79427	8dae6187-ac1f-4c63-96d3-ca06d25d60d2
96	15	-81	GBIF Germany	4f6826f2-4ff6-443d-b966-e6913bd24013	8dcd8da2-f762-11e1-a439-00145eb45e9a
250	1276	1026	Colombian Biodiversity Information System	7e865cba-7c46-417b-ade5-97f2cf5b7be0	8ffeca3a-6ef4-43fb-8319-d82fe17dccc7
69	40	-29	GBIF Germany	4f6826f2-4ff6-443d-b966-e6913bd24013	90446d12-f762-11e1-a439-00145eb45e9a
378	243	-135	GBIF Germany	4f6826f2-4ff6-443d-b966-e6913bd24013	90dd581a-f762-11e1-a439-00145eb45e9a
4	2	-2	GBIF Germany	4f6826f2-4ff6-443d-b966-e6913bd24013	9138308c-f762-11e1-a439-00145eb45e9a
39	35	-4	GBIF Germany	4f6826f2-4ff6-443d-b966-e6913bd24013	9149bc76-f762-11e1-a439-00145eb45e9a
1259	1259	0	GBIF Germany	4f6826f2-4ff6-443d-b966-e6913bd24013	923a7b20-f762-11e1-a439-00145eb45e9a
10	8	-2	GBIF Germany	4f6826f2-4ff6-443d-b966-e6913bd24013	92dde2e2-f762-11e1-a439-00145eb45e9a
28732	31921	3189	National Biodiversity Network	d897a5b9-35ee-4232-94bd-b0bcaac003c2	935bb261-f341-49db-9b4c-58d7fbac0386
163	163	0	GBIF Germany	4f6826f2-4ff6-443d-b966-e6913bd24013	93adda9c-f762-11e1-a439-00145eb45e9a
129	129	0	GBIF Germany	4f6826f2-4ff6-443d-b966-e6913bd24013	93ff1948-f762-11e1-a439-00145eb45e9a
165	165	0	GBIF Germany	4f6826f2-4ff6-443d-b966-e6913bd24013	9502ec16-f762-11e1-a439-00145eb45e9a
122	122	0	GBIF Germany	4f6826f2-4ff6-443d-b966-e6913bd24013	9613cd1e-f762-11e1-a439-00145eb45e9a
0	1179	1179	GBIF Ecuador	2dc472f1-c3d9-486d-b3c1-12ca7ba1ed22	9664f2b1-6b39-4905-9b40-302eb50348c1
43	43	0	GBIF Germany	4f6826f2-4ff6-443d-b966-e6913bd24013	97a54478-f762-11e1-a439-00145eb45e9a
2	2	0	Plazi	ffb07bec-2d10-492d-9c37-361fe0b79427	9ee04596-42f7-42dc-96fa-f95873ce1363
0	60	60	GBIF Portugal	673f7038-4262-4149-b753-5658a4e912f6	a069c573-3295-43bb-95fb-71dbac83378d
286	286	0	GBIF Germany	4f6826f2-4ff6-443d-b966-e6913bd24013	a1cf53b6-b0d8-444e-88ce-21b9c34e0d2b
0	8449	8449	GBIF Switzerland	169eb292-376b-4cc6-8e31-9c2c432de0ad	a56b9254-25a0-45a8-9909-bbe1365f01f1
8654	9204	550	GBIF Japan	db5705aa-6a6e-42f1-8942-d77b9f4896ea	a6d84a4e-d2c1-4cf1-924f-58d67f592a32
4	4	0	Plazi	ffb07bec-2d10-492d-9c37-361fe0b79427	a84770ff-1285-4b5f-a7c8-fffb75c2ad9d
2	2	0	Plazi	ffb07bec-2d10-492d-9c37-361fe0b79427	a8f50d35-5190-4cfd-8947-37d9362aec81
0	1	1	Plazi	ffb07bec-2d10-492d-9c37-361fe0b79427	a967c90e-ea10-4a10-b43b-cd5328a1d6e6
25153	25153	0	National Biodiversity Network	d897a5b9-35ee-4232-94bd-b0bcaac003c2	ac2867ca-3b2b-4795-961c-867194da1630
37088	37088	0	GBIF Brazil	cdc9736d-5ff7-4ece-9959-3c744360cdb3	b0059a3a-5cab-4a08-8d14-d92c23378e43
0	6	6	Plazi	ffb07bec-2d10-492d-9c37-361fe0b79427	b1ce99ec-afa5-4d54-aa32-ef12a643975b
0	8087	8087	GBIF Benin	efb9c00e-f802-45dd-8826-a52ec45b89ff	b1d39f3c-792b-4d44-a370-a43ad3985f74
0	209039	209039	Ocean Biodiversity Information System	ba0670b9-4186-41e6-8e70-f9cb3065551a	b49a165b-6022-4b09-a443-1551c8eb0535
23	23	0	Plazi	ffb07bec-2d10-492d-9c37-361fe0b79427	b540ef6b-5137-4574-ac0d-cc2291dd0797
10060	10060	0	National Biodiversity Network	d897a5b9-35ee-4232-94bd-b0bcaac003c2	b728f93f-145e-487f-8d15-5738978890a3
0	10	10	Plazi	ffb07bec-2d10-492d-9c37-361fe0b79427	ba8abdc9-995f-4221-8124-7eb03edfe731
121	121	0	GBIF France	da44cd31-5901-4687-a106-6d1c7734ee3a	bb57ce1d-23a8-4bb4-a22d-9d02b4084beb
116	116	0	GBIF Germany	4f6826f2-4ff6-443d-b966-e6913bd24013	bb6bccbd-4378-4641-9ee4-60d113a42d78
7	7	0	Plazi	ffb07bec-2d10-492d-9c37-361fe0b79427	bd251eac-93f1-465c-98c8-e9991ce81034
718	718	0	Biodiversity Information System of Mexico	b324e8e9-9a4c-44fa-8f1a-7f39ea7ab576	c5a9b58e-00b0-4a00-898f-a44e3a844236
17	17	0	Plazi	ffb07bec-2d10-492d-9c37-361fe0b79427	c5b23ffc-6b96-4686-aba1-3ecdb21f618b
495	495	0	U.S. Geological Survey	8618c64a-93e0-4300-b546-7249e5148ed2	c7e1bea1-62c1-49e4-8778-0e1307193347
0	64	64	Plazi	ffb07bec-2d10-492d-9c37-361fe0b79427	c7ecb63e-4d46-4af3-b512-cb76ba9e0caa
5	55	50	Plazi	ffb07bec-2d10-492d-9c37-361fe0b79427	c93d9a7f-28c5-4282-a677-5f28410fc66c
125	73	-52	GBIF Germany	4f6826f2-4ff6-443d-b966-e6913bd24013	cd6a5414-890a-4923-85de-ac20d89224bc
3	3	0	Plazi	ffb07bec-2d10-492d-9c37-361fe0b79427	cdbb80c0-8eff-40e8-a2a8-c385bbfd5770
0	6	6	Plazi	ffb07bec-2d10-492d-9c37-361fe0b79427	d0eabb53-1eeb-4af6-a9b3-53d3149b8e23
39	39	0	Plazi	ffb07bec-2d10-492d-9c37-361fe0b79427	d19034f9-3b62-470f-be80-b63215b5369c
2	2	0	Plazi	ffb07bec-2d10-492d-9c37-361fe0b79427	d2665075-e345-4bc0-bb16-9bdec8e4adcd
1732	1732	0	GBIF Benin	efb9c00e-f802-45dd-8826-a52ec45b89ff	d2724ca9-8ccd-416e-9837-7aee75f67422
0	1	1	Plazi	ffb07bec-2d10-492d-9c37-361fe0b79427	d419e05a-f3be-405a-87d0-6d65f9861ce9
0	4	4	Ocean Biodiversity Information System	ba0670b9-4186-41e6-8e70-f9cb3065551a	d5f4e57e-9841-4bff-b760-fe5eb7067bde
5830	5741	-89	GBIF Brazil	cdc9736d-5ff7-4ece-9959-3c744360cdb3	d71abe29-0cc7-451c-9eaf-42514a361885
47	47	0	Plazi	ffb07bec-2d10-492d-9c37-361fe0b79427	d7ce47e4-cf32-40d9-9d95-9625427cedaf
91	91	0	Plazi	ffb07bec-2d10-492d-9c37-361fe0b79427	d8f38b1a-d989-4559-8f58-95878de25602
36	36	0	GBIF France	da44cd31-5901-4687-a106-6d1c7734ee3a	dcae56f9-0461-4460-ac4e-28337170489a
1064	1064	0	Society for the Management of Electronic Biodiversity Data	97818ee4-1461-4180-bf1d-b3201050124f	de5a61e2-ef59-450d-be70-fcb241a2d567
23	23	0	Colombian Biodiversity Information System	7e865cba-7c46-417b-ade5-97f2cf5b7be0	e31ff7ad-6c19-4066-ac94-a624cf66b2e4
1	1	0	Plazi	ffb07bec-2d10-492d-9c37-361fe0b79427	e812d88f-6bd9-48e2-88d7-aebf355a87bf
0	137	137	Belgian Biodiversity Platform	fb11cfe1-ebc3-45af-9159-17d9fddbcdac	e82beebb-d3ce-4236-a46f-aec303d1cc86
552	552	0	GBIF France	da44cd31-5901-4687-a106-6d1c7734ee3a	e83db554-b316-4d59-87ea-a664ef87ab65
1	1	0	Plazi	ffb07bec-2d10-492d-9c37-361fe0b79427	e8eb1ae2-8454-4723-87dd-9bf360a1ccb0
111	111	0	Plazi	ffb07bec-2d10-492d-9c37-361fe0b79427	f43b0f7c-f6bc-4625-8344-0d79d6b3055d
0	2	2	Plazi	ffb07bec-2d10-492d-9c37-361fe0b79427	f619d8e8-5fed-4e14-bdb3-805d1ed49b58
274	274	0	Participant Node Managers Committee	7f48e0c8-5c96-49ec-b972-30748e339115	f7fc8184-1ca5-4ff2-98a6-59aab751b5bb
0	4	4	Plazi	ffb07bec-2d10-492d-9c37-361fe0b79427	fa567acb-dc40-4b0b-b572-f91183d29b12
0	2	2	Plazi	ffb07bec-2d10-492d-9c37-361fe0b79427	facdfd5b-97e8-4560-b741-11326bc9bfa0
0	7	7	Plazi	ffb07bec-2d10-492d-9c37-361fe0b79427	fb02abdb-c8d3-4892-9921-83a9286eb309
8088	8088	0	GBIF France	da44cd31-5901-4687-a106-6d1c7734ee3a	fbae5895-bc21-4331-93f8-bf8905f33e04
0	112	112	Plazi	ffb07bec-2d10-492d-9c37-361fe0b79427	fbd884d0-352e-4e3e-ba95-fde2cc87af91
15491	15512	21	Canada Biodiversity Information Facility	8f83fc96-c966-4126-83f7-bf044dc49efa	00ed18ea-4993-4809-a656-62363baa4808
0	131	131	Ocean Biodiversity Information System	ba0670b9-4186-41e6-8e70-f9cb3065551a	042bb43d-c0c1-461a-9179-67c82d8dfe19
889	889	0	National Biodiversity Network	d897a5b9-35ee-4232-94bd-b0bcaac003c2	05b53126-67e7-4fca-8a2b-7bd74e59fd48
7	7	0	Plazi	ffb07bec-2d10-492d-9c37-361fe0b79427	06e27461-4a99-402f-ae42-eb81da865394
339218	339217	-1	National Biodiversity Network	d897a5b9-35ee-4232-94bd-b0bcaac003c2	0a02b3dc-3cea-4efe-96b7-1d349985805b
0	5	5	Plazi	ffb07bec-2d10-492d-9c37-361fe0b79427	0a064355-8a60-4637-bc99-37b95c0b7417
281	281	0	GBIF Germany	4f6826f2-4ff6-443d-b966-e6913bd24013	0c1c7f01-49b7-4b8b-b912-609a412389da
3233	3233	0	GBIF Benin	efb9c00e-f802-45dd-8826-a52ec45b89ff	0d2e2847-e125-4a3b-b4a7-a2a199919b44
2	2	0	GBIF Japan	db5705aa-6a6e-42f1-8942-d77b9f4896ea	0ffa4232-ee43-428c-b978-8b533895fee2
7580	11948	4368	Colombian Biodiversity Information System	7e865cba-7c46-417b-ade5-97f2cf5b7be0	1035299a-5f41-4dde-92d4-2951e3d4bc87
0	154	154	Plazi	ffb07bec-2d10-492d-9c37-361fe0b79427	1053c042-2d20-480a-b084-05eda83a77a4
29	29	0	GBIF France	da44cd31-5901-4687-a106-6d1c7734ee3a	146c5ce3-47a4-4829-bf26-4d6e31d1537d
307	307	0	GBIF Finland	dd514216-5c7c-45f3-910d-797424cb5be6	14bb4067-7350-451c-8c36-c2c199f04d9e
127	127	0	Plazi	ffb07bec-2d10-492d-9c37-361fe0b79427	14dfc815-148a-4ed7-a4c4-34af7019a1eb
1	1	0	Plazi	ffb07bec-2d10-492d-9c37-361fe0b79427	151f88f7-a32e-4f91-aa0c-7a598af25109
52020	52765	745	GBIF Brazil	cdc9736d-5ff7-4ece-9959-3c744360cdb3	16ed67e5-fd70-4fd4-85c3-70ea2da627fe
0	4	4	Plazi	ffb07bec-2d10-492d-9c37-361fe0b79427	1a53f4bf-3485-4e70-b748-a9524d79e387
0	2	2	Plazi	ffb07bec-2d10-492d-9c37-361fe0b79427	1b414718-9ce8-4aff-9c5d-c2a8cbd891e0
71	71	0	Plazi	ffb07bec-2d10-492d-9c37-361fe0b79427	1cf12f99-65ce-4f59-a455-0008d79df52d
43	43	0	GBIF Sweden	a0b3be64-6525-4387-ac67-a499950f92e1	1fcf7a77-ed1a-4ecf-9ebe-887f37ec829e
214	214	0	Plazi	ffb07bec-2d10-492d-9c37-361fe0b79427	20827bdf-af12-45dc-b600-b1486443da36
0	34	34	GBIF Chile	a8b16421-d80b-4ef3-8f22-098b01a89255	211f0e9b-0655-46f9-81cc-00f0ccda97b6
129	110	-19	Biodiversity Information System of Mexico	b324e8e9-9a4c-44fa-8f1a-7f39ea7ab576	220ccf17-818a-4940-b425-d8ee1587bddc
124	124	0	GBIF Finland	dd514216-5c7c-45f3-910d-797424cb5be6	269bd204-ddc4-4e76-8bff-996fd5f2dbad
0	2	2	Plazi	ffb07bec-2d10-492d-9c37-361fe0b79427	270e8703-c75c-44a7-9eb5-425ea2b0d7ea
93	93	0	Atlas of Living Australia	4a6f1b71-969e-4fc5-a693-282b05e1220c	28ff4b21-bc9d-4c4e-91a5-e424ab301353
25	25	0	Plazi	ffb07bec-2d10-492d-9c37-361fe0b79427	29bc2ba0-3bc3-4d72-a4e4-355ff1d13d7d
0	48072	48072	Colombian Biodiversity Information System	7e865cba-7c46-417b-ade5-97f2cf5b7be0	2d66b392-d4fd-4fdf-95ca-e34958ae85db
0	2	2	Plazi	ffb07bec-2d10-492d-9c37-361fe0b79427	2df52457-bfd9-48cb-ab35-2db0b87cee7e
2885	2885	0	Biodiversity Information System of Mexico	b324e8e9-9a4c-44fa-8f1a-7f39ea7ab576	352f4c9b-e35d-4385-8303-50362fa07f24
43	43	0	Plazi	ffb07bec-2d10-492d-9c37-361fe0b79427	357507b3-3b8d-4d2e-b8c1-3c69d6d4fdaa
12	12	0	GBIF Germany	4f6826f2-4ff6-443d-b966-e6913bd24013	37f12469-b72b-4ba9-8cd8-426913b2c430
0	18	18	Plazi	ffb07bec-2d10-492d-9c37-361fe0b79427	3ba86712-853d-444f-9f71-2bc818a7ae80
0	3851	3851	Colombian Biodiversity Information System	7e865cba-7c46-417b-ade5-97f2cf5b7be0	3bf0f4d2-0a4d-466e-8484-ef8d8b7b12cf
14	14	0	GBIF Germany	4f6826f2-4ff6-443d-b966-e6913bd24013	3db60781-ecd3-42be-9eea-05ba7c7695d3
0	501	501	Participant Node Managers Committee	7f48e0c8-5c96-49ec-b972-30748e339115	3fc4ed1b-9026-47a9-857f-f6543c444874
10098	10098	0	Polish Biodiversity Information Network	2618bfdf-e194-4911-a241-80db3107bc51	41103800-0e2e-11de-b8e6-b8a03c50a862
380	380	0	GBIF Germany	4f6826f2-4ff6-443d-b966-e6913bd24013	42962fd5-34ee-4666-abdb-04e8ba4d23b0
114	114	0	GBIF France	da44cd31-5901-4687-a106-6d1c7734ee3a	442d5fde-1001-41bc-bc4d-3559266cd01a
13	13	0	GBIF Germany	4f6826f2-4ff6-443d-b966-e6913bd24013	44a8361c-3a0c-11e2-b0ce-00145eb45e9a
0	72	72	Colombian Biodiversity Information System	7e865cba-7c46-417b-ade5-97f2cf5b7be0	450dbb07-3067-4de7-925f-5ff45b97f5f5
1748	1748	0	GBIF Germany	4f6826f2-4ff6-443d-b966-e6913bd24013	453c9cb5-4019-4335-9a2b-fb71572330e8
12	12	0	Plazi	ffb07bec-2d10-492d-9c37-361fe0b79427	45af3c09-551b-490b-abb9-dda95499f47f
104	104	0	GBIF France	da44cd31-5901-4687-a106-6d1c7734ee3a	47b226c0-2dc8-4f7e-9a76-7a610f1c6781
126169	126169	0	Atlas of Living Australia	4a6f1b71-969e-4fc5-a693-282b05e1220c	47c9fee2-619a-481c-a114-386bc4748256
0	75	75	Plazi	ffb07bec-2d10-492d-9c37-361fe0b79427	4b298f97-c246-4d4f-8f9f-38d414ffadb7
431	431	0	Colombian Biodiversity Information System	7e865cba-7c46-417b-ade5-97f2cf5b7be0	4d12fc2b-b910-470e-958f-666f3c020770
170	170	0	GBIF France	da44cd31-5901-4687-a106-6d1c7734ee3a	4d3b4683-a3b0-4145-9315-78a99af7ec5f
9264	9264	0	GBIF Japan	db5705aa-6a6e-42f1-8942-d77b9f4896ea	508263bf-7557-40d4-b839-59d125ceca5b
0	13	13	Plazi	ffb07bec-2d10-492d-9c37-361fe0b79427	5268baff-3074-40c5-ae0f-f799f2c8d8c2
6774	6774	0	GBIF Argentina	2426a871-9feb-40a1-96c6-0c593a76b835	561367c9-576b-4aa8-8fc9-1981155b11af
146	146	0	National Biodiversity Network	d897a5b9-35ee-4232-94bd-b0bcaac003c2	57196654-cf6d-424f-8eb7-b30cd6f4d5a8
41411	41411	0	DanBIF - Danish Biodiversity Information Facility	4ddd294f-02b7-4359-ac33-0806a9ca9c6b	58fc397b-eee4-4138-8a5f-50f9dfb00216
6224	6224	0	GBIF France	da44cd31-5901-4687-a106-6d1c7734ee3a	5905769a-49d8-4d49-8fb5-375a4a270ba7
64	64	0	GBIF France	da44cd31-5901-4687-a106-6d1c7734ee3a	5a6c0b74-8237-4b1b-b498-2b14dc2d2de4
2618	2618	0	GBIF France	da44cd31-5901-4687-a106-6d1c7734ee3a	5b628ee9-daf9-496e-9a2d-1add79fff274
6387	6387	0	GBIF France	da44cd31-5901-4687-a106-6d1c7734ee3a	5bd30d93-14a4-463b-bef1-b5bb8690562d
31	31	0	GBIF France	da44cd31-5901-4687-a106-6d1c7734ee3a	5d8dd766-2aec-4984-9a7c-2476ee5ac294
911	911	0	Participant Node Managers Committee	7f48e0c8-5c96-49ec-b972-30748e339115	5deaec15-d540-43ec-9093-1694c3854873
1	1	0	Plazi	ffb07bec-2d10-492d-9c37-361fe0b79427	5f4f71dd-4123-4b54-99b6-cd65e56cd666
6	6	0	Plazi	ffb07bec-2d10-492d-9c37-361fe0b79427	5fc3a664-f66d-4099-bc49-64e03f1fc972
37	37	0	GBIF Germany	4f6826f2-4ff6-443d-b966-e6913bd24013	615fd18a-f762-11e1-a439-00145eb45e9a
297	297	0	GBIF Germany	4f6826f2-4ff6-443d-b966-e6913bd24013	620eb664-f762-11e1-a439-00145eb45e9a
13	13	0	Plazi	ffb07bec-2d10-492d-9c37-361fe0b79427	621a93ac-5768-4dc0-9a7f-0c7916d2de20
244	244	0	GBIF Germany	4f6826f2-4ff6-443d-b966-e6913bd24013	6220d650-f762-11e1-a439-00145eb45e9a
166	166	0	GBIF Germany	4f6826f2-4ff6-443d-b966-e6913bd24013	63b7a318-f762-11e1-a439-00145eb45e9a
4126	4126	0	Colombian Biodiversity Information System	7e865cba-7c46-417b-ade5-97f2cf5b7be0	63bcf8e4-3444-4a94-a993-f653c99b1758
38	38	0	GBIF Germany	4f6826f2-4ff6-443d-b966-e6913bd24013	6482de2a-f762-11e1-a439-00145eb45e9a
2	2	0	Plazi	ffb07bec-2d10-492d-9c37-361fe0b79427	65b524e3-53cc-4bde-a834-4a6f25272c70
18	17	-1	GBIF Germany	4f6826f2-4ff6-443d-b966-e6913bd24013	65c1661c-f762-11e1-a439-00145eb45e9a
77	77	0	GBIF Germany	4f6826f2-4ff6-443d-b966-e6913bd24013	687c2f18-f762-11e1-a439-00145eb45e9a
131	131	0	GBIF Germany	4f6826f2-4ff6-443d-b966-e6913bd24013	69cdabbc-f762-11e1-a439-00145eb45e9a
136	136	0	GBIF Germany	4f6826f2-4ff6-443d-b966-e6913bd24013	69d714ae-f762-11e1-a439-00145eb45e9a
187	187	0	GBIF Germany	4f6826f2-4ff6-443d-b966-e6913bd24013	69dd6282-f762-11e1-a439-00145eb45e9a
1280	1280	0	GBIF Germany	4f6826f2-4ff6-443d-b966-e6913bd24013	6a3373ca-f762-11e1-a439-00145eb45e9a
34	34	0	GBIF Germany	4f6826f2-4ff6-443d-b966-e6913bd24013	6aad2bac-f762-11e1-a439-00145eb45e9a
2	2	0	GBIF Germany	4f6826f2-4ff6-443d-b966-e6913bd24013	6ad0b388-f762-11e1-a439-00145eb45e9a
12	12	0	GBIF Germany	4f6826f2-4ff6-443d-b966-e6913bd24013	6c02b62a-f762-11e1-a439-00145eb45e9a
0	6	6	Plazi	ffb07bec-2d10-492d-9c37-361fe0b79427	6d35d331-3be9-4aed-8ba4-ee36dc7d95cb
8	8	0	Plazi	ffb07bec-2d10-492d-9c37-361fe0b79427	6ee78ad9-4d46-4f7c-b292-3b4a4841df1f
8	8	0	Plazi	ffb07bec-2d10-492d-9c37-361fe0b79427	6f72de26-2262-48a6-bff9-5319fb6986fc
3792	3792	0	National Biodiversity Network	d897a5b9-35ee-4232-94bd-b0bcaac003c2	6ff4972a-3787-4bef-8a2b-e4ceed8e7cd4
15	15	0	Plazi	ffb07bec-2d10-492d-9c37-361fe0b79427	710a368c-2adb-49a0-ba1e-acfa6f61a7c1
2	2	0	Plazi	ffb07bec-2d10-492d-9c37-361fe0b79427	714105a1-fcbd-4a61-9692-94866f217044
0	1	1	Plazi	ffb07bec-2d10-492d-9c37-361fe0b79427	756aeb2d-d451-4503-a7e0-d2e666a24981
17	17	0	National Biodiversity Network	d897a5b9-35ee-4232-94bd-b0bcaac003c2	759ed665-1e9d-401a-86c7-603c6698d976
4	4	0	GBIF Germany	4f6826f2-4ff6-443d-b966-e6913bd24013	75ddd49a-f762-11e1-a439-00145eb45e9a
9902	9902	0	GBIF Benin	efb9c00e-f802-45dd-8826-a52ec45b89ff	76a657f1-c2b7-4be6-b822-1f8efccc5323
41834	41834	0	GBIF France	da44cd31-5901-4687-a106-6d1c7734ee3a	77c3a178-a140-4a5d-87af-1f29e29f8330
90	90	0	Plazi	ffb07bec-2d10-492d-9c37-361fe0b79427	77f7bd0a-753c-4807-8f66-8d687f3b2b5e
1853589	1853589	0	Taiwan Biodiversity Information Facility	e1b85abc-61f9-430f-ba79-6813dec53a0f	78fc169f-cef0-4054-88ec-9b694bcbf6e4
3361	3361	0	GBIF Brazil	cdc9736d-5ff7-4ece-9959-3c744360cdb3	797693e3-21c6-4043-8bf9-08217dd0747b
920	920	0	GBIF Germany	4f6826f2-4ff6-443d-b966-e6913bd24013	79bdd896-19b1-4c7d-b438-7a84aa35a12e
20	20	0	Plazi	ffb07bec-2d10-492d-9c37-361fe0b79427	7b94dd56-d3a7-4462-8da2-72ceb277835f
84	84	0	GBIF Germany	4f6826f2-4ff6-443d-b966-e6913bd24013	7bcc233e-f762-11e1-a439-00145eb45e9a
391	35	-356	GBIF Germany	4f6826f2-4ff6-443d-b966-e6913bd24013	7be162b8-18f0-4f2c-b0fd-18c03d35938c
20	20	0	GBIF Germany	4f6826f2-4ff6-443d-b966-e6913bd24013	7c16a40e-f762-11e1-a439-00145eb45e9a
558	527	-31	GBIF Germany	4f6826f2-4ff6-443d-b966-e6913bd24013	7c1cf2be-f762-11e1-a439-00145eb45e9a
66	66	0	GBIF Germany	4f6826f2-4ff6-443d-b966-e6913bd24013	7cd1b906-f762-11e1-a439-00145eb45e9a
1624	1586	-38	GBIF Germany	4f6826f2-4ff6-443d-b966-e6913bd24013	7cf10630-f762-11e1-a439-00145eb45e9a
65	65	0	GBIF Germany	4f6826f2-4ff6-443d-b966-e6913bd24013	7cfb9924-f762-11e1-a439-00145eb45e9a
7176	7176	0	Biodiversity Information System of Mexico	b324e8e9-9a4c-44fa-8f1a-7f39ea7ab576	7d0775ec-119a-43ca-8121-cdb142869169
103	51	-52	GBIF Germany	4f6826f2-4ff6-443d-b966-e6913bd24013	7da67c4a-f762-11e1-a439-00145eb45e9a
45	31	-14	GBIF Germany	4f6826f2-4ff6-443d-b966-e6913bd24013	7ea09dce-f762-11e1-a439-00145eb45e9a
1562	1563	1	GBIF Germany	4f6826f2-4ff6-443d-b966-e6913bd24013	7f8aab44-1387-11e2-bb2e-00145eb45e9a
232	232	0	Biodiversity Information System of Mexico	b324e8e9-9a4c-44fa-8f1a-7f39ea7ab576	80863c34-f762-11e1-a439-00145eb45e9a
500	500	0	GBIF Japan	db5705aa-6a6e-42f1-8942-d77b9f4896ea	80dbdd92-f762-11e1-a439-00145eb45e9a
8	8	0	National Biodiversity Network	d897a5b9-35ee-4232-94bd-b0bcaac003c2	81c0bac7-19c6-436e-9538-9dcb134d8f72
27	27	0	GBIF Germany	4f6826f2-4ff6-443d-b966-e6913bd24013	81ca34f6-f762-11e1-a439-00145eb45e9a
3053	3053	0	Participant Node Managers Committee	7f48e0c8-5c96-49ec-b972-30748e339115	827843c0-e60b-4283-b79f-6fa88482736d
88	88	0	Participant Node Managers Committee	7f48e0c8-5c96-49ec-b972-30748e339115	83aee115-7c59-468b-9b30-92d14b7add82
265	265	0	Biodiversity Information System of Mexico	b324e8e9-9a4c-44fa-8f1a-7f39ea7ab576	850dd1ae-f762-11e1-a439-00145eb45e9a
12826	12826	0	National Biodiversity Network	d897a5b9-35ee-4232-94bd-b0bcaac003c2	852c6f27-e079-4a64-98b4-b80176654a44
24	24	0	World Federation for Culture Collections	a6bdc523-5368-4e0f-9d2e-de1c262ac092	855cef78-f762-11e1-a439-00145eb45e9a
195	195	0	GBIF Germany	4f6826f2-4ff6-443d-b966-e6913bd24013	8635ed00-f762-11e1-a439-00145eb45e9a
12	8	-4	GBIF Germany	4f6826f2-4ff6-443d-b966-e6913bd24013	8774ec8e-f762-11e1-a439-00145eb45e9a
0	14	14	Plazi	ffb07bec-2d10-492d-9c37-361fe0b79427	883492e3-943e-4f9e-be66-29858a171190
11	11	0	GBIF Germany	4f6826f2-4ff6-443d-b966-e6913bd24013	88a5f198-f762-11e1-a439-00145eb45e9a
670	670	0	GBIF Germany	4f6826f2-4ff6-443d-b966-e6913bd24013	89f52a6e-f762-11e1-a439-00145eb45e9a
18	18	0	Plazi	ffb07bec-2d10-492d-9c37-361fe0b79427	8a2f683f-55cb-4e52-8df6-512dd102adfa
1753	1753	0	Participant Node Managers Committee	7f48e0c8-5c96-49ec-b972-30748e339115	8af571a4-135f-4ca0-acd8-16983cf6ee77
75	56	-19	GBIF Germany	4f6826f2-4ff6-443d-b966-e6913bd24013	8d5982b8-f762-11e1-a439-00145eb45e9a
687	289	-398	GBIF Germany	4f6826f2-4ff6-443d-b966-e6913bd24013	8e17b56c-f762-11e1-a439-00145eb45e9a
78	73	-5	GBIF Germany	4f6826f2-4ff6-443d-b966-e6913bd24013	8f53b2a0-f762-11e1-a439-00145eb45e9a
221	221	0	GBIF Germany	4f6826f2-4ff6-443d-b966-e6913bd24013	8f7d4b92-f762-11e1-a439-00145eb45e9a
86	51	-35	GBIF Germany	4f6826f2-4ff6-443d-b966-e6913bd24013	8fbfa9b0-f762-11e1-a439-00145eb45e9a
78	43	-35	GBIF Germany	4f6826f2-4ff6-443d-b966-e6913bd24013	904d86f4-f762-11e1-a439-00145eb45e9a
1259	749	-510	GBIF Germany	4f6826f2-4ff6-443d-b966-e6913bd24013	9060c0e8-f762-11e1-a439-00145eb45e9a
127238	127238	0	U.S. Geological Survey	8618c64a-93e0-4300-b546-7249e5148ed2	9168f50d-350e-4af1-ba97-17274f1faeaf
329	295	-34	GBIF Germany	4f6826f2-4ff6-443d-b966-e6913bd24013	917a7de8-f762-11e1-a439-00145eb45e9a
95	95	0	GBIF Germany	4f6826f2-4ff6-443d-b966-e6913bd24013	925b28b6-f762-11e1-a439-00145eb45e9a
241	193	-48	GBIF Germany	4f6826f2-4ff6-443d-b966-e6913bd24013	92e09596-f762-11e1-a439-00145eb45e9a
16	16	0	GBIF Germany	4f6826f2-4ff6-443d-b966-e6913bd24013	93565628-f762-11e1-a439-00145eb45e9a
56	56	0	GBIF Germany	4f6826f2-4ff6-443d-b966-e6913bd24013	9444d7d0-f762-11e1-a439-00145eb45e9a
10	10	0	GBIF Germany	4f6826f2-4ff6-443d-b966-e6913bd24013	957e199a-f762-11e1-a439-00145eb45e9a
16289	16289	0	GBIF Japan	db5705aa-6a6e-42f1-8942-d77b9f4896ea	96001198-f762-11e1-a439-00145eb45e9a
7	7	0	Plazi	ffb07bec-2d10-492d-9c37-361fe0b79427	96047e01-ad24-4fa6-8169-7f58eb8e75a2
105	105	0	GBIF France	da44cd31-5901-4687-a106-6d1c7734ee3a	9709750f-2534-4a6d-834e-8aa317bf660e
1649	1649	0	U.S. Geological Survey	8618c64a-93e0-4300-b546-7249e5148ed2	97f3fa73-3195-4af9-a14e-07030f00db96
4	4	0	Plazi	ffb07bec-2d10-492d-9c37-361fe0b79427	9948103c-ea55-4019-9121-b84c3c365e75
1546	1546	0	Colombian Biodiversity Information System	7e865cba-7c46-417b-ade5-97f2cf5b7be0	99bb6c96-5c51-4349-bc04-52f0985ae9df
407	407	0	National Biodiversity Network	d897a5b9-35ee-4232-94bd-b0bcaac003c2	9d2de2c1-c9f9-4249-9edc-b1e88bd1a83c
0	728	728	Canada Biodiversity Information Facility	8f83fc96-c966-4126-83f7-bf044dc49efa	a00b1bcc-584c-47f7-85ba-74ef49d7837e
104797	108465	3668	U.S. Geological Survey	8618c64a-93e0-4300-b546-7249e5148ed2	a2254f58-8bbf-41e6-ac4e-03d1683e0ce5
0	1	1	Ocean Biodiversity Information System	ba0670b9-4186-41e6-8e70-f9cb3065551a	a3b0a78d-0cc0-46d8-8248-88f9a6bb62a5
101	101	0	National Biodiversity Network	d897a5b9-35ee-4232-94bd-b0bcaac003c2	a546e5b0-4a64-4df0-88d3-5238c4749c2e
36034	36034	0	GBIF France	da44cd31-5901-4687-a106-6d1c7734ee3a	a5f073d3-2a88-4fe0-bdcb-e332397b4b6a
1	1	0	Plazi	ffb07bec-2d10-492d-9c37-361fe0b79427	a9d864e0-dc0e-4e84-aa88-e6644cf7d229
12	12	0	Participant Node Managers Committee	7f48e0c8-5c96-49ec-b972-30748e339115	a9d9de68-7194-4bbe-8996-911e6f942944
0	166	166	Colombian Biodiversity Information System	7e865cba-7c46-417b-ade5-97f2cf5b7be0	aaad5daa-5582-49d3-a74f-edfaa9945be5
2	2	0	Plazi	ffb07bec-2d10-492d-9c37-361fe0b79427	ac1be7ab-8f1c-4032-9e05-bd069cbee124
0	2	2	Plazi	ffb07bec-2d10-492d-9c37-361fe0b79427	ad84806a-d65f-4ef4-b906-1fd44381a126
0	5	5	Plazi	ffb07bec-2d10-492d-9c37-361fe0b79427	ae5ad8b5-20ca-4b96-9339-5c849832f375
2251	2087	-164	GBIF Germany	4f6826f2-4ff6-443d-b966-e6913bd24013	b0a87653-2617-48f7-966b-136ffdb18da7
24218	24656	438	U.S. Geological Survey	8618c64a-93e0-4300-b546-7249e5148ed2	b211f32f-326b-43d3-8012-2fbce0cc6dcc
3051	2042	-1009	GBIF Germany	4f6826f2-4ff6-443d-b966-e6913bd24013	b413d269-02d3-4bf6-8b77-f02f8e3477ca
241	241	0	GBIF France	da44cd31-5901-4687-a106-6d1c7734ee3a	b4be17d7-4591-4ffd-9cd4-a15891119a2f
26	26	0	GBIF Malawi	2a42e4d7-ad4a-41b3-84c4-de4aa7b74d35	b4c500f8-a952-4f9a-bf72-711ae53c67c1
44	44	0	Plazi	ffb07bec-2d10-492d-9c37-361fe0b79427	b52dc28e-80f9-4d05-bb8e-3fe4a404b439
2	2	0	Plazi	ffb07bec-2d10-492d-9c37-361fe0b79427	b6634719-99ce-4f43-8742-e67f1900fd8a
139	139	0	GBIF France	da44cd31-5901-4687-a106-6d1c7734ee3a	b86c20a6-eefc-4bb2-a4f3-d41550ee9d0f
0	20	20	Plazi	ffb07bec-2d10-492d-9c37-361fe0b79427	b98c5a41-914b-4398-8dca-2cf9b36d1817
0	30497	30497	BioCASE	d8bbf693-a180-4995-94fe-6130795dcf2f	b999cd04-2167-4f58-b013-d1923f9863f7
5	5	0	Plazi	ffb07bec-2d10-492d-9c37-361fe0b79427	bb60a8d8-4d6e-4af6-b709-e25c635c6e2f
250	250	0	Plazi	ffb07bec-2d10-492d-9c37-361fe0b79427	bb7fccfa-ae25-4a5f-afb6-4aa071fa61df
1327	1327	0	Belgian Biodiversity Platform	fb11cfe1-ebc3-45af-9159-17d9fddbcdac	be19d04a-044f-4def-a298-186a3616be8f
16	16	0	Plazi	ffb07bec-2d10-492d-9c37-361fe0b79427	bf1cab4f-e45e-4c2a-b835-3147e286d204
356	356	0	Polish Biodiversity Information Network	2618bfdf-e194-4911-a241-80db3107bc51	bf5ed960-9fcc-11da-a90c-b8a03c50a862
0	824	824	Ocean Biodiversity Information System	ba0670b9-4186-41e6-8e70-f9cb3065551a	c0e32290-cf5a-47a0-91ca-2c26fbf5bd64
9	9	0	Plazi	ffb07bec-2d10-492d-9c37-361fe0b79427	c15316e2-1983-47f7-8919-04dab3ebe304
3261	3261	0	Ocean Biodiversity Information System	ba0670b9-4186-41e6-8e70-f9cb3065551a	c25f5a6a-5c8c-4310-ac09-26120b91858e
0	408	408	Participant Node Managers Committee	7f48e0c8-5c96-49ec-b972-30748e339115	c264fb87-e550-48e3-b24f-7cebaee395d6
16587	16587	0	National Biodiversity Network	d897a5b9-35ee-4232-94bd-b0bcaac003c2	c280aa86-69f2-4d7e-be6a-7fa41a9bade1
0	17	17	Plazi	ffb07bec-2d10-492d-9c37-361fe0b79427	c542e28a-4470-4cd2-a945-a24f723f5253
67	67	0	Colombian Biodiversity Information System	7e865cba-7c46-417b-ade5-97f2cf5b7be0	c68230c3-394d-4b52-abf1-7a2a065be965
199	199	0	Participant Node Managers Committee	7f48e0c8-5c96-49ec-b972-30748e339115	c684e21e-eed5-4c0b-9d5e-028c08d9d893
222	222	0	National Biodiversity Network	d897a5b9-35ee-4232-94bd-b0bcaac003c2	c846d1b9-0a75-4af1-9cc0-b7d66216589f
2	2	0	Participant Node Managers Committee	7f48e0c8-5c96-49ec-b972-30748e339115	ce6f2f4b-ae5b-4e3d-b3e4-f1965f77e782
882	882	0	GBIF Germany	4f6826f2-4ff6-443d-b966-e6913bd24013	d120fec3-001d-45bf-8da7-47e91c861b5b
202	202	0	GBIF Germany	4f6826f2-4ff6-443d-b966-e6913bd24013	d1336fbe-11b9-46e7-8791-6f2c0315bc16
3643	3643	0	National Biodiversity Network	d897a5b9-35ee-4232-94bd-b0bcaac003c2	d2c5a3fa-e541-4399-b7b3-5d879af9f266
21	21	0	Plazi	ffb07bec-2d10-492d-9c37-361fe0b79427	d4cb7abf-edbd-4fd6-a205-04fd50a801d7
1440	1440	0	Netherlands Biodiversity Information Facility	0909d601-bda2-42df-9e63-a6d51847ebce	d538ab33-a853-471a-8e1d-be808dd7b922
7	7	0	Plazi	ffb07bec-2d10-492d-9c37-361fe0b79427	d64d995c-06c4-4541-aae0-737c86d030a9
5	5	0	Plazi	ffb07bec-2d10-492d-9c37-361fe0b79427	d855e5f3-a7a8-4990-a44a-88046a2b4fd6
34429	35311	882	U.S. Geological Survey	8618c64a-93e0-4300-b546-7249e5148ed2	d9e3a5bc-3811-4811-a78c-77d78a2107d7
1261	1261	0	Biodiversity Information System of Mexico	b324e8e9-9a4c-44fa-8f1a-7f39ea7ab576	da2f43fd-ac8c-424b-bc98-273573b0b7e3
0	2	2	Plazi	ffb07bec-2d10-492d-9c37-361fe0b79427	da4c865b-eda3-4151-b777-0898eb6458c8
0	57105	57105	Belgian Biodiversity Platform	fb11cfe1-ebc3-45af-9159-17d9fddbcdac	db2cd6fc-a7d5-43ad-b944-8a663d57ae73
6	6	0	Plazi	ffb07bec-2d10-492d-9c37-361fe0b79427	db595c03-4859-4d5b-94f6-f9d73a40db69
303	303	0	Ocean Biodiversity Information System	ba0670b9-4186-41e6-8e70-f9cb3065551a	db9ab2e6-9e9b-41d9-88ab-5abf254bd5b2
11	11	0	Plazi	ffb07bec-2d10-492d-9c37-361fe0b79427	dcbb64d9-cac5-4c86-9cf9-248c8f42efa2
5	5	0	Plazi	ffb07bec-2d10-492d-9c37-361fe0b79427	dce36608-9519-4ad4-a271-1540b7d4ae96
3	3	0	Plazi	ffb07bec-2d10-492d-9c37-361fe0b79427	dd799718-840d-44dd-8d54-6a522f112170
1756	1756	0	GBIF France	da44cd31-5901-4687-a106-6d1c7734ee3a	df8aecb5-eb27-41a2-aac3-3d7c5d361c3c
0	1	1	Plazi	ffb07bec-2d10-492d-9c37-361fe0b79427	e1f25c63-a989-4294-a204-d0cb636a6945
0	1090	1090	Plazi	ffb07bec-2d10-492d-9c37-361fe0b79427	e8ade5ef-ebef-4519-85fe-50919b4b9fe1
566	566	0	Colombian Biodiversity Information System	7e865cba-7c46-417b-ade5-97f2cf5b7be0	ea0c5060-7b9b-49c6-abb5-0a02e1428c0a
3	3	0	Plazi	ffb07bec-2d10-492d-9c37-361fe0b79427	ebc88ba8-1981-4e5d-aacc-d80412593b6f
119	119	0	GBIF Germany	4f6826f2-4ff6-443d-b966-e6913bd24013	eca57f6e-bcb4-41a8-bcce-038f3f6f0c67
88	88	0	Plazi	ffb07bec-2d10-492d-9c37-361fe0b79427	f3328b3e-6059-40b6-b7f5-1c19aa90f676
1212	1212	0	National Biodiversity Network	d897a5b9-35ee-4232-94bd-b0bcaac003c2	f809877d-53e1-423e-a9ad-d28ffd7fb660
0	1	1	Plazi	ffb07bec-2d10-492d-9c37-361fe0b79427	f9082e38-ffc3-4f2b-8a49-a684d82d32b4
1499	1499	0	GBIF Benin	efb9c00e-f802-45dd-8826-a52ec45b89ff	f9a444d9-0963-4ef4-819f-d03334ea399f
773	773	0	GBIF Germany	4f6826f2-4ff6-443d-b966-e6913bd24013	fa4a1877-8e05-4731-ba8b-78290595d215
15	15	0	Plazi	ffb07bec-2d10-492d-9c37-361fe0b79427	fa5fe76f-3f7f-4df4-91fd-a533522aae3d
0	15	15	Plazi	ffb07bec-2d10-492d-9c37-361fe0b79427	fb7cc247-9e60-4417-92df-5c4a134d10be
116	116	0	GBIF France	da44cd31-5901-4687-a106-6d1c7734ee3a	fc456348-0f3d-497d-b92d-1654df6aeb7a
477	477	0	Plazi	ffb07bec-2d10-492d-9c37-361fe0b79427	fcb57df9-61a0-49dd-ac9c-71e73b61b777
1065	1065	0	Netherlands Biodiversity Information Facility	0909d601-bda2-42df-9e63-a6d51847ebce	fdcd944c-20b1-4d9e-b771-8df5bc27284b
2	2	0	Plazi	ffb07bec-2d10-492d-9c37-361fe0b79427	ff3f8aaa-dcde-4822-8849-84d69f16552a
1	1	0	Plazi	ffb07bec-2d10-492d-9c37-361fe0b79427	00a34b27-7af9-43b3-b522-0854c721b5db
3818	3818	0	Colombian Biodiversity Information System	7e865cba-7c46-417b-ade5-97f2cf5b7be0	03d13f7f-fe29-4558-8869-9896b102f4f9
0	667	667	Ocean Biodiversity Information System	ba0670b9-4186-41e6-8e70-f9cb3065551a	076254a0-4e20-44c4-bffa-4475ba345536
1389	722	-667	GBIF Germany	4f6826f2-4ff6-443d-b966-e6913bd24013	091eb451-7476-4942-9532-f23c82c9e627
4589	4589	0	Biodiversity Information System of Mexico	b324e8e9-9a4c-44fa-8f1a-7f39ea7ab576	09e074a3-6385-454c-9dc8-bd52c56188de
0	1	1	Plazi	ffb07bec-2d10-492d-9c37-361fe0b79427	0b3ef57e-18ca-4b1a-88aa-2e2e74807e88
715	715	0	GBIF France	da44cd31-5901-4687-a106-6d1c7734ee3a	0b3f2e17-b68e-4f9b-a5d4-4557fe95bbce
384	384	0	National Biodiversity Network	d897a5b9-35ee-4232-94bd-b0bcaac003c2	0d073fd8-a8dd-4e0a-adec-9875bc43a13d
236585	236585	0	Belgian Biodiversity Platform	fb11cfe1-ebc3-45af-9159-17d9fddbcdac	0d7c6a1a-0aab-47dc-8256-f23fefac69cd
0	31	31	Plazi	ffb07bec-2d10-492d-9c37-361fe0b79427	0f58e2f0-694f-4142-9045-191862f9d47e
2	2	0	Plazi	ffb07bec-2d10-492d-9c37-361fe0b79427	109d3c63-8f6c-4c66-bab6-cb8cf8257961
4596	4596	0	GBIF France	da44cd31-5901-4687-a106-6d1c7734ee3a	10f2c4ee-4b24-40e9-886b-d7d0067f8c14
1	1	0	Plazi	ffb07bec-2d10-492d-9c37-361fe0b79427	1686dc5c-c0db-4023-a221-56785ba8295e
0	2	2	Plazi	ffb07bec-2d10-492d-9c37-361fe0b79427	1799af97-a5ca-473c-a4c9-0fc5f08ddb8c
1	1	0	Plazi	ffb07bec-2d10-492d-9c37-361fe0b79427	197be004-5911-44e6-be9e-0582ff71f29d
4	4	0	Plazi	ffb07bec-2d10-492d-9c37-361fe0b79427	1a7a5362-e927-404a-948b-98cc0162cc65
1	1	0	GBIF France	da44cd31-5901-4687-a106-6d1c7734ee3a	2015efcb-7791-40dc-bd71-7c77449acf49
2	2	0	Plazi	ffb07bec-2d10-492d-9c37-361fe0b79427	21b9288c-7301-4b31-9fe1-6397eef9709f
23	23	0	Plazi	ffb07bec-2d10-492d-9c37-361fe0b79427	21e76f5b-58c0-4caa-8065-ec760e4f46ea
6323	6323	0	National Biodiversity Network	d897a5b9-35ee-4232-94bd-b0bcaac003c2	27053051-516f-4962-8367-7e88503b1ecd
0	13705	13705	Participant Node Managers Committee	7f48e0c8-5c96-49ec-b972-30748e339115	293877e6-6eed-48fc-8f2c-04ea0797e050
2	2	0	Plazi	ffb07bec-2d10-492d-9c37-361fe0b79427	2c9e23a9-5adf-4091-a5a8-0655938f9a0f
380	380	0	GBIF Germany	4f6826f2-4ff6-443d-b966-e6913bd24013	2e4d6279-61a4-44fe-8b77-6f1e4e67d813
317	317	0	Participant Node Managers Committee	7f48e0c8-5c96-49ec-b972-30748e339115	2f0f6f6b-b7dc-4cf0-9ede-107627044722
230	230	0	National Biodiversity Network	d897a5b9-35ee-4232-94bd-b0bcaac003c2	35ad191d-3496-4a6a-bc1c-4b0a5dcbf461
0	11	11	Participant Node Managers Committee	7f48e0c8-5c96-49ec-b972-30748e339115	35e04543-62ea-444e-9998-11663ea99d15
40	40	0	Indonesian Biodiversity Information Facility	2ebd91f6-f14f-4375-b525-c011a3774f03	3839d127-ff17-4477-9069-2b0746d4bc83
0	84	84	Ocean Biodiversity Information System	ba0670b9-4186-41e6-8e70-f9cb3065551a	38cd2a3c-7cc3-4156-bb2e-51e4add3f1fe
0	6	6	Plazi	ffb07bec-2d10-492d-9c37-361fe0b79427	395b5c2c-b75f-4803-956d-176d8677b9aa
11	11	0	Participant Node Managers Committee	7f48e0c8-5c96-49ec-b972-30748e339115	3ab5d19a-17f4-49a2-8feb-52d18430acd7
0	2	2	Plazi	ffb07bec-2d10-492d-9c37-361fe0b79427	3eb81863-15ec-4e46-8d15-3c73d694a302
22	22	0	Colombian Biodiversity Information System	7e865cba-7c46-417b-ade5-97f2cf5b7be0	3ef2f45d-6292-4b2b-be3b-75933dec5a6b
0	6	6	Plazi	ffb07bec-2d10-492d-9c37-361fe0b79427	3fec678d-2a3c-4fdd-9564-aebe0202971b
1	1	0	Plazi	ffb07bec-2d10-492d-9c37-361fe0b79427	40c6737a-e0d1-4b28-994c-cad377305534
2	2	0	Plazi	ffb07bec-2d10-492d-9c37-361fe0b79427	4213a2c9-5ec2-480b-9cd6-65f235d73fb2
3373	3373	0	Participant Node Managers Committee	7f48e0c8-5c96-49ec-b972-30748e339115	43f9dcb0-80e1-40ec-906f-93a186e993b2
0	17	17	Plazi	ffb07bec-2d10-492d-9c37-361fe0b79427	44ee08a6-22ce-4f43-be98-4ac76aad2c24
85	85	0	Plazi	ffb07bec-2d10-492d-9c37-361fe0b79427	44f3260b-e3ff-408d-8f18-673df696600c
0	182	182	Plazi	ffb07bec-2d10-492d-9c37-361fe0b79427	453c885c-f427-4a38-ab97-dc14b686e126
6	6	0	Plazi	ffb07bec-2d10-492d-9c37-361fe0b79427	46cccc50-af03-4f6e-b6cf-dec70c636d83
2553	2553	0	GBIF France	da44cd31-5901-4687-a106-6d1c7734ee3a	49bde372-d1b5-4f67-90e0-e44dafcd9f62
17	17	0	GBIF France	da44cd31-5901-4687-a106-6d1c7734ee3a	4a97bb04-2378-4ca1-9fe9-a70f23098374
0	22	22	Plazi	ffb07bec-2d10-492d-9c37-361fe0b79427	4b869ec8-22e5-4b3a-bdbf-7a3db724770e
253	253	0	Albertine Rift Conservation Society	90a939d3-e99c-4f6d-915f-2616423b3735	4bdb4b17-6933-4317-b19b-89a2f1769380
55	55	0	GBIF France	da44cd31-5901-4687-a106-6d1c7734ee3a	4c389c9a-19fb-4b6b-a121-8b359466cd64
270	270	0	Ocean Biodiversity Information System	ba0670b9-4186-41e6-8e70-f9cb3065551a	4d41127b-f5af-4c03-ba74-5c3a3b5627e9
30418	30418	0	GBIF France	da44cd31-5901-4687-a106-6d1c7734ee3a	4d9e1a03-26a9-44da-b207-92cba0881881
32	32	0	Plazi	ffb07bec-2d10-492d-9c37-361fe0b79427	4f9ba87f-e6b0-4f0b-8c55-06c01075dfec
292	292	0	National Biodiversity Network	d897a5b9-35ee-4232-94bd-b0bcaac003c2	4feff147-70bc-46e1-981f-5ac215c77570
38623	38623	0	National Biodiversity Network	d897a5b9-35ee-4232-94bd-b0bcaac003c2	51fd12e4-402a-4271-94f8-9d5727af1cda
0	10	10	Plazi	ffb07bec-2d10-492d-9c37-361fe0b79427	525e48e7-3795-466b-94b1-ba13fef57fab
4316	4316	0	National Biodiversity Network	d897a5b9-35ee-4232-94bd-b0bcaac003c2	52b0f7f3-7d01-4bb9-a602-7656922b53bd
679	679	0	Belgian Biodiversity Platform	fb11cfe1-ebc3-45af-9159-17d9fddbcdac	53a911cf-d038-4f6f-a8a2-1b082a1bc781
14	14	0	Plazi	ffb07bec-2d10-492d-9c37-361fe0b79427	5687fe8c-c610-4663-8d60-b89380b66532
1900	1900	0	Polish Biodiversity Information Network	2618bfdf-e194-4911-a241-80db3107bc51	56db1620-139f-11de-b2de-b8a03c50a862
8	8	0	Plazi	ffb07bec-2d10-492d-9c37-361fe0b79427	59870e66-a888-4d8a-8db8-b133dddfcf96
0	2	2	Plazi	ffb07bec-2d10-492d-9c37-361fe0b79427	5da8e094-1fa4-4a71-98a9-dd79a31c6ca7
0	1	1	Plazi	ffb07bec-2d10-492d-9c37-361fe0b79427	5e576552-f597-4dba-a95b-1532e2f01b7b
0	16	16	Plazi	ffb07bec-2d10-492d-9c37-361fe0b79427	5f641674-ff3f-402a-958a-001031667efc
546	546	0	GBIF Germany	4f6826f2-4ff6-443d-b966-e6913bd24013	60c84057-e3fc-4e8d-a996-8845ef4fb70b
676	676	0	Participant Node Managers Committee	7f48e0c8-5c96-49ec-b972-30748e339115	60ded084-8414-416d-856e-283345c42830
95	95	0	Plazi	ffb07bec-2d10-492d-9c37-361fe0b79427	60fc6c5d-bde4-4e23-b84c-519bc8fefb0e
71	71	0	GBIF Germany	4f6826f2-4ff6-443d-b966-e6913bd24013	61bf44b2-f762-11e1-a439-00145eb45e9a
28	28	0	GBIF Germany	4f6826f2-4ff6-443d-b966-e6913bd24013	61fff6a6-f762-11e1-a439-00145eb45e9a
160	160	0	GBIF Germany	4f6826f2-4ff6-443d-b966-e6913bd24013	62355f44-f762-11e1-a439-00145eb45e9a
0	14	14	Ocean Biodiversity Information System	ba0670b9-4186-41e6-8e70-f9cb3065551a	64107db4-1a18-428b-9790-3aadd5b9deab
510	473	-37	GBIF Germany	4f6826f2-4ff6-443d-b966-e6913bd24013	6564d974-f762-11e1-a439-00145eb45e9a
71	69	-2	GBIF Germany	4f6826f2-4ff6-443d-b966-e6913bd24013	658330e0-f762-11e1-a439-00145eb45e9a
31	31	0	GBIF Germany	4f6826f2-4ff6-443d-b966-e6913bd24013	65902f5c-f762-11e1-a439-00145eb45e9a
350	350	0	Participant Node Managers Committee	7f48e0c8-5c96-49ec-b972-30748e339115	66913c83-3b37-4513-b319-86872fe46d0e
7	7	0	GBIF Germany	4f6826f2-4ff6-443d-b966-e6913bd24013	688393c0-f762-11e1-a439-00145eb45e9a
297	167	-130	GBIF Germany	4f6826f2-4ff6-443d-b966-e6913bd24013	68dda7c0-f762-11e1-a439-00145eb45e9a
104	104	0	GBIF Germany	4f6826f2-4ff6-443d-b966-e6913bd24013	6995ad66-f762-11e1-a439-00145eb45e9a
6	6	0	GBIF Germany	4f6826f2-4ff6-443d-b966-e6913bd24013	6b5cb82e-f762-11e1-a439-00145eb45e9a
23	23	0	U.S. Geological Survey	8618c64a-93e0-4300-b546-7249e5148ed2	6bc8ff15-8517-4704-96fc-b8696377b364
12	12	0	GBIF Germany	4f6826f2-4ff6-443d-b966-e6913bd24013	6bcf2bd4-f762-11e1-a439-00145eb45e9a
0	87	87	Plazi	ffb07bec-2d10-492d-9c37-361fe0b79427	6bfe8d7a-0ff2-4ccd-b2a6-dee315bce197
219	219	0	GBIF Germany	4f6826f2-4ff6-443d-b966-e6913bd24013	6c1003ac-f762-11e1-a439-00145eb45e9a
41	41	0	GBIF Germany	4f6826f2-4ff6-443d-b966-e6913bd24013	6d3b2176-f762-11e1-a439-00145eb45e9a
1	1	0	Plazi	ffb07bec-2d10-492d-9c37-361fe0b79427	6de65293-38cf-4b21-9a93-dacb22d1300d
6	6	0	GBIF Germany	4f6826f2-4ff6-443d-b966-e6913bd24013	6efdc5b8-b1c4-43d2-af66-276fe5010179
57	57	0	GBIF France	da44cd31-5901-4687-a106-6d1c7734ee3a	6f2f4af5-2e5d-4a32-99c4-c84bebf8bcd6
112	112	0	GBIF Germany	4f6826f2-4ff6-443d-b966-e6913bd24013	7058c4ee-f762-11e1-a439-00145eb45e9a
103	103	0	GBIF Germany	4f6826f2-4ff6-443d-b966-e6913bd24013	70f7560e-f762-11e1-a439-00145eb45e9a
60	60	0	GBIF Germany	4f6826f2-4ff6-443d-b966-e6913bd24013	719f0228-f762-11e1-a439-00145eb45e9a
52	52	0	Plazi	ffb07bec-2d10-492d-9c37-361fe0b79427	71f9dd38-f9b3-432d-87d0-f3428ac1f0be
2	2	0	GBIF Germany	4f6826f2-4ff6-443d-b966-e6913bd24013	71fa736a-f762-11e1-a439-00145eb45e9a
5	5	0	GBIF Germany	4f6826f2-4ff6-443d-b966-e6913bd24013	736e1846-f762-11e1-a439-00145eb45e9a
41	41	0	GBIF Germany	4f6826f2-4ff6-443d-b966-e6913bd24013	744ea58c-f762-11e1-a439-00145eb45e9a
4	4	0	Plazi	ffb07bec-2d10-492d-9c37-361fe0b79427	74c0f76d-d747-4bc3-ae4d-15d99a9413c3
3675	3675	0	GBIF Finland	dd514216-5c7c-45f3-910d-797424cb5be6	75d5124d-b545-4309-851c-2f49c9837b18
5165	5165	0	National Biodiversity Network	d897a5b9-35ee-4232-94bd-b0bcaac003c2	76491dee-1e0a-4f2e-a9b5-56682d9fe51d
1	1	0	Plazi	ffb07bec-2d10-492d-9c37-361fe0b79427	77015415-9187-4d0e-bf53-41b1308e4699
797	797	0	GBIF Germany	4f6826f2-4ff6-443d-b966-e6913bd24013	776a4938-f762-11e1-a439-00145eb45e9a
2	2	0	Plazi	ffb07bec-2d10-492d-9c37-361fe0b79427	77798da4-9663-415a-a959-c31e762e76b1
0	239723	239723	GBIF Switzerland	169eb292-376b-4cc6-8e31-9c2c432de0ad	77c244e3-05bc-48a8-b200-8336d9db3ca1
22	22	0	GBIF Germany	4f6826f2-4ff6-443d-b966-e6913bd24013	78465108-f762-11e1-a439-00145eb45e9a
4	4	0	GBIF Germany	4f6826f2-4ff6-443d-b966-e6913bd24013	78888e24-f762-11e1-a439-00145eb45e9a
17	17	0	GBIF Germany	4f6826f2-4ff6-443d-b966-e6913bd24013	78ab77cc-f762-11e1-a439-00145eb45e9a
192	192	0	GBIF Germany	4f6826f2-4ff6-443d-b966-e6913bd24013	78d0646a-f762-11e1-a439-00145eb45e9a
1	1	0	GBIF Germany	4f6826f2-4ff6-443d-b966-e6913bd24013	7a9fe4dc-f762-11e1-a439-00145eb45e9a
0	325	325	Belgian Biodiversity Platform	fb11cfe1-ebc3-45af-9159-17d9fddbcdac	7ac2b32b-44e1-44f0-bd1e-0295d72b9c47
68784	68784	0	Korean Biodiversity Information Facility	e0a1e772-0177-4800-94b4-2d023fe6cdf4	7b095dea-f762-11e1-a439-00145eb45e9a
3182	3183	1	GBIF Germany	4f6826f2-4ff6-443d-b966-e6913bd24013	7b9fcff0-f762-11e1-a439-00145eb45e9a
139	139	0	GBIF Germany	4f6826f2-4ff6-443d-b966-e6913bd24013	7bf3bf52-f762-11e1-a439-00145eb45e9a
4962	4962	0	GBIF Germany	4f6826f2-4ff6-443d-b966-e6913bd24013	7da7c9d8-f762-11e1-a439-00145eb45e9a
12	12	0	Biodiversity Information System of Mexico	b324e8e9-9a4c-44fa-8f1a-7f39ea7ab576	7f9fb41c-f762-11e1-a439-00145eb45e9a
1920	1920	0	Biodiversity Information System of Mexico	b324e8e9-9a4c-44fa-8f1a-7f39ea7ab576	7fc94f48-f762-11e1-a439-00145eb45e9a
0	57	57	Plazi	ffb07bec-2d10-492d-9c37-361fe0b79427	80bbe987-bfc8-47dd-9df1-07ceb17e1029
10789	10789	0	GBIF Spain	1f94b3ca-9345-4d65-afe2-4bace93aa0fe	8119a2da-f762-11e1-a439-00145eb45e9a
1	1	0	Plazi	ffb07bec-2d10-492d-9c37-361fe0b79427	81844621-39b2-4708-855c-9d6d09bea2ee
1840	1840	0	GBIF Germany	4f6826f2-4ff6-443d-b966-e6913bd24013	821f53be-f762-11e1-a439-00145eb45e9a
6	6	0	Korean Biodiversity Information Facility	e0a1e772-0177-4800-94b4-2d023fe6cdf4	83380a34-f762-11e1-a439-00145eb45e9a
0	27	27	Plazi	ffb07bec-2d10-492d-9c37-361fe0b79427	84904a7a-33b5-4ad3-b884-de74dca84ab4
692	293	-399	Biodiversity Information System of Mexico	b324e8e9-9a4c-44fa-8f1a-7f39ea7ab576	856ba999-339c-441c-9fa8-3643294a70ef
9754	9754	0	GBIF Spain	1f94b3ca-9345-4d65-afe2-4bace93aa0fe	85b571c0-f762-11e1-a439-00145eb45e9a
0	981	981	Ocean Biodiversity Information System	ba0670b9-4186-41e6-8e70-f9cb3065551a	86214182-a35a-42a4-b810-6e8a45d3e2a0
182	121	-61	GBIF Germany	4f6826f2-4ff6-443d-b966-e6913bd24013	879b64cc-f762-11e1-a439-00145eb45e9a
17	17	0	GBIF Germany	4f6826f2-4ff6-443d-b966-e6913bd24013	8879208c-f762-11e1-a439-00145eb45e9a
975	975	0	GBIF Germany	4f6826f2-4ff6-443d-b966-e6913bd24013	897fb2c0-f762-11e1-a439-00145eb45e9a
2475	2475	0	GBIF Germany	4f6826f2-4ff6-443d-b966-e6913bd24013	89d55c66-f762-11e1-a439-00145eb45e9a
154	154	0	GBIF Germany	4f6826f2-4ff6-443d-b966-e6913bd24013	8a1656ee-f762-11e1-a439-00145eb45e9a
133	133	0	GBIF Germany	4f6826f2-4ff6-443d-b966-e6913bd24013	8a5d0576-f762-11e1-a439-00145eb45e9a
0	14009	14009	Participant Node Managers Committee	7f48e0c8-5c96-49ec-b972-30748e339115	8aa4f5e1-ab1d-4214-a2d0-8a5aa51432d8
64	64	0	GBIF Germany	4f6826f2-4ff6-443d-b966-e6913bd24013	8bcf06de-f762-11e1-a439-00145eb45e9a
72	72	0	GBIF Germany	4f6826f2-4ff6-443d-b966-e6913bd24013	8d580a5a-f762-11e1-a439-00145eb45e9a
156	63	-93	GBIF Germany	4f6826f2-4ff6-443d-b966-e6913bd24013	8df42e80-f762-11e1-a439-00145eb45e9a
0	2	2	Plazi	ffb07bec-2d10-492d-9c37-361fe0b79427	8eeda02c-1fd6-4807-b12d-966546ffc007
5	5	0	Plazi	ffb07bec-2d10-492d-9c37-361fe0b79427	8eefe71a-a5f9-4f77-9102-eaabecb63cc0
9	9	0	Plazi	ffb07bec-2d10-492d-9c37-361fe0b79427	8f475431-fd20-4445-9ffb-62b57b270a10
90	90	0	GBIF Sweden	a0b3be64-6525-4387-ac67-a499950f92e1	8f533d4c-4e27-460a-96fa-71c9f818726d
88	71	-17	GBIF Germany	4f6826f2-4ff6-443d-b966-e6913bd24013	911776bc-f762-11e1-a439-00145eb45e9a
14	13	-1	GBIF Germany	4f6826f2-4ff6-443d-b966-e6913bd24013	917cfe74-f762-11e1-a439-00145eb45e9a
421	224	-197	GBIF Germany	4f6826f2-4ff6-443d-b966-e6913bd24013	9247d3ba-f762-11e1-a439-00145eb45e9a
1280	1280	0	GBIF Germany	4f6826f2-4ff6-443d-b966-e6913bd24013	94253efc-f762-11e1-a439-00145eb45e9a
0	724	724	Atlas of Living Australia	4a6f1b71-969e-4fc5-a693-282b05e1220c	9431f690-2478-4e27-ad13-843efb77ac79
594	594	0	GBIF Germany	4f6826f2-4ff6-443d-b966-e6913bd24013	943bd590-f762-11e1-a439-00145eb45e9a
0	4	4	Plazi	ffb07bec-2d10-492d-9c37-361fe0b79427	94fd1155-9d46-4569-b4bf-dcdd971c83db
0	3312	3312	Biodiversity Information System of Mexico	b324e8e9-9a4c-44fa-8f1a-7f39ea7ab576	976fe971-654c-4a69-80b6-ca93a3975ede
6	6	0	Plazi	ffb07bec-2d10-492d-9c37-361fe0b79427	97f8e411-1da1-4168-b4cb-ba21ab656ce5
3200	3200	0	Atlas of Living Australia	4a6f1b71-969e-4fc5-a693-282b05e1220c	98a2fca0-4bfe-4d6e-85bc-b50d58891639
1143	1139	-4	Atlas of Living Australia	4a6f1b71-969e-4fc5-a693-282b05e1220c	99baccb4-c358-4abe-b2a7-262a2074157f
1	1	0	Plazi	ffb07bec-2d10-492d-9c37-361fe0b79427	9c2edadf-1c8c-4cd3-8d63-9daf539d98c4
2812	2812	0	Participant Node Managers Committee	7f48e0c8-5c96-49ec-b972-30748e339115	9cabc8a4-884e-45ff-92c2-84d4c9c7d368
89	89	0	GBIF France	da44cd31-5901-4687-a106-6d1c7734ee3a	9ce50398-384e-4d19-8f93-c491a54cba59
2	2	0	Plazi	ffb07bec-2d10-492d-9c37-361fe0b79427	9d83bbcc-f416-4661-bc99-5f5585b87583
0	306	306	Colombian Biodiversity Information System	7e865cba-7c46-417b-ade5-97f2cf5b7be0	9e91f45a-35b7-429e-ae46-20457acf6527
0	14	14	Plazi	ffb07bec-2d10-492d-9c37-361fe0b79427	a0e1aef2-1a85-4ae6-9132-e1c7e1c93616
205	205	0	National Biodiversity Network	d897a5b9-35ee-4232-94bd-b0bcaac003c2	a223cea4-1a87-41d9-a876-19b5d8e80510
0	2	2	Plazi	ffb07bec-2d10-492d-9c37-361fe0b79427	a5c421db-9d17-4a25-9431-378a79f940bc
15	15	0	Plazi	ffb07bec-2d10-492d-9c37-361fe0b79427	a6efb27e-a61f-4900-9425-b94fd9948169
0	12	12	Plazi	ffb07bec-2d10-492d-9c37-361fe0b79427	a734f1af-0349-48df-b987-90c4aba47fe4
0	16	16	Plazi	ffb07bec-2d10-492d-9c37-361fe0b79427	a76e8b32-f6d1-44f5-9ffa-1f31fc22384c
2	2	0	Plazi	ffb07bec-2d10-492d-9c37-361fe0b79427	a7ca403f-6a41-4485-b224-afe6eccb8c02
4	4	0	Plazi	ffb07bec-2d10-492d-9c37-361fe0b79427	abf776d2-0a07-42fe-b02d-a2c049b360f2
858	858	0	GBIF France	da44cd31-5901-4687-a106-6d1c7734ee3a	ad0579fd-d32b-4e3b-a13f-787051f19bfe
389	389	0	Belgian Biodiversity Platform	fb11cfe1-ebc3-45af-9159-17d9fddbcdac	addf4056-698b-4d66-881f-525e51342359
8892	8892	0	GBIF Portugal	673f7038-4262-4149-b753-5658a4e912f6	aeee38d0-b290-4155-ae4b-b02a42b93e35
33	33	0	GBIF Kenya	2a44d626-9f7a-4120-8a7a-4ab5ac15ff2a	af2ec1c4-9bcd-44cf-8be7-402f08279248
3863	3863	0	National Biodiversity Network	d897a5b9-35ee-4232-94bd-b0bcaac003c2	b2371835-ea93-4475-b0f9-e5274147863b
0	3447	3447	GBIF Japan	db5705aa-6a6e-42f1-8942-d77b9f4896ea	b2c5da65-f44f-448d-911d-845ef79a2de9
3	3	0	Plazi	ffb07bec-2d10-492d-9c37-361fe0b79427	b2d3dcb1-99c9-49bc-b1c7-4df142fd8249
8	8	0	Plazi	ffb07bec-2d10-492d-9c37-361fe0b79427	b3aeb765-a3b2-40f4-bee9-8501781bead8
440	440	0	GBIF France	da44cd31-5901-4687-a106-6d1c7734ee3a	b65a54f9-c256-481f-b4a8-b7673291150c
319	319	0	GBIF France	da44cd31-5901-4687-a106-6d1c7734ee3a	b76f53f9-b934-4185-ac5a-e66dc7c766a8
16	16	0	Plazi	ffb07bec-2d10-492d-9c37-361fe0b79427	bd967b46-4846-4ecd-b3f9-052d2cb76060
66	66	0	GBIF France	da44cd31-5901-4687-a106-6d1c7734ee3a	bf4e903b-1b9e-485f-b777-5d10f660b548
3565	3565	0	GBIF Germany	4f6826f2-4ff6-443d-b966-e6913bd24013	c1aaedc7-b5ba-4baf-9112-ec70637e242e
271	271	0	GBIF Malawi	2a42e4d7-ad4a-41b3-84c4-de4aa7b74d35	c1ae1c90-d21e-49d9-b5a8-6605c07c8364
2	2	0	Plazi	ffb07bec-2d10-492d-9c37-361fe0b79427	c1d3a5fe-3139-4e2a-9c5d-caacd6ddbce2
2	2	0	Plazi	ffb07bec-2d10-492d-9c37-361fe0b79427	c2abe59c-39ee-449f-9585-ede35c9f91fd
0	61	61	Plazi	ffb07bec-2d10-492d-9c37-361fe0b79427	c6b93219-bd58-4cda-8fae-1245772fc92f
408	408	0	GBIF France	da44cd31-5901-4687-a106-6d1c7734ee3a	ca8c4575-a763-4271-9376-c962981d402a
9	9	0	Plazi	ffb07bec-2d10-492d-9c37-361fe0b79427	cde52bbb-e1d8-458a-b247-efe42f9e58ab
170543	170543	0	National Biodiversity Network	d897a5b9-35ee-4232-94bd-b0bcaac003c2	d03f444a-7192-4fa0-bf7a-63714585c611
847	847	0	GBIF Norway	4f829580-180d-46a9-9c87-ed8ec959b545	d27fd37e-a619-4326-b294-b3661bee57fe
5314	5314	0	GBIF Brazil	cdc9736d-5ff7-4ece-9959-3c744360cdb3	d2f80269-9c4d-4689-b8a9-511c613d7681
29	29	0	Plazi	ffb07bec-2d10-492d-9c37-361fe0b79427	d5b314e8-8740-4134-b113-03bfa693b3c0
0	5	5	Plazi	ffb07bec-2d10-492d-9c37-361fe0b79427	d7bfba7c-daea-4461-ae00-ede681196007
250	250	0	Plazi	ffb07bec-2d10-492d-9c37-361fe0b79427	d7f9c4a0-1ea7-4172-8cb3-a1b7039ad456
0	146	146	Plazi	ffb07bec-2d10-492d-9c37-361fe0b79427	da216df7-8367-4c95-9678-f89e694af9b2
0	3	3	Plazi	ffb07bec-2d10-492d-9c37-361fe0b79427	de5031ea-8a92-47ca-8bec-a4a3e433d95a
943	943	0	GBIF France	da44cd31-5901-4687-a106-6d1c7734ee3a	de69ada8-b46c-48c9-91ef-6171aa9b0b77
13	13	0	Plazi	ffb07bec-2d10-492d-9c37-361fe0b79427	de87eb6f-f4eb-46af-8e43-95ca6ab2b672
88	88	0	Plazi	ffb07bec-2d10-492d-9c37-361fe0b79427	dee7da9c-56a6-4be0-8cc4-3c907d8e1a0f
3	3	0	GBIF Germany	4f6826f2-4ff6-443d-b966-e6913bd24013	e26918bf-d44b-4e60-be04-167760b28cf4
7	7	0	Plazi	ffb07bec-2d10-492d-9c37-361fe0b79427	eb140ec7-9d9f-459e-ab58-ce247df51ea1
0	339	339	Plazi	ffb07bec-2d10-492d-9c37-361fe0b79427	eb597d59-1f6e-412d-a99a-de1a67e7cc94
39	39	0	GBIF France	da44cd31-5901-4687-a106-6d1c7734ee3a	ee74c011-1f32-4ac3-b900-a949e9ee9f40
3	3	0	Plazi	ffb07bec-2d10-492d-9c37-361fe0b79427	f0a1c949-3b2a-4dc5-a130-07c5fa649679
0	2151	2151	Participant Node Managers Committee	7f48e0c8-5c96-49ec-b972-30748e339115	f102fdf5-5fd2-4895-889a-5a046783dfba
79	79	0	U.S. Geological Survey	8618c64a-93e0-4300-b546-7249e5148ed2	f1d97c8a-b88f-4c44-a381-b55ca10c469f
1	1	0	Plazi	ffb07bec-2d10-492d-9c37-361fe0b79427	f2ff99d3-58f6-4d7c-9157-0e016f5e3772
310556	310556	0	U.S. Geological Survey	8618c64a-93e0-4300-b546-7249e5148ed2	f31212ae-87f5-45e3-8c03-87a0cc5cb86f
7367	7813	446	U.S. Geological Survey	8618c64a-93e0-4300-b546-7249e5148ed2	f3ca3b02-8e8b-4909-9628-abbe50cd44f1
0	510	510	Korean Biodiversity Information Facility	e0a1e772-0177-4800-94b4-2d023fe6cdf4	f4004b04-bdcb-467f-9bbf-878b736a72ce
6	6	0	Plazi	ffb07bec-2d10-492d-9c37-361fe0b79427	f88efb22-2147-4792-9c9e-d50e1e7d8ced
187	187	0	Plazi	ffb07bec-2d10-492d-9c37-361fe0b79427	f8b7d63c-0872-4cf0-ae31-58f6bfaaa6f0
0	20	20	GBIF Japan	db5705aa-6a6e-42f1-8942-d77b9f4896ea	fa921623-d899-4013-9d9c-07deb9d3535a
16493	16844	351	Symbiota Support Hub	612b5a0b-908b-4b4e-b9bf-ca15dfdc94fa	faf9bd60-071c-4ed4-8705-faa17e645f60
0	1	1	Plazi	ffb07bec-2d10-492d-9c37-361fe0b79427	ff847ede-0e20-4ca8-a7e6-654426712ff5
0	2920	2920	Participant Node Managers Committee	7f48e0c8-5c96-49ec-b972-30748e339115	ff8ebaf8-a7b4-4911-ab5f-d0ebf3221e66
42	42	0	Plazi	ffb07bec-2d10-492d-9c37-361fe0b79427	00adaef8-991b-47aa-9c33-12e2d46a5258
0	5	5	Plazi	ffb07bec-2d10-492d-9c37-361fe0b79427	08feafa7-d493-476f-b92e-493ac9f31a3e
0	25	25	Plazi	ffb07bec-2d10-492d-9c37-361fe0b79427	09aa0e00-2e1f-43aa-914b-98704bd39db7
1332	1332	0	GBIF France	da44cd31-5901-4687-a106-6d1c7734ee3a	0a97d349-e05a-4b24-947c-a6dfd2f588fb
1188	1188	0	Biodiversity Information System of Mexico	b324e8e9-9a4c-44fa-8f1a-7f39ea7ab576	0aeaa61d-92da-46c7-bd30-c4c7504f7aaa
71	71	0	Plazi	ffb07bec-2d10-492d-9c37-361fe0b79427	0e932262-6e5a-477c-ad0f-32c1feb84725
0	14	14	Plazi	ffb07bec-2d10-492d-9c37-361fe0b79427	12d0f5e4-e2b0-4146-9055-90e3eca9c36f
9726	9726	0	U.S. Geological Survey	8618c64a-93e0-4300-b546-7249e5148ed2	1435780a-33e0-478b-95b4-1d390ae0ec27
0	1	1	Plazi	ffb07bec-2d10-492d-9c37-361fe0b79427	143a6bdc-3b06-483e-a0cc-fd2259e48583
0	299797	299797	GBIF Estonia	2c11b821-d22b-4c64-8cd3-c1578173b129	1af83152-24f7-4df7-afbc-b213b62175bb
0	1	1	Plazi	ffb07bec-2d10-492d-9c37-361fe0b79427	1c6814a5-25ec-45db-a0c5-5d5252d164f6
2647	2647	0	National Biodiversity Network	d897a5b9-35ee-4232-94bd-b0bcaac003c2	1ca4f2c1-b4ec-4626-b6c0-2dd1a5dd32c9
0	12	12	Plazi	ffb07bec-2d10-492d-9c37-361fe0b79427	1e432211-1133-49c7-88a7-7392fac996ba
0	927	927	Colombian Biodiversity Information System	7e865cba-7c46-417b-ade5-97f2cf5b7be0	1e481eb6-13cf-48cf-994c-3815d4bf9812
2385	2385	0	National Biodiversity Network	d897a5b9-35ee-4232-94bd-b0bcaac003c2	1f1a3d98-e3da-4cf4-b577-b808265f8518
1582	837	-745	GBIF Germany	4f6826f2-4ff6-443d-b966-e6913bd24013	1f48cc53-728e-4099-afb3-9e967ddc6018
131	131	0	GBIF France	da44cd31-5901-4687-a106-6d1c7734ee3a	2517480a-8dc6-46f0-9f22-241c77e1e871
2164	2164	0	Tanzania Biodiversity Information Facility	abd95ca6-3959-4db9-aaa6-2de1aeecf514	253fa82c-65ec-4f92-8892-c54b864dfd68
8737	8737	0	Colombian Biodiversity Information System	7e865cba-7c46-417b-ade5-97f2cf5b7be0	2618e878-7e19-412d-99e3-f12a8aa23ebb
78	78	0	GBIF Germany	4f6826f2-4ff6-443d-b966-e6913bd24013	26826f72-6fed-4b8f-94d5-6201f2dfab5b
41	41	0	GBIF France	da44cd31-5901-4687-a106-6d1c7734ee3a	2747a081-2994-409d-963f-a746af097c3c
0	9	9	Plazi	ffb07bec-2d10-492d-9c37-361fe0b79427	287a3f15-b20c-453b-afd9-4469d5095c6c
0	13	13	Plazi	ffb07bec-2d10-492d-9c37-361fe0b79427	296004ab-b3b6-4c5e-b107-ec5cf247cd10
0	12	12	Plazi	ffb07bec-2d10-492d-9c37-361fe0b79427	2b9a8854-3b3a-40cd-a965-743b5d6ee23b
0	3	3	Ocean Biodiversity Information System	ba0670b9-4186-41e6-8e70-f9cb3065551a	32a32019-9e25-404e-bba4-39aa940c4562
9	9	0	Plazi	ffb07bec-2d10-492d-9c37-361fe0b79427	32f9324a-cfcc-4398-a7f6-b81474b86d3f
2113	2113	0	GBIF France	da44cd31-5901-4687-a106-6d1c7734ee3a	33b57a5a-64eb-4f5f-8d0f-e8c5f82f9cc7
5	5	0	Plazi	ffb07bec-2d10-492d-9c37-361fe0b79427	34356318-6cff-4456-9a65-49c67923e883
0	63	63	Plazi	ffb07bec-2d10-492d-9c37-361fe0b79427	34c6b1ec-569d-499a-a622-63d2e6d018e8
0	2	2	Plazi	ffb07bec-2d10-492d-9c37-361fe0b79427	370a394a-9b2c-4861-be5b-ef4a85083cca
3	3	0	Plazi	ffb07bec-2d10-492d-9c37-361fe0b79427	3771b659-9048-4961-99b7-a790dcb015a4
662	662	0	National Biodiversity Network	d897a5b9-35ee-4232-94bd-b0bcaac003c2	385408bb-31f6-4251-bec3-a40a52c9dfe3
79326282	82017124	2690842	GBIF Sweden	a0b3be64-6525-4387-ac67-a499950f92e1	38b4c89f-584c-41bb-bd8f-cd1def33e92f
128562	128562	0	GBIF Brazil	cdc9736d-5ff7-4ece-9959-3c744360cdb3	3cb7fc60-aa95-4556-b987-b7f6f593b9a1
4	4	0	Plazi	ffb07bec-2d10-492d-9c37-361fe0b79427	3e6a5017-74ae-4bb5-8c16-1370aee20a63
80	80	0	Plazi	ffb07bec-2d10-492d-9c37-361fe0b79427	439171d3-3406-4ede-bc8a-ac388e13a9c2
0	2	2	Plazi	ffb07bec-2d10-492d-9c37-361fe0b79427	451b57f5-9c6a-4981-b898-aa91c054b69d
12	12	0	Plazi	ffb07bec-2d10-492d-9c37-361fe0b79427	4b11dc94-fb10-4c84-b1a7-5f51be1d0869
0	3	3	Plazi	ffb07bec-2d10-492d-9c37-361fe0b79427	4b3c4e71-8837-418e-ae63-171c3db043d7
42	42	0	GBIF Argentina	2426a871-9feb-40a1-96c6-0c593a76b835	4c992c6f-4a3f-4408-9fa1-1d01ef49fa1d
443	443	0	U.S. Geological Survey	8618c64a-93e0-4300-b546-7249e5148ed2	4fa43229-ab7a-4bae-a760-12460a37f5c6
2352	2352	0	GBIF Germany	4f6826f2-4ff6-443d-b966-e6913bd24013	543b8dec-fa96-4dee-8171-e07aadf22ac8
2	2	0	Plazi	ffb07bec-2d10-492d-9c37-361fe0b79427	54fad0b6-730b-4cab-928c-1ef8f7a8c0ac
165	327	162	Colombian Biodiversity Information System	7e865cba-7c46-417b-ade5-97f2cf5b7be0	553a786d-3354-455f-ad30-61e148d2e9fd
3	3	0	GBIF Argentina	2426a871-9feb-40a1-96c6-0c593a76b835	5641846c-867f-47ec-a832-439c026a7974
0	1	1	Plazi	ffb07bec-2d10-492d-9c37-361fe0b79427	58096fca-5024-46c5-b5da-bbddbc5bd573
0	43	43	Plazi	ffb07bec-2d10-492d-9c37-361fe0b79427	581c83b8-3eab-46b4-845f-b2aba4fbf138
2258	2258	0	Colombian Biodiversity Information System	7e865cba-7c46-417b-ade5-97f2cf5b7be0	5980f768-4730-4688-bcb7-f5ee256bd560
245	245	0	Plazi	ffb07bec-2d10-492d-9c37-361fe0b79427	59fc10fe-e8c3-4537-abb9-049fbda4c7ed
3707	3707	0	South African Biodiversity Information Facility	7190b835-4e86-4b6e-85c1-19cc6677c250	5da288d0-94ca-4355-a438-11890b726f5b
19	19	0	Plazi	ffb07bec-2d10-492d-9c37-361fe0b79427	5dcff406-a135-4ba0-bac3-d56b4f629887
0	17	17	Plazi	ffb07bec-2d10-492d-9c37-361fe0b79427	5e2a7f4b-d1ec-46ad-8bc6-45511785f89e
1456	1456	0	GBIF Germany	4f6826f2-4ff6-443d-b966-e6913bd24013	5f6b4d9b-0e6a-4626-b6fd-93d564ecf595
56	56	0	GBIF Germany	4f6826f2-4ff6-443d-b966-e6913bd24013	618bd38e-f762-11e1-a439-00145eb45e9a
23	23	0	GBIF Germany	4f6826f2-4ff6-443d-b966-e6913bd24013	62f8496e-f762-11e1-a439-00145eb45e9a
1517	1517	0	GBIF France	da44cd31-5901-4687-a106-6d1c7734ee3a	64506744-f343-44cb-bb14-1fbe6610b22b
12930	12930	0	National Biodiversity Network	d897a5b9-35ee-4232-94bd-b0bcaac003c2	659f15cf-2cca-4f5d-bfc1-3d3be74251f1
275	268	-7	GBIF Germany	4f6826f2-4ff6-443d-b966-e6913bd24013	65eb4b94-f762-11e1-a439-00145eb45e9a
0	1	1	Plazi	ffb07bec-2d10-492d-9c37-361fe0b79427	674f11ca-ded8-46d7-ab68-799e4256d475
135	135	0	GBIF Germany	4f6826f2-4ff6-443d-b966-e6913bd24013	67529122-f762-11e1-a439-00145eb45e9a
802	802	0	South African Biodiversity Information Facility	7190b835-4e86-4b6e-85c1-19cc6677c250	67f6db6f-6df3-4373-b119-b9758ab7d93d
150	150	0	GBIF Germany	4f6826f2-4ff6-443d-b966-e6913bd24013	683aaf48-f762-11e1-a439-00145eb45e9a
358	238	-120	GBIF Germany	4f6826f2-4ff6-443d-b966-e6913bd24013	694a77e2-f762-11e1-a439-00145eb45e9a
23328	23328	0	GBIF Japan	db5705aa-6a6e-42f1-8942-d77b9f4896ea	69acd8f2-7a20-4dbe-bf84-8b607304529d
5	5	0	Plazi	ffb07bec-2d10-492d-9c37-361fe0b79427	6a470746-0423-4a36-8c23-e1961db220c6
4	4	0	GBIF Germany	4f6826f2-4ff6-443d-b966-e6913bd24013	6b50b790-f762-11e1-a439-00145eb45e9a
0	24	24	Plazi	ffb07bec-2d10-492d-9c37-361fe0b79427	6dc2872d-cbab-4982-baed-c0969e3e3236
0	5	5	U.S. Geological Survey	8618c64a-93e0-4300-b546-7249e5148ed2	6df42303-d421-4a4c-98da-4e17bc11f7ab
0	5	5	Plazi	ffb07bec-2d10-492d-9c37-361fe0b79427	6e673574-f555-4f1b-8e56-a809669021fd
17427	17633	206	U.S. Geological Survey	8618c64a-93e0-4300-b546-7249e5148ed2	6ec3c7f5-6233-48f6-b36a-06b867edbadd
44	44	0	GBIF Argentina	2426a871-9feb-40a1-96c6-0c593a76b835	70180c9b-3887-4fcd-8b53-ac1c4bc47ba4
0	2557	2557	GBIF Finland	dd514216-5c7c-45f3-910d-797424cb5be6	7027c22a-dca9-49db-8f5a-93c3ccc6072b
0	527	527	Ocean Biodiversity Information System	ba0670b9-4186-41e6-8e70-f9cb3065551a	7156f425-5489-4b79-a864-c6dcbeaa4e9e
4074	4074	0	GBIF Germany	4f6826f2-4ff6-443d-b966-e6913bd24013	721f6224-f762-11e1-a439-00145eb45e9a
80	80	0	GBIF Germany	4f6826f2-4ff6-443d-b966-e6913bd24013	723d519e-f762-11e1-a439-00145eb45e9a
108	108	0	GBIF Germany	4f6826f2-4ff6-443d-b966-e6913bd24013	74e4b5b8-f762-11e1-a439-00145eb45e9a
194	194	0	GBIF France	da44cd31-5901-4687-a106-6d1c7734ee3a	78227a90-248a-4981-84ec-9b8867de949d
116	116	0	Plazi	ffb07bec-2d10-492d-9c37-361fe0b79427	78caac28-67ae-4fdf-9142-595adc991ccb
1723	1723	0	GBIF Germany	4f6826f2-4ff6-443d-b966-e6913bd24013	79398d6e-f762-11e1-a439-00145eb45e9a
567	567	0	GBIF Germany	4f6826f2-4ff6-443d-b966-e6913bd24013	79f3074e-f762-11e1-a439-00145eb45e9a
0	14	14	Ocean Biodiversity Information System	ba0670b9-4186-41e6-8e70-f9cb3065551a	7a0c187e-cbf0-4d47-b409-fa4e1994b682
0	16705	16705	GBIF Germany	4f6826f2-4ff6-443d-b966-e6913bd24013	7a507da7-d00a-4645-ae1a-cd9c2fb5aaa7
27	27	0	GBIF Germany	4f6826f2-4ff6-443d-b966-e6913bd24013	7a8e1086-f762-11e1-a439-00145eb45e9a
115	115	0	Ocean Biodiversity Information System	ba0670b9-4186-41e6-8e70-f9cb3065551a	7b58c736-f762-11e1-a439-00145eb45e9a
4135	4135	0	GBIF Norway	4f829580-180d-46a9-9c87-ed8ec959b545	7ccdcbd6-e559-4c71-ac50-59275ef592f3
600	600	0	Ocean Biodiversity Information System	ba0670b9-4186-41e6-8e70-f9cb3065551a	7d264665-b3db-43b1-bdf6-04ec97819d9c
1844	1844	0	GBIF Germany	4f6826f2-4ff6-443d-b966-e6913bd24013	7d8d17b4-f762-11e1-a439-00145eb45e9a
28	28	0	U.S. Geological Survey	8618c64a-93e0-4300-b546-7249e5148ed2	7f2de377-9f9f-4276-b0b8-5c792b499223
181	181	0	Ocean Biodiversity Information System	ba0670b9-4186-41e6-8e70-f9cb3065551a	7f611dcc-fe4f-4519-82bc-3e07166017d6
869	869	0	GBIF France	da44cd31-5901-4687-a106-6d1c7734ee3a	7fc2cc5f-91a9-4182-977e-8d5d542070bf
565	565	0	Biodiversity Information System of Mexico	b324e8e9-9a4c-44fa-8f1a-7f39ea7ab576	7fc2fb2a-f762-11e1-a439-00145eb45e9a
387	387	0	Biodiversity Information System of Mexico	b324e8e9-9a4c-44fa-8f1a-7f39ea7ab576	8065b662-f762-11e1-a439-00145eb45e9a
16522	16522	0	GBIF Japan	db5705aa-6a6e-42f1-8942-d77b9f4896ea	81287cb0-f762-11e1-a439-00145eb45e9a
94	94	0	GBIF Norway	4f829580-180d-46a9-9c87-ed8ec959b545	819b724f-d32a-48ac-a62a-9a3425b9b0a0
36	36	0	GBIF Germany	4f6826f2-4ff6-443d-b966-e6913bd24013	81beed9e-f762-11e1-a439-00145eb45e9a
704	704	0	GBIF Germany	4f6826f2-4ff6-443d-b966-e6913bd24013	81c7a754-f762-11e1-a439-00145eb45e9a
1281	1281	0	GBIF Germany	4f6826f2-4ff6-443d-b966-e6913bd24013	81fe5862-f762-11e1-a439-00145eb45e9a
844	796	-48	GBIF Germany	4f6826f2-4ff6-443d-b966-e6913bd24013	820235e0-f762-11e1-a439-00145eb45e9a
134	134	0	GBIF France	da44cd31-5901-4687-a106-6d1c7734ee3a	828d744e-5746-4f7a-8eb1-11107c3ab036
60163	60163	0	GBIF Spain	1f94b3ca-9345-4d65-afe2-4bace93aa0fe	835852b2-f762-11e1-a439-00145eb45e9a
531	531	0	GBIF Germany	4f6826f2-4ff6-443d-b966-e6913bd24013	83db17cd-68e7-4a4a-bea0-eff4a50fd3b7
21243	22047	804	GBIF Japan	db5705aa-6a6e-42f1-8942-d77b9f4896ea	8490a652-f762-11e1-a439-00145eb45e9a
38049	38049	0	Biodiversity Information System of Mexico	b324e8e9-9a4c-44fa-8f1a-7f39ea7ab576	84faa3a4-f762-11e1-a439-00145eb45e9a
4	4	0	GBIF Germany	4f6826f2-4ff6-443d-b966-e6913bd24013	85aa6efd-48e3-4d90-9531-13dd1b0e69d6
24630	24630	0	National Biodiversity Network	d897a5b9-35ee-4232-94bd-b0bcaac003c2	85e64601-1c72-46dc-ba4b-6b8e409dee15
1	1	0	GBIF France	da44cd31-5901-4687-a106-6d1c7734ee3a	85f5d6e1-4271-4104-bd50-5ef55e97070a
62125	62125	0	U.S. Geological Survey	8618c64a-93e0-4300-b546-7249e5148ed2	8631295a-f762-11e1-a439-00145eb45e9a
200	100	-100	GBIF Germany	4f6826f2-4ff6-443d-b966-e6913bd24013	88cb411e-f762-11e1-a439-00145eb45e9a
0	384	384	GBIF Portugal	673f7038-4262-4149-b753-5658a4e912f6	891df84a-96d6-44ea-bab0-6471d51acff0
45	45	0	GBIF Germany	4f6826f2-4ff6-443d-b966-e6913bd24013	89780480-f762-11e1-a439-00145eb45e9a
131	131	0	GBIF Germany	4f6826f2-4ff6-443d-b966-e6913bd24013	8a433a9c-f762-11e1-a439-00145eb45e9a
13	13	0	GBIF Germany	4f6826f2-4ff6-443d-b966-e6913bd24013	8d1acb86-f762-11e1-a439-00145eb45e9a
50	27	-23	GBIF Germany	4f6826f2-4ff6-443d-b966-e6913bd24013	8d3a3282-f762-11e1-a439-00145eb45e9a
5	3	-2	GBIF Germany	4f6826f2-4ff6-443d-b966-e6913bd24013	8d600e62-f762-11e1-a439-00145eb45e9a
468	252	-216	GBIF Germany	4f6826f2-4ff6-443d-b966-e6913bd24013	8d8c7bc8-f762-11e1-a439-00145eb45e9a
33	17	-16	GBIF Germany	4f6826f2-4ff6-443d-b966-e6913bd24013	8e5245e2-f762-11e1-a439-00145eb45e9a
48387	48387	0	Belgian Biodiversity Platform	fb11cfe1-ebc3-45af-9159-17d9fddbcdac	8f1960d0-6d5f-11df-8b7f-b8a03c50a862
789	789	0	Plazi	ffb07bec-2d10-492d-9c37-361fe0b79427	91c2f25f-409c-4319-bc7c-feb9e4210de1
521	313	-208	GBIF Germany	4f6826f2-4ff6-443d-b966-e6913bd24013	91c43c12-f762-11e1-a439-00145eb45e9a
0	84	84	Participant Node Managers Committee	7f48e0c8-5c96-49ec-b972-30748e339115	91eccba9-8801-42df-83aa-217f2bb89503
52	40	-12	GBIF Germany	4f6826f2-4ff6-443d-b966-e6913bd24013	92fbc4e2-f762-11e1-a439-00145eb45e9a
966	368	-598	GBIF Germany	4f6826f2-4ff6-443d-b966-e6913bd24013	935b5e5c-f762-11e1-a439-00145eb45e9a
59828	59828	0	Polish Biodiversity Information Network	2618bfdf-e194-4911-a241-80db3107bc51	9368f520-0e2d-11de-b8e6-b8a03c50a862
703	703	0	GBIF Germany	4f6826f2-4ff6-443d-b966-e6913bd24013	949efaee-f762-11e1-a439-00145eb45e9a
169	169	0	Atlas of Living Australia	4a6f1b71-969e-4fc5-a693-282b05e1220c	965046a4-f762-11e1-a439-00145eb45e9a
2075	2075	0	Colombian Biodiversity Information System	7e865cba-7c46-417b-ade5-97f2cf5b7be0	969597cd-473c-4d18-90e8-d11b5c107d0a
227	227	0	GBIF Germany	4f6826f2-4ff6-443d-b966-e6913bd24013	978fee52-f762-11e1-a439-00145eb45e9a
149	149	0	GBIF Germany	4f6826f2-4ff6-443d-b966-e6913bd24013	97d37147-d32d-45bc-b83b-6be3559bd489
0	4	4	Plazi	ffb07bec-2d10-492d-9c37-361fe0b79427	99fe7a09-63bf-48ef-bc2a-5aa05f8f43fa
22542	22542	0	Colombian Biodiversity Information System	7e865cba-7c46-417b-ade5-97f2cf5b7be0	9c2d26f1-0ce0-4cde-9f8d-de8284404fff
16	16	0	Plazi	ffb07bec-2d10-492d-9c37-361fe0b79427	9db4515c-7f05-4cd4-b281-7b45861fe49c
0	141	141	Ocean Biodiversity Information System	ba0670b9-4186-41e6-8e70-f9cb3065551a	9e756986-cbdf-45a6-ba55-db12f0ba6a7a
3635	3634	-1	National Biodiversity Network	d897a5b9-35ee-4232-94bd-b0bcaac003c2	9ebeccc1-895b-4751-9c56-90f646b8b303
4	4	0	Plazi	ffb07bec-2d10-492d-9c37-361fe0b79427	9ff07594-f512-43b2-b64d-1605ac58f115
15	15	0	GBIF France	da44cd31-5901-4687-a106-6d1c7734ee3a	a55e16c7-6722-42c5-9d9a-d3b0a24a3396
143	143	0	GBIF Madagascar	2dbfc5c5-51b5-4494-9dfc-4d3f013a3b64	aa1df177-e42c-4313-b50c-ddda2422e193
8	8	0	Participant Node Managers Committee	7f48e0c8-5c96-49ec-b972-30748e339115	aa75de79-4c0a-42ad-a0d0-61556df0d88c
0	34	34	Plazi	ffb07bec-2d10-492d-9c37-361fe0b79427	aac9870a-74e2-43f7-9ba0-45a193255ec6
5	5	0	Plazi	ffb07bec-2d10-492d-9c37-361fe0b79427	ab9b5bbb-4f34-41c7-8465-672e93791aae
1320	1320	0	Participant Node Managers Committee	7f48e0c8-5c96-49ec-b972-30748e339115	b0694431-3b93-4bdc-ab1f-f109ea43fcc0
0	3	3	Plazi	ffb07bec-2d10-492d-9c37-361fe0b79427	b249e8ed-a79d-4a90-9358-29cdf69b9ba3
86769	103033	16264	National Biodiversity Network	d897a5b9-35ee-4232-94bd-b0bcaac003c2	b4c0c858-f6f3-415f-aec1-f7e3534a8126
2839	10967	8128	National Biodiversity Data Centre	422b00b2-6c94-4bb6-976b-c359916efdb8	b6f1a044-45b1-4a06-9b1c-90b0a733a4a2
0	177	177	Colombian Biodiversity Information System	7e865cba-7c46-417b-ade5-97f2cf5b7be0	baadf36b-2462-482c-b837-d367b9b9a3f4
5160	4620	-540	GBIF Germany	4f6826f2-4ff6-443d-b966-e6913bd24013	bc88ae05-880c-4e2b-832a-2a596386369e
6768	6768	0	Colombian Biodiversity Information System	7e865cba-7c46-417b-ade5-97f2cf5b7be0	bd910e78-7a69-44ac-9450-65bf41329604
25	25	0	GBIF Kenya	2a44d626-9f7a-4120-8a7a-4ab5ac15ff2a	bfb68d69-27a4-4c13-bb46-21ad71801d57
2	2	0	Plazi	ffb07bec-2d10-492d-9c37-361fe0b79427	c4810e59-8b78-4bfa-a29d-d997acde629e
0	1069323	1069323	GBIF Japan	db5705aa-6a6e-42f1-8942-d77b9f4896ea	c7399c30-eeda-4424-8194-dba370ea380c
119	119	0	GBIF France	da44cd31-5901-4687-a106-6d1c7734ee3a	cbe7e37b-3905-4479-9c89-de4eb6ece0bf
5	5	0	Plazi	ffb07bec-2d10-492d-9c37-361fe0b79427	cf6915d2-9ccf-4086-b003-bf98af07aec3
637	637	0	GBIF Germany	4f6826f2-4ff6-443d-b966-e6913bd24013	d02fd431-87f6-42ff-a6ca-0c1fcd47b5c2
10	10	0	Participant Node Managers Committee	7f48e0c8-5c96-49ec-b972-30748e339115	d06ccbfc-f131-44d7-a1f1-f7cfae09b267
1896	4111	2215	U.S. Geological Survey	8618c64a-93e0-4300-b546-7249e5148ed2	d1229774-8f05-4aa6-973f-1d7b6bd96948
13000	13000	0	GBIF France	da44cd31-5901-4687-a106-6d1c7734ee3a	d3c56ecd-a0e2-4659-aa1e-cf3592ba551f
0	9	9	Plazi	ffb07bec-2d10-492d-9c37-361fe0b79427	d423429a-696f-4bce-b65e-7cbbdf9e87ab
18	18	0	Plazi	ffb07bec-2d10-492d-9c37-361fe0b79427	d48aecc5-2a44-491e-802f-4556f052a7a7
0	30	30	Scientific Committee on Antarctic Research	51e4e8ff-bff0-4996-8b27-9107d61b3478	d5010a6c-152b-4565-b799-cc8eb0e7a77b
769	769	0	Costa Rica Biodiversity Facility	3379bb09-1a58-41e7-9c57-e3b66c3eb5a0	d5ccc1d6-b154-45a8-b0d5-1c772266d323
0	18	18	Plazi	ffb07bec-2d10-492d-9c37-361fe0b79427	db9cba5a-5cbb-426f-a6d3-bbe332465546
320	320	0	National Biodiversity Network	d897a5b9-35ee-4232-94bd-b0bcaac003c2	de3cd1eb-1ec1-4e95-b9f8-ec2fc13f51cf
102	102	0	GBIF France	da44cd31-5901-4687-a106-6d1c7734ee3a	df33407e-771d-40f5-b3a2-fa0859a7e051
0	4	4	Plazi	ffb07bec-2d10-492d-9c37-361fe0b79427	e01cc40a-5281-4611-8775-13c9f91b57d7
18	18	0	Plazi	ffb07bec-2d10-492d-9c37-361fe0b79427	e0de689b-1b48-44ea-bf12-1fe0ac10c4f1
1	1	0	Plazi	ffb07bec-2d10-492d-9c37-361fe0b79427	e4df1db0-3e0e-430b-86f9-04db2cb9b163
0	3	3	Plazi	ffb07bec-2d10-492d-9c37-361fe0b79427	e62b6c2f-8642-4a9a-8330-22bb3a6618f0
214	214	0	Colombian Biodiversity Information System	7e865cba-7c46-417b-ade5-97f2cf5b7be0	e68d55fc-7b81-45ee-9594-dd78ec57d9a9
0	17469	17469	Participant Node Managers Committee	7f48e0c8-5c96-49ec-b972-30748e339115	e6a27867-de78-45bc-a1cf-af04675038c0
33	33	0	Plazi	ffb07bec-2d10-492d-9c37-361fe0b79427	e739553d-4003-4e0f-b5d2-4f97b61d1610
4	4	0	Plazi	ffb07bec-2d10-492d-9c37-361fe0b79427	e95dc0f3-4897-4a17-aaf4-ce56c28f49f0
355	355	0	Belgian Biodiversity Platform	fb11cfe1-ebc3-45af-9159-17d9fddbcdac	ea64939f-0dd1-4f6a-9f16-bd6c37b6c2e5
46755	46755	0	GBIF France	da44cd31-5901-4687-a106-6d1c7734ee3a	eae096ac-c585-4234-99cb-b32e7c517604
1	1	0	Plazi	ffb07bec-2d10-492d-9c37-361fe0b79427	eb12f8d8-4cb4-4839-830c-f9e9a453f4be
0	45405	45405	Ocean Biodiversity Information System	ba0670b9-4186-41e6-8e70-f9cb3065551a	ed8817bd-2087-4667-bcd1-f2f82f9ca894
105628	107929	2301	GBIF New Zealand	4f9fd726-20dd-445e-89a1-8ed93792276f	ee27b1b0-3b55-11dc-8c18-b8a03c50a862
0	13	13	Plazi	ffb07bec-2d10-492d-9c37-361fe0b79427	f14ff0c1-7ea3-47bb-a716-e18d17344ade
1458	1458	0	U.S. Geological Survey	8618c64a-93e0-4300-b546-7249e5148ed2	f16589a9-1c6e-4e91-b683-d5018aed4b81
0	613	613	Ocean Biodiversity Information System	ba0670b9-4186-41e6-8e70-f9cb3065551a	f21430c3-3b6d-4f54-8777-1119d8c759e2
10837	10837	0	Colombian Biodiversity Information System	7e865cba-7c46-417b-ade5-97f2cf5b7be0	f3053f73-094c-4db7-9273-58978ecf5d77
4	4	0	Plazi	ffb07bec-2d10-492d-9c37-361fe0b79427	f64fbcda-5e9b-46c5-bf53-04f547138326
25	25	0	Plazi	ffb07bec-2d10-492d-9c37-361fe0b79427	f8bc1f95-5358-4af7-87f8-adff028aa4a2
83	83	0	Plazi	ffb07bec-2d10-492d-9c37-361fe0b79427	fa2c148d-adf5-4ee3-9eee-d6f18b85c44d
43	43	0	Plazi	ffb07bec-2d10-492d-9c37-361fe0b79427	fea9295f-dda6-4cfb-8fb5-593fb43c066f
4	4	0	Plazi	ffb07bec-2d10-492d-9c37-361fe0b79427	040a8a92-28fa-44fa-bcae-30c45939b007
0	789	789	Colombian Biodiversity Information System	7e865cba-7c46-417b-ade5-97f2cf5b7be0	04cf429e-853f-43a1-88fd-4dec7ae6b249
301	301	0	Colombian Biodiversity Information System	7e865cba-7c46-417b-ade5-97f2cf5b7be0	06966867-9a16-4845-8f7f-83b93770bf75
5	5	0	Plazi	ffb07bec-2d10-492d-9c37-361fe0b79427	08887191-3584-41e1-be9d-ca5b8cc40165
0	111	111	Ocean Biodiversity Information System	ba0670b9-4186-41e6-8e70-f9cb3065551a	09abedff-dcea-4040-a97b-e0dd6a1cadd2
0	93	93	GBIF Spain	1f94b3ca-9345-4d65-afe2-4bace93aa0fe	0af41654-baeb-45d8-9aef-8bf3e95f766f
403	403	0	Korean Biodiversity Information Facility	e0a1e772-0177-4800-94b4-2d023fe6cdf4	0afcffc5-fb7a-44d3-9354-6cc3c6039436
114	114	0	Colombian Biodiversity Information System	7e865cba-7c46-417b-ade5-97f2cf5b7be0	0ce86639-748d-4ec5-a035-54ac34c9730a
1751	1751	0	National Biodiversity Network	d897a5b9-35ee-4232-94bd-b0bcaac003c2	0d1384ad-c122-4562-bf94-0f4c21cdc75f
770	770	0	GBIF France	da44cd31-5901-4687-a106-6d1c7734ee3a	100247eb-0bae-4e3a-a874-f62aecac15f9
3151	3151	0	GBIF France	da44cd31-5901-4687-a106-6d1c7734ee3a	145254fc-a861-4b9d-987a-b428ac6f0b08
19	19	0	Plazi	ffb07bec-2d10-492d-9c37-361fe0b79427	14df26ef-0ca5-4c2d-a705-3c1713fcf27f
4	4	0	Plazi	ffb07bec-2d10-492d-9c37-361fe0b79427	191fbfb8-f938-422a-956a-307c0a8a6e1d
0	1	1	Plazi	ffb07bec-2d10-492d-9c37-361fe0b79427	1a15b39a-bb78-49a5-860e-6dab7c88a99b
184	184	0	GBIF France	da44cd31-5901-4687-a106-6d1c7734ee3a	1a29a0fa-6a4e-4a66-aabf-7f97adb233a5
6	6	0	Plazi	ffb07bec-2d10-492d-9c37-361fe0b79427	1a61a73a-959c-470f-83fc-644c93fbd112
5771	5771	0	Colombian Biodiversity Information System	7e865cba-7c46-417b-ade5-97f2cf5b7be0	1c00952b-574b-4307-9b07-6ae9ef4dd44d
168413	168620	207	U.S. Geological Survey	8618c64a-93e0-4300-b546-7249e5148ed2	1d04e739-98a9-4e16-9970-8f8f3bf9e9e3
808	808	0	GBIF Benin	efb9c00e-f802-45dd-8826-a52ec45b89ff	1fedeaed-c709-41a5-9fa5-93793f7f883d
0	2	2	Plazi	ffb07bec-2d10-492d-9c37-361fe0b79427	216f128f-70e2-41e5-9168-3d0cd70d5795
0	31	31	Plazi	ffb07bec-2d10-492d-9c37-361fe0b79427	246e8b67-d767-402a-9a32-7b80be71a6ef
1969	1969	0	National Biodiversity Network	d897a5b9-35ee-4232-94bd-b0bcaac003c2	25dda45f-bc86-4b03-8079-41222257febf
114	114	0	GBIF Germany	4f6826f2-4ff6-443d-b966-e6913bd24013	271c26d8-7084-47d8-ad44-61a294497a95
493	493	0	Biodiversity Information System of Mexico	b324e8e9-9a4c-44fa-8f1a-7f39ea7ab576	28b20161-d9ef-4e62-b13c-19564af2005c
507	507	0	National Biodiversity Network	d897a5b9-35ee-4232-94bd-b0bcaac003c2	2fef5fcc-9eb5-4967-9604-2b1e80e9b9ec
9	9	0	Plazi	ffb07bec-2d10-492d-9c37-361fe0b79427	30587774-c10b-4ba9-8f83-86246937b18f
0	62	62	Ocean Biodiversity Information System	ba0670b9-4186-41e6-8e70-f9cb3065551a	30ecc1e8-751f-4a97-b77f-53b81a191c00
880	880	0	Biodiversity Information System of Mexico	b324e8e9-9a4c-44fa-8f1a-7f39ea7ab576	33a0f02e-6a9d-4b6f-a731-014f89d943de
5099	5099	0	Belgian Biodiversity Platform	fb11cfe1-ebc3-45af-9159-17d9fddbcdac	366954fa-7fe3-402c-977b-00b4fac70be1
78838	79544	706	U.S. Geological Survey	8618c64a-93e0-4300-b546-7249e5148ed2	3774eeec-8a91-45d0-b3d5-a3903cfc220d
3359932	3359932	0	Netherlands Biodiversity Information Facility	0909d601-bda2-42df-9e63-a6d51847ebce	37f48e00-1fe8-11dc-b461-b8a03c50a862
215	215	0	GBIF France	da44cd31-5901-4687-a106-6d1c7734ee3a	394a873b-0931-40ce-9a6e-3f76d76084a0
4	4	0	Plazi	ffb07bec-2d10-492d-9c37-361fe0b79427	3f56c3ca-c520-4e2c-9310-95178c282c9d
21	21	0	National Biodiversity Network	d897a5b9-35ee-4232-94bd-b0bcaac003c2	3f628915-1aef-4982-b3d3-0113336399ec
12217	12217	0	U.S. Geological Survey	8618c64a-93e0-4300-b546-7249e5148ed2	431b19b9-b5b4-4bcb-ae11-072899dd4c52
2	2	0	GBIF Germany	4f6826f2-4ff6-443d-b966-e6913bd24013	44cc2996-3a0c-11e2-b0ce-00145eb45e9a
3572	3572	0	GBIF Argentina	2426a871-9feb-40a1-96c6-0c593a76b835	48baafff-2848-4819-a5c8-e8123c82b946
178	178	0	National Biodiversity Network	d897a5b9-35ee-4232-94bd-b0bcaac003c2	48f0df2f-4f66-4091-8927-b8a9430d0106
1782873	1782873	0	GBIF France	da44cd31-5901-4687-a106-6d1c7734ee3a	4ebe5835-851f-43fd-beed-afade357bfc7
167	167	0	GBIF Japan	db5705aa-6a6e-42f1-8942-d77b9f4896ea	50e6f611-fbaf-4dd3-809b-a053bf2efb5c
0	15	15	Plazi	ffb07bec-2d10-492d-9c37-361fe0b79427	53a3a5b6-86cb-462e-9e16-1ade7ac70634
21	21	0	Plazi	ffb07bec-2d10-492d-9c37-361fe0b79427	5876c089-ac56-431b-941e-61a51186120f
0	569	569	Atlas of Living Australia	4a6f1b71-969e-4fc5-a693-282b05e1220c	591e257f-93bc-4703-aad6-aeae190f000c
0	34	34	Plazi	ffb07bec-2d10-492d-9c37-361fe0b79427	5b810a15-ecb9-4822-ba5a-1a1827a4a7a6
3	3	0	Plazi	ffb07bec-2d10-492d-9c37-361fe0b79427	5bfa6115-2a5e-451a-8237-81de4aea990b
0	12	12	Plazi	ffb07bec-2d10-492d-9c37-361fe0b79427	5c192143-9df8-4464-a090-dc535a3a9cda
94	94	0	GBIF Brazil	cdc9736d-5ff7-4ece-9959-3c744360cdb3	5d3e640e-6c80-463e-bb73-ec4faaf2d15a
708	708	0	GBIF Portugal	673f7038-4262-4149-b753-5658a4e912f6	611aea9f-9c55-4404-ac36-0d82c0b9edf9
71	71	0	GBIF Germany	4f6826f2-4ff6-443d-b966-e6913bd24013	613b9b30-f762-11e1-a439-00145eb45e9a
103	103	0	GBIF Germany	4f6826f2-4ff6-443d-b966-e6913bd24013	61633bf4-f762-11e1-a439-00145eb45e9a
73	73	0	GBIF Germany	4f6826f2-4ff6-443d-b966-e6913bd24013	61cb0784-f762-11e1-a439-00145eb45e9a
79	79	0	GBIF Germany	4f6826f2-4ff6-443d-b966-e6913bd24013	61d2ee22-f762-11e1-a439-00145eb45e9a
103	103	0	GBIF Germany	4f6826f2-4ff6-443d-b966-e6913bd24013	61e54d6a-f762-11e1-a439-00145eb45e9a
49	49	0	GBIF Germany	4f6826f2-4ff6-443d-b966-e6913bd24013	61ef1002-f762-11e1-a439-00145eb45e9a
102	102	0	GBIF Germany	4f6826f2-4ff6-443d-b966-e6913bd24013	627826d0-f762-11e1-a439-00145eb45e9a
1478	1478	0	GBIF France	da44cd31-5901-4687-a106-6d1c7734ee3a	63b40632-a404-4cfd-af3b-2644a8e77325
48	48	0	GBIF Germany	4f6826f2-4ff6-443d-b966-e6913bd24013	64eedbca-f762-11e1-a439-00145eb45e9a
28	25	-3	GBIF Germany	4f6826f2-4ff6-443d-b966-e6913bd24013	65adbdd8-f762-11e1-a439-00145eb45e9a
122	122	0	GBIF Germany	4f6826f2-4ff6-443d-b966-e6913bd24013	666310ac-f762-11e1-a439-00145eb45e9a
28	28	0	GBIF Germany	4f6826f2-4ff6-443d-b966-e6913bd24013	669f43f6-f762-11e1-a439-00145eb45e9a
0	2	2	Plazi	ffb07bec-2d10-492d-9c37-361fe0b79427	66ae7007-06a9-4051-867b-8396621dea3f
73	73	0	GBIF Germany	4f6826f2-4ff6-443d-b966-e6913bd24013	68ba829a-f762-11e1-a439-00145eb45e9a
37	37	0	GBIF Germany	4f6826f2-4ff6-443d-b966-e6913bd24013	692efdd2-f762-11e1-a439-00145eb45e9a
713	713	0	Plazi	ffb07bec-2d10-492d-9c37-361fe0b79427	6c17414c-fd9d-47b0-b9b0-b9c538aa8cf0
4	4	0	Plazi	ffb07bec-2d10-492d-9c37-361fe0b79427	6c7d1ea7-6586-46f9-a3b4-714f249cd838
261	261	0	GBIF France	da44cd31-5901-4687-a106-6d1c7734ee3a	6cc34c05-4d27-4653-8989-1dcd48fa1fb2
3	3	0	Plazi	ffb07bec-2d10-492d-9c37-361fe0b79427	6cc8ce12-ae21-4ce3-90db-d0a9853cfc04
11250	11250	0	Colombian Biodiversity Information System	7e865cba-7c46-417b-ade5-97f2cf5b7be0	6d5fced1-6e85-4d9e-88f4-e1459772d2fd
178677	216173	37496	GBIF New Zealand	4f9fd726-20dd-445e-89a1-8ed93792276f	6e4b215e-9019-4934-8433-65d80a35c230
3775	3775	0	GBIF France	da44cd31-5901-4687-a106-6d1c7734ee3a	6e6b3b6a-3452-491f-9d91-9ab571dfa03f
53	53	0	GBIF Germany	4f6826f2-4ff6-443d-b966-e6913bd24013	70e0867c-f762-11e1-a439-00145eb45e9a
222	66	-156	GBIF Germany	4f6826f2-4ff6-443d-b966-e6913bd24013	70e57bc8-f762-11e1-a439-00145eb45e9a
115	111	-4	GBIF Germany	4f6826f2-4ff6-443d-b966-e6913bd24013	73d8ff26-f762-11e1-a439-00145eb45e9a
34	34	0	GBIF Germany	4f6826f2-4ff6-443d-b966-e6913bd24013	73fb7894-f762-11e1-a439-00145eb45e9a
29	29	0	GBIF Germany	4f6826f2-4ff6-443d-b966-e6913bd24013	7581d1ae-f762-11e1-a439-00145eb45e9a
846	776	-70	GBIF Germany	4f6826f2-4ff6-443d-b966-e6913bd24013	76056a5a-f762-11e1-a439-00145eb45e9a
187	76	-111	GBIF Germany	4f6826f2-4ff6-443d-b966-e6913bd24013	78545f96-f762-11e1-a439-00145eb45e9a
4	4	0	GBIF Germany	4f6826f2-4ff6-443d-b966-e6913bd24013	788343b0-f762-11e1-a439-00145eb45e9a
30008	30008	0	GBIF Japan	db5705aa-6a6e-42f1-8942-d77b9f4896ea	78f2723d-c757-42b6-9da0-19d0a53c738a
51	41	-10	GBIF Germany	4f6826f2-4ff6-443d-b966-e6913bd24013	7955b642-f762-11e1-a439-00145eb45e9a
6857	6857	0	U.S. Geological Survey	8618c64a-93e0-4300-b546-7249e5148ed2	79d089b3-cb21-4d81-924b-f1997dec5988
16	16	0	Plazi	ffb07bec-2d10-492d-9c37-361fe0b79427	7a878a72-48da-4dad-b84d-6317c790eab3
661	661	0	Korean Biodiversity Information Facility	e0a1e772-0177-4800-94b4-2d023fe6cdf4	7b2d95d4-f762-11e1-a439-00145eb45e9a
3118	3118	0	GBIF Germany	4f6826f2-4ff6-443d-b966-e6913bd24013	7c74881c-f762-11e1-a439-00145eb45e9a
153	128	-25	GBIF Germany	4f6826f2-4ff6-443d-b966-e6913bd24013	7e8a6400-f762-11e1-a439-00145eb45e9a
83	83	0	GBIF Germany	4f6826f2-4ff6-443d-b966-e6913bd24013	7f104462-f762-11e1-a439-00145eb45e9a
1511	1504	-7	Biodiversity Information System of Mexico	b324e8e9-9a4c-44fa-8f1a-7f39ea7ab576	7f8efb22-f762-11e1-a439-00145eb45e9a
580	580	0	Biodiversity Information System of Mexico	b324e8e9-9a4c-44fa-8f1a-7f39ea7ab576	7fd8f36c-f762-11e1-a439-00145eb45e9a
129	129	0	GBIF Germany	4f6826f2-4ff6-443d-b966-e6913bd24013	82087c52-f762-11e1-a439-00145eb45e9a
2980	2980	0	GBIF Spain	1f94b3ca-9345-4d65-afe2-4bace93aa0fe	837d1c8c-f762-11e1-a439-00145eb45e9a
0	3	3	Plazi	ffb07bec-2d10-492d-9c37-361fe0b79427	84eadb24-4c2c-4317-b068-c12776220192
9195	9195	0	GBIF Japan	db5705aa-6a6e-42f1-8942-d77b9f4896ea	86a294e6-f762-11e1-a439-00145eb45e9a
0	5	5	Plazi	ffb07bec-2d10-492d-9c37-361fe0b79427	86f6d666-7a93-4f5d-bda2-301f2287b231
1528	1296	-232	GBIF Germany	4f6826f2-4ff6-443d-b966-e6913bd24013	8703241e-f762-11e1-a439-00145eb45e9a
140	103	-37	GBIF Germany	4f6826f2-4ff6-443d-b966-e6913bd24013	87778282-f762-11e1-a439-00145eb45e9a
454	322	-132	GBIF Germany	4f6826f2-4ff6-443d-b966-e6913bd24013	87d48f9a-f762-11e1-a439-00145eb45e9a
271	271	0	GBIF Germany	4f6826f2-4ff6-443d-b966-e6913bd24013	88376476-f762-11e1-a439-00145eb45e9a
496	411	-85	GBIF Germany	4f6826f2-4ff6-443d-b966-e6913bd24013	8849a028-f762-11e1-a439-00145eb45e9a
158	158	0	GBIF France	da44cd31-5901-4687-a106-6d1c7734ee3a	8a73e9b5-ab13-4601-8497-99229ba69ded
58	58	0	GBIF Germany	4f6826f2-4ff6-443d-b966-e6913bd24013	8ab0799a-f762-11e1-a439-00145eb45e9a
4	4	0	GBIF Germany	4f6826f2-4ff6-443d-b966-e6913bd24013	8b85fb10-f762-11e1-a439-00145eb45e9a
202	150	-52	GBIF Germany	4f6826f2-4ff6-443d-b966-e6913bd24013	8c6ccca2-f762-11e1-a439-00145eb45e9a
21	16	-5	GBIF Germany	4f6826f2-4ff6-443d-b966-e6913bd24013	8cbcadf8-f762-11e1-a439-00145eb45e9a
137785	137785	0	GBIF France	da44cd31-5901-4687-a106-6d1c7734ee3a	8d53b914-0bd6-4b6d-a3e0-05e4407e7331
0	17	17	Plazi	ffb07bec-2d10-492d-9c37-361fe0b79427	8e60af8c-873f-40d6-971f-7b95915ef8f0
8	8	0	Plazi	ffb07bec-2d10-492d-9c37-361fe0b79427	8e6e52bb-ad01-49bf-897b-9052cc9b2e20
748	748	0	GBIF Germany	4f6826f2-4ff6-443d-b966-e6913bd24013	8f1ffad2-f762-11e1-a439-00145eb45e9a
138	55	-83	GBIF Germany	4f6826f2-4ff6-443d-b966-e6913bd24013	90faefce-f762-11e1-a439-00145eb45e9a
5	5	0	Plazi	ffb07bec-2d10-492d-9c37-361fe0b79427	9144f409-d6d3-453c-9551-801d07178b22
7	7	0	Plazi	ffb07bec-2d10-492d-9c37-361fe0b79427	91632c26-bc53-48bc-86ef-7ba516964f61
171	171	0	GBIF Germany	4f6826f2-4ff6-443d-b966-e6913bd24013	92718a16-f762-11e1-a439-00145eb45e9a
26	25	-1	GBIF Germany	4f6826f2-4ff6-443d-b966-e6913bd24013	928247c0-f762-11e1-a439-00145eb45e9a
0	2	2	Plazi	ffb07bec-2d10-492d-9c37-361fe0b79427	94084051-a340-4710-833e-8cd72977880e
33	33	0	GBIF Germany	4f6826f2-4ff6-443d-b966-e6913bd24013	95aaaafa-f762-11e1-a439-00145eb45e9a
1	1	0	GBIF Germany	4f6826f2-4ff6-443d-b966-e6913bd24013	96843e1e-f762-11e1-a439-00145eb45e9a
17	17	0	Participant Node Managers Committee	7f48e0c8-5c96-49ec-b972-30748e339115	96ff3b8d-54ff-4a26-902b-1cac861c3cbe
4253	4292	39	U.S. Geological Survey	8618c64a-93e0-4300-b546-7249e5148ed2	97ce9818-7028-42a0-9743-ccb5897dec1f
20191	20191	0	GBIF Norway	4f829580-180d-46a9-9c87-ed8ec959b545	9801530f-ab2f-4913-9050-d7239d12aed0
13	13	0	Plazi	ffb07bec-2d10-492d-9c37-361fe0b79427	98e13ef7-c43b-46c1-8fe6-6e2ccf1e4811
0	107997	107997	Belgian Biodiversity Platform	fb11cfe1-ebc3-45af-9159-17d9fddbcdac	99047b1e-ee53-4053-ba69-2e28eaaa45d9
4282	4282	0	GBIF France	da44cd31-5901-4687-a106-6d1c7734ee3a	9b509219-8a73-4caf-80b8-daa16ed35c09
0	3	3	Plazi	ffb07bec-2d10-492d-9c37-361fe0b79427	9da01539-530c-4d2c-a162-094e28f5866d
107	107	0	GBIF Germany	4f6826f2-4ff6-443d-b966-e6913bd24013	9e96a4a8-c87c-47a7-b972-45769078469c
2	2	0	GBIF Germany	4f6826f2-4ff6-443d-b966-e6913bd24013	9ef0ea9f-8ab0-4373-9d1b-b180b09d4b99
8	8	0	Plazi	ffb07bec-2d10-492d-9c37-361fe0b79427	a13227aa-4322-4f62-ae72-528c04041fd2
2351	2351	0	GBIF Finland	dd514216-5c7c-45f3-910d-797424cb5be6	a19133e2-d381-4de8-a7e7-94f47fe90132
6	6	0	Plazi	ffb07bec-2d10-492d-9c37-361fe0b79427	a33c8231-6ff0-4198-ac1e-3e52fe251db3
119	119	0	GBIF France	da44cd31-5901-4687-a106-6d1c7734ee3a	a5634a41-5b4f-46e1-81e0-065863deca6d
3	3	0	Plazi	ffb07bec-2d10-492d-9c37-361fe0b79427	a584d3ee-4428-4651-bdc7-1d34d274c34c
4	4	0	Plazi	ffb07bec-2d10-492d-9c37-361fe0b79427	a5aa49c0-765f-4ea8-b899-9d9e04781bc8
0	254321	254321	GBIF Switzerland	169eb292-376b-4cc6-8e31-9c2c432de0ad	a5ce6f77-0e25-43f8-b811-9f7794b18e08
4	4	0	Plazi	ffb07bec-2d10-492d-9c37-361fe0b79427	a7502cfd-2f56-4913-82d6-c18a2de19e14
9	9	0	Plazi	ffb07bec-2d10-492d-9c37-361fe0b79427	a7d4bb96-fcda-4926-b859-e25288812a76
162	162	0	Colombian Biodiversity Information System	7e865cba-7c46-417b-ade5-97f2cf5b7be0	aab301bb-4611-41db-a44e-ed0885d18f16
6575	7318	743	Participant Node Managers Committee	7f48e0c8-5c96-49ec-b972-30748e339115	acd76923-54da-4799-b4b0-cfe585c2c0b8
2	2	0	Plazi	ffb07bec-2d10-492d-9c37-361fe0b79427	adbdaa22-6739-4162-9503-487b9bdb4ada
115	115	0	Plazi	ffb07bec-2d10-492d-9c37-361fe0b79427	ae784474-b543-438c-b369-51b671b83fc4
3	3	0	Plazi	ffb07bec-2d10-492d-9c37-361fe0b79427	ae9f6659-8606-4ba6-8967-e48abd5b147f
1833	1833	0	National Biodiversity Network	d897a5b9-35ee-4232-94bd-b0bcaac003c2	aed6e717-d69f-40a1-ba62-abcb13d293a4
93	93	0	Colombian Biodiversity Information System	7e865cba-7c46-417b-ade5-97f2cf5b7be0	b37dedc0-ed41-4214-9c31-2fc7c27b63e3
9062	9062	0	Canada Biodiversity Information Facility	8f83fc96-c966-4126-83f7-bf044dc49efa	b42a2e9a-fba0-41bf-ba18-d430cc6c3c59
5	5	0	Plazi	ffb07bec-2d10-492d-9c37-361fe0b79427	b49ecec2-a0c0-4fff-a3a7-c7180ec2d5d4
232	232	0	Plazi	ffb07bec-2d10-492d-9c37-361fe0b79427	b5128e41-1646-4893-ba03-2d83c37cffbd
2612	2612	0	Participant Node Managers Committee	7f48e0c8-5c96-49ec-b972-30748e339115	b6538814-468b-4278-b5f1-68ca4afd1e88
348	348	0	Atlas of Living Australia	4a6f1b71-969e-4fc5-a693-282b05e1220c	b7c6fac5-7677-4dd9-be3c-b9838605ff70
661	661	0	Participant Node Managers Committee	7f48e0c8-5c96-49ec-b972-30748e339115	b7ce62f1-8e9d-467b-8889-af1a2158321a
0	24574	24574	Belgian Biodiversity Platform	fb11cfe1-ebc3-45af-9159-17d9fddbcdac	b93edff8-66e2-43d5-9020-3f6a6379c3ed
293	293	0	Participant Node Managers Committee	7f48e0c8-5c96-49ec-b972-30748e339115	b95534da-3507-4e66-afe7-94c655eaceb3
62	62	0	GBIF Germany	4f6826f2-4ff6-443d-b966-e6913bd24013	bbe9a926-86ce-4691-9587-ee8a1c1bb630
855	855	0	GBIF Germany	4f6826f2-4ff6-443d-b966-e6913bd24013	bc1150e4-fc80-4e04-8071-88878ed3c4d1
2140	2140	0	GBIF France	da44cd31-5901-4687-a106-6d1c7734ee3a	bc63a7ec-2b59-46f9-b549-9d77b7d4a70b
2	2	0	Plazi	ffb07bec-2d10-492d-9c37-361fe0b79427	bc7c1790-d1b4-480a-8f12-4d1dd9a6ccb4
267	267	0	GBIF France	da44cd31-5901-4687-a106-6d1c7734ee3a	bda88a87-1975-4872-8333-7a83b653a643
0	76767	76767	Korean Biodiversity Information Facility	e0a1e772-0177-4800-94b4-2d023fe6cdf4	bef19e99-90a7-4b3d-a113-bdf4ea6c88f2
112	112	0	Plazi	ffb07bec-2d10-492d-9c37-361fe0b79427	c08a0701-368a-475e-9e86-35edc68ff30b
0	5	5	Plazi	ffb07bec-2d10-492d-9c37-361fe0b79427	c0ee6717-7e35-4acf-8619-fdeb5f6d1605
381	381	0	Ocean Biodiversity Information System	ba0670b9-4186-41e6-8e70-f9cb3065551a	c1250215-2efc-4bcf-8a6e-fda854d6019d
8	8	0	Plazi	ffb07bec-2d10-492d-9c37-361fe0b79427	c31e76f5-34bc-48e9-91d2-e0f225ebda09
0	8	8	Plazi	ffb07bec-2d10-492d-9c37-361fe0b79427	c371f308-0c4f-40ab-90be-9cac102e4797
3	3	0	Plazi	ffb07bec-2d10-492d-9c37-361fe0b79427	c3926bda-b7c5-42ae-ad52-8655ac9ae4f8
0	2	2	Plazi	ffb07bec-2d10-492d-9c37-361fe0b79427	c545d663-78d1-4ce7-bf98-91d116902eba
8	8	0	Plazi	ffb07bec-2d10-492d-9c37-361fe0b79427	c6943e65-b41a-462f-a60a-476a7dc30c42
52	52	0	Plazi	ffb07bec-2d10-492d-9c37-361fe0b79427	c92ad4f3-1985-414c-b0eb-b18cc3679ed2
31094	31624	530	GBIF Brazil	cdc9736d-5ff7-4ece-9959-3c744360cdb3	ca2e422f-be48-42a5-bca5-a37cada435c8
3	3	0	Plazi	ffb07bec-2d10-492d-9c37-361fe0b79427	d052da5f-7fb1-4969-ae20-89437a05f105
0	8	8	Plazi	ffb07bec-2d10-492d-9c37-361fe0b79427	d5271af7-64bc-4522-843d-7204c3673f22
0	112	112	Ocean Biodiversity Information System	ba0670b9-4186-41e6-8e70-f9cb3065551a	d558518f-670f-45cf-8a77-2a432054745d
211	211	0	GBIF Guinea	b1cd2e84-c4ba-47bd-b72a-dfd1f92dce0a	d6c31a17-f877-4d23-b983-81ad03716f32
1885	1885	0	National Biodiversity Network	d897a5b9-35ee-4232-94bd-b0bcaac003c2	db6f82cc-a90f-4492-9526-4539980c58b5
10	10	0	Plazi	ffb07bec-2d10-492d-9c37-361fe0b79427	dc72f6e5-06b2-4846-89ed-cc8a213f054e
172	172	0	GBIF Germany	4f6826f2-4ff6-443d-b966-e6913bd24013	e2b4d0a6-1722-4172-9105-64dd867a8ef1
9	9	0	Plazi	ffb07bec-2d10-492d-9c37-361fe0b79427	e4b42299-bc81-4225-a7d4-92c8999b134e
1	1	0	Plazi	ffb07bec-2d10-492d-9c37-361fe0b79427	e5a7a04a-8ecf-43eb-be40-3c54aa89e210
442	442	0	Atlas of Living Australia	4a6f1b71-969e-4fc5-a693-282b05e1220c	eb477342-875e-450a-b377-cf405f315f16
127	127	0	GBIF France	da44cd31-5901-4687-a106-6d1c7734ee3a	ec34593d-3146-499a-9cb6-28119384d762
0	2	2	Plazi	ffb07bec-2d10-492d-9c37-361fe0b79427	edcf70cf-d7cf-4e5a-87b1-97bbdf7970db
0	24	24	Plazi	ffb07bec-2d10-492d-9c37-361fe0b79427	f0925a2c-4db7-4d8f-a8d7-079b934fee2f
189	189	0	GBIF France	da44cd31-5901-4687-a106-6d1c7734ee3a	f2c0b061-46dc-4c63-b8e3-33bb0ad2b80e
42	42	0	Plazi	ffb07bec-2d10-492d-9c37-361fe0b79427	f30f953f-f745-452b-8498-a53ce12e04ba
3440	3440	0	GBIF Brazil	cdc9736d-5ff7-4ece-9959-3c744360cdb3	f67c16a4-4734-4d7a-9418-53f528abc110
1	1	0	Plazi	ffb07bec-2d10-492d-9c37-361fe0b79427	f8f2f734-4675-453c-8197-335511d6b3aa
9396	9396	0	National Biodiversity Network	d897a5b9-35ee-4232-94bd-b0bcaac003c2	f8f4c490-8ab3-4e27-b871-944fb807bc1b
31	31	0	Colombian Biodiversity Information System	7e865cba-7c46-417b-ade5-97f2cf5b7be0	f9049e23-7738-491e-82f3-95196f2f2cac
0	3	3	Participant Node Managers Committee	7f48e0c8-5c96-49ec-b972-30748e339115	fc1ea304-9a7b-4146-8295-f5619321c657
748	748	0	GBIF France	da44cd31-5901-4687-a106-6d1c7734ee3a	01cbf8a9-0457-4abe-b34a-9343765676aa
5	5	0	GBIF Finland	dd514216-5c7c-45f3-910d-797424cb5be6	0360f9fc-bf9b-43b2-8c7f-d09e853fc721
0	336	336	Plazi	ffb07bec-2d10-492d-9c37-361fe0b79427	081ba61b-c79c-401c-a265-060a46979cd2
0	34	34	Plazi	ffb07bec-2d10-492d-9c37-361fe0b79427	0db7e20e-9509-407e-b377-d1af3a411051
0	11	11	Plazi	ffb07bec-2d10-492d-9c37-361fe0b79427	0e4f0459-0892-43b2-b01d-50f384c6c945
0	2	2	Plazi	ffb07bec-2d10-492d-9c37-361fe0b79427	10735030-598e-4c9a-86d6-facb73848c65
0	1	1	Plazi	ffb07bec-2d10-492d-9c37-361fe0b79427	143982dd-c519-4cd4-9207-e15a33f940b9
5733	5733	0	Polish Biodiversity Information Network	2618bfdf-e194-4911-a241-80db3107bc51	147133d0-6ff7-11db-b2a6-b8a03c50a862
4	4	0	Plazi	ffb07bec-2d10-492d-9c37-361fe0b79427	15192bcb-c91d-4dc7-acd4-fd7caf151edc
11	11	0	Plazi	ffb07bec-2d10-492d-9c37-361fe0b79427	1595b9b6-1abb-40d6-917f-51d6229a5657
751	751	0	GBIF France	da44cd31-5901-4687-a106-6d1c7734ee3a	17cd138e-92e6-4df7-ab1e-50c63a26ec6e
3	3	0	Plazi	ffb07bec-2d10-492d-9c37-361fe0b79427	1934d198-9912-471c-b967-ee69e33185af
77	77	0	Plazi	ffb07bec-2d10-492d-9c37-361fe0b79427	1c0a6be8-85ec-4b9f-8e3b-f8387400bea2
4	4	0	Plazi	ffb07bec-2d10-492d-9c37-361fe0b79427	1da84487-747f-46a0-b0e7-e618a5819c8d
107	107	0	National Biodiversity Network	d897a5b9-35ee-4232-94bd-b0bcaac003c2	1e103a3c-a8c7-4a6a-b842-5bbc363c1533
0	860	860	Colombian Biodiversity Information System	7e865cba-7c46-417b-ade5-97f2cf5b7be0	21fd86ac-8d53-48b3-b467-426eff64b14b
231952	231952	0	National Biodiversity Network	d897a5b9-35ee-4232-94bd-b0bcaac003c2	22f1d0f1-3bf5-4f2c-b979-667fcd9db2bb
23	23	0	Plazi	ffb07bec-2d10-492d-9c37-361fe0b79427	25a56727-8624-4caa-81fa-a3742327a0d6
0	1500	1500	Ocean Biodiversity Information System	ba0670b9-4186-41e6-8e70-f9cb3065551a	25c15e2a-843b-4dc4-a6d7-80b2a24196b5
28895	28895	0	GBIF France	da44cd31-5901-4687-a106-6d1c7734ee3a	25ff81bc-cdc5-4953-8c51-5bd74fd97b36
1758	1758	0	National Biodiversity Network	d897a5b9-35ee-4232-94bd-b0bcaac003c2	2912f89b-4104-4dd7-a5fc-bbe45884cdbc
144	144	0	Colombian Biodiversity Information System	7e865cba-7c46-417b-ade5-97f2cf5b7be0	2a45b639-c604-49ea-b3e9-e01dfacdd726
19	19	0	South African Biodiversity Information Facility	7190b835-4e86-4b6e-85c1-19cc6677c250	2d34b8f7-1c8e-471f-977a-9116cea9354b
126918	126918	0	U.S. Geological Survey	8618c64a-93e0-4300-b546-7249e5148ed2	2d633622-d522-4c0d-93ae-a3940df3bbe7
3836	3836	0	Participant Node Managers Committee	7f48e0c8-5c96-49ec-b972-30748e339115	2e0e2d1e-4903-40f8-9815-16a03de3955f
7765	7765	0	Atlas of Living Australia	4a6f1b71-969e-4fc5-a693-282b05e1220c	2eb5a1d1-0436-4d3d-af87-2842ddd86c36
330	330	0	National Biodiversity Network	d897a5b9-35ee-4232-94bd-b0bcaac003c2	2ee1a588-0be5-4458-8bc5-487b9bd99fe7
3	3	0	Plazi	ffb07bec-2d10-492d-9c37-361fe0b79427	328adfa4-4626-461b-a14e-837fd43ed77f
3464	3464	0	GBIF France	da44cd31-5901-4687-a106-6d1c7734ee3a	32be30f9-0129-4508-8185-3f09c654f9ed
0	14	14	Plazi	ffb07bec-2d10-492d-9c37-361fe0b79427	33ff9a02-4298-4ec0-a596-3876685b2065
10	10	0	Plazi	ffb07bec-2d10-492d-9c37-361fe0b79427	343c32f4-190c-4cf1-a1e2-a24dc25e8ebe
11870	11870	0	National Biodiversity Network	d897a5b9-35ee-4232-94bd-b0bcaac003c2	3479d9c7-dcf3-41de-a48c-9df1cb96ae44
0	18	18	Ocean Biodiversity Information System	ba0670b9-4186-41e6-8e70-f9cb3065551a	34c0a1ea-5373-44ff-8c2e-d2462b129a36
104	104	0	Participant Node Managers Committee	7f48e0c8-5c96-49ec-b972-30748e339115	35f47748-8f91-4cca-9d2c-573ab66078cc
521444	521444	0	U.S. Geological Survey	8618c64a-93e0-4300-b546-7249e5148ed2	36f15a36-6b45-442e-9c31-cd633423aee0
4	4	0	Plazi	ffb07bec-2d10-492d-9c37-361fe0b79427	37e33fa8-2cb4-4693-86c6-77bb430b5baa
178	178	0	GBIF France	da44cd31-5901-4687-a106-6d1c7734ee3a	3af43949-ba69-4c23-857e-2021084dded7
0	40	40	Plazi	ffb07bec-2d10-492d-9c37-361fe0b79427	3c15254c-086c-448f-bfe2-e3cd208dcc87
4	4	0	Plazi	ffb07bec-2d10-492d-9c37-361fe0b79427	3c1d0ee0-1cb0-4a76-a16f-f59d4101f970
118	118	0	Plazi	ffb07bec-2d10-492d-9c37-361fe0b79427	3d0b9b5c-037d-4e6a-8eca-308bd049f4f4
62	62	0	Plazi	ffb07bec-2d10-492d-9c37-361fe0b79427	3d4695b9-9b9b-45c4-b8e6-da80ea19575e
27	27	0	Plazi	ffb07bec-2d10-492d-9c37-361fe0b79427	40ab6670-6c79-40bb-8b59-e272f49cf12a
193	193	0	South African Biodiversity Information Facility	7190b835-4e86-4b6e-85c1-19cc6677c250	417276eb-5082-4da3-b410-fe5680da65d9
1027799	1027799	0	GBIF France	da44cd31-5901-4687-a106-6d1c7734ee3a	43027054-3812-4599-b7bc-a01f1df5b071
222	222	0	Belgian Biodiversity Platform	fb11cfe1-ebc3-45af-9159-17d9fddbcdac	443810c4-f384-488f-b476-7e17ecb737ad
8	8	0	Plazi	ffb07bec-2d10-492d-9c37-361fe0b79427	4673b91e-e7f9-414e-a3bf-d1b78d986967
25	25	0	Plazi	ffb07bec-2d10-492d-9c37-361fe0b79427	4aa941f3-5db6-4a15-8730-ce5f47fa50b9
0	4	4	Plazi	ffb07bec-2d10-492d-9c37-361fe0b79427	4cecd899-5900-4411-8446-0d9552b1b098
657	657	0	National Biodiversity Network	d897a5b9-35ee-4232-94bd-b0bcaac003c2	500e6d9d-d66f-452c-8c7b-b8a15c5e6d2d
49637	49637	0	Society for the Management of Electronic Biodiversity Data	97818ee4-1461-4180-bf1d-b3201050124f	505cabc3-7550-4fd1-96dc-6d77d5ffc6de
6603	7440	837	U.S. Geological Survey	8618c64a-93e0-4300-b546-7249e5148ed2	59728459-7b42-4942-8e38-00eb56f2331e
43598	43598	0	GBIF Switzerland	169eb292-376b-4cc6-8e31-9c2c432de0ad	5a659248-1f70-11e3-b2c5-00145eb45e9a
2	2	0	Plazi	ffb07bec-2d10-492d-9c37-361fe0b79427	5ae23703-fa79-4179-a240-927e0135995b
131642	131642	0	Ciencia y Tecnología para el Desarrollo	dbecf582-c93c-4a6a-8991-0327bdf7fd49	5c4a1973-2b2f-4c32-a9c8-65150ef4cf13
8344	8344	0	GBIF France	da44cd31-5901-4687-a106-6d1c7734ee3a	5c628ff4-7406-4d8c-9a6b-276eb02eb305
0	10	10	Ocean Biodiversity Information System	ba0670b9-4186-41e6-8e70-f9cb3065551a	5fce2e20-d608-4b5c-941a-fad6692b1e87
5	5	0	Plazi	ffb07bec-2d10-492d-9c37-361fe0b79427	60ba4873-d1f0-4818-9303-9caecbeed842
126	126	0	GBIF France	da44cd31-5901-4687-a106-6d1c7734ee3a	624a9f2b-3242-43ed-a5a0-2539554bb265
145	145	0	GBIF Germany	4f6826f2-4ff6-443d-b966-e6913bd24013	63978de4-f762-11e1-a439-00145eb45e9a
5	5	0	Plazi	ffb07bec-2d10-492d-9c37-361fe0b79427	64f05738-818e-47db-89f7-33dabce1e3f2
125	120	-5	GBIF Germany	4f6826f2-4ff6-443d-b966-e6913bd24013	65f148be-f762-11e1-a439-00145eb45e9a
91	91	0	GBIF Germany	4f6826f2-4ff6-443d-b966-e6913bd24013	664d3836-f762-11e1-a439-00145eb45e9a
15	15	0	Plazi	ffb07bec-2d10-492d-9c37-361fe0b79427	665a714c-6c8e-4d42-a544-282471582c07
37	37	0	GBIF Germany	4f6826f2-4ff6-443d-b966-e6913bd24013	67f14952-f762-11e1-a439-00145eb45e9a
368	368	0	Colombian Biodiversity Information System	7e865cba-7c46-417b-ade5-97f2cf5b7be0	687ec654-d3a9-4f04-a536-3159e0439e58
123	123	0	GBIF Germany	4f6826f2-4ff6-443d-b966-e6913bd24013	688ef350-f762-11e1-a439-00145eb45e9a
5	5	0	GBIF Germany	4f6826f2-4ff6-443d-b966-e6913bd24013	68c85ce4-f762-11e1-a439-00145eb45e9a
102	102	0	GBIF Germany	4f6826f2-4ff6-443d-b966-e6913bd24013	690a366e-f762-11e1-a439-00145eb45e9a
0	6	6	Ocean Biodiversity Information System	ba0670b9-4186-41e6-8e70-f9cb3065551a	6995400e-2bc9-489d-948f-3863257ed5ce
48450	55186	6736	National Biodiversity Network	d897a5b9-35ee-4232-94bd-b0bcaac003c2	699a09d4-951c-4a10-9cd6-7bddbbb92546
27766	27766	0	GBIF France	da44cd31-5901-4687-a106-6d1c7734ee3a	69cf8bf0-0e90-4742-8970-4df15c123691
0	3	3	Plazi	ffb07bec-2d10-492d-9c37-361fe0b79427	6b1cbcb9-d983-4f57-95b7-a5984b7dbf5b
18	18	0	GBIF Germany	4f6826f2-4ff6-443d-b966-e6913bd24013	6b2ac774-f762-11e1-a439-00145eb45e9a
492	492	0	GBIF Nigeria	6529bcb5-a542-4fda-be87-54a624515335	6b6fb2f3-b38a-4027-b8f1-ab824238cc07
30	30	0	GBIF Malawi	2a42e4d7-ad4a-41b3-84c4-de4aa7b74d35	6beeffee-3fa7-45e9-97f3-e7605e58dff3
302	302	0	GBIF Germany	4f6826f2-4ff6-443d-b966-e6913bd24013	6c0d31fe-f762-11e1-a439-00145eb45e9a
385	385	0	Plazi	ffb07bec-2d10-492d-9c37-361fe0b79427	6c3d39df-7484-4878-8952-9c6a0d926465
56	56	0	GBIF Germany	4f6826f2-4ff6-443d-b966-e6913bd24013	6ce2fa50-f762-11e1-a439-00145eb45e9a
102	102	0	GBIF France	da44cd31-5901-4687-a106-6d1c7734ee3a	6de6a7d6-95ce-40b8-a569-43b127a57bc5
337	337	0	GBIF France	da44cd31-5901-4687-a106-6d1c7734ee3a	6f3bfb64-ed20-47cd-a379-5c0f6b858c4b
4	4	0	GBIF Germany	4f6826f2-4ff6-443d-b966-e6913bd24013	6f96cb32-f762-11e1-a439-00145eb45e9a
4	4	0	GBIF Germany	4f6826f2-4ff6-443d-b966-e6913bd24013	6fa8643c-f762-11e1-a439-00145eb45e9a
23	23	0	Plazi	ffb07bec-2d10-492d-9c37-361fe0b79427	6fd34dba-e79f-4cdc-9e5a-719ffd2ae517
918	918	0	GBIF Germany	4f6826f2-4ff6-443d-b966-e6913bd24013	7129bc34-f762-11e1-a439-00145eb45e9a
1080	378	-702	GBIF Germany	4f6826f2-4ff6-443d-b966-e6913bd24013	712d6e6a-f762-11e1-a439-00145eb45e9a
6	6	0	GBIF Germany	4f6826f2-4ff6-443d-b966-e6913bd24013	7150be1a-f762-11e1-a439-00145eb45e9a
125	125	0	GBIF Germany	4f6826f2-4ff6-443d-b966-e6913bd24013	720bc188-f762-11e1-a439-00145eb45e9a
49	49	0	Plazi	ffb07bec-2d10-492d-9c37-361fe0b79427	7438332f-a925-43aa-b17f-059781bdfc12
6	6	0	GBIF Germany	4f6826f2-4ff6-443d-b966-e6913bd24013	743e1154-f762-11e1-a439-00145eb45e9a
113	113	0	Colombian Biodiversity Information System	7e865cba-7c46-417b-ade5-97f2cf5b7be0	74416b7e-51e0-4191-9758-d151e6989300
479	479	0	Colombian Biodiversity Information System	7e865cba-7c46-417b-ade5-97f2cf5b7be0	746dbba0-9a4c-4c0c-b462-fbced8436d42
27080	27080	0	National Biodiversity Network	d897a5b9-35ee-4232-94bd-b0bcaac003c2	7492ff6a-a1c7-4489-8c9c-31decfa78364
25	25	0	Plazi	ffb07bec-2d10-492d-9c37-361fe0b79427	74c501e2-be96-45ef-9f59-d3ea64b028c4
0	43	43	Plazi	ffb07bec-2d10-492d-9c37-361fe0b79427	778b8e9e-9010-4388-b049-5560cb26b544
2	2	0	GBIF Germany	4f6826f2-4ff6-443d-b966-e6913bd24013	78784672-f762-11e1-a439-00145eb45e9a
456	456	0	GBIF Portugal	673f7038-4262-4149-b753-5658a4e912f6	7885fbbf-45c6-41d1-8c09-a07409076030
255	255	0	GBIF Germany	4f6826f2-4ff6-443d-b966-e6913bd24013	79719c9a-f762-11e1-a439-00145eb45e9a
76	76	0	GBIF France	da44cd31-5901-4687-a106-6d1c7734ee3a	79b2d54f-b49a-4e38-80b2-85a41d16af53
57	57	0	GBIF Germany	4f6826f2-4ff6-443d-b966-e6913bd24013	79f4575c-f762-11e1-a439-00145eb45e9a
2	2	0	GBIF Germany	4f6826f2-4ff6-443d-b966-e6913bd24013	7aaa36a8-f762-11e1-a439-00145eb45e9a
13	13	0	GBIF Portugal	673f7038-4262-4149-b753-5658a4e912f6	7b84fe1d-42d0-439a-b60f-0b621f7ba93d
27681	27769	88	GBIF Germany	4f6826f2-4ff6-443d-b966-e6913bd24013	7b8964ea-f762-11e1-a439-00145eb45e9a
0	75	75	Plazi	ffb07bec-2d10-492d-9c37-361fe0b79427	7c3990d1-9460-4a35-9648-9941e9bc6de8
0	7	7	Plazi	ffb07bec-2d10-492d-9c37-361fe0b79427	7c649442-081b-4cea-ba92-98e6940c0b17
90	90	0	GBIF Germany	4f6826f2-4ff6-443d-b966-e6913bd24013	7d1ee000-f762-11e1-a439-00145eb45e9a
31	31	0	Participant Node Managers Committee	7f48e0c8-5c96-49ec-b972-30748e339115	7f0a89f6-46d2-4312-ac6e-f02278c4f1f7
368	368	0	GBIF Germany	4f6826f2-4ff6-443d-b966-e6913bd24013	7f3dac5e-f762-11e1-a439-00145eb45e9a
33	33	0	Plazi	ffb07bec-2d10-492d-9c37-361fe0b79427	8094be38-8ec7-4cd1-89b2-0173f551d554
2079	1404	-675	GBIF Germany	4f6826f2-4ff6-443d-b966-e6913bd24013	81639322-f762-11e1-a439-00145eb45e9a
367	367	0	GBIF Norway	4f829580-180d-46a9-9c87-ed8ec959b545	8167bb10-9d74-4d70-afea-778b87720307
2	2	0	Plazi	ffb07bec-2d10-492d-9c37-361fe0b79427	8219907b-ec76-4d13-8b37-2521fbae9acd
280	280	0	GBIF Germany	4f6826f2-4ff6-443d-b966-e6913bd24013	821c9b60-f762-11e1-a439-00145eb45e9a
299	299	0	Korean Biodiversity Information Facility	e0a1e772-0177-4800-94b4-2d023fe6cdf4	82fad3d0-f762-11e1-a439-00145eb45e9a
0	141	141	Ocean Biodiversity Information System	ba0670b9-4186-41e6-8e70-f9cb3065551a	841abf98-0efc-42d7-a78c-78a7f85fe276
0	114	114	Plazi	ffb07bec-2d10-492d-9c37-361fe0b79427	84789f3d-fe89-4207-bc24-6be53dfbbe4c
321	321	0	U.S. Geological Survey	8618c64a-93e0-4300-b546-7249e5148ed2	85339498-f762-11e1-a439-00145eb45e9a
3	3	0	Plazi	ffb07bec-2d10-492d-9c37-361fe0b79427	8553f4e1-4a3e-4d1f-9c6c-49344c313bd3
1539	1539	0	GBIF Japan	db5705aa-6a6e-42f1-8942-d77b9f4896ea	8619a294-f762-11e1-a439-00145eb45e9a
133152	133152	0	GBIF France	da44cd31-5901-4687-a106-6d1c7734ee3a	869b574f-23eb-4575-a771-6ffd480dcdab
9	9	0	GBIF France	da44cd31-5901-4687-a106-6d1c7734ee3a	871099ec-f027-461d-a8af-7059898f759b
14192	12552	-1640	GBIF Germany	4f6826f2-4ff6-443d-b966-e6913bd24013	87220b2c-f762-11e1-a439-00145eb45e9a
21	9	-12	GBIF Germany	4f6826f2-4ff6-443d-b966-e6913bd24013	877258ca-f762-11e1-a439-00145eb45e9a
29	15	-14	GBIF Germany	4f6826f2-4ff6-443d-b966-e6913bd24013	87861ebe-f762-11e1-a439-00145eb45e9a
2434	1852	-582	GBIF Germany	4f6826f2-4ff6-443d-b966-e6913bd24013	8869407c-f762-11e1-a439-00145eb45e9a
352	352	0	GBIF Germany	4f6826f2-4ff6-443d-b966-e6913bd24013	8a4a00d4-f762-11e1-a439-00145eb45e9a
0	1	1	Plazi	ffb07bec-2d10-492d-9c37-361fe0b79427	8b5afb3d-92bd-4e36-8c86-675537e88d70
14	14	0	GBIF Germany	4f6826f2-4ff6-443d-b966-e6913bd24013	8bdb6226-f762-11e1-a439-00145eb45e9a
684	502	-182	GBIF Germany	4f6826f2-4ff6-443d-b966-e6913bd24013	8c3305bc-f762-11e1-a439-00145eb45e9a
0	43	43	Plazi	ffb07bec-2d10-492d-9c37-361fe0b79427	8cc293b1-7429-40f0-a5a3-912f2730df83
222	222	0	GBIF Germany	4f6826f2-4ff6-443d-b966-e6913bd24013	8d77b10c-f762-11e1-a439-00145eb45e9a
25	18	-7	GBIF Germany	4f6826f2-4ff6-443d-b966-e6913bd24013	8eac9ed4-f762-11e1-a439-00145eb45e9a
583	243	-340	GBIF Germany	4f6826f2-4ff6-443d-b966-e6913bd24013	90f9a72c-f762-11e1-a439-00145eb45e9a
1500	630	-870	GBIF Germany	4f6826f2-4ff6-443d-b966-e6913bd24013	91a4cb7a-f762-11e1-a439-00145eb45e9a
14	14	0	GBIF Germany	4f6826f2-4ff6-443d-b966-e6913bd24013	92aef4dc-f762-11e1-a439-00145eb45e9a
156	155	-1	GBIF Germany	4f6826f2-4ff6-443d-b966-e6913bd24013	93705172-f762-11e1-a439-00145eb45e9a
96	96	0	GBIF Germany	4f6826f2-4ff6-443d-b966-e6913bd24013	94fafc86-f762-11e1-a439-00145eb45e9a
19	19	0	GBIF Germany	4f6826f2-4ff6-443d-b966-e6913bd24013	95ad9c74-f762-11e1-a439-00145eb45e9a
477	477	0	GBIF France	da44cd31-5901-4687-a106-6d1c7734ee3a	9609b469-4e5f-44c8-9baa-c2139a952ede
1218	1266	48	GBIF Germany	4f6826f2-4ff6-443d-b966-e6913bd24013	966ef9aa-f762-11e1-a439-00145eb45e9a
55	55	0	GBIF Spain	1f94b3ca-9345-4d65-afe2-4bace93aa0fe	971d3f64-4db4-48b3-8000-234399e7d598
3	3	0	Plazi	ffb07bec-2d10-492d-9c37-361fe0b79427	999351db-f419-48f9-8488-22ee9b484a96
142	142	0	GBIF Germany	4f6826f2-4ff6-443d-b966-e6913bd24013	9b03f743-0c3c-4dbf-bd3b-742391502292
9	9	0	Plazi	ffb07bec-2d10-492d-9c37-361fe0b79427	9b676062-411e-4168-bce7-473f0de29b2e
122	122	0	South African Biodiversity Information Facility	7190b835-4e86-4b6e-85c1-19cc6677c250	9ffa8eaa-191a-48bf-82f3-2f9cdfa7baa4
1889	1889	0	Biodiversity Information System of Mexico	b324e8e9-9a4c-44fa-8f1a-7f39ea7ab576	a1d63dd1-5456-450c-afc8-25a62ffec50e
24293	24293	0	U.S. Geological Survey	8618c64a-93e0-4300-b546-7249e5148ed2	a6e35034-fca7-457f-888b-e6d97030dee5
0	2	2	Plazi	ffb07bec-2d10-492d-9c37-361fe0b79427	a949fd58-a15f-4265-badf-b2d18d3a64b4
3	3	0	Plazi	ffb07bec-2d10-492d-9c37-361fe0b79427	aa1813a9-5f54-4698-aee9-60b70260bde0
77	77	0	GBIF France	da44cd31-5901-4687-a106-6d1c7734ee3a	aa275853-0ae3-49a1-a045-a7e5798fc642
53	53	0	National Biodiversity Network	d897a5b9-35ee-4232-94bd-b0bcaac003c2	aa71f4bb-44a4-4eea-bf91-03a1bb869672
25	25	0	GBIF New Zealand	4f9fd726-20dd-445e-89a1-8ed93792276f	aa720aa9-92ea-43e9-bdf3-26714c9b3271
8	8	0	Plazi	ffb07bec-2d10-492d-9c37-361fe0b79427	b1996337-1296-4a09-aa55-1c4fec961d21
273002	273002	0	Netherlands Biodiversity Information Facility	0909d601-bda2-42df-9e63-a6d51847ebce	b3a30c93-04fb-4a2e-9016-0ac99005b48c
0	11	11	Ocean Biodiversity Information System	ba0670b9-4186-41e6-8e70-f9cb3065551a	b7a6ef09-2f43-43e9-a1c5-07b683bbf223
1	1	0	Plazi	ffb07bec-2d10-492d-9c37-361fe0b79427	b8fc3818-d1f2-4852-b430-7de4ccb9fc50
1333	1333	0	Biodiversity Information System of Mexico	b324e8e9-9a4c-44fa-8f1a-7f39ea7ab576	b9402e70-bc30-4f6e-a67c-581cfb056b7f
11	11	0	National Biodiversity Network	d897a5b9-35ee-4232-94bd-b0bcaac003c2	b95ca904-3540-49b2-bb24-9166a96c6aad
3	3	0	Plazi	ffb07bec-2d10-492d-9c37-361fe0b79427	bcf91d01-0d97-4d76-b62f-3e61c60c0f26
77	77	0	GBIF Finland	dd514216-5c7c-45f3-910d-797424cb5be6	bd484fc9-1d70-474e-b019-0a6cb32c19dc
382	382	0	GBIF Madagascar	2dbfc5c5-51b5-4494-9dfc-4d3f013a3b64	bddfce7e-8a19-4ee3-825c-b3d6e9e2220d
2	2	0	Plazi	ffb07bec-2d10-492d-9c37-361fe0b79427	be7bbb62-d595-4b5b-9483-9fb660eabc86
1197	1197	0	GBIF Finland	dd514216-5c7c-45f3-910d-797424cb5be6	bfb19595-de2a-409d-bdcf-2e2e339a8c43
243	243	0	National Biodiversity Network	d897a5b9-35ee-4232-94bd-b0bcaac003c2	c01ddb0f-b7e4-4723-b630-7e0c2217230e
235	235	0	National Biodiversity Data Centre	422b00b2-6c94-4bb6-976b-c359916efdb8	c5b050b0-c7b8-11de-b279-9b15c0021cf7
121778	121778	0	GBIF France	da44cd31-5901-4687-a106-6d1c7734ee3a	c6d289cc-62ee-46e1-9367-515092eed533
0	47	47	Plazi	ffb07bec-2d10-492d-9c37-361fe0b79427	c80d3ec2-e33a-4a11-80e3-f2fafc952695
8	8	0	Plazi	ffb07bec-2d10-492d-9c37-361fe0b79427	cb2db64a-2fde-423c-982f-3d9d8978fff2
87	79	-8	GBIF Germany	4f6826f2-4ff6-443d-b966-e6913bd24013	cdcd0c41-82ab-48d6-beba-db58bd6a2e95
45	45	0	Plazi	ffb07bec-2d10-492d-9c37-361fe0b79427	ce1210d0-2c8f-434d-8069-ce3c5e53c23d
102	102	0	GBIF Sweden	a0b3be64-6525-4387-ac67-a499950f92e1	ce76f3b3-7114-400f-9386-a27ea2f3f519
0	30	30	Plazi	ffb07bec-2d10-492d-9c37-361fe0b79427	d17d6f73-dd94-41b3-bbe8-659244368357
22548	22606	58	GBIF Brazil	cdc9736d-5ff7-4ece-9959-3c744360cdb3	d1d43c63-6b44-472d-8369-8293eca75991
221	221	0	Plazi	ffb07bec-2d10-492d-9c37-361fe0b79427	d33a3344-7f9a-4028-8569-2b7643d9b43f
1218925	1218925	0	GBIF Norway	4f829580-180d-46a9-9c87-ed8ec959b545	d34ed8a4-d3cb-473c-a11c-79c5fec4d649
12273	12273	0	U.S. Geological Survey	8618c64a-93e0-4300-b546-7249e5148ed2	d587c7e5-d442-437a-a6d7-d1a78ecf2300
0	9	9	Plazi	ffb07bec-2d10-492d-9c37-361fe0b79427	d6afdfcf-5b8e-4630-bbf1-0efe5d3fdc3c
2	2	0	Plazi	ffb07bec-2d10-492d-9c37-361fe0b79427	d7250053-37e8-456d-816f-aab3878a05cc
4333	4333	0	Participant Node Managers Committee	7f48e0c8-5c96-49ec-b972-30748e339115	d98c3efe-983e-455f-8fdb-ccc76c7959c3
0	8	8	Plazi	ffb07bec-2d10-492d-9c37-361fe0b79427	d9a2f10f-7a8b-42b8-8b07-2495ab5b25ee
12	12	0	Participant Node Managers Committee	7f48e0c8-5c96-49ec-b972-30748e339115	d9ce66a5-1e90-49a9-bb8a-d54b25b07f99
16	16	0	Plazi	ffb07bec-2d10-492d-9c37-361fe0b79427	d9fd72b0-fe43-4296-92dc-dbcc1860279f
14	14	0	Plazi	ffb07bec-2d10-492d-9c37-361fe0b79427	dc5f418e-e39b-4763-b6e0-8b53a048f678
906	906	0	National Biodiversity Network	d897a5b9-35ee-4232-94bd-b0bcaac003c2	e0c4e2df-b987-45a6-b1dd-b3f50328f72a
16	16	0	Plazi	ffb07bec-2d10-492d-9c37-361fe0b79427	e1cd4661-3d65-4dce-bdbc-757b73e88fde
0	631	631	Plazi	ffb07bec-2d10-492d-9c37-361fe0b79427	e20afa6a-b9b0-40d6-922a-349da64e1a5b
4	4	0	Plazi	ffb07bec-2d10-492d-9c37-361fe0b79427	e21738dc-49f0-49ad-b3cf-2118063174f8
0	4808	4808	Ocean Biodiversity Information System	ba0670b9-4186-41e6-8e70-f9cb3065551a	e4bd9ece-92b4-4f3a-821c-4f5979e52269
517	517	0	Biodiversity Information System of Mexico	b324e8e9-9a4c-44fa-8f1a-7f39ea7ab576	e4fecf61-a790-4b0d-aaa1-6df408b57bd8
365	365	0	Belgian Biodiversity Platform	fb11cfe1-ebc3-45af-9159-17d9fddbcdac	e55a4257-819d-48e2-a0af-83c3448bc0ee
701	701	0	GBIF France	da44cd31-5901-4687-a106-6d1c7734ee3a	e666297b-910b-4f75-860b-9b7adf5e8c5c
20225	20225	0	GBIF France	da44cd31-5901-4687-a106-6d1c7734ee3a	ef2605dc-a8f4-4ce5-a12f-4b5112a56a36
0	153	153	Ocean Biodiversity Information System	ba0670b9-4186-41e6-8e70-f9cb3065551a	f0687f9a-f45e-4913-8977-0ec4a57cdebf
0	49	49	Plazi	ffb07bec-2d10-492d-9c37-361fe0b79427	f8284e18-7e9f-4063-b949-20e53177298e
0	60	60	Colombian Biodiversity Information System	7e865cba-7c46-417b-ade5-97f2cf5b7be0	fc2c07b7-59d4-4e06-84cb-9a9eec3c0b5d
0	4	4	Participant Node Managers Committee	7f48e0c8-5c96-49ec-b972-30748e339115	fd896983-7ad0-45cf-b298-2c06a7c87a44
2	2	0	Plazi	ffb07bec-2d10-492d-9c37-361fe0b79427	fdf27046-d373-44fc-9e95-38707d602995
80	80	0	GBIF France	da44cd31-5901-4687-a106-6d1c7734ee3a	02ab589f-d822-44c5-9dc4-cca38e8e9823
52	52	0	Plazi	ffb07bec-2d10-492d-9c37-361fe0b79427	05d8180d-db62-432e-b21e-bd45dd3dc4aa
0	15	15	Plazi	ffb07bec-2d10-492d-9c37-361fe0b79427	06c2d3e4-ac6b-4893-b921-594d3f401327
4	4	0	Plazi	ffb07bec-2d10-492d-9c37-361fe0b79427	07f301b9-ea8c-4ec9-93a8-c8f513e317f3
1067	1067	0	Colombian Biodiversity Information System	7e865cba-7c46-417b-ade5-97f2cf5b7be0	0835b6d6-ee6f-4c7a-86e7-81a95c313632
13	13	0	Plazi	ffb07bec-2d10-492d-9c37-361fe0b79427	094719b5-dc14-45f2-bb78-c437b5445efb
13912	13912	0	GBIF Spain	1f94b3ca-9345-4d65-afe2-4bace93aa0fe	09547bfa-4e56-4041-83e6-0c0fecd78abb
19	19	0	Participant Node Managers Committee	7f48e0c8-5c96-49ec-b972-30748e339115	0a3811d0-cc1d-4217-a818-15b754280cea
11	11	0	Plazi	ffb07bec-2d10-492d-9c37-361fe0b79427	0b0c3c61-0218-413d-ba7c-993a800621e8
0	408	408	GBIF Spain	1f94b3ca-9345-4d65-afe2-4bace93aa0fe	105d66e9-de9a-4e2e-8469-537aa59754c6
1	1	0	Plazi	ffb07bec-2d10-492d-9c37-361fe0b79427	120b5532-55b8-4edc-8a02-f32b3bb5a6fa
356	356	0	Colombian Biodiversity Information System	7e865cba-7c46-417b-ade5-97f2cf5b7be0	1324ac5a-4bc8-4fe2-853f-d091bbf97107
318	318	0	GBIF France	da44cd31-5901-4687-a106-6d1c7734ee3a	16010a07-42ca-4ae8-827a-7497ab6483a6
9	9	0	Plazi	ffb07bec-2d10-492d-9c37-361fe0b79427	18da1b37-b84c-4edf-8fd5-554662866715
0	9	9	Plazi	ffb07bec-2d10-492d-9c37-361fe0b79427	199e9ad5-4332-4ceb-a3c5-4e12d5ac0f40
3606	3606	0	Ocean Biodiversity Information System	ba0670b9-4186-41e6-8e70-f9cb3065551a	1a0de42c-8a6c-4ed4-b96a-6527ff14cdfa
183	67	-116	GBIF Germany	4f6826f2-4ff6-443d-b966-e6913bd24013	1a7d640c-7025-472f-a30f-e31465e5b1c3
7	7	0	Plazi	ffb07bec-2d10-492d-9c37-361fe0b79427	1c31a941-a1c3-40a3-ae8c-3ed33e41942b
183	183	0	National Biodiversity Network	d897a5b9-35ee-4232-94bd-b0bcaac003c2	1d3e860f-1e91-4c47-91be-806a1a962aa9
770	770	0	GBIF Norway	4f829580-180d-46a9-9c87-ed8ec959b545	1e3a86ae-127b-4824-83bd-ef5af698f9f9
0	4	4	Plazi	ffb07bec-2d10-492d-9c37-361fe0b79427	1ff1e1ee-8a21-4026-842d-4a973c995bfc
0	3	3	Plazi	ffb07bec-2d10-492d-9c37-361fe0b79427	2126fc1c-7ea1-45a8-a22a-0909e34f3259
29	29	0	Colombian Biodiversity Information System	7e865cba-7c46-417b-ade5-97f2cf5b7be0	23f4da21-db6b-445d-b2ac-df931df7e112
1374	1374	0	GBIF Japan	db5705aa-6a6e-42f1-8942-d77b9f4896ea	2488cd13-4f80-479c-ae54-257de312054e
101	101	0	Plazi	ffb07bec-2d10-492d-9c37-361fe0b79427	24ae3650-4b27-4fcb-9f51-1787fd8aa2a4
0	4	4	Plazi	ffb07bec-2d10-492d-9c37-361fe0b79427	263b320e-a000-4a8f-acfe-b21312a40d43
5	5	0	Plazi	ffb07bec-2d10-492d-9c37-361fe0b79427	2b50a048-8eb3-4ef4-b2ad-fb21cc83c29c
242	242	0	Biodiversity Information System of Mexico	b324e8e9-9a4c-44fa-8f1a-7f39ea7ab576	2b568c96-1792-4c02-8709-569f520ad654
151	151	0	Plazi	ffb07bec-2d10-492d-9c37-361fe0b79427	2b77aabb-48b0-4b25-b508-06776e6231e6
347	347	0	Biodiversity Information System of Mexico	b324e8e9-9a4c-44fa-8f1a-7f39ea7ab576	2de77161-4cfb-4e4f-8e35-ee909878bc4b
1	1	0	Plazi	ffb07bec-2d10-492d-9c37-361fe0b79427	2fefb547-9060-4359-8249-412395afcfe9
0	70	70	Plazi	ffb07bec-2d10-492d-9c37-361fe0b79427	2ffdac24-b2ae-448c-b88e-b4f0dd1a9547
37965	38130	165	Netherlands Biodiversity Information Facility	0909d601-bda2-42df-9e63-a6d51847ebce	306f61f2-9ff0-404e-8aa6-a525a7fae369
9492	9492	0	GBIF France	da44cd31-5901-4687-a106-6d1c7734ee3a	30ba0b42-991d-47d8-b553-940082bee207
9	9	0	Plazi	ffb07bec-2d10-492d-9c37-361fe0b79427	315f6657-6f59-4a2e-8f55-3181b3453ee6
4	4	0	Plazi	ffb07bec-2d10-492d-9c37-361fe0b79427	32d9d6d0-0dad-4aaa-9bf0-07afb423a1db
69	69	0	GBIF France	da44cd31-5901-4687-a106-6d1c7734ee3a	33d3a923-4a27-4254-abd7-50fbc6037cae
188	188	0	Plazi	ffb07bec-2d10-492d-9c37-361fe0b79427	349f1d0e-6dfc-443a-998d-0322ea62b866
0	5	5	Plazi	ffb07bec-2d10-492d-9c37-361fe0b79427	37a4119c-488d-4591-b0b2-5652396ce549
711	711	0	GBIF Norway	4f829580-180d-46a9-9c87-ed8ec959b545	39657c3a-e1ca-4a80-89cd-2f10356dfe83
2	2	0	Plazi	ffb07bec-2d10-492d-9c37-361fe0b79427	3e326079-e0cd-4a5f-9b58-5d24eccb331b
17	17	0	National Biodiversity Network	d897a5b9-35ee-4232-94bd-b0bcaac003c2	3f942fdc-5ae7-42bd-b09b-9dc083725bc4
9	9	0	Plazi	ffb07bec-2d10-492d-9c37-361fe0b79427	46365bee-ee24-435e-bb7c-5a3cf5918de1
816	816	0	GBIF Madagascar	2dbfc5c5-51b5-4494-9dfc-4d3f013a3b64	4da0200f-66d3-4442-a71c-1a9461c86e87
5	5	0	Biodiversity Information System of Mexico	b324e8e9-9a4c-44fa-8f1a-7f39ea7ab576	4f2ed7cc-d225-4db8-8fc0-d33fec7e0b92
14556	14556	0	GBIF France	da44cd31-5901-4687-a106-6d1c7734ee3a	50de8011-5291-4689-ae08-f35d2d2c17e2
0	4946	4946	Canada Biodiversity Information Facility	8f83fc96-c966-4126-83f7-bf044dc49efa	51ccea48-aefe-443d-9229-1519d73bea35
0	6	6	Plazi	ffb07bec-2d10-492d-9c37-361fe0b79427	526ef1ae-8c32-4a4f-8009-ed2d571dfac9
0	4184	4184	Colombian Biodiversity Information System	7e865cba-7c46-417b-ade5-97f2cf5b7be0	52ef3d4c-d10d-416c-8d40-11d1dc33e4a1
20585	20585	0	U.S. Geological Survey	8618c64a-93e0-4300-b546-7249e5148ed2	53e9eca5-6831-4a43-a109-130feecfcd9c
197	197	0	Plazi	ffb07bec-2d10-492d-9c37-361fe0b79427	5a990a21-33cb-4a4b-b658-b29aea9e40af
3	3	0	Plazi	ffb07bec-2d10-492d-9c37-361fe0b79427	5eff0024-3ffb-46dc-99bc-795de27fa33b
20096	20096	0	GBIF France	da44cd31-5901-4687-a106-6d1c7734ee3a	607e692e-a6af-4721-acf0-61c91950b554
150	150	0	GBIF Germany	4f6826f2-4ff6-443d-b966-e6913bd24013	610eba84-f762-11e1-a439-00145eb45e9a
127	127	0	GBIF Germany	4f6826f2-4ff6-443d-b966-e6913bd24013	612f67d4-f762-11e1-a439-00145eb45e9a
145	145	0	GBIF Germany	4f6826f2-4ff6-443d-b966-e6913bd24013	61ada4b4-f762-11e1-a439-00145eb45e9a
98	98	0	GBIF Germany	4f6826f2-4ff6-443d-b966-e6913bd24013	623ecebc-f762-11e1-a439-00145eb45e9a
0	3	3	Plazi	ffb07bec-2d10-492d-9c37-361fe0b79427	62f9b724-d048-4434-85ee-29e9fdfb42b1
40	40	0	GBIF Germany	4f6826f2-4ff6-443d-b966-e6913bd24013	6316e895-3a42-47ee-8e6e-45b7ce4ab465
126	126	0	GBIF Germany	4f6826f2-4ff6-443d-b966-e6913bd24013	63e5adc6-f762-11e1-a439-00145eb45e9a
28	28	0	GBIF Germany	4f6826f2-4ff6-443d-b966-e6913bd24013	64cefbca-f762-11e1-a439-00145eb45e9a
529	529	0	GBIF Germany	4f6826f2-4ff6-443d-b966-e6913bd24013	654cef62-f762-11e1-a439-00145eb45e9a
4	4	0	GBIF France	da44cd31-5901-4687-a106-6d1c7734ee3a	66f0cad3-3f24-48ca-a82e-dedd7e20bb83
123	123	0	GBIF Germany	4f6826f2-4ff6-443d-b966-e6913bd24013	68354f80-f762-11e1-a439-00145eb45e9a
98	98	0	GBIF Germany	4f6826f2-4ff6-443d-b966-e6913bd24013	69a2325c-f762-11e1-a439-00145eb45e9a
79	79	0	GBIF Germany	4f6826f2-4ff6-443d-b966-e6913bd24013	69cee16c-f762-11e1-a439-00145eb45e9a
151	151	0	GBIF Germany	4f6826f2-4ff6-443d-b966-e6913bd24013	6a090d74-f762-11e1-a439-00145eb45e9a
23	11	-12	GBIF Germany	4f6826f2-4ff6-443d-b966-e6913bd24013	6a449baa-f762-11e1-a439-00145eb45e9a
4	4	0	GBIF Germany	4f6826f2-4ff6-443d-b966-e6913bd24013	6b6754aa-f762-11e1-a439-00145eb45e9a
41646	65036	23390	GBIF Japan	db5705aa-6a6e-42f1-8942-d77b9f4896ea	6c4f18a9-1bb7-401b-902c-037d0ab6bb2a
42	42	0	GBIF Germany	4f6826f2-4ff6-443d-b966-e6913bd24013	6e280b1c-6be0-4bac-bd3e-db694a2540f6
24	24	0	GBIF Germany	4f6826f2-4ff6-443d-b966-e6913bd24013	6feeb22a-f762-11e1-a439-00145eb45e9a
489	489	0	GBIF Germany	4f6826f2-4ff6-443d-b966-e6913bd24013	70a319a4-f762-11e1-a439-00145eb45e9a
478	478	0	GBIF France	da44cd31-5901-4687-a106-6d1c7734ee3a	71415c4d-35c3-4dd4-be8a-bed8be0bb33c
265	265	0	GBIF Germany	4f6826f2-4ff6-443d-b966-e6913bd24013	717269fc-f762-11e1-a439-00145eb45e9a
998	998	0	GBIF France	da44cd31-5901-4687-a106-6d1c7734ee3a	718cce1a-5345-468e-bf5d-8bb1ea314c22
0	2	2	Plazi	ffb07bec-2d10-492d-9c37-361fe0b79427	728adba1-ad5a-4ffc-a344-102cd25050a8
244	244	0	GBIF Germany	4f6826f2-4ff6-443d-b966-e6913bd24013	7401ea26-f762-11e1-a439-00145eb45e9a
395	395	0	GBIF Germany	4f6826f2-4ff6-443d-b966-e6913bd24013	747de996-f762-11e1-a439-00145eb45e9a
566	566	0	GBIF Germany	4f6826f2-4ff6-443d-b966-e6913bd24013	74d8f8b8-f762-11e1-a439-00145eb45e9a
95	95	0	GBIF Germany	4f6826f2-4ff6-443d-b966-e6913bd24013	74e36bc2-f762-11e1-a439-00145eb45e9a
0	5	5	Participant Node Managers Committee	7f48e0c8-5c96-49ec-b972-30748e339115	77bdc7dd-44c4-4240-81bc-4e83fba8edd1
3	3	0	GBIF Germany	4f6826f2-4ff6-443d-b966-e6913bd24013	789e8c9c-f762-11e1-a439-00145eb45e9a
31	31	0	GBIF Germany	4f6826f2-4ff6-443d-b966-e6913bd24013	78b5bbba-f762-11e1-a439-00145eb45e9a
14	14	0	GBIF Germany	4f6826f2-4ff6-443d-b966-e6913bd24013	79323758-f762-11e1-a439-00145eb45e9a
908	908	0	Polish Biodiversity Information Network	2618bfdf-e194-4911-a241-80db3107bc51	794d92d0-bdcb-11dc-9a6c-b8a03c50a862
275	262	-13	GBIF Germany	4f6826f2-4ff6-443d-b966-e6913bd24013	798070c6-f762-11e1-a439-00145eb45e9a
6	6	0	GBIF Germany	4f6826f2-4ff6-443d-b966-e6913bd24013	7a6df76a-f762-11e1-a439-00145eb45e9a
11	11	0	Plazi	ffb07bec-2d10-492d-9c37-361fe0b79427	7b43fe29-e505-4e3c-867c-086153fb3514
2427	2427	0	Atlas of Living Australia	4a6f1b71-969e-4fc5-a693-282b05e1220c	7b714568-f762-11e1-a439-00145eb45e9a
0	13442	13442	Ocean Biodiversity Information System	ba0670b9-4186-41e6-8e70-f9cb3065551a	7ba44a6f-e031-4c43-9c7c-d8de11263558
5	5	0	Plazi	ffb07bec-2d10-492d-9c37-361fe0b79427	7bc0a9bd-188b-4a9c-a59e-e1ca0d7744a9
9	9	0	GBIF Germany	4f6826f2-4ff6-443d-b966-e6913bd24013	7cd975ec-f762-11e1-a439-00145eb45e9a
8	8	0	Plazi	ffb07bec-2d10-492d-9c37-361fe0b79427	7cfca4c9-68c7-4159-8366-eff2f1d07e30
830	830	0	GBIF Germany	4f6826f2-4ff6-443d-b966-e6913bd24013	7eaf1520-f762-11e1-a439-00145eb45e9a
606	606	0	Biodiversity Information System of Mexico	b324e8e9-9a4c-44fa-8f1a-7f39ea7ab576	8074177a-f762-11e1-a439-00145eb45e9a
20287	20293	6	U.S. Geological Survey	8618c64a-93e0-4300-b546-7249e5148ed2	80ebe7f9-00ee-4fe3-80f6-303729cf5bac
5107	5307	200	GBIF Japan	db5705aa-6a6e-42f1-8942-d77b9f4896ea	811d24dc-f762-11e1-a439-00145eb45e9a
32	32	0	GBIF Germany	4f6826f2-4ff6-443d-b966-e6913bd24013	82115692-f762-11e1-a439-00145eb45e9a
1995	1995	0	GBIF Germany	4f6826f2-4ff6-443d-b966-e6913bd24013	85c667c8-f762-11e1-a439-00145eb45e9a
736	395	-341	Atlas of Living Australia	4a6f1b71-969e-4fc5-a693-282b05e1220c	8600992a-f762-11e1-a439-00145eb45e9a
546	546	0	Biodiversity Information System of Mexico	b324e8e9-9a4c-44fa-8f1a-7f39ea7ab576	88435d97-186e-4435-98a6-52502aef0a79
14	14	0	Plazi	ffb07bec-2d10-492d-9c37-361fe0b79427	89217b4b-720f-409c-9b30-69c6b7332391
1	1	0	Plazi	ffb07bec-2d10-492d-9c37-361fe0b79427	896a6777-2263-4654-ad64-a31447db355b
210	210	0	GBIF Germany	4f6826f2-4ff6-443d-b966-e6913bd24013	8a35b41c-f762-11e1-a439-00145eb45e9a
43	43	0	GBIF Germany	4f6826f2-4ff6-443d-b966-e6913bd24013	8a563c14-f762-11e1-a439-00145eb45e9a
6	2	-4	GBIF Germany	4f6826f2-4ff6-443d-b966-e6913bd24013	8cff3fe2-f762-11e1-a439-00145eb45e9a
0	3	3	Ocean Biodiversity Information System	ba0670b9-4186-41e6-8e70-f9cb3065551a	8d4c0ad3-84b2-4ca2-b041-5a6e5d357148
509	509	0	GBIF Germany	4f6826f2-4ff6-443d-b966-e6913bd24013	8d80cc92-f762-11e1-a439-00145eb45e9a
0	6	6	Plazi	ffb07bec-2d10-492d-9c37-361fe0b79427	8ea0a922-0437-483c-abc9-4d008c950628
1	1	0	Plazi	ffb07bec-2d10-492d-9c37-361fe0b79427	8efe3297-2365-402f-91af-ef2005961c9f
27	25	-2	GBIF Germany	4f6826f2-4ff6-443d-b966-e6913bd24013	8f3430b0-f762-11e1-a439-00145eb45e9a
115	109	-6	GBIF Germany	4f6826f2-4ff6-443d-b966-e6913bd24013	8f488254-f762-11e1-a439-00145eb45e9a
783	216	-567	GBIF Germany	4f6826f2-4ff6-443d-b966-e6913bd24013	8f928aa2-f762-11e1-a439-00145eb45e9a
0	225	225	Ocean Biodiversity Information System	ba0670b9-4186-41e6-8e70-f9cb3065551a	90284317-6f12-4aaa-a997-b66fad9edcfa
530	530	0	GBIF Germany	4f6826f2-4ff6-443d-b966-e6913bd24013	92a29688-f762-11e1-a439-00145eb45e9a
1460	548	-912	GBIF Germany	4f6826f2-4ff6-443d-b966-e6913bd24013	93056d44-f762-11e1-a439-00145eb45e9a
2214	2214	0	GBIF Germany	4f6826f2-4ff6-443d-b966-e6913bd24013	93150678-f762-11e1-a439-00145eb45e9a
3818	3978	160	National Biodiversity Network	d897a5b9-35ee-4232-94bd-b0bcaac003c2	932829c3-7c7b-4910-a56c-2ec4a1db8045
384	208	-176	GBIF Germany	4f6826f2-4ff6-443d-b966-e6913bd24013	9360466a-f762-11e1-a439-00145eb45e9a
124	124	0	GBIF Germany	4f6826f2-4ff6-443d-b966-e6913bd24013	93b1b68a-f762-11e1-a439-00145eb45e9a
7	7	0	GBIF Germany	4f6826f2-4ff6-443d-b966-e6913bd24013	93dc51e2-f762-11e1-a439-00145eb45e9a
187	187	0	GBIF Germany	4f6826f2-4ff6-443d-b966-e6913bd24013	945f854e-f762-11e1-a439-00145eb45e9a
0	1	1	Plazi	ffb07bec-2d10-492d-9c37-361fe0b79427	948f1b6b-8598-4084-84c3-dee8c828027e
261	261	0	GBIF Germany	4f6826f2-4ff6-443d-b966-e6913bd24013	94cb2ad6-3ecc-4725-9ebe-b22af97749d1
119	119	0	GBIF Portugal	673f7038-4262-4149-b753-5658a4e912f6	97b22be7-a3a1-45d7-ab42-dd2b2260608c
429	429	0	Colombian Biodiversity Information System	7e865cba-7c46-417b-ade5-97f2cf5b7be0	a1106727-5ec4-473e-9e3e-c8311ddbdddf
112	112	0	Atlas of Living Australia	4a6f1b71-969e-4fc5-a693-282b05e1220c	a5fd2bf1-fcba-4ea9-8edb-7b2421ad4c38
79	79	0	Participant Node Managers Committee	7f48e0c8-5c96-49ec-b972-30748e339115	a7c6ec70-665e-4898-86d5-76d43ab9fa69
0	1	1	Plazi	ffb07bec-2d10-492d-9c37-361fe0b79427	a863d26e-f20f-45f2-836e-7f06305aa3f3
0	2	2	Plazi	ffb07bec-2d10-492d-9c37-361fe0b79427	a9abd94f-9c4c-46d4-80eb-b6e0a010f38b
256	256	0	Plazi	ffb07bec-2d10-492d-9c37-361fe0b79427	ac8dcfb3-4bee-4e7e-b549-a7a34d295867
37	37	0	Plazi	ffb07bec-2d10-492d-9c37-361fe0b79427	b2465730-6237-4a14-a98d-7fd2d1096cb0
0	66	66	Ocean Biodiversity Information System	ba0670b9-4186-41e6-8e70-f9cb3065551a	b7d18922-ab57-4c29-891b-142a6977f638
22	22	0	Plazi	ffb07bec-2d10-492d-9c37-361fe0b79427	b9df25d5-5a06-4650-ac8b-e5f1e4bbe929
8965	8965	0	National Biodiversity Data Centre	422b00b2-6c94-4bb6-976b-c359916efdb8	ba0b34a0-c7b8-11de-b279-f12cadb93607
143	143	0	Ocean Biodiversity Information System	ba0670b9-4186-41e6-8e70-f9cb3065551a	ba1e0dc3-5904-43d8-8a27-874dd4079698
2	2	0	Plazi	ffb07bec-2d10-492d-9c37-361fe0b79427	c26e3746-2064-4f3a-b080-0da987427e4c
0	19	19	Ocean Biodiversity Information System	ba0670b9-4186-41e6-8e70-f9cb3065551a	c3f135b5-bb69-4e56-9fcc-3b570a76f9b0
0	8142	8142	U.S. Geological Survey	8618c64a-93e0-4300-b546-7249e5148ed2	c45bba0f-28ea-4166-b519-ae04673541f4
60	60	0	Plazi	ffb07bec-2d10-492d-9c37-361fe0b79427	c80bd38d-5790-4da4-9008-59055a4add8f
0	5589	5589	Ocean Biodiversity Information System	ba0670b9-4186-41e6-8e70-f9cb3065551a	c8dd0161-7246-4c14-b205-fd82120df8de
0	370	370	Colombian Biodiversity Information System	7e865cba-7c46-417b-ade5-97f2cf5b7be0	c9c73966-aedc-489e-b2ec-6cd34eca64e7
10	10	0	Plazi	ffb07bec-2d10-492d-9c37-361fe0b79427	ca5660a9-f60b-4400-a06d-1be9645b3688
1	1	0	Plazi	ffb07bec-2d10-492d-9c37-361fe0b79427	caaf2fad-9aaf-4335-a81b-81458afd1006
110866	110866	0	National Biodiversity Network	d897a5b9-35ee-4232-94bd-b0bcaac003c2	cbd94c94-02ae-4c40-b5b5-ec7221f0482b
245	245	0	Plazi	ffb07bec-2d10-492d-9c37-361fe0b79427	cd2abe34-b1ec-44ad-8c31-a7689817db77
797	797	0	GBIF France	da44cd31-5901-4687-a106-6d1c7734ee3a	cdc314d3-bd48-4446-97ba-acb7d5667b43
441	441	0	GBIF France	da44cd31-5901-4687-a106-6d1c7734ee3a	d2392de6-1c56-4814-98cd-010c2be1cc45
6330	6330	0	Biodiversity Information System of Mexico	b324e8e9-9a4c-44fa-8f1a-7f39ea7ab576	d6be921e-a764-4fb6-b208-0665e87d5120
0	21559	21559	GBIF Estonia	2c11b821-d22b-4c64-8cd3-c1578173b129	d74890a5-0979-4413-8914-a587e4ece7e7
297	297	0	Participant Node Managers Committee	7f48e0c8-5c96-49ec-b972-30748e339115	d88c33a5-2534-4069-bdd2-a071029ef44c
716	716	0	GBIF France	da44cd31-5901-4687-a106-6d1c7734ee3a	d9870517-1d50-45f0-831c-a783922c22d3
3280	2296	-984	GBIF Germany	4f6826f2-4ff6-443d-b966-e6913bd24013	db5ae447-2113-4a70-9092-54a9107aef0f
5067	5067	0	Colombian Biodiversity Information System	7e865cba-7c46-417b-ade5-97f2cf5b7be0	de45bd59-54e6-4f62-9a15-b481af99fc48
480	480	0	Plazi	ffb07bec-2d10-492d-9c37-361fe0b79427	e0acc5ae-bfff-4f31-bf35-3580e085955a
0	3	3	Plazi	ffb07bec-2d10-492d-9c37-361fe0b79427	e0c31b7c-51a6-409f-b180-5fb1d29b71b7
6	6	0	Plazi	ffb07bec-2d10-492d-9c37-361fe0b79427	e4262fe3-082e-420c-a52c-423429fa41a1
8347	8347	0	National Biodiversity Network	d897a5b9-35ee-4232-94bd-b0bcaac003c2	e48838ec-51f1-4d25-bf5c-fe3c24a28b32
2699	2699	0	Colombian Biodiversity Information System	7e865cba-7c46-417b-ade5-97f2cf5b7be0	e550b7a5-439c-42d6-917a-5990a633347d
0	41	41	Plazi	ffb07bec-2d10-492d-9c37-361fe0b79427	e5f646b5-e1aa-45ad-9f07-306760ab8cca
1	1	0	Participant Node Managers Committee	7f48e0c8-5c96-49ec-b972-30748e339115	e801b9b4-5a23-4112-8f4a-98bf2fe60ceb
1	1	0	Plazi	ffb07bec-2d10-492d-9c37-361fe0b79427	ead95ba6-be5d-41bd-bdbf-18e73cd3a7eb
3472	3472	0	GBIF Finland	dd514216-5c7c-45f3-910d-797424cb5be6	eb5d794f-e05e-4d96-b173-363bd3a1822d
171	171	0	Polish Biodiversity Information Network	2618bfdf-e194-4911-a241-80db3107bc51	ed1173e0-f6ea-4ed5-9a66-c28e6760e198
8	8	0	Plazi	ffb07bec-2d10-492d-9c37-361fe0b79427	ed2e6df3-f7cc-4cf2-8791-a1ca50015952
0	3764	3764	GBIF Switzerland	169eb292-376b-4cc6-8e31-9c2c432de0ad	ed58b8fa-ad6c-4c73-99b8-813fd7689404
0	10	10	Plazi	ffb07bec-2d10-492d-9c37-361fe0b79427	ed5d7a07-edd8-498a-a33f-6c59b66f534e
171	171	0	Plazi	ffb07bec-2d10-492d-9c37-361fe0b79427	eeaba26d-91f6-41e6-b88a-373c047d47cf
2	2	0	Plazi	ffb07bec-2d10-492d-9c37-361fe0b79427	f0046cbf-0277-4083-8c2f-73fd8745fd80
0	48	48	Ocean Biodiversity Information System	ba0670b9-4186-41e6-8e70-f9cb3065551a	f080e3df-08d4-44a3-b942-99421eaa2579
0	6475	6475	Biodiversity Information System of Mexico	b324e8e9-9a4c-44fa-8f1a-7f39ea7ab576	f39d15ff-c218-4738-a9e9-6bc8688f8027
0	728	728	National Biodiversity Network	d897a5b9-35ee-4232-94bd-b0bcaac003c2	f3f169bb-3cd8-4a67-b347-f0776c53f3e5
9	9	0	Plazi	ffb07bec-2d10-492d-9c37-361fe0b79427	f43659d6-17a6-488c-b88b-441dbc661fb7
0	5535	5535	Participant Node Managers Committee	7f48e0c8-5c96-49ec-b972-30748e339115	f6246c23-9eb9-4392-b0af-c2427282e196
31	31	0	Colombian Biodiversity Information System	7e865cba-7c46-417b-ade5-97f2cf5b7be0	f82e7327-2e4e-4ef8-8f96-60b41c146dbb
1	1	0	Plazi	ffb07bec-2d10-492d-9c37-361fe0b79427	fa16abd7-48fe-46de-8feb-1b3fcc26f8cf
32	32	0	Plazi	ffb07bec-2d10-492d-9c37-361fe0b79427	01962892-5ab4-4828-a43c-838f01b109b6
2	2	0	Plazi	ffb07bec-2d10-492d-9c37-361fe0b79427	0678d5a2-2da8-4bb8-a1dd-fe5a40835f9e
28916	28916	0	Canada Biodiversity Information Facility	8f83fc96-c966-4126-83f7-bf044dc49efa	09e90dfb-5b1b-4dd9-a796-e2fba53d26f0
5	5	0	Plazi	ffb07bec-2d10-492d-9c37-361fe0b79427	0c30f7bd-7385-47ef-961c-9f3205276837
286	286	0	Polish Biodiversity Information Network	2618bfdf-e194-4911-a241-80db3107bc51	0e6799d0-13e6-11de-b2e1-b8a03c50a862
0	63	63	GBIF Portugal	673f7038-4262-4149-b753-5658a4e912f6	0f1cf4ce-8bee-4329-a188-5282b0dd4172
475	475	0	Atlas of Living Australia	4a6f1b71-969e-4fc5-a693-282b05e1220c	100caf86-ad3e-4c13-be7b-4c838d221dfa
0	22	22	Ocean Biodiversity Information System	ba0670b9-4186-41e6-8e70-f9cb3065551a	10a988a4-2405-4e01-aeb9-74f2ee269482
25900	34639	8739	National Biodiversity Network	d897a5b9-35ee-4232-94bd-b0bcaac003c2	12934e15-749a-4df4-ab89-211c10573525
874	874	0	GBIF France	da44cd31-5901-4687-a106-6d1c7734ee3a	19217bc6-84f2-49a9-9e46-ab50777c33ae
217	217	0	Biodiversity Information System of Mexico	b324e8e9-9a4c-44fa-8f1a-7f39ea7ab576	1922a4ed-6519-40e0-9afd-15f14963da55
119265	119375	110	U.S. Geological Survey	8618c64a-93e0-4300-b546-7249e5148ed2	1953be92-e2b9-4b70-a1e5-893bc8d051f7
389	389	0	Korean Biodiversity Information Facility	e0a1e772-0177-4800-94b4-2d023fe6cdf4	19c34f7a-f6d9-4e42-8865-7324f0611b36
200	200	0	Colombian Biodiversity Information System	7e865cba-7c46-417b-ade5-97f2cf5b7be0	1ad7253a-4e19-42be-9386-1e6d1caca0f4
18521	18521	0	GBIF Norway	4f829580-180d-46a9-9c87-ed8ec959b545	1daaaa9b-f637-4d6a-84d4-d8038d4c71aa
0	2	2	Plazi	ffb07bec-2d10-492d-9c37-361fe0b79427	1dc3b06e-1467-4be2-b878-8965e2a42329
62	62	0	Biodiversity Information System of Mexico	b324e8e9-9a4c-44fa-8f1a-7f39ea7ab576	2237b8cd-84b1-45d1-9941-bccdb277933b
28305	45063	16758	GBIF Sweden	a0b3be64-6525-4387-ac67-a499950f92e1	252f45fe-dfb6-46d6-9457-59bb3947c517
0	4	4	Plazi	ffb07bec-2d10-492d-9c37-361fe0b79427	25e7d5d0-2837-4604-b167-999222b9d773
3	3	0	Plazi	ffb07bec-2d10-492d-9c37-361fe0b79427	27a47f50-d25a-4582-b378-4e6fd8b1080d
21	21	0	Plazi	ffb07bec-2d10-492d-9c37-361fe0b79427	27f25e00-bfe0-4b05-997f-8bfb2092ac47
2	2	0	Plazi	ffb07bec-2d10-492d-9c37-361fe0b79427	28ab3f39-6883-4b22-9db1-f26643fb2b4c
4854	4854	0	Biodiversity Information System of Mexico	b324e8e9-9a4c-44fa-8f1a-7f39ea7ab576	293bc355-c0d3-4ce8-98f7-5fa6303152cb
10	10	0	Plazi	ffb07bec-2d10-492d-9c37-361fe0b79427	2bd62c1b-509d-4e51-a773-d16656d97589
140	140	0	GBIF Portugal	673f7038-4262-4149-b753-5658a4e912f6	2d5a6c0e-64eb-45f5-8e04-7d7467707a0a
23	23	0	Plazi	ffb07bec-2d10-492d-9c37-361fe0b79427	316bc03d-a38f-4bf7-9ee6-b061ec68050d
33	33	0	GBIF Germany	4f6826f2-4ff6-443d-b966-e6913bd24013	318818f2-3445-4ca1-b446-219f665aff9a
24	24	0	Plazi	ffb07bec-2d10-492d-9c37-361fe0b79427	3231104a-d686-4c36-8e4d-a0519f6a2767
8	10	2	Plazi	ffb07bec-2d10-492d-9c37-361fe0b79427	369787f4-96b4-48e0-90e2-3d1f44785c64
247	247	0	GBIF France	da44cd31-5901-4687-a106-6d1c7734ee3a	37425207-1a9a-4ef4-b504-5da6b7c21edd
107	107	0	Biodiversity Information System of Mexico	b324e8e9-9a4c-44fa-8f1a-7f39ea7ab576	38db85b2-4fe0-442f-ac27-dccbe9b0ed86
31000	31000	0	GBIF Japan	db5705aa-6a6e-42f1-8942-d77b9f4896ea	38e8b720-9074-4471-a016-73cae18a6c1c
0	5	5	Plazi	ffb07bec-2d10-492d-9c37-361fe0b79427	4008e506-8187-4be2-bc11-f7e03a10070b
269	269	0	GBIF France	da44cd31-5901-4687-a106-6d1c7734ee3a	40ee275b-0b35-45b0-9764-6e606226d075
2996	2996	0	U.S. Geological Survey	8618c64a-93e0-4300-b546-7249e5148ed2	41a910f3-db13-4520-a3b2-199edb4a32ea
823	823	0	Colombian Biodiversity Information System	7e865cba-7c46-417b-ade5-97f2cf5b7be0	434d867c-713f-4f13-8d03-b7de4f3a0ab8
0	4	4	Plazi	ffb07bec-2d10-492d-9c37-361fe0b79427	44b958c8-816b-4fb3-b091-02a1d5d4b177
0	46	46	Plazi	ffb07bec-2d10-492d-9c37-361fe0b79427	45c79e5f-0c6c-4a8c-897f-9c4d68c0e709
100	100	0	BioCASE	d8bbf693-a180-4995-94fe-6130795dcf2f	4692000e-dc38-4c41-8131-c8b16fbe3c81
0	74	74	Ocean Biodiversity Information System	ba0670b9-4186-41e6-8e70-f9cb3065551a	46fd3696-7fcf-4429-8355-dd5ce89c059d
7205	7205	0	GBIF France	da44cd31-5901-4687-a106-6d1c7734ee3a	47c11f62-1b68-404a-8bba-2e85d3404906
1	1	0	Plazi	ffb07bec-2d10-492d-9c37-361fe0b79427	4c545ebd-4718-49c6-b4ff-c74ff94030d5
0	16	16	Plazi	ffb07bec-2d10-492d-9c37-361fe0b79427	4e3f5851-4760-4744-ac56-0db8612b60ce
2027	2027	0	GBIF France	da44cd31-5901-4687-a106-6d1c7734ee3a	4efdc7a2-0dae-421c-83e1-80f75590896d
0	4	4	Plazi	ffb07bec-2d10-492d-9c37-361fe0b79427	4f24c0fe-251d-4224-9793-2d33af7a20cc
1	1	0	Plazi	ffb07bec-2d10-492d-9c37-361fe0b79427	510ec35c-8b9b-4d61-8b50-f75c9bf74cc2
3	3	0	Plazi	ffb07bec-2d10-492d-9c37-361fe0b79427	52074589-b252-4ea1-b90c-160fff445e22
9	9	0	Plazi	ffb07bec-2d10-492d-9c37-361fe0b79427	532758c6-a328-4d53-82f5-592d22419678
5	5	0	Plazi	ffb07bec-2d10-492d-9c37-361fe0b79427	537940a7-a7f2-44ce-9d00-1b702bc9cd96
0	2	2	Plazi	ffb07bec-2d10-492d-9c37-361fe0b79427	584aa105-ae5a-463e-b0b1-58784bb9fe4e
7	7	0	Plazi	ffb07bec-2d10-492d-9c37-361fe0b79427	5a25e523-7350-43a2-b5cb-6cafa6259b25
98	98	0	GBIF France	da44cd31-5901-4687-a106-6d1c7734ee3a	5b0b2162-240d-4ac5-a8c8-a2df210cd750
828	828	0	U.S. Geological Survey	8618c64a-93e0-4300-b546-7249e5148ed2	5b5af180-599c-44e7-bd3b-6f5d53bbb55d
0	38	38	Plazi	ffb07bec-2d10-492d-9c37-361fe0b79427	5ccd1678-818a-48bf-bdbe-ab74b1eb422a
5	5	0	Plazi	ffb07bec-2d10-492d-9c37-361fe0b79427	5eda1cf0-cf64-48a5-b3e7-e88729f3301e
27	27	0	Colombian Biodiversity Information System	7e865cba-7c46-417b-ade5-97f2cf5b7be0	5f1d8962-cde6-4d1b-9baf-56a0bbcaa286
0	7	7	Plazi	ffb07bec-2d10-492d-9c37-361fe0b79427	5fdab486-e3f0-41a3-a970-241e047779ee
5	5	0	Plazi	ffb07bec-2d10-492d-9c37-361fe0b79427	600097c0-88e6-4a65-a5f6-a303c48a1221
86	86	0	GBIF Germany	4f6826f2-4ff6-443d-b966-e6913bd24013	6183020e-f762-11e1-a439-00145eb45e9a
0	31	31	Ocean Biodiversity Information System	ba0670b9-4186-41e6-8e70-f9cb3065551a	61f3dbee-b9a2-47a9-b595-013174de4a58
81	81	0	GBIF Germany	4f6826f2-4ff6-443d-b966-e6913bd24013	6205a718-f762-11e1-a439-00145eb45e9a
84	84	0	GBIF Germany	4f6826f2-4ff6-443d-b966-e6913bd24013	62b7b444-f762-11e1-a439-00145eb45e9a
24	24	0	GBIF Germany	4f6826f2-4ff6-443d-b966-e6913bd24013	632c969c-f762-11e1-a439-00145eb45e9a
89	89	0	GBIF Germany	4f6826f2-4ff6-443d-b966-e6913bd24013	63692e5e-f762-11e1-a439-00145eb45e9a
965	965	0	Participant Node Managers Committee	7f48e0c8-5c96-49ec-b972-30748e339115	640ae8b7-14b9-4188-894a-a2bc3821c752
132	132	0	GBIF Germany	4f6826f2-4ff6-443d-b966-e6913bd24013	64248c44-f762-11e1-a439-00145eb45e9a
152	152	0	GBIF Germany	4f6826f2-4ff6-443d-b966-e6913bd24013	647901f2-f762-11e1-a439-00145eb45e9a
281	281	0	GBIF Germany	4f6826f2-4ff6-443d-b966-e6913bd24013	655b7c94-f762-11e1-a439-00145eb45e9a
42	37	-5	GBIF Germany	4f6826f2-4ff6-443d-b966-e6913bd24013	65b02758-f762-11e1-a439-00145eb45e9a
15	15	0	Plazi	ffb07bec-2d10-492d-9c37-361fe0b79427	65cfba2c-c68d-4671-8340-8c60617cbcc0
215	215	0	Colombian Biodiversity Information System	7e865cba-7c46-417b-ade5-97f2cf5b7be0	66bd3ed0-4fed-442c-ac0b-17c860583d43
72	72	0	GBIF Guinea	b1cd2e84-c4ba-47bd-b72a-dfd1f92dce0a	67446c42-0a57-471d-942a-ef247c50c1f3
61418	73721	12303	GBIF Norway	4f829580-180d-46a9-9c87-ed8ec959b545	68a0650f-96ae-499c-8b2a-a4f92c01e4b3
19	19	0	GBIF Germany	4f6826f2-4ff6-443d-b966-e6913bd24013	68e716de-f762-11e1-a439-00145eb45e9a
135	135	0	GBIF Germany	4f6826f2-4ff6-443d-b966-e6913bd24013	6959d1f6-f762-11e1-a439-00145eb45e9a
1021	1021	0	GBIF France	da44cd31-5901-4687-a106-6d1c7734ee3a	6b7e9f21-2ede-41e7-8923-e3520b72afc2
12	12	0	GBIF Germany	4f6826f2-4ff6-443d-b966-e6913bd24013	6bc71318-f762-11e1-a439-00145eb45e9a
37200	37200	0	GBIF Japan	db5705aa-6a6e-42f1-8942-d77b9f4896ea	6ca390f7-b377-4313-a657-16b44a5dc52e
0	5246	5246	Taiwan Biodiversity Information Facility	e1b85abc-61f9-430f-ba79-6813dec53a0f	70e66bc4-a791-44c5-9c9b-1aa32934a909
0	1241	1241	Colombian Biodiversity Information System	7e865cba-7c46-417b-ade5-97f2cf5b7be0	719fcac3-f4a1-49d1-ba9e-62522d0dbd22
85	85	0	GBIF Germany	4f6826f2-4ff6-443d-b966-e6913bd24013	7221c7c6-f762-11e1-a439-00145eb45e9a
940	940	0	GBIF Germany	4f6826f2-4ff6-443d-b966-e6913bd24013	733184bc-f762-11e1-a439-00145eb45e9a
2413	2413	0	Colombian Biodiversity Information System	7e865cba-7c46-417b-ade5-97f2cf5b7be0	73416d1c-e675-43b3-bbe4-672d5a9f9e8b
22	22	0	Ocean Biodiversity Information System	ba0670b9-4186-41e6-8e70-f9cb3065551a	740af3ba-80c8-42fd-a424-6e34513fa754
113	113	0	GBIF Germany	4f6826f2-4ff6-443d-b966-e6913bd24013	74cd2be6-f762-11e1-a439-00145eb45e9a
407	407	0	GBIF Germany	4f6826f2-4ff6-443d-b966-e6913bd24013	7597f902-f762-11e1-a439-00145eb45e9a
2	2	0	Plazi	ffb07bec-2d10-492d-9c37-361fe0b79427	76d7a113-b4bb-4458-807b-2011a8fd0750
18	18	0	GBIF France	da44cd31-5901-4687-a106-6d1c7734ee3a	79238f7f-c841-421f-8c42-6cd2df5a634a
1455	1455	0	GBIF France	da44cd31-5901-4687-a106-6d1c7734ee3a	793d37c9-1c68-466f-bc8c-1bfe28aed527
462	339	-123	GBIF Germany	4f6826f2-4ff6-443d-b966-e6913bd24013	79c23ca4-f762-11e1-a439-00145eb45e9a
10212	10212	0	Korean Biodiversity Information Facility	e0a1e772-0177-4800-94b4-2d023fe6cdf4	7b04c104-f762-11e1-a439-00145eb45e9a
210	210	0	GBIF Germany	4f6826f2-4ff6-443d-b966-e6913bd24013	7be50200-f762-11e1-a439-00145eb45e9a
756	540	-216	GBIF Germany	4f6826f2-4ff6-443d-b966-e6913bd24013	7c5619f4-f762-11e1-a439-00145eb45e9a
98	98	0	GBIF Germany	4f6826f2-4ff6-443d-b966-e6913bd24013	7d565b34-f762-11e1-a439-00145eb45e9a
0	575481	575481	GBIF Portugal	673f7038-4262-4149-b753-5658a4e912f6	7dccad9d-1339-4a81-9f42-c67d9a897377
118	118	0	GBIF Germany	4f6826f2-4ff6-443d-b966-e6913bd24013	7eb82476-f762-11e1-a439-00145eb45e9a
7985	8200	215	U.S. Geological Survey	8618c64a-93e0-4300-b546-7249e5148ed2	80570f04-9925-461c-b729-c4844e20e923
77	77	0	Biodiversity Information System of Mexico	b324e8e9-9a4c-44fa-8f1a-7f39ea7ab576	80cf0324-f762-11e1-a439-00145eb45e9a
0	4228	4228	GBIF Portugal	673f7038-4262-4149-b753-5658a4e912f6	80d4429a-0b88-4952-b943-5999324b805f
4	4	0	GBIF Japan	db5705aa-6a6e-42f1-8942-d77b9f4896ea	80eca9ce-f762-11e1-a439-00145eb45e9a
689	689	0	GBIF Germany	4f6826f2-4ff6-443d-b966-e6913bd24013	81c5297a-f762-11e1-a439-00145eb45e9a
2483	2483	0	Polish Biodiversity Information Network	2618bfdf-e194-4911-a241-80db3107bc51	859fe27e-f762-11e1-a439-00145eb45e9a
17802	17802	0	GBIF France	da44cd31-5901-4687-a106-6d1c7734ee3a	868ad223-8e90-45e7-ba2c-c69751663ab1
429	323	-106	GBIF Germany	4f6826f2-4ff6-443d-b966-e6913bd24013	87e6d920-f762-11e1-a439-00145eb45e9a
6	6	0	Plazi	ffb07bec-2d10-492d-9c37-361fe0b79427	88042df7-dae6-4b66-93eb-9fcbe4706bdd
242	242	0	GBIF Germany	4f6826f2-4ff6-443d-b966-e6913bd24013	88ccdb5a-f762-11e1-a439-00145eb45e9a
4560	4560	0	Canada Biodiversity Information Facility	8f83fc96-c966-4126-83f7-bf044dc49efa	88d7437e-f762-11e1-a439-00145eb45e9a
82953	82953	0	GBIF Norway	4f829580-180d-46a9-9c87-ed8ec959b545	88ea9eca-96ad-4a5a-8a01-99a4acabe050
156	156	0	GBIF Germany	4f6826f2-4ff6-443d-b966-e6913bd24013	898660c0-f762-11e1-a439-00145eb45e9a
918	918	0	GBIF Germany	4f6826f2-4ff6-443d-b966-e6913bd24013	89ca51ae-f762-11e1-a439-00145eb45e9a
601	601	0	GBIF Germany	4f6826f2-4ff6-443d-b966-e6913bd24013	8a78059f-d784-49d3-bb14-cbbff0dd769b
160	160	0	GBIF Germany	4f6826f2-4ff6-443d-b966-e6913bd24013	8bb29a6c-f762-11e1-a439-00145eb45e9a
10	10	0	GBIF Germany	4f6826f2-4ff6-443d-b966-e6913bd24013	8c0aee56-f762-11e1-a439-00145eb45e9a
114203	114203	0	U.S. Geological Survey	8618c64a-93e0-4300-b546-7249e5148ed2	8d88898d-a2c4-4616-a1fe-431b9c06b671
84	57	-27	GBIF Germany	4f6826f2-4ff6-443d-b966-e6913bd24013	8eadfdec-f762-11e1-a439-00145eb45e9a
409	409	0	GBIF Norway	4f829580-180d-46a9-9c87-ed8ec959b545	8f3081d6-42e6-44df-972a-a5c0c991f3ca
2	2	0	Plazi	ffb07bec-2d10-492d-9c37-361fe0b79427	8f552587-81e8-43fd-94ec-8b5027171a4c
356	309	-47	GBIF Germany	4f6826f2-4ff6-443d-b966-e6913bd24013	916043f6-f762-11e1-a439-00145eb45e9a
5401	5401	0	GBIF France	da44cd31-5901-4687-a106-6d1c7734ee3a	91b61521-24c1-4d32-9963-480c50661a24
102	77	-25	GBIF Germany	4f6826f2-4ff6-443d-b966-e6913bd24013	92412236-f762-11e1-a439-00145eb45e9a
62725	66164	3439	National Biodiversity Network	d897a5b9-35ee-4232-94bd-b0bcaac003c2	928304f1-d313-47cd-b17b-0232bc27b727
3	3	0	GBIF Germany	4f6826f2-4ff6-443d-b966-e6913bd24013	939d8390-f762-11e1-a439-00145eb45e9a
55690	55690	0	National Biodiversity Data Centre	422b00b2-6c94-4bb6-976b-c359916efdb8	93f5be1b-c517-4a76-8cbe-6e81a5dd4f85
3766	3766	0	GBIF Germany	4f6826f2-4ff6-443d-b966-e6913bd24013	95070d0a-f762-11e1-a439-00145eb45e9a
910	905	-5	GBIF Germany	4f6826f2-4ff6-443d-b966-e6913bd24013	954d87b2-f762-11e1-a439-00145eb45e9a
31680	31680	0	GBIF Germany	4f6826f2-4ff6-443d-b966-e6913bd24013	95d672e8-f762-11e1-a439-00145eb45e9a
17000	17000	0	GBIF Japan	db5705aa-6a6e-42f1-8942-d77b9f4896ea	95fed08a-f762-11e1-a439-00145eb45e9a
32740	32740	0	GBIF Brazil	cdc9736d-5ff7-4ece-9959-3c744360cdb3	96355268-9d5d-47ff-9148-a7c6083beb12
63386	64896	1510	GBIF Germany	4f6826f2-4ff6-443d-b966-e6913bd24013	965bbbd8-f762-11e1-a439-00145eb45e9a
829	829	0	Atlas of Living Australia	4a6f1b71-969e-4fc5-a693-282b05e1220c	96a4053c-f762-11e1-a439-00145eb45e9a
51	51	0	GBIF Germany	4f6826f2-4ff6-443d-b966-e6913bd24013	97a3fbcc-f762-11e1-a439-00145eb45e9a
1596	1596	0	GBIF Portugal	673f7038-4262-4149-b753-5658a4e912f6	9d740bbc-214c-46d6-8609-34ceeb4b7045
0	41	41	Plazi	ffb07bec-2d10-492d-9c37-361fe0b79427	9df2f318-f536-45e4-9d05-6622b96e9e25
0	1392	1392	Ocean Biodiversity Information System	ba0670b9-4186-41e6-8e70-f9cb3065551a	9fe5f160-8f85-4ac7-9e36-017e52339cdd
0	1	1	Participant Node Managers Committee	7f48e0c8-5c96-49ec-b972-30748e339115	a041ce14-d734-4196-aa5c-c37374a2951a
0	138	138	Ocean Biodiversity Information System	ba0670b9-4186-41e6-8e70-f9cb3065551a	a0476053-08b8-4054-927c-3594a1960287
251	251	0	GBIF France	da44cd31-5901-4687-a106-6d1c7734ee3a	a1bec4a7-7204-46e0-9425-c48e3805a4a5
160	160	0	GBIF Portugal	673f7038-4262-4149-b753-5658a4e912f6	a24ceae3-692b-4a45-8c6d-72131287cb2c
0	8	8	Plazi	ffb07bec-2d10-492d-9c37-361fe0b79427	a689750f-abb6-402f-9e78-b07b11bf9fd2
4	4	0	GBIF Finland	dd514216-5c7c-45f3-910d-797424cb5be6	a7f3a2ac-fb04-4a97-969c-3bcf78a7433c
792	792	0	GBIF France	da44cd31-5901-4687-a106-6d1c7734ee3a	aa5ed849-ce8b-4326-a220-f5a2b8aa0edf
25473	25471	-2	National Biodiversity Network	d897a5b9-35ee-4232-94bd-b0bcaac003c2	aa8fe1e4-10ec-4fb1-a520-c062b91cb788
24	24	0	GBIF Argentina	2426a871-9feb-40a1-96c6-0c593a76b835	aae77222-6299-409a-9c1a-03744dbf4020
491	491	0	Plazi	ffb07bec-2d10-492d-9c37-361fe0b79427	ae9d8467-6c08-48f2-93b8-6b8039725bd7
5	5	0	Plazi	ffb07bec-2d10-492d-9c37-361fe0b79427	b1dcd976-f722-486a-8da8-75fb69e6b14f
231	231	0	GBIF Germany	4f6826f2-4ff6-443d-b966-e6913bd24013	b2253887-7b27-42e7-84cb-3f6f5c2f453c
713	713	0	Atlas of Living Australia	4a6f1b71-969e-4fc5-a693-282b05e1220c	b2c37c6b-ab2f-4eff-93a6-ecfd3676e69d
0	2	2	Plazi	ffb07bec-2d10-492d-9c37-361fe0b79427	b3db5fd4-438d-4d21-a796-a4ef46023801
7837	7837	0	Biodiversity Information System of Mexico	b324e8e9-9a4c-44fa-8f1a-7f39ea7ab576	b3f5c276-6416-473a-956f-902ae62cd760
2129	2129	0	Biodiversity Information System of Mexico	b324e8e9-9a4c-44fa-8f1a-7f39ea7ab576	b7d5e282-aeeb-41f2-923b-e24b52d8028a
101327	104113	2786	U.S. Geological Survey	8618c64a-93e0-4300-b546-7249e5148ed2	b89d52a2-861d-4388-adad-c0da3d55fc78
660	660	0	GBIF Madagascar	2dbfc5c5-51b5-4494-9dfc-4d3f013a3b64	bcb0c727-4820-46ba-8a69-34e33eb9bd62
6	6	0	Plazi	ffb07bec-2d10-492d-9c37-361fe0b79427	bd102e06-69c1-448b-95c0-fd962fa1cdcf
3	3	0	Participant Node Managers Committee	7f48e0c8-5c96-49ec-b972-30748e339115	be62e2f5-e871-407c-8e58-3e2200bf3d2b
84	84	0	Plazi	ffb07bec-2d10-492d-9c37-361fe0b79427	c1b6cefa-7ca1-474f-955f-fd89beada20a
2	2	0	Plazi	ffb07bec-2d10-492d-9c37-361fe0b79427	c2241d14-77b2-4b4c-a5fc-a0b95a17a685
36	36	0	GBIF Germany	4f6826f2-4ff6-443d-b966-e6913bd24013	c3465efc-ea11-414f-afe7-85386b816df6
11	11	0	Plazi	ffb07bec-2d10-492d-9c37-361fe0b79427	c66fc524-9b16-4e5b-9e11-0049f89225ef
0	15025	15025	GBIF Portugal	673f7038-4262-4149-b753-5658a4e912f6	c8bcbc1e-3073-4a7a-930c-65a0727493be
206	206	0	Participant Node Managers Committee	7f48e0c8-5c96-49ec-b972-30748e339115	ca80296a-7e8c-41f6-9fbf-6c8d818b4ab9
22540	22540	0	GBIF France	da44cd31-5901-4687-a106-6d1c7734ee3a	cdafb94e-6dcc-44de-b0ef-98439a1ca28e
32	32	0	Plazi	ffb07bec-2d10-492d-9c37-361fe0b79427	d010619b-5768-4265-8b23-d724c7dcbfc6
0	1	1	Ocean Biodiversity Information System	ba0670b9-4186-41e6-8e70-f9cb3065551a	d0b5c196-259c-4af6-bfc7-6c2e024db440
75	75	0	Colombian Biodiversity Information System	7e865cba-7c46-417b-ade5-97f2cf5b7be0	d0d33a6d-c8ec-4f5d-82b1-7d391be0e8ee
3	3	0	Plazi	ffb07bec-2d10-492d-9c37-361fe0b79427	d1087ef4-03bc-4656-887b-506a0f972c08
17890	17890	0	GBIF Benin	efb9c00e-f802-45dd-8826-a52ec45b89ff	d24105a5-665e-4ab1-a792-e4242ae33d85
1	1	0	Plazi	ffb07bec-2d10-492d-9c37-361fe0b79427	d38e8ddc-d3e2-4a0b-9aab-9b7587400244
1031	1031	0	DanBIF - Danish Biodiversity Information Facility	4ddd294f-02b7-4359-ac33-0806a9ca9c6b	d435e038-1f0a-4007-9429-4e55e71428e7
12	12	0	Plazi	ffb07bec-2d10-492d-9c37-361fe0b79427	d5fdc6f0-0c09-4e68-8239-28ba1c61693f
4	4	0	Plazi	ffb07bec-2d10-492d-9c37-361fe0b79427	d7d01ab2-ccc5-401a-91fd-de8071f454ed
0	2	2	Plazi	ffb07bec-2d10-492d-9c37-361fe0b79427	daf76c87-fc11-4854-9b2f-3b50e27bcf86
471	471	0	GBIF Germany	4f6826f2-4ff6-443d-b966-e6913bd24013	dcd51550-fd2d-4e63-9ecf-cccc27a863a4
6896	6896	0	GBIF Argentina	2426a871-9feb-40a1-96c6-0c593a76b835	de9feacc-af31-4a63-b439-72b84fcf40ad
1	1	0	Plazi	ffb07bec-2d10-492d-9c37-361fe0b79427	e0282f17-aea7-40d1-a756-4ff1b312dfbb
0	2	2	Plazi	ffb07bec-2d10-492d-9c37-361fe0b79427	e0297fec-1433-4cfd-acaa-8c2a1a48c9a0
247	247	0	GBIF France	da44cd31-5901-4687-a106-6d1c7734ee3a	e0b24863-477b-430d-9353-b1be20b3afcf
0	38	38	Plazi	ffb07bec-2d10-492d-9c37-361fe0b79427	e14407e6-33f9-4388-9099-9ac2dbc11f6b
0	9	9	Plazi	ffb07bec-2d10-492d-9c37-361fe0b79427	e3e8f325-7ce2-4262-a3f0-78500edec1cc
0	3	3	Plazi	ffb07bec-2d10-492d-9c37-361fe0b79427	e445342a-274f-45ff-85dd-3497f17ce48b
0	7	7	Plazi	ffb07bec-2d10-492d-9c37-361fe0b79427	e9198dea-e15c-459d-bb53-92390f2189ae
125	125	0	Plazi	ffb07bec-2d10-492d-9c37-361fe0b79427	e943a8eb-b1e3-4328-9006-9508ba1f8fe2
3367	3367	0	Atlas of Living Australia	4a6f1b71-969e-4fc5-a693-282b05e1220c	e9493ed6-55ba-43e8-bcda-fef47ba441e3
5	5	0	Plazi	ffb07bec-2d10-492d-9c37-361fe0b79427	eb7603a7-9328-484e-897b-ad72c9e80be6
7	7	0	GBIF France	da44cd31-5901-4687-a106-6d1c7734ee3a	ebdd89e0-3e3c-4b6b-bf57-b658235c1923
3	3	0	Plazi	ffb07bec-2d10-492d-9c37-361fe0b79427	edaefd1e-b9e7-4502-98fb-776efdefa37f
649	649	0	VertNet	d205def7-82c3-472a-be4b-31d11dcd51fd	ee36f4f3-117a-4cdc-b5e0-10dc209d4b30
6640	6640	0	National Biodiversity Network	d897a5b9-35ee-4232-94bd-b0bcaac003c2	ee5f5e73-28e3-4018-abc9-12dbf3a07553
28	28	0	Plazi	ffb07bec-2d10-492d-9c37-361fe0b79427	efad8a8c-7730-4513-8853-b5ac5640deb5
0	171	171	Plazi	ffb07bec-2d10-492d-9c37-361fe0b79427	f01782d1-107a-4884-8319-4f9c53d8cdd1
739	739	0	Colombian Biodiversity Information System	7e865cba-7c46-417b-ade5-97f2cf5b7be0	f1c297ca-528e-4e2a-a014-3664f345258f
0	12	12	Plazi	ffb07bec-2d10-492d-9c37-361fe0b79427	f2e2b777-cc43-44fa-be59-3a443e93c204
3	3	0	Plazi	ffb07bec-2d10-492d-9c37-361fe0b79427	f2e6d53b-f640-4f7c-8bd7-24fc524a6464
4	4	0	Plazi	ffb07bec-2d10-492d-9c37-361fe0b79427	f2e9ecc2-a2b7-4533-b328-2c7aed75a68b
0	2	2	Plazi	ffb07bec-2d10-492d-9c37-361fe0b79427	f485f631-e223-460a-9e53-f7371e2abce9
0	331	331	Plazi	ffb07bec-2d10-492d-9c37-361fe0b79427	f7f21cba-d005-486a-a383-fe6d09b81f04
1	1	0	Plazi	ffb07bec-2d10-492d-9c37-361fe0b79427	fb9243af-ffa0-4c5b-b95c-6c92038a6669
615	615	0	National Biodiversity Network	d897a5b9-35ee-4232-94bd-b0bcaac003c2	fba40972-e465-485d-bcaa-eb2f7e8f105c
389	389	0	GBIF France	da44cd31-5901-4687-a106-6d1c7734ee3a	fdf9e526-bd9b-48e9-bf2d-8f9b0a923066
22	22	0	Plazi	ffb07bec-2d10-492d-9c37-361fe0b79427	028d313d-40ec-4ac6-b011-63806ce7f0b8
1470	1470	0	Belgian Biodiversity Platform	fb11cfe1-ebc3-45af-9159-17d9fddbcdac	029ca2ac-d525-4dd0-bfc5-288102358341
15	15	0	Plazi	ffb07bec-2d10-492d-9c37-361fe0b79427	0497b481-e216-41a4-b1f8-fd732cb69ca1
0	247402	247402	Participant Node Managers Committee	7f48e0c8-5c96-49ec-b972-30748e339115	07a5ec6c-e271-4d6a-865c-7f9a6b484514
0	5	5	Plazi	ffb07bec-2d10-492d-9c37-361fe0b79427	07c3b002-34f1-4cc9-a80c-934135f90eb2
0	15	15	Plazi	ffb07bec-2d10-492d-9c37-361fe0b79427	07ec7a2a-9c31-4089-923a-643a84e6e2d4
210	210	0	Colombian Biodiversity Information System	7e865cba-7c46-417b-ade5-97f2cf5b7be0	0971f775-16f4-4ac2-9e5d-403926c60a5d
1889	1889	0	GBIF Norway	4f829580-180d-46a9-9c87-ed8ec959b545	0ae8db45-88e0-452c-986b-c7e62393efe4
0	60088	60088	DanBIF - Danish Biodiversity Information Facility	4ddd294f-02b7-4359-ac33-0806a9ca9c6b	0d1f9cee-7cb7-4d3a-a8c4-d2ca6edcd23b
0	82	82	Plazi	ffb07bec-2d10-492d-9c37-361fe0b79427	10606ef4-92b0-4fd4-bb91-56962637ec44
1009	1009	0	GBIF France	da44cd31-5901-4687-a106-6d1c7734ee3a	1225f6fb-5b9e-4fcf-8a48-5bb02de4f145
0	6	6	Plazi	ffb07bec-2d10-492d-9c37-361fe0b79427	178c0ddf-4f13-4af0-945b-bc3674d9f799
3178	3178	0	National Biodiversity Network	d897a5b9-35ee-4232-94bd-b0bcaac003c2	17cc1c85-2081-4d8a-8978-81e2e8f173e3
213	213	0	GBIF Germany	4f6826f2-4ff6-443d-b966-e6913bd24013	1af1afa5-bb7b-467c-8f5c-6fac7e4537d8
2513	2513	0	Polish Biodiversity Information Network	2618bfdf-e194-4911-a241-80db3107bc51	1c8df1b0-30b2-11de-b171-b8a03c50a862
2747	386063	383316	National Biodiversity Network	d897a5b9-35ee-4232-94bd-b0bcaac003c2	1f472c7b-bb1d-4397-8ca0-ffcdfbb2b8b2
4	4	0	Plazi	ffb07bec-2d10-492d-9c37-361fe0b79427	1f8c806d-5fbd-475c-b152-317b1da4591b
0	2	2	Plazi	ffb07bec-2d10-492d-9c37-361fe0b79427	20752e6b-419c-49c4-a557-81e79f3ceee8
788	788	0	GBIF France	da44cd31-5901-4687-a106-6d1c7734ee3a	238ac419-b6ce-4547-9177-f9db2671f1f6
2408695	2408695	0	GBIF Portugal	673f7038-4262-4149-b753-5658a4e912f6	24baf0da-60a9-4a13-99d7-a8c860c3cb30
273	273	0	GBIF Germany	4f6826f2-4ff6-443d-b966-e6913bd24013	285a0d08-6a9d-459b-8071-244a8ab013c4
44	44	0	Participant Node Managers Committee	7f48e0c8-5c96-49ec-b972-30748e339115	2a401a87-b3e2-4de2-ab2f-e01536f69f01
5623	5623	0	South African Biodiversity Information Facility	7190b835-4e86-4b6e-85c1-19cc6677c250	2cb89f7c-75ac-470b-b372-dc9928a7d7b2
0	15	15	Plazi	ffb07bec-2d10-492d-9c37-361fe0b79427	323251aa-a564-4e42-ba30-058440cdbe71
312	312	0	Plazi	ffb07bec-2d10-492d-9c37-361fe0b79427	3338d9d4-c5fa-4f77-89fb-901b1e028237
15	15	0	Plazi	ffb07bec-2d10-492d-9c37-361fe0b79427	33bd05ac-2eba-486a-8bd9-afbd5916298f
0	2	2	Plazi	ffb07bec-2d10-492d-9c37-361fe0b79427	34e662f6-0e88-4616-b951-3cc825a0e76b
1460	1460	0	GBIF Benin	efb9c00e-f802-45dd-8826-a52ec45b89ff	3eac82ac-f6e9-4637-b307-2ead71525d25
1	1	0	GBIF Portugal	673f7038-4262-4149-b753-5658a4e912f6	3f23468a-fdd7-4327-8178-5bafc023eb40
16	16	0	Plazi	ffb07bec-2d10-492d-9c37-361fe0b79427	3f87b3ca-a2d3-49c5-ae1b-402130e9e134
29337	29337	0	Taiwan Biodiversity Information Facility	e1b85abc-61f9-430f-ba79-6813dec53a0f	3f9cd7e5-6d7b-40a8-8062-a18d2f2ca599
0	319	319	Ocean Biodiversity Information System	ba0670b9-4186-41e6-8e70-f9cb3065551a	40234e8a-0a5d-4eb1-aa3c-1e0989366046
6	6	0	Plazi	ffb07bec-2d10-492d-9c37-361fe0b79427	41345ec5-8471-474d-813c-43580c2c3e07
374	374	0	GBIF Germany	4f6826f2-4ff6-443d-b966-e6913bd24013	4228b5a6-3a0c-11e2-b0ce-00145eb45e9a
2	2	0	Plazi	ffb07bec-2d10-492d-9c37-361fe0b79427	429379eb-d7d6-449c-9667-687bbfd23a1d
0	1	1	Ocean Biodiversity Information System	ba0670b9-4186-41e6-8e70-f9cb3065551a	42baa786-2f73-48de-b0e2-2ca6b2c26b96
23	23	0	Plazi	ffb07bec-2d10-492d-9c37-361fe0b79427	443c4b7d-db24-4e3a-91c2-5bae78d429e7
3	3	0	Plazi	ffb07bec-2d10-492d-9c37-361fe0b79427	458df93d-4b4d-46c0-a9ee-d004cfde7863
3	3	0	Plazi	ffb07bec-2d10-492d-9c37-361fe0b79427	46b4f1d4-82d6-407f-9198-34d8131bb6e3
6	6	0	Plazi	ffb07bec-2d10-492d-9c37-361fe0b79427	46e3c9af-0519-487e-bc94-db4a62ff6f71
1	1	0	Plazi	ffb07bec-2d10-492d-9c37-361fe0b79427	470cb733-e2bb-4321-861a-2698940b4478
0	484	484	Atlas of Living Australia	4a6f1b71-969e-4fc5-a693-282b05e1220c	472206fd-12be-4beb-84fe-0b9b971627db
5	5	0	Participant Node Managers Committee	7f48e0c8-5c96-49ec-b972-30748e339115	49c0d651-9601-41ef-a20b-d599e54f07b6
0	710	710	Canada Biodiversity Information Facility	8f83fc96-c966-4126-83f7-bf044dc49efa	4ad4e91c-8f8f-4c31-a709-1fcb042a0f95
0	2	2	Plazi	ffb07bec-2d10-492d-9c37-361fe0b79427	4e981dd3-e4e6-4419-bbe5-eaa3907d5092
84	84	0	Colombian Biodiversity Information System	7e865cba-7c46-417b-ade5-97f2cf5b7be0	4fd96bf6-d699-41d2-b15d-1faf05ac91ed
661	608	-53	GBIF Germany	4f6826f2-4ff6-443d-b966-e6913bd24013	4fe0abdc-688d-4088-a6ba-d345595f62d9
0	573	573	National Biodiversity Network	d897a5b9-35ee-4232-94bd-b0bcaac003c2	535e1955-802b-402f-a019-d373f38849fc
2	2	0	Plazi	ffb07bec-2d10-492d-9c37-361fe0b79427	573b9469-6a81-4224-a64f-b1525ca7edae
4	4	0	Plazi	ffb07bec-2d10-492d-9c37-361fe0b79427	576197a6-015b-4293-ac10-d8dcf3360f9f
462	462	0	U.S. Geological Survey	8618c64a-93e0-4300-b546-7249e5148ed2	591cd797-d7ec-4e33-9a4f-e3bb242e83e6
7853	7853	0	Biodiversity Information System of Mexico	b324e8e9-9a4c-44fa-8f1a-7f39ea7ab576	5a5dd02d-54f5-4eb5-a191-5a54f77891a5
0	27	27	Ocean Biodiversity Information System	ba0670b9-4186-41e6-8e70-f9cb3065551a	5b58560c-9ffc-48df-b46d-22d9dd4b82d6
1382	1382	0	GBIF France	da44cd31-5901-4687-a106-6d1c7734ee3a	5c5e17e7-fbc1-4452-ac55-b8876e10e289
8	8	0	Participant Node Managers Committee	7f48e0c8-5c96-49ec-b972-30748e339115	5e36b794-82c4-4bf8-8cc7-ba79cc0ca957
0	230	230	Colombian Biodiversity Information System	7e865cba-7c46-417b-ade5-97f2cf5b7be0	61761d8b-27cb-44a7-b445-c3b9dc9a7752
64	64	0	GBIF Germany	4f6826f2-4ff6-443d-b966-e6913bd24013	618d1a8c-f762-11e1-a439-00145eb45e9a
23	23	0	Plazi	ffb07bec-2d10-492d-9c37-361fe0b79427	61d609de-bcb3-4490-ac65-ba7cacda2d72
95	95	0	GBIF Germany	4f6826f2-4ff6-443d-b966-e6913bd24013	622f762e-f762-11e1-a439-00145eb45e9a
1	1	0	Plazi	ffb07bec-2d10-492d-9c37-361fe0b79427	624ca701-2d5a-49bd-87f6-c8a9ab958f69
23	23	0	GBIF Germany	4f6826f2-4ff6-443d-b966-e6913bd24013	6317c550-f762-11e1-a439-00145eb45e9a
83	83	0	GBIF Germany	4f6826f2-4ff6-443d-b966-e6913bd24013	642df734-f762-11e1-a439-00145eb45e9a
61	61	0	GBIF Germany	4f6826f2-4ff6-443d-b966-e6913bd24013	643fe67e-f762-11e1-a439-00145eb45e9a
66	66	0	GBIF Germany	4f6826f2-4ff6-443d-b966-e6913bd24013	6474a9f4-f762-11e1-a439-00145eb45e9a
12	12	0	GBIF Germany	4f6826f2-4ff6-443d-b966-e6913bd24013	65914bb2-f762-11e1-a439-00145eb45e9a
14	14	0	GBIF Germany	4f6826f2-4ff6-443d-b966-e6913bd24013	65d15612-f762-11e1-a439-00145eb45e9a
119	118	-1	GBIF Germany	4f6826f2-4ff6-443d-b966-e6913bd24013	65d72952-f762-11e1-a439-00145eb45e9a
166	162	-4	GBIF Germany	4f6826f2-4ff6-443d-b966-e6913bd24013	65f27aea-f762-11e1-a439-00145eb45e9a
8	8	0	Plazi	ffb07bec-2d10-492d-9c37-361fe0b79427	66107e61-3c0c-43c5-a160-2182e0ffd633
190	190	0	GBIF Germany	4f6826f2-4ff6-443d-b966-e6913bd24013	6643a0f0-f762-11e1-a439-00145eb45e9a
154	154	0	GBIF Germany	4f6826f2-4ff6-443d-b966-e6913bd24013	6729e768-f762-11e1-a439-00145eb45e9a
0	1	1	Plazi	ffb07bec-2d10-492d-9c37-361fe0b79427	682f8989-73a2-4d33-bcee-4ada54a6e90b
76	76	0	GBIF Germany	4f6826f2-4ff6-443d-b966-e6913bd24013	68772e32-f762-11e1-a439-00145eb45e9a
0	7	7	Plazi	ffb07bec-2d10-492d-9c37-361fe0b79427	68afccde-40ee-4471-87bb-93c60786d2e1
302	302	0	GBIF Germany	4f6826f2-4ff6-443d-b966-e6913bd24013	6a5f419e-f762-11e1-a439-00145eb45e9a
24	24	0	GBIF Germany	4f6826f2-4ff6-443d-b966-e6913bd24013	6b41c7d0-f762-11e1-a439-00145eb45e9a
30	30	0	GBIF Germany	4f6826f2-4ff6-443d-b966-e6913bd24013	6b54c042-f762-11e1-a439-00145eb45e9a
24	24	0	GBIF Germany	4f6826f2-4ff6-443d-b966-e6913bd24013	6b7cba70-f762-11e1-a439-00145eb45e9a
12	12	0	GBIF Germany	4f6826f2-4ff6-443d-b966-e6913bd24013	6bd318ac-f762-11e1-a439-00145eb45e9a
16	16	0	Plazi	ffb07bec-2d10-492d-9c37-361fe0b79427	6c854ad1-99de-43de-bc05-ef8d902d38bb
192	192	0	GBIF Germany	4f6826f2-4ff6-443d-b966-e6913bd24013	6ca99cd8-f762-11e1-a439-00145eb45e9a
22	22	0	Plazi	ffb07bec-2d10-492d-9c37-361fe0b79427	6cfcf195-6db0-4b59-ac99-4f587276ba77
1	1	0	Plazi	ffb07bec-2d10-492d-9c37-361fe0b79427	6f9a026c-ac73-47c1-bf17-ffe9bc900f49
8	8	0	GBIF Germany	4f6826f2-4ff6-443d-b966-e6913bd24013	6fa0bd18-f762-11e1-a439-00145eb45e9a
5	5	0	GBIF Germany	4f6826f2-4ff6-443d-b966-e6913bd24013	7178b8c0-f762-11e1-a439-00145eb45e9a
276	276	0	Plazi	ffb07bec-2d10-492d-9c37-361fe0b79427	719fd3b2-e591-4d51-b512-88e1fdeac745
0	13	13	Plazi	ffb07bec-2d10-492d-9c37-361fe0b79427	71acdda2-fd18-4f0b-85b5-88e4f2a2c84c
12157	13110	953	GBIF Germany	4f6826f2-4ff6-443d-b966-e6913bd24013	71f27d90-f762-11e1-a439-00145eb45e9a
4	4	0	Plazi	ffb07bec-2d10-492d-9c37-361fe0b79427	71fe26bd-ea6f-4930-bf7c-60c55cba2169
5451	5451	0	GBIF Germany	4f6826f2-4ff6-443d-b966-e6913bd24013	71ff24d2-f762-11e1-a439-00145eb45e9a
44	44	0	Plazi	ffb07bec-2d10-492d-9c37-361fe0b79427	72108784-cf25-47ce-a673-422196b39246
42	42	0	GBIF Germany	4f6826f2-4ff6-443d-b966-e6913bd24013	724395c2-f762-11e1-a439-00145eb45e9a
17	17	0	Plazi	ffb07bec-2d10-492d-9c37-361fe0b79427	724ba016-3afc-47c4-b630-a3e663945a25
392	392	0	GBIF Germany	4f6826f2-4ff6-443d-b966-e6913bd24013	72bbb84a-f762-11e1-a439-00145eb45e9a
287	287	0	GBIF France	da44cd31-5901-4687-a106-6d1c7734ee3a	72e9f47d-b653-47c8-90e0-f3f91da0c8b6
27777	27777	0	South African Biodiversity Information Facility	7190b835-4e86-4b6e-85c1-19cc6677c250	7401f23d-e962-4828-8646-dc4d8cfc2394
64	64	0	GBIF Germany	4f6826f2-4ff6-443d-b966-e6913bd24013	749fdc18-f762-11e1-a439-00145eb45e9a
0	181	181	Plazi	ffb07bec-2d10-492d-9c37-361fe0b79427	761fcec7-c79d-4e80-bb2b-23cc9e78e0b6
109	109	0	GBIF France	da44cd31-5901-4687-a106-6d1c7734ee3a	76d4ebf0-3a38-4280-98d9-f732f4d2698c
186	98	-88	GBIF Germany	4f6826f2-4ff6-443d-b966-e6913bd24013	77ccd57e-c110-4cc8-b36b-1917050be09f
1145	899	-246	GBIF Germany	4f6826f2-4ff6-443d-b966-e6913bd24013	795e442e-f762-11e1-a439-00145eb45e9a
532	434	-98	GBIF Germany	4f6826f2-4ff6-443d-b966-e6913bd24013	799e24d6-f762-11e1-a439-00145eb45e9a
1949	1331	-618	GBIF Germany	4f6826f2-4ff6-443d-b966-e6913bd24013	79e55216-f762-11e1-a439-00145eb45e9a
857	857	0	GBIF Germany	4f6826f2-4ff6-443d-b966-e6913bd24013	7a6a36d4-f762-11e1-a439-00145eb45e9a
14480	14480	0	National Biodiversity Network	d897a5b9-35ee-4232-94bd-b0bcaac003c2	7aa44448-d392-4f59-b012-5fe364d70926
301	301	0	Korean Biodiversity Information Facility	e0a1e772-0177-4800-94b4-2d023fe6cdf4	7b0cecbc-f762-11e1-a439-00145eb45e9a
0	3	3	Plazi	ffb07bec-2d10-492d-9c37-361fe0b79427	7b9247eb-d72a-41dd-9fb3-cd061c3fbeaa
493	493	0	GBIF Germany	4f6826f2-4ff6-443d-b966-e6913bd24013	7bb5caee-f762-11e1-a439-00145eb45e9a
415	415	0	GBIF Germany	4f6826f2-4ff6-443d-b966-e6913bd24013	7bbec266-f762-11e1-a439-00145eb45e9a
141	141	0	GBIF Germany	4f6826f2-4ff6-443d-b966-e6913bd24013	7d2980f0-f762-11e1-a439-00145eb45e9a
3378	2633	-745	GBIF Germany	4f6826f2-4ff6-443d-b966-e6913bd24013	7d731328-f762-11e1-a439-00145eb45e9a
216	216	0	National Biodiversity Network	d897a5b9-35ee-4232-94bd-b0bcaac003c2	7d7f4d30-bb31-4238-9d4a-58c6d16a752e
5	5	0	GBIF Germany	4f6826f2-4ff6-443d-b966-e6913bd24013	7dec69da-f762-11e1-a439-00145eb45e9a
0	20	20	Plazi	ffb07bec-2d10-492d-9c37-361fe0b79427	7e1fd8ac-534b-4a96-8252-1679b0723fe1
317	317	0	GBIF Germany	4f6826f2-4ff6-443d-b966-e6913bd24013	7e9a84b6-f762-11e1-a439-00145eb45e9a
432	180	-252	GBIF Germany	4f6826f2-4ff6-443d-b966-e6913bd24013	7ec61720-f762-11e1-a439-00145eb45e9a
20	20	0	GBIF Germany	4f6826f2-4ff6-443d-b966-e6913bd24013	7f02a14a-f762-11e1-a439-00145eb45e9a
1645	1645	0	Biodiversity Information System of Mexico	b324e8e9-9a4c-44fa-8f1a-7f39ea7ab576	7f338607-96bb-47b0-8558-f3f73b609269
0	4	4	Plazi	ffb07bec-2d10-492d-9c37-361fe0b79427	812b113f-e8b2-4704-9e50-060ca26bf480
2438	2438	0	GBIF Germany	4f6826f2-4ff6-443d-b966-e6913bd24013	82757db6-f762-11e1-a439-00145eb45e9a
68	68	0	National Biodiversity Network	d897a5b9-35ee-4232-94bd-b0bcaac003c2	845cbd2e-ffa5-4bd2-9486-90313c2d2ae0
39183	39183	0	U.S. Geological Survey	8618c64a-93e0-4300-b546-7249e5148ed2	847e2306-f762-11e1-a439-00145eb45e9a
34110	34158	48	GBIF Norway	4f829580-180d-46a9-9c87-ed8ec959b545	84b9a51f-ec2e-41dc-9d7a-1e3aa411b939
196	196	0	Plazi	ffb07bec-2d10-492d-9c37-361fe0b79427	84f83638-fe1a-41bc-a7f1-80496ad46be0
32606	32606	0	Participant Node Managers Committee	7f48e0c8-5c96-49ec-b972-30748e339115	859c6946-f762-11e1-a439-00145eb45e9a
2021	1581	-440	GBIF Germany	4f6826f2-4ff6-443d-b966-e6913bd24013	86e76e40-f762-11e1-a439-00145eb45e9a
142	71	-71	GBIF Germany	4f6826f2-4ff6-443d-b966-e6913bd24013	873b15a4-f762-11e1-a439-00145eb45e9a
139	84	-55	GBIF Germany	4f6826f2-4ff6-443d-b966-e6913bd24013	88b935be-f762-11e1-a439-00145eb45e9a
0	47	47	Plazi	ffb07bec-2d10-492d-9c37-361fe0b79427	899b95a0-13b7-42aa-959e-4ad7678fb8a9
0	1	1	Colombian Biodiversity Information System	7e865cba-7c46-417b-ade5-97f2cf5b7be0	89e03c0c-a084-4922-b468-1dc9f9f8003d
286	286	0	GBIF Germany	4f6826f2-4ff6-443d-b966-e6913bd24013	8a0ca5cc-f762-11e1-a439-00145eb45e9a
4	4	0	GBIF Germany	4f6826f2-4ff6-443d-b966-e6913bd24013	8ba743f6-f762-11e1-a439-00145eb45e9a
162	162	0	Biodiversity Information System of Mexico	b324e8e9-9a4c-44fa-8f1a-7f39ea7ab576	8da53f1a-8ed7-4c91-8b47-f51f3be8bd1d
0	18878	18878	DanBIF - Danish Biodiversity Information Facility	4ddd294f-02b7-4359-ac33-0806a9ca9c6b	8e1b54db-ce7f-402e-a36e-c1382f0b7b97
4	4	0	GBIF Germany	4f6826f2-4ff6-443d-b966-e6913bd24013	8e2df796-f762-11e1-a439-00145eb45e9a
0	2268	2268	Colombian Biodiversity Information System	7e865cba-7c46-417b-ade5-97f2cf5b7be0	8e792742-1f4e-4619-b39b-200b8685260a
750	750	0	Ocean Biodiversity Information System	ba0670b9-4186-41e6-8e70-f9cb3065551a	90f2713a-79ac-4d96-9a66-889a5fb9abb1
1	1	0	Plazi	ffb07bec-2d10-492d-9c37-361fe0b79427	91304cde-1cb9-49cc-b09e-1ab84e68b126
4120	4120	0	Participant Node Managers Committee	7f48e0c8-5c96-49ec-b972-30748e339115	9192a5a8-5eba-4ec6-a336-797924214175
0	4	4	Plazi	ffb07bec-2d10-492d-9c37-361fe0b79427	91f543ed-028b-49c0-abd7-57e940cc9e12
804	804	0	GBIF Germany	4f6826f2-4ff6-443d-b966-e6913bd24013	942d0718-f762-11e1-a439-00145eb45e9a
135	135	0	GBIF Germany	4f6826f2-4ff6-443d-b966-e6913bd24013	9448b3f0-f762-11e1-a439-00145eb45e9a
156	156	0	GBIF France	da44cd31-5901-4687-a106-6d1c7734ee3a	9451a655-2ca4-475a-af56-665dd78e0d8a
72	72	0	GBIF Germany	4f6826f2-4ff6-443d-b966-e6913bd24013	959ee97c-f762-11e1-a439-00145eb45e9a
44	44	0	GBIF Germany	4f6826f2-4ff6-443d-b966-e6913bd24013	95a63830-f762-11e1-a439-00145eb45e9a
31342	33132	1790	GBIF Germany	4f6826f2-4ff6-443d-b966-e6913bd24013	96582dc4-f762-11e1-a439-00145eb45e9a
624	624	0	Colombian Biodiversity Information System	7e865cba-7c46-417b-ade5-97f2cf5b7be0	96e5a2f0-d008-4136-955c-83cd139b23c6
2970	2970	0	South African Biodiversity Information Facility	7190b835-4e86-4b6e-85c1-19cc6677c250	96f53e46-902a-48d5-a599-7c96c065b214
0	31	31	Plazi	ffb07bec-2d10-492d-9c37-361fe0b79427	97e7f88b-b01e-499f-9074-bd73dd981043
5168	5168	0	National Biodiversity Network	d897a5b9-35ee-4232-94bd-b0bcaac003c2	9946bfe1-e59e-4879-81ac-dae1b348c4e4
2430	2430	0	National Biodiversity Network	d897a5b9-35ee-4232-94bd-b0bcaac003c2	9c40055e-ea35-49a4-ae85-2466438a04a8
50	50	0	Plazi	ffb07bec-2d10-492d-9c37-361fe0b79427	9f3541fc-3179-4592-ac05-8c4726a7b00c
0	167091	167091	Canada Biodiversity Information Facility	8f83fc96-c966-4126-83f7-bf044dc49efa	9fcd8de5-a2b6-4c72-b863-debe63ee3a72
555	555	0	Ocean Biodiversity Information System	ba0670b9-4186-41e6-8e70-f9cb3065551a	a156f7eb-cf32-4840-aa3c-5318d78d7eff
0	100786	100786	National Biodiversity Network	d897a5b9-35ee-4232-94bd-b0bcaac003c2	a2a36824-70bb-431a-a5a4-1f848e5cc9b3
2	2	0	Plazi	ffb07bec-2d10-492d-9c37-361fe0b79427	a400245c-823c-424a-ba97-eb4d506247e7
1460	1460	0	GBIF Japan	db5705aa-6a6e-42f1-8942-d77b9f4896ea	a58ff47c-b609-49c7-982a-7f0194b13472
254	254	0	GBIF Germany	4f6826f2-4ff6-443d-b966-e6913bd24013	a62b4352-d922-41ce-a882-83133ab2ffdd
94	94	0	Plazi	ffb07bec-2d10-492d-9c37-361fe0b79427	a813be74-4065-4caf-a7ee-b4e0ba1ae939
241	241	0	Participant Node Managers Committee	7f48e0c8-5c96-49ec-b972-30748e339115	a8b2da2c-a818-4851-9a42-2e910753c6ea
1215	1215	0	Colombian Biodiversity Information System	7e865cba-7c46-417b-ade5-97f2cf5b7be0	a8e534dd-7b00-458c-a4c7-ca539ea28ff8
0	2069	2069	Ocean Biodiversity Information System	ba0670b9-4186-41e6-8e70-f9cb3065551a	aa0272db-f7cc-401f-8573-25cc4fc8ac65
16	16	0	Plazi	ffb07bec-2d10-492d-9c37-361fe0b79427	aaf46e46-0638-46fa-aea2-fe501b020c96
67	67	0	GBIF France	da44cd31-5901-4687-a106-6d1c7734ee3a	b03cfa51-03a0-4208-94a7-6d03fd9d9a04
34	34	0	Plazi	ffb07bec-2d10-492d-9c37-361fe0b79427	b0f64eab-2b27-4363-b4ed-d599ff7d5a44
201	201	0	GBIF Spain	1f94b3ca-9345-4d65-afe2-4bace93aa0fe	b1b5147c-0ff8-4c3c-aff0-c5d78aff44db
2177	2177	0	GBIF Germany	4f6826f2-4ff6-443d-b966-e6913bd24013	b2842df4-f897-4fa7-8f6b-aa154db06d3f
88	88	0	GBIF Germany	4f6826f2-4ff6-443d-b966-e6913bd24013	b6aed881-9cc6-4741-94b3-dd11feb76b4f
1627	1627	0	National Biodiversity Network	d897a5b9-35ee-4232-94bd-b0bcaac003c2	b6da6358-dd77-41fe-848e-1383f14a9ffb
8	8	0	Plazi	ffb07bec-2d10-492d-9c37-361fe0b79427	b71cb93f-8b72-4949-9be6-bde4505198d0
6	6	0	Plazi	ffb07bec-2d10-492d-9c37-361fe0b79427	b84dcc61-5e37-4de0-85f3-59e65bc202f3
13947	21762	7815	GBIF Germany	4f6826f2-4ff6-443d-b966-e6913bd24013	b89a7f02-021d-4e7a-b19f-575d10578a6d
2	2	0	Plazi	ffb07bec-2d10-492d-9c37-361fe0b79427	ba1632d3-9982-4f98-a5e4-f47900eda1e6
0	53	53	Plazi	ffb07bec-2d10-492d-9c37-361fe0b79427	bbff2b88-99dd-461e-bba6-7326d82dd9f1
122	122	0	Ocean Biodiversity Information System	ba0670b9-4186-41e6-8e70-f9cb3065551a	bd8949d4-319c-48c2-b39b-61cf419f7073
20818	20818	0	GBIF Norway	4f829580-180d-46a9-9c87-ed8ec959b545	bdaa0157-b8bd-4106-b943-61f1dfcc9792
1	1	0	Plazi	ffb07bec-2d10-492d-9c37-361fe0b79427	be77760c-2d20-4a90-ba81-6897f69e3353
1	1	0	Plazi	ffb07bec-2d10-492d-9c37-361fe0b79427	c482bd26-6128-4a6f-8707-b44b82e77f10
10	10	0	Plazi	ffb07bec-2d10-492d-9c37-361fe0b79427	c5a80e95-0675-435d-b834-3ccc1694559d
0	57	57	Plazi	ffb07bec-2d10-492d-9c37-361fe0b79427	c6787a76-50d1-460d-8e89-da28ab07a203
4	4	0	Plazi	ffb07bec-2d10-492d-9c37-361fe0b79427	c8239bdd-76a0-481f-893c-e7969f4a6e2d
101	101	0	Plazi	ffb07bec-2d10-492d-9c37-361fe0b79427	cb56b0e3-1b88-4a89-b478-186e2b30721f
59083	59083	0	GBIF France	da44cd31-5901-4687-a106-6d1c7734ee3a	d23e32b4-5d32-4947-b2e4-734342cb24a3
0	5	5	Plazi	ffb07bec-2d10-492d-9c37-361fe0b79427	d2c30063-5f19-4214-bee4-d78008fa86bd
0	50	50	GBIF Ecuador	2dc472f1-c3d9-486d-b3c1-12ca7ba1ed22	d3209204-de4f-4680-957e-6523f5a4447c
2560	2566	6	Biodiversity Information System of Mexico	b324e8e9-9a4c-44fa-8f1a-7f39ea7ab576	ddb02801-3efd-41ef-884f-d9153d200257
40281	40281	0	U.S. Geological Survey	8618c64a-93e0-4300-b546-7249e5148ed2	de4500ba-fe61-4a51-a0c6-e01c3016c6eb
1	1	0	Plazi	ffb07bec-2d10-492d-9c37-361fe0b79427	e0249d31-07fe-482a-8d9d-e5f9cb941e92
3874	3874	0	GBIF France	da44cd31-5901-4687-a106-6d1c7734ee3a	e06381a8-4bb9-4c34-a35a-fd6cb7101a12
30	30	0	National Biodiversity Network	d897a5b9-35ee-4232-94bd-b0bcaac003c2	e0cf479c-4941-44ff-a169-f47187a422f1
6	6	0	Plazi	ffb07bec-2d10-492d-9c37-361fe0b79427	e18a289e-f0a8-46f9-99e9-e34b5cbe0df0
24	24	0	Plazi	ffb07bec-2d10-492d-9c37-361fe0b79427	e326c808-0236-47a8-a3a0-4bf06f2d04c1
1	1	0	Participant Node Managers Committee	7f48e0c8-5c96-49ec-b972-30748e339115	e4fa4c8d-d804-4e81-9da1-368dab794491
18861	18861	0	GBIF France	da44cd31-5901-4687-a106-6d1c7734ee3a	e54e33cb-83fc-4bdd-8301-7050825f3e2b
2718	2718	0	GBIF France	da44cd31-5901-4687-a106-6d1c7734ee3a	e82b3c80-3600-4848-8540-c82feb3cf006
8	8	0	Plazi	ffb07bec-2d10-492d-9c37-361fe0b79427	ec34603c-c149-40e0-875d-f7b177c9cf3b
0	8	8	Plazi	ffb07bec-2d10-492d-9c37-361fe0b79427	ecb2d6a0-1d92-46a3-813b-d2bc7cfa1c2b
0	13	13	Plazi	ffb07bec-2d10-492d-9c37-361fe0b79427	edb3b9cd-6483-4630-9013-436a42206581
0	39	39	Plazi	ffb07bec-2d10-492d-9c37-361fe0b79427	f0721f19-9f1f-43a2-9c52-25c1838ed2c6
28	28	0	Biodiversity Information System of Mexico	b324e8e9-9a4c-44fa-8f1a-7f39ea7ab576	f177e6d9-1a21-4f55-906f-fdc4f344f814
1	1	0	Plazi	ffb07bec-2d10-492d-9c37-361fe0b79427	f36c5d06-ad05-4b3c-8ded-ebb9fa8afd72
204	204	0	GBIF Malawi	2a42e4d7-ad4a-41b3-84c4-de4aa7b74d35	f5b749ce-3659-4695-8af5-06be3e421688
30	30	0	Korean Biodiversity Information Facility	e0a1e772-0177-4800-94b4-2d023fe6cdf4	f5bb1106-44bd-4fef-b806-3606e229c41d
9	9	0	Plazi	ffb07bec-2d10-492d-9c37-361fe0b79427	f66172d5-c21d-4a42-b3de-c33fea3234f5
3	3	0	Plazi	ffb07bec-2d10-492d-9c37-361fe0b79427	f6df6758-191f-45b4-bb7a-0bd04adae339
2	2	0	Plazi	ffb07bec-2d10-492d-9c37-361fe0b79427	f7924a95-abc6-4b20-b365-1a9f8a4bbf82
1520	1520	0	GBIF Argentina	2426a871-9feb-40a1-96c6-0c593a76b835	f812093f-5e56-42c9-be74-bd85c68e29e7
247	247	0	GBIF Finland	dd514216-5c7c-45f3-910d-797424cb5be6	f8582bf9-e1e3-4b33-9539-7112937aab63
1963	1963	0	National Biodiversity Network	d897a5b9-35ee-4232-94bd-b0bcaac003c2	f8c6823b-c854-48b1-a449-5cc1704bc7a3
0	27	27	Plazi	ffb07bec-2d10-492d-9c37-361fe0b79427	fba570b2-6a41-4565-9b2a-903fee19af14
3	3	0	Plazi	ffb07bec-2d10-492d-9c37-361fe0b79427	fc07b249-7913-48e4-89f6-e760087aba64
0	204	204	Belgian Biodiversity Platform	fb11cfe1-ebc3-45af-9159-17d9fddbcdac	fc4e2dc0-3d87-4881-b59f-192c0afde08f
595	595	0	Colombian Biodiversity Information System	7e865cba-7c46-417b-ade5-97f2cf5b7be0	fddce2c5-1687-47e4-ac9c-7f55bba9a0a3
3183	3183	0	GBIF Japan	db5705aa-6a6e-42f1-8942-d77b9f4896ea	fe34f771-4df6-4f07-910b-12948dde2180
0	5	5	Plazi	ffb07bec-2d10-492d-9c37-361fe0b79427	01037cc6-51ee-42b2-8a7d-4ac91c6ab3e7
1715184	1715184	0	National Biodiversity Network	d897a5b9-35ee-4232-94bd-b0bcaac003c2	02d1e772-54ee-4767-b4b8-c35f0c7270ba
0	3626	3626	Ocean Biodiversity Information System	ba0670b9-4186-41e6-8e70-f9cb3065551a	046fedf4-29ee-45e9-a421-a4b82c229f1d
432	432	0	Colombian Biodiversity Information System	7e865cba-7c46-417b-ade5-97f2cf5b7be0	05a6cd1c-4ed9-40bb-9566-b9c7383dcd4c
238	100	-138	GBIF Germany	4f6826f2-4ff6-443d-b966-e6913bd24013	064734d1-8d5b-4272-aef9-4257f29618ce
8478	8478	0	GBIF New Zealand	4f9fd726-20dd-445e-89a1-8ed93792276f	081facf0-b768-41ad-b692-3b30a1bcbb1b
1369	1464	95	Atlas of Living Australia	4a6f1b71-969e-4fc5-a693-282b05e1220c	0a9ada31-8f3e-412b-ac1c-2881e00ad3d9
0	1	1	Plazi	ffb07bec-2d10-492d-9c37-361fe0b79427	0b25bedc-a333-4163-b6f5-3f3e2baccbcc
4716	5810	1094	U.S. Geological Survey	8618c64a-93e0-4300-b546-7249e5148ed2	0c7a975e-9f63-4a0f-b8ce-e37f8f70e777
178	907	729	Participant Node Managers Committee	7f48e0c8-5c96-49ec-b972-30748e339115	0cbd57d0-d99e-49f9-b364-2621eea43d52
99	99	0	National Biodiversity Network	d897a5b9-35ee-4232-94bd-b0bcaac003c2	0ec43e7f-852a-4a13-9a15-1a8b66253844
491	491	0	Biodiversity Information System of Mexico	b324e8e9-9a4c-44fa-8f1a-7f39ea7ab576	0ffe005a-c42f-4d74-b3d7-b400048ee8b7
0	3	3	Plazi	ffb07bec-2d10-492d-9c37-361fe0b79427	102c4ace-4626-4232-9858-8c4e5c37f9a7
0	8	8	Plazi	ffb07bec-2d10-492d-9c37-361fe0b79427	135c0e6a-ff75-4a2a-852c-add35ec73b40
14	14	0	Plazi	ffb07bec-2d10-492d-9c37-361fe0b79427	147088c7-7c06-4a60-8e64-034a6136a4f6
0	1	1	Plazi	ffb07bec-2d10-492d-9c37-361fe0b79427	1577e5f5-b4ef-4ba8-a7c2-d9a47fa0b6a0
0	93	93	Plazi	ffb07bec-2d10-492d-9c37-361fe0b79427	190bd627-4b6b-4483-afa0-0aa04972a177
0	112	112	Plazi	ffb07bec-2d10-492d-9c37-361fe0b79427	1f5ee6c2-2635-44a8-8469-49319b7a8c62
654	654	0	GBIF Norway	4f829580-180d-46a9-9c87-ed8ec959b545	1f8694bd-6207-4685-921e-d29db4243947
60	60	0	GBIF France	da44cd31-5901-4687-a106-6d1c7734ee3a	268b72be-25ab-4020-93b5-4e400f97c102
78	78	0	Plazi	ffb07bec-2d10-492d-9c37-361fe0b79427	269cf599-428d-464d-8f21-994d69110c5c
0	4379	4379	U.S. Geological Survey	8618c64a-93e0-4300-b546-7249e5148ed2	26c7440a-f4e4-4564-9901-9aac6e116536
0	241	241	Colombian Biodiversity Information System	7e865cba-7c46-417b-ade5-97f2cf5b7be0	27343563-43b6-4bbd-b449-c10ba812fda2
0	9	9	Plazi	ffb07bec-2d10-492d-9c37-361fe0b79427	2ec11cc0-8c0d-4dcd-bf52-f7c89246d087
0	7	7	Ocean Biodiversity Information System	ba0670b9-4186-41e6-8e70-f9cb3065551a	32236512-b8e8-4ca8-bc1d-a65da4d257f8
275	275	0	Participant Node Managers Committee	7f48e0c8-5c96-49ec-b972-30748e339115	385f5b18-5ceb-4458-ab4b-84d7850034fd
0	3	3	Plazi	ffb07bec-2d10-492d-9c37-361fe0b79427	3997d831-ae29-42d0-ba99-cd20cc8b7fc3
0	5	5	Plazi	ffb07bec-2d10-492d-9c37-361fe0b79427	3a97936d-8db1-4aaa-99b2-140ea063540a
0	10	10	Plazi	ffb07bec-2d10-492d-9c37-361fe0b79427	3bf755cf-854f-42c9-a092-d0a9837c3877
1	1	0	Plazi	ffb07bec-2d10-492d-9c37-361fe0b79427	3fdba419-604c-497c-9c89-a1f6be25fc92
0	3	3	Plazi	ffb07bec-2d10-492d-9c37-361fe0b79427	4074b185-a219-4e7e-b1bd-1bc4bd3ef9e7
0	4	4	Plazi	ffb07bec-2d10-492d-9c37-361fe0b79427	4282eef7-8222-491b-b47a-879771ac17ea
0	131	131	Plazi	ffb07bec-2d10-492d-9c37-361fe0b79427	429136c9-4275-463d-aec5-198d190b3524
130	130	0	GBIF France	da44cd31-5901-4687-a106-6d1c7734ee3a	447efe76-7223-45a7-b669-6a7e4e772dea
30	30	0	Colombian Biodiversity Information System	7e865cba-7c46-417b-ade5-97f2cf5b7be0	447f271e-5303-4ce7-9fe3-bef395d591ef
10	10	0	Plazi	ffb07bec-2d10-492d-9c37-361fe0b79427	473446c3-43de-49d9-8661-561ebd1733e4
342200	342200	0	GBIF France	da44cd31-5901-4687-a106-6d1c7734ee3a	483dd49a-7b02-4697-bce4-6d8564be9c9c
0	13	13	Ocean Biodiversity Information System	ba0670b9-4186-41e6-8e70-f9cb3065551a	48b63152-3893-44c8-9117-b77f63be048a
1945	1945	0	Colombian Biodiversity Information System	7e865cba-7c46-417b-ade5-97f2cf5b7be0	49604496-95c1-453f-93f3-590b56e57f78
27033	27033	0	GBIF Spain	1f94b3ca-9345-4d65-afe2-4bace93aa0fe	4edae129-fbdd-412b-8296-7bdb361d61f4
23	23	0	Plazi	ffb07bec-2d10-492d-9c37-361fe0b79427	50513da8-e5ff-4c11-bb0e-3afed74cb0da
2	2	0	Plazi	ffb07bec-2d10-492d-9c37-361fe0b79427	52f3e82f-ad51-41ac-948d-5e72d29f551f
438	438	0	Plazi	ffb07bec-2d10-492d-9c37-361fe0b79427	53b13716-5bbb-42df-b688-a954563b0525
0	1	1	Plazi	ffb07bec-2d10-492d-9c37-361fe0b79427	54b7c513-4651-4292-af4e-e0bca488a4fa
34520	34520	0	U.S. Geological Survey	8618c64a-93e0-4300-b546-7249e5148ed2	56e311e3-43c6-4b99-aa21-af396074d5e3
120492	120492	0	U.S. Geological Survey	8618c64a-93e0-4300-b546-7249e5148ed2	56e9c560-bd2a-11dd-b15e-b8a03c50a862
0	608	608	Ocean Biodiversity Information System	ba0670b9-4186-41e6-8e70-f9cb3065551a	571d3d6a-c6f9-4a02-bdbd-0a1a8c023bdf
37325	37325	0	Participant Node Managers Committee	7f48e0c8-5c96-49ec-b972-30748e339115	59876921-fda6-4fd5-af5d-cba2a7152527
1408	1407	-1	Biodiversity Information System of Mexico	b324e8e9-9a4c-44fa-8f1a-7f39ea7ab576	5ced9d84-7773-47b4-b649-7279259f0453
18	18	0	GBIF Germany	4f6826f2-4ff6-443d-b966-e6913bd24013	61d70b42-f762-11e1-a439-00145eb45e9a
65	65	0	GBIF Germany	4f6826f2-4ff6-443d-b966-e6913bd24013	61f41dfe-f762-11e1-a439-00145eb45e9a
83	83	0	GBIF Germany	4f6826f2-4ff6-443d-b966-e6913bd24013	6270da9c-f762-11e1-a439-00145eb45e9a
8	8	0	GBIF Germany	4f6826f2-4ff6-443d-b966-e6913bd24013	62f1e344-f762-11e1-a439-00145eb45e9a
4	4	0	Plazi	ffb07bec-2d10-492d-9c37-361fe0b79427	641cd26f-54db-4069-9513-6ad899ed6b4e
254	254	0	National Biodiversity Network	d897a5b9-35ee-4232-94bd-b0bcaac003c2	6584ac06-820a-4176-981d-b26f5b19ab5e
0	26	26	Colombian Biodiversity Information System	7e865cba-7c46-417b-ade5-97f2cf5b7be0	65ef8930-ca21-4b5c-b6bb-464a49b826ad
12	12	0	Colombian Biodiversity Information System	7e865cba-7c46-417b-ade5-97f2cf5b7be0	679d9e42-c59c-4e26-98d2-2e4e1b0740ab
128	128	0	GBIF Germany	4f6826f2-4ff6-443d-b966-e6913bd24013	684b37b4-f762-11e1-a439-00145eb45e9a
159	159	0	GBIF Germany	4f6826f2-4ff6-443d-b966-e6913bd24013	688736a6-f762-11e1-a439-00145eb45e9a
65	65	0	GBIF Germany	4f6826f2-4ff6-443d-b966-e6913bd24013	68a8b844-f762-11e1-a439-00145eb45e9a
166	166	0	GBIF Germany	4f6826f2-4ff6-443d-b966-e6913bd24013	68c36342-f762-11e1-a439-00145eb45e9a
197	197	0	GBIF Germany	4f6826f2-4ff6-443d-b966-e6913bd24013	6962c054-f762-11e1-a439-00145eb45e9a
456692	456692	0	Korean Biodiversity Information Facility	e0a1e772-0177-4800-94b4-2d023fe6cdf4	6b8e4fd5-d300-4f9c-a176-5685f136ecef
19	19	0	GBIF Germany	4f6826f2-4ff6-443d-b966-e6913bd24013	6bde297c-f762-11e1-a439-00145eb45e9a
8	8	0	GBIF Germany	4f6826f2-4ff6-443d-b966-e6913bd24013	6fc31b4c-f762-11e1-a439-00145eb45e9a
778	607	-171	GBIF Germany	4f6826f2-4ff6-443d-b966-e6913bd24013	6fe5c9f8-f762-11e1-a439-00145eb45e9a
1371	951	-420	GBIF Germany	4f6826f2-4ff6-443d-b966-e6913bd24013	7048b1e4-f762-11e1-a439-00145eb45e9a
78	78	0	Taiwan Biodiversity Information Facility	e1b85abc-61f9-430f-ba79-6813dec53a0f	704a907a-2d51-49a6-937d-cf180887a3fe
4159	1599	-2560	GBIF Germany	4f6826f2-4ff6-443d-b966-e6913bd24013	709e75e8-f762-11e1-a439-00145eb45e9a
21	21	0	GBIF Germany	4f6826f2-4ff6-443d-b966-e6913bd24013	711989b8-f762-11e1-a439-00145eb45e9a
110	110	0	GBIF Germany	4f6826f2-4ff6-443d-b966-e6913bd24013	71c63032-f762-11e1-a439-00145eb45e9a
264	264	0	GBIF Germany	4f6826f2-4ff6-443d-b966-e6913bd24013	721bd8fc-f762-11e1-a439-00145eb45e9a
99	99	0	GBIF Germany	4f6826f2-4ff6-443d-b966-e6913bd24013	72e3c7e0-f762-11e1-a439-00145eb45e9a
6	6	0	Plazi	ffb07bec-2d10-492d-9c37-361fe0b79427	73497131-9fbf-42b2-8943-57d8577d7a6e
2641	2641	0	GBIF Malawi	2a42e4d7-ad4a-41b3-84c4-de4aa7b74d35	7351fca8-d39b-4af5-b23f-fdcd8da0120e
15	15	0	GBIF Germany	4f6826f2-4ff6-443d-b966-e6913bd24013	747ca900-f762-11e1-a439-00145eb45e9a
257	257	0	GBIF Germany	4f6826f2-4ff6-443d-b966-e6913bd24013	74806f86-f762-11e1-a439-00145eb45e9a
78	78	0	GBIF Germany	4f6826f2-4ff6-443d-b966-e6913bd24013	74eb2ee8-f762-11e1-a439-00145eb45e9a
22	22	0	GBIF Germany	4f6826f2-4ff6-443d-b966-e6913bd24013	750b99a8-f762-11e1-a439-00145eb45e9a
1545	1546	1	U.S. Geological Survey	8618c64a-93e0-4300-b546-7249e5148ed2	76fda5bd-86a1-404d-89df-b5af9dd3a961
210	199	-11	GBIF Germany	4f6826f2-4ff6-443d-b966-e6913bd24013	776f6954-f762-11e1-a439-00145eb45e9a
64	64	0	GBIF Germany	4f6826f2-4ff6-443d-b966-e6913bd24013	79c9fa48-f762-11e1-a439-00145eb45e9a
925	647	-278	GBIF Germany	4f6826f2-4ff6-443d-b966-e6913bd24013	79e1cb82-f762-11e1-a439-00145eb45e9a
0	41	41	Plazi	ffb07bec-2d10-492d-9c37-361fe0b79427	7a76dd6f-bb26-4ca4-aa56-0a30df56743d
411	411	0	Korean Biodiversity Information Facility	e0a1e772-0177-4800-94b4-2d023fe6cdf4	7afcb874-f762-11e1-a439-00145eb45e9a
103455	103455	0	Ocean Biodiversity Information System	ba0670b9-4186-41e6-8e70-f9cb3065551a	7b940ada-f762-11e1-a439-00145eb45e9a
315	315	0	GBIF Japan	db5705aa-6a6e-42f1-8942-d77b9f4896ea	7bafc0d6-f762-11e1-a439-00145eb45e9a
226	226	0	GBIF Germany	4f6826f2-4ff6-443d-b966-e6913bd24013	7be12d06-f762-11e1-a439-00145eb45e9a
493	464	-29	GBIF Germany	4f6826f2-4ff6-443d-b966-e6913bd24013	7c010e32-f762-11e1-a439-00145eb45e9a
94	94	0	GBIF Germany	4f6826f2-4ff6-443d-b966-e6913bd24013	7c038aae-f762-11e1-a439-00145eb45e9a
1818	1818	0	Biodiversity Information System of Mexico	b324e8e9-9a4c-44fa-8f1a-7f39ea7ab576	7c57418d-6abd-47a5-ad43-86c7ebf93d0e
1151	1151	0	GBIF Germany	4f6826f2-4ff6-443d-b966-e6913bd24013	7c6451c2-f762-11e1-a439-00145eb45e9a
11322	4440	-6882	GBIF Germany	4f6826f2-4ff6-443d-b966-e6913bd24013	7cb03326-f762-11e1-a439-00145eb45e9a
1089	1089	0	GBIF Germany	4f6826f2-4ff6-443d-b966-e6913bd24013	7d86c06c-f762-11e1-a439-00145eb45e9a
2501	6163	3662	Participant Node Managers Committee	7f48e0c8-5c96-49ec-b972-30748e339115	7dc0d8a3-57da-4090-a959-69a0aad10285
419	1892	1473	GBIF Japan	db5705aa-6a6e-42f1-8942-d77b9f4896ea	7ec20c70-32e9-4548-86f8-3c915bffefdf
227	227	0	Biodiversity Information System of Mexico	b324e8e9-9a4c-44fa-8f1a-7f39ea7ab576	7fa971be-f762-11e1-a439-00145eb45e9a
1826	1826	0	National Biodiversity Network	d897a5b9-35ee-4232-94bd-b0bcaac003c2	818c9f7f-2c4b-48c0-8493-17821473c714
865	865	0	GBIF Germany	4f6826f2-4ff6-443d-b966-e6913bd24013	8232271e-f762-11e1-a439-00145eb45e9a
109	109	0	Belgian Biodiversity Platform	fb11cfe1-ebc3-45af-9159-17d9fddbcdac	824f4ab2-dfa1-4811-97d0-2ee1105b7c53
0	218	218	Participant Node Managers Committee	7f48e0c8-5c96-49ec-b972-30748e339115	8273a301-fa63-4a88-9e06-046aa4e7c6d3
0	2	2	Plazi	ffb07bec-2d10-492d-9c37-361fe0b79427	8357bfe7-0687-42bb-a57b-ce2f63a0832b
18	18	0	Plazi	ffb07bec-2d10-492d-9c37-361fe0b79427	83ddc9a7-a41c-4314-8e53-3b4a6501e390
413	413	0	GBIF Argentina	2426a871-9feb-40a1-96c6-0c593a76b835	8440eddd-15ce-4925-8bcd-e17105e05594
3367	2411	-956	GBIF Germany	4f6826f2-4ff6-443d-b966-e6913bd24013	86bdd3d2-f762-11e1-a439-00145eb45e9a
2425	1832	-593	GBIF Germany	4f6826f2-4ff6-443d-b966-e6913bd24013	8746e73a-f762-11e1-a439-00145eb45e9a
96	96	0	GBIF France	da44cd31-5901-4687-a106-6d1c7734ee3a	87f62455-777c-4562-a2ca-9cde09292507
11	11	0	GBIF Germany	4f6826f2-4ff6-443d-b966-e6913bd24013	889d1a50-f762-11e1-a439-00145eb45e9a
560	560	0	GBIF Germany	4f6826f2-4ff6-443d-b966-e6913bd24013	8be90f66-f762-11e1-a439-00145eb45e9a
357	357	0	GBIF France	da44cd31-5901-4687-a106-6d1c7734ee3a	8d72b9ff-d540-4586-803a-0355f210d99b
28	206	178	Colombian Biodiversity Information System	7e865cba-7c46-417b-ade5-97f2cf5b7be0	8d773885-955d-44e2-b36d-ee45e4b38385
0	2358	2358	GBIF Norway	4f829580-180d-46a9-9c87-ed8ec959b545	8dbe67d7-26df-4810-a989-d246f0e93edb
621	400	-221	GBIF Germany	4f6826f2-4ff6-443d-b966-e6913bd24013	9057c8e4-f762-11e1-a439-00145eb45e9a
2303	1598	-705	GBIF Germany	4f6826f2-4ff6-443d-b966-e6913bd24013	9083c2dc-f762-11e1-a439-00145eb45e9a
8	4	-4	GBIF Germany	4f6826f2-4ff6-443d-b966-e6913bd24013	9114b5f8-f762-11e1-a439-00145eb45e9a
0	25	25	DanBIF - Danish Biodiversity Information Facility	4ddd294f-02b7-4359-ac33-0806a9ca9c6b	911c0b88-ba75-442a-8e43-53466c7db56a
9134	9134	0	GBIF Brazil	cdc9736d-5ff7-4ece-9959-3c744360cdb3	914c3b86-f2a1-4d5e-b343-b2597b9d4542
23	19	-4	GBIF Germany	4f6826f2-4ff6-443d-b966-e6913bd24013	927f7608-f762-11e1-a439-00145eb45e9a
0	255	255	Colombian Biodiversity Information System	7e865cba-7c46-417b-ade5-97f2cf5b7be0	92cab376-1b07-4c80-8ae1-e9450be01098
323	323	0	GBIF Germany	4f6826f2-4ff6-443d-b966-e6913bd24013	9362c34a-f762-11e1-a439-00145eb45e9a
0	1	1	Ocean Biodiversity Information System	ba0670b9-4186-41e6-8e70-f9cb3065551a	973393b8-604f-4184-af83-f86cbc4c82e5
40	40	0	GBIF Germany	4f6826f2-4ff6-443d-b966-e6913bd24013	97814082-f762-11e1-a439-00145eb45e9a
243	243	0	Colombian Biodiversity Information System	7e865cba-7c46-417b-ade5-97f2cf5b7be0	987ccc8c-4257-446c-b125-57960ebb69a7
15	15	0	Plazi	ffb07bec-2d10-492d-9c37-361fe0b79427	9a47b8ee-f3cd-4f4c-a0ff-83a19305de69
43	43	0	Plazi	ffb07bec-2d10-492d-9c37-361fe0b79427	9b5efe0b-1ca6-4468-b462-227be30ffd37
1807	1807	0	Participant Node Managers Committee	7f48e0c8-5c96-49ec-b972-30748e339115	a044815a-afb2-4bce-b23a-99b6810c075f
181	181	0	GBIF Benin	efb9c00e-f802-45dd-8826-a52ec45b89ff	ab022a73-a5da-4b61-8206-86c55b674fe4
2	2	0	Plazi	ffb07bec-2d10-492d-9c37-361fe0b79427	ab0767c3-8f6b-4800-a4eb-d4c096aa0bd0
0	162	162	Ocean Biodiversity Information System	ba0670b9-4186-41e6-8e70-f9cb3065551a	ac8cc5bb-5327-474c-ae67-bafe7728b6f5
0	3	3	Plazi	ffb07bec-2d10-492d-9c37-361fe0b79427	acacfd33-aa94-4928-9f64-49aa7a59a8b2
5856	6505	649	GBIF Brazil	cdc9736d-5ff7-4ece-9959-3c744360cdb3	ad0f71c1-1ddc-4a46-950c-751ceb5b2cf8
150	150	0	Biodiversity Information System of Mexico	b324e8e9-9a4c-44fa-8f1a-7f39ea7ab576	ae379339-581e-4126-9fb1-ea1c1fc91412
0	6	6	Plazi	ffb07bec-2d10-492d-9c37-361fe0b79427	af719e11-0a23-487d-aefa-44712815d3e5
12572	12572	0	GBIF Togo	c9659a3e-07e9-4fcb-83c6-de8b9009a02e	b05dd467-aaf8-4c67-843c-27f049057b78
0	1	1	Plazi	ffb07bec-2d10-492d-9c37-361fe0b79427	b079a0c0-fcdf-4a67-aee2-60c72e21414c
0	6	6	Plazi	ffb07bec-2d10-492d-9c37-361fe0b79427	b33816ea-cc6c-4ebe-b7cb-b70f2bb0775e
718	718	0	GBIF France	da44cd31-5901-4687-a106-6d1c7734ee3a	b494912f-a180-4e65-9840-141681d67a6e
0	3	3	Plazi	ffb07bec-2d10-492d-9c37-361fe0b79427	b7a11f1b-6aa3-4529-b619-221de586ae52
1	1	0	Plazi	ffb07bec-2d10-492d-9c37-361fe0b79427	ba40d3ae-8444-41d5-9bac-b38fbe2f17f1
53	53	0	Plazi	ffb07bec-2d10-492d-9c37-361fe0b79427	baad33c2-93c5-43c7-87e5-96b87bae3df9
0	17	17	Plazi	ffb07bec-2d10-492d-9c37-361fe0b79427	bc05f757-a985-4de1-a08b-eaaeb92a3925
2610	2610	0	Biodiversity Information System of Mexico	b324e8e9-9a4c-44fa-8f1a-7f39ea7ab576	bcd192c2-18bf-44a8-a9df-80f92a1cb76d
0	7	7	U.S. Geological Survey	8618c64a-93e0-4300-b546-7249e5148ed2	bd87a8e3-8408-4df2-a7a7-f5f405620ab8
0	73	73	Participant Node Managers Committee	7f48e0c8-5c96-49ec-b972-30748e339115	be1b10c6-29eb-4879-a55d-62cb89fa8512
2300868	2300868	0	Belgian Biodiversity Platform	fb11cfe1-ebc3-45af-9159-17d9fddbcdac	bfc6fe18-77c7-4ede-a555-9207d60d1d86
0	41	41	Ocean Biodiversity Information System	ba0670b9-4186-41e6-8e70-f9cb3065551a	c15c7913-e0f4-44d6-a246-678ce908a9e5
30	30	0	Plazi	ffb07bec-2d10-492d-9c37-361fe0b79427	c5bf98c6-6ecc-4efc-982e-ab837af9e86a
949	949	0	National Biodiversity Network	d897a5b9-35ee-4232-94bd-b0bcaac003c2	c70f82bb-dcd4-402a-94a6-25b49b23fb0e
1	1	0	Plazi	ffb07bec-2d10-492d-9c37-361fe0b79427	cb81bc4d-9967-4bd1-8882-d9bf81e5ba07
0	77	77	Plazi	ffb07bec-2d10-492d-9c37-361fe0b79427	ce31448f-6b88-4b38-baaf-f02faee96256
452	452	0	U.S. Geological Survey	8618c64a-93e0-4300-b546-7249e5148ed2	d8fd5432-0cb3-4354-8be8-874f2c047f8d
5	5	0	Plazi	ffb07bec-2d10-492d-9c37-361fe0b79427	dc935b9b-2f74-4b50-8dd3-9c4a91dbfe44
1507	1507	0	Biodiversity Information System of Mexico	b324e8e9-9a4c-44fa-8f1a-7f39ea7ab576	dd03d3f4-b4ea-490d-bba7-983888cce902
1	1	0	GBIF France	da44cd31-5901-4687-a106-6d1c7734ee3a	de1da8df-802c-4b2a-b417-27847ea3edb6
2	2	0	Plazi	ffb07bec-2d10-492d-9c37-361fe0b79427	dfccca88-65de-4d9a-8b8a-1ce4d71c007a
3	3	0	Plazi	ffb07bec-2d10-492d-9c37-361fe0b79427	e0c124df-75bd-4fab-8afe-f7e84a575c26
124997	124997	0	U.S. Geological Survey	8618c64a-93e0-4300-b546-7249e5148ed2	e1a01804-881b-42ae-8f97-1e80f697fd56
1913	1913	0	Colombian Biodiversity Information System	7e865cba-7c46-417b-ade5-97f2cf5b7be0	e307fa47-ae87-4fc9-a1a5-b1415adac8be
2	2	0	Plazi	ffb07bec-2d10-492d-9c37-361fe0b79427	e4cde658-ed27-42c9-89da-cda249c3c184
0	25512	25512	Ocean Biodiversity Information System	ba0670b9-4186-41e6-8e70-f9cb3065551a	e80fa6fc-5468-4ee7-8a74-e6dea5ccfaf9
33	33	0	Plazi	ffb07bec-2d10-492d-9c37-361fe0b79427	e96f0a31-8cfd-4f96-96d1-189ad5392f31
114	114	0	GBIF France	da44cd31-5901-4687-a106-6d1c7734ee3a	e98d09ac-2e31-44f4-9d42-4e89022ac9cb
1320	1320	0	U.S. Geological Survey	8618c64a-93e0-4300-b546-7249e5148ed2	ec0d2fe8-21b1-4ab1-8b91-67873e8ca912
18	18	0	Plazi	ffb07bec-2d10-492d-9c37-361fe0b79427	ec2388ec-d288-4a38-ba8f-11015339c095
28	28	0	Plazi	ffb07bec-2d10-492d-9c37-361fe0b79427	efe96d69-d39e-4c88-a8e3-96c3c9ae3425
0	3	3	Plazi	ffb07bec-2d10-492d-9c37-361fe0b79427	f098b26c-9433-4992-b078-c3e3e1d78209
0	1	1	Plazi	ffb07bec-2d10-492d-9c37-361fe0b79427	f1a369d4-4e7e-4e4d-882e-888d46012707
0	16	16	Plazi	ffb07bec-2d10-492d-9c37-361fe0b79427	f2cccd3d-fea3-48e1-8676-4c7195f8e77c
26	26	0	Colombian Biodiversity Information System	7e865cba-7c46-417b-ade5-97f2cf5b7be0	f4bd8820-5840-48b8-a53b-0310e3ca60b7
14	14	0	Plazi	ffb07bec-2d10-492d-9c37-361fe0b79427	f4f7dd3b-b6b5-4c0f-92a4-3766b8e03682
0	2	2	Plazi	ffb07bec-2d10-492d-9c37-361fe0b79427	f55bcb9b-ff76-463c-b36f-884987a1da43
0	49	49	Plazi	ffb07bec-2d10-492d-9c37-361fe0b79427	f74cc436-90c8-4bd8-b9f7-c88a53871978
1384	1384	0	Colombian Biodiversity Information System	7e865cba-7c46-417b-ade5-97f2cf5b7be0	f77a9a9d-b758-425e-b9a8-739c6de07e5c
2433	2433	0	GBIF France	da44cd31-5901-4687-a106-6d1c7734ee3a	f8ca1960-9390-4e66-b204-00ed31cb7b34
0	13	13	Ocean Biodiversity Information System	ba0670b9-4186-41e6-8e70-f9cb3065551a	fbd3e207-7b2c-4e89-a322-6a1f09553538
0	2	2	Plazi	ffb07bec-2d10-492d-9c37-361fe0b79427	fd46e672-7c7d-4579-a7a9-0209e50fc3c6
3	3	0	Plazi	ffb07bec-2d10-492d-9c37-361fe0b79427	fe02b10e-ce13-4174-b0c4-b04af1c4161e
462	462	0	National Biodiversity Network	d897a5b9-35ee-4232-94bd-b0bcaac003c2	fe62fe7b-a441-4ab1-9451-bb016674c706
15	15	0	GBIF France	da44cd31-5901-4687-a106-6d1c7734ee3a	014e1cd3-6d40-4dd6-8543-af295fef377f
828	1220	392	GBIF Japan	db5705aa-6a6e-42f1-8942-d77b9f4896ea	02396af3-59b1-43ad-8a54-5029557825e5
1590	1590	0	National Biodiversity Network	d897a5b9-35ee-4232-94bd-b0bcaac003c2	04e0550a-e142-4658-9575-3e46fb6675b7
0	17575	17575	National Biodiversity Network	d897a5b9-35ee-4232-94bd-b0bcaac003c2	05835387-a9e6-403a-9c61-02632467ff21
0	4	4	Plazi	ffb07bec-2d10-492d-9c37-361fe0b79427	0952afb5-bd61-4545-a050-d53556a4fc7d
3	3	0	U.S. Geological Survey	8618c64a-93e0-4300-b546-7249e5148ed2	09a17133-1487-440f-93aa-656d75877280
14052	14052	0	Atlas of Living Australia	4a6f1b71-969e-4fc5-a693-282b05e1220c	0a147ef3-8436-44a2-8f06-7820daf54d30
0	11	11	Plazi	ffb07bec-2d10-492d-9c37-361fe0b79427	0a548fa6-7a68-4041-a6f9-060b8efb2c63
12724	12724	0	U.S. Geological Survey	8618c64a-93e0-4300-b546-7249e5148ed2	0b33986b-9b62-451e-ba7a-9c2e777e5580
91	91	0	Colombian Biodiversity Information System	7e865cba-7c46-417b-ade5-97f2cf5b7be0	0d222b01-3d5e-400b-8fca-167e79c46f86
12	12	0	Plazi	ffb07bec-2d10-492d-9c37-361fe0b79427	0d619857-daed-4764-820b-99b924c97c07
20771	20771	0	National Biodiversity Network	d897a5b9-35ee-4232-94bd-b0bcaac003c2	0ee9e63e-8eda-4bb1-aab1-9a29232cf437
1010	1010	0	Colombian Biodiversity Information System	7e865cba-7c46-417b-ade5-97f2cf5b7be0	10cb9850-c9ca-4cc1-a041-a43cf6634d36
0	2	2	Plazi	ffb07bec-2d10-492d-9c37-361fe0b79427	13724e55-530b-44a2-a139-17f84357fda4
11	11	0	Plazi	ffb07bec-2d10-492d-9c37-361fe0b79427	142f0faa-5ba2-4f67-b963-d2e525c4b27d
19	19	0	Plazi	ffb07bec-2d10-492d-9c37-361fe0b79427	1586b06b-82e0-4be6-837e-0d11ca1a5214
1	1	0	Plazi	ffb07bec-2d10-492d-9c37-361fe0b79427	1645bc34-3674-4ef3-bb55-fbc459f86640
1339	1339	0	GBIF Benin	efb9c00e-f802-45dd-8826-a52ec45b89ff	1804f32e-d63c-4aa3-a8fa-e9d6b44d3de0
89	89	0	GBIF France	da44cd31-5901-4687-a106-6d1c7734ee3a	1a5edc28-96a9-4870-8b0a-cf762b7086e7
2394	2394	0	GBIF Portugal	673f7038-4262-4149-b753-5658a4e912f6	1b20ed8a-453f-4496-a713-066a8973ab04
12	12	0	Plazi	ffb07bec-2d10-492d-9c37-361fe0b79427	1cb0e227-6a7f-41f2-8ac7-4a98a9641ad2
19041	19040	-1	Biodiversity Information System of Mexico	b324e8e9-9a4c-44fa-8f1a-7f39ea7ab576	1f6704e8-b455-4f6b-916c-0cd727293fca
10	10	0	Plazi	ffb07bec-2d10-492d-9c37-361fe0b79427	21188528-9db3-4411-8402-62902f3502e8
0	75	75	Participant Node Managers Committee	7f48e0c8-5c96-49ec-b972-30748e339115	2239f4d8-d90a-445b-a39d-6e5556c9c98f
10	10	0	GBIF Germany	4f6826f2-4ff6-443d-b966-e6913bd24013	22d6b6cd-260b-4790-af1a-fa6d01a13fba
65	65	0	GBIF Brazil	cdc9736d-5ff7-4ece-9959-3c744360cdb3	236d8d68-c590-4f68-9c06-6dbd92171a58
1	1	0	Plazi	ffb07bec-2d10-492d-9c37-361fe0b79427	242c8732-8194-4009-9c38-2d0806a038d4
1	1	0	Plazi	ffb07bec-2d10-492d-9c37-361fe0b79427	25715e93-04e8-44fb-a43d-ff97b0f9d7b7
4	4	0	Plazi	ffb07bec-2d10-492d-9c37-361fe0b79427	25c52d53-5912-4ae6-b986-1d320eadf654
60	60	0	Plazi	ffb07bec-2d10-492d-9c37-361fe0b79427	2d860eed-811e-4478-a9d4-1188016c66d1
13	13	0	Plazi	ffb07bec-2d10-492d-9c37-361fe0b79427	3026c846-a607-4826-b2a9-8f7a531baec5
20	20	0	Colombian Biodiversity Information System	7e865cba-7c46-417b-ade5-97f2cf5b7be0	38b0df36-8d7f-4c35-a268-70ed9886a31f
1	1	0	Plazi	ffb07bec-2d10-492d-9c37-361fe0b79427	401f8e4d-f7f4-443f-98e2-ba33dd6b2122
88	88	0	GBIF France	da44cd31-5901-4687-a106-6d1c7734ee3a	42e91293-8593-42de-94cc-755ba7be51cc
0	3	3	Ocean Biodiversity Information System	ba0670b9-4186-41e6-8e70-f9cb3065551a	4ae6488a-5790-4d9a-b6b4-f0a4c77e9048
4	4	0	Plazi	ffb07bec-2d10-492d-9c37-361fe0b79427	4c39ac27-2151-40ae-86d0-c4233ece5e80
3	3	0	Plazi	ffb07bec-2d10-492d-9c37-361fe0b79427	4d7b0cdd-73a9-4eeb-ab24-a3fa7ebfe774
437	437	0	Plazi	ffb07bec-2d10-492d-9c37-361fe0b79427	4db6b327-7482-432e-a5f6-36f91c79fef3
7051	7051	0	GBIF Chile	a8b16421-d80b-4ef3-8f22-098b01a89255	500e7c7f-bacd-48c9-ace0-6ce9cb749ac7
49999	49999	0	GBIF France	da44cd31-5901-4687-a106-6d1c7734ee3a	54bae6ef-8b4e-4ad3-8729-c4296299e5c7
2160	2160	0	GBIF Portugal	673f7038-4262-4149-b753-5658a4e912f6	54df7284-37aa-4584-8484-433100d62c6c
236	236	0	Colombian Biodiversity Information System	7e865cba-7c46-417b-ade5-97f2cf5b7be0	559f2aa5-a767-4088-a787-3682896d844a
187	187	0	GBIF France	da44cd31-5901-4687-a106-6d1c7734ee3a	56fb52a5-3f56-4b8e-8b01-59a5c6d6fae9
88	88	0	Plazi	ffb07bec-2d10-492d-9c37-361fe0b79427	57b938b5-ff1c-4df8-9d94-416d8a3668dc
83	83	0	Biodiversity Information System of Mexico	b324e8e9-9a4c-44fa-8f1a-7f39ea7ab576	5ab95e95-c6ae-4299-9cda-d2047b74e54d
1	1	0	Plazi	ffb07bec-2d10-492d-9c37-361fe0b79427	5e3f5c6c-7f5c-4ce4-b416-b999f9ccc985
13949	13949	0	Netherlands Biodiversity Information Facility	0909d601-bda2-42df-9e63-a6d51847ebce	5e50896f-8bbd-43e7-9ba5-ef7ed7b3e865
153	153	0	GBIF Germany	4f6826f2-4ff6-443d-b966-e6913bd24013	620c7d9a-f762-11e1-a439-00145eb45e9a
142	142	0	GBIF Germany	4f6826f2-4ff6-443d-b966-e6913bd24013	62833278-f762-11e1-a439-00145eb45e9a
1695	1695	0	Atlas of Living Australia	4a6f1b71-969e-4fc5-a693-282b05e1220c	64ec1ba4-08d4-46ef-b40a-68965728e182
629	629	0	GBIF Germany	4f6826f2-4ff6-443d-b966-e6913bd24013	65f7362a-f762-11e1-a439-00145eb45e9a
10	10	0	GBIF Germany	4f6826f2-4ff6-443d-b966-e6913bd24013	666f453e-f762-11e1-a439-00145eb45e9a
0	100	100	Plazi	ffb07bec-2d10-492d-9c37-361fe0b79427	66e2d72d-ad54-494d-80e6-56b6020ef450
167	167	0	GBIF Germany	4f6826f2-4ff6-443d-b966-e6913bd24013	67e0cafa-f762-11e1-a439-00145eb45e9a
0	1	1	Plazi	ffb07bec-2d10-492d-9c37-361fe0b79427	680c1b0e-a2b3-4127-b61b-0760e03b9740
113	74	-39	GBIF Germany	4f6826f2-4ff6-443d-b966-e6913bd24013	683a93e7-7c50-49c2-9167-49cfe9a3c8e9
18	18	0	GBIF Germany	4f6826f2-4ff6-443d-b966-e6913bd24013	693a2234-f762-11e1-a439-00145eb45e9a
16	16	0	GBIF Germany	4f6826f2-4ff6-443d-b966-e6913bd24013	6b09914e-f762-11e1-a439-00145eb45e9a
38	38	0	GBIF Germany	4f6826f2-4ff6-443d-b966-e6913bd24013	6b537e76-f762-11e1-a439-00145eb45e9a
18	18	0	GBIF Germany	4f6826f2-4ff6-443d-b966-e6913bd24013	6b98bb62-f762-11e1-a439-00145eb45e9a
780	780	0	GBIF Germany	4f6826f2-4ff6-443d-b966-e6913bd24013	709ff1f2-f762-11e1-a439-00145eb45e9a
27	12	-15	GBIF Germany	4f6826f2-4ff6-443d-b966-e6913bd24013	712736ee-f762-11e1-a439-00145eb45e9a
1510	556	-954	GBIF Germany	4f6826f2-4ff6-443d-b966-e6913bd24013	71f03224-f762-11e1-a439-00145eb45e9a
99	99	0	GBIF Germany	4f6826f2-4ff6-443d-b966-e6913bd24013	721d0308-f762-11e1-a439-00145eb45e9a
26	26	0	Plazi	ffb07bec-2d10-492d-9c37-361fe0b79427	748a53c9-cd20-4bda-a383-043d270f549c
528	528	0	GBIF Germany	4f6826f2-4ff6-443d-b966-e6913bd24013	7496bb2e-f762-11e1-a439-00145eb45e9a
131	131	0	GBIF Germany	4f6826f2-4ff6-443d-b966-e6913bd24013	75add06a-f762-11e1-a439-00145eb45e9a
28	28	0	GBIF Germany	4f6826f2-4ff6-443d-b966-e6913bd24013	7871bece-492c-461a-b28e-e8a4e8243960
0	3908	3908	Participant Node Managers Committee	7f48e0c8-5c96-49ec-b972-30748e339115	78917bd0-c914-4c8f-9fb2-a961637ac043
33956	34904	948	Symbiota Support Hub	612b5a0b-908b-4b4e-b9bf-ca15dfdc94fa	78f98484-a7ef-4e6c-8b51-7464f1209591
121	121	0	GBIF Germany	4f6826f2-4ff6-443d-b966-e6913bd24013	79ceba06-f762-11e1-a439-00145eb45e9a
95	95	0	Ocean Biodiversity Information System	ba0670b9-4186-41e6-8e70-f9cb3065551a	7b45011a-f762-11e1-a439-00145eb45e9a
65	65	0	Plazi	ffb07bec-2d10-492d-9c37-361fe0b79427	7c894b94-e853-4b19-b380-09f6e0760952
2	2	0	Plazi	ffb07bec-2d10-492d-9c37-361fe0b79427	7d19d012-8cc3-4355-88d9-e90526d4dcef
200	200	0	GBIF Germany	4f6826f2-4ff6-443d-b966-e6913bd24013	7dce81ae-f762-11e1-a439-00145eb45e9a
559	559	0	GBIF Germany	4f6826f2-4ff6-443d-b966-e6913bd24013	7ec04440-c31d-4d04-8115-3fc5241115bf
177	177	0	GBIF France	da44cd31-5901-4687-a106-6d1c7734ee3a	7eceec26-8f3e-4e84-9b34-f9cc6cecd797
191	191	0	GBIF France	da44cd31-5901-4687-a106-6d1c7734ee3a	8106ab81-36e2-4d7e-ad68-05d66a6eb8b5
4688	4688	0	GBIF Spain	1f94b3ca-9345-4d65-afe2-4bace93aa0fe	8112b722-f762-11e1-a439-00145eb45e9a
25446	25446	0	GBIF Japan	db5705aa-6a6e-42f1-8942-d77b9f4896ea	812d3fca-f762-11e1-a439-00145eb45e9a
609	609	0	GBIF Germany	4f6826f2-4ff6-443d-b966-e6913bd24013	81723e04-f762-11e1-a439-00145eb45e9a
0	2	2	Plazi	ffb07bec-2d10-492d-9c37-361fe0b79427	821b958e-ff46-42f5-82af-ea8f9f47b904
2	2	0	Plazi	ffb07bec-2d10-492d-9c37-361fe0b79427	8265bc1a-8903-47d1-a59d-218d749895e5
103049	103700	651	National Biodiversity Network	d897a5b9-35ee-4232-94bd-b0bcaac003c2	82d23348-0fee-4e2d-9152-48136ef54b2d
10090	10090	0	National Biodiversity Network	d897a5b9-35ee-4232-94bd-b0bcaac003c2	82d8c0ec-f762-11e1-a439-00145eb45e9a
2	2	0	Plazi	ffb07bec-2d10-492d-9c37-361fe0b79427	8377a8d1-29d2-46b3-b0a5-2651e79a1178
0	132	132	International Centre for Integrated Mountain Development	b35cf8f1-748d-467a-adca-4f9170f20a4e	841c97b3-a5e1-428f-aa78-5953bdf01328
546	546	0	Canada Biodiversity Information Facility	8f83fc96-c966-4126-83f7-bf044dc49efa	844f5238-f762-11e1-a439-00145eb45e9a
4084	4084	0	DanBIF - Danish Biodiversity Information Facility	4ddd294f-02b7-4359-ac33-0806a9ca9c6b	84cca7ba-f762-11e1-a439-00145eb45e9a
2099	1676	-423	GBIF Germany	4f6826f2-4ff6-443d-b966-e6913bd24013	8742e996-f762-11e1-a439-00145eb45e9a
1	1	0	Plazi	ffb07bec-2d10-492d-9c37-361fe0b79427	889b09d2-2ca5-44f3-9950-18be346b6a4a
899	899	0	GBIF Germany	4f6826f2-4ff6-443d-b966-e6913bd24013	899ea946-f762-11e1-a439-00145eb45e9a
149	149	0	GBIF Germany	4f6826f2-4ff6-443d-b966-e6913bd24013	8a2d6992-f762-11e1-a439-00145eb45e9a
5	5	0	Plazi	ffb07bec-2d10-492d-9c37-361fe0b79427	8a3697cb-b8f5-4860-befa-59c79dbfcad6
73	73	0	GBIF Germany	4f6826f2-4ff6-443d-b966-e6913bd24013	8a7b4216-f762-11e1-a439-00145eb45e9a
124	124	0	GBIF Germany	4f6826f2-4ff6-443d-b966-e6913bd24013	8ac42224-f762-11e1-a439-00145eb45e9a
0	831	831	Ocean Biodiversity Information System	ba0670b9-4186-41e6-8e70-f9cb3065551a	8bbb60c8-681f-4e1f-ba5b-523c44ea4354
57	44	-13	GBIF Germany	4f6826f2-4ff6-443d-b966-e6913bd24013	8cb2c27a-f762-11e1-a439-00145eb45e9a
0	4	4	Plazi	ffb07bec-2d10-492d-9c37-361fe0b79427	8d21a5a0-7c39-4e80-964d-f696d48e850d
9	9	0	Plazi	ffb07bec-2d10-492d-9c37-361fe0b79427	8d769c95-bc44-4f5d-8693-5b52e55ad3ab
392	80	-312	GBIF Germany	4f6826f2-4ff6-443d-b966-e6913bd24013	8dcac5cc-f762-11e1-a439-00145eb45e9a
967	757	-210	GBIF Germany	4f6826f2-4ff6-443d-b966-e6913bd24013	8ec9e8a4-f762-11e1-a439-00145eb45e9a
1283	977	-306	GBIF Germany	4f6826f2-4ff6-443d-b966-e6913bd24013	8ed250a2-f762-11e1-a439-00145eb45e9a
600	336	-264	GBIF Germany	4f6826f2-4ff6-443d-b966-e6913bd24013	905bac70-f762-11e1-a439-00145eb45e9a
178	143	-35	GBIF Germany	4f6826f2-4ff6-443d-b966-e6913bd24013	90c0d186-f762-11e1-a439-00145eb45e9a
186	134	-52	GBIF Germany	4f6826f2-4ff6-443d-b966-e6913bd24013	90cf17f0-f762-11e1-a439-00145eb45e9a
76	51	-25	GBIF Germany	4f6826f2-4ff6-443d-b966-e6913bd24013	910e2364-f762-11e1-a439-00145eb45e9a
3	2	-1	GBIF Germany	4f6826f2-4ff6-443d-b966-e6913bd24013	9131b66c-f762-11e1-a439-00145eb45e9a
452	452	0	GBIF Germany	4f6826f2-4ff6-443d-b966-e6913bd24013	92045a4a-f762-11e1-a439-00145eb45e9a
17	17	0	GBIF Germany	4f6826f2-4ff6-443d-b966-e6913bd24013	9313b9f8-f762-11e1-a439-00145eb45e9a
0	811	811	Plazi	ffb07bec-2d10-492d-9c37-361fe0b79427	9322f2b2-a384-40bf-9d57-d789c76ce5c4
1	1	0	GBIF Germany	4f6826f2-4ff6-443d-b966-e6913bd24013	939ecc14-f762-11e1-a439-00145eb45e9a
4	4	0	GBIF Germany	4f6826f2-4ff6-443d-b966-e6913bd24013	93d2e616-f762-11e1-a439-00145eb45e9a
10	10	0	GBIF Germany	4f6826f2-4ff6-443d-b966-e6913bd24013	93e6c50a-f762-11e1-a439-00145eb45e9a
134	134	0	Plazi	ffb07bec-2d10-492d-9c37-361fe0b79427	951f398c-f88a-4bdc-a6d2-79a3a4a0bae0
14084	14084	0	GBIF Finland	dd514216-5c7c-45f3-910d-797424cb5be6	95a410f0-386b-4792-8e5d-ba2cbeecfbde
0	16	16	Plazi	ffb07bec-2d10-492d-9c37-361fe0b79427	9714f27d-8a27-4277-a23f-6d458e7bae13
26	26	0	GBIF Germany	4f6826f2-4ff6-443d-b966-e6913bd24013	977a916a-f762-11e1-a439-00145eb45e9a
0	4	4	Plazi	ffb07bec-2d10-492d-9c37-361fe0b79427	979f164c-3366-47cd-9aa7-02e5bb2c0136
4290	4290	0	Colombian Biodiversity Information System	7e865cba-7c46-417b-ade5-97f2cf5b7be0	983c4ccb-377d-412f-9eb8-6d96d0c620fa
1	1	0	Plazi	ffb07bec-2d10-492d-9c37-361fe0b79427	999b31f7-5116-41a7-92cc-23e8442d4c56
50642	51265	623	U.S. Geological Survey	8618c64a-93e0-4300-b546-7249e5148ed2	9a201e2f-dada-4cb9-88c7-695e391aeb2f
24	24	0	Plazi	ffb07bec-2d10-492d-9c37-361fe0b79427	9d886e8f-ca13-442d-8abb-cd79272ba339
0	13	13	Participant Node Managers Committee	7f48e0c8-5c96-49ec-b972-30748e339115	a19e14fd-7992-4e72-8474-f06b476100c4
0	18	18	Plazi	ffb07bec-2d10-492d-9c37-361fe0b79427	a3bf6440-2b88-402b-9bbe-107a257286e1
73	73	0	Plazi	ffb07bec-2d10-492d-9c37-361fe0b79427	a59b0c61-41bf-4216-8318-f736997099b1
8008	8008	0	GBIF Argentina	2426a871-9feb-40a1-96c6-0c593a76b835	a6058f47-15ae-412e-b316-912dd6e2ec9b
12	12	0	Plazi	ffb07bec-2d10-492d-9c37-361fe0b79427	a6c67e38-a7b7-4df5-839d-998299fd74b6
0	21	21	Plazi	ffb07bec-2d10-492d-9c37-361fe0b79427	ae92fbc8-7dd7-4fcd-a469-9f09c96946f0
647	647	0	GBIF Madagascar	2dbfc5c5-51b5-4494-9dfc-4d3f013a3b64	af7ff8ba-8ab2-4f50-951e-5fb4df0c7f8f
0	9	9	Plazi	ffb07bec-2d10-492d-9c37-361fe0b79427	b275e04e-a622-4bee-8f9b-9256ef5b9a66
0	11	11	Plazi	ffb07bec-2d10-492d-9c37-361fe0b79427	b556e004-aeb2-4b7b-b860-e139582ebfa9
0	2	2	Plazi	ffb07bec-2d10-492d-9c37-361fe0b79427	b6188841-cdc6-42fa-bb29-ac39d113dd72
106	106	0	GBIF France	da44cd31-5901-4687-a106-6d1c7734ee3a	b82dfd84-2d4b-4d42-8cef-c3a4f0391535
30	30	0	Biodiversity Information System of Mexico	b324e8e9-9a4c-44fa-8f1a-7f39ea7ab576	b838afe5-8368-415c-8bab-659d21589f76
1	1	0	Plazi	ffb07bec-2d10-492d-9c37-361fe0b79427	b9e29874-8452-4e48-8759-275d17c61a05
354	354	0	GBIF France	da44cd31-5901-4687-a106-6d1c7734ee3a	ba202542-f460-4221-972b-03ab2a6d4c41
0	6	6	Plazi	ffb07bec-2d10-492d-9c37-361fe0b79427	ba6a7d23-c04f-40b4-b3c2-9c94e8a6928d
26	26	0	GBIF France	da44cd31-5901-4687-a106-6d1c7734ee3a	bd2d6937-4a61-40d1-b202-31b5de349623
2	2	0	Plazi	ffb07bec-2d10-492d-9c37-361fe0b79427	bdb8184b-4737-46d7-9db0-fcd8857c516a
3	3	0	Plazi	ffb07bec-2d10-492d-9c37-361fe0b79427	bfadd56d-e213-4ff4-865a-cf7614a300dc
8442	8442	0	U.S. Geological Survey	8618c64a-93e0-4300-b546-7249e5148ed2	c053c6ad-e590-4c69-a141-5fd9c8ebbe3c
13	13	0	Plazi	ffb07bec-2d10-492d-9c37-361fe0b79427	c334310a-79e7-4182-862e-566e19c52037
21	21	0	Plazi	ffb07bec-2d10-492d-9c37-361fe0b79427	c6168fb3-61c7-43c0-8faf-8171cd5f3fbf
10	10	0	Plazi	ffb07bec-2d10-492d-9c37-361fe0b79427	cb23c8ce-d093-4dfc-9d46-8f20ee18a6e8
39190	39190	0	Society for the Management of Electronic Biodiversity Data	97818ee4-1461-4180-bf1d-b3201050124f	ce0f1750-ad92-46b7-b8c7-59033460de43
0	2	2	Participant Node Managers Committee	7f48e0c8-5c96-49ec-b972-30748e339115	ceac96c9-6ba3-4a38-97f8-3684364756f5
179	179	0	Plazi	ffb07bec-2d10-492d-9c37-361fe0b79427	d38f7cc0-2c64-4295-aef1-a29ca1050afd
0	874	874	Participant Node Managers Committee	7f48e0c8-5c96-49ec-b972-30748e339115	d3b36936-d030-4ebb-a0f1-d046dcd947e4
2838	2838	0	GBIF Germany	4f6826f2-4ff6-443d-b966-e6913bd24013	d4e61632-2c27-473d-aa68-92727127929d
46664	46664	0	National Biodiversity Network	d897a5b9-35ee-4232-94bd-b0bcaac003c2	dc184bae-d36b-4a9b-985a-dc42913ced1a
0	20	20	Plazi	ffb07bec-2d10-492d-9c37-361fe0b79427	dc4c77fc-fd51-405f-8fd1-eef9fb061c0b
17	17	0	Plazi	ffb07bec-2d10-492d-9c37-361fe0b79427	dd78d512-62e3-4562-8648-2881796c1018
1680	1680	0	GBIF Germany	4f6826f2-4ff6-443d-b966-e6913bd24013	df7c6137-fe0a-4776-ac6b-df1c94f92f1e
0	2	2	Plazi	ffb07bec-2d10-492d-9c37-361fe0b79427	e30fbf6d-d7db-44cf-be8f-03f8d0068b98
7	7	0	Plazi	ffb07bec-2d10-492d-9c37-361fe0b79427	e4845a94-beaf-4958-a577-a576087e46de
8	8	0	Plazi	ffb07bec-2d10-492d-9c37-361fe0b79427	e6439412-43e7-49c1-9852-ea900a5d7c31
66270	66825	555	GBIF Brazil	cdc9736d-5ff7-4ece-9959-3c744360cdb3	e7b96ed9-da1c-4eec-a481-281b1b319e48
0	8	8	Plazi	ffb07bec-2d10-492d-9c37-361fe0b79427	ed6bb867-54ff-4469-b93e-3bbb635d14d2
5120	5120	0	Biodiversity Information System of Mexico	b324e8e9-9a4c-44fa-8f1a-7f39ea7ab576	efd4552a-faa4-4f35-a5ac-007b9ca84e8e
10699	13335	2636	GBIF France	da44cd31-5901-4687-a106-6d1c7734ee3a	eff7d030-3013-43da-b686-6bafdd228131
0	5	5	Plazi	ffb07bec-2d10-492d-9c37-361fe0b79427	f1058b01-dc9a-4206-b616-b58b3cc07f51
30	30	0	National Biodiversity Network	d897a5b9-35ee-4232-94bd-b0bcaac003c2	f5eb599c-ca3b-4f8e-88f9-5ccca517f062
0	7	7	Plazi	ffb07bec-2d10-492d-9c37-361fe0b79427	f8ffe2da-cc47-4208-aa25-12ece5d5b13e
345	345	0	Atlas of Living Australia	4a6f1b71-969e-4fc5-a693-282b05e1220c	f9452582-daf8-4724-a217-4e99af1aea8a
5	5	0	Plazi	ffb07bec-2d10-492d-9c37-361fe0b79427	faefcf9b-3673-4f50-b6a8-8a5d0cbd01de
238549	238549	0	GBIF France	da44cd31-5901-4687-a106-6d1c7734ee3a	fb5bea36-859e-47f1-995d-ee8962d96f41
9	9	0	Participant Node Managers Committee	7f48e0c8-5c96-49ec-b972-30748e339115	0101bbf0-146d-40ed-b32f-b21a64183c47
2	2	0	Plazi	ffb07bec-2d10-492d-9c37-361fe0b79427	02308cb2-2ac2-407f-aa58-b7f5b657fc44
12075	12075	0	Biodiversity Information System of Mexico	b324e8e9-9a4c-44fa-8f1a-7f39ea7ab576	08ccad1b-e79f-4481-94e5-7f47533129ff
2454	855	-1599	GBIF Germany	4f6826f2-4ff6-443d-b966-e6913bd24013	0adec430-7ca2-4133-a087-a5e9a6f4ff20
2	2	0	Plazi	ffb07bec-2d10-492d-9c37-361fe0b79427	0d31fba1-7033-42bf-bcb8-849253d4caaa
32	32	0	Participant Node Managers Committee	7f48e0c8-5c96-49ec-b972-30748e339115	0e12c2cc-0d0e-4300-bcc8-6492ac6eb117
6	6	0	Plazi	ffb07bec-2d10-492d-9c37-361fe0b79427	0ffdae09-7a8d-4c69-8372-0c84e7e72605
72	72	0	Colombian Biodiversity Information System	7e865cba-7c46-417b-ade5-97f2cf5b7be0	11bca344-8615-4dc9-b85c-8ee96a74c798
3197	3197	0	GBIF Finland	dd514216-5c7c-45f3-910d-797424cb5be6	19979096-dada-4247-a5f9-92601a933221
2	2	0	Plazi	ffb07bec-2d10-492d-9c37-361fe0b79427	1a3777da-c6a2-425e-9cca-3d00ae1df03f
3319	3319	0	Biodiversity Information System of Mexico	b324e8e9-9a4c-44fa-8f1a-7f39ea7ab576	1a7a6016-79ea-4639-8e0e-e61b3b81efc4
2	2	0	Plazi	ffb07bec-2d10-492d-9c37-361fe0b79427	1aeda346-69eb-41e6-8655-d82772c05804
11	11	0	Plazi	ffb07bec-2d10-492d-9c37-361fe0b79427	1c27da21-036c-4956-bfd8-4d84cc563a51
9	9	0	Plazi	ffb07bec-2d10-492d-9c37-361fe0b79427	1e639a23-7677-4c4f-933f-4df2d320671c
0	2	2	Plazi	ffb07bec-2d10-492d-9c37-361fe0b79427	1ed52ba2-3342-46d5-a999-74d612a87012
358	358	0	Colombian Biodiversity Information System	7e865cba-7c46-417b-ade5-97f2cf5b7be0	1ef66bdc-801a-4e64-b83a-66125d1aebab
395	395	0	GBIF France	da44cd31-5901-4687-a106-6d1c7734ee3a	1fc4c36a-056b-48a9-915e-cf0207cf7148
6	6	0	Plazi	ffb07bec-2d10-492d-9c37-361fe0b79427	2004e8b3-099e-405a-9a81-0286648ffaaa
157	157	0	GBIF France	da44cd31-5901-4687-a106-6d1c7734ee3a	20900294-85ce-4e0b-aa56-d9a9494bf189
0	18806	18806	U.S. Geological Survey	8618c64a-93e0-4300-b546-7249e5148ed2	20e2ba7f-c339-42e9-bc3c-0ca587b78311
586	586	0	GBIF Finland	dd514216-5c7c-45f3-910d-797424cb5be6	21a371d0-9a1a-4d8b-a91d-e3333197b3e7
0	1	1	Plazi	ffb07bec-2d10-492d-9c37-361fe0b79427	243915ab-a8cf-4737-b19a-0f64a62e4e63
1	1	0	Plazi	ffb07bec-2d10-492d-9c37-361fe0b79427	24c58dd6-2d36-442e-8806-978e1461a995
407836	411943	4107	GBIF Norway	4f829580-180d-46a9-9c87-ed8ec959b545	26f5b360-8770-4d54-9c2d-397798a5e513
51761	54469	2708	Belgian Biodiversity Platform	fb11cfe1-ebc3-45af-9159-17d9fddbcdac	274a36be-0626-41c1-a757-3064e05811a4
0	10	10	Ocean Biodiversity Information System	ba0670b9-4186-41e6-8e70-f9cb3065551a	299545ae-66a5-42ba-a96b-add95573a135
0	171	171	GBIF France	da44cd31-5901-4687-a106-6d1c7734ee3a	2ad96a45-354d-45e8-b0b8-e44ee26bac3b
401	401	0	National Biodiversity Network	d897a5b9-35ee-4232-94bd-b0bcaac003c2	2ce8d28a-8b47-4910-8fbd-197942cadf68
3	3	0	Plazi	ffb07bec-2d10-492d-9c37-361fe0b79427	2d4a9aef-6b65-4af8-9d92-32924bf6827f
348	348	0	GBIF Germany	4f6826f2-4ff6-443d-b966-e6913bd24013	2e69f69c-703f-11e2-ad8f-00145eb45e9a
0	9	9	Plazi	ffb07bec-2d10-492d-9c37-361fe0b79427	303340f4-6346-4585-91d4-a2122fd3674c
925	925	0	GBIF France	da44cd31-5901-4687-a106-6d1c7734ee3a	3105f9e9-4bdb-4726-83c0-9ad685306329
5	5	0	Plazi	ffb07bec-2d10-492d-9c37-361fe0b79427	322f8a11-1ce7-4ef3-a096-61dcc1e5635f
1737	1737	0	Participant Node Managers Committee	7f48e0c8-5c96-49ec-b972-30748e339115	336e3eb6-0ed7-46a7-8a13-1faec0d3f8f2
0	31	31	Plazi	ffb07bec-2d10-492d-9c37-361fe0b79427	356a98ac-1526-4045-ae7f-52d08e753dfb
38	38	0	Plazi	ffb07bec-2d10-492d-9c37-361fe0b79427	3824c296-1994-4c6b-8cc1-e9d34074e7c1
157	157	0	GBIF Finland	dd514216-5c7c-45f3-910d-797424cb5be6	38c928d1-ae8b-46fb-a01a-08bd9cb00f73
64	64	0	Plazi	ffb07bec-2d10-492d-9c37-361fe0b79427	3c6556e1-0719-4007-b220-15ba5ee33612
5	5	0	Plazi	ffb07bec-2d10-492d-9c37-361fe0b79427	3d36e1b2-e633-4b18-ac9c-fd7ec92474f5
69	69	0	GBIF France	da44cd31-5901-4687-a106-6d1c7734ee3a	3ffbab4f-baf0-4bbd-822e-18f84824bbaa
9	9	0	Plazi	ffb07bec-2d10-492d-9c37-361fe0b79427	44e80db5-8f5d-4bed-a189-baed3b1020c8
0	7360	7360	Participant Node Managers Committee	7f48e0c8-5c96-49ec-b972-30748e339115	453ea4dc-e3de-4feb-a699-65060559bc49
20921	20921	0	U.S. Geological Survey	8618c64a-93e0-4300-b546-7249e5148ed2	474cd7e1-7620-454f-828c-24907a15d6a7
0	850	850	National Biodiversity Data Centre	422b00b2-6c94-4bb6-976b-c359916efdb8	484606ae-fd39-4d4d-97cb-7aa6dd789c2e
2	2	0	Plazi	ffb07bec-2d10-492d-9c37-361fe0b79427	4dcb044d-9ed9-4321-bd40-eb5728d277e0
0	2	2	Plazi	ffb07bec-2d10-492d-9c37-361fe0b79427	505300c6-21d1-4ef5-880b-f05d36cbb2a2
128	128	0	Secretariat of the Pacific Regional Environment Programme	29c6a139-ea7f-41f5-8d9b-c55af8736182	52135fde-5721-44a3-aaa4-26fad6c7fbca
30	30	0	Plazi	ffb07bec-2d10-492d-9c37-361fe0b79427	5449e1a8-d793-4d90-9b61-1c66964b3af3
80	80	0	GBIF France	da44cd31-5901-4687-a106-6d1c7734ee3a	5530da5d-2d6e-4b6e-93bf-fa2eaaffbc26
10468	10468	0	National Biodiversity Network	d897a5b9-35ee-4232-94bd-b0bcaac003c2	5734021f-d66a-4a3a-9466-ae420dc29307
0	79	79	Ocean Biodiversity Information System	ba0670b9-4186-41e6-8e70-f9cb3065551a	5a064456-3006-40b3-bd3b-3ad82d4a905c
987	987	0	GBIF Argentina	2426a871-9feb-40a1-96c6-0c593a76b835	5dcc7d76-53d8-4a02-9038-91cc7c5d917b
7	7	0	Plazi	ffb07bec-2d10-492d-9c37-361fe0b79427	5f59510b-7dfc-4c00-9efe-74c6f8de34bc
182	182	0	GBIF Germany	4f6826f2-4ff6-443d-b966-e6913bd24013	60e6e41f-cf36-4a4b-b264-cc0525629f29
100	100	0	GBIF Germany	4f6826f2-4ff6-443d-b966-e6913bd24013	6123e67a-f762-11e1-a439-00145eb45e9a
85	85	0	GBIF Germany	4f6826f2-4ff6-443d-b966-e6913bd24013	612e4e6c-f762-11e1-a439-00145eb45e9a
84	84	0	GBIF Germany	4f6826f2-4ff6-443d-b966-e6913bd24013	61360882-f762-11e1-a439-00145eb45e9a
110	110	0	GBIF Germany	4f6826f2-4ff6-443d-b966-e6913bd24013	6251ac58-f762-11e1-a439-00145eb45e9a
26	26	0	GBIF Germany	4f6826f2-4ff6-443d-b966-e6913bd24013	62cfcfa2-f762-11e1-a439-00145eb45e9a
101	101	0	GBIF Germany	4f6826f2-4ff6-443d-b966-e6913bd24013	63c7f83a-f762-11e1-a439-00145eb45e9a
0	13986	13986	Participant Node Managers Committee	7f48e0c8-5c96-49ec-b972-30748e339115	646daa81-9b48-445a-9eba-56f73192f647
30	30	0	GBIF Germany	4f6826f2-4ff6-443d-b966-e6913bd24013	649377bc-f762-11e1-a439-00145eb45e9a
204	204	0	GBIF Germany	4f6826f2-4ff6-443d-b966-e6913bd24013	665346c2-f762-11e1-a439-00145eb45e9a
95	95	0	GBIF Germany	4f6826f2-4ff6-443d-b966-e6913bd24013	6679296e-f762-11e1-a439-00145eb45e9a
84	84	0	National Biodiversity Data Centre	422b00b2-6c94-4bb6-976b-c359916efdb8	677d2c20-c7b8-11de-b279-c5c2022f659d
95	95	0	GBIF Germany	4f6826f2-4ff6-443d-b966-e6913bd24013	68102bd8-f762-11e1-a439-00145eb45e9a
267243	267243	0	GBIF Japan	db5705aa-6a6e-42f1-8942-d77b9f4896ea	68c30283-d2a7-4742-96cb-52e249598ff9
32602	27019	-5583	GBIF Germany	4f6826f2-4ff6-443d-b966-e6913bd24013	68efc55e-f762-11e1-a439-00145eb45e9a
14	14	0	GBIF Finland	dd514216-5c7c-45f3-910d-797424cb5be6	6a70015f-2d0a-45af-8ae9-a2e53d453b55
28	28	0	Plazi	ffb07bec-2d10-492d-9c37-361fe0b79427	6abc8130-1b65-4df2-b6aa-ef3e2779ef6d
7	7	0	Plazi	ffb07bec-2d10-492d-9c37-361fe0b79427	6aca9b3a-0eda-4fb0-b6d5-3933f8ca2f6c
4	4	0	Plazi	ffb07bec-2d10-492d-9c37-361fe0b79427	6b003da1-30a4-4961-839d-53f2f79ae563
24	24	0	GBIF Germany	4f6826f2-4ff6-443d-b966-e6913bd24013	6be83a16-f762-11e1-a439-00145eb45e9a
106	106	0	Colombian Biodiversity Information System	7e865cba-7c46-417b-ade5-97f2cf5b7be0	6c41b69e-6a38-49e6-ab8d-99f1d0516f91
0	2	2	Plazi	ffb07bec-2d10-492d-9c37-361fe0b79427	6d81c522-80a3-4f1a-8731-32ea6004964e
4	4	0	Plazi	ffb07bec-2d10-492d-9c37-361fe0b79427	6f3572d0-0a33-42fa-94d1-88028a541cdb
23	23	0	Atlas of Living Australia	4a6f1b71-969e-4fc5-a693-282b05e1220c	70c9ed78-fa16-4e18-95c5-80f46419f585
1257	1257	0	Observation International	ad048418-7cd8-4070-a151-fe1c1f303129	70f6c067-ea99-4acc-9fd0-ae4c53dffcc0
69	69	0	GBIF Germany	4f6826f2-4ff6-443d-b966-e6913bd24013	7180553a-f762-11e1-a439-00145eb45e9a
0	2	2	Plazi	ffb07bec-2d10-492d-9c37-361fe0b79427	718e3fd5-4f82-41cd-9d83-7873251d26df
3047	3047	0	National Biodiversity Network	d897a5b9-35ee-4232-94bd-b0bcaac003c2	72bbd511-a9a5-4d4d-92ce-4210b702a7a7
0	2	2	Plazi	ffb07bec-2d10-492d-9c37-361fe0b79427	72e2e275-efa5-4436-9755-3e754db980c8
218	218	0	GBIF Germany	4f6826f2-4ff6-443d-b966-e6913bd24013	732f00f2-f762-11e1-a439-00145eb45e9a
1726	1726	0	GBIF Germany	4f6826f2-4ff6-443d-b966-e6913bd24013	734a9e66-f762-11e1-a439-00145eb45e9a
144	144	0	GBIF Germany	4f6826f2-4ff6-443d-b966-e6913bd24013	74edd12a-f762-11e1-a439-00145eb45e9a
105	105	0	Plazi	ffb07bec-2d10-492d-9c37-361fe0b79427	75de85af-39c5-41ca-9ccc-4ff7b743eefa
2	2	0	Plazi	ffb07bec-2d10-492d-9c37-361fe0b79427	77e56377-beb6-4828-941a-3a411430125c
130	130	0	GBIF Germany	4f6826f2-4ff6-443d-b966-e6913bd24013	783ce104-f762-11e1-a439-00145eb45e9a
7	7	0	GBIF Germany	4f6826f2-4ff6-443d-b966-e6913bd24013	78d19fa6-f762-11e1-a439-00145eb45e9a
7	7	0	GBIF Germany	4f6826f2-4ff6-443d-b966-e6913bd24013	78ec0954-f762-11e1-a439-00145eb45e9a
11	11	0	GBIF Germany	4f6826f2-4ff6-443d-b966-e6913bd24013	78f69752-f762-11e1-a439-00145eb45e9a
2	2	0	Plazi	ffb07bec-2d10-492d-9c37-361fe0b79427	78fa0540-bfb3-4c88-a84d-eb9c203779cc
391	391	0	Plazi	ffb07bec-2d10-492d-9c37-361fe0b79427	792ac05c-a144-47d5-a048-9f181d559fd7
222	222	0	GBIF Germany	4f6826f2-4ff6-443d-b966-e6913bd24013	792dd1e0-f762-11e1-a439-00145eb45e9a
6	6	0	Plazi	ffb07bec-2d10-492d-9c37-361fe0b79427	795485ed-5f1b-46d8-8ce6-1216e579b222
27	27	0	GBIF Germany	4f6826f2-4ff6-443d-b966-e6913bd24013	7ab0db5c-f762-11e1-a439-00145eb45e9a
0	4	4	Plazi	ffb07bec-2d10-492d-9c37-361fe0b79427	7af35e08-e059-4967-b4b7-43e191e9c90a
746	746	0	Atlas of Living Australia	4a6f1b71-969e-4fc5-a693-282b05e1220c	7b7269b6-f762-11e1-a439-00145eb45e9a
1015	1015	0	Colombian Biodiversity Information System	7e865cba-7c46-417b-ade5-97f2cf5b7be0	7bd9f9d7-5b5e-49c2-baaa-25f09e037dd7
189	189	0	GBIF Germany	4f6826f2-4ff6-443d-b966-e6913bd24013	7cb6f936-f762-11e1-a439-00145eb45e9a
15	15	0	Plazi	ffb07bec-2d10-492d-9c37-361fe0b79427	7ce897ab-56d1-41f4-bc1e-99d36c15ed87
0	3	3	Plazi	ffb07bec-2d10-492d-9c37-361fe0b79427	7cf05e72-a279-4e29-82eb-7be8499a4eb3
32	14	-18	GBIF Germany	4f6826f2-4ff6-443d-b966-e6913bd24013	7d0f5784-f762-11e1-a439-00145eb45e9a
126	126	0	GBIF Germany	4f6826f2-4ff6-443d-b966-e6913bd24013	7ebe184a-f762-11e1-a439-00145eb45e9a
572	572	0	GBIF Germany	4f6826f2-4ff6-443d-b966-e6913bd24013	7ee968ba-f762-11e1-a439-00145eb45e9a
3	3	0	Plazi	ffb07bec-2d10-492d-9c37-361fe0b79427	80b2b242-4455-40a8-83f0-cd458330341a
10699	10699	0	National Biodiversity Network	d897a5b9-35ee-4232-94bd-b0bcaac003c2	82091a91-03bb-4af0-8fc3-e141ad1a6efc
4258	4768	510	GBIF Germany	4f6826f2-4ff6-443d-b966-e6913bd24013	827fc19a-f762-11e1-a439-00145eb45e9a
3132	3132	0	Ocean Biodiversity Information System	ba0670b9-4186-41e6-8e70-f9cb3065551a	83afb58e-f762-11e1-a439-00145eb45e9a
4896	4896	0	GBIF Germany	4f6826f2-4ff6-443d-b966-e6913bd24013	846da666-ea1c-496c-895a-274e092c6a67
4212	3402	-810	GBIF Germany	4f6826f2-4ff6-443d-b966-e6913bd24013	855f7d8b-950c-4397-97e7-fa19e653dc59
3541	3541	0	GBIF Portugal	673f7038-4262-4149-b753-5658a4e912f6	85bcaab2-f762-11e1-a439-00145eb45e9a
67	40	-27	GBIF Germany	4f6826f2-4ff6-443d-b966-e6913bd24013	8720c2ee-f762-11e1-a439-00145eb45e9a
1408	1165	-243	GBIF Germany	4f6826f2-4ff6-443d-b966-e6913bd24013	8841d0aa-f762-11e1-a439-00145eb45e9a
14	14	0	GBIF Germany	4f6826f2-4ff6-443d-b966-e6913bd24013	889bd6e0-f762-11e1-a439-00145eb45e9a
107	69	-38	GBIF Germany	4f6826f2-4ff6-443d-b966-e6913bd24013	88b52e4c-f762-11e1-a439-00145eb45e9a
81	81	0	GBIF Germany	4f6826f2-4ff6-443d-b966-e6913bd24013	89cd2ab4-f762-11e1-a439-00145eb45e9a
2657	2657	0	Colombian Biodiversity Information System	7e865cba-7c46-417b-ade5-97f2cf5b7be0	89fb846d-3765-4022-90e0-88a8b55b2620
6	6	0	Plazi	ffb07bec-2d10-492d-9c37-361fe0b79427	8c3e2155-90e2-48a2-accd-f35f92042176
3	3	0	Plazi	ffb07bec-2d10-492d-9c37-361fe0b79427	8c7e308f-78bc-4d73-bb80-f700c7d04310
10	9	-1	GBIF Germany	4f6826f2-4ff6-443d-b966-e6913bd24013	8cb4028e-f762-11e1-a439-00145eb45e9a
9	8	-1	GBIF Germany	4f6826f2-4ff6-443d-b966-e6913bd24013	8d44dc3c-f762-11e1-a439-00145eb45e9a
17	12	-5	GBIF Germany	4f6826f2-4ff6-443d-b966-e6913bd24013	8dc44134-f762-11e1-a439-00145eb45e9a
4985	4985	0	GBIF Cameroon	cfe0cad9-2bf4-4d16-ae33-c3dfb0da1ed9	8df8741e-4033-46c5-a770-837ea13d9fa5
90	54	-36	GBIF Germany	4f6826f2-4ff6-443d-b966-e6913bd24013	8e1ed7e8-f762-11e1-a439-00145eb45e9a
82	67	-15	GBIF Germany	4f6826f2-4ff6-443d-b966-e6913bd24013	8e7f6202-f762-11e1-a439-00145eb45e9a
170	139	-31	GBIF Germany	4f6826f2-4ff6-443d-b966-e6913bd24013	8ea9d988-f762-11e1-a439-00145eb45e9a
0	15	15	Ocean Biodiversity Information System	ba0670b9-4186-41e6-8e70-f9cb3065551a	8efaf0de-7038-4c5d-91cc-fdd1d06c6c9d
122	122	0	GBIF Germany	4f6826f2-4ff6-443d-b966-e6913bd24013	8f2129c0-f762-11e1-a439-00145eb45e9a
251	163	-88	GBIF Germany	4f6826f2-4ff6-443d-b966-e6913bd24013	8faf87b0-f762-11e1-a439-00145eb45e9a
93	93	0	Colombian Biodiversity Information System	7e865cba-7c46-417b-ade5-97f2cf5b7be0	8fe7fc31-775f-444b-b49e-2d59f62400e3
0	178	178	Ocean Biodiversity Information System	ba0670b9-4186-41e6-8e70-f9cb3065551a	9052cd49-044f-4a06-87e5-41a207415343
341	341	0	GBIF France	da44cd31-5901-4687-a106-6d1c7734ee3a	90a9d9f3-e252-4753-80ab-334c98f0c485
43	30	-13	GBIF Germany	4f6826f2-4ff6-443d-b966-e6913bd24013	91066778-f762-11e1-a439-00145eb45e9a
2	2	0	Participant Node Managers Committee	7f48e0c8-5c96-49ec-b972-30748e339115	9247c2f2-e147-46b7-893a-b003c20c4653
14	14	0	Plazi	ffb07bec-2d10-492d-9c37-361fe0b79427	92772b5a-ed6a-4ab2-a871-1df6a26993b4
98	98	0	GBIF Germany	4f6826f2-4ff6-443d-b966-e6913bd24013	92f38f66-f762-11e1-a439-00145eb45e9a
15	15	0	GBIF France	da44cd31-5901-4687-a106-6d1c7734ee3a	946224cc-22ab-4399-95a8-7c7fcb74acc2
655	655	0	GBIF Germany	4f6826f2-4ff6-443d-b966-e6913bd24013	950196f4-f762-11e1-a439-00145eb45e9a
339	339	0	GBIF Spain	1f94b3ca-9345-4d65-afe2-4bace93aa0fe	968759c2-b249-45f0-8986-34859c30c917
248	248	0	Plazi	ffb07bec-2d10-492d-9c37-361fe0b79427	978683ec-19af-4c4b-aa66-b2574448d93a
477	477	0	GBIF France	da44cd31-5901-4687-a106-6d1c7734ee3a	9baf254d-aac5-48a2-b1ad-a0672f4f5eea
1	1	0	Plazi	ffb07bec-2d10-492d-9c37-361fe0b79427	9cb272cb-025c-43aa-af86-7b3bcb9371f4
7	7	0	Plazi	ffb07bec-2d10-492d-9c37-361fe0b79427	9e80dd31-e9cd-4f26-a2bf-567794c017c9
59	59	0	Plazi	ffb07bec-2d10-492d-9c37-361fe0b79427	9e8a020a-c322-48a0-935d-ae3ff9c1f1c2
21	21	0	Plazi	ffb07bec-2d10-492d-9c37-361fe0b79427	a05d10ec-8ed6-48d0-acce-66810d5a714b
0	5	5	Plazi	ffb07bec-2d10-492d-9c37-361fe0b79427	a0f33093-8910-47a9-b748-42115253ef95
4508	4508	0	GBIF Benin	efb9c00e-f802-45dd-8826-a52ec45b89ff	a1e5960c-559e-4a9f-bcbe-d97f131364bf
0	2	2	Plazi	ffb07bec-2d10-492d-9c37-361fe0b79427	a55fecce-e260-4207-8e40-448126f372c8
1	1	0	Plazi	ffb07bec-2d10-492d-9c37-361fe0b79427	a6ddf7c1-eaf4-4018-9589-014328f3021f
0	166	166	Colombian Biodiversity Information System	7e865cba-7c46-417b-ade5-97f2cf5b7be0	a742ad41-0567-4578-b146-564befa35b78
0	397	397	Participant Node Managers Committee	7f48e0c8-5c96-49ec-b972-30748e339115	a8207151-95ff-457a-ada6-03438de183b6
0	1	1	Plazi	ffb07bec-2d10-492d-9c37-361fe0b79427	a96f5118-fc2f-43e7-b9ec-171f78f10665
0	3	3	Plazi	ffb07bec-2d10-492d-9c37-361fe0b79427	a9ab053d-a82f-43a7-8f2f-931c58c14d77
344	344	0	National Biodiversity Network	d897a5b9-35ee-4232-94bd-b0bcaac003c2	ac87012e-7a4d-4136-a6c0-955a5fe7306e
580	580	0	National Biodiversity Network	d897a5b9-35ee-4232-94bd-b0bcaac003c2	afa486d5-7b6d-4b35-a5a4-59c968f8511f
165	165	0	Colombian Biodiversity Information System	7e865cba-7c46-417b-ade5-97f2cf5b7be0	b10da481-0b23-42d2-97ff-5cbeb3b08afe
2748	2748	0	Ocean Biodiversity Information System	ba0670b9-4186-41e6-8e70-f9cb3065551a	b1c6b7a6-4c57-4814-93bc-d5c0c5743203
11	11	0	GBIF Finland	dd514216-5c7c-45f3-910d-797424cb5be6	b3bffc0a-5c20-466a-b32f-082cf4dd0ec0
1170	1170	0	GBIF Norway	4f829580-180d-46a9-9c87-ed8ec959b545	b55058c4-d270-42b1-b849-332f734cfc33
0	1144	1144	Ocean Biodiversity Information System	ba0670b9-4186-41e6-8e70-f9cb3065551a	b5c83840-fafc-437a-9059-d71a8e1c4fb9
0	2	2	Plazi	ffb07bec-2d10-492d-9c37-361fe0b79427	b6057512-bbb2-418e-bc8e-9cd6095d1f2f
255	255	0	GBIF France	da44cd31-5901-4687-a106-6d1c7734ee3a	b6947f5b-380f-41c2-9cc8-52e5ca544865
950	950	0	GBIF France	da44cd31-5901-4687-a106-6d1c7734ee3a	b78d1c35-bf08-4552-aa38-f9e214ffc3da
0	6973	6973	Ocean Biodiversity Information System	ba0670b9-4186-41e6-8e70-f9cb3065551a	ba383cae-b440-4a69-a606-a669d6a7638e
316	119	-197	Biodiversity Information System of Mexico	b324e8e9-9a4c-44fa-8f1a-7f39ea7ab576	ba945b85-a284-48fe-a68c-7b76845c5109
0	16	16	Plazi	ffb07bec-2d10-492d-9c37-361fe0b79427	ba9eadc3-7247-4841-8272-e7af87754011
0	53	53	Plazi	ffb07bec-2d10-492d-9c37-361fe0b79427	bba5c695-619c-4f8e-a634-c29f65a72f1c
16	16	0	Plazi	ffb07bec-2d10-492d-9c37-361fe0b79427	becdb1cf-be93-48ca-abc4-898d0f84d0bd
91	91	0	Colombian Biodiversity Information System	7e865cba-7c46-417b-ade5-97f2cf5b7be0	c2a9c8ae-98a4-48b7-a282-604536871265
0	18	18	Plazi	ffb07bec-2d10-492d-9c37-361fe0b79427	c2e2ad51-1242-4859-ae31-b4c9fd0e16f1
4	4	0	Plazi	ffb07bec-2d10-492d-9c37-361fe0b79427	c3d7ef5c-99ce-4c62-9cf7-fd7d43f2003e
2	2	0	Plazi	ffb07bec-2d10-492d-9c37-361fe0b79427	c40ab8c0-eec0-46a5-95c5-03e93830dc36
518	518	0	Colombian Biodiversity Information System	7e865cba-7c46-417b-ade5-97f2cf5b7be0	c544e57a-82fa-42d5-908a-967cc34f90e7
2620	173494	170874	National Biodiversity Network	d897a5b9-35ee-4232-94bd-b0bcaac003c2	c8891f08-bd2a-4aad-a2b5-a11bee2e6245
0	204	204	Ocean Biodiversity Information System	ba0670b9-4186-41e6-8e70-f9cb3065551a	c89d4997-952d-42c6-8d60-e484a29a4e61
347	707	360	GBIF Brazil	cdc9736d-5ff7-4ece-9959-3c744360cdb3	cbc1ecc8-7b69-408a-9b42-8c2c72567523
0	14	14	Ocean Biodiversity Information System	ba0670b9-4186-41e6-8e70-f9cb3065551a	ceafa803-8838-4a09-8ff1-cc0ebf8a90d3
0	96	96	Ocean Biodiversity Information System	ba0670b9-4186-41e6-8e70-f9cb3065551a	d0eb93c9-5b35-44f1-966c-fb8712072a70
0	1692	1692	GBIF Benin	efb9c00e-f802-45dd-8826-a52ec45b89ff	d34deb78-9f33-461c-a3a9-8aa7f02496e9
2	2	0	Plazi	ffb07bec-2d10-492d-9c37-361fe0b79427	d66ed56d-eec7-424a-a7c9-9f2c884269e7
15	15	0	Plazi	ffb07bec-2d10-492d-9c37-361fe0b79427	d84ad457-323a-4cfd-9f94-ad8369150e0a
280	280	0	Atlas of Living Australia	4a6f1b71-969e-4fc5-a693-282b05e1220c	db8f0895-3023-4e03-9f37-2c27bb2e5fc7
0	82	82	GBIF Japan	db5705aa-6a6e-42f1-8942-d77b9f4896ea	dc0f5e84-2e93-4e3f-9aa3-fdc8caa0d98a
0	59	59	Plazi	ffb07bec-2d10-492d-9c37-361fe0b79427	dce64c93-3c8e-41c7-a2af-9e57afb600f6
0	184	184	Participant Node Managers Committee	7f48e0c8-5c96-49ec-b972-30748e339115	de08035e-ae18-4d3e-8d04-da897c0418aa
0	269	269	Plazi	ffb07bec-2d10-492d-9c37-361fe0b79427	de57c743-d85a-426f-a004-84da96723546
3	3	0	Plazi	ffb07bec-2d10-492d-9c37-361fe0b79427	e50a816b-a410-44d6-ac91-a06002a0caa6
6	6	0	Plazi	ffb07bec-2d10-492d-9c37-361fe0b79427	e5a58990-d727-440a-aab9-7638a5698954
140	140	0	Belgian Biodiversity Platform	fb11cfe1-ebc3-45af-9159-17d9fddbcdac	e844e45b-abb2-42e9-a074-6f5960ffecf7
2	2	0	Participant Node Managers Committee	7f48e0c8-5c96-49ec-b972-30748e339115	eb082f6f-3de1-46e9-a749-0381c3f0ef09
12	12	0	Plazi	ffb07bec-2d10-492d-9c37-361fe0b79427	eb2b70bd-66e2-4590-b938-f0eff9a5bc08
6	6	0	Plazi	ffb07bec-2d10-492d-9c37-361fe0b79427	eeff5839-dd7b-4cea-8ca9-25af76ba2c19
5	5	0	Plazi	ffb07bec-2d10-492d-9c37-361fe0b79427	ef043e21-12d9-402e-b07a-2440ca8754ab
0	25	25	Ocean Biodiversity Information System	ba0670b9-4186-41e6-8e70-f9cb3065551a	ef09f362-ea37-4a8f-aebb-9a87f971a40c
0	174	174	Plazi	ffb07bec-2d10-492d-9c37-361fe0b79427	ef34abf2-a217-4ef5-afdf-38ce6e0e7a1f
0	405	405	Colombian Biodiversity Information System	7e865cba-7c46-417b-ade5-97f2cf5b7be0	ef43eb6d-1abb-4f72-ac7d-3eef605375d1
542	542	0	GBIF France	da44cd31-5901-4687-a106-6d1c7734ee3a	f3fe9414-fa46-4e8a-841d-0a71cbc50b29
1011	1011	0	Colombian Biodiversity Information System	7e865cba-7c46-417b-ade5-97f2cf5b7be0	f57cd13f-a377-47c0-b2aa-e0a0a15e8f40
54	54	0	Plazi	ffb07bec-2d10-492d-9c37-361fe0b79427	f5b155f4-c251-4daf-b267-322b95115f91
0	2	2	Plazi	ffb07bec-2d10-492d-9c37-361fe0b79427	f93df7d5-b9f3-4c3a-ac83-25bd5b61c5f4
522	343	-179	GBIF Germany	4f6826f2-4ff6-443d-b966-e6913bd24013	f9bf82d5-e1b0-45d1-a981-04f3e9a160f9
0	10	10	Plazi	ffb07bec-2d10-492d-9c37-361fe0b79427	f9c3b5b7-1faa-4731-99a0-161d26ca21b2
154	154	0	GBIF France	da44cd31-5901-4687-a106-6d1c7734ee3a	fa11e3b9-99ca-4059-9acc-390bb74be648
49399	49648	249	Netherlands Biodiversity Information Facility	0909d601-bda2-42df-9e63-a6d51847ebce	fccafd83-a934-4021-a112-4ae5fd39c14b
224	158	-66	GBIF Germany	4f6826f2-4ff6-443d-b966-e6913bd24013	fd6ed809-eeb5-4959-a196-d6abdf97578b
0	1591	1591	Participant Node Managers Committee	7f48e0c8-5c96-49ec-b972-30748e339115	ffc0834b-f129-4821-b626-0f23e18be6b8
0	5108	5108	National Biodiversity Network	d897a5b9-35ee-4232-94bd-b0bcaac003c2	00df33f6-0296-46df-b2fe-0355c1422ba4
1365	1365	0	Ocean Biodiversity Information System	ba0670b9-4186-41e6-8e70-f9cb3065551a	02dd359e-895c-4082-b80e-0433dd4ea95e
0	256	256	Plazi	ffb07bec-2d10-492d-9c37-361fe0b79427	04b19d7f-1d74-41ec-b657-9b57f47826f9
6	6	0	Plazi	ffb07bec-2d10-492d-9c37-361fe0b79427	0568f6d6-5662-48c7-aeb4-25d523157f30
15	259	244	GBIF Norway	4f829580-180d-46a9-9c87-ed8ec959b545	07d699bc-469b-4b2d-99a7-363c45fbe325
3	3	0	Plazi	ffb07bec-2d10-492d-9c37-361fe0b79427	09fee717-b4b0-4f45-9bc2-a42e35018369
5	5	0	Plazi	ffb07bec-2d10-492d-9c37-361fe0b79427	0b04a6f9-e453-4c9c-b598-5510e15d2af3
374	374	0	Ocean Biodiversity Information System	ba0670b9-4186-41e6-8e70-f9cb3065551a	0ba6c967-5244-4507-bfb5-ecc9f36729d6
88	88	0	GBIF France	da44cd31-5901-4687-a106-6d1c7734ee3a	0bfe7739-a164-4a76-ac1c-38a9a34123a3
1	1	0	Plazi	ffb07bec-2d10-492d-9c37-361fe0b79427	0efcada5-1b2c-45cf-bb56-73f4909b5c74
0	46	46	Plazi	ffb07bec-2d10-492d-9c37-361fe0b79427	135c11d2-60ff-4738-a1aa-4ace629507aa
918	918	0	GBIF France	da44cd31-5901-4687-a106-6d1c7734ee3a	13645ac8-b87d-465e-bb99-0903016ab7ae
0	1	1	Plazi	ffb07bec-2d10-492d-9c37-361fe0b79427	1425ad8a-0089-45b3-ac96-d89258976346
45	45	0	GBIF Germany	4f6826f2-4ff6-443d-b966-e6913bd24013	1ded8670-6d66-4cf7-9b03-422b61aaa039
1	1	0	Plazi	ffb07bec-2d10-492d-9c37-361fe0b79427	20c6f816-bec3-4494-bd4c-78327477c5bd
1295	1295	0	GBIF France	da44cd31-5901-4687-a106-6d1c7734ee3a	256acc28-ca45-4403-a38d-1c19473d9f23
4	4	0	GBIF Germany	4f6826f2-4ff6-443d-b966-e6913bd24013	2582a76b-d44c-4966-afc3-78460f1b5276
0	109	109	Colombian Biodiversity Information System	7e865cba-7c46-417b-ade5-97f2cf5b7be0	267243b0-587a-4cfd-af83-4b8380d09d81
347	347	0	Participant Node Managers Committee	7f48e0c8-5c96-49ec-b972-30748e339115	2743e1fb-5a9c-4224-800c-f86bab2ca52b
5053399	5053399	0	South African Biodiversity Information Facility	7190b835-4e86-4b6e-85c1-19cc6677c250	282d0ccb-4fa0-40f9-8593-105c77e88417
506	506	0	GBIF Benin	efb9c00e-f802-45dd-8826-a52ec45b89ff	2948350c-c37d-4bc2-95ca-147725aa3054
1004184	1004184	0	GBIF France	da44cd31-5901-4687-a106-6d1c7734ee3a	29cd9f29-7c76-4e6b-a8b8-78d91eaf49bf
94	94	0	Belgian Biodiversity Platform	fb11cfe1-ebc3-45af-9159-17d9fddbcdac	2a570f00-86e1-46ca-bfb6-7dd077e66004
250	250	0	National Biodiversity Network	d897a5b9-35ee-4232-94bd-b0bcaac003c2	2cc2f22d-bef7-40a4-bb74-375a624f8ada
0	17	17	Plazi	ffb07bec-2d10-492d-9c37-361fe0b79427	2efa715e-0e76-4e6e-8a3c-be1afb40e0ac
8	8	0	Plazi	ffb07bec-2d10-492d-9c37-361fe0b79427	2f20dd80-0cad-40e0-a1fd-5ff804f9aca0
19237	19237	0	Netherlands Biodiversity Information Facility	0909d601-bda2-42df-9e63-a6d51847ebce	30eca5bd-6a4f-46de-9e6f-d6ede90850dc
23449	23449	0	Atlas of Living Australia	4a6f1b71-969e-4fc5-a693-282b05e1220c	322ec841-f604-4024-ab49-897dc47f74c3
371	371	0	GBIF France	da44cd31-5901-4687-a106-6d1c7734ee3a	32478f26-4f6b-4893-9708-ea8c62c957ef
0	18	18	Plazi	ffb07bec-2d10-492d-9c37-361fe0b79427	3272d7a6-47c3-416c-9a02-5b18c553f132
0	160	160	Ocean Biodiversity Information System	ba0670b9-4186-41e6-8e70-f9cb3065551a	34d1718f-381e-4729-8bab-a509480a0381
61	61	0	Plazi	ffb07bec-2d10-492d-9c37-361fe0b79427	354b29bc-23dd-4af4-a140-ca022a21e86d
139841	141057	1216	U.S. Geological Survey	8618c64a-93e0-4300-b546-7249e5148ed2	377be098-626f-4cc2-b4b5-35700050669a
464	464	0	GBIF Norway	4f829580-180d-46a9-9c87-ed8ec959b545	38c0c1a7-44b7-44e6-b2af-a3114de02ef4
18940	18940	0	Canada Biodiversity Information Facility	8f83fc96-c966-4126-83f7-bf044dc49efa	3ad882bb-cd21-4201-8b83-3684bfc6d830
1322	1322	0	ASEAN Centre for Biodiversity	af2a0fa1-4c8e-4bdc-8954-b1a55e32b0f1	3caf2aad-a970-4905-872c-b4cd014f48bd
438	438	0	Plazi	ffb07bec-2d10-492d-9c37-361fe0b79427	3f7df4de-b7dc-4376-b808-e479925a5ee4
1307	1307	0	GBIF France	da44cd31-5901-4687-a106-6d1c7734ee3a	45ceda03-4afd-443b-88b1-43b10a2124cb
0	224	224	Colombian Biodiversity Information System	7e865cba-7c46-417b-ade5-97f2cf5b7be0	46cd3148-083d-47ab-a32e-bbd739f14eb7
146	146	0	Atlas of Living Australia	4a6f1b71-969e-4fc5-a693-282b05e1220c	47a97869-269b-44d2-95b2-0cf5289cbef7
1116	1116	0	GBIF Germany	4f6826f2-4ff6-443d-b966-e6913bd24013	4f613bad-fee1-4f62-8585-429ac50fb5f9
105	105	0	Participant Node Managers Committee	7f48e0c8-5c96-49ec-b972-30748e339115	4f6a518f-3a43-41a8-8989-af0c4eb288d5
273	288	15	U.S. Geological Survey	8618c64a-93e0-4300-b546-7249e5148ed2	531ed831-f35f-4bd5-9d83-bf260fc8236d
1390	1390	0	Colombian Biodiversity Information System	7e865cba-7c46-417b-ade5-97f2cf5b7be0	53725322-b5f3-412f-87e6-5a1b4a36a702
2	2	0	Plazi	ffb07bec-2d10-492d-9c37-361fe0b79427	53ed89f6-69dd-45b5-8960-c4bf19157402
599	599	0	National Biodiversity Network	d897a5b9-35ee-4232-94bd-b0bcaac003c2	56391128-784a-47fa-81b4-409c1e929783
424	424	0	Netherlands Biodiversity Information Facility	0909d601-bda2-42df-9e63-a6d51847ebce	576c0061-40a6-46fa-8f95-a425eef87893
5	5	0	Plazi	ffb07bec-2d10-492d-9c37-361fe0b79427	58040490-3e21-4c42-ab41-34ccd4af6ad9
100884	107553	6669	GBIF Austria	1e789bc9-79fc-4e60-a49e-89dfc45a7188	5830fa3c-497c-4d37-b771-bd6c84997f2c
0	7	7	Plazi	ffb07bec-2d10-492d-9c37-361fe0b79427	589b50ff-77f6-4090-b8d5-d8d0ffcea9da
0	2324	2324	GBIF Spain	1f94b3ca-9345-4d65-afe2-4bace93aa0fe	5920d638-2445-42c4-aec5-956f14fab7b9
2	2	0	Plazi	ffb07bec-2d10-492d-9c37-361fe0b79427	5aa4bcb0-c3be-4c77-9cbe-8d401ddf5c06
0	7	7	Plazi	ffb07bec-2d10-492d-9c37-361fe0b79427	5bb8688e-007c-4826-8c88-4669ade049a3
0	4	4	Plazi	ffb07bec-2d10-492d-9c37-361fe0b79427	5d9f7315-0593-472a-a14b-bd8f6ff42a0b
7300	7300	0	GBIF Spain	1f94b3ca-9345-4d65-afe2-4bace93aa0fe	5f442679-017d-4d99-8b81-2444d79321c8
0	168	168	National Biodiversity Network	d897a5b9-35ee-4232-94bd-b0bcaac003c2	6069bfe1-73bc-4602-a408-f723b56b813e
20	20	0	GBIF Germany	4f6826f2-4ff6-443d-b966-e6913bd24013	6178cb40-f762-11e1-a439-00145eb45e9a
18	18	0	GBIF Germany	4f6826f2-4ff6-443d-b966-e6913bd24013	619cca36-f762-11e1-a439-00145eb45e9a
0	13672	13672	Colombian Biodiversity Information System	7e865cba-7c46-417b-ade5-97f2cf5b7be0	623d8d63-ea76-4582-b4ad-8dbf5f043f70
141	141	0	GBIF Germany	4f6826f2-4ff6-443d-b966-e6913bd24013	62c57912-f762-11e1-a439-00145eb45e9a
5	5	0	GBIF Germany	4f6826f2-4ff6-443d-b966-e6913bd24013	62e159de-f762-11e1-a439-00145eb45e9a
15339	15339	0	Netherlands Biodiversity Information Facility	0909d601-bda2-42df-9e63-a6d51847ebce	63add3c5-6d15-42b2-9e67-f81979c6ef65
22	22	0	Plazi	ffb07bec-2d10-492d-9c37-361fe0b79427	63f6f510-cabb-4818-897b-83f67334dd79
0	1	1	Plazi	ffb07bec-2d10-492d-9c37-361fe0b79427	6438451a-5725-438a-b19a-4bbe51632510
18	18	0	GBIF Germany	4f6826f2-4ff6-443d-b966-e6913bd24013	64963858-f762-11e1-a439-00145eb45e9a
38	38	0	GBIF Germany	4f6826f2-4ff6-443d-b966-e6913bd24013	64b52ea2-f762-11e1-a439-00145eb45e9a
27	27	0	GBIF Germany	4f6826f2-4ff6-443d-b966-e6913bd24013	64e04538-f762-11e1-a439-00145eb45e9a
288	288	0	GBIF Germany	4f6826f2-4ff6-443d-b966-e6913bd24013	653b5a9a-f762-11e1-a439-00145eb45e9a
158	158	0	GBIF Germany	4f6826f2-4ff6-443d-b966-e6913bd24013	6691f3e0-f762-11e1-a439-00145eb45e9a
0	475	475	GBIF Spain	1f94b3ca-9345-4d65-afe2-4bace93aa0fe	66a58ebb-ea4f-44a1-8e2b-6e3b4876c0de
80	80	0	GBIF Germany	4f6826f2-4ff6-443d-b966-e6913bd24013	67745afa-f762-11e1-a439-00145eb45e9a
192	192	0	GBIF Germany	4f6826f2-4ff6-443d-b966-e6913bd24013	67d52e52-f762-11e1-a439-00145eb45e9a
160	160	0	GBIF Germany	4f6826f2-4ff6-443d-b966-e6913bd24013	67d6840a-f762-11e1-a439-00145eb45e9a
128	128	0	GBIF Germany	4f6826f2-4ff6-443d-b966-e6913bd24013	689a5042-f762-11e1-a439-00145eb45e9a
104	104	0	National Biodiversity Network	d897a5b9-35ee-4232-94bd-b0bcaac003c2	6902fa28-46d9-44f7-a510-1f1f83e99c7c
0	2	2	Plazi	ffb07bec-2d10-492d-9c37-361fe0b79427	69439e7d-5f31-417b-8c29-d810bdabe0d4
165	165	0	GBIF France	da44cd31-5901-4687-a106-6d1c7734ee3a	69ea87a6-2928-47a0-9246-b1f3c4cdcaa4
2	2	0	GBIF Germany	4f6826f2-4ff6-443d-b966-e6913bd24013	6b5a0dd6-f762-11e1-a439-00145eb45e9a
13610	13610	0	GBIF Norway	4f829580-180d-46a9-9c87-ed8ec959b545	6bbcb71c-42e7-40e7-bd02-b66d4e9a5c6e
4	4	0	Plazi	ffb07bec-2d10-492d-9c37-361fe0b79427	6be10c07-890a-41b6-80b9-55206dbf2fc5
43	43	0	GBIF Germany	4f6826f2-4ff6-443d-b966-e6913bd24013	6cb019e6-f762-11e1-a439-00145eb45e9a
515	515	0	Colombian Biodiversity Information System	7e865cba-7c46-417b-ade5-97f2cf5b7be0	6cc43c36-cd9e-4402-85d3-16f8dc5e160a
52	52	0	GBIF Germany	4f6826f2-4ff6-443d-b966-e6913bd24013	6ce92db2-f762-11e1-a439-00145eb45e9a
1	1	0	Plazi	ffb07bec-2d10-492d-9c37-361fe0b79427	6d7922c1-402c-4a3b-9ebd-b38b7d380a31
6390	6390	0	GBIF Argentina	2426a871-9feb-40a1-96c6-0c593a76b835	6df67f83-b615-448c-96d2-d315655e3e04
0	3	3	Plazi	ffb07bec-2d10-492d-9c37-361fe0b79427	6e1353f3-5b6d-4529-a1c5-cac5002a7e76
73	70	-3	GBIF Germany	4f6826f2-4ff6-443d-b966-e6913bd24013	6f867278-f762-11e1-a439-00145eb45e9a
7868	7868	0	Netherlands Biodiversity Information Facility	0909d601-bda2-42df-9e63-a6d51847ebce	6fe8dde0-7ef1-41c0-ba0f-ecf41ac2d342
110	110	0	GBIF Germany	4f6826f2-4ff6-443d-b966-e6913bd24013	7118480a-f762-11e1-a439-00145eb45e9a
75	75	0	Plazi	ffb07bec-2d10-492d-9c37-361fe0b79427	724cf4c6-1901-4318-afdc-257b464a2416
39	39	0	GBIF Germany	4f6826f2-4ff6-443d-b966-e6913bd24013	73852c52-f762-11e1-a439-00145eb45e9a
24	24	0	GBIF Germany	4f6826f2-4ff6-443d-b966-e6913bd24013	7400918a-f762-11e1-a439-00145eb45e9a
0	479	479	Plazi	ffb07bec-2d10-492d-9c37-361fe0b79427	740af13a-ed5c-40d0-b0c1-8d3fd2b92f56
31	31	0	GBIF Germany	4f6826f2-4ff6-443d-b966-e6913bd24013	74420264-f762-11e1-a439-00145eb45e9a
3	3	0	National Biodiversity Network	d897a5b9-35ee-4232-94bd-b0bcaac003c2	74854305-f38a-490c-b4f2-df04f625f3ad
0	433	433	Plazi	ffb07bec-2d10-492d-9c37-361fe0b79427	74dc998a-dc7a-4b02-b43c-a2064c9c6dc2
139	139	0	GBIF Germany	4f6826f2-4ff6-443d-b966-e6913bd24013	752bc2c8-f762-11e1-a439-00145eb45e9a
10	10	0	Plazi	ffb07bec-2d10-492d-9c37-361fe0b79427	75caa414-c102-4cf9-ade8-0f8b2d93b37b
6	6	0	Plazi	ffb07bec-2d10-492d-9c37-361fe0b79427	77d18215-6900-476b-9f99-013053d06c3a
90	90	0	National Biodiversity Network	d897a5b9-35ee-4232-94bd-b0bcaac003c2	781d4a26-86c5-48b3-81a6-b5c3d318e849
211	211	0	GBIF France	da44cd31-5901-4687-a106-6d1c7734ee3a	7866051f-7d64-4db7-aece-99f259f6a0da
7334	10423	3089	GBIF Spain	1f94b3ca-9345-4d65-afe2-4bace93aa0fe	7a1f6da2-f762-11e1-a439-00145eb45e9a
3220	1960	-1260	GBIF Germany	4f6826f2-4ff6-443d-b966-e6913bd24013	7bd8206c-f762-11e1-a439-00145eb45e9a
0	3	3	Plazi	ffb07bec-2d10-492d-9c37-361fe0b79427	7cd9ac74-2600-4d77-9758-cec734130b58
29	29	0	GBIF Germany	4f6826f2-4ff6-443d-b966-e6913bd24013	7d4ff6ae-1387-11e2-bb2e-00145eb45e9a
97	97	0	GBIF Germany	4f6826f2-4ff6-443d-b966-e6913bd24013	7f235426-f762-11e1-a439-00145eb45e9a
1997	1997	0	GBIF Germany	4f6826f2-4ff6-443d-b966-e6913bd24013	7f2da250-f762-11e1-a439-00145eb45e9a
6720	6720	0	Biodiversity Information System of Mexico	b324e8e9-9a4c-44fa-8f1a-7f39ea7ab576	7f638a28-f762-11e1-a439-00145eb45e9a
4	4	0	Participant Node Managers Committee	7f48e0c8-5c96-49ec-b972-30748e339115	7fec81ef-2ff9-4c5c-9dda-338cfa2dc4fb
15605	15605	0	Biodiversity Information System of Mexico	b324e8e9-9a4c-44fa-8f1a-7f39ea7ab576	804c3336-f762-11e1-a439-00145eb45e9a
1099	1099	0	Biodiversity Information System of Mexico	b324e8e9-9a4c-44fa-8f1a-7f39ea7ab576	8096d260-f762-11e1-a439-00145eb45e9a
18	18	0	GBIF Japan	db5705aa-6a6e-42f1-8942-d77b9f4896ea	80e6cc3e-f762-11e1-a439-00145eb45e9a
1168	1115	-53	GBIF Germany	4f6826f2-4ff6-443d-b966-e6913bd24013	8200e7da-f762-11e1-a439-00145eb45e9a
2	2	0	Plazi	ffb07bec-2d10-492d-9c37-361fe0b79427	83809d91-7d87-4bf3-a1a1-c5f2bf2dc954
5	5	0	National Biodiversity Network	d897a5b9-35ee-4232-94bd-b0bcaac003c2	83b1894d-0bc2-48ee-b26d-06f114657e62
0	3	3	Plazi	ffb07bec-2d10-492d-9c37-361fe0b79427	85fadde3-1743-4c03-bab8-7b8bc62b72a4
4	4	0	Plazi	ffb07bec-2d10-492d-9c37-361fe0b79427	8797b5a9-cd30-441a-864f-295ad9869b90
457	457	0	GBIF Japan	db5705aa-6a6e-42f1-8942-d77b9f4896ea	87a311d8-b1d4-4791-b791-adc7a84af774
1450	550	-900	GBIF Germany	4f6826f2-4ff6-443d-b966-e6913bd24013	894e17c4-f762-11e1-a439-00145eb45e9a
16	16	0	Plazi	ffb07bec-2d10-492d-9c37-361fe0b79427	895f6990-113a-4193-a279-7dfbcd8be850
167	167	0	GBIF Germany	4f6826f2-4ff6-443d-b966-e6913bd24013	898bb3f4-f762-11e1-a439-00145eb45e9a
718	718	0	GBIF Germany	4f6826f2-4ff6-443d-b966-e6913bd24013	89a9fe7c-f762-11e1-a439-00145eb45e9a
123	123	0	GBIF Germany	4f6826f2-4ff6-443d-b966-e6913bd24013	8a09d248-f762-11e1-a439-00145eb45e9a
188	188	0	GBIF Germany	4f6826f2-4ff6-443d-b966-e6913bd24013	8a1e02f4-f762-11e1-a439-00145eb45e9a
243	243	0	GBIF Germany	4f6826f2-4ff6-443d-b966-e6913bd24013	8bafebe6-f762-11e1-a439-00145eb45e9a
1	1	0	Plazi	ffb07bec-2d10-492d-9c37-361fe0b79427	8cacede5-9aca-4e4f-a269-01c3c0629cd5
28	26	-2	GBIF Germany	4f6826f2-4ff6-443d-b966-e6913bd24013	8d985b32-f762-11e1-a439-00145eb45e9a
446	273	-173	GBIF Germany	4f6826f2-4ff6-443d-b966-e6913bd24013	8e6ac8d8-f762-11e1-a439-00145eb45e9a
377	377	0	GBIF Germany	4f6826f2-4ff6-443d-b966-e6913bd24013	8ea74b0d-1a2a-40e1-a4eb-8f4f66175e00
19	14	-5	GBIF Germany	4f6826f2-4ff6-443d-b966-e6913bd24013	9002905e-f762-11e1-a439-00145eb45e9a
57388	57393	5	National Biodiversity Network	d897a5b9-35ee-4232-94bd-b0bcaac003c2	90eae6b8-57d2-4d24-8eb3-1dbde00f1669
21	15	-6	GBIF Germany	4f6826f2-4ff6-443d-b966-e6913bd24013	919a04d8-f762-11e1-a439-00145eb45e9a
0	6722	6722	Participant Node Managers Committee	7f48e0c8-5c96-49ec-b972-30748e339115	926f3dd4-89d9-4cbd-8ed7-32fb6fcfa861
0	44	44	Plazi	ffb07bec-2d10-492d-9c37-361fe0b79427	92d80046-8608-4b9f-b36a-8a86b319e232
1312	1312	0	GBIF Germany	4f6826f2-4ff6-443d-b966-e6913bd24013	931cb21a-f762-11e1-a439-00145eb45e9a
868	868	0	GBIF Germany	4f6826f2-4ff6-443d-b966-e6913bd24013	93b07d1a-f762-11e1-a439-00145eb45e9a
2	2	0	GBIF Germany	4f6826f2-4ff6-443d-b966-e6913bd24013	9401ab68-f762-11e1-a439-00145eb45e9a
12	12	0	Plazi	ffb07bec-2d10-492d-9c37-361fe0b79427	94bce609-5e3d-4bd6-9d81-ecf399e70982
26833	31779	4946	GBIF Japan	db5705aa-6a6e-42f1-8942-d77b9f4896ea	956c26d2-d114-421f-bf02-e9088a805a74
12	12	0	Plazi	ffb07bec-2d10-492d-9c37-361fe0b79427	959b8ddc-1c3d-49f9-93dc-2a190fbd78c8
0	180	180	Ocean Biodiversity Information System	ba0670b9-4186-41e6-8e70-f9cb3065551a	960c3033-4246-4717-bded-f691922675dd
1261	1261	0	GBIF Spain	1f94b3ca-9345-4d65-afe2-4bace93aa0fe	96bfeedc-f762-11e1-a439-00145eb45e9a
14	14	0	Plazi	ffb07bec-2d10-492d-9c37-361fe0b79427	96ca21a9-aeb1-4d05-849f-38e1b7c4d8f4
50	50	0	GBIF France	da44cd31-5901-4687-a106-6d1c7734ee3a	99fd5638-cff4-460d-9436-f2cd658a2cde
39	39	0	Plazi	ffb07bec-2d10-492d-9c37-361fe0b79427	9bd7fe36-c78b-4318-80e5-1a295d80138c
1	1	0	Plazi	ffb07bec-2d10-492d-9c37-361fe0b79427	9c98de66-5cd8-43eb-8d04-72e430fb6ba9
271	271	0	Korean Biodiversity Information Facility	e0a1e772-0177-4800-94b4-2d023fe6cdf4	9d670ffc-27fc-11e2-85e3-00145eb45e9a
1948	1948	0	GBIF Portugal	673f7038-4262-4149-b753-5658a4e912f6	9d9d16b2-b6ad-433f-9baa-5354132896ac
44325	44325	0	National Biodiversity Network	d897a5b9-35ee-4232-94bd-b0bcaac003c2	9dd4b61a-2ce7-42e6-9a36-5a23f406445f
182	182	0	GBIF Germany	4f6826f2-4ff6-443d-b966-e6913bd24013	9f515257-deb3-424b-a178-78dffec05d84
2	2	0	Plazi	ffb07bec-2d10-492d-9c37-361fe0b79427	a01f09e0-427c-4df3-bc40-4817c55c36d8
0	4	4	Plazi	ffb07bec-2d10-492d-9c37-361fe0b79427	a0254751-d2ac-481f-99b1-f995f8da110d
5	5	0	GBIF Germany	4f6826f2-4ff6-443d-b966-e6913bd24013	a3cda8ca-f2c1-4fa4-8221-fe3b4d47ace4
1	1	0	Plazi	ffb07bec-2d10-492d-9c37-361fe0b79427	a408b633-215c-4515-91b2-82af72644d60
9	9	0	Participant Node Managers Committee	7f48e0c8-5c96-49ec-b972-30748e339115	a74431ec-9954-411a-801e-2acdb14caf93
2	2	0	Plazi	ffb07bec-2d10-492d-9c37-361fe0b79427	a796f578-1291-4e1e-9a39-8edf97e99954
258	212	-46	GBIF Germany	4f6826f2-4ff6-443d-b966-e6913bd24013	aab623c4-6614-4035-94cf-20aaa80032cd
1	1	0	Plazi	ffb07bec-2d10-492d-9c37-361fe0b79427	ac0b171f-5421-43ee-b41b-51ab12cfec6c
2346	2346	0	GBIF Japan	db5705aa-6a6e-42f1-8942-d77b9f4896ea	ad66f5d0-f485-4d27-905e-3328a0f951fe
33803	33803	0	Biodiversity Information System of Mexico	b324e8e9-9a4c-44fa-8f1a-7f39ea7ab576	afeb5256-0c46-4470-b070-8514cc2b6969
210	210	0	Biodiversity Information System of Mexico	b324e8e9-9a4c-44fa-8f1a-7f39ea7ab576	b117baec-9e2d-4798-9afc-6e78fc26d14c
3	3	0	Plazi	ffb07bec-2d10-492d-9c37-361fe0b79427	b1b4a2d8-315e-42b3-aa80-174d561964e6
22	22	0	Plazi	ffb07bec-2d10-492d-9c37-361fe0b79427	b2a9ea86-343f-4690-8bec-0bef8965d17a
143	143	0	National Biodiversity Network	d897a5b9-35ee-4232-94bd-b0bcaac003c2	b33e446b-41c9-46a7-971c-3046e06fc241
1	1	0	Plazi	ffb07bec-2d10-492d-9c37-361fe0b79427	b50ae897-7f79-4191-91f8-a8e11a805fc1
40	40	0	GBIF Germany	4f6826f2-4ff6-443d-b966-e6913bd24013	b65dafc6-c089-4438-8396-773b5f851651
1672	1672	0	GBIF Spain	1f94b3ca-9345-4d65-afe2-4bace93aa0fe	ba5f097c-54d3-48ac-a57f-6d93cdbc85c8
6	6	0	Plazi	ffb07bec-2d10-492d-9c37-361fe0b79427	bb0cc874-262d-4214-a795-3c9312d0cd82
10	10	0	Plazi	ffb07bec-2d10-492d-9c37-361fe0b79427	bcd5bcbf-c545-4df9-99fb-0e9a6ae4ec96
6	6	0	Plazi	ffb07bec-2d10-492d-9c37-361fe0b79427	bcde625f-2053-405d-9839-d41e50e94927
84	84	0	Plazi	ffb07bec-2d10-492d-9c37-361fe0b79427	becb48c2-0616-4dc7-9f35-fd5240e14ee7
0	3	3	Plazi	ffb07bec-2d10-492d-9c37-361fe0b79427	c0c8a1d4-59e5-4d8a-80bf-de2018ab0bf3
5982	5982	0	Colombian Biodiversity Information System	7e865cba-7c46-417b-ade5-97f2cf5b7be0	c13f70f2-ec82-47fe-be87-85d3c31d7294
27	27	0	Plazi	ffb07bec-2d10-492d-9c37-361fe0b79427	c34d16b9-d110-450e-a994-3ade2b3c6db3
10279	10279	0	GBIF Togo	c9659a3e-07e9-4fcb-83c6-de8b9009a02e	c51f2d61-9c82-4231-a810-99b421fc9533
490	490	0	GBIF France	da44cd31-5901-4687-a106-6d1c7734ee3a	c8715817-8c2e-4b44-8862-cd7ecdb61bb9
315	315	0	GBIF Madagascar	2dbfc5c5-51b5-4494-9dfc-4d3f013a3b64	c8e45ee9-c12d-4cf9-8055-15b3d9a1e628
2	2	0	Plazi	ffb07bec-2d10-492d-9c37-361fe0b79427	c9f4b071-6bb0-4d3c-a601-e038fd3873c0
2	2	0	Plazi	ffb07bec-2d10-492d-9c37-361fe0b79427	cbda1598-b522-4f08-9da0-2a1b01326598
89632	89632	0	Participant Node Managers Committee	7f48e0c8-5c96-49ec-b972-30748e339115	d1e8a7af-097a-4ca8-aa91-62d3ff834711
2	2	0	Plazi	ffb07bec-2d10-492d-9c37-361fe0b79427	d3a30c7a-742d-4e14-b679-237a07d59652
0	2924	2924	Ocean Biodiversity Information System	ba0670b9-4186-41e6-8e70-f9cb3065551a	d8bbc31d-4e0f-423e-973e-73efda28462a
0	11	11	Plazi	ffb07bec-2d10-492d-9c37-361fe0b79427	d9b664cc-3197-44d5-92ca-08f8ce0fcc4f
349615	350294	679	U.S. Geological Survey	8618c64a-93e0-4300-b546-7249e5148ed2	dce00a1f-f6b4-4e11-9771-92c62c40ad80
0	1108	1108	Ocean Biodiversity Information System	ba0670b9-4186-41e6-8e70-f9cb3065551a	e4c97a76-f8f3-4047-a39e-3321fc4a3c16
26	26	0	Plazi	ffb07bec-2d10-492d-9c37-361fe0b79427	e730b987-dfb5-4f29-9c6b-4c41e95bf226
0	12	12	Plazi	ffb07bec-2d10-492d-9c37-361fe0b79427	e7afe7be-d00d-4356-9c51-e7dccff1c4ca
12811851	12811851	0	Belgian Biodiversity Platform	fb11cfe1-ebc3-45af-9159-17d9fddbcdac	e7cbb0ed-04c6-44ce-ac86-ebe49f4efb28
3	3	0	Plazi	ffb07bec-2d10-492d-9c37-361fe0b79427	eb2074de-efc0-4e0d-8ed3-90dc1350d939
19	19	0	Plazi	ffb07bec-2d10-492d-9c37-361fe0b79427	eb583c7d-c4a6-4fc1-be8c-deaa190a3f1b
0	1154	1154	Biodiversity Information System of Mexico	b324e8e9-9a4c-44fa-8f1a-7f39ea7ab576	ec5c485b-123d-4238-b687-f0fc085f1ffa
3	3	0	Plazi	ffb07bec-2d10-492d-9c37-361fe0b79427	ed406cdc-dbc5-4841-8221-917c3d346274
2378	2377	-1	Biodiversity Information System of Mexico	b324e8e9-9a4c-44fa-8f1a-7f39ea7ab576	f0268e26-de5f-4ef9-b62f-1851e6a4370d
0	4	4	Plazi	ffb07bec-2d10-492d-9c37-361fe0b79427	f21ecc56-fb7a-4ae6-b7b3-26a6a5ae1515
450993	471580	20587	GBIF Spain	1f94b3ca-9345-4d65-afe2-4bace93aa0fe	f3278405-0943-41a0-9f04-3a7733ec344d
17	17	0	Participant Node Managers Committee	7f48e0c8-5c96-49ec-b972-30748e339115	f617427f-16ee-4ece-b555-34b5fbff834b
41	41	0	National Biodiversity Network	d897a5b9-35ee-4232-94bd-b0bcaac003c2	f6f0e4dc-e1cc-4c7c-9ecc-b84900af76f5
0	6	6	Plazi	ffb07bec-2d10-492d-9c37-361fe0b79427	f88d32b0-c7f5-4f74-94dd-f212f068cea6
575	832	257	Participant Node Managers Committee	7f48e0c8-5c96-49ec-b972-30748e339115	fae98fd0-c0a2-460f-a30c-53cb4c88006c
4316	4316	0	GBIF France	da44cd31-5901-4687-a106-6d1c7734ee3a	fbc58ce1-255e-43bf-8dbb-7406f95c447b
6	6	0	Plazi	ffb07bec-2d10-492d-9c37-361fe0b79427	fbd696f4-13e1-41f7-b288-e792207e2046
13	13	0	Colombian Biodiversity Information System	7e865cba-7c46-417b-ade5-97f2cf5b7be0	fbf97019-92f1-430b-8419-6aaf68343317
21615	21615	0	GBIF Portugal	673f7038-4262-4149-b753-5658a4e912f6	feb41318-374b-4ed6-b61e-0369993abedc
232	232	0	Atlas of Living Australia	4a6f1b71-969e-4fc5-a693-282b05e1220c	ff2ce83d-c987-4ba0-83bc-9eb29d7fe780
2	2	0	Plazi	ffb07bec-2d10-492d-9c37-361fe0b79427	00632df3-b93c-4e05-a65a-4f397ba2b228
32	32	0	Plazi	ffb07bec-2d10-492d-9c37-361fe0b79427	0181eba5-b670-4a4b-a446-6c0134b8535a
191	191	0	National Biodiversity Network	d897a5b9-35ee-4232-94bd-b0bcaac003c2	024ef930-6138-4cd7-b7e5-31a93dd9f80a
3014	3014	0	Biodiversity Information System of Mexico	b324e8e9-9a4c-44fa-8f1a-7f39ea7ab576	0293515a-6eaa-4f6a-9a88-dd641a0c2170
5	5	0	Plazi	ffb07bec-2d10-492d-9c37-361fe0b79427	02fb596a-357a-4231-8d8a-76f3b982f7bc
8	8	0	Plazi	ffb07bec-2d10-492d-9c37-361fe0b79427	03595a80-cbb9-4f3b-95f3-6dbe82f81961
0	18360	18360	GBIF Brazil	cdc9736d-5ff7-4ece-9959-3c744360cdb3	04167aa4-4148-4691-a264-031922765fc1
3	3	0	Plazi	ffb07bec-2d10-492d-9c37-361fe0b79427	05e4bcce-91c1-4172-84cd-384cb981987c
0	130	130	Plazi	ffb07bec-2d10-492d-9c37-361fe0b79427	09f66541-18e3-4044-b553-7aab04763396
5729	5729	0	Netherlands Biodiversity Information Facility	0909d601-bda2-42df-9e63-a6d51847ebce	0a180756-7f7e-44c6-ba27-09d22f37e873
9	9	0	Plazi	ffb07bec-2d10-492d-9c37-361fe0b79427	0d6a177e-0d2a-41ae-bbac-7bbc23919230
82	82	0	Plazi	ffb07bec-2d10-492d-9c37-361fe0b79427	104a1ea7-b7d6-45cd-9402-bc84ab16b143
0	1	1	Plazi	ffb07bec-2d10-492d-9c37-361fe0b79427	1197d532-2a28-41a0-b872-cd1159b3e8eb
584	584	0	Plazi	ffb07bec-2d10-492d-9c37-361fe0b79427	12c52018-f40f-455c-9e93-836808d3b087
66	66	0	GBIF Argentina	2426a871-9feb-40a1-96c6-0c593a76b835	1332fa48-e9ab-426d-b0bc-0d216a53de35
63	63	0	Plazi	ffb07bec-2d10-492d-9c37-361fe0b79427	195dcd83-47c3-4d53-a9ea-f4da1f2ead68
1824	1824	0	GBIF Portugal	673f7038-4262-4149-b753-5658a4e912f6	19a905bf-6665-42f1-a5ac-7d5dcc7c29e8
116	116	0	GBIF Argentina	2426a871-9feb-40a1-96c6-0c593a76b835	1cc3188f-e264-4ddd-a94a-f6f1dea49441
15655	15655	0	National Biodiversity Network	d897a5b9-35ee-4232-94bd-b0bcaac003c2	1d6c7aea-5094-4559-a960-c18923e008cf
4	4	0	Plazi	ffb07bec-2d10-492d-9c37-361fe0b79427	1e87ced1-1631-463d-92d4-508d30dbbc48
0	5	5	Ocean Biodiversity Information System	ba0670b9-4186-41e6-8e70-f9cb3065551a	1e8ae014-ac8d-4c16-86e4-eefee7be182b
20606	31130	10524	BioCASE	d8bbf693-a180-4995-94fe-6130795dcf2f	1e98cc26-065e-40ca-9c57-20fa0a2f4981
150	150	0	Colombian Biodiversity Information System	7e865cba-7c46-417b-ade5-97f2cf5b7be0	1ecb5d8b-2115-48cd-847f-be79c0733ecf
0	18	18	Ocean Biodiversity Information System	ba0670b9-4186-41e6-8e70-f9cb3065551a	1f76c7c5-443b-44cb-9085-e44f4964da4f
216	216	0	National Biodiversity Network	d897a5b9-35ee-4232-94bd-b0bcaac003c2	20b6c4b7-d811-409d-bf38-7815d2b66373
19	19	0	Plazi	ffb07bec-2d10-492d-9c37-361fe0b79427	23905003-5ee5-4326-b1bb-3a2fd6250df3
2	2	0	Plazi	ffb07bec-2d10-492d-9c37-361fe0b79427	252e9e39-3d94-415e-aa5a-cabcd6174a0c
0	5	5	Plazi	ffb07bec-2d10-492d-9c37-361fe0b79427	28c4df09-5509-4b01-826f-3d8aa2bae804
185	185	0	GBIF Finland	dd514216-5c7c-45f3-910d-797424cb5be6	2b4f6d66-d958-4107-a6fa-3ed6ada9a2f6
0	1	1	Plazi	ffb07bec-2d10-492d-9c37-361fe0b79427	2d0689ba-fae9-48bf-9672-f3ed8943b4c6
767	767	0	GBIF Israel	8cb55387-7802-40e8-86d6-d357a583c596	2ea221ef-6fa8-4bac-b23e-be2a2e7feb7d
1548	1548	0	U.S. Geological Survey	8618c64a-93e0-4300-b546-7249e5148ed2	2ea6a803-fcf8-4733-9171-23e3edc59624
6468	6241	-227	Biodiversity Information System of Mexico	b324e8e9-9a4c-44fa-8f1a-7f39ea7ab576	3167cfa0-50fa-4037-bc92-1791fabb4694
5	5	0	Plazi	ffb07bec-2d10-492d-9c37-361fe0b79427	319e6db5-f883-4699-91ae-44d66182df10
7822	7822	0	Colombian Biodiversity Information System	7e865cba-7c46-417b-ade5-97f2cf5b7be0	31da52cd-6114-439d-be0a-700bf52de8f3
4	4	0	U.S. Geological Survey	8618c64a-93e0-4300-b546-7249e5148ed2	31e5eae9-5862-49fe-a39e-709375e0b279
16	16	0	GBIF Germany	4f6826f2-4ff6-443d-b966-e6913bd24013	32e1ba1f-e765-4873-b6b7-f170b4501ea9
11	11	0	Plazi	ffb07bec-2d10-492d-9c37-361fe0b79427	33f73222-e040-4981-984f-95646c8c3c92
7000	500	-6500	Biodiversity Information System of Mexico	b324e8e9-9a4c-44fa-8f1a-7f39ea7ab576	34ca940f-facb-4039-9ac0-111dad7fd9cc
212	212	0	Plazi	ffb07bec-2d10-492d-9c37-361fe0b79427	34f39440-da4f-4f5e-b9bf-258a7445ce73
0	508	508	Ocean Biodiversity Information System	ba0670b9-4186-41e6-8e70-f9cb3065551a	35e7feb7-e9db-47ca-8362-14f82b4f0785
85	85	0	Plazi	ffb07bec-2d10-492d-9c37-361fe0b79427	3a36617b-9f27-4f96-abb7-1ca64270915e
0	7	7	Plazi	ffb07bec-2d10-492d-9c37-361fe0b79427	3bf6fc2c-fb02-4b86-a11d-6ef9255eb468
20727	20727	0	Participant Node Managers Committee	7f48e0c8-5c96-49ec-b972-30748e339115	3e7837d0-4318-4dea-8800-f2b208b25148
11061	12799	1738	GBIF Brazil	cdc9736d-5ff7-4ece-9959-3c744360cdb3	3f6a3304-f66f-4ba8-be57-92a70f3aac3f
208	208	0	GBIF Germany	4f6826f2-4ff6-443d-b966-e6913bd24013	4087ce5d-cd0d-4452-b80d-126f9f12dd36
281	281	0	Costa Rica Biodiversity Facility	3379bb09-1a58-41e7-9c57-e3b66c3eb5a0	42c68f60-e30f-4ab7-8dd9-8f166fabcdb1
115	115	0	GBIF France	da44cd31-5901-4687-a106-6d1c7734ee3a	4308661b-fbc7-4896-9ba4-d1574d38a41a
15527	15527	0	Ocean Biodiversity Information System	ba0670b9-4186-41e6-8e70-f9cb3065551a	43d13435-60f0-421e-860a-6edaeafd79b2
0	5	5	Plazi	ffb07bec-2d10-492d-9c37-361fe0b79427	44cac780-ac71-47d9-8d4a-c994fb92586b
3142	1549	-1593	GBIF Germany	4f6826f2-4ff6-443d-b966-e6913bd24013	454583dd-1560-4973-800d-65aafa1de6fe
191	191	0	GBIF Finland	dd514216-5c7c-45f3-910d-797424cb5be6	486a6494-33f2-4f8a-8498-b31f39b66ac1
432	432	0	Atlas of Living Australia	4a6f1b71-969e-4fc5-a693-282b05e1220c	4896f82a-ff72-4d14-bf2a-780b86ab03f7
0	3167	3167	GBIF Portugal	673f7038-4262-4149-b753-5658a4e912f6	49f3138e-28c2-4a74-8950-cf8a0ecc1840
0	8	8	Plazi	ffb07bec-2d10-492d-9c37-361fe0b79427	4a8017df-4f4e-4dc4-a5fe-c3e2ba3643fe
909	909	0	Participant Node Managers Committee	7f48e0c8-5c96-49ec-b972-30748e339115	4b0fa95c-e815-4df0-9979-53b285061d79
0	5	5	Plazi	ffb07bec-2d10-492d-9c37-361fe0b79427	4b48fe2c-095b-463e-98b2-2dcc9417a41b
29171	29171	0	Netherlands Biodiversity Information Facility	0909d601-bda2-42df-9e63-a6d51847ebce	4f8de55f-5967-46c4-b689-31de17090ed4
36	36	0	Plazi	ffb07bec-2d10-492d-9c37-361fe0b79427	516e88e7-5d6e-4d32-8ec2-e1e7fb040a86
598	598	0	Colombian Biodiversity Information System	7e865cba-7c46-417b-ade5-97f2cf5b7be0	54a03690-2b59-4eb7-bbe1-d5d73e858c2b
2	2	0	Participant Node Managers Committee	7f48e0c8-5c96-49ec-b972-30748e339115	55840438-de12-416d-bf81-d7c8c58e4547
1463	1463	0	GBIF France	da44cd31-5901-4687-a106-6d1c7734ee3a	56083ea2-9b95-4cc0-af1d-1d6147b2bec2
0	1	1	Plazi	ffb07bec-2d10-492d-9c37-361fe0b79427	5c097b36-ea2f-4283-ba4e-e80eb4aee26a
123	123	0	GBIF France	da44cd31-5901-4687-a106-6d1c7734ee3a	5cfd6c1f-3f24-4e96-98cc-32d978d90963
97	97	0	GBIF Germany	4f6826f2-4ff6-443d-b966-e6913bd24013	614fea18-f762-11e1-a439-00145eb45e9a
86	86	0	GBIF Germany	4f6826f2-4ff6-443d-b966-e6913bd24013	623c709a-f762-11e1-a439-00145eb45e9a
22	22	0	Plazi	ffb07bec-2d10-492d-9c37-361fe0b79427	629f2e5b-cd3c-41bb-b902-cd376e632133
6	6	0	Plazi	ffb07bec-2d10-492d-9c37-361fe0b79427	64552781-51af-4830-8a50-9efbbf886a14
36	36	0	National Biodiversity Network	d897a5b9-35ee-4232-94bd-b0bcaac003c2	646ff066-e15f-40ef-82d2-2696fdae2c9c
0	243	243	Plazi	ffb07bec-2d10-492d-9c37-361fe0b79427	64896e02-1182-4af2-b69d-90eb4cc6aaa6
3	3	0	Plazi	ffb07bec-2d10-492d-9c37-361fe0b79427	649fcc0f-65fd-4ceb-a2e2-bba266bb5d7e
178	178	0	Participant Node Managers Committee	7f48e0c8-5c96-49ec-b972-30748e339115	6524e783-4fea-4ec1-b3ce-a27cef0ca168
58	57	-1	GBIF Germany	4f6826f2-4ff6-443d-b966-e6913bd24013	65891b4a-f762-11e1-a439-00145eb45e9a
174	169	-5	GBIF Germany	4f6826f2-4ff6-443d-b966-e6913bd24013	65edc05e-f762-11e1-a439-00145eb45e9a
63	63	0	GBIF Germany	4f6826f2-4ff6-443d-b966-e6913bd24013	681d5e20-f762-11e1-a439-00145eb45e9a
364	364	0	GBIF France	da44cd31-5901-4687-a106-6d1c7734ee3a	68267365-e262-4a39-bf42-64d0eec1ac2b
20	20	0	GBIF Germany	4f6826f2-4ff6-443d-b966-e6913bd24013	68277c20-f762-11e1-a439-00145eb45e9a
318	318	0	GBIF Germany	4f6826f2-4ff6-443d-b966-e6913bd24013	691c0394-f762-11e1-a439-00145eb45e9a
46	46	0	GBIF Germany	4f6826f2-4ff6-443d-b966-e6913bd24013	69904178-f762-11e1-a439-00145eb45e9a
142	142	0	GBIF Germany	4f6826f2-4ff6-443d-b966-e6913bd24013	69e3f656-f762-11e1-a439-00145eb45e9a
14	14	0	GBIF Germany	4f6826f2-4ff6-443d-b966-e6913bd24013	6a8c6c00-f762-11e1-a439-00145eb45e9a
30	30	0	GBIF Germany	4f6826f2-4ff6-443d-b966-e6913bd24013	6b7f78c8-f762-11e1-a439-00145eb45e9a
12	12	0	GBIF Germany	4f6826f2-4ff6-443d-b966-e6913bd24013	6bbf34f4-f762-11e1-a439-00145eb45e9a
301	301	0	GBIF Germany	4f6826f2-4ff6-443d-b966-e6913bd24013	6c53f998-403e-4a61-bc25-13704541000a
0	38248	38248	U.S. Geological Survey	8618c64a-93e0-4300-b546-7249e5148ed2	6cfce8da-c177-4790-b038-1202dd33e9d7
1461	1461	0	GBIF Germany	4f6826f2-4ff6-443d-b966-e6913bd24013	6dd93e3f-8151-4245-b149-04d1183d8776
0	35	35	Plazi	ffb07bec-2d10-492d-9c37-361fe0b79427	6de29c70-f7c6-491e-874e-3ba163fde44d
8	8	0	GBIF France	da44cd31-5901-4687-a106-6d1c7734ee3a	6e51f70c-4da6-468b-8e76-16ea0ce328d1
39	39	0	Plazi	ffb07bec-2d10-492d-9c37-361fe0b79427	6f10b20b-2570-4234-a1ed-533ca2348b90
8036	8036	0	GBIF Portugal	673f7038-4262-4149-b753-5658a4e912f6	6f8e55e2-1a7f-43bb-8e6f-a57314b9b9a4
12	12	0	GBIF Germany	4f6826f2-4ff6-443d-b966-e6913bd24013	70cc95d6-f762-11e1-a439-00145eb45e9a
0	4	4	Plazi	ffb07bec-2d10-492d-9c37-361fe0b79427	7154be90-26b9-4896-87fc-9e6255f97b9b
12337	12337	0	GBIF Japan	db5705aa-6a6e-42f1-8942-d77b9f4896ea	7201065d-95ac-4706-bb2b-9fd04209fc8d
0	5860	5860	Colombian Biodiversity Information System	7e865cba-7c46-417b-ade5-97f2cf5b7be0	733fe0fc-68d2-42c9-8a53-e1ab320d50ec
577	577	0	GBIF Germany	4f6826f2-4ff6-443d-b966-e6913bd24013	73573298-f762-11e1-a439-00145eb45e9a
93	93	0	GBIF Germany	4f6826f2-4ff6-443d-b966-e6913bd24013	73d295f0-f762-11e1-a439-00145eb45e9a
31	31	0	GBIF Germany	4f6826f2-4ff6-443d-b966-e6913bd24013	7456604c-f762-11e1-a439-00145eb45e9a
1	1	0	Plazi	ffb07bec-2d10-492d-9c37-361fe0b79427	74b777c9-eae0-4770-8c86-dcbb10fb06b3
196	196	0	GBIF Germany	4f6826f2-4ff6-443d-b966-e6913bd24013	752122dc-f762-11e1-a439-00145eb45e9a
48	48	0	GBIF Germany	4f6826f2-4ff6-443d-b966-e6913bd24013	75291bae-f762-11e1-a439-00145eb45e9a
24	24	0	GBIF Germany	4f6826f2-4ff6-443d-b966-e6913bd24013	7546c6fe-f762-11e1-a439-00145eb45e9a
0	10	10	Plazi	ffb07bec-2d10-492d-9c37-361fe0b79427	757cd5e5-d114-41fb-92b4-20298a3e11e4
8214	8214	0	U.S. Geological Survey	8618c64a-93e0-4300-b546-7249e5148ed2	77573a8e-8ceb-472a-aaad-af7a87f5c5c6
257	257	0	Plazi	ffb07bec-2d10-492d-9c37-361fe0b79427	77c874cd-4f85-4746-8466-3ca09e2c2b8d
0	1961557	1961557	Canada Biodiversity Information Facility	8f83fc96-c966-4126-83f7-bf044dc49efa	78540eb6-95b0-4c3d-b362-03ed0bb5b2d3
10	10	0	GBIF Germany	4f6826f2-4ff6-443d-b966-e6913bd24013	78f02dea-f762-11e1-a439-00145eb45e9a
15	15	0	GBIF France	da44cd31-5901-4687-a106-6d1c7734ee3a	7afe0982-a3a9-4e90-b2a1-02ac03b43e97
504	504	0	Korean Biodiversity Information Facility	e0a1e772-0177-4800-94b4-2d023fe6cdf4	7b027232-f762-11e1-a439-00145eb45e9a
4	4	0	Plazi	ffb07bec-2d10-492d-9c37-361fe0b79427	7bc281a9-bf71-47bb-ab92-e927fb002e9b
6680	6680	0	National Biodiversity Network	d897a5b9-35ee-4232-94bd-b0bcaac003c2	7c20aae4-f762-11e1-a439-00145eb45e9a
1984	1984	0	GBIF Germany	4f6826f2-4ff6-443d-b966-e6913bd24013	7ce6887c-f762-11e1-a439-00145eb45e9a
35	35	0	GBIF Germany	4f6826f2-4ff6-443d-b966-e6913bd24013	7d3baa96-f762-11e1-a439-00145eb45e9a
325	273	-52	GBIF Germany	4f6826f2-4ff6-443d-b966-e6913bd24013	7d6ddf34-f762-11e1-a439-00145eb45e9a
37	37	0	GBIF Germany	4f6826f2-4ff6-443d-b966-e6913bd24013	7df574d0-f762-11e1-a439-00145eb45e9a
5291	5291	0	GBIF Spain	1f94b3ca-9345-4d65-afe2-4bace93aa0fe	7f57f884-f762-11e1-a439-00145eb45e9a
0	1716	1716	Ocean Biodiversity Information System	ba0670b9-4186-41e6-8e70-f9cb3065551a	7f810496-749c-4f1e-87c5-6e41a5be394c
3238	3238	0	GBIF Germany	4f6826f2-4ff6-443d-b966-e6913bd24013	81b78f9a-f762-11e1-a439-00145eb45e9a
393	393	0	GBIF Benin	efb9c00e-f802-45dd-8826-a52ec45b89ff	81ffbf80-6f85-4556-a126-ba20225cb757
45	45	0	GBIF Germany	4f6826f2-4ff6-443d-b966-e6913bd24013	822f88ce-f762-11e1-a439-00145eb45e9a
19705	21040	1335	GBIF Germany	4f6826f2-4ff6-443d-b966-e6913bd24013	8286cf26-f762-11e1-a439-00145eb45e9a
998	998	0	Korean Biodiversity Information Facility	e0a1e772-0177-4800-94b4-2d023fe6cdf4	8300bfde-f762-11e1-a439-00145eb45e9a
197500	197500	0	GBIF Spain	1f94b3ca-9345-4d65-afe2-4bace93aa0fe	8379962a-f762-11e1-a439-00145eb45e9a
48	48	0	Plazi	ffb07bec-2d10-492d-9c37-361fe0b79427	8494ee53-c52c-4970-8cdf-b959be3f5a9c
978	978	0	GBIF Germany	4f6826f2-4ff6-443d-b966-e6913bd24013	84e57e73-164d-4ec2-94c5-db2c0e481804
5159	5159	0	Biodiversity Information System of Mexico	b324e8e9-9a4c-44fa-8f1a-7f39ea7ab576	85102666-f762-11e1-a439-00145eb45e9a
4	4	0	GBIF Germany	4f6826f2-4ff6-443d-b966-e6913bd24013	85e1e64c-f762-11e1-a439-00145eb45e9a
107580	107580	0	DiSSCo	07b1b3f9-e3fa-4348-8f0c-4077974ce177	867dbe0a-f762-11e1-a439-00145eb45e9a
316	242	-74	GBIF Germany	4f6826f2-4ff6-443d-b966-e6913bd24013	876beb3e-f762-11e1-a439-00145eb45e9a
767	716	-51	GBIF Germany	4f6826f2-4ff6-443d-b966-e6913bd24013	87c75758-f762-11e1-a439-00145eb45e9a
481	383	-98	GBIF Germany	4f6826f2-4ff6-443d-b966-e6913bd24013	8839fd44-f762-11e1-a439-00145eb45e9a
120	105	-15	GBIF Germany	4f6826f2-4ff6-443d-b966-e6913bd24013	883de026-f762-11e1-a439-00145eb45e9a
26	26	0	GBIF Germany	4f6826f2-4ff6-443d-b966-e6913bd24013	887ba6e0-f762-11e1-a439-00145eb45e9a
26	26	0	GBIF Germany	4f6826f2-4ff6-443d-b966-e6913bd24013	88a74f52-f762-11e1-a439-00145eb45e9a
59	59	0	U.S. Geological Survey	8618c64a-93e0-4300-b546-7249e5148ed2	88ba1ac8-497d-4aa4-b2de-bf2d71739a29
446	446	0	Biodiversity Information System of Mexico	b324e8e9-9a4c-44fa-8f1a-7f39ea7ab576	892ef448-f762-11e1-a439-00145eb45e9a
3	3	0	Plazi	ffb07bec-2d10-492d-9c37-361fe0b79427	89da9c23-c32d-4d91-9cbe-8e594db3892b
0	2	2	Plazi	ffb07bec-2d10-492d-9c37-361fe0b79427	8a06639e-2216-4578-a6e3-edd9aa67cdc3
1210	1210	0	Atlas of Living Australia	4a6f1b71-969e-4fc5-a693-282b05e1220c	8b70ab8e-c0d3-464b-8ce5-3f8d29470aca
4	4	0	GBIF Germany	4f6826f2-4ff6-443d-b966-e6913bd24013	8ba61314-f762-11e1-a439-00145eb45e9a
10	10	0	GBIF Germany	4f6826f2-4ff6-443d-b966-e6913bd24013	8c07285c-f762-11e1-a439-00145eb45e9a
473	312	-161	GBIF Germany	4f6826f2-4ff6-443d-b966-e6913bd24013	8de1a1f2-f762-11e1-a439-00145eb45e9a
602	341	-261	GBIF Germany	4f6826f2-4ff6-443d-b966-e6913bd24013	8e822096-f762-11e1-a439-00145eb45e9a
1131	754	-377	GBIF Germany	4f6826f2-4ff6-443d-b966-e6913bd24013	8e9965b2-f762-11e1-a439-00145eb45e9a
10	10	0	GBIF Germany	4f6826f2-4ff6-443d-b966-e6913bd24013	8f4496da-f762-11e1-a439-00145eb45e9a
439	262	-177	GBIF Germany	4f6826f2-4ff6-443d-b966-e6913bd24013	8f9f438c-f762-11e1-a439-00145eb45e9a
489	489	0	GBIF France	da44cd31-5901-4687-a106-6d1c7734ee3a	905f00be-866c-4c60-920a-3056349df52e
558	558	0	Polish Biodiversity Information Network	2618bfdf-e194-4911-a241-80db3107bc51	90837c06-ff84-47ec-b5fd-98c8b8f541f3
97	49	-48	GBIF Germany	4f6826f2-4ff6-443d-b966-e6913bd24013	90ed01ca-f762-11e1-a439-00145eb45e9a
2	2	0	GBIF Germany	4f6826f2-4ff6-443d-b966-e6913bd24013	918b3426-f762-11e1-a439-00145eb45e9a
40	39	-1	GBIF Germany	4f6826f2-4ff6-443d-b966-e6913bd24013	91bb2820-f762-11e1-a439-00145eb45e9a
9	9	0	Plazi	ffb07bec-2d10-492d-9c37-361fe0b79427	924793df-6845-46a0-a9a0-6cf1496166c9
8	8	0	Plazi	ffb07bec-2d10-492d-9c37-361fe0b79427	92938be1-837f-4f83-82ec-8bd8b9c9395c
28187	28187	0	U.S. Geological Survey	8618c64a-93e0-4300-b546-7249e5148ed2	96275bf2-8999-4869-95d5-4903a84391b0
10	10	0	Plazi	ffb07bec-2d10-492d-9c37-361fe0b79427	9675f3d4-930d-4e4c-97e1-bcc7e6c5120d
90	90	0	Society for the Management of Electronic Biodiversity Data	97818ee4-1461-4180-bf1d-b3201050124f	974c7838-232a-4fb8-bc02-ef408fcb6944
4	4	0	Plazi	ffb07bec-2d10-492d-9c37-361fe0b79427	98eff97b-3170-445e-b92e-217fdf7afb1d
3336	3336	0	National Biodiversity Network	d897a5b9-35ee-4232-94bd-b0bcaac003c2	9b45e07f-7231-4c85-a4ff-f287893d4fef
0	260	260	Plazi	ffb07bec-2d10-492d-9c37-361fe0b79427	9b512d6d-956c-45a3-9265-8ae1167ba019
0	41	41	Plazi	ffb07bec-2d10-492d-9c37-361fe0b79427	9bde0cf2-6fea-4674-ba84-aa18c5ed7601
5323	5323	0	Society for the Management of Electronic Biodiversity Data	97818ee4-1461-4180-bf1d-b3201050124f	9c4e36c1-d3f9-49ce-8ec1-8c434fa9e6eb
103143	103143	0	U.S. Geological Survey	8618c64a-93e0-4300-b546-7249e5148ed2	9f747cff-839f-4485-83a1-f10317a92a82
5	5	0	Plazi	ffb07bec-2d10-492d-9c37-361fe0b79427	9fcb2174-ef48-4aa7-a9ab-b7345f9358b5
4	4	0	Plazi	ffb07bec-2d10-492d-9c37-361fe0b79427	a09ca613-dcc4-4041-98e0-3dfdbf39b506
2509	2509	0	Participant Node Managers Committee	7f48e0c8-5c96-49ec-b972-30748e339115	a1850113-9112-42a6-a3ef-c53ac260d388
13	13	0	GBIF France	da44cd31-5901-4687-a106-6d1c7734ee3a	a25e2449-d405-4cd6-a95d-fe9f8cfc5932
92	92	0	Colombian Biodiversity Information System	7e865cba-7c46-417b-ade5-97f2cf5b7be0	a414b648-a007-4ade-b993-b575013c5c70
13	13	0	Plazi	ffb07bec-2d10-492d-9c37-361fe0b79427	a5cecd60-c2bc-4ba3-a9f1-ecb12bc84b08
822472	825348	2876	Atlas of Living Australia	4a6f1b71-969e-4fc5-a693-282b05e1220c	a79c2b50-6c8a-11de-8226-b8a03c50a862
55	55	0	Plazi	ffb07bec-2d10-492d-9c37-361fe0b79427	a86fa4a0-606f-4828-84c9-f931abd9c49e
12370	12370	0	GBIF Finland	dd514216-5c7c-45f3-910d-797424cb5be6	ab663bb6-f94f-4d13-9bab-81316ed1f4a3
15	15	0	Plazi	ffb07bec-2d10-492d-9c37-361fe0b79427	ab9adc2b-f315-4b78-bdaf-a86abc4b006e
2	2	0	Plazi	ffb07bec-2d10-492d-9c37-361fe0b79427	b3b7a402-6d63-4d91-a1c4-deb0b6449a4b
169	169	0	GBIF France	da44cd31-5901-4687-a106-6d1c7734ee3a	b51d422c-8ad3-4945-b86b-53a423969ea4
0	91	91	U.S. Geological Survey	8618c64a-93e0-4300-b546-7249e5148ed2	b7429d9e-6800-479e-a2bf-2bbfb83405a7
0	133550	133550	Netherlands Biodiversity Information Facility	0909d601-bda2-42df-9e63-a6d51847ebce	bda96dc3-956c-43cc-bf0d-3567f948866d
167	167	0	Plazi	ffb07bec-2d10-492d-9c37-361fe0b79427	be5e4bdb-a5e2-48f0-bc0c-3c27ddb7a1cf
0	440	440	Ocean Biodiversity Information System	ba0670b9-4186-41e6-8e70-f9cb3065551a	bfc5f84c-c88e-44e1-8d65-445d4dfc0f2e
0	1	1	Chinese Academy of Sciences	e760dc6f-dd68-474d-ab41-bd3588571793	c25ee91c-ffb0-4064-825e-143875d93cff
51	51	0	National Biodiversity Network	d897a5b9-35ee-4232-94bd-b0bcaac003c2	c291b1b4-925d-49e6-a54b-c7cb8bc7999e
25	25	0	Participant Node Managers Committee	7f48e0c8-5c96-49ec-b972-30748e339115	c489091a-75f6-4c51-990e-424d111955ca
16	16	0	Plazi	ffb07bec-2d10-492d-9c37-361fe0b79427	c4db0964-a92e-472d-b3b9-517613497c84
0	5	5	Plazi	ffb07bec-2d10-492d-9c37-361fe0b79427	c8622ca7-cde1-46e9-8c54-da13e2637cc3
10	10	0	Plazi	ffb07bec-2d10-492d-9c37-361fe0b79427	cba502b0-cc06-4252-94f1-3eda754e8183
2369	2369	0	GBIF Finland	dd514216-5c7c-45f3-910d-797424cb5be6	ccdb1c44-3836-48b0-b9e9-6e180bcaa637
0	48	48	Participant Node Managers Committee	7f48e0c8-5c96-49ec-b972-30748e339115	cde1c696-9dd4-410d-a8c9-0ce8b2530d65
4183	4183	0	U.S. Geological Survey	8618c64a-93e0-4300-b546-7249e5148ed2	d021ed3a-7179-4f25-bfd3-90d72cc6fd38
0	2	2	Plazi	ffb07bec-2d10-492d-9c37-361fe0b79427	d19867b5-924d-4fde-9fda-0b71a9bd7443
6	6	0	Plazi	ffb07bec-2d10-492d-9c37-361fe0b79427	d1e7eca1-54d0-4abc-a40c-8167d62aa840
4	4	0	Plazi	ffb07bec-2d10-492d-9c37-361fe0b79427	d2b69f13-1f9c-4249-9c5a-487930339084
7706	7706	0	GBIF France	da44cd31-5901-4687-a106-6d1c7734ee3a	d3af0996-5d4b-40ff-af06-0830942391f6
0	1	1	Plazi	ffb07bec-2d10-492d-9c37-361fe0b79427	d5352c35-f6dc-46d9-ad03-461d44f5db05
221	221	0	GBIF Argentina	2426a871-9feb-40a1-96c6-0c593a76b835	d59de814-5dac-4aab-a9b1-e404aff4b0c6
100372	100372	0	Atlas of Living Australia	4a6f1b71-969e-4fc5-a693-282b05e1220c	d7349b4a-5b9e-414f-94a2-418af65425ce
357	357	0	Canada Biodiversity Information Facility	8f83fc96-c966-4126-83f7-bf044dc49efa	da5c3928-edfa-4de8-a667-1b2fc007e640
6	6	0	Plazi	ffb07bec-2d10-492d-9c37-361fe0b79427	db486d75-72b1-4897-9654-55a22c358d9f
33	33	0	Plazi	ffb07bec-2d10-492d-9c37-361fe0b79427	db716632-f55b-4a04-b3cd-918eea1c92c9
0	26	26	Ocean Biodiversity Information System	ba0670b9-4186-41e6-8e70-f9cb3065551a	dbb81459-91c9-4cc1-b2b0-17a098d0d803
0	3	3	Plazi	ffb07bec-2d10-492d-9c37-361fe0b79427	df54c9c6-71f4-4d3f-8c82-3e2756f48024
0	63	63	Plazi	ffb07bec-2d10-492d-9c37-361fe0b79427	e03ba3fc-13a1-4096-b515-a772de4ec84e
0	2	2	Plazi	ffb07bec-2d10-492d-9c37-361fe0b79427	e3c2c7d0-4f11-47f3-9d88-3ffb02db5bd7
10516	10516	0	National Biodiversity Network	d897a5b9-35ee-4232-94bd-b0bcaac003c2	e7690a15-c71c-44e3-9891-c86b8a9cf6be
347	335	-12	Biodiversity Information System of Mexico	b324e8e9-9a4c-44fa-8f1a-7f39ea7ab576	ecbb2874-d2a4-4400-b57e-00b8ebcd3a9c
725	725	0	National Biodiversity Network	d897a5b9-35ee-4232-94bd-b0bcaac003c2	ed031f83-8e47-4116-847d-ae35f145f9c5
482	482	0	GBIF France	da44cd31-5901-4687-a106-6d1c7734ee3a	ee57ec5e-1fcc-437a-9783-fd58a2ee73d7
1590	1590	0	Participant Node Managers Committee	7f48e0c8-5c96-49ec-b972-30748e339115	ee71be2d-16e5-460d-967c-9f4602417fd4
682	682	0	National Biodiversity Network	d897a5b9-35ee-4232-94bd-b0bcaac003c2	ef7e0d45-c59f-4f48-afa3-53d9f545de56
34034	34034	0	GBIF France	da44cd31-5901-4687-a106-6d1c7734ee3a	f0613af8-9a0e-42c9-bdc7-1479521a26fd
3	3	0	Plazi	ffb07bec-2d10-492d-9c37-361fe0b79427	f1580943-c9fc-4ded-8259-7ff0f84baad8
12	12	0	Plazi	ffb07bec-2d10-492d-9c37-361fe0b79427	f5380ee2-16c4-4ac9-b0c1-aa29fd8ab2da
31232	31232	0	GBIF Brazil	cdc9736d-5ff7-4ece-9959-3c744360cdb3	f68d90e0-46dd-4ac4-acac-ade9d2645886
1098	1098	0	GBIF Brazil	cdc9736d-5ff7-4ece-9959-3c744360cdb3	f6a922c4-d0ca-4f9c-bba2-7b1939996439
524749	527285	2536	Atlas of Living Australia	4a6f1b71-969e-4fc5-a693-282b05e1220c	fa375330-6c8a-11de-8226-b8a03c50a862
383	383	0	Colombian Biodiversity Information System	7e865cba-7c46-417b-ade5-97f2cf5b7be0	fd43e69f-857c-48ff-a488-30049c0ce46d
6	6	0	Plazi	ffb07bec-2d10-492d-9c37-361fe0b79427	ffeaa7fe-f040-4c53-98d9-38938a1f71e7
85	85	0	Plazi	ffb07bec-2d10-492d-9c37-361fe0b79427	00507d5f-328a-4506-8b7f-132a7df3786d
31917	31917	0	Costa Rica Biodiversity Facility	3379bb09-1a58-41e7-9c57-e3b66c3eb5a0	01e71491-0712-47f5-95a0-55a43f44fddc
3079	3079	0	National Biodiversity Network	d897a5b9-35ee-4232-94bd-b0bcaac003c2	0270ba00-4b1f-4ed6-9a88-de906a04fba5
2	2	0	Participant Node Managers Committee	7f48e0c8-5c96-49ec-b972-30748e339115	036ec3ff-7852-41ae-86ce-5abe097a6943
345	345	0	GBIF France	da44cd31-5901-4687-a106-6d1c7734ee3a	039a3012-439d-435b-8977-83c5dba5bd10
2463	2463	0	Biodiversity Information System of Mexico	b324e8e9-9a4c-44fa-8f1a-7f39ea7ab576	05b90d06-58a6-477a-bade-046a5a5b1887
2	2	0	Plazi	ffb07bec-2d10-492d-9c37-361fe0b79427	072a54a0-5184-4c2c-866d-68f53cae5580
25	25	0	Plazi	ffb07bec-2d10-492d-9c37-361fe0b79427	07fcb633-1ee4-416c-9109-3cb90766232d
27788	27788	0	National Biodiversity Network	d897a5b9-35ee-4232-94bd-b0bcaac003c2	08360455-914e-4d02-809a-13e3cd8a8d21
2109	2109	0	GBIF Germany	4f6826f2-4ff6-443d-b966-e6913bd24013	09f03b70-f0aa-48da-a309-b51bbefe12cf
0	7	7	Plazi	ffb07bec-2d10-492d-9c37-361fe0b79427	0a14196a-0bdc-44b2-ac87-035269b84ea7
447	447	0	Atlas of Living Australia	4a6f1b71-969e-4fc5-a693-282b05e1220c	0cb30c4a-55c7-481c-ac46-88c7d51a4dd1
5443	5443	0	National Biodiversity Network	d897a5b9-35ee-4232-94bd-b0bcaac003c2	0ddc0e06-9c61-4e2b-9260-6b59468ebf86
1006	1006	0	National Biodiversity Network	d897a5b9-35ee-4232-94bd-b0bcaac003c2	0e548409-32c6-4f6b-9546-e444cfba097b
225	225	0	GBIF Germany	4f6826f2-4ff6-443d-b966-e6913bd24013	0ed099a8-8052-4ca0-ba65-534f692c11a3
5	5	0	Plazi	ffb07bec-2d10-492d-9c37-361fe0b79427	12947330-5546-4beb-94f3-06c43d8723e7
2	2	0	Plazi	ffb07bec-2d10-492d-9c37-361fe0b79427	1c5094f8-baa5-479b-9a86-b05da2fb210f
2	2	0	Plazi	ffb07bec-2d10-492d-9c37-361fe0b79427	1d65c0e0-dc2e-46c8-b0f6-9c3b7f4c8a4f
0	18	18	Plazi	ffb07bec-2d10-492d-9c37-361fe0b79427	210b95ea-4596-487c-914d-03df0694d33e
0	8	8	Plazi	ffb07bec-2d10-492d-9c37-361fe0b79427	21ae9d03-bd32-4de0-848a-9bcb5f5769f7
9	9	0	Plazi	ffb07bec-2d10-492d-9c37-361fe0b79427	2349f756-42b8-4290-891a-474f8253fbac
0	3	3	Plazi	ffb07bec-2d10-492d-9c37-361fe0b79427	24560744-5ba1-4113-9560-4578b72e8391
39	39	0	Plazi	ffb07bec-2d10-492d-9c37-361fe0b79427	281f5b51-25b6-4acf-ac92-c7c2845674e5
9446	9446	0	Colombian Biodiversity Information System	7e865cba-7c46-417b-ade5-97f2cf5b7be0	2a337d5a-a784-4f8a-a947-46d69e0fa3eb
3	3	0	Plazi	ffb07bec-2d10-492d-9c37-361fe0b79427	2ca9177b-26ba-43d1-8333-2e6d98a4b11d
4	4	0	Plazi	ffb07bec-2d10-492d-9c37-361fe0b79427	2d16ed65-ae72-4880-b255-5bd77c201da8
168	168	0	Colombian Biodiversity Information System	7e865cba-7c46-417b-ade5-97f2cf5b7be0	2d8496b6-462f-4400-b7a4-ce4f3a220e46
8	8	0	Plazi	ffb07bec-2d10-492d-9c37-361fe0b79427	2dbd1492-da1f-4175-9353-71d642668466
2608	2608	0	Participant Node Managers Committee	7f48e0c8-5c96-49ec-b972-30748e339115	2dc54d17-6a79-425d-a1e3-82dc0b607dfb
0	22	22	Plazi	ffb07bec-2d10-492d-9c37-361fe0b79427	2e886aea-b59a-45a6-aeaa-2427d584a894
11	11	0	GBIF France	da44cd31-5901-4687-a106-6d1c7734ee3a	30e657e0-ed66-4809-866d-9a241452fde4
405	405	0	GBIF Portugal	673f7038-4262-4149-b753-5658a4e912f6	39b10187-1265-4295-988d-5912671bcfee
19100	19560	460	GBIF New Zealand	4f9fd726-20dd-445e-89a1-8ed93792276f	3c6e7390-3b56-11dc-8c19-b8a03c50a862
114	114	0	Plazi	ffb07bec-2d10-492d-9c37-361fe0b79427	3f040435-a70c-49ec-ae9a-07df11b91f4a
9	9	0	Plazi	ffb07bec-2d10-492d-9c37-361fe0b79427	4029fef6-b3ec-4241-b783-9fc713eaab09
0	6754	6754	National Biodiversity Data Centre	422b00b2-6c94-4bb6-976b-c359916efdb8	43fa788e-a1ac-46bd-ab45-cd39db08d754
1192	1192	0	GBIF France	da44cd31-5901-4687-a106-6d1c7734ee3a	45e24212-6e3b-481d-91a9-76c252e0d580
58	58	0	GBIF Germany	4f6826f2-4ff6-443d-b966-e6913bd24013	4854ce47-33d4-49a3-b52e-faac1db7d641
0	24	24	Colombian Biodiversity Information System	7e865cba-7c46-417b-ade5-97f2cf5b7be0	494c2bec-537d-4aed-9069-a1331e44a0e9
189	189	0	GBIF Portugal	673f7038-4262-4149-b753-5658a4e912f6	49576930-4b51-441e-9f4c-b20a4045e882
1713	1713	0	Atlas of Living Australia	4a6f1b71-969e-4fc5-a693-282b05e1220c	4b614564-e5f4-4d36-82b2-4a621d26b9a7
0	100	100	Plazi	ffb07bec-2d10-492d-9c37-361fe0b79427	4c0b59ec-84a8-4daa-8467-3ac34e86ecd6
0	16	16	Plazi	ffb07bec-2d10-492d-9c37-361fe0b79427	4d61c86d-77e8-4f77-89b6-c093ddc83f39
1	1	0	Plazi	ffb07bec-2d10-492d-9c37-361fe0b79427	4dab2987-0956-4343-b019-543f793aeaa1
640	640	0	GBIF France	da44cd31-5901-4687-a106-6d1c7734ee3a	4df19e80-d3f3-4d50-9a0d-ab92c84b6fa3
382	382	0	GBIF Finland	dd514216-5c7c-45f3-910d-797424cb5be6	51109185-ab25-4c50-bd7e-31fca996ecfe
0	1	1	Plazi	ffb07bec-2d10-492d-9c37-361fe0b79427	53213a45-a01e-4ca3-8ac2-8a123a29310f
1594	1594	0	GBIF France	da44cd31-5901-4687-a106-6d1c7734ee3a	566faecc-db83-4566-be32-4b41e755022e
33	33	0	Plazi	ffb07bec-2d10-492d-9c37-361fe0b79427	57153cac-0d4c-4e55-95e8-c06b710831cf
638	638	0	Ocean Biodiversity Information System	ba0670b9-4186-41e6-8e70-f9cb3065551a	57fa062c-ac30-4f3f-a8ec-9d210e913415
0	127	127	Ocean Biodiversity Information System	ba0670b9-4186-41e6-8e70-f9cb3065551a	588f99b4-9a8c-457c-8b3a-48534dcac317
0	4	4	Plazi	ffb07bec-2d10-492d-9c37-361fe0b79427	5cf7f9b1-b767-428e-ad81-63e49225b6d2
42	42	0	GBIF France	da44cd31-5901-4687-a106-6d1c7734ee3a	5d7dcfa0-d342-4eb9-8d7c-d708c3702136
0	2	2	Plazi	ffb07bec-2d10-492d-9c37-361fe0b79427	5de42fe9-d0c2-44e9-a115-a15948fb0122
1	1	0	Plazi	ffb07bec-2d10-492d-9c37-361fe0b79427	5e1af224-566a-472e-8ed3-8d1e081a9cd0
124	124	0	Colombian Biodiversity Information System	7e865cba-7c46-417b-ade5-97f2cf5b7be0	6034d065-74c5-4982-8a4f-eb88591fba35
36	36	0	GBIF France	da44cd31-5901-4687-a106-6d1c7734ee3a	631a9894-3fa2-4711-a1f4-eaaab06147cf
6717	6717	0	U.S. Geological Survey	8618c64a-93e0-4300-b546-7249e5148ed2	6346de55-4767-4bc3-a855-1c9e819f3fe9
103	103	0	GBIF Germany	4f6826f2-4ff6-443d-b966-e6913bd24013	63d2c724-f762-11e1-a439-00145eb45e9a
287	287	0	Plazi	ffb07bec-2d10-492d-9c37-361fe0b79427	643c9c14-2378-435b-94cc-ce7640f7d683
2952	2952	0	Biodiversity Information System of Mexico	b324e8e9-9a4c-44fa-8f1a-7f39ea7ab576	649f457a-47db-4b13-a9f3-db127432f0a0
47	47	0	GBIF Germany	4f6826f2-4ff6-443d-b966-e6913bd24013	64ccdb92-f762-11e1-a439-00145eb45e9a
14	12	-2	GBIF Germany	4f6826f2-4ff6-443d-b966-e6913bd24013	65c50434-f762-11e1-a439-00145eb45e9a
219	219	0	GBIF Germany	4f6826f2-4ff6-443d-b966-e6913bd24013	66368de8-f762-11e1-a439-00145eb45e9a
157	157	0	GBIF Germany	4f6826f2-4ff6-443d-b966-e6913bd24013	665f656a-f762-11e1-a439-00145eb45e9a
76	76	0	GBIF Germany	4f6826f2-4ff6-443d-b966-e6913bd24013	66a19fac-f762-11e1-a439-00145eb45e9a
72	72	0	GBIF Germany	4f6826f2-4ff6-443d-b966-e6913bd24013	679d1a62-f762-11e1-a439-00145eb45e9a
63	63	0	GBIF Germany	4f6826f2-4ff6-443d-b966-e6913bd24013	681c099e-f762-11e1-a439-00145eb45e9a
90	90	0	GBIF Germany	4f6826f2-4ff6-443d-b966-e6913bd24013	685993a4-f762-11e1-a439-00145eb45e9a
29	29	0	GBIF Germany	4f6826f2-4ff6-443d-b966-e6913bd24013	68f25c7e-f762-11e1-a439-00145eb45e9a
223	223	0	GBIF France	da44cd31-5901-4687-a106-6d1c7734ee3a	6ace6c92-2437-4923-ada5-94ff0340da0d
18	18	0	GBIF Germany	4f6826f2-4ff6-443d-b966-e6913bd24013	6b27fe0e-f762-11e1-a439-00145eb45e9a
19	19	0	GBIF Germany	4f6826f2-4ff6-443d-b966-e6913bd24013	6c963f76-f762-11e1-a439-00145eb45e9a
17	17	0	Plazi	ffb07bec-2d10-492d-9c37-361fe0b79427	6c9679e9-1c41-4278-a2a5-888faaec913d
44	44	0	GBIF Germany	4f6826f2-4ff6-443d-b966-e6913bd24013	6cc674a2-f762-11e1-a439-00145eb45e9a
184	184	0	GBIF Sweden	a0b3be64-6525-4387-ac67-a499950f92e1	6d26de3e-83ea-4a19-a000-8a4e8ce0c4f4
1	1	0	Plazi	ffb07bec-2d10-492d-9c37-361fe0b79427	6ec72253-14d7-4af4-af52-fbaed1a9fbc7
92	92	0	Plazi	ffb07bec-2d10-492d-9c37-361fe0b79427	6efa7f72-4a8f-4101-aa9f-eab5c40ab01a
3	3	0	Plazi	ffb07bec-2d10-492d-9c37-361fe0b79427	7026b84a-7ea2-48a7-82a2-1a5eaa6c6dca
12	12	0	GBIF Germany	4f6826f2-4ff6-443d-b966-e6913bd24013	7084253a-f762-11e1-a439-00145eb45e9a
444	444	0	GBIF France	da44cd31-5901-4687-a106-6d1c7734ee3a	71fce53d-5098-48ce-9617-9cdf8192003c
5	5	0	GBIF Germany	4f6826f2-4ff6-443d-b966-e6913bd24013	73abded8-f762-11e1-a439-00145eb45e9a
20941	22983	2042	Colombian Biodiversity Information System	7e865cba-7c46-417b-ade5-97f2cf5b7be0	75bcbf8f-5e58-4714-9eba-382129702022
400	400	0	Korean Biodiversity Information Facility	e0a1e772-0177-4800-94b4-2d023fe6cdf4	78a1a6ba-6e0c-4df2-a4cf-e006e04338a7
205	160	-45	GBIF Germany	4f6826f2-4ff6-443d-b966-e6913bd24013	798648ac-f762-11e1-a439-00145eb45e9a
0	1	1	Plazi	ffb07bec-2d10-492d-9c37-361fe0b79427	79c110d8-8c82-4313-b050-5f234f12244d
389	389	0	Ocean Biodiversity Information System	ba0670b9-4186-41e6-8e70-f9cb3065551a	79e731ed-fe9b-4d50-93f7-ab1f01636385
164	74	-90	GBIF Germany	4f6826f2-4ff6-443d-b966-e6913bd24013	7a1306de-f762-11e1-a439-00145eb45e9a
577	577	0	GBIF Spain	1f94b3ca-9345-4d65-afe2-4bace93aa0fe	7a4cfd76-f762-11e1-a439-00145eb45e9a
4	4	0	Plazi	ffb07bec-2d10-492d-9c37-361fe0b79427	7aa61bbd-72a0-45e3-be72-96ef58ecbd08
4778	4778	0	Ocean Biodiversity Information System	ba0670b9-4186-41e6-8e70-f9cb3065551a	7b6a2364-f762-11e1-a439-00145eb45e9a
1769	488	-1281	GBIF Germany	4f6826f2-4ff6-443d-b966-e6913bd24013	7ca9595c-f762-11e1-a439-00145eb45e9a
314	189	-125	GBIF Germany	4f6826f2-4ff6-443d-b966-e6913bd24013	7cf3b5ec-f762-11e1-a439-00145eb45e9a
77	77	0	GBIF Germany	4f6826f2-4ff6-443d-b966-e6913bd24013	7dfd2a18-f762-11e1-a439-00145eb45e9a
161	161	0	GBIF Germany	4f6826f2-4ff6-443d-b966-e6913bd24013	7e0f7f38-f762-11e1-a439-00145eb45e9a
398	398	0	GBIF Germany	4f6826f2-4ff6-443d-b966-e6913bd24013	7e9be4f0-f762-11e1-a439-00145eb45e9a
3067	3067	0	GBIF France	da44cd31-5901-4687-a106-6d1c7734ee3a	7ec77cf4-cc93-4bdc-b7d7-f3a50a4c84ee
29499	46199	16700	GBIF Japan	db5705aa-6a6e-42f1-8942-d77b9f4896ea	80fc4302-f762-11e1-a439-00145eb45e9a
120	140	20	GBIF Japan	db5705aa-6a6e-42f1-8942-d77b9f4896ea	8123fd5c-f762-11e1-a439-00145eb45e9a
26753	26753	0	GBIF Japan	db5705aa-6a6e-42f1-8942-d77b9f4896ea	8129ab94-f762-11e1-a439-00145eb45e9a
1780	1780	0	GBIF Germany	4f6826f2-4ff6-443d-b966-e6913bd24013	81cdf992-f762-11e1-a439-00145eb45e9a
457	457	0	GBIF Germany	4f6826f2-4ff6-443d-b966-e6913bd24013	81d65b97-e1da-473f-90f6-dfb21171cda0
866	866	0	GBIF Germany	4f6826f2-4ff6-443d-b966-e6913bd24013	822093fa-f762-11e1-a439-00145eb45e9a
499	499	0	GBIF France	da44cd31-5901-4687-a106-6d1c7734ee3a	824075e1-b788-4e22-94e5-6a97c9a290b7
1230	738	-492	GBIF Germany	4f6826f2-4ff6-443d-b966-e6913bd24013	8242a350-f762-11e1-a439-00145eb45e9a
2656	2656	0	GBIF Switzerland	169eb292-376b-4cc6-8e31-9c2c432de0ad	82ac3414-f762-11e1-a439-00145eb45e9a
0	7	7	Participant Node Managers Committee	7f48e0c8-5c96-49ec-b972-30748e339115	83fd6a74-0d8a-4534-a742-649b334b7dda
9810	9810	0	Canada Biodiversity Information Facility	8f83fc96-c966-4126-83f7-bf044dc49efa	843f1abc-f762-11e1-a439-00145eb45e9a
557	557	0	DanBIF - Danish Biodiversity Information Facility	4ddd294f-02b7-4359-ac33-0806a9ca9c6b	84c4638e-f762-11e1-a439-00145eb45e9a
16795	17011	216	GBIF Brazil	cdc9736d-5ff7-4ece-9959-3c744360cdb3	86894738-457d-4d25-89ca-d05231a02d46
352	352	0	GBIF Germany	4f6826f2-4ff6-443d-b966-e6913bd24013	87485444-666a-466f-ae36-d56bc3563e0a
39	39	0	Colombian Biodiversity Information System	7e865cba-7c46-417b-ade5-97f2cf5b7be0	8955c0b0-7c3d-419f-9fea-fe985d615208
48	48	0	GBIF Germany	4f6826f2-4ff6-443d-b966-e6913bd24013	8aaf1e7e-f762-11e1-a439-00145eb45e9a
0	632	632	Participant Node Managers Committee	7f48e0c8-5c96-49ec-b972-30748e339115	8bb31819-cdb1-44b1-b3e8-6315e011c3ce
463	463	0	GBIF France	da44cd31-5901-4687-a106-6d1c7734ee3a	8c6aacda-2fd5-48a6-9b27-c673163ce2dd
12	8	-4	GBIF Germany	4f6826f2-4ff6-443d-b966-e6913bd24013	8caa0f5e-f762-11e1-a439-00145eb45e9a
3	3	0	Plazi	ffb07bec-2d10-492d-9c37-361fe0b79427	8cb4c5c9-dca0-44c7-91f3-aa0c35a3d58f
652	472	-180	GBIF Germany	4f6826f2-4ff6-443d-b966-e6913bd24013	8e5104e8-f762-11e1-a439-00145eb45e9a
770	770	0	GBIF Germany	4f6826f2-4ff6-443d-b966-e6913bd24013	8e597873-f2e4-4227-a6a8-442cd658c4f9
17485	17485	0	GBIF Germany	4f6826f2-4ff6-443d-b966-e6913bd24013	8ea44a78-c6af-11e2-9b88-00145eb45e9a
2	2	0	GBIF Germany	4f6826f2-4ff6-443d-b966-e6913bd24013	8eb37132-f762-11e1-a439-00145eb45e9a
16	16	0	GBIF Germany	4f6826f2-4ff6-443d-b966-e6913bd24013	937bb0a3-e9e0-400a-8e07-0b33176953aa
133	133	0	GBIF Germany	4f6826f2-4ff6-443d-b966-e6913bd24013	93e05292-f762-11e1-a439-00145eb45e9a
3513	3513	0	Participant Node Managers Committee	7f48e0c8-5c96-49ec-b972-30748e339115	95a336b6-e4f6-401d-9cbe-a4aef935d82b
661	661	0	GBIF Germany	4f6826f2-4ff6-443d-b966-e6913bd24013	960c633a-f762-11e1-a439-00145eb45e9a
4802	4790	-12	GBIF Germany	4f6826f2-4ff6-443d-b966-e6913bd24013	965a9618-f762-11e1-a439-00145eb45e9a
2	2	0	Plazi	ffb07bec-2d10-492d-9c37-361fe0b79427	9688e558-0af3-44b3-a7fd-d5ac91ce0b61
1	1	0	Plazi	ffb07bec-2d10-492d-9c37-361fe0b79427	9a076b57-ae45-497b-973f-e6c4797ad3b1
0	3827	3827	Ocean Biodiversity Information System	ba0670b9-4186-41e6-8e70-f9cb3065551a	9cbbb821-90e6-4d3a-a849-56054de7704e
1	1	0	Plazi	ffb07bec-2d10-492d-9c37-361fe0b79427	9d94ed6f-3180-4795-bc8c-876f3bb6d857
4988	4988	0	Ocean Biodiversity Information System	ba0670b9-4186-41e6-8e70-f9cb3065551a	a2807e3c-9296-4ede-9ac2-b9a361a46116
337	337	0	GBIF Argentina	2426a871-9feb-40a1-96c6-0c593a76b835	a388c2f4-6653-40d2-96e0-e55c5b0d5fb9
57	57	0	Plazi	ffb07bec-2d10-492d-9c37-361fe0b79427	a5e5d5ad-9d52-48cd-9bf9-ca28a2a7af4b
5364	5364	0	GBIF Germany	4f6826f2-4ff6-443d-b966-e6913bd24013	a65a0ff8-46f0-43e6-bb0c-b0ef1602484a
1759	1759	0	National Biodiversity Network	d897a5b9-35ee-4232-94bd-b0bcaac003c2	a7025d6c-cf48-43e0-a43b-043c47f7f98c
26	26	0	GBIF Germany	4f6826f2-4ff6-443d-b966-e6913bd24013	aa5184cc-8410-406b-afe1-ad801975557e
264348	264348	0	GBIF Germany	4f6826f2-4ff6-443d-b966-e6913bd24013	aa6c5ee6-d4d7-4a65-a04f-379cffbf4842
101	101	0	Plazi	ffb07bec-2d10-492d-9c37-361fe0b79427	ab53b3fe-9bc5-4caf-bcd8-49687171932d
0	282	282	Ocean Biodiversity Information System	ba0670b9-4186-41e6-8e70-f9cb3065551a	ac733410-e54d-4ee8-a151-c0767d1b914f
0	16	16	Plazi	ffb07bec-2d10-492d-9c37-361fe0b79427	ada7e6a4-ac70-4599-b987-f31ccb8ebf8a
23	23	0	Plazi	ffb07bec-2d10-492d-9c37-361fe0b79427	af300c4e-8ffa-42dd-8f0c-f97d12c2e428
178	178	0	Plazi	ffb07bec-2d10-492d-9c37-361fe0b79427	b2090339-f421-4720-9828-db20c45ce634
0	1370	1370	Biodiversity Information System of Mexico	b324e8e9-9a4c-44fa-8f1a-7f39ea7ab576	b2d7468f-ed7b-4895-b0b4-e5828d3c21ef
0	234	234	GBIF Portugal	673f7038-4262-4149-b753-5658a4e912f6	b63b377f-b7c9-450d-bee8-34056169ff25
772	772	0	National Biodiversity Network	d897a5b9-35ee-4232-94bd-b0bcaac003c2	b7691b4d-ddcb-4def-bd01-53fe7319f5d4
171	171	0	Colombian Biodiversity Information System	7e865cba-7c46-417b-ade5-97f2cf5b7be0	bcb37c89-2276-4aea-8e08-9a92a166a8fc
2	2	0	Plazi	ffb07bec-2d10-492d-9c37-361fe0b79427	c16b340a-7325-43ea-9b33-7e0e7e25056f
858	858	0	GBIF France	da44cd31-5901-4687-a106-6d1c7734ee3a	c254e1b7-8702-4359-bfd6-35ad887a98b2
140	140	0	Colombian Biodiversity Information System	7e865cba-7c46-417b-ade5-97f2cf5b7be0	c52b1923-6494-47eb-8061-287351560781
17	17	0	Plazi	ffb07bec-2d10-492d-9c37-361fe0b79427	c5dc11ef-779c-4575-ab09-67f40ecb5aee
3088	3088	0	GBIF New Zealand	4f9fd726-20dd-445e-89a1-8ed93792276f	c7c1cc3c-7f15-493d-8501-e64b9ad3df6d
17	17	0	Colombian Biodiversity Information System	7e865cba-7c46-417b-ade5-97f2cf5b7be0	c8b9a9f4-447f-4e0d-b0a0-fe0d09373cb8
0	4	4	Plazi	ffb07bec-2d10-492d-9c37-361fe0b79427	c964dd72-1666-4310-b7fc-e320dad70d1e
0	424	424	Colombian Biodiversity Information System	7e865cba-7c46-417b-ade5-97f2cf5b7be0	ca4cc20d-4461-4028-bd84-9ed85f62ecb1
12510	12510	0	GBIF Spain	1f94b3ca-9345-4d65-afe2-4bace93aa0fe	cc326faf-0b27-47a8-b9f4-17b7c9c13f00
951	951	0	National Biodiversity Network	d897a5b9-35ee-4232-94bd-b0bcaac003c2	ce514255-8231-4a94-af94-f2793034b3ee
0	11	11	Plazi	ffb07bec-2d10-492d-9c37-361fe0b79427	cf139a31-bcd0-4bed-b887-67bd8f9b7f12
0	4	4	Plazi	ffb07bec-2d10-492d-9c37-361fe0b79427	cfc7ee81-1d59-48be-9568-08af71afda09
0	4	4	Plazi	ffb07bec-2d10-492d-9c37-361fe0b79427	d2532ee2-2ebf-4390-9fcb-24e7f36dbf56
636	636	0	Biodiversity Information System of Mexico	b324e8e9-9a4c-44fa-8f1a-7f39ea7ab576	d5513e5a-a470-4eaa-bff3-c41ff26f102a
73	73	0	Atlas of Living Australia	4a6f1b71-969e-4fc5-a693-282b05e1220c	d7d8cce3-a4f3-4f64-9871-dd7283c85f91
181	181	0	Colombian Biodiversity Information System	7e865cba-7c46-417b-ade5-97f2cf5b7be0	d955ca78-2292-462e-91e2-680b332028b3
1966	1966	0	GBIF Portugal	673f7038-4262-4149-b753-5658a4e912f6	da3542b4-9a73-4054-b9a3-2d762e172199
1	1	0	Plazi	ffb07bec-2d10-492d-9c37-361fe0b79427	db5835c1-6f4a-449f-9852-a6393aada934
0	166	166	Ocean Biodiversity Information System	ba0670b9-4186-41e6-8e70-f9cb3065551a	dbb2579d-9f3e-453e-9acd-94d3418e0b0b
10137	10137	0	GBIF Chile	a8b16421-d80b-4ef3-8f22-098b01a89255	dc0ac5b3-f7f6-49ef-82ab-80b79eace946
43	43	0	Plazi	ffb07bec-2d10-492d-9c37-361fe0b79427	dc267496-af01-4588-a2f2-d107e8cf0f50
0	234	234	Ocean Biodiversity Information System	ba0670b9-4186-41e6-8e70-f9cb3065551a	dc556ee4-6b76-4294-9577-9ea6e8d63e8d
7	7	0	Plazi	ffb07bec-2d10-492d-9c37-361fe0b79427	dd032848-7430-45d0-85d9-e528f25c83bb
154	154	0	Plazi	ffb07bec-2d10-492d-9c37-361fe0b79427	dd8ef826-0c0f-4261-b127-1d1afa7f5601
2	2	0	Plazi	ffb07bec-2d10-492d-9c37-361fe0b79427	e0d43c28-8479-4705-b5fa-aaeb64a48390
8	8	0	Plazi	ffb07bec-2d10-492d-9c37-361fe0b79427	e192e57f-a7cb-4620-9aa3-ec699df4da5c
43423	44173	750	GBIF Brazil	cdc9736d-5ff7-4ece-9959-3c744360cdb3	e257fa65-598c-4f11-b03e-dfeba1191db8
7	7	0	Plazi	ffb07bec-2d10-492d-9c37-361fe0b79427	e32f0a2e-0156-4758-bb80-18dc544f1c04
30	30	0	Plazi	ffb07bec-2d10-492d-9c37-361fe0b79427	e7e981cf-0238-4fec-9d4d-f03a5ae449ea
24218	24218	0	U.S. Geological Survey	8618c64a-93e0-4300-b546-7249e5148ed2	eba1cb5d-eafe-4828-99c4-e9f53f14d7bc
77	77	0	Colombian Biodiversity Information System	7e865cba-7c46-417b-ade5-97f2cf5b7be0	f090e47d-7e22-4b83-abae-293786ee320d
392	392	0	Colombian Biodiversity Information System	7e865cba-7c46-417b-ade5-97f2cf5b7be0	f191d3a7-56b2-495f-b204-38dc761b5ee9
31153	31153	0	GBIF France	da44cd31-5901-4687-a106-6d1c7734ee3a	f34bfbe6-4027-447e-a1c2-e1686bab02e3
0	22	22	Plazi	ffb07bec-2d10-492d-9c37-361fe0b79427	f4c55cc5-fb40-4343-833d-db7f91e0d93b
23	23	0	Plazi	ffb07bec-2d10-492d-9c37-361fe0b79427	f5fa598b-e158-40cf-b475-4d1177d95149
2691	2691	0	U.S. Geological Survey	8618c64a-93e0-4300-b546-7249e5148ed2	f7a30683-8156-49b1-b31e-d4e3be017d61
180	180	0	Colombian Biodiversity Information System	7e865cba-7c46-417b-ade5-97f2cf5b7be0	fb0d92ea-7119-467f-abfc-ac6fc099d3b9
130	72	-58	GBIF Germany	4f6826f2-4ff6-443d-b966-e6913bd24013	fb5cbfcf-921b-4c00-ba2d-fd6349f9941f
249	249	0	Colombian Biodiversity Information System	7e865cba-7c46-417b-ade5-97f2cf5b7be0	027c10bb-9fab-4236-982f-224d0f749c49
1	1	0	Plazi	ffb07bec-2d10-492d-9c37-361fe0b79427	0436e7e3-cd42-420d-a6e9-6b69afb0a911
0	44047	44047	Canada Biodiversity Information Facility	8f83fc96-c966-4126-83f7-bf044dc49efa	06f9f3fa-ef86-478d-9286-be020c6bd73b
2494	2494	0	Costa Rica Biodiversity Facility	3379bb09-1a58-41e7-9c57-e3b66c3eb5a0	0d8f0f47-5df4-49a8-ae94-03ae253659bf
360	360	0	GBIF Germany	4f6826f2-4ff6-443d-b966-e6913bd24013	0e639515-0d4c-46f7-928c-99dd17371e4b
1995	1995	0	GBIF Japan	db5705aa-6a6e-42f1-8942-d77b9f4896ea	0f8ef13d-dc6f-4f56-9815-313818910e9c
112	112	0	GBIF France	da44cd31-5901-4687-a106-6d1c7734ee3a	18dc2732-45c3-47ec-9755-a781b7c9963e
5	5	0	Plazi	ffb07bec-2d10-492d-9c37-361fe0b79427	1992cccd-42a0-4b5e-bb36-9379caed1400
8	8	0	Plazi	ffb07bec-2d10-492d-9c37-361fe0b79427	1bad4e53-fbe6-4037-9f7b-dd82ca165daf
0	85	85	Plazi	ffb07bec-2d10-492d-9c37-361fe0b79427	20141273-3452-4388-b6a8-aab9193c87fe
149	33	-116	GBIF Germany	4f6826f2-4ff6-443d-b966-e6913bd24013	20b7c193-dcd2-42e6-a39c-3be2a5586045
0	1	1	Plazi	ffb07bec-2d10-492d-9c37-361fe0b79427	21b53556-1fc6-4c97-bb5f-6eb6f1ca0027
0	1	1	Plazi	ffb07bec-2d10-492d-9c37-361fe0b79427	234d3553-9ac6-47aa-b2c0-8ef2f8248d19
205	205	0	GBIF France	da44cd31-5901-4687-a106-6d1c7734ee3a	249791f0-eb16-40ec-830d-68506a611578
187	187	0	U.S. Geological Survey	8618c64a-93e0-4300-b546-7249e5148ed2	25685aee-445d-4e82-94c8-815ee2169644
593	593	0	Ocean Biodiversity Information System	ba0670b9-4186-41e6-8e70-f9cb3065551a	25e11899-c0d8-490a-b1fa-f158086b92c3
84	84	0	Colombian Biodiversity Information System	7e865cba-7c46-417b-ade5-97f2cf5b7be0	2b5aab57-4660-40d8-b3a3-149ff3353044
1944	1944	0	Participant Node Managers Committee	7f48e0c8-5c96-49ec-b972-30748e339115	2baad33a-e52e-4789-95ad-b288607673f8
16	16	0	Plazi	ffb07bec-2d10-492d-9c37-361fe0b79427	2c5526b8-5a26-4fd7-b823-8d2f6362d687
0	60	60	Plazi	ffb07bec-2d10-492d-9c37-361fe0b79427	2d8f0338-4a38-4806-916d-1ee20d4d3f58
5	5	0	Plazi	ffb07bec-2d10-492d-9c37-361fe0b79427	3040fda0-dbae-4374-ab6f-943bafce7daa
23	23	0	National Biodiversity Network	d897a5b9-35ee-4232-94bd-b0bcaac003c2	308a4067-4c08-4562-82fb-d2ef91c1c05e
1604	1604	0	National Biodiversity Network	d897a5b9-35ee-4232-94bd-b0bcaac003c2	32852cc7-eaec-4b28-a6f0-2008044e754f
12	12	0	Plazi	ffb07bec-2d10-492d-9c37-361fe0b79427	339bdf2d-40c3-4c58-aa5d-a4d8c27c4b46
140	140	0	GBIF Niger	dc9041d6-a5ae-4217-92ea-f7674794d760	34585f24-1ffe-4744-8734-7d563c918d18
0	6	6	Plazi	ffb07bec-2d10-492d-9c37-361fe0b79427	34a03d1b-f67e-41da-885f-349a4cfff881
4	4	0	Plazi	ffb07bec-2d10-492d-9c37-361fe0b79427	35d94d8a-8367-4e0f-8746-9d22bea27b0e
202	202	0	National Biodiversity Network	d897a5b9-35ee-4232-94bd-b0bcaac003c2	3a042642-8151-4ed9-871b-72062df75838
0	10	10	GBIF Spain	1f94b3ca-9345-4d65-afe2-4bace93aa0fe	3d6f3c64-d0c8-4bf9-a765-5c22d73e34a1
330	330	0	Plazi	ffb07bec-2d10-492d-9c37-361fe0b79427	3da0d889-944e-465a-8a94-c6fde5cda633
78482	78482	0	U.S. Geological Survey	8618c64a-93e0-4300-b546-7249e5148ed2	3ee66eb3-4786-4bda-b7f1-c145b1a57a6b
124	94	-30	GBIF Germany	4f6826f2-4ff6-443d-b966-e6913bd24013	42473b81-1679-4420-bd5a-e5323356c80d
0	1	1	Plazi	ffb07bec-2d10-492d-9c37-361fe0b79427	435c0dd9-5087-41e3-8aa3-1ee4a57f3e17
11	11	0	Plazi	ffb07bec-2d10-492d-9c37-361fe0b79427	43a886b0-89af-4040-9d32-476bf25c6e2a
221	221	0	Plazi	ffb07bec-2d10-492d-9c37-361fe0b79427	43c18a9c-5545-4f3d-b285-956094e43d43
41	41	0	Plazi	ffb07bec-2d10-492d-9c37-361fe0b79427	43d91420-2629-40e4-98d0-4ff6c6416067
3	3	0	Plazi	ffb07bec-2d10-492d-9c37-361fe0b79427	4482510f-7eea-4403-b013-687607a6cae1
11	11	0	Plazi	ffb07bec-2d10-492d-9c37-361fe0b79427	44b12099-59c0-4c00-b34c-c4f14d37ec56
21	21	0	Plazi	ffb07bec-2d10-492d-9c37-361fe0b79427	463347b1-46f3-443b-856f-3a12e91292d5
0	188	188	Plazi	ffb07bec-2d10-492d-9c37-361fe0b79427	46a4213a-dc51-40d0-95a3-b816c3e9fe51
8	8	0	Plazi	ffb07bec-2d10-492d-9c37-361fe0b79427	47e59b7a-9bf2-4a9f-97d1-ac890d24961c
186	186	0	GBIF Germany	4f6826f2-4ff6-443d-b966-e6913bd24013	4ad5e1bd-553d-4b3b-bcbc-06d10942bfe1
14	14	0	Plazi	ffb07bec-2d10-492d-9c37-361fe0b79427	4f2bb6f9-3fd9-43dd-b1ae-bbb529dbb481
12	12	0	Plazi	ffb07bec-2d10-492d-9c37-361fe0b79427	50051180-a420-4306-9f97-5d6194c5ac52
4	4	0	Plazi	ffb07bec-2d10-492d-9c37-361fe0b79427	509ff7cf-3199-412b-8d01-198cb6371322
93506	93506	0	GBIF France	da44cd31-5901-4687-a106-6d1c7734ee3a	54facf62-bf0c-43e7-9972-4fdc407fa6c5
6	6	0	Plazi	ffb07bec-2d10-492d-9c37-361fe0b79427	5557b2c6-99ea-4be4-bcfa-eb014aaa8932
0	9	9	Plazi	ffb07bec-2d10-492d-9c37-361fe0b79427	55890bbd-92d4-488c-a5ef-4b867d092f5a
4	4	0	Plazi	ffb07bec-2d10-492d-9c37-361fe0b79427	55b3c7a5-ae21-47dc-8b4d-1049bf3f6617
2	2	0	Plazi	ffb07bec-2d10-492d-9c37-361fe0b79427	563f68d5-7547-4bf1-8a3d-d37418a6b0ce
59	59	0	Plazi	ffb07bec-2d10-492d-9c37-361fe0b79427	57ad8c16-9b8a-4fbc-a739-ae2286ac28d0
0	1896	1896	Ocean Biodiversity Information System	ba0670b9-4186-41e6-8e70-f9cb3065551a	57cbea0b-0bf4-4bc3-b3c7-c25a9caa5ef0
0	4	4	Plazi	ffb07bec-2d10-492d-9c37-361fe0b79427	582fe5b8-d9a7-4b8c-b100-44f4b0d96dde
0	2	2	Plazi	ffb07bec-2d10-492d-9c37-361fe0b79427	589f0424-cc14-4d94-b247-74d81c674af9
0	965	965	GBIF Japan	db5705aa-6a6e-42f1-8942-d77b9f4896ea	5948bc78-1581-42fe-8b40-1f757bd5ad03
0	25	25	Plazi	ffb07bec-2d10-492d-9c37-361fe0b79427	5ac8576a-048a-4e78-b435-bd33de4c6554
555992	555992	0	Korean Biodiversity Information Facility	e0a1e772-0177-4800-94b4-2d023fe6cdf4	5c2a93e4-4578-496c-9b61-edb9d72e8cbc
229	229	0	Participant Node Managers Committee	7f48e0c8-5c96-49ec-b972-30748e339115	5cfac570-94dc-458e-b846-c17b1f5dd837
337	337	0	Plazi	ffb07bec-2d10-492d-9c37-361fe0b79427	5e1d0e63-c052-42fa-ba84-55f2166bfefd
9	9	0	Plazi	ffb07bec-2d10-492d-9c37-361fe0b79427	609e1f9a-16f8-4821-b45b-55ea3f1b8e78
915	915	0	GBIF Spain	1f94b3ca-9345-4d65-afe2-4bace93aa0fe	61b3f445-1684-42be-b918-a9b5d279419e
0	2	2	Plazi	ffb07bec-2d10-492d-9c37-361fe0b79427	636a1bab-b848-454e-86f6-c0bc1857dd03
139	139	0	GBIF Germany	4f6826f2-4ff6-443d-b966-e6913bd24013	63a0ea60-f762-11e1-a439-00145eb45e9a
937	937	0	GBIF Spain	1f94b3ca-9345-4d65-afe2-4bace93aa0fe	63d05c2c-44b9-4190-abc0-4fa66a8d083d
15	15	0	Plazi	ffb07bec-2d10-492d-9c37-361fe0b79427	63f92f6b-7b95-4615-92b2-00f712d5d3f2
364	364	0	GBIF Germany	4f6826f2-4ff6-443d-b966-e6913bd24013	654bcbf0-f762-11e1-a439-00145eb45e9a
387	387	0	GBIF Germany	4f6826f2-4ff6-443d-b966-e6913bd24013	65615c4a-f762-11e1-a439-00145eb45e9a
134	89	-45	GBIF Germany	4f6826f2-4ff6-443d-b966-e6913bd24013	6600de14-f762-11e1-a439-00145eb45e9a
52	52	0	GBIF Germany	4f6826f2-4ff6-443d-b966-e6913bd24013	673ff634-f762-11e1-a439-00145eb45e9a
36	36	0	GBIF Germany	4f6826f2-4ff6-443d-b966-e6913bd24013	6831894a-f762-11e1-a439-00145eb45e9a
34	34	0	GBIF Germany	4f6826f2-4ff6-443d-b966-e6913bd24013	69c66ca8-f762-11e1-a439-00145eb45e9a
16	16	0	GBIF Germany	4f6826f2-4ff6-443d-b966-e6913bd24013	6afc1dfc-f762-11e1-a439-00145eb45e9a
16	16	0	GBIF Germany	4f6826f2-4ff6-443d-b966-e6913bd24013	708b5f08-f762-11e1-a439-00145eb45e9a
163	163	0	GBIF Germany	4f6826f2-4ff6-443d-b966-e6913bd24013	7233ceee-f762-11e1-a439-00145eb45e9a
4347	4347	0	Colombian Biodiversity Information System	7e865cba-7c46-417b-ade5-97f2cf5b7be0	7329dbf2-8c75-41be-a3a0-0cd0a368eb26
65	65	0	GBIF Germany	4f6826f2-4ff6-443d-b966-e6913bd24013	7343124a-f762-11e1-a439-00145eb45e9a
3396	3396	0	National Biodiversity Network	d897a5b9-35ee-4232-94bd-b0bcaac003c2	73c3ce16-26a7-4b91-ab5b-590a6ade5b22
0	2	2	Plazi	ffb07bec-2d10-492d-9c37-361fe0b79427	766e2d75-af43-43f7-a679-8c5969acb49f
18412	19105	693	GBIF Brazil	cdc9736d-5ff7-4ece-9959-3c744360cdb3	767bddaa-9e6a-4eb1-bd12-f94a2b39a7d6
33	33	0	GBIF Germany	4f6826f2-4ff6-443d-b966-e6913bd24013	7866f75a-f762-11e1-a439-00145eb45e9a
4	4	0	GBIF Germany	4f6826f2-4ff6-443d-b966-e6913bd24013	7885f81c-f762-11e1-a439-00145eb45e9a
1211	843	-368	GBIF Germany	4f6826f2-4ff6-443d-b966-e6913bd24013	7956e904-f762-11e1-a439-00145eb45e9a
8551	8551	0	Korean Biodiversity Information Facility	e0a1e772-0177-4800-94b4-2d023fe6cdf4	7b2c60ba-f762-11e1-a439-00145eb45e9a
2385	2385	0	GBIF Germany	4f6826f2-4ff6-443d-b966-e6913bd24013	7cd4427a-f762-11e1-a439-00145eb45e9a
226	216	-10	GBIF Germany	4f6826f2-4ff6-443d-b966-e6913bd24013	7cdd60bc-f762-11e1-a439-00145eb45e9a
1115	1115	0	Atlas of Living Australia	4a6f1b71-969e-4fc5-a693-282b05e1220c	7cede6e3-c7f9-401d-9226-c9ce34a73f7d
100	40	-60	GBIF Germany	4f6826f2-4ff6-443d-b966-e6913bd24013	7d10a15c-f762-11e1-a439-00145eb45e9a
136	136	0	GBIF Germany	4f6826f2-4ff6-443d-b966-e6913bd24013	7d1c63d4-f762-11e1-a439-00145eb45e9a
1506	1451	-55	GBIF Germany	4f6826f2-4ff6-443d-b966-e6913bd24013	7dd12404-f762-11e1-a439-00145eb45e9a
264	264	0	GBIF Germany	4f6826f2-4ff6-443d-b966-e6913bd24013	7e9a4f64-1387-11e2-bb2e-00145eb45e9a
4896	4896	0	GBIF Germany	4f6826f2-4ff6-443d-b966-e6913bd24013	7f1b9e34-f762-11e1-a439-00145eb45e9a
45	45	0	GBIF France	da44cd31-5901-4687-a106-6d1c7734ee3a	7f5ed718-d5f9-448f-8261-db9e2c82e729
1957	1957	0	Biodiversity Information System of Mexico	b324e8e9-9a4c-44fa-8f1a-7f39ea7ab576	7f7c9f2c-f762-11e1-a439-00145eb45e9a
162	162	0	Biodiversity Information System of Mexico	b324e8e9-9a4c-44fa-8f1a-7f39ea7ab576	801a0276-f762-11e1-a439-00145eb45e9a
1	1	0	Plazi	ffb07bec-2d10-492d-9c37-361fe0b79427	805b8914-9e3e-417e-9a56-41f2c776c2db
1297	1297	0	Biodiversity Information System of Mexico	b324e8e9-9a4c-44fa-8f1a-7f39ea7ab576	806eb816-f762-11e1-a439-00145eb45e9a
0	15113	15113	Ocean Biodiversity Information System	ba0670b9-4186-41e6-8e70-f9cb3065551a	807a28cf-7dd6-4a99-8dad-06c07d22d824
1	1	0	Plazi	ffb07bec-2d10-492d-9c37-361fe0b79427	80d102d3-ab38-4035-9e03-f5f04022aa5a
151128	151005	-123	National Biodiversity Network	d897a5b9-35ee-4232-94bd-b0bcaac003c2	80df9ab6-fb28-422c-8b86-e92cf9bfdbf7
1709	1709	0	GBIF Germany	4f6826f2-4ff6-443d-b966-e6913bd24013	818152ea-f762-11e1-a439-00145eb45e9a
0	10195	10195	U.S. Geological Survey	8618c64a-93e0-4300-b546-7249e5148ed2	829598f1-ef80-4731-85b2-006b10bc0208
2	2	0	Plazi	ffb07bec-2d10-492d-9c37-361fe0b79427	82cc6dea-1dfa-4401-a03d-4fa9f24c904c
4071	4071	0	GBIF Spain	1f94b3ca-9345-4d65-afe2-4bace93aa0fe	8347f6ba-f762-11e1-a439-00145eb45e9a
3437	3437	0	Ocean Biodiversity Information System	ba0670b9-4186-41e6-8e70-f9cb3065551a	83a65020-f762-11e1-a439-00145eb45e9a
6351	6351	0	Ocean Biodiversity Information System	ba0670b9-4186-41e6-8e70-f9cb3065551a	83a7950c-f762-11e1-a439-00145eb45e9a
1308	1308	0	National Biodiversity Network	d897a5b9-35ee-4232-94bd-b0bcaac003c2	83cff6ec-743a-4dee-92de-71a3f0dd3d14
19614	19614	0	U.S. Geological Survey	8618c64a-93e0-4300-b546-7249e5148ed2	8411c274-49e8-4871-8ddd-9244ab7ae5d2
3	3	0	Plazi	ffb07bec-2d10-492d-9c37-361fe0b79427	847bdbc0-1d3a-4c4b-b4db-b72c57f29048
30000	30000	0	GBIF Japan	db5705aa-6a6e-42f1-8942-d77b9f4896ea	84a5a08e-f762-11e1-a439-00145eb45e9a
15	15	0	Plazi	ffb07bec-2d10-492d-9c37-361fe0b79427	857eb594-755e-493e-a705-602b5d46e686
3703	3703	0	DanBIF - Danish Biodiversity Information Facility	4ddd294f-02b7-4359-ac33-0806a9ca9c6b	85f26058-f762-11e1-a439-00145eb45e9a
15	15	0	Plazi	ffb07bec-2d10-492d-9c37-361fe0b79427	86d4ed88-8e65-4a5d-82d0-c9407e597b22
0	95	95	Plazi	ffb07bec-2d10-492d-9c37-361fe0b79427	88310031-a45c-46f3-b273-2216c818ac22
1472	1472	0	GBIF Benin	efb9c00e-f802-45dd-8826-a52ec45b89ff	8918ab8e-2534-4a3f-8469-67407dd166c8
360	144	-216	GBIF Germany	4f6826f2-4ff6-443d-b966-e6913bd24013	89522fee-f762-11e1-a439-00145eb45e9a
186	186	0	GBIF Germany	4f6826f2-4ff6-443d-b966-e6913bd24013	8a294452-f762-11e1-a439-00145eb45e9a
7	7	0	Plazi	ffb07bec-2d10-492d-9c37-361fe0b79427	8a99d3a6-9a47-4a5a-92b3-69941914cb39
71	71	0	GBIF Germany	4f6826f2-4ff6-443d-b966-e6913bd24013	8b98888e-f762-11e1-a439-00145eb45e9a
3	3	0	GBIF Germany	4f6826f2-4ff6-443d-b966-e6913bd24013	8c3e549e-f762-11e1-a439-00145eb45e9a
38	38	0	Plazi	ffb07bec-2d10-492d-9c37-361fe0b79427	8c967763-8311-48fa-bb8f-71deb22f4f75
8	8	0	GBIF Germany	4f6826f2-4ff6-443d-b966-e6913bd24013	8cac9bfc-f762-11e1-a439-00145eb45e9a
2	2	0	Plazi	ffb07bec-2d10-492d-9c37-361fe0b79427	8e11b0e4-e2b1-4d1f-9790-ddbe3d307575
525	525	0	GBIF Germany	4f6826f2-4ff6-443d-b966-e6913bd24013	8e81b76f-b768-49f4-8595-484472dde3bf
148	82	-66	GBIF Germany	4f6826f2-4ff6-443d-b966-e6913bd24013	8f24e6b4-f762-11e1-a439-00145eb45e9a
31	16	-15	GBIF Germany	4f6826f2-4ff6-443d-b966-e6913bd24013	90515022-f762-11e1-a439-00145eb45e9a
531	314	-217	GBIF Germany	4f6826f2-4ff6-443d-b966-e6913bd24013	90827350-f762-11e1-a439-00145eb45e9a
230	131	-99	GBIF Germany	4f6826f2-4ff6-443d-b966-e6913bd24013	90a6e6fe-f762-11e1-a439-00145eb45e9a
266	208	-58	GBIF Germany	4f6826f2-4ff6-443d-b966-e6913bd24013	90b91a4a-f762-11e1-a439-00145eb45e9a
7	4	-3	GBIF Germany	4f6826f2-4ff6-443d-b966-e6913bd24013	910515bc-f762-11e1-a439-00145eb45e9a
131	110	-21	GBIF Germany	4f6826f2-4ff6-443d-b966-e6913bd24013	9124849c-f762-11e1-a439-00145eb45e9a
23	10	-13	GBIF Germany	4f6826f2-4ff6-443d-b966-e6913bd24013	91934dd2-f762-11e1-a439-00145eb45e9a
5	5	0	Plazi	ffb07bec-2d10-492d-9c37-361fe0b79427	920b149c-2aaf-4183-82c3-f5332800112b
550	550	0	GBIF Germany	4f6826f2-4ff6-443d-b966-e6913bd24013	93b6bec8-f762-11e1-a439-00145eb45e9a
926	806	-120	GBIF Germany	4f6826f2-4ff6-443d-b966-e6913bd24013	9532b964-f762-11e1-a439-00145eb45e9a
154	143	-11	GBIF Germany	4f6826f2-4ff6-443d-b966-e6913bd24013	95415cb2-f762-11e1-a439-00145eb45e9a
22	22	0	GBIF Germany	4f6826f2-4ff6-443d-b966-e6913bd24013	95a92a86-f762-11e1-a439-00145eb45e9a
88	88	0	GBIF Germany	4f6826f2-4ff6-443d-b966-e6913bd24013	95c11286-f762-11e1-a439-00145eb45e9a
23	23	0	GBIF Germany	4f6826f2-4ff6-443d-b966-e6913bd24013	97712814-f762-11e1-a439-00145eb45e9a
661	661	0	GBIF Germany	4f6826f2-4ff6-443d-b966-e6913bd24013	97cf5eac-f762-11e1-a439-00145eb45e9a
818	818	0	Colombian Biodiversity Information System	7e865cba-7c46-417b-ade5-97f2cf5b7be0	98c40e55-0e09-4945-b592-0279aa227d50
2	2	0	Plazi	ffb07bec-2d10-492d-9c37-361fe0b79427	99633158-7202-4399-a2cf-5bd190d00da7
1934	1934	0	GBIF Uganda	71b40829-6a12-4c3d-8fee-5746f5e9cf8c	9abcea65-4186-41f9-9337-1f2638bccb23
0	3	3	Plazi	ffb07bec-2d10-492d-9c37-361fe0b79427	9b0cb44e-2615-4514-9817-230f33f690aa
14402	14402	0	GBIF France	da44cd31-5901-4687-a106-6d1c7734ee3a	9d1a3db7-b8a8-4936-9159-4548a7d9e535
38	38	0	Plazi	ffb07bec-2d10-492d-9c37-361fe0b79427	9f723faa-02cb-4344-ac09-279b8a23311f
0	2	2	Plazi	ffb07bec-2d10-492d-9c37-361fe0b79427	a0081f79-1eca-45d8-a9d2-82d57f201d26
29	29	0	Colombian Biodiversity Information System	7e865cba-7c46-417b-ade5-97f2cf5b7be0	a41bc26a-c639-4988-acaa-2d463aac94cc
0	131	131	Colombian Biodiversity Information System	7e865cba-7c46-417b-ade5-97f2cf5b7be0	a46f7cde-7f0e-4161-892d-a57be217ade5
0	8072	8072	Ocean Biodiversity Information System	ba0670b9-4186-41e6-8e70-f9cb3065551a	a4b94a2c-3f36-4010-82af-0de2e98aa584
153	153	0	GBIF Germany	4f6826f2-4ff6-443d-b966-e6913bd24013	a6ae0be9-b8d0-4ca7-a581-2616cba886f7
0	8	8	Plazi	ffb07bec-2d10-492d-9c37-361fe0b79427	a6ee038f-4cda-4f38-8fde-8ad0efec8f0f
58	58	0	Colombian Biodiversity Information System	7e865cba-7c46-417b-ade5-97f2cf5b7be0	a983b1f1-296c-4d97-8504-69a6e969ac03
161	161	0	GBIF Sweden	a0b3be64-6525-4387-ac67-a499950f92e1	ac5a2801-784a-43d5-8a14-c2b34bc46973
1	1	0	GBIF Germany	4f6826f2-4ff6-443d-b966-e6913bd24013	ac84f53b-04d8-416f-b595-493368a0cea2
124	124	0	GBIF France	da44cd31-5901-4687-a106-6d1c7734ee3a	acc39f75-be19-48e7-898b-ede53573982a
759	759	0	GBIF France	da44cd31-5901-4687-a106-6d1c7734ee3a	aea0759f-ce10-4ac5-bd6f-f3411b0a1806
0	19	19	Plazi	ffb07bec-2d10-492d-9c37-361fe0b79427	afc31c44-0e11-4da3-a5ad-59dbc47cf5ff
0	12	12	Plazi	ffb07bec-2d10-492d-9c37-361fe0b79427	b1fca0fe-4044-4293-bc35-4a316bd84b17
3	3	0	Plazi	ffb07bec-2d10-492d-9c37-361fe0b79427	b7f0299d-7cbb-4cc3-8ad0-4eb9846a6bd8
836971	836971	0	U.S. Geological Survey	8618c64a-93e0-4300-b546-7249e5148ed2	b929f23d-290f-4e85-8f17-764c55b3b284
0	10	10	Ocean Biodiversity Information System	ba0670b9-4186-41e6-8e70-f9cb3065551a	b983a203-35d0-4c28-b2d9-208312155e7f
0	4	4	Plazi	ffb07bec-2d10-492d-9c37-361fe0b79427	be5233d5-98c2-44f3-bea4-bc9fa14ae4f3
65	65	0	Plazi	ffb07bec-2d10-492d-9c37-361fe0b79427	c34b41a3-b71c-4a98-b3ee-2bfd2caec6af
11	11	0	GBIF France	da44cd31-5901-4687-a106-6d1c7734ee3a	c5164a74-c322-4395-b06e-8d8815ac17fe
466	466	0	National Biodiversity Network	d897a5b9-35ee-4232-94bd-b0bcaac003c2	c53de484-96ca-4e08-860f-f3f9b7c9897a
921	921	0	GBIF Spain	1f94b3ca-9345-4d65-afe2-4bace93aa0fe	c67decad-0b17-4383-9f12-1a87f6a6a6ca
22172	22172	0	Ocean Biodiversity Information System	ba0670b9-4186-41e6-8e70-f9cb3065551a	c6bb9397-f67f-4ecd-a85a-a27debe6ce3c
0	2	2	Plazi	ffb07bec-2d10-492d-9c37-361fe0b79427	c8f33f7e-400c-496a-8d7f-bab0fa74e875
111	111	0	GBIF France	da44cd31-5901-4687-a106-6d1c7734ee3a	c9defb60-fe06-4833-8bb6-29c89ed46dfe
0	5	5	Plazi	ffb07bec-2d10-492d-9c37-361fe0b79427	cadac5b6-f94f-4a2c-bf21-9e41c1f153fc
2	2	0	Plazi	ffb07bec-2d10-492d-9c37-361fe0b79427	cb1d9bad-e5a4-420e-8a64-beebd4325b7b
292	292	0	Biodiversity Information System of Mexico	b324e8e9-9a4c-44fa-8f1a-7f39ea7ab576	cea8cd4e-ac8b-4e81-9242-6a5bf9e41e4d
2	2	0	Plazi	ffb07bec-2d10-492d-9c37-361fe0b79427	d44ee1a2-f7cf-49d9-a496-19c07c7aaf9a
343	343	0	National Biodiversity Network	d897a5b9-35ee-4232-94bd-b0bcaac003c2	d490f264-f563-4140-90da-13632cf30eb1
0	9	9	Plazi	ffb07bec-2d10-492d-9c37-361fe0b79427	d5c131c2-4099-449f-9a1c-d6931c371ec4
1	1	0	Plazi	ffb07bec-2d10-492d-9c37-361fe0b79427	dcfa8eba-6c43-4f9b-ab56-80c7ebda8574
12938	12938	0	National Biodiversity Network	d897a5b9-35ee-4232-94bd-b0bcaac003c2	df780901-d0d4-45b0-978b-849c51f63917
7191	9827	2636	Belgian Biodiversity Platform	fb11cfe1-ebc3-45af-9159-17d9fddbcdac	e0bbc7b4-c22e-42b7-8c0c-2deb26495948
0	1806	1806	Ocean Biodiversity Information System	ba0670b9-4186-41e6-8e70-f9cb3065551a	e0da2d53-86f0-440c-a11a-42ffb0b3fd3e
0	164	164	Ocean Biodiversity Information System	ba0670b9-4186-41e6-8e70-f9cb3065551a	e11c8712-9b86-4767-8ebf-ffe0e0789d06
6	6	0	Plazi	ffb07bec-2d10-492d-9c37-361fe0b79427	e11cb68f-db0b-4742-ba25-f4a87cdd5ca0
0	66640	66640	GBIF Switzerland	169eb292-376b-4cc6-8e31-9c2c432de0ad	e232367a-6346-4069-9830-f1bcbd67631a
263	263	0	GBIF Finland	dd514216-5c7c-45f3-910d-797424cb5be6	e263aa94-fc9f-4c36-bbf9-4e1864046ccd
0	1	1	Plazi	ffb07bec-2d10-492d-9c37-361fe0b79427	e30b6d36-d2e2-467f-906e-5997790671c7
3	3	0	Plazi	ffb07bec-2d10-492d-9c37-361fe0b79427	e8fc0124-d913-472d-b352-57341ad57f22
22862	22862	0	National Biodiversity Network	d897a5b9-35ee-4232-94bd-b0bcaac003c2	e994ebdd-317b-4116-9884-80a9d285b2a0
22	22	0	National Biodiversity Network	d897a5b9-35ee-4232-94bd-b0bcaac003c2	ebb8109a-a28c-4a07-9827-e689e1b4e807
25	25	0	Plazi	ffb07bec-2d10-492d-9c37-361fe0b79427	efc997e8-29bf-4b9d-8dc8-488626b30627
251	251	0	GBIF Brazil	cdc9736d-5ff7-4ece-9959-3c744360cdb3	f05e070e-f907-46af-9660-d8fc0a5aa910
0	2	2	Plazi	ffb07bec-2d10-492d-9c37-361fe0b79427	f07030ad-a1a7-4d3b-b5c7-21351abc0bbe
61	61	0	Polish Biodiversity Information Network	2618bfdf-e194-4911-a241-80db3107bc51	f1d79850-2fe8-11de-816f-b8a03c50a862
6948	6948	0	GBIF Sweden	a0b3be64-6525-4387-ac67-a499950f92e1	f2ec825d-145a-42fd-9bfe-a411a557bc47
0	38	38	Plazi	ffb07bec-2d10-492d-9c37-361fe0b79427	f3553bae-f738-4e65-b8d2-93f256496627
6	6	0	Plazi	ffb07bec-2d10-492d-9c37-361fe0b79427	f6928bb5-c27d-4e12-a291-8ba360222421
0	57	57	Ocean Biodiversity Information System	ba0670b9-4186-41e6-8e70-f9cb3065551a	fca29e62-2331-4860-abf8-8615d8328d52
0	1	1	Plazi	ffb07bec-2d10-492d-9c37-361fe0b79427	fcacce7b-005a-4976-9926-825ebce5d8be
1	1	0	Plazi	ffb07bec-2d10-492d-9c37-361fe0b79427	feb4164b-2c9c-4da6-acb3-326e2a5a34f2
0	41	41	Plazi	ffb07bec-2d10-492d-9c37-361fe0b79427	00e9b517-5cef-4913-af3b-6ade0bcb64e8
5	5	0	Plazi	ffb07bec-2d10-492d-9c37-361fe0b79427	0250df4b-a235-414e-8de5-99d013c3b1d8
0	7	7	Plazi	ffb07bec-2d10-492d-9c37-361fe0b79427	02ff2350-38f1-4647-a359-7a3018f78be7
762	762	0	GBIF France	da44cd31-5901-4687-a106-6d1c7734ee3a	0375fd40-83ee-439a-8ad9-62375d769ac9
79	79	0	Plazi	ffb07bec-2d10-492d-9c37-361fe0b79427	04b01108-9416-4dde-b316-fba307321016
11	11	0	Plazi	ffb07bec-2d10-492d-9c37-361fe0b79427	05b7c0ec-be2d-47ae-840b-6851e33c9058
0	1	1	Plazi	ffb07bec-2d10-492d-9c37-361fe0b79427	06bad515-ea43-452d-befa-d053712dd162
1	1	0	Plazi	ffb07bec-2d10-492d-9c37-361fe0b79427	08f63677-9afc-43ef-8d7b-acf3fc60e2e8
69	69	0	Plazi	ffb07bec-2d10-492d-9c37-361fe0b79427	0935deaf-8f18-434e-b4a0-0468cefc9577
2	2	0	Plazi	ffb07bec-2d10-492d-9c37-361fe0b79427	094bf6e3-dd74-4120-ad81-3aa8a6aa629c
289	289	0	Participant Node Managers Committee	7f48e0c8-5c96-49ec-b972-30748e339115	098045a1-9b72-42e9-91bd-3dbd2d90ede3
25486	25486	0	National Biodiversity Network	d897a5b9-35ee-4232-94bd-b0bcaac003c2	0af8fdeb-6bbd-463e-ae5d-aa13790f896f
15637	15637	0	U.S. Geological Survey	8618c64a-93e0-4300-b546-7249e5148ed2	1050a336-b87a-44b1-b0ec-6fe5fcb3d298
0	4	4	Plazi	ffb07bec-2d10-492d-9c37-361fe0b79427	19293790-5c5c-4ac2-a245-8fd435604725
25	25	0	South African Biodiversity Information Facility	7190b835-4e86-4b6e-85c1-19cc6677c250	19e4e6dd-1800-4c2d-af34-ebc30879c65a
1	1	0	GBIF France	da44cd31-5901-4687-a106-6d1c7734ee3a	1b7051d1-15ca-4951-88d6-48156985375e
0	1672	1672	U.S. Geological Survey	8618c64a-93e0-4300-b546-7249e5148ed2	1b81302b-b935-4493-8ff8-9a47797d68c1
0	10	10	Plazi	ffb07bec-2d10-492d-9c37-361fe0b79427	1c49c7bb-1919-4316-8191-357b02f2d98b
5	5	0	Participant Node Managers Committee	7f48e0c8-5c96-49ec-b972-30748e339115	1cd83cb3-6c34-4edc-af16-449daa5602a7
293164	293164	0	National Biodiversity Network	d897a5b9-35ee-4232-94bd-b0bcaac003c2	20b968fd-b7e0-4002-9136-1ccfa8e5b9df
22	22	0	GBIF France	da44cd31-5901-4687-a106-6d1c7734ee3a	22493e2b-ec30-45c2-8ae9-5d7ff7199928
320	320	0	GBIF Portugal	673f7038-4262-4149-b753-5658a4e912f6	22c0c715-b2a8-4c01-9719-13f79be07fdc
2	2	0	Plazi	ffb07bec-2d10-492d-9c37-361fe0b79427	2331879a-c67d-437d-8464-6cdd66765b57
0	117402	117402	GBIF Estonia	2c11b821-d22b-4c64-8cd3-c1578173b129	24fd68c4-d4ac-4a39-8e8b-3af9dae81db4
2576	2576	0	Polish Biodiversity Information Network	2618bfdf-e194-4911-a241-80db3107bc51	28913bf0-adee-11db-ad75-b8a03c50a862
126	126	0	Plazi	ffb07bec-2d10-492d-9c37-361fe0b79427	2b60af66-f747-47b2-8e43-2eb333131a4b
137	137	0	Colombian Biodiversity Information System	7e865cba-7c46-417b-ade5-97f2cf5b7be0	2d036cfc-514a-42f7-9e50-acb5eda23dd6
4	4	0	Plazi	ffb07bec-2d10-492d-9c37-361fe0b79427	2d3447fa-32a5-4db7-8e8c-0a6310a4fbc7
432	433	1	GBIF Norway	4f829580-180d-46a9-9c87-ed8ec959b545	2e71efb1-78c9-4475-9056-96beeaf9ca42
5	5	0	Plazi	ffb07bec-2d10-492d-9c37-361fe0b79427	34031c5e-d6b9-46c0-b2eb-1e4cd0edb935
62	62	0	GBIF France	da44cd31-5901-4687-a106-6d1c7734ee3a	36afb3b5-e683-44f5-b640-7f8f3f32d854
1	1	0	Plazi	ffb07bec-2d10-492d-9c37-361fe0b79427	39256adf-7987-46d7-ab43-998df5970e5c
0	4	4	Plazi	ffb07bec-2d10-492d-9c37-361fe0b79427	39c452ba-0698-4ccc-bb26-d68e0e970abe
34	34	0	Plazi	ffb07bec-2d10-492d-9c37-361fe0b79427	3b3ee0c1-182b-441f-983d-b0d815db6174
526	526	0	Colombian Biodiversity Information System	7e865cba-7c46-417b-ade5-97f2cf5b7be0	41e8af41-4a59-48b0-900e-c658d1cdc898
1470	1470	0	GBIF Sweden	a0b3be64-6525-4387-ac67-a499950f92e1	43607f5f-3404-40bf-b812-1cabf3c66f2c
115	115	0	GBIF France	da44cd31-5901-4687-a106-6d1c7734ee3a	43d42772-ee9f-4527-8602-22e0e638b171
6	6	0	Plazi	ffb07bec-2d10-492d-9c37-361fe0b79427	450d8a4d-1879-4d5f-b29b-0b5e6914baf6
0	7	7	Plazi	ffb07bec-2d10-492d-9c37-361fe0b79427	47fb68b4-6fa6-4898-a9a7-adbb9fe77c42
2	2	0	Plazi	ffb07bec-2d10-492d-9c37-361fe0b79427	4a3616f3-c7cc-426c-8b63-2dac26ccca08
0	6	6	Plazi	ffb07bec-2d10-492d-9c37-361fe0b79427	4c6980ee-d053-4d48-a8e3-9d9cd34d2a40
21135	21135	0	GBIF France	da44cd31-5901-4687-a106-6d1c7734ee3a	4cb11f8e-7132-43e9-a52c-dad325938326
16	16	0	Atlas of Living Australia	4a6f1b71-969e-4fc5-a693-282b05e1220c	4e9aecfe-6aa6-467b-a874-a6a0d89242a6
8542	8542	0	GBIF France	da44cd31-5901-4687-a106-6d1c7734ee3a	4f19d152-735f-4286-9c6d-650404dbd18c
0	9	9	Plazi	ffb07bec-2d10-492d-9c37-361fe0b79427	4f9affc2-8bc8-470d-b079-0f6342eb8256
28079	28079	0	GBIF Argentina	2426a871-9feb-40a1-96c6-0c593a76b835	512c11b0-a103-11de-88ae-b8a03c50a862
14172	14172	0	GBIF Japan	db5705aa-6a6e-42f1-8942-d77b9f4896ea	5349d319-972f-47ad-b90c-6ec8a995d69d
49	49	0	Plazi	ffb07bec-2d10-492d-9c37-361fe0b79427	55f6b110-0a37-45fe-be1c-34e9a035fe0e
13	13	0	GBIF France	da44cd31-5901-4687-a106-6d1c7734ee3a	57134608-85ba-43ea-8c4f-c1e978b73a92
0	88	88	Ocean Biodiversity Information System	ba0670b9-4186-41e6-8e70-f9cb3065551a	5af68f8f-689b-4c4f-bdfd-75f060a2111b
0	16	16	Plazi	ffb07bec-2d10-492d-9c37-361fe0b79427	5b9fe588-f25a-4e76-b901-7e30047688c1
0	248	248	Plazi	ffb07bec-2d10-492d-9c37-361fe0b79427	5dc17a27-e095-4dc8-b10d-09fc935dbf45
534	534	0	GBIF Brazil	cdc9736d-5ff7-4ece-9959-3c744360cdb3	5f8eeafe-fa02-4e89-9027-d0922d611cca
99	99	0	GBIF Germany	4f6826f2-4ff6-443d-b966-e6913bd24013	63c3d1c4-f762-11e1-a439-00145eb45e9a
75	75	0	GBIF Germany	4f6826f2-4ff6-443d-b966-e6913bd24013	64681220-f762-11e1-a439-00145eb45e9a
96	96	0	GBIF Germany	4f6826f2-4ff6-443d-b966-e6913bd24013	67eec4e8-f762-11e1-a439-00145eb45e9a
11	11	0	GBIF Germany	4f6826f2-4ff6-443d-b966-e6913bd24013	69304b74-f762-11e1-a439-00145eb45e9a
103	103	0	GBIF Germany	4f6826f2-4ff6-443d-b966-e6913bd24013	69caed5a-f762-11e1-a439-00145eb45e9a
131	87	-44	GBIF Germany	4f6826f2-4ff6-443d-b966-e6913bd24013	69ec689a-f762-11e1-a439-00145eb45e9a
892	892	0	GBIF Germany	4f6826f2-4ff6-443d-b966-e6913bd24013	6a28ccae-f762-11e1-a439-00145eb45e9a
18	18	0	GBIF Germany	4f6826f2-4ff6-443d-b966-e6913bd24013	6b36ed06-f762-11e1-a439-00145eb45e9a
18	18	0	GBIF Germany	4f6826f2-4ff6-443d-b966-e6913bd24013	6b383a80-f762-11e1-a439-00145eb45e9a
18	18	0	GBIF Germany	4f6826f2-4ff6-443d-b966-e6913bd24013	6b8b7e34-f762-11e1-a439-00145eb45e9a
9	9	0	Plazi	ffb07bec-2d10-492d-9c37-361fe0b79427	6bf97383-b199-4676-96bd-49d292d4bde7
191	191	0	GBIF Germany	4f6826f2-4ff6-443d-b966-e6913bd24013	6d2474ee-f762-11e1-a439-00145eb45e9a
42919	57847	14928	National Biodiversity Network	d897a5b9-35ee-4232-94bd-b0bcaac003c2	6ec0db76-23c5-44b5-80f8-ad7e2aa17773
15975	15975	0	GBIF France	da44cd31-5901-4687-a106-6d1c7734ee3a	6f6f97bf-b985-43ee-8be1-cd3c0666665f
7	7	0	GBIF Germany	4f6826f2-4ff6-443d-b966-e6913bd24013	6fb40972-f762-11e1-a439-00145eb45e9a
1375	1375	0	Colombian Biodiversity Information System	7e865cba-7c46-417b-ade5-97f2cf5b7be0	6fea96d6-e47f-4cd5-abcd-08235a8e26d7
128	128	0	GBIF Germany	4f6826f2-4ff6-443d-b966-e6913bd24013	70a7dd4a-f762-11e1-a439-00145eb45e9a
11	11	0	Plazi	ffb07bec-2d10-492d-9c37-361fe0b79427	70c2eb92-9f75-4d4a-bc6c-dc81e0313d21
48	38	-10	GBIF Germany	4f6826f2-4ff6-443d-b966-e6913bd24013	70c732e4-f762-11e1-a439-00145eb45e9a
15	15	0	GBIF Germany	4f6826f2-4ff6-443d-b966-e6913bd24013	7115de08-f762-11e1-a439-00145eb45e9a
392	141	-251	GBIF Germany	4f6826f2-4ff6-443d-b966-e6913bd24013	742192ce-be9c-4434-8b48-d46223353797
27	27	0	GBIF Germany	4f6826f2-4ff6-443d-b966-e6913bd24013	7423b250-f762-11e1-a439-00145eb45e9a
8	8	0	Plazi	ffb07bec-2d10-492d-9c37-361fe0b79427	743e2d77-a1e9-4ae7-972f-dc271fb264ef
46	46	0	GBIF Germany	4f6826f2-4ff6-443d-b966-e6913bd24013	7466243c-f762-11e1-a439-00145eb45e9a
23	23	0	Plazi	ffb07bec-2d10-492d-9c37-361fe0b79427	74df8806-5fa5-40e3-87c4-c89409cb76ed
1288	1232	-56	GBIF Germany	4f6826f2-4ff6-443d-b966-e6913bd24013	76ae815e-9cf3-4307-b3e2-670829f9a6ce
143	143	0	Atlas of Living Australia	4a6f1b71-969e-4fc5-a693-282b05e1220c	784c0a48-dbf9-41b6-a5ed-06f69cc12491
6	6	0	GBIF Germany	4f6826f2-4ff6-443d-b966-e6913bd24013	78dbb892-f762-11e1-a439-00145eb45e9a
812	812	0	GBIF Togo	c9659a3e-07e9-4fcb-83c6-de8b9009a02e	7aac92e4-1c11-4eca-97cb-5ef587de8239
2190	1460	-730	GBIF Germany	4f6826f2-4ff6-443d-b966-e6913bd24013	7bc6ca74-f762-11e1-a439-00145eb45e9a
4757549	4818461	60912	U.S. Geological Survey	8618c64a-93e0-4300-b546-7249e5148ed2	7bd65a7a-f762-11e1-a439-00145eb45e9a
30	30	0	GBIF Germany	4f6826f2-4ff6-443d-b966-e6913bd24013	7e02551a-f762-11e1-a439-00145eb45e9a
875	875	0	GBIF Germany	4f6826f2-4ff6-443d-b966-e6913bd24013	7e8d62f4-f762-11e1-a439-00145eb45e9a
661	661	0	Biodiversity Information System of Mexico	b324e8e9-9a4c-44fa-8f1a-7f39ea7ab576	80ac6ada-f762-11e1-a439-00145eb45e9a
600	600	0	GBIF Germany	4f6826f2-4ff6-443d-b966-e6913bd24013	8169c8aa-f762-11e1-a439-00145eb45e9a
17	17	0	GBIF Germany	4f6826f2-4ff6-443d-b966-e6913bd24013	82549c68-f762-11e1-a439-00145eb45e9a
3021	3021	0	Polish Biodiversity Information Network	2618bfdf-e194-4911-a241-80db3107bc51	833ff136-f762-11e1-a439-00145eb45e9a
1	1	0	Plazi	ffb07bec-2d10-492d-9c37-361fe0b79427	83ffcc85-572b-4157-9cee-953c6bd08319
200187	200187	0	GBIF Austria	1e789bc9-79fc-4e60-a49e-89dfc45a7188	8642bfd0-f762-11e1-a439-00145eb45e9a
15830	18102	2272	GBIF Japan	db5705aa-6a6e-42f1-8942-d77b9f4896ea	8699eba2-f762-11e1-a439-00145eb45e9a
15647	15647	0	GBIF Spain	1f94b3ca-9345-4d65-afe2-4bace93aa0fe	86ba1954-f762-11e1-a439-00145eb45e9a
1	1	0	Plazi	ffb07bec-2d10-492d-9c37-361fe0b79427	88bca5aa-d612-4ca7-9c2b-a6eb82b280e6
39621	40835	1214	GBIF France	da44cd31-5901-4687-a106-6d1c7734ee3a	89064e3a-aa3c-495d-b236-092e1dae7042
2	2	0	Plazi	ffb07bec-2d10-492d-9c37-361fe0b79427	89366f6b-ef01-463e-959d-215ea384e239
1	1	0	Plazi	ffb07bec-2d10-492d-9c37-361fe0b79427	8959291b-1a7f-4c4c-8282-f9cf6f5bf8bb
49	49	0	GBIF Germany	4f6826f2-4ff6-443d-b966-e6913bd24013	8a08801e-f762-11e1-a439-00145eb45e9a
8611	8611	0	National Biodiversity Network	d897a5b9-35ee-4232-94bd-b0bcaac003c2	8a3edfa1-5a1f-42bb-a32e-95d459d3b773
10	10	0	GBIF Germany	4f6826f2-4ff6-443d-b966-e6913bd24013	8c1dce22-f762-11e1-a439-00145eb45e9a
10	10	0	Plazi	ffb07bec-2d10-492d-9c37-361fe0b79427	8d356426-0167-447a-90c5-3aee9657b2f1
1	1	0	GBIF Germany	4f6826f2-4ff6-443d-b966-e6913bd24013	8ddc5864-f762-11e1-a439-00145eb45e9a
0	7234	7234	Colombian Biodiversity Information System	7e865cba-7c46-417b-ade5-97f2cf5b7be0	8df7c102-b5d0-47b0-afbc-4ab3c86672f2
46	19	-27	GBIF Germany	4f6826f2-4ff6-443d-b966-e6913bd24013	8e09a058-f762-11e1-a439-00145eb45e9a
194	125	-69	GBIF Germany	4f6826f2-4ff6-443d-b966-e6913bd24013	8e5fcb40-f762-11e1-a439-00145eb45e9a
164	133	-31	GBIF Germany	4f6826f2-4ff6-443d-b966-e6913bd24013	8eb7e76c-f762-11e1-a439-00145eb45e9a
94	99	5	Plazi	ffb07bec-2d10-492d-9c37-361fe0b79427	8fba1b0e-71a1-4c1c-b88e-45e99282bce0
6592	6592	0	Biodiversity Information System of Mexico	b324e8e9-9a4c-44fa-8f1a-7f39ea7ab576	914831e7-a602-46a1-9c2c-0932cdcfff3a
139	71	-68	GBIF Germany	4f6826f2-4ff6-443d-b966-e6913bd24013	91c578d4-f762-11e1-a439-00145eb45e9a
111	111	0	GBIF Germany	4f6826f2-4ff6-443d-b966-e6913bd24013	921422b8-f762-11e1-a439-00145eb45e9a
15	15	0	GBIF Germany	4f6826f2-4ff6-443d-b966-e6913bd24013	923d1d4e-f762-11e1-a439-00145eb45e9a
860	860	0	GBIF France	da44cd31-5901-4687-a106-6d1c7734ee3a	92be5730-6b1c-464d-b29b-8845a5b06538
160	160	0	GBIF France	da44cd31-5901-4687-a106-6d1c7734ee3a	92e820d9-f387-4f8b-82ea-66c3b77fb1ab
13	13	0	GBIF Germany	4f6826f2-4ff6-443d-b966-e6913bd24013	93a52b36-f762-11e1-a439-00145eb45e9a
880	880	0	GBIF Germany	4f6826f2-4ff6-443d-b966-e6913bd24013	942688ac-f762-11e1-a439-00145eb45e9a
22	22	0	GBIF Germany	4f6826f2-4ff6-443d-b966-e6913bd24013	94463490-f762-11e1-a439-00145eb45e9a
0	91	91	Ocean Biodiversity Information System	ba0670b9-4186-41e6-8e70-f9cb3065551a	9abfb9ef-0ede-4e3f-984a-a012f7be5a68
1	1	0	Plazi	ffb07bec-2d10-492d-9c37-361fe0b79427	9dacac86-2808-44ec-b5df-4fd030e3810b
1	1	0	Plazi	ffb07bec-2d10-492d-9c37-361fe0b79427	9ebe3063-1237-493c-90b6-804d0ceb1ad9
50	50	0	Plazi	ffb07bec-2d10-492d-9c37-361fe0b79427	9efd778b-cdfc-4c82-905d-58f49a9bb01d
118	118	0	GBIF Germany	4f6826f2-4ff6-443d-b966-e6913bd24013	9fa737a7-cd58-4c4b-ba36-ca5205455935
233	233	0	National Biodiversity Network	d897a5b9-35ee-4232-94bd-b0bcaac003c2	a05f9c00-c402-45a1-8991-bac981ab3ee2
189	189	0	GBIF France	da44cd31-5901-4687-a106-6d1c7734ee3a	a73eb5ae-2c35-4628-8e08-29f5ed15a099
92	92	0	GBIF Germany	4f6826f2-4ff6-443d-b966-e6913bd24013	a86dd8e2-1b74-41fa-b0bf-be4a5608c8b5
26789	26789	0	U.S. Geological Survey	8618c64a-93e0-4300-b546-7249e5148ed2	a8ee9bc6-5914-427d-9fba-f8545250ac34
123	123	0	National Biodiversity Network	d897a5b9-35ee-4232-94bd-b0bcaac003c2	a91f9cf3-6455-4847-9144-b9f5e29d3fe3
1148	1148	0	GBIF Malawi	2a42e4d7-ad4a-41b3-84c4-de4aa7b74d35	ac772abb-fa13-4bd2-8222-c8e7875e260e
0	9767	9767	National Biodiversity Network	d897a5b9-35ee-4232-94bd-b0bcaac003c2	af31d100-66b7-4918-80d0-53e7b57fe2b8
225	225	0	Colombian Biodiversity Information System	7e865cba-7c46-417b-ade5-97f2cf5b7be0	afdf4877-5e44-432e-9111-1a160a6a6df4
1305	1305	0	GBIF Germany	4f6826f2-4ff6-443d-b966-e6913bd24013	aff137ec-e96b-4b94-a8f5-554b7623cec3
0	24104	24104	Belgian Biodiversity Platform	fb11cfe1-ebc3-45af-9159-17d9fddbcdac	b18ab2ec-1838-40db-b3b2-631a8dcabf61
15918	16527	609	U.S. Geological Survey	8618c64a-93e0-4300-b546-7249e5148ed2	b2d55172-8980-4195-9632-a186edb27d5a
0	5	5	Plazi	ffb07bec-2d10-492d-9c37-361fe0b79427	b3486c45-e123-4b7d-afee-65822823c86f
0	2	2	Plazi	ffb07bec-2d10-492d-9c37-361fe0b79427	b38dbf20-cf87-4698-8928-701b3e7591d8
9	9	0	Plazi	ffb07bec-2d10-492d-9c37-361fe0b79427	b6db5980-7fa7-4269-b2ab-dee4a4c756fd
17	17	0	GBIF Madagascar	2dbfc5c5-51b5-4494-9dfc-4d3f013a3b64	b7879846-b952-48c3-bbab-d72dff0ac95d
2714	2714	0	GBIF France	da44cd31-5901-4687-a106-6d1c7734ee3a	b7f9bf35-2f33-4e3d-8732-fd4146d1dc0c
0	56	56	Plazi	ffb07bec-2d10-492d-9c37-361fe0b79427	ba67c0cc-a0e8-4137-b1be-b9007fcd05fe
1	1	0	Plazi	ffb07bec-2d10-492d-9c37-361fe0b79427	bb32c806-d3c0-46a4-9f44-b4c451ca6b56
3	3	0	Plazi	ffb07bec-2d10-492d-9c37-361fe0b79427	bc36d368-aac7-41a6-b241-52ea6fa64978
3389	3389	0	Colombian Biodiversity Information System	7e865cba-7c46-417b-ade5-97f2cf5b7be0	bdb3951b-1b8a-446d-8820-22ce0a2ea380
155	155	0	Society for the Management of Electronic Biodiversity Data	97818ee4-1461-4180-bf1d-b3201050124f	c05b97bc-e172-40e9-9d42-9df0f93a6e65
254	254	0	GBIF Germany	4f6826f2-4ff6-443d-b966-e6913bd24013	c1c18b0b-cd6c-4546-97fa-0d6c60a527fa
4	4	0	Plazi	ffb07bec-2d10-492d-9c37-361fe0b79427	c704c5d3-8ef6-48b6-a346-efe5b5e1c032
1724	1724	0	South African Biodiversity Information Facility	7190b835-4e86-4b6e-85c1-19cc6677c250	c8323cbb-26b1-4c87-bc89-9bfb1efe9a56
0	2	2	Participant Node Managers Committee	7f48e0c8-5c96-49ec-b972-30748e339115	cbec9e62-2bde-441c-967a-0ef6516832ee
176	124	-52	GBIF Germany	4f6826f2-4ff6-443d-b966-e6913bd24013	cdf3166a-6db5-45d3-8eaf-e3b13cd439bc
3272	3272	0	GBIF France	da44cd31-5901-4687-a106-6d1c7734ee3a	d0e7eba3-d939-4a68-a13d-66c17dafeedb
32	32	0	Plazi	ffb07bec-2d10-492d-9c37-361fe0b79427	d14c2f38-fbe4-4363-a6c3-83a0145bf389
3546	3546	0	Biodiversity Information System of Mexico	b324e8e9-9a4c-44fa-8f1a-7f39ea7ab576	d3725a3d-5a5e-4cca-b95b-866905b1ae04
0	60	60	Ocean Biodiversity Information System	ba0670b9-4186-41e6-8e70-f9cb3065551a	d48850ad-3f90-434f-b105-09584cd147db
260	260	0	Colombian Biodiversity Information System	7e865cba-7c46-417b-ade5-97f2cf5b7be0	d5bf8f78-2285-402e-a2c8-b1bbba1599fd
379	379	0	GBIF France	da44cd31-5901-4687-a106-6d1c7734ee3a	dc2d2c19-92b8-485d-802d-f7c8f1d2055f
0	299	299	Colombian Biodiversity Information System	7e865cba-7c46-417b-ade5-97f2cf5b7be0	e0c3d402-1c00-440a-9a4e-a58576354bc8
1	1	0	Plazi	ffb07bec-2d10-492d-9c37-361fe0b79427	e3687527-fca8-41e5-98d3-082e62dba904
191642	192590	948	U.S. Geological Survey	8618c64a-93e0-4300-b546-7249e5148ed2	e3b959d6-fcbe-4a28-a166-e4a807c340a0
17	17	0	Plazi	ffb07bec-2d10-492d-9c37-361fe0b79427	e3bd629a-61b2-4a04-b881-6d140b27632d
2695	2695	0	Biodiversity Information System of Mexico	b324e8e9-9a4c-44fa-8f1a-7f39ea7ab576	e95df14f-f7e2-48f2-8053-101f208ad8eb
76	76	0	Plazi	ffb07bec-2d10-492d-9c37-361fe0b79427	e9c19fd6-7804-4c57-b6dc-5cad9863e3d3
27	27	0	Plazi	ffb07bec-2d10-492d-9c37-361fe0b79427	ef329ae9-a539-4f51-9a40-815300b0aeb4
69	69	0	GBIF France	da44cd31-5901-4687-a106-6d1c7734ee3a	f1254d00-734a-42c0-a5cb-550e1ca26594
1	1	0	Plazi	ffb07bec-2d10-492d-9c37-361fe0b79427	f15a5672-5af2-4a5a-9a1e-cf9254bf8d89
0	6535	6535	Ocean Biodiversity Information System	ba0670b9-4186-41e6-8e70-f9cb3065551a	f30db7c2-5f7b-449d-a508-34b701e95c43
4	4	0	Plazi	ffb07bec-2d10-492d-9c37-361fe0b79427	f53bfc43-739c-4108-9aef-2b1ea8dfb042
1904	1904	0	National Biodiversity Network	d897a5b9-35ee-4232-94bd-b0bcaac003c2	f7fe989b-4f4e-4ad5-832b-5c09d654ec67
1639	1639	0	Nordic Genetic Resource Centre	fa6bdac4-51e2-4334-940c-ba6cdf6e1257	f875121b-07ae-4b44-a928-9fb793874d54
92	92	0	Plazi	ffb07bec-2d10-492d-9c37-361fe0b79427	fc27a97b-c482-4829-8d12-b19cb4e83e26
4	4	0	Plazi	ffb07bec-2d10-492d-9c37-361fe0b79427	fd03f669-c046-46cd-861a-6bf56b7fc989
161	161	0	GBIF Portugal	673f7038-4262-4149-b753-5658a4e912f6	fe2c3e56-d4e6-4a3f-a56d-b1e349d48b94
388	388	0	GBIF Brazil	cdc9736d-5ff7-4ece-9959-3c744360cdb3	fe7657bc-aa54-4b5d-b084-f5c91275ad62
0	32	32	Plazi	ffb07bec-2d10-492d-9c37-361fe0b79427	00f4ae66-2696-4a36-be77-6de24695dcab
17	17	0	Plazi	ffb07bec-2d10-492d-9c37-361fe0b79427	0120379d-90da-491f-aab3-00b5812711c0
1440	1440	0	National Biodiversity Network	d897a5b9-35ee-4232-94bd-b0bcaac003c2	022fa98c-0b7b-401f-9aa3-57f2273429ef
1	1	0	Plazi	ffb07bec-2d10-492d-9c37-361fe0b79427	038432ac-12c2-4e26-ba94-e5da796df109
1	1	0	Plazi	ffb07bec-2d10-492d-9c37-361fe0b79427	092c1085-8fb8-43ba-898d-48c4f574752f
799	799	0	Colombian Biodiversity Information System	7e865cba-7c46-417b-ade5-97f2cf5b7be0	0a8ca827-8c09-429e-b558-803ec6045d94
0	37455	37455	BioCASE	d8bbf693-a180-4995-94fe-6130795dcf2f	0b0735e0-624d-4abb-abba-91a2733adea4
2091	2091	0	Participant Node Managers Committee	7f48e0c8-5c96-49ec-b972-30748e339115	0c922703-de01-498b-84b5-b05cf4cfdc18
0	5	5	Ocean Biodiversity Information System	ba0670b9-4186-41e6-8e70-f9cb3065551a	0d0e631e-27f3-4e26-a0b1-94138b01c95b
1565	1565	0	GBIF France	da44cd31-5901-4687-a106-6d1c7734ee3a	0de64ae5-5306-4d16-b55f-0f56146150a6
4343	4343	0	Scientific Committee on Antarctic Research	51e4e8ff-bff0-4996-8b27-9107d61b3478	0e8b0e10-1680-4d71-ae93-f61bd7933b1d
0	8	8	Plazi	ffb07bec-2d10-492d-9c37-361fe0b79427	10698d51-cee9-4ea4-afbf-c1a0746b9044
102	102	0	GBIF France	da44cd31-5901-4687-a106-6d1c7734ee3a	1689f35f-8c9b-41be-a903-12210c5d57db
62	62	0	Plazi	ffb07bec-2d10-492d-9c37-361fe0b79427	18949fd5-8f09-44ea-8dfa-c04ba71bcc7b
282	282	0	GBIF Benin	efb9c00e-f802-45dd-8826-a52ec45b89ff	1ab75437-0cac-402a-981b-9e5db8fafa74
0	1311	1311	Colombian Biodiversity Information System	7e865cba-7c46-417b-ade5-97f2cf5b7be0	1ada0f0e-457c-4018-a8bb-98f3f4bb08b0
366	366	0	GBIF France	da44cd31-5901-4687-a106-6d1c7734ee3a	1b686aa8-b52b-4c2f-a397-093b8a8233fa
5	5	0	GBIF Portugal	673f7038-4262-4149-b753-5658a4e912f6	22f83f75-3b92-4db6-a86e-8dac512c4e65
261	261	0	Colombian Biodiversity Information System	7e865cba-7c46-417b-ade5-97f2cf5b7be0	25ead144-6df3-4803-b770-a77128746de6
24430	24430	0	GBIF Portugal	673f7038-4262-4149-b753-5658a4e912f6	273d1a81-32e8-4453-9e22-6b78ed0c0ebd
304	304	0	Ocean Biodiversity Information System	ba0670b9-4186-41e6-8e70-f9cb3065551a	27448b7d-f4c5-4ccf-9ffc-31c91bf42cec
0	107	107	Ocean Biodiversity Information System	ba0670b9-4186-41e6-8e70-f9cb3065551a	2759182f-c13a-4b88-947b-370da3c53081
76	76	0	Ocean Biodiversity Information System	ba0670b9-4186-41e6-8e70-f9cb3065551a	278dd85c-cf15-4a44-932d-2c0ee6e3230d
1	1	0	Plazi	ffb07bec-2d10-492d-9c37-361fe0b79427	2dd78289-9a8e-4f20-8c87-1e572a2bf051
20692	20692	0	National Biodiversity Network	d897a5b9-35ee-4232-94bd-b0bcaac003c2	306ac83b-8b15-40e0-8937-65f5ad39f83f
0	10	10	Plazi	ffb07bec-2d10-492d-9c37-361fe0b79427	330478a0-c5ed-4e65-a8ec-1551d9beb64f
4	4	0	Plazi	ffb07bec-2d10-492d-9c37-361fe0b79427	337ced60-ab9e-424f-b83f-f439d0ef8068
7207	7207	0	National Biodiversity Network	d897a5b9-35ee-4232-94bd-b0bcaac003c2	340984fa-507b-4aa6-b59c-cce1dcee339f
24	24	0	Plazi	ffb07bec-2d10-492d-9c37-361fe0b79427	35a1e1dd-0f99-4c5d-8a1f-54363af967be
2983	2983	0	Netherlands Biodiversity Information Facility	0909d601-bda2-42df-9e63-a6d51847ebce	39b07c5d-caa9-4118-b803-290d667cdd5e
540	540	0	Participant Node Managers Committee	7f48e0c8-5c96-49ec-b972-30748e339115	3a8a3458-675f-46f1-abbc-6e089059e5e8
8	8	0	Plazi	ffb07bec-2d10-492d-9c37-361fe0b79427	3c6ad9b9-cc65-40f2-9acd-4de6c87a3b7d
410	410	0	GBIF France	da44cd31-5901-4687-a106-6d1c7734ee3a	3ccb35b5-ef36-49c4-8e77-92984dc5a920
155	155	0	GBIF France	da44cd31-5901-4687-a106-6d1c7734ee3a	3ccc0c07-bdc9-4bbf-8beb-f4457b4eb665
0	9	9	Plazi	ffb07bec-2d10-492d-9c37-361fe0b79427	3f24224e-3ff9-474c-a138-adb332383ac3
0	2	2	Plazi	ffb07bec-2d10-492d-9c37-361fe0b79427	4182158c-65e6-426b-9c03-921e2d014ed6
0	23	23	Plazi	ffb07bec-2d10-492d-9c37-361fe0b79427	444d361b-db3d-4043-89d3-a216cf8d586a
18924	18918	-6	GBIF Japan	db5705aa-6a6e-42f1-8942-d77b9f4896ea	44e8b95a-1850-4507-8fa0-a3a07f5dd936
2	2	0	Plazi	ffb07bec-2d10-492d-9c37-361fe0b79427	44f5fd61-db26-4111-8598-52365b9f7c78
175	175	0	Plazi	ffb07bec-2d10-492d-9c37-361fe0b79427	4603132a-4e96-4119-bf2f-21ffe40dce69
0	2	2	Plazi	ffb07bec-2d10-492d-9c37-361fe0b79427	4acef3a8-bf94-40a1-b9d4-8432b07579be
26	26	0	Plazi	ffb07bec-2d10-492d-9c37-361fe0b79427	4af6e86c-b098-42b4-8a81-09d734b0a599
217	217	0	GBIF France	da44cd31-5901-4687-a106-6d1c7734ee3a	4dce1bb0-9425-4e21-b6ec-27d62c63a025
0	141	141	GBIF France	da44cd31-5901-4687-a106-6d1c7734ee3a	4e916dc3-010f-4e23-bbe2-50e04f38b7fc
1764	1764	0	GBIF Germany	4f6826f2-4ff6-443d-b966-e6913bd24013	506a9ea7-083c-4b4f-8b09-3ecd9a9b79a7
9	9	0	Plazi	ffb07bec-2d10-492d-9c37-361fe0b79427	52b151bb-14a5-48f0-80ae-256066b38b98
95	95	0	Colombian Biodiversity Information System	7e865cba-7c46-417b-ade5-97f2cf5b7be0	56c48715-9f8b-445a-98b7-cada12902027
0	1	1	Plazi	ffb07bec-2d10-492d-9c37-361fe0b79427	57dc65ad-d68e-45ff-a552-4d618dd11890
24	24	0	Plazi	ffb07bec-2d10-492d-9c37-361fe0b79427	5825c1c0-61ff-4fce-af46-9f77ed3a0b2c
0	2	2	Plazi	ffb07bec-2d10-492d-9c37-361fe0b79427	5a132eed-a205-458a-b043-f056fca2e25f
0	2	2	Plazi	ffb07bec-2d10-492d-9c37-361fe0b79427	5b2d651a-1c6b-445d-b1cc-62eb3ad7e85f
4	4	0	Plazi	ffb07bec-2d10-492d-9c37-361fe0b79427	5d620328-25b8-42e3-a7e9-c641e9031332
0	5	5	Plazi	ffb07bec-2d10-492d-9c37-361fe0b79427	5f80c889-a1a2-4351-bea4-3d75392da8c2
7398	7398	0	GBIF Germany	4f6826f2-4ff6-443d-b966-e6913bd24013	5fc08dad-66eb-4e2b-ba38-829a0773d29f
133	133	0	GBIF Germany	4f6826f2-4ff6-443d-b966-e6913bd24013	62566d9c-f762-11e1-a439-00145eb45e9a
18	18	0	Plazi	ffb07bec-2d10-492d-9c37-361fe0b79427	628bb48f-a435-466b-b6c5-e328a3909cab
0	101	101	Plazi	ffb07bec-2d10-492d-9c37-361fe0b79427	62f9dc57-bade-4fbc-8af7-f92ff107593c
112	112	0	GBIF Germany	4f6826f2-4ff6-443d-b966-e6913bd24013	63f20b7a-f762-11e1-a439-00145eb45e9a
93	93	0	GBIF Germany	4f6826f2-4ff6-443d-b966-e6913bd24013	65bbaa38-f762-11e1-a439-00145eb45e9a
33560	33560	0	National Biodiversity Network	d897a5b9-35ee-4232-94bd-b0bcaac003c2	662ca265-290e-4886-af5f-3fe0cb9a07b3
0	40	40	Plazi	ffb07bec-2d10-492d-9c37-361fe0b79427	6784a642-4e5b-4726-b560-b7b6ed83e0bc
132	132	0	GBIF Germany	4f6826f2-4ff6-443d-b966-e6913bd24013	67aa3a58-f762-11e1-a439-00145eb45e9a
2247	2247	0	GBIF Japan	db5705aa-6a6e-42f1-8942-d77b9f4896ea	67c9da14-9d56-4142-a10c-b3aea3cb2ee5
164	164	0	GBIF Germany	4f6826f2-4ff6-443d-b966-e6913bd24013	6828c5a8-f762-11e1-a439-00145eb45e9a
83	83	0	GBIF Germany	4f6826f2-4ff6-443d-b966-e6913bd24013	69bbc226-f762-11e1-a439-00145eb45e9a
63	63	0	GBIF Germany	4f6826f2-4ff6-443d-b966-e6913bd24013	6a066934-f762-11e1-a439-00145eb45e9a
4	4	0	Plazi	ffb07bec-2d10-492d-9c37-361fe0b79427	6a11f07e-91a5-4420-9eb8-dedb2bdf9c80
430	430	0	National Biodiversity Network	d897a5b9-35ee-4232-94bd-b0bcaac003c2	6a197e32-24e4-401d-9082-383f86ba0344
431	431	0	GBIF Germany	4f6826f2-4ff6-443d-b966-e6913bd24013	6a2d6ef8-f762-11e1-a439-00145eb45e9a
0	317	317	Participant Node Managers Committee	7f48e0c8-5c96-49ec-b972-30748e339115	6bfba41f-0259-4c8d-9818-4c23a432f477
49	49	0	Plazi	ffb07bec-2d10-492d-9c37-361fe0b79427	6c09e75c-a60b-44e7-8492-0cc892b84d23
10	10	0	GBIF France	da44cd31-5901-4687-a106-6d1c7734ee3a	6c8ace1e-f374-4b5f-93bd-7c7eacd66c61
0	202529	202529	National Biodiversity Network	d897a5b9-35ee-4232-94bd-b0bcaac003c2	70921b14-8ee5-47a0-aea4-679ac21e8196
2776	2776	0	Biodiversity Information System of Mexico	b324e8e9-9a4c-44fa-8f1a-7f39ea7ab576	70b05350-a0a5-4e74-bc0c-d67348b7a1a9
45139	45139	0	GBIF France	da44cd31-5901-4687-a106-6d1c7734ee3a	70f49e37-aea1-4ede-a21a-03057bc0a984
27	27	0	Plazi	ffb07bec-2d10-492d-9c37-361fe0b79427	72176970-7295-41ae-a47f-15810a8d6cf2
7	7	0	GBIF Germany	4f6826f2-4ff6-443d-b966-e6913bd24013	745e2be2-f762-11e1-a439-00145eb45e9a
2	2	0	Plazi	ffb07bec-2d10-492d-9c37-361fe0b79427	74b26dd7-321c-4541-be9d-0988c26fbd11
2	2	0	Participant Node Managers Committee	7f48e0c8-5c96-49ec-b972-30748e339115	755f296b-2e3a-4677-80f7-1941f6561123
12	12	0	Plazi	ffb07bec-2d10-492d-9c37-361fe0b79427	760311d4-67ec-4b7a-82a9-3b976c5e7e3a
118	118	0	Plazi	ffb07bec-2d10-492d-9c37-361fe0b79427	768211ea-7b41-4e48-b178-eda8592d256f
2226	2226	0	GBIF Germany	4f6826f2-4ff6-443d-b966-e6913bd24013	786ef838-f762-11e1-a439-00145eb45e9a
93	59	-34	GBIF Germany	4f6826f2-4ff6-443d-b966-e6913bd24013	795d114e-f762-11e1-a439-00145eb45e9a
0	1	1	Plazi	ffb07bec-2d10-492d-9c37-361fe0b79427	7a08d87e-3854-4371-bd27-217a2db2b418
5	5	0	Plazi	ffb07bec-2d10-492d-9c37-361fe0b79427	7aa589ec-3ac9-4ec8-828d-e3bb9012955b
738	738	0	GBIF France	da44cd31-5901-4687-a106-6d1c7734ee3a	7b359d4a-996e-4ebe-a032-0e8a265db283
4	4	0	Plazi	ffb07bec-2d10-492d-9c37-361fe0b79427	7b6c18a6-d29a-444f-a849-7a6eea05c2d7
7	7	0	Plazi	ffb07bec-2d10-492d-9c37-361fe0b79427	7c324801-2c22-439d-87c8-1bdb83e11827
440	440	0	GBIF France	da44cd31-5901-4687-a106-6d1c7734ee3a	7cb80b23-603a-4815-a612-b02486c746bb
93	93	0	GBIF Germany	4f6826f2-4ff6-443d-b966-e6913bd24013	7ced13a4-f762-11e1-a439-00145eb45e9a
439	129	-310	GBIF Germany	4f6826f2-4ff6-443d-b966-e6913bd24013	7d3517d0-f762-11e1-a439-00145eb45e9a
111	111	0	GBIF Germany	4f6826f2-4ff6-443d-b966-e6913bd24013	7e010af2-f762-11e1-a439-00145eb45e9a
14278	3751	-10527	GBIF Germany	4f6826f2-4ff6-443d-b966-e6913bd24013	7e659224-f762-11e1-a439-00145eb45e9a
1	1	0	National Biodiversity Network	d897a5b9-35ee-4232-94bd-b0bcaac003c2	7eb5c03e-fc46-46e7-acbd-92df3296ffae
999	999	0	GBIF Germany	4f6826f2-4ff6-443d-b966-e6913bd24013	7f0edc80-f762-11e1-a439-00145eb45e9a
45954	45954	0	GBIF Japan	db5705aa-6a6e-42f1-8942-d77b9f4896ea	812ae932-f762-11e1-a439-00145eb45e9a
30	30	0	GBIF Germany	4f6826f2-4ff6-443d-b966-e6913bd24013	81444b45-39c0-4d08-b026-7bb4baeda16e
2507	2507	0	National Biodiversity Network	d897a5b9-35ee-4232-94bd-b0bcaac003c2	814940c3-f826-481e-8e4e-7408de7a2c3d
432	432	0	GBIF Germany	4f6826f2-4ff6-443d-b966-e6913bd24013	8170feae-f762-11e1-a439-00145eb45e9a
2102	1088	-1014	GBIF Germany	4f6826f2-4ff6-443d-b966-e6913bd24013	82453caa-f762-11e1-a439-00145eb45e9a
24958	24958	0	CABI Bioscience	ed988a18-81f8-4d5f-a88d-f93ef592b2f2	832282e0-f762-11e1-a439-00145eb45e9a
4	4	0	Plazi	ffb07bec-2d10-492d-9c37-361fe0b79427	84dcc992-563c-49f4-ab51-8bccda65449a
0	1	1	Plazi	ffb07bec-2d10-492d-9c37-361fe0b79427	84ead453-bef6-4d97-88bd-4b07131a2d28
27351	27351	0	GBIF Germany	4f6826f2-4ff6-443d-b966-e6913bd24013	85771146-f762-11e1-a439-00145eb45e9a
65	33	-32	GBIF Germany	4f6826f2-4ff6-443d-b966-e6913bd24013	876565fc-f762-11e1-a439-00145eb45e9a
27	16	-11	GBIF Germany	4f6826f2-4ff6-443d-b966-e6913bd24013	8766a9f8-f762-11e1-a439-00145eb45e9a
126	126	0	Atlas of Living Australia	4a6f1b71-969e-4fc5-a693-282b05e1220c	892c7dee-f762-11e1-a439-00145eb45e9a
596	191	-405	GBIF Germany	4f6826f2-4ff6-443d-b966-e6913bd24013	894472c8-f762-11e1-a439-00145eb45e9a
39	39	0	GBIF Germany	4f6826f2-4ff6-443d-b966-e6913bd24013	8a772b0e-f762-11e1-a439-00145eb45e9a
0	21	21	Plazi	ffb07bec-2d10-492d-9c37-361fe0b79427	8ad18705-edc8-4ee2-9054-de82643e46da
105	105	0	GBIF Germany	4f6826f2-4ff6-443d-b966-e6913bd24013	8c529706-f762-11e1-a439-00145eb45e9a
158	158	0	Colombian Biodiversity Information System	7e865cba-7c46-417b-ade5-97f2cf5b7be0	8cbc947b-baf7-4fb2-a6bd-fc40d0355ce6
0	1	1	Plazi	ffb07bec-2d10-492d-9c37-361fe0b79427	8ef22762-4fd3-4d65-8d0b-20b07d88d5d1
39	18	-21	GBIF Germany	4f6826f2-4ff6-443d-b966-e6913bd24013	8f6a1888-f762-11e1-a439-00145eb45e9a
84	56	-28	GBIF Germany	4f6826f2-4ff6-443d-b966-e6913bd24013	90cdcab2-f762-11e1-a439-00145eb45e9a
25	25	0	Plazi	ffb07bec-2d10-492d-9c37-361fe0b79427	911ecd53-56b9-4c32-b948-7aec22113775
4	4	0	Plazi	ffb07bec-2d10-492d-9c37-361fe0b79427	920561e2-c548-4c19-8be6-aeccfc9579a8
82	82	0	GBIF Germany	4f6826f2-4ff6-443d-b966-e6913bd24013	92c32786-f762-11e1-a439-00145eb45e9a
56	24	-32	GBIF Germany	4f6826f2-4ff6-443d-b966-e6913bd24013	92e4bea0-f762-11e1-a439-00145eb45e9a
28636	29399	763	GBIF Brazil	cdc9736d-5ff7-4ece-9959-3c744360cdb3	92e7a11c-2765-4eee-9341-2a89083e6132
101	101	0	GBIF France	da44cd31-5901-4687-a106-6d1c7734ee3a	93b2bc80-a0ef-4619-b51c-074506700050
1476	1476	0	GBIF Germany	4f6826f2-4ff6-443d-b966-e6913bd24013	94356106-f762-11e1-a439-00145eb45e9a
51	51	0	Participant Node Managers Committee	7f48e0c8-5c96-49ec-b972-30748e339115	94fca048-287c-49ea-8876-34a011ee0029
339	339	0	GBIF Germany	4f6826f2-4ff6-443d-b966-e6913bd24013	951d67c2-f0de-4153-9094-09ec686d3ca0
2992	2775	-217	GBIF Germany	4f6826f2-4ff6-443d-b966-e6913bd24013	95256278-f762-11e1-a439-00145eb45e9a
105	105	0	GBIF France	da44cd31-5901-4687-a106-6d1c7734ee3a	95a258e1-94b6-4c1f-becb-93d080d0d5dc
0	739	739	Ocean Biodiversity Information System	ba0670b9-4186-41e6-8e70-f9cb3065551a	95b97de1-8452-449b-8f67-450e019816fc
10	10	0	GBIF Germany	4f6826f2-4ff6-443d-b966-e6913bd24013	967f9d46-f762-11e1-a439-00145eb45e9a
0	457	457	Colombian Biodiversity Information System	7e865cba-7c46-417b-ade5-97f2cf5b7be0	97333283-df15-4a0e-8ce4-aeeecf3e643c
163	163	0	GBIF Portugal	673f7038-4262-4149-b753-5658a4e912f6	9756e0d8-2234-4219-82e6-fde1c1b45314
9	9	0	GBIF Germany	4f6826f2-4ff6-443d-b966-e6913bd24013	97a00026-f762-11e1-a439-00145eb45e9a
218	218	0	GBIF France	da44cd31-5901-4687-a106-6d1c7734ee3a	97e17313-f5b5-4d8c-9453-d90abf00c911
0	10	10	Plazi	ffb07bec-2d10-492d-9c37-361fe0b79427	99e1ad66-4364-4dcb-bdfd-2bb8778f6b8b
0	4	4	Plazi	ffb07bec-2d10-492d-9c37-361fe0b79427	a046a495-8330-48eb-b1e3-9f47a9322dd1
5	5	0	Plazi	ffb07bec-2d10-492d-9c37-361fe0b79427	a3f6433d-a351-42d3-8834-5a3c1c7e497f
13	13	0	GBIF Spain	1f94b3ca-9345-4d65-afe2-4bace93aa0fe	a73c418e-7baa-4955-bdad-0159bcf2be2d
148	148	0	GBIF Japan	db5705aa-6a6e-42f1-8942-d77b9f4896ea	a799fd82-0b29-44d9-92e0-9fd71abd9d2a
132	132	0	GBIF Germany	4f6826f2-4ff6-443d-b966-e6913bd24013	ac31d361-b0bb-4b03-95dc-b3946a4cf97a
4	4	0	Plazi	ffb07bec-2d10-492d-9c37-361fe0b79427	af818b3b-0aaf-4f80-9e61-9508357d4cf8
0	12503	12503	Ocean Biodiversity Information System	ba0670b9-4186-41e6-8e70-f9cb3065551a	afc4f93e-0abd-4697-9167-6fd5da0982ce
16	16	0	Plazi	ffb07bec-2d10-492d-9c37-361fe0b79427	b09a9b35-11d9-4314-8365-0b8850fee8fb
0	13	13	Plazi	ffb07bec-2d10-492d-9c37-361fe0b79427	b54efda7-4ae3-4c67-9b89-c7b699dffb19
0	835	835	Ocean Biodiversity Information System	ba0670b9-4186-41e6-8e70-f9cb3065551a	b7d5f7db-0bec-4a64-9fde-31a15d571bc7
926	926	0	National Biodiversity Network	d897a5b9-35ee-4232-94bd-b0bcaac003c2	b7edcdcf-bcd9-4669-b97b-9bc2f1119ea6
2017	2017	0	GBIF Brazil	cdc9736d-5ff7-4ece-9959-3c744360cdb3	b8690829-221b-49df-91bc-78bd1fdced24
164	164	0	GBIF France	da44cd31-5901-4687-a106-6d1c7734ee3a	b9df90c9-2930-45ed-8720-841344609a7e
154	154	0	GBIF Germany	4f6826f2-4ff6-443d-b966-e6913bd24013	bcbacb0a-874b-443d-9ffe-573cc5f9c628
0	8	8	Plazi	ffb07bec-2d10-492d-9c37-361fe0b79427	c0471856-e429-45ed-a0ca-dc4eda1d8fa9
139	139	0	Plazi	ffb07bec-2d10-492d-9c37-361fe0b79427	c28f42c9-ff11-469c-9db8-97350d61d00b
28	28	0	Plazi	ffb07bec-2d10-492d-9c37-361fe0b79427	c34a0b8a-e322-449a-903b-e0f61bdc8987
0	1	1	Plazi	ffb07bec-2d10-492d-9c37-361fe0b79427	c44a0cd4-5fb7-4a28-a554-54b838bce338
427	427	0	GBIF Germany	4f6826f2-4ff6-443d-b966-e6913bd24013	c46cf144-5877-4411-86fd-2b7204662826
10	10	0	Plazi	ffb07bec-2d10-492d-9c37-361fe0b79427	c6810d7b-b8a5-4eb9-b87d-faa0b4698a8c
117	117	0	GBIF France	da44cd31-5901-4687-a106-6d1c7734ee3a	c6a51631-8db6-453a-ba79-0d89d0376efd
89	89	0	Plazi	ffb07bec-2d10-492d-9c37-361fe0b79427	c84de1cc-eca9-487e-aa1f-58e33c72c775
2530	2530	0	Atlas of Living Australia	4a6f1b71-969e-4fc5-a693-282b05e1220c	c9d02825-4ff4-4483-bdd6-7bce652826d3
570	570	0	GBIF Benin	efb9c00e-f802-45dd-8826-a52ec45b89ff	ca86747b-2fae-4ca4-a61c-feccff7b7494
2	2	0	Plazi	ffb07bec-2d10-492d-9c37-361fe0b79427	ca9247d0-9c90-484e-a33f-7a9192dadc9b
0	11	11	Plazi	ffb07bec-2d10-492d-9c37-361fe0b79427	cc383fa6-6a88-41d4-a794-48ce2e5b4180
0	1	1	Plazi	ffb07bec-2d10-492d-9c37-361fe0b79427	cdd39956-de72-43ea-afa3-cf79f805dd83
2	2	0	Plazi	ffb07bec-2d10-492d-9c37-361fe0b79427	cdf61ac1-38c5-406f-9414-011a7e2a537c
0	10	10	Plazi	ffb07bec-2d10-492d-9c37-361fe0b79427	ce27a6b1-3c00-44a4-905e-2157e5070727
292	292	0	Biodiversity Information System of Mexico	b324e8e9-9a4c-44fa-8f1a-7f39ea7ab576	d0763028-e8a8-4a0e-a5f5-3e65621df6da
214	214	0	GBIF Norway	4f829580-180d-46a9-9c87-ed8ec959b545	d1c13016-51c4-4819-8e4d-56b2082baab4
58	58	0	Plazi	ffb07bec-2d10-492d-9c37-361fe0b79427	d21bedeb-4bcc-4dd5-aefd-5426ba5abaf4
824	824	0	Biodiversity Information System of Mexico	b324e8e9-9a4c-44fa-8f1a-7f39ea7ab576	d22863c3-aff9-4f91-b727-dc3ece083694
22	22	0	Plazi	ffb07bec-2d10-492d-9c37-361fe0b79427	d2524fd4-6cef-4a4b-bd4c-d792264a76e6
0	5	5	Ocean Biodiversity Information System	ba0670b9-4186-41e6-8e70-f9cb3065551a	d29ee539-bb1a-401c-9159-d2fe05df9625
5146	5146	0	GBIF France	da44cd31-5901-4687-a106-6d1c7734ee3a	d85e9305-e0e5-4e95-b7b0-e87a0488db85
8	8	0	Ocean Biodiversity Information System	ba0670b9-4186-41e6-8e70-f9cb3065551a	d8da8f68-a619-4730-8dfa-beb2487be803
11974	11974	0	National Biodiversity Network	d897a5b9-35ee-4232-94bd-b0bcaac003c2	d9f1abed-656b-4b02-92bd-58a6d63167c8
12234	12234	0	GBIF France	da44cd31-5901-4687-a106-6d1c7734ee3a	da18c4ac-e5aa-4caf-915b-e6a86a01705d
225	225	0	Colombian Biodiversity Information System	7e865cba-7c46-417b-ade5-97f2cf5b7be0	dbab2e28-bce6-492d-8cd6-e0653a34cc58
0	169	169	Colombian Biodiversity Information System	7e865cba-7c46-417b-ade5-97f2cf5b7be0	df883069-c6ee-41d0-83d3-029fed1b70af
105	105	0	GBIF Germany	4f6826f2-4ff6-443d-b966-e6913bd24013	e0d1ce44-728d-4d0b-a303-41d151c5d4cf
1231	1293	62	GBIF Spain	1f94b3ca-9345-4d65-afe2-4bace93aa0fe	e13c9ce4-9f3f-4497-9dc5-5b0f16f3402c
516	516	0	Participant Node Managers Committee	7f48e0c8-5c96-49ec-b972-30748e339115	e1966d34-2144-4a07-a6d4-b246d6f047aa
9	9	0	Plazi	ffb07bec-2d10-492d-9c37-361fe0b79427	e60f857a-280d-4d2e-97d4-1045c4487585
0	42	42	Plazi	ffb07bec-2d10-492d-9c37-361fe0b79427	e7b81459-adad-480d-8dba-601a13fde0b7
8	8	0	Plazi	ffb07bec-2d10-492d-9c37-361fe0b79427	e9be13b4-b13b-458e-af94-7f9118030ec7
11143	11143	0	Canada Biodiversity Information Facility	8f83fc96-c966-4126-83f7-bf044dc49efa	e9e6abed-f507-497c-aa34-29b05227f4e8
34	34	0	GBIF France	da44cd31-5901-4687-a106-6d1c7734ee3a	ea2f9e38-fb37-4fd0-98b1-4a38aa4e3441
5069	5069	0	GBIF France	da44cd31-5901-4687-a106-6d1c7734ee3a	eabe9306-fd68-4140-83fc-554da92e6268
0	6553	6553	Participant Node Managers Committee	7f48e0c8-5c96-49ec-b972-30748e339115	eac7957f-8d7a-4605-afe3-96e6b1877416
1949	1276	-673	Biodiversity Information System of Mexico	b324e8e9-9a4c-44fa-8f1a-7f39ea7ab576	ec00e3e6-52cd-4e91-9ea8-8003345f5c3d
0	407	407	GBIF Chile	a8b16421-d80b-4ef3-8f22-098b01a89255	ec377d02-c837-445a-9a35-d600adbf0ba0
18	18	0	National Biodiversity Network	d897a5b9-35ee-4232-94bd-b0bcaac003c2	ee50b7b3-e934-490f-ba3d-1734f478845c
0	2	2	Plazi	ffb07bec-2d10-492d-9c37-361fe0b79427	f0c39384-84d5-4a4a-a48b-c19b5ca52e7f
1102	1102	0	Biodiversity Information System of Mexico	b324e8e9-9a4c-44fa-8f1a-7f39ea7ab576	f1ffb4bc-2f10-4bd6-92f6-801ee4054a30
0	29532	29532	Ocean Biodiversity Information System	ba0670b9-4186-41e6-8e70-f9cb3065551a	f6baa711-9c3f-4820-97ce-83fe50744678
114	66	-48	Biodiversity Information System of Mexico	b324e8e9-9a4c-44fa-8f1a-7f39ea7ab576	f7f05647-5608-4b11-aa08-ce51da5949a1
315	259	-56	GBIF Germany	4f6826f2-4ff6-443d-b966-e6913bd24013	fa9a3990-565c-487c-b1b1-bae99dbd6dd9
0	3574	3574	Tanzania Biodiversity Information Facility	abd95ca6-3959-4db9-aaa6-2de1aeecf514	fc883eba-3e05-47f0-9cb4-970e4a911483
83	83	0	Participant Node Managers Committee	7f48e0c8-5c96-49ec-b972-30748e339115	fe8be2e9-d7ed-4548-b2a4-df375a1afe85
0	193	193	Ocean Biodiversity Information System	ba0670b9-4186-41e6-8e70-f9cb3065551a	001db2b9-e713-43e4-ac5d-2c52ef009ef1
10	10	0	Plazi	ffb07bec-2d10-492d-9c37-361fe0b79427	03880476-7a8d-4369-bf5b-d15b049f958c
12	12	0	Plazi	ffb07bec-2d10-492d-9c37-361fe0b79427	040d3afa-65fe-4a2b-92e8-196dc8224dc6
20518	20518	0	U.S. Geological Survey	8618c64a-93e0-4300-b546-7249e5148ed2	04169fce-7d4f-41f7-9dff-245960f5b59e
11	11	0	Plazi	ffb07bec-2d10-492d-9c37-361fe0b79427	0599559b-cb03-4425-a2d7-653955b1b5e2
1014	1014	0	GBIF Madagascar	2dbfc5c5-51b5-4494-9dfc-4d3f013a3b64	073938a7-50e8-446e-8884-035b0639982c
0	5	5	Plazi	ffb07bec-2d10-492d-9c37-361fe0b79427	07eb2d3b-7c51-452d-a9be-34fa0ef8031d
7	7	0	Plazi	ffb07bec-2d10-492d-9c37-361fe0b79427	086501d9-a2f5-418d-8b5e-368bf4c45b3f
195	195	0	Colombian Biodiversity Information System	7e865cba-7c46-417b-ade5-97f2cf5b7be0	09fa2625-92c0-4720-9cbb-d43ced49d11f
2546	2546	0	Polish Biodiversity Information Network	2618bfdf-e194-4911-a241-80db3107bc51	0d9f8ae0-33cf-11de-afc5-b8a03c50a862
167	167	0	GBIF Argentina	2426a871-9feb-40a1-96c6-0c593a76b835	10eb3506-78a4-4d43-b86a-1a06d7463d5f
0	88	88	Participant Node Managers Committee	7f48e0c8-5c96-49ec-b972-30748e339115	1377b4ca-f6ac-4919-98e5-2ea0c0f5c09e
0	3	3	Plazi	ffb07bec-2d10-492d-9c37-361fe0b79427	1445507c-5333-4120-8788-18d39aed0bde
15	15	0	Plazi	ffb07bec-2d10-492d-9c37-361fe0b79427	16d85ec8-06f0-4aed-bcba-fed1a927bbe8
1004	1004	0	National Biodiversity Network	d897a5b9-35ee-4232-94bd-b0bcaac003c2	18fda624-fb6a-444b-b414-41925f0408df
0	66	66	Plazi	ffb07bec-2d10-492d-9c37-361fe0b79427	1b3e9021-9c16-46d1-b76b-93821bcbb053
27	27	0	Plazi	ffb07bec-2d10-492d-9c37-361fe0b79427	1f178728-7a1b-402e-a7c2-7caa361f39f5
39872	334341	294469	U.S. Geological Survey	8618c64a-93e0-4300-b546-7249e5148ed2	2473e9c3-624f-4cd6-bfc6-b476913790b5
0	120	120	Colombian Biodiversity Information System	7e865cba-7c46-417b-ade5-97f2cf5b7be0	250b08c2-470b-4eed-b225-1477239f1f53
4583	4590	7	GBIF Brazil	cdc9736d-5ff7-4ece-9959-3c744360cdb3	252d1966-b6f4-4f06-94bc-c10a3ade5ff2
0	28	28	Plazi	ffb07bec-2d10-492d-9c37-361fe0b79427	26a856ab-18fe-49bd-a58c-56a008fc637f
165	165	0	Plazi	ffb07bec-2d10-492d-9c37-361fe0b79427	2a295c2d-c399-419a-bb33-730768aac493
13477	13477	0	South African Biodiversity Information Facility	7190b835-4e86-4b6e-85c1-19cc6677c250	2c7c7c32-fbe8-495f-8243-544178d7466b
76	76	0	GBIF Germany	4f6826f2-4ff6-443d-b966-e6913bd24013	2dc0db43-8714-4421-9883-7f021531b92f
0	23518	23518	Ocean Biodiversity Information System	ba0670b9-4186-41e6-8e70-f9cb3065551a	2f4aedac-2a48-40e1-a991-e789c171f456
56	56	0	Plazi	ffb07bec-2d10-492d-9c37-361fe0b79427	30b2e4dc-5996-46b6-8be8-7bccdd041563
595	595	0	Belgian Biodiversity Platform	fb11cfe1-ebc3-45af-9159-17d9fddbcdac	31183754-1027-42e2-94f7-55f9d1311bcb
0	10	10	Plazi	ffb07bec-2d10-492d-9c37-361fe0b79427	31474b65-a602-41a5-83a0-94919c9fee25
37	37	0	Colombian Biodiversity Information System	7e865cba-7c46-417b-ade5-97f2cf5b7be0	33d0dd93-a279-4762-b8d0-eabec49b50c0
20	20	0	Plazi	ffb07bec-2d10-492d-9c37-361fe0b79427	366afc15-fa1b-4a2d-ab0b-c0742ad3832e
78	78	0	GBIF France	da44cd31-5901-4687-a106-6d1c7734ee3a	3713861f-99f4-4dcd-bf03-8f09f96e653f
1661	1661	0	GBIF France	da44cd31-5901-4687-a106-6d1c7734ee3a	3967f5b7-d1a4-463d-9865-319319af4eea
6	6	0	Plazi	ffb07bec-2d10-492d-9c37-361fe0b79427	39a36038-a621-477e-97af-f4d214503b2e
0	1	1	Participant Node Managers Committee	7f48e0c8-5c96-49ec-b972-30748e339115	3c095e10-f884-4733-8a5a-b4d7dce9b394
30	30	0	Plazi	ffb07bec-2d10-492d-9c37-361fe0b79427	3e72ff64-3a86-42fe-9626-dd5bece8188e
2627	2627	0	U.S. Geological Survey	8618c64a-93e0-4300-b546-7249e5148ed2	40660363-6d19-4989-99e8-395f5b12ded8
66	66	0	GBIF Germany	4f6826f2-4ff6-443d-b966-e6913bd24013	41040f86-84bd-47fd-9b21-bd52213c386d
4	4	0	Participant Node Managers Committee	7f48e0c8-5c96-49ec-b972-30748e339115	45d3bec7-9f30-480a-b935-44693d1dd86c
0	2	2	Plazi	ffb07bec-2d10-492d-9c37-361fe0b79427	463131ba-f55b-4c5e-8f87-18a906483e2e
0	8	8	Plazi	ffb07bec-2d10-492d-9c37-361fe0b79427	465b794f-46d6-419f-940f-0866462da82b
101	101	0	Participant Node Managers Committee	7f48e0c8-5c96-49ec-b972-30748e339115	4792ce42-563a-40a5-b961-fcd7efa64ba0
0	23	23	Plazi	ffb07bec-2d10-492d-9c37-361fe0b79427	47aa6d7b-d71f-43b3-8587-453e07fa1c4b
1992	1992	0	GBIF Argentina	2426a871-9feb-40a1-96c6-0c593a76b835	47b61433-ac6e-4a4f-b81d-bfa798717be5
898	898	0	Colombian Biodiversity Information System	7e865cba-7c46-417b-ade5-97f2cf5b7be0	4ae715d1-e34b-4788-916e-f4360d078768
1322	1322	0	Biodiversity Information System of Mexico	b324e8e9-9a4c-44fa-8f1a-7f39ea7ab576	4aed1b54-e881-4a65-a294-71b9ada41f63
16	16	0	GBIF France	da44cd31-5901-4687-a106-6d1c7734ee3a	4b44c178-373e-405e-88c9-bc133344c0f7
3	3	0	Plazi	ffb07bec-2d10-492d-9c37-361fe0b79427	4eefffc2-54ae-4f2a-8086-ec4e0db43cb0
0	7	7	Plazi	ffb07bec-2d10-492d-9c37-361fe0b79427	4fa93b26-008e-489a-9e9f-fcef036e7674
22851698	36832669	13980971	U.S. Geological Survey	8618c64a-93e0-4300-b546-7249e5148ed2	50c9509d-22c7-4a22-a47d-8c48425ef4a7
0	9064	9064	U.S. Geological Survey	8618c64a-93e0-4300-b546-7249e5148ed2	54cd9f35-2864-4c7b-93f5-dc7a62f84373
22901	22901	0	GBIF France	da44cd31-5901-4687-a106-6d1c7734ee3a	5686f1a4-0da5-4264-be76-8a0ac1e7d6fa
145	145	0	Participant Node Managers Committee	7f48e0c8-5c96-49ec-b972-30748e339115	578475de-d1b7-453f-a429-8de9ecfd9e1d
0	113	113	Participant Node Managers Committee	7f48e0c8-5c96-49ec-b972-30748e339115	5b2a5f78-87b9-4880-aa5b-8a8618fe9a1a
4	4	0	Plazi	ffb07bec-2d10-492d-9c37-361fe0b79427	5d04bca1-ae4b-4be7-9cc1-2b289ce4bef2
50	50	0	Colombian Biodiversity Information System	7e865cba-7c46-417b-ade5-97f2cf5b7be0	608b2f9a-f5ea-4a18-93fb-028f8e881126
2	2	0	Plazi	ffb07bec-2d10-492d-9c37-361fe0b79427	6106143f-cb2b-4bf7-a9cf-a06d956b9081
241	241	0	GBIF Germany	4f6826f2-4ff6-443d-b966-e6913bd24013	61412960-f762-11e1-a439-00145eb45e9a
304	304	0	GBIF Germany	4f6826f2-4ff6-443d-b966-e6913bd24013	61b59ff2-f762-11e1-a439-00145eb45e9a
54	54	0	GBIF Germany	4f6826f2-4ff6-443d-b966-e6913bd24013	61bbc152-f762-11e1-a439-00145eb45e9a
32	32	0	GBIF Germany	4f6826f2-4ff6-443d-b966-e6913bd24013	61cf80e8-f762-11e1-a439-00145eb45e9a
1	1	0	Plazi	ffb07bec-2d10-492d-9c37-361fe0b79427	62735361-4a5a-4203-9251-be83966d5902
58	58	0	GBIF Germany	4f6826f2-4ff6-443d-b966-e6913bd24013	629d61ac-f762-11e1-a439-00145eb45e9a
6	6	0	GBIF Germany	4f6826f2-4ff6-443d-b966-e6913bd24013	630704ea-f762-11e1-a439-00145eb45e9a
334	334	0	GBIF Germany	4f6826f2-4ff6-443d-b966-e6913bd24013	63910384-f762-11e1-a439-00145eb45e9a
100	100	0	GBIF Germany	4f6826f2-4ff6-443d-b966-e6913bd24013	63c52b1e-f762-11e1-a439-00145eb45e9a
1163	1163	0	Atlas of Living Australia	4a6f1b71-969e-4fc5-a693-282b05e1220c	63cee3e6-4a0f-4469-928f-962b20872e48
116	116	0	GBIF Germany	4f6826f2-4ff6-443d-b966-e6913bd24013	6421e37c-f762-11e1-a439-00145eb45e9a
194	194	0	GBIF Germany	4f6826f2-4ff6-443d-b966-e6913bd24013	6425e954-f762-11e1-a439-00145eb45e9a
3	3	0	Plazi	ffb07bec-2d10-492d-9c37-361fe0b79427	643bdd02-bbf6-4d89-9c6d-46adf076d3a2
90	90	0	GBIF Germany	4f6826f2-4ff6-443d-b966-e6913bd24013	644b165c-f762-11e1-a439-00145eb45e9a
101	101	0	GBIF Germany	4f6826f2-4ff6-443d-b966-e6913bd24013	644f37a0-f762-11e1-a439-00145eb45e9a
27	27	0	Plazi	ffb07bec-2d10-492d-9c37-361fe0b79427	65a16a5a-387d-46c2-93e9-1f0ac7e27896
1011	975	-36	GBIF Germany	4f6826f2-4ff6-443d-b966-e6913bd24013	65a7cf40-f762-11e1-a439-00145eb45e9a
80	80	0	GBIF Germany	4f6826f2-4ff6-443d-b966-e6913bd24013	68869654-61f7-409f-913b-ce94c06430de
74	74	0	GBIF Germany	4f6826f2-4ff6-443d-b966-e6913bd24013	68a77894-f762-11e1-a439-00145eb45e9a
493	493	0	GBIF Germany	4f6826f2-4ff6-443d-b966-e6913bd24013	696e5f9a-f762-11e1-a439-00145eb45e9a
1146	1146	0	GBIF France	da44cd31-5901-4687-a106-6d1c7734ee3a	69870da4-4f0f-4cc5-9b95-862970ea994e
4658	4658	0	GBIF Germany	4f6826f2-4ff6-443d-b966-e6913bd24013	69f0f5c2-08b9-11e3-ab1f-00145eb45e9a
1	1	0	Plazi	ffb07bec-2d10-492d-9c37-361fe0b79427	6add1840-9b97-43ce-b6ce-df430ef86c5c
4043	4043	0	GBIF Portugal	673f7038-4262-4149-b753-5658a4e912f6	6af010f0-8238-4745-8309-21c3f82bd488
24	24	0	GBIF Germany	4f6826f2-4ff6-443d-b966-e6913bd24013	6b3f1378-f762-11e1-a439-00145eb45e9a
24	24	0	GBIF Germany	4f6826f2-4ff6-443d-b966-e6913bd24013	6b4481a0-f762-11e1-a439-00145eb45e9a
18	18	0	GBIF Germany	4f6826f2-4ff6-443d-b966-e6913bd24013	6b93a1ae-f762-11e1-a439-00145eb45e9a
10	10	0	GBIF Germany	4f6826f2-4ff6-443d-b966-e6913bd24013	6bac5564-f762-11e1-a439-00145eb45e9a
108	108	0	Plazi	ffb07bec-2d10-492d-9c37-361fe0b79427	6bca4eb8-bfdd-496c-9916-dc998447a172
33	33	0	GBIF Germany	4f6826f2-4ff6-443d-b966-e6913bd24013	6cd6bfec-f762-11e1-a439-00145eb45e9a
64457	64457	0	Ocean Biodiversity Information System	ba0670b9-4186-41e6-8e70-f9cb3065551a	6d28a527-bf84-4e58-b133-0e60987b5e7c
0	8944	8944	Belgian Biodiversity Platform	fb11cfe1-ebc3-45af-9159-17d9fddbcdac	6d437ff3-5140-4de3-ad97-80016181760a
96	96	0	GBIF Germany	4f6826f2-4ff6-443d-b966-e6913bd24013	6d5d3626-f762-11e1-a439-00145eb45e9a
797	797	0	GBIF Germany	4f6826f2-4ff6-443d-b966-e6913bd24013	6ee7d4ba-f762-11e1-a439-00145eb45e9a
3161	3161	0	GBIF Benin	efb9c00e-f802-45dd-8826-a52ec45b89ff	6f9a2451-3d0e-40d9-9e13-51ee7ca0d41d
99	99	0	GBIF Germany	4f6826f2-4ff6-443d-b966-e6913bd24013	6ff5009e-f762-11e1-a439-00145eb45e9a
6	6	0	Plazi	ffb07bec-2d10-492d-9c37-361fe0b79427	71421820-a02b-4fef-a8b6-e8b216c3e8f1
9	9	0	Plazi	ffb07bec-2d10-492d-9c37-361fe0b79427	7281d6a2-10d6-45ea-ba7e-af1aa95f008a
104	104	0	GBIF Germany	4f6826f2-4ff6-443d-b966-e6913bd24013	7370a7b4-f762-11e1-a439-00145eb45e9a
511	511	0	GBIF Germany	4f6826f2-4ff6-443d-b966-e6913bd24013	74845a9c-f762-11e1-a439-00145eb45e9a
24795	26736	1941	GBIF France	da44cd31-5901-4687-a106-6d1c7734ee3a	74f3bc4b-7b4a-47bb-b64e-71de754c3dac
394	394	0	GBIF Germany	4f6826f2-4ff6-443d-b966-e6913bd24013	759e7214-f762-11e1-a439-00145eb45e9a
3	3	0	GBIF Germany	4f6826f2-4ff6-443d-b966-e6913bd24013	7887531a-f762-11e1-a439-00145eb45e9a
3	3	0	GBIF Germany	4f6826f2-4ff6-443d-b966-e6913bd24013	788b4cd6-f762-11e1-a439-00145eb45e9a
0	9	9	Plazi	ffb07bec-2d10-492d-9c37-361fe0b79427	78c81fd2-99ee-4534-9776-40969214c3ce
0	4727	4727	U.S. Geological Survey	8618c64a-93e0-4300-b546-7249e5148ed2	7afb6dbd-6485-42c2-aee7-c730bd81d2cd
4	4	0	Plazi	ffb07bec-2d10-492d-9c37-361fe0b79427	7afd8925-20e8-493e-beff-a3ae013cba36
885	885	0	Ocean Biodiversity Information System	ba0670b9-4186-41e6-8e70-f9cb3065551a	7b68f20a-f762-11e1-a439-00145eb45e9a
51973	51973	0	GBIF Germany	4f6826f2-4ff6-443d-b966-e6913bd24013	7b9a08ea-f762-11e1-a439-00145eb45e9a
1	1	0	Indonesian Biodiversity Information Facility	2ebd91f6-f14f-4375-b525-c011a3774f03	7c133c01-f2a9-4d40-b346-d37ae2a041b4
0	2402	2402	Belgian Biodiversity Platform	fb11cfe1-ebc3-45af-9159-17d9fddbcdac	7c4621d3-7b86-4c99-a14e-ff8b3fce5c10
2933	2933	0	GBIF Germany	4f6826f2-4ff6-443d-b966-e6913bd24013	7c61a558-f762-11e1-a439-00145eb45e9a
1	1	0	Plazi	ffb07bec-2d10-492d-9c37-361fe0b79427	7d0a2b56-968d-4ed2-b07c-d8ac142ae7ba
0	45	45	Ocean Biodiversity Information System	ba0670b9-4186-41e6-8e70-f9cb3065551a	7d8c41b9-1df1-43e3-a1e7-4648671afd67
1227	1227	0	GBIF Germany	4f6826f2-4ff6-443d-b966-e6913bd24013	7e7941e8-f762-11e1-a439-00145eb45e9a
18	18	0	Plazi	ffb07bec-2d10-492d-9c37-361fe0b79427	7f8d997c-35ae-48dc-a874-53597ec2223b
453	453	0	GBIF France	da44cd31-5901-4687-a106-6d1c7734ee3a	7ffaecd1-e922-4202-82ce-a7d270be7479
2	2	0	GBIF Japan	db5705aa-6a6e-42f1-8942-d77b9f4896ea	80d816bc-f762-11e1-a439-00145eb45e9a
3889	3889	0	GBIF Argentina	2426a871-9feb-40a1-96c6-0c593a76b835	80faa258-c22e-4c99-af1a-29fa6d65e2cb
178	178	0	GBIF Germany	4f6826f2-4ff6-443d-b966-e6913bd24013	821517aa-f762-11e1-a439-00145eb45e9a
670	670	0	GBIF Germany	4f6826f2-4ff6-443d-b966-e6913bd24013	8230d2ce-f762-11e1-a439-00145eb45e9a
2691	2691	0	U.S. Geological Survey	8618c64a-93e0-4300-b546-7249e5148ed2	83a9d9ab-b29c-4593-b88a-6243fb624be0
44501	44501	0	Canada Biodiversity Information Facility	8f83fc96-c966-4126-83f7-bf044dc49efa	844040a4-f762-11e1-a439-00145eb45e9a
165077	165077	0	GBIF Finland	dd514216-5c7c-45f3-910d-797424cb5be6	84ede380-f762-11e1-a439-00145eb45e9a
41460	41460	0	U.S. Geological Survey	8618c64a-93e0-4300-b546-7249e5148ed2	84f9770e-f762-11e1-a439-00145eb45e9a
91	91	0	Biodiversity Information System of Mexico	b324e8e9-9a4c-44fa-8f1a-7f39ea7ab576	850a1e38-f762-11e1-a439-00145eb45e9a
0	10	10	Plazi	ffb07bec-2d10-492d-9c37-361fe0b79427	858068a8-f144-4f84-9eb2-873ebc866e7f
0	60193	60193	Belgian Biodiversity Platform	fb11cfe1-ebc3-45af-9159-17d9fddbcdac	8581f44d-7373-4138-9a3f-7d7508047419
407594	407594	0	U.S. Geological Survey	8618c64a-93e0-4300-b546-7249e5148ed2	86b50d88-f762-11e1-a439-00145eb45e9a
1069	809	-260	GBIF Germany	4f6826f2-4ff6-443d-b966-e6913bd24013	86d8c214-f762-11e1-a439-00145eb45e9a
0	3	3	Plazi	ffb07bec-2d10-492d-9c37-361fe0b79427	86ed7c95-806a-4447-b904-1dd97762b405
18	18	0	GBIF Germany	4f6826f2-4ff6-443d-b966-e6913bd24013	887cf5d6-f762-11e1-a439-00145eb45e9a
12	12	0	GBIF Germany	4f6826f2-4ff6-443d-b966-e6913bd24013	888113e6-f762-11e1-a439-00145eb45e9a
0	2	2	Participant Node Managers Committee	7f48e0c8-5c96-49ec-b972-30748e339115	89d62481-9040-408a-a26b-0c9d71a19bf2
55	40	-15	GBIF Germany	4f6826f2-4ff6-443d-b966-e6913bd24013	8d3208e6-f762-11e1-a439-00145eb45e9a
83	83	0	GBIF Germany	4f6826f2-4ff6-443d-b966-e6913bd24013	8d4e48c6-f762-11e1-a439-00145eb45e9a
0	819	819	Ocean Biodiversity Information System	ba0670b9-4186-41e6-8e70-f9cb3065551a	8e72dea0-9356-4915-af4b-c9241d829615
23	23	0	Plazi	ffb07bec-2d10-492d-9c37-361fe0b79427	90d9193f-91f3-4118-81a1-d4c6a05d2d1f
37	37	0	Plazi	ffb07bec-2d10-492d-9c37-361fe0b79427	915c6879-9c9e-489c-88a2-dba3d0db940a
2832	2465	-367	GBIF Germany	4f6826f2-4ff6-443d-b966-e6913bd24013	91b20394-f762-11e1-a439-00145eb45e9a
544	544	0	GBIF Germany	4f6826f2-4ff6-443d-b966-e6913bd24013	921d75e8-f762-11e1-a439-00145eb45e9a
2	2	0	Plazi	ffb07bec-2d10-492d-9c37-361fe0b79427	92c8b1bd-65cf-4017-84ff-0efd3ad54eae
2699	2699	0	GBIF Germany	4f6826f2-4ff6-443d-b966-e6913bd24013	93098046-f762-11e1-a439-00145eb45e9a
58	59	1	GBIF Germany	4f6826f2-4ff6-443d-b966-e6913bd24013	933c3c5c-f762-11e1-a439-00145eb45e9a
526	526	0	U.S. Geological Survey	8618c64a-93e0-4300-b546-7249e5148ed2	95b438a4-f762-11e1-a439-00145eb45e9a
0	4	4	Plazi	ffb07bec-2d10-492d-9c37-361fe0b79427	961005ea-456f-43fe-8aa6-2d616e80774c
156	156	0	Atlas of Living Australia	4a6f1b71-969e-4fc5-a693-282b05e1220c	969feb14-f762-11e1-a439-00145eb45e9a
33	33	0	GBIF Germany	4f6826f2-4ff6-443d-b966-e6913bd24013	976a7514-f762-11e1-a439-00145eb45e9a
6	6	0	Plazi	ffb07bec-2d10-492d-9c37-361fe0b79427	98af7895-c4b5-4a39-9fec-67965f6912b4
259	259	0	Plazi	ffb07bec-2d10-492d-9c37-361fe0b79427	9d2bb551-2708-455d-8252-8cb1e800a9a5
57	57	0	Plazi	ffb07bec-2d10-492d-9c37-361fe0b79427	9de070ed-9c35-4131-a350-72371ee93ddf
4	4	0	Plazi	ffb07bec-2d10-492d-9c37-361fe0b79427	9e438b7f-8915-4359-828a-35910065f056
95	95	0	Biodiversity Information System of Mexico	b324e8e9-9a4c-44fa-8f1a-7f39ea7ab576	9e482772-4281-4f7e-a8bc-a2501366588b
0	434542	434542	GBIF Japan	db5705aa-6a6e-42f1-8942-d77b9f4896ea	9fa532c7-5543-4a8e-a281-bf5bee9ad1db
0	6	6	Ocean Biodiversity Information System	ba0670b9-4186-41e6-8e70-f9cb3065551a	a29c1f52-3f24-42f5-8d9f-b29e731923eb
0	501	501	Plazi	ffb07bec-2d10-492d-9c37-361fe0b79427	a2aef684-44f1-429d-9dd5-dd394539fa36
92374	92374	0	GBIF Portugal	673f7038-4262-4149-b753-5658a4e912f6	a559e942-0fbe-4f09-93ca-28cf244ce2a0
0	1849	1849	Ocean Biodiversity Information System	ba0670b9-4186-41e6-8e70-f9cb3065551a	aadd4f01-b9dd-4b7a-9389-0e9f36f9ccdf
112	112	0	Plazi	ffb07bec-2d10-492d-9c37-361fe0b79427	ac743694-3c75-4efe-82b1-1c49797b3323
0	35684	35684	Ocean Biodiversity Information System	ba0670b9-4186-41e6-8e70-f9cb3065551a	af5fdf89-bde4-475b-8f07-21ecdaf63a44
124	124	0	National Biodiversity Network	d897a5b9-35ee-4232-94bd-b0bcaac003c2	afd93eed-df6e-452d-b3f0-a9aada4cab8b
2	2	0	Plazi	ffb07bec-2d10-492d-9c37-361fe0b79427	b3b53404-5f24-4055-8ecf-28f7b38968f6
0	3	3	Plazi	ffb07bec-2d10-492d-9c37-361fe0b79427	b625533e-b513-47cf-9933-a0401f06fe4e
97931	103638	5707	U.S. Geological Survey	8618c64a-93e0-4300-b546-7249e5148ed2	bb71d4cb-6cc3-4730-a170-82912cc84475
8	8	0	Plazi	ffb07bec-2d10-492d-9c37-361fe0b79427	bd6c0211-6670-46b8-9876-9903c49d6225
23	23	0	Plazi	ffb07bec-2d10-492d-9c37-361fe0b79427	bdf2db84-05b5-4c94-bfa7-7cf9274fda9b
0	103	103	Plazi	ffb07bec-2d10-492d-9c37-361fe0b79427	be91818f-5889-4e51-82b9-ab9b2a5e3445
0	114	114	Biodiversity Information System of Mexico	b324e8e9-9a4c-44fa-8f1a-7f39ea7ab576	c22d4068-af5e-4f0a-94da-924818d32817
120	120	0	GBIF France	da44cd31-5901-4687-a106-6d1c7734ee3a	c2f7743d-85e2-46c2-87f6-975fba152250
43	43	0	Plazi	ffb07bec-2d10-492d-9c37-361fe0b79427	c39f6757-32a1-4f98-a45e-5e4910776b0f
2	2	0	Plazi	ffb07bec-2d10-492d-9c37-361fe0b79427	c5a9d761-efbd-4864-b696-8f349dde3e30
4	4	0	Plazi	ffb07bec-2d10-492d-9c37-361fe0b79427	c729d6d8-9f82-4bd9-8e95-5443833b4779
16246	16246	0	GBIF Japan	db5705aa-6a6e-42f1-8942-d77b9f4896ea	c81d08e2-e648-4ffc-aec9-35ca10e570bb
96	96	0	GBIF Chile	a8b16421-d80b-4ef3-8f22-098b01a89255	ca11ce6d-78fd-4d35-aeb9-0c0b2e7d3433
765	765	0	GBIF Argentina	2426a871-9feb-40a1-96c6-0c593a76b835	cc47cd0b-7cdb-452d-b41c-c3e340092c09
12	12	0	Plazi	ffb07bec-2d10-492d-9c37-361fe0b79427	cc93f69a-aa7f-4ddc-bbd7-b003a85fbb81
48	48	0	Plazi	ffb07bec-2d10-492d-9c37-361fe0b79427	ce5d3e24-560d-4fbd-ac87-8da9b32afeba
1479	1479	0	GBIF France	da44cd31-5901-4687-a106-6d1c7734ee3a	d08434a4-0732-473c-ae3e-bce487e2adf6
75000	104700	29700	South African Biodiversity Information Facility	7190b835-4e86-4b6e-85c1-19cc6677c250	d0963cee-1a29-47a2-b9bf-fb0e7690077c
0	152	152	Plazi	ffb07bec-2d10-492d-9c37-361fe0b79427	d2046a1e-a3a5-46f6-ab00-906b77e825e5
0	30	30	Plazi	ffb07bec-2d10-492d-9c37-361fe0b79427	d7c4f18e-5da6-4627-9da9-c4697feb5414
171	171	0	Plazi	ffb07bec-2d10-492d-9c37-361fe0b79427	d7e68b70-b0ee-4914-b1b6-5fa7317ad51b
0	650	650	GBIF Japan	db5705aa-6a6e-42f1-8942-d77b9f4896ea	d855188a-bbd9-49d9-9c45-417893b0dceb
525	525	0	Plazi	ffb07bec-2d10-492d-9c37-361fe0b79427	d89af63d-c093-4908-bd61-2b26133bb7d6
840	840	0	GBIF France	da44cd31-5901-4687-a106-6d1c7734ee3a	dca20cae-9fd8-404e-8024-30e697eb3024
0	1	1	Plazi	ffb07bec-2d10-492d-9c37-361fe0b79427	ded2e88a-0628-477a-aa4a-2aa9662561b3
2896	2896	0	Participant Node Managers Committee	7f48e0c8-5c96-49ec-b972-30748e339115	def5a43e-0e85-4789-9c0a-35c23ac90879
0	64903	64903	U.S. Geological Survey	8618c64a-93e0-4300-b546-7249e5148ed2	e0b59ee7-19ae-4eb0-9217-33317fb50d47
0	11100	11100	Ocean Biodiversity Information System	ba0670b9-4186-41e6-8e70-f9cb3065551a	e1e33f62-d1ae-4e1d-89a2-9c6fc6a092e7
648	648	0	GBIF France	da44cd31-5901-4687-a106-6d1c7734ee3a	e43d91a4-582c-4613-8546-c13e836f9c79
8	8	0	Plazi	ffb07bec-2d10-492d-9c37-361fe0b79427	e4768fad-87fb-4d93-a920-33a84e48c7c1
14	14	0	Plazi	ffb07bec-2d10-492d-9c37-361fe0b79427	e7d164f6-b22c-4120-b1f6-6464cfc6de0b
16774	16774	0	GBIF Norway	4f829580-180d-46a9-9c87-ed8ec959b545	e7f1c38e-2a85-4c6e-80aa-d052766a916f
0	3	3	Plazi	ffb07bec-2d10-492d-9c37-361fe0b79427	eac2a9dc-45bc-42cf-b071-55ac778e4450
0	2	2	Plazi	ffb07bec-2d10-492d-9c37-361fe0b79427	eccbb6a0-10f0-495c-862e-528293df9ac6
2	2	0	Plazi	ffb07bec-2d10-492d-9c37-361fe0b79427	ed6285e1-bb66-4121-8dbb-fefa0cbcdc31
55	55	0	Plazi	ffb07bec-2d10-492d-9c37-361fe0b79427	edb59612-5977-43c4-bbc1-602cd58a2bd2
369	369	0	Colombian Biodiversity Information System	7e865cba-7c46-417b-ade5-97f2cf5b7be0	ee0cf104-84bc-4f32-8e3e-a349537766db
95	95	0	Plazi	ffb07bec-2d10-492d-9c37-361fe0b79427	ee3428d1-9e3b-495d-99a5-e61ea679b5e9
4	4	0	Plazi	ffb07bec-2d10-492d-9c37-361fe0b79427	ee8652f1-7d15-4131-b652-24aa0d5fa269
169	169	0	GBIF Germany	4f6826f2-4ff6-443d-b966-e6913bd24013	f1e88cf1-b6e6-40ea-8f91-2fade5d20f2c
0	2443	2443	Korean Biodiversity Information Facility	e0a1e772-0177-4800-94b4-2d023fe6cdf4	f1ef321f-8cde-4e84-b771-0317c61b2820
0	1	1	Plazi	ffb07bec-2d10-492d-9c37-361fe0b79427	f49cd992-5bff-4957-8e2c-a52adff778bf
20	20	0	Colombian Biodiversity Information System	7e865cba-7c46-417b-ade5-97f2cf5b7be0	f58fbdad-3d5b-4cd2-a83f-753e19cb92b9
5	5	0	Plazi	ffb07bec-2d10-492d-9c37-361fe0b79427	f5fe2fa9-6860-449f-9ac1-3b9404252f7f
6234	6234	0	GBIF Germany	4f6826f2-4ff6-443d-b966-e6913bd24013	fa2b0c5a-d609-433f-9534-5d0032b38eaa
0	505	505	GBIF New Zealand	4f9fd726-20dd-445e-89a1-8ed93792276f	fc05a931-fdbc-4a77-9a13-2487418d60d5
47	47	0	Plazi	ffb07bec-2d10-492d-9c37-361fe0b79427	fe001114-35af-46d5-bab4-4ab21689cdc6
0	134	134	Participant Node Managers Committee	7f48e0c8-5c96-49ec-b972-30748e339115	fe05ad05-cfe4-42d0-b66f-cd408869fbac
0	3	3	Plazi	ffb07bec-2d10-492d-9c37-361fe0b79427	024ed081-5dff-4cd4-a12a-201e4cc78f2c
185	185	0	GBIF Sweden	a0b3be64-6525-4387-ac67-a499950f92e1	0294ccfd-ff43-4bbd-a8de-e1bf9a91e79a
0	103	103	Ocean Biodiversity Information System	ba0670b9-4186-41e6-8e70-f9cb3065551a	04e658da-8168-4e5b-815f-aa4cc096b402
20	20	0	GBIF France	da44cd31-5901-4687-a106-6d1c7734ee3a	08a4a865-0949-4b68-9295-4d84498e6bb3
2147	2147	0	GBIF Germany	4f6826f2-4ff6-443d-b966-e6913bd24013	08b4e00f-720d-4ae9-9d45-6277f9576c02
14	14	0	Plazi	ffb07bec-2d10-492d-9c37-361fe0b79427	0a75e36a-4254-44be-9a1a-2c2bc6f115fa
0	994	994	Participant Node Managers Committee	7f48e0c8-5c96-49ec-b972-30748e339115	0aa2d11f-1e65-43ec-a579-3129cefa194b
784	784	0	Colombian Biodiversity Information System	7e865cba-7c46-417b-ade5-97f2cf5b7be0	0abbca06-0bb5-4d03-9542-7fee04b1f759
179	179	0	Colombian Biodiversity Information System	7e865cba-7c46-417b-ade5-97f2cf5b7be0	0b73a5a1-4aab-4a2a-b865-36ff6aa9a60b
0	4	4	Plazi	ffb07bec-2d10-492d-9c37-361fe0b79427	0ecd8581-b443-4f28-8cd6-395ade9cb559
226	226	0	Plazi	ffb07bec-2d10-492d-9c37-361fe0b79427	108a5b4b-23db-4b34-93a3-7effb973414e
66	66	0	Colombian Biodiversity Information System	7e865cba-7c46-417b-ade5-97f2cf5b7be0	1af7b746-b98a-4227-9a96-b3ef26200be2
2389	2389	0	GBIF Spain	1f94b3ca-9345-4d65-afe2-4bace93aa0fe	1ea32a69-06ec-48d4-9b00-6e954ceb7828
2	2	0	Plazi	ffb07bec-2d10-492d-9c37-361fe0b79427	1eaf4800-94f1-4618-9d58-a6b71724d11b
1	1	0	Plazi	ffb07bec-2d10-492d-9c37-361fe0b79427	1ebf1268-4c1b-437b-a1a5-997235d75d7d
29	29	0	Plazi	ffb07bec-2d10-492d-9c37-361fe0b79427	1fc6a5fd-49a4-4687-acc7-259f3d8a4f54
0	15	15	Ocean Biodiversity Information System	ba0670b9-4186-41e6-8e70-f9cb3065551a	233ec9c0-ef02-4516-8a08-4477be375680
179	179	0	GBIF Argentina	2426a871-9feb-40a1-96c6-0c593a76b835	2730d812-acea-4a45-940d-66e40bf96a45
9	9	0	Plazi	ffb07bec-2d10-492d-9c37-361fe0b79427	2bb0a745-07bd-4df6-99e7-4d8a6b242aa5
133	133	0	Colombian Biodiversity Information System	7e865cba-7c46-417b-ade5-97f2cf5b7be0	2ca1c052-4c80-4eb6-96b8-e71b9f761b36
1004	1004	0	GBIF France	da44cd31-5901-4687-a106-6d1c7734ee3a	2ce977ed-eb2f-4f47-811f-514e326bea26
54792	54792	0	Participant Node Managers Committee	7f48e0c8-5c96-49ec-b972-30748e339115	2d684bb5-ea11-4709-ae12-8fc0a800287f
1759	1759	0	GBIF Benin	efb9c00e-f802-45dd-8826-a52ec45b89ff	2dca5fbd-1989-4634-b745-269ff1098ebf
254	254	0	Colombian Biodiversity Information System	7e865cba-7c46-417b-ade5-97f2cf5b7be0	2e44347f-9b43-4487-b3df-90e6beb31f62
254056	256036	1980	GBIF Brazil	cdc9736d-5ff7-4ece-9959-3c744360cdb3	2e684fd6-09e2-4661-910a-0a188b610c04
1855	1855	0	GBIF Japan	db5705aa-6a6e-42f1-8942-d77b9f4896ea	301b8100-b71b-467c-8f69-e9fdc8cf3b73
0	136	136	Plazi	ffb07bec-2d10-492d-9c37-361fe0b79427	302813c6-fb6d-4142-b635-4d0a1e18fb27
320	320	0	GBIF France	da44cd31-5901-4687-a106-6d1c7734ee3a	304d9604-b355-43b9-be0b-623b1711cd5e
73	73	0	GBIF France	da44cd31-5901-4687-a106-6d1c7734ee3a	328eec3d-9c75-40a6-9380-2757331d5767
0	1589	1589	Participant Node Managers Committee	7f48e0c8-5c96-49ec-b972-30748e339115	330ead6c-1af1-44ea-ba70-dc778a6c167b
6992	6992	0	National Biodiversity Network	d897a5b9-35ee-4232-94bd-b0bcaac003c2	369792d2-c509-4971-b6c5-0dffca53037e
3769	3769	0	U.S. Geological Survey	8618c64a-93e0-4300-b546-7249e5148ed2	39f021d5-240c-445d-b62f-33bfed94938d
1905	1905	0	GBIF Israel	8cb55387-7802-40e8-86d6-d357a583c596	3ba389d4-488b-4f0c-86e9-8d275aa16eae
14	14	0	Biodiversity Information System of Mexico	b324e8e9-9a4c-44fa-8f1a-7f39ea7ab576	3d80a83c-407a-4d67-bff3-896bcb418cca
134	134	0	Plazi	ffb07bec-2d10-492d-9c37-361fe0b79427	43393d12-25cb-499b-9cf1-83d60aded671
0	32	32	Plazi	ffb07bec-2d10-492d-9c37-361fe0b79427	4559cb92-0d2b-4505-9e00-976d716e5f60
0	2	2	Plazi	ffb07bec-2d10-492d-9c37-361fe0b79427	45803d56-d8ad-49c1-b1fe-0fc8411bf58b
17	17	0	National Biodiversity Network	d897a5b9-35ee-4232-94bd-b0bcaac003c2	466c64f7-fd94-400c-b29a-e3b09b26af79
1006	1006	0	Atlas of Living Australia	4a6f1b71-969e-4fc5-a693-282b05e1220c	4677560c-a8d9-4e3e-b883-d3c6d97ded49
172	172	0	Plazi	ffb07bec-2d10-492d-9c37-361fe0b79427	4b57ed78-9e9f-4dbf-aa3b-f518c1639005
4	4	0	Plazi	ffb07bec-2d10-492d-9c37-361fe0b79427	4b9aceb3-df9f-495a-9299-84f70c3f00e2
72	72	0	Biodiversity Information System of Mexico	b324e8e9-9a4c-44fa-8f1a-7f39ea7ab576	4dc45aea-124e-43fe-aa0b-884a93164eaa
220	220	0	GBIF France	da44cd31-5901-4687-a106-6d1c7734ee3a	51210d9e-3f1c-47f2-9d3d-8454f44a26fe
1	1	0	Plazi	ffb07bec-2d10-492d-9c37-361fe0b79427	53b96271-789f-4155-aa9f-995572842e98
2	2	0	Plazi	ffb07bec-2d10-492d-9c37-361fe0b79427	59038a71-375b-4d53-80ac-d2f94b85e6d2
0	3	3	Plazi	ffb07bec-2d10-492d-9c37-361fe0b79427	5ad283ed-8f49-4284-9c96-86f2980804cf
11	11	0	Plazi	ffb07bec-2d10-492d-9c37-361fe0b79427	5af53e5e-f5c9-431e-9a99-242b0afba244
0	23	23	Plazi	ffb07bec-2d10-492d-9c37-361fe0b79427	5b6e22ed-ee96-4fa0-990b-0e8f78961670
261	261	0	Plazi	ffb07bec-2d10-492d-9c37-361fe0b79427	5f2a3918-af89-448e-be80-ee65faccff7c
6	6	0	Colombian Biodiversity Information System	7e865cba-7c46-417b-ade5-97f2cf5b7be0	606b838a-075e-48ee-8b17-6b5e925c1ee9
52	52	0	Colombian Biodiversity Information System	7e865cba-7c46-417b-ade5-97f2cf5b7be0	61713fd3-9378-4b69-b3a7-7b4186428502
76	76	0	GBIF Germany	4f6826f2-4ff6-443d-b966-e6913bd24013	6181d00a-f762-11e1-a439-00145eb45e9a
375	375	0	GBIF Germany	4f6826f2-4ff6-443d-b966-e6913bd24013	619b7e4c-f762-11e1-a439-00145eb45e9a
26	26	0	GBIF Germany	4f6826f2-4ff6-443d-b966-e6913bd24013	61e42bd8-f762-11e1-a439-00145eb45e9a
62	62	0	GBIF Germany	4f6826f2-4ff6-443d-b966-e6913bd24013	62155be0-f762-11e1-a439-00145eb45e9a
217	217	0	Plazi	ffb07bec-2d10-492d-9c37-361fe0b79427	627475fb-1f23-40a1-9ca1-eea335a3aac9
174	174	0	GBIF Spain	1f94b3ca-9345-4d65-afe2-4bace93aa0fe	635d1600-f762-11e1-a439-00145eb45e9a
129	129	0	GBIF Germany	4f6826f2-4ff6-443d-b966-e6913bd24013	63e2fb9e-f762-11e1-a439-00145eb45e9a
725	725	0	GBIF France	da44cd31-5901-4687-a106-6d1c7734ee3a	63e931fa-27df-439a-81d7-c7d1cee50197
30004	42004	12000	GBIF Japan	db5705aa-6a6e-42f1-8942-d77b9f4896ea	652d4247-3120-477e-bbf4-75ab04efe1c0
0	87	87	Plazi	ffb07bec-2d10-492d-9c37-361fe0b79427	65541536-7dc5-42cd-bc83-e41093d93ce0
338	344	6	GBIF Germany	4f6826f2-4ff6-443d-b966-e6913bd24013	65628d86-f762-11e1-a439-00145eb45e9a
311	311	0	GBIF Germany	4f6826f2-4ff6-443d-b966-e6913bd24013	6563b65c-f762-11e1-a439-00145eb45e9a
63	63	0	GBIF Germany	4f6826f2-4ff6-443d-b966-e6913bd24013	66b895ea-f762-11e1-a439-00145eb45e9a
74	74	0	GBIF Germany	4f6826f2-4ff6-443d-b966-e6913bd24013	676e32ce-f762-11e1-a439-00145eb45e9a
161	161	0	GBIF Germany	4f6826f2-4ff6-443d-b966-e6913bd24013	67e4b584-f762-11e1-a439-00145eb45e9a
58	58	0	GBIF Germany	4f6826f2-4ff6-443d-b966-e6913bd24013	67ed84a2-f762-11e1-a439-00145eb45e9a
265	265	0	GBIF Germany	4f6826f2-4ff6-443d-b966-e6913bd24013	682dac26-f762-11e1-a439-00145eb45e9a
71	71	0	GBIF Germany	4f6826f2-4ff6-443d-b966-e6913bd24013	6908f696-f762-11e1-a439-00145eb45e9a
34	34	0	GBIF Germany	4f6826f2-4ff6-443d-b966-e6913bd24013	6b6a1852-f762-11e1-a439-00145eb45e9a
12	12	0	GBIF Germany	4f6826f2-4ff6-443d-b966-e6913bd24013	6bcc5fa8-f762-11e1-a439-00145eb45e9a
292	292	0	Plazi	ffb07bec-2d10-492d-9c37-361fe0b79427	6bed073a-175c-42e6-bb99-645c99d55b4f
0	77	77	Colombian Biodiversity Information System	7e865cba-7c46-417b-ade5-97f2cf5b7be0	6cbe9af0-f0ae-4caa-aaac-f4e3aab6f98f
1	1	0	GBIF Japan	db5705aa-6a6e-42f1-8942-d77b9f4896ea	6d15c108-3d25-43a8-904f-8e631f71ec43
6	6	0	Plazi	ffb07bec-2d10-492d-9c37-361fe0b79427	6f171b80-465d-4b71-b931-c0c18c9e244d
0	7	7	Plazi	ffb07bec-2d10-492d-9c37-361fe0b79427	70001fcf-fff4-4a71-b7ee-5be2044c7ccc
21	21	0	GBIF Germany	4f6826f2-4ff6-443d-b966-e6913bd24013	703dae7a-f762-11e1-a439-00145eb45e9a
52	43	-9	GBIF Germany	4f6826f2-4ff6-443d-b966-e6913bd24013	70d8eafc-f762-11e1-a439-00145eb45e9a
167	167	0	GBIF France	da44cd31-5901-4687-a106-6d1c7734ee3a	715e4ebc-877f-454b-b117-cb5a3700140e
4338	4338	0	GBIF Germany	4f6826f2-4ff6-443d-b966-e6913bd24013	72006b62-f762-11e1-a439-00145eb45e9a
49	49	0	Plazi	ffb07bec-2d10-492d-9c37-361fe0b79427	73be5c96-5c26-4eac-8bbd-2648f8d41b4d
26	26	0	Plazi	ffb07bec-2d10-492d-9c37-361fe0b79427	74aa32b8-fb79-4925-b474-f33938b3f57c
18	18	0	GBIF Germany	4f6826f2-4ff6-443d-b966-e6913bd24013	755456f2-f762-11e1-a439-00145eb45e9a
420	330	-90	GBIF Germany	4f6826f2-4ff6-443d-b966-e6913bd24013	799f6bf2-f762-11e1-a439-00145eb45e9a
758	758	0	Korean Biodiversity Information Facility	e0a1e772-0177-4800-94b4-2d023fe6cdf4	7b1fab40-f762-11e1-a439-00145eb45e9a
447	447	0	Ocean Biodiversity Information System	ba0670b9-4186-41e6-8e70-f9cb3065551a	7b42aea6-f762-11e1-a439-00145eb45e9a
752	128	-624	GBIF Germany	4f6826f2-4ff6-443d-b966-e6913bd24013	7d44a3f8-f762-11e1-a439-00145eb45e9a
1441	1441	0	Colombian Biodiversity Information System	7e865cba-7c46-417b-ade5-97f2cf5b7be0	7d5c8ab2-3d20-46e3-b4d4-d6308bd3e5b8
8525	8525	0	BioCASE	d8bbf693-a180-4995-94fe-6130795dcf2f	7db4f705-61ae-4c6e-9de2-06674e7d46b2
723	723	0	GBIF Germany	4f6826f2-4ff6-443d-b966-e6913bd24013	7e4e26e8-f762-11e1-a439-00145eb45e9a
21	21	0	Plazi	ffb07bec-2d10-492d-9c37-361fe0b79427	7e5b5624-cb34-457f-b588-2f20485c3de5
2444	2449	5	GBIF Germany	4f6826f2-4ff6-443d-b966-e6913bd24013	7f18f85a-f762-11e1-a439-00145eb45e9a
0	5	5	Plazi	ffb07bec-2d10-492d-9c37-361fe0b79427	7f1b74fb-18b4-4d88-bd9e-cddd52d09f07
6	6	0	Plazi	ffb07bec-2d10-492d-9c37-361fe0b79427	7f28b0ed-becc-4fcb-bb7e-5432ff0af7ce
899	899	0	Biodiversity Information System of Mexico	b324e8e9-9a4c-44fa-8f1a-7f39ea7ab576	7f6267a6-f762-11e1-a439-00145eb45e9a
15774	15774	0	GBIF Japan	db5705aa-6a6e-42f1-8942-d77b9f4896ea	81037ec4-f762-11e1-a439-00145eb45e9a
5	5	0	GBIF Germany	4f6826f2-4ff6-443d-b966-e6913bd24013	81bdb8e8-f762-11e1-a439-00145eb45e9a
15936	15936	0	GBIF Japan	db5705aa-6a6e-42f1-8942-d77b9f4896ea	843bf094-d0d8-4864-b668-86cd45d2af79
1135	1135	0	National Biodiversity Data Centre	422b00b2-6c94-4bb6-976b-c359916efdb8	870afa50-180e-4153-b1b7-ec437ede20cb
16	16	0	Plazi	ffb07bec-2d10-492d-9c37-361fe0b79427	8748e38c-b56e-431a-9d19-7578f630f55c
3814	4561	747	GBIF Japan	db5705aa-6a6e-42f1-8942-d77b9f4896ea	8812c25a-753a-4616-9676-8dd1cf04bae1
504	425	-79	GBIF Germany	4f6826f2-4ff6-443d-b966-e6913bd24013	88196228-f762-11e1-a439-00145eb45e9a
14	14	0	GBIF Germany	4f6826f2-4ff6-443d-b966-e6913bd24013	886e89ce-f762-11e1-a439-00145eb45e9a
448	448	0	GBIF Germany	4f6826f2-4ff6-443d-b966-e6913bd24013	892a1d74-f762-11e1-a439-00145eb45e9a
46	46	0	GBIF Germany	4f6826f2-4ff6-443d-b966-e6913bd24013	8a943492-f762-11e1-a439-00145eb45e9a
153	153	0	GBIF Germany	4f6826f2-4ff6-443d-b966-e6913bd24013	8ab49566-f762-11e1-a439-00145eb45e9a
134	134	0	GBIF Germany	4f6826f2-4ff6-443d-b966-e6913bd24013	8ad37f44-f762-11e1-a439-00145eb45e9a
4	4	0	GBIF Germany	4f6826f2-4ff6-443d-b966-e6913bd24013	8baaef74-f762-11e1-a439-00145eb45e9a
71	71	0	GBIF Germany	4f6826f2-4ff6-443d-b966-e6913bd24013	8c69115c-f762-11e1-a439-00145eb45e9a
309	288	-21	GBIF Germany	4f6826f2-4ff6-443d-b966-e6913bd24013	8d9075ca-f762-11e1-a439-00145eb45e9a
6568	1716	-4852	GBIF Germany	4f6826f2-4ff6-443d-b966-e6913bd24013	8e06e296-f762-11e1-a439-00145eb45e9a
48	22	-26	GBIF Germany	4f6826f2-4ff6-443d-b966-e6913bd24013	8e4783dc-f762-11e1-a439-00145eb45e9a
202	181	-21	GBIF Germany	4f6826f2-4ff6-443d-b966-e6913bd24013	8e6804c2-f762-11e1-a439-00145eb45e9a
153	154	1	Biodiversity Information System of Mexico	b324e8e9-9a4c-44fa-8f1a-7f39ea7ab576	8ed51d29-5aeb-41c6-a35f-b3fa09bacb6f
12	12	0	Colombian Biodiversity Information System	7e865cba-7c46-417b-ade5-97f2cf5b7be0	8ed7d410-fcf5-4ebb-90dc-f60e750c387b
270	99	-171	GBIF Germany	4f6826f2-4ff6-443d-b966-e6913bd24013	8f49c650-f762-11e1-a439-00145eb45e9a
116	78	-38	GBIF Germany	4f6826f2-4ff6-443d-b966-e6913bd24013	8f89b8c8-f762-11e1-a439-00145eb45e9a
27	21	-6	GBIF Germany	4f6826f2-4ff6-443d-b966-e6913bd24013	8f9b7716-f762-11e1-a439-00145eb45e9a
125	109	-16	GBIF Germany	4f6826f2-4ff6-443d-b966-e6913bd24013	8fb1f3ba-f762-11e1-a439-00145eb45e9a
927	927	0	GBIF France	da44cd31-5901-4687-a106-6d1c7734ee3a	902941c5-ca49-4736-b28a-4627b8ca5497
782	422	-360	GBIF Germany	4f6826f2-4ff6-443d-b966-e6913bd24013	9078319c-f762-11e1-a439-00145eb45e9a
604	325	-279	GBIF Germany	4f6826f2-4ff6-443d-b966-e6913bd24013	907ae018-f762-11e1-a439-00145eb45e9a
243	243	0	Colombian Biodiversity Information System	7e865cba-7c46-417b-ade5-97f2cf5b7be0	909c04cb-3f28-4fea-bb7d-3b99a851e265
101	60	-41	GBIF Germany	4f6826f2-4ff6-443d-b966-e6913bd24013	90c9dede-f762-11e1-a439-00145eb45e9a
19	11	-8	GBIF Germany	4f6826f2-4ff6-443d-b966-e6913bd24013	90cb1f6a-f762-11e1-a439-00145eb45e9a
306	306	0	GBIF Germany	4f6826f2-4ff6-443d-b966-e6913bd24013	91b4a8ce-f762-11e1-a439-00145eb45e9a
72	61	-11	GBIF Germany	4f6826f2-4ff6-443d-b966-e6913bd24013	926ed712-f762-11e1-a439-00145eb45e9a
78	80	2	GBIF Germany	4f6826f2-4ff6-443d-b966-e6913bd24013	933d81d4-f762-11e1-a439-00145eb45e9a
15555	15554	-1	National Biodiversity Network	d897a5b9-35ee-4232-94bd-b0bcaac003c2	935e993c-d04b-43aa-b635-d2b887287fae
4	4	0	Plazi	ffb07bec-2d10-492d-9c37-361fe0b79427	95384d3c-03a2-4157-846e-06f0f6688f80
1871	1871	0	Colombian Biodiversity Information System	7e865cba-7c46-417b-ade5-97f2cf5b7be0	953c792e-1417-4d0a-97b6-b0a1d7c96f0d
124959	257647	132688	GBIF Switzerland	169eb292-376b-4cc6-8e31-9c2c432de0ad	96c5c442-f762-11e1-a439-00145eb45e9a
11	11	0	Plazi	ffb07bec-2d10-492d-9c37-361fe0b79427	996f4f67-46f8-4aad-b19d-589b76bcef03
0	180	180	Colombian Biodiversity Information System	7e865cba-7c46-417b-ade5-97f2cf5b7be0	9a556c9d-91d5-4513-92ef-009d781109b2
38	38	0	GBIF France	da44cd31-5901-4687-a106-6d1c7734ee3a	9b1ada0b-a810-41f8-a21a-115cae4fdf2c
78621	78621	0	Taiwan Biodiversity Information Facility	e1b85abc-61f9-430f-ba79-6813dec53a0f	9edd4990-4138-11de-b28f-b8a03c50a862
3999	3999	0	GBIF France	da44cd31-5901-4687-a106-6d1c7734ee3a	9fe7046f-1a63-4de3-910d-af20316133e1
833	833	0	GBIF Benin	efb9c00e-f802-45dd-8826-a52ec45b89ff	a01dc6ff-c725-4b93-87a5-83079f76ae4f
90	90	0	Participant Node Managers Committee	7f48e0c8-5c96-49ec-b972-30748e339115	a239b32e-e90d-4902-ac9f-6f72a78769d2
2012	2012	0	GBIF Germany	4f6826f2-4ff6-443d-b966-e6913bd24013	a4f50a48-f362-4b1a-bcbd-302b721f1513
0	323	323	Ocean Biodiversity Information System	ba0670b9-4186-41e6-8e70-f9cb3065551a	a6252bfc-83d6-4f06-b85c-059c4e0bfa38
19846	19846	0	GBIF Brazil	cdc9736d-5ff7-4ece-9959-3c744360cdb3	a7f1d343-b5cd-4890-bd44-72dfd4b6afb7
0	1	1	Plazi	ffb07bec-2d10-492d-9c37-361fe0b79427	aaf16860-dc63-41fa-929c-304d9c8374ba
3918	3918	0	Polish Biodiversity Information Network	2618bfdf-e194-4911-a241-80db3107bc51	ad9a17b0-ad1f-11db-9793-b8a03c50a862
159	159	0	Plazi	ffb07bec-2d10-492d-9c37-361fe0b79427	adb428f5-289d-43f0-91d6-a5da8981da8a
497	497	0	GBIF Norway	4f829580-180d-46a9-9c87-ed8ec959b545	aef3c42a-7545-439e-bf29-9e0ff95f9ae0
1	1	0	Plazi	ffb07bec-2d10-492d-9c37-361fe0b79427	af3aacd7-3b96-4295-86f4-f899ce00cbb1
0	6	6	Plazi	ffb07bec-2d10-492d-9c37-361fe0b79427	af75a762-387c-4dc9-850c-293eb7c3e15e
322	322	0	Colombian Biodiversity Information System	7e865cba-7c46-417b-ade5-97f2cf5b7be0	b00c7f09-f77a-4fa4-8b5c-58133c833033
5	5	0	Plazi	ffb07bec-2d10-492d-9c37-361fe0b79427	b1c4daf1-f32a-43c6-a428-27db733f0f8e
0	441	441	Plazi	ffb07bec-2d10-492d-9c37-361fe0b79427	b2e605e3-bf11-45a8-a175-ce716bccb00b
0	11	11	Ocean Biodiversity Information System	ba0670b9-4186-41e6-8e70-f9cb3065551a	b531b38f-071c-4d32-a644-a8822cde9374
0	141	141	Plazi	ffb07bec-2d10-492d-9c37-361fe0b79427	b829a58c-42a2-44f1-b0ad-5346289588a2
16	16	0	Plazi	ffb07bec-2d10-492d-9c37-361fe0b79427	b8e5cb85-d81c-4e7c-b22a-1ef331a1c93b
68	68	0	Tanzania Biodiversity Information Facility	abd95ca6-3959-4db9-aaa6-2de1aeecf514	b929ccda-03b1-4166-9e5b-34588339d61d
9	9	0	Plazi	ffb07bec-2d10-492d-9c37-361fe0b79427	bac6b789-4266-4dba-b10f-110b4536f47b
564	564	0	GBIF France	da44cd31-5901-4687-a106-6d1c7734ee3a	bacf5035-b9e9-43c7-930f-8e985dc3415b
3	3	0	Plazi	ffb07bec-2d10-492d-9c37-361fe0b79427	bcbe5ddd-833f-4dde-9885-cdacb4a031a2
0	13	13	Plazi	ffb07bec-2d10-492d-9c37-361fe0b79427	bceb7326-a450-4c21-a8b8-e2998cb85be3
11687	11687	0	Atlas of Living Australia	4a6f1b71-969e-4fc5-a693-282b05e1220c	bd93635d-c4ad-46ad-a285-aad2c3bfd408
0	4	4	Plazi	ffb07bec-2d10-492d-9c37-361fe0b79427	be640028-35fd-45ce-96e2-2c3a49624b81
0	433	433	Colombian Biodiversity Information System	7e865cba-7c46-417b-ade5-97f2cf5b7be0	c0b4d6ab-21e7-4e07-bb50-d49e899c46dc
0	1	1	Plazi	ffb07bec-2d10-492d-9c37-361fe0b79427	c1e0e505-4c8e-4919-961f-a9c8220372fa
2	2	0	Plazi	ffb07bec-2d10-492d-9c37-361fe0b79427	c2904d1a-f779-42b6-8459-da4ba09aed48
2	2	0	Plazi	ffb07bec-2d10-492d-9c37-361fe0b79427	c505e772-aa95-4ad9-a55d-5504131d9e07
1	1	0	Plazi	ffb07bec-2d10-492d-9c37-361fe0b79427	c7e5c6b9-4161-455a-8d91-33a81f2e9b32
7	7	0	Plazi	ffb07bec-2d10-492d-9c37-361fe0b79427	cc861f79-5aac-49a2-ba30-e4f3ca74584d
0	20	20	Plazi	ffb07bec-2d10-492d-9c37-361fe0b79427	d2a0ac89-57d0-4434-a935-2b553a1bf829
62	62	0	Ocean Biodiversity Information System	ba0670b9-4186-41e6-8e70-f9cb3065551a	d4bc99fa-705a-48fe-b4c3-248729a532de
2128	2128	0	GBIF New Zealand	4f9fd726-20dd-445e-89a1-8ed93792276f	d4bce7d2-6c5e-44c6-9382-20f130baa129
6478	6478	0	Polish Biodiversity Information Network	2618bfdf-e194-4911-a241-80db3107bc51	d53f3b70-2fe9-11de-816f-b8a03c50a862
0	7	7	Plazi	ffb07bec-2d10-492d-9c37-361fe0b79427	d5ded2a1-7d1c-4f8a-806a-b6d3d96e0632
0	174	174	Plazi	ffb07bec-2d10-492d-9c37-361fe0b79427	d63cab47-63f1-4fdc-9209-26a256c91ccb
45	45	0	GBIF Guinea	b1cd2e84-c4ba-47bd-b72a-dfd1f92dce0a	d6ab787f-5007-4af8-9bab-fad25eaf8aa4
28	28	0	Plazi	ffb07bec-2d10-492d-9c37-361fe0b79427	d9650b33-97b2-4d9c-867b-79cd628daf8f
0	42	42	Participant Node Managers Committee	7f48e0c8-5c96-49ec-b972-30748e339115	d96cb9d2-ec75-45bf-8771-849e731c685d
27	27	0	Plazi	ffb07bec-2d10-492d-9c37-361fe0b79427	dc3a6786-06ae-42d6-ab29-e84b49127537
0	5	5	Plazi	ffb07bec-2d10-492d-9c37-361fe0b79427	de96c7fb-613d-405a-9c9d-e0dc9702abbb
24	24	0	Plazi	ffb07bec-2d10-492d-9c37-361fe0b79427	e58bc271-c1e7-4a9e-bd0b-9bc798cd33bb
7626	7626	0	GBIF Germany	4f6826f2-4ff6-443d-b966-e6913bd24013	e88fdc62-ea3b-41a3-8967-b3780f602c0b
16	16	0	Plazi	ffb07bec-2d10-492d-9c37-361fe0b79427	eb1f92d6-b231-49e8-942a-23a304304304
225	225	0	GBIF Norway	4f829580-180d-46a9-9c87-ed8ec959b545	eb5df2ee-5105-4e2a-abcf-470c75e072e4
16682	1986	-14696	GBIF Norway	4f829580-180d-46a9-9c87-ed8ec959b545	ed391b37-d3d3-4efd-9419-1583c39c0c87
899	899	0	GBIF France	da44cd31-5901-4687-a106-6d1c7734ee3a	eed49c61-2085-46c4-8d4f-d2cda50fd404
141	141	0	Biodiversity Information System of Mexico	b324e8e9-9a4c-44fa-8f1a-7f39ea7ab576	ef037b0c-9525-45b3-94a7-4bc2cdbb79df
1063	1188	125	U.S. Geological Survey	8618c64a-93e0-4300-b546-7249e5148ed2	f0b88eb8-cfc1-4989-861d-30521645ce11
788	788	0	GBIF Norway	4f829580-180d-46a9-9c87-ed8ec959b545	f861b96e-76f8-4a4d-b301-ebb82eed6011
3007	3007	0	U.S. Geological Survey	8618c64a-93e0-4300-b546-7249e5148ed2	fab6edb3-9311-4219-9d32-6114125f86a1
485	485	0	GBIF France	da44cd31-5901-4687-a106-6d1c7734ee3a	fac1936d-3df3-4558-9abc-aef194482d82
15423	10701	-4722	U.S. Geological Survey	8618c64a-93e0-4300-b546-7249e5148ed2	fc65374a-64af-4131-9c4e-e206945ac0b3
75	75	0	Plazi	ffb07bec-2d10-492d-9c37-361fe0b79427	fcd016df-cea2-46ac-a537-18eb45d239e0
6958	4473	-2485	GBIF Germany	4f6826f2-4ff6-443d-b966-e6913bd24013	fcdf6a92-4123-44c7-aef4-c2c4ba39f1e0
0	47	47	Plazi	ffb07bec-2d10-492d-9c37-361fe0b79427	fcf4d8f9-10b7-4c73-836d-ebfcfb7bbfeb
11840	11840	0	U.S. Geological Survey	8618c64a-93e0-4300-b546-7249e5148ed2	017101b3-2668-4119-b6de-ddb983486f50
47090	47090	0	National Biodiversity Network	d897a5b9-35ee-4232-94bd-b0bcaac003c2	0179375d-1189-4ce4-8a1a-cad25b89435d
857	790	-67	GBIF Germany	4f6826f2-4ff6-443d-b966-e6913bd24013	01cec130-c69f-497e-ab15-0534c50e003d
0	2	2	Plazi	ffb07bec-2d10-492d-9c37-361fe0b79427	06a8b44e-787b-42fe-9098-399f9666e8af
0	2	2	Ocean Biodiversity Information System	ba0670b9-4186-41e6-8e70-f9cb3065551a	08d8700e-5b4b-4dce-8a30-ba64702b5840
0	15000	15000	South African Biodiversity Information Facility	7190b835-4e86-4b6e-85c1-19cc6677c250	0b1150c9-dfa8-4904-8bc5-b79b4e1930e6
798	798	0	Biodiversity Information System of Mexico	b324e8e9-9a4c-44fa-8f1a-7f39ea7ab576	0d348386-e88e-48eb-8d0b-4eca090a2ce0
0	3	3	Plazi	ffb07bec-2d10-492d-9c37-361fe0b79427	0eb9031f-b266-431c-8c28-477ab5a3c59a
975	975	0	GBIF Germany	4f6826f2-4ff6-443d-b966-e6913bd24013	0f205a76-6866-4ade-af02-cc9dd58770ae
1268	1292	24	GBIF Japan	db5705aa-6a6e-42f1-8942-d77b9f4896ea	1495ce24-43be-4cb7-895a-322f643ad885
130	130	0	GBIF France	da44cd31-5901-4687-a106-6d1c7734ee3a	1692dbde-c17c-4ef6-bb6d-c3ad0a375118
0	4	4	Plazi	ffb07bec-2d10-492d-9c37-361fe0b79427	1b40d80c-fac1-4bd4-a62b-a930109c91bc
384	384	0	GBIF Germany	4f6826f2-4ff6-443d-b966-e6913bd24013	1bf7a055-444d-4896-b611-e9b2c4894765
12429	12425	-4	GBIF Germany	4f6826f2-4ff6-443d-b966-e6913bd24013	1c5c3e48-7fc0-4d4f-96e6-c4df2c747f34
7	7	0	Plazi	ffb07bec-2d10-492d-9c37-361fe0b79427	1e5444f4-9e36-4413-b932-664119da19de
773	773	0	Albertine Rift Conservation Society	90a939d3-e99c-4f6d-915f-2616423b3735	28de8f2c-9737-4d46-bfc2-6d8cf2efcfee
7	7	0	Plazi	ffb07bec-2d10-492d-9c37-361fe0b79427	29c5b07d-8712-4d58-9666-850f5761b080
8	8	0	Colombian Biodiversity Information System	7e865cba-7c46-417b-ade5-97f2cf5b7be0	2cc48427-444f-4132-aaee-472bcda3c27e
243	243	0	GBIF France	da44cd31-5901-4687-a106-6d1c7734ee3a	2e0727d2-460d-4c58-9b44-f8741fd3f558
7	7	0	Plazi	ffb07bec-2d10-492d-9c37-361fe0b79427	2f8b8e31-ab43-4705-a9c3-c48851b3f61e
9	9	0	GBIF France	da44cd31-5901-4687-a106-6d1c7734ee3a	31d6eb13-a6f0-42ea-bf81-97cebca51374
0	18	18	Ocean Biodiversity Information System	ba0670b9-4186-41e6-8e70-f9cb3065551a	32d86f41-5548-44c9-9f62-350e533999e7
28	28	0	Plazi	ffb07bec-2d10-492d-9c37-361fe0b79427	3a1e4b25-1608-4a3a-9c80-84e16c937807
50407	50407	0	U.S. Geological Survey	8618c64a-93e0-4300-b546-7249e5148ed2	3a339645-d3b4-40aa-b891-f9c92dc554d8
3	3	0	Participant Node Managers Committee	7f48e0c8-5c96-49ec-b972-30748e339115	3b8b8198-742f-4521-8b2f-2326bd7b234b
3	3	0	Plazi	ffb07bec-2d10-492d-9c37-361fe0b79427	40b1fa89-7f6c-4164-8977-5503ef3d07c2
65	65	0	Plazi	ffb07bec-2d10-492d-9c37-361fe0b79427	41cc7678-9369-4e59-83ce-2c5c767dff2f
19054	19054	0	National Biodiversity Network	d897a5b9-35ee-4232-94bd-b0bcaac003c2	424509a3-e3df-4185-89c5-f25a91b17ec3
10	10	0	Plazi	ffb07bec-2d10-492d-9c37-361fe0b79427	4388d7fb-188c-402f-8fae-990a1f3dcdf4
0	12	12	Ocean Biodiversity Information System	ba0670b9-4186-41e6-8e70-f9cb3065551a	46200758-136e-48c3-ae7e-0daaaab19edd
0	565	565	Ocean Biodiversity Information System	ba0670b9-4186-41e6-8e70-f9cb3065551a	489c3fab-6a8c-46c3-831e-2eba0c4febdb
4	4	0	Plazi	ffb07bec-2d10-492d-9c37-361fe0b79427	48a19db1-f273-4336-a295-d792c21e988f
6	6	0	Plazi	ffb07bec-2d10-492d-9c37-361fe0b79427	48c2539e-c040-4dd2-8727-ddbf457664e9
0	13	13	Ocean Biodiversity Information System	ba0670b9-4186-41e6-8e70-f9cb3065551a	492d091c-9ad8-477e-98e9-5a9eeaa83d88
0	2	2	Plazi	ffb07bec-2d10-492d-9c37-361fe0b79427	49fe1a5a-f9e5-4159-a11e-ba8224e5be7b
4480	4575	95	Atlas of Living Australia	4a6f1b71-969e-4fc5-a693-282b05e1220c	4b75c0ac-f7c4-4883-942d-d1dfe6939754
0	6	6	Plazi	ffb07bec-2d10-492d-9c37-361fe0b79427	4c147515-cc03-41d4-809a-8dc3a2d79d2d
5	5	0	Plazi	ffb07bec-2d10-492d-9c37-361fe0b79427	4d1de6b1-8864-4764-9ded-da7fdd4eb9c3
0	2	2	Plazi	ffb07bec-2d10-492d-9c37-361fe0b79427	4d3ccfa0-ccd1-4cf9-8689-0b8f64a22d72
0	29	29	Plazi	ffb07bec-2d10-492d-9c37-361fe0b79427	4d5564e3-80c1-41e0-8219-d7a462e05bc2
70	70	0	GBIF France	da44cd31-5901-4687-a106-6d1c7734ee3a	4e3aa413-e8b7-4805-a6e2-1b632928130e
5030	5030	0	Ocean Biodiversity Information System	ba0670b9-4186-41e6-8e70-f9cb3065551a	4eaf3d52-fd05-4c8c-b31e-a03169738c3f
0	849	849	Participant Node Managers Committee	7f48e0c8-5c96-49ec-b972-30748e339115	4f3a73a3-ee40-42cd-b678-24516f32d56e
201	201	0	GBIF New Zealand	4f9fd726-20dd-445e-89a1-8ed93792276f	4f924fb3-95d0-4a76-a091-993fd8dae167
3546	3546	0	National Biodiversity Network	d897a5b9-35ee-4232-94bd-b0bcaac003c2	52246141-e0f3-4806-8de1-6911bc2436b8
0	11	11	Plazi	ffb07bec-2d10-492d-9c37-361fe0b79427	53d6d3e4-fd4d-4e8a-bd42-e45e51de6ea7
247	247	0	National Biodiversity Network	d897a5b9-35ee-4232-94bd-b0bcaac003c2	58b0eee7-5012-4d83-8726-3172c15a634c
26	26	0	GBIF Sweden	a0b3be64-6525-4387-ac67-a499950f92e1	58c6de21-442a-4793-a81a-eb2f72624512
1546	1546	0	GBIF France	da44cd31-5901-4687-a106-6d1c7734ee3a	5991c9f5-6f12-4e89-aff6-328f5617c5d8
0	1596	1596	Colombian Biodiversity Information System	7e865cba-7c46-417b-ade5-97f2cf5b7be0	5b7e7b64-8e97-4644-add3-864c2a4b0043
24	24	0	Plazi	ffb07bec-2d10-492d-9c37-361fe0b79427	5b8eb757-76f6-46d4-b5e8-45fb539f5e65
198	198	0	GBIF Germany	4f6826f2-4ff6-443d-b966-e6913bd24013	6146b07e-f762-11e1-a439-00145eb45e9a
54	54	0	GBIF Germany	4f6826f2-4ff6-443d-b966-e6913bd24013	625c474e-f762-11e1-a439-00145eb45e9a
97	97	0	GBIF Germany	4f6826f2-4ff6-443d-b966-e6913bd24013	625d777c-f762-11e1-a439-00145eb45e9a
58	58	0	GBIF Germany	4f6826f2-4ff6-443d-b966-e6913bd24013	627f7e12-f762-11e1-a439-00145eb45e9a
0	319	319	Tanzania Biodiversity Information Facility	abd95ca6-3959-4db9-aaa6-2de1aeecf514	631cec26-8d92-4fcc-98ba-a4ab9bcb75e7
41	41	0	Plazi	ffb07bec-2d10-492d-9c37-361fe0b79427	6342b41d-ffd8-44e1-82b8-339b0f9ce081
82	82	0	GBIF Germany	4f6826f2-4ff6-443d-b966-e6913bd24013	63b3af10-f762-11e1-a439-00145eb45e9a
5	5	0	Plazi	ffb07bec-2d10-492d-9c37-361fe0b79427	6474abd2-9cf7-4ae8-bdbc-bc34ec2a9841
0	8	8	Plazi	ffb07bec-2d10-492d-9c37-361fe0b79427	64dd8c4e-3756-4ad8-bf54-83b14ee83e85
53	54	1	GBIF Germany	4f6826f2-4ff6-443d-b966-e6913bd24013	65d021de-f762-11e1-a439-00145eb45e9a
117	117	0	GBIF Germany	4f6826f2-4ff6-443d-b966-e6913bd24013	6626438e-f762-11e1-a439-00145eb45e9a
132	132	0	GBIF Germany	4f6826f2-4ff6-443d-b966-e6913bd24013	665480f0-f762-11e1-a439-00145eb45e9a
91	91	0	GBIF Germany	4f6826f2-4ff6-443d-b966-e6913bd24013	66ab0150-f762-11e1-a439-00145eb45e9a
1	1	0	Plazi	ffb07bec-2d10-492d-9c37-361fe0b79427	68aaae91-54f3-422b-976f-3ce4870369aa
0	67	67	Ocean Biodiversity Information System	ba0670b9-4186-41e6-8e70-f9cb3065551a	692ec1bd-6c9b-4343-93cb-cc2997fe92bd
22	22	0	GBIF Germany	4f6826f2-4ff6-443d-b966-e6913bd24013	69353968-f762-11e1-a439-00145eb45e9a
42	42	0	GBIF Germany	4f6826f2-4ff6-443d-b966-e6913bd24013	6aa93c0e-f762-11e1-a439-00145eb45e9a
18	18	0	GBIF Germany	4f6826f2-4ff6-443d-b966-e6913bd24013	6b269668-f762-11e1-a439-00145eb45e9a
36	36	0	GBIF Germany	4f6826f2-4ff6-443d-b966-e6913bd24013	6c7e3980-f762-11e1-a439-00145eb45e9a
36836	36836	0	GBIF Andorra	8df8d012-8e64-4c8a-886e-521a3bdfa623	6cc66c26-4f44-470e-a8eb-b25cba1a3a39
2112490	2112490	0	National Biodiversity Network	d897a5b9-35ee-4232-94bd-b0bcaac003c2	6d56415d-b007-4273-9c74-bcd6b2467434
17	17	0	Plazi	ffb07bec-2d10-492d-9c37-361fe0b79427	6dc7a54e-751e-4d96-ba4d-c6950fd77335
8	8	0	Plazi	ffb07bec-2d10-492d-9c37-361fe0b79427	6e699de7-3402-497b-ac7d-cf031d53b703
0	145	145	Plazi	ffb07bec-2d10-492d-9c37-361fe0b79427	6e7f4e75-9f6c-43d8-bd88-4ceb637afe60
64	64	0	Plazi	ffb07bec-2d10-492d-9c37-361fe0b79427	6f4d3ace-4792-48f0-8e2c-7f03993989cc
0	48	48	Plazi	ffb07bec-2d10-492d-9c37-361fe0b79427	6f7c2191-a210-4685-98f6-7a90241131df
171	171	0	GBIF Germany	4f6826f2-4ff6-443d-b966-e6913bd24013	713d9d94-f762-11e1-a439-00145eb45e9a
123	123	0	GBIF Germany	4f6826f2-4ff6-443d-b966-e6913bd24013	7337bcc4-f762-11e1-a439-00145eb45e9a
0	7	7	Plazi	ffb07bec-2d10-492d-9c37-361fe0b79427	7392ae8e-f0ef-4ad2-af7a-03e3a3f32bdb
0	3	3	Plazi	ffb07bec-2d10-492d-9c37-361fe0b79427	73a0820d-7503-472f-8c32-3836cf5fe857
1	1	0	GBIF Germany	4f6826f2-4ff6-443d-b966-e6913bd24013	7453d58e-f762-11e1-a439-00145eb45e9a
0	7	7	Plazi	ffb07bec-2d10-492d-9c37-361fe0b79427	74608c98-0969-4e4d-a911-7f886d529b25
396	396	0	GBIF Germany	4f6826f2-4ff6-443d-b966-e6913bd24013	74d79e8c-f762-11e1-a439-00145eb45e9a
30	30	0	GBIF Germany	4f6826f2-4ff6-443d-b966-e6913bd24013	74f9cb38-f762-11e1-a439-00145eb45e9a
99	99	0	GBIF Germany	4f6826f2-4ff6-443d-b966-e6913bd24013	758ed566-f762-11e1-a439-00145eb45e9a
223	223	0	GBIF Germany	4f6826f2-4ff6-443d-b966-e6913bd24013	75c5fcd0-f762-11e1-a439-00145eb45e9a
2	2	0	GBIF Germany	4f6826f2-4ff6-443d-b966-e6913bd24013	75df5766-f762-11e1-a439-00145eb45e9a
260	260	0	GBIF Germany	4f6826f2-4ff6-443d-b966-e6913bd24013	75f76ab8-f762-11e1-a439-00145eb45e9a
161	161	0	GBIF Germany	4f6826f2-4ff6-443d-b966-e6913bd24013	75fb2afe-f762-11e1-a439-00145eb45e9a
3008	3008	0	GBIF Benin	efb9c00e-f802-45dd-8826-a52ec45b89ff	76aa53bd-5a53-4254-aac0-c7f7de211df0
330	330	0	GBIF Germany	4f6826f2-4ff6-443d-b966-e6913bd24013	773ec182-f762-11e1-a439-00145eb45e9a
16	16	0	Plazi	ffb07bec-2d10-492d-9c37-361fe0b79427	775fa0af-c6d1-4679-80cc-c756b01d1743
490	490	0	GBIF Germany	4f6826f2-4ff6-443d-b966-e6913bd24013	7767aeda-f762-11e1-a439-00145eb45e9a
28	16	-12	GBIF Germany	4f6826f2-4ff6-443d-b966-e6913bd24013	7875abd8-f762-11e1-a439-00145eb45e9a
3321	3321	0	GBIF France	da44cd31-5901-4687-a106-6d1c7734ee3a	788428e9-6026-43c6-a2c1-ef905db040af
2	2	0	Plazi	ffb07bec-2d10-492d-9c37-361fe0b79427	79684bbd-6700-4a99-a1fe-dbd69a9a6080
38884	38884	0	GBIF France	da44cd31-5901-4687-a106-6d1c7734ee3a	797a494b-96d1-4468-b3f2-f951d4deddcd
4	4	0	GBIF Germany	4f6826f2-4ff6-443d-b966-e6913bd24013	7aae2ede-f762-11e1-a439-00145eb45e9a
7583	7583	0	GBIF Japan	db5705aa-6a6e-42f1-8942-d77b9f4896ea	7ae496b8-f762-11e1-a439-00145eb45e9a
1531	1531	0	Ocean Biodiversity Information System	ba0670b9-4186-41e6-8e70-f9cb3065551a	7b488c54-f762-11e1-a439-00145eb45e9a
390	195	-195	GBIF Germany	4f6826f2-4ff6-443d-b966-e6913bd24013	7cb44736-f762-11e1-a439-00145eb45e9a
154	154	0	Plazi	ffb07bec-2d10-492d-9c37-361fe0b79427	7d3f18b4-55d4-4d57-abad-26da26d2502d
165	165	0	GBIF Germany	4f6826f2-4ff6-443d-b966-e6913bd24013	7d8810ac-f762-11e1-a439-00145eb45e9a
234	234	0	Atlas of Living Australia	4a6f1b71-969e-4fc5-a693-282b05e1220c	7f5c7c38-f762-11e1-a439-00145eb45e9a
1336	825	-511	Biodiversity Information System of Mexico	b324e8e9-9a4c-44fa-8f1a-7f39ea7ab576	7fa5dbd0-f762-11e1-a439-00145eb45e9a
64	64	0	Biodiversity Information System of Mexico	b324e8e9-9a4c-44fa-8f1a-7f39ea7ab576	807fcbc4-f762-11e1-a439-00145eb45e9a
466	466	0	GBIF Japan	db5705aa-6a6e-42f1-8942-d77b9f4896ea	80f9cd7a-f762-11e1-a439-00145eb45e9a
1287	1287	0	GBIF Germany	4f6826f2-4ff6-443d-b966-e6913bd24013	818b4192-f762-11e1-a439-00145eb45e9a
0	2	2	Plazi	ffb07bec-2d10-492d-9c37-361fe0b79427	828fe9a4-e2eb-475e-8b6b-37caa69ae0a4
1426	1426	0	Korean Biodiversity Information Facility	e0a1e772-0177-4800-94b4-2d023fe6cdf4	8306a85e-f762-11e1-a439-00145eb45e9a
39	39	0	GBIF France	da44cd31-5901-4687-a106-6d1c7734ee3a	84832801-fecb-48e2-9103-6f016bb333e8
276	276	0	Plazi	ffb07bec-2d10-492d-9c37-361fe0b79427	852c6d59-9547-436d-9f06-60fc6fd51922
1597	1597	0	GBIF Spain	1f94b3ca-9345-4d65-afe2-4bace93aa0fe	85b41bf4-f762-11e1-a439-00145eb45e9a
9083	9083	0	GBIF France	da44cd31-5901-4687-a106-6d1c7734ee3a	86bc683e-8ff2-40cc-965a-896f3f59d46f
370	284	-86	GBIF Germany	4f6826f2-4ff6-443d-b966-e6913bd24013	876d2878-f762-11e1-a439-00145eb45e9a
13	13	0	GBIF Germany	4f6826f2-4ff6-443d-b966-e6913bd24013	8894eefc-f762-11e1-a439-00145eb45e9a
31115	31115	0	National Biodiversity Network	d897a5b9-35ee-4232-94bd-b0bcaac003c2	88a3a70c-fd4b-4e01-89df-1b44b6e744f6
87075	87075	0	GBIF Spain	1f94b3ca-9345-4d65-afe2-4bace93aa0fe	88dd2d48-f762-11e1-a439-00145eb45e9a
0	5	5	Plazi	ffb07bec-2d10-492d-9c37-361fe0b79427	8922c724-e7b9-488d-b55a-a3dc8c203305
7	7	0	Plazi	ffb07bec-2d10-492d-9c37-361fe0b79427	8c295c37-8139-475d-978e-ea626e787d3c
3	3	0	GBIF Germany	4f6826f2-4ff6-443d-b966-e6913bd24013	8c36b1e4-f762-11e1-a439-00145eb45e9a
1	1	0	GBIF Germany	4f6826f2-4ff6-443d-b966-e6913bd24013	8cdaad6c-f762-11e1-a439-00145eb45e9a
1260	960	-300	GBIF Germany	4f6826f2-4ff6-443d-b966-e6913bd24013	8e93f226-f762-11e1-a439-00145eb45e9a
0	15	15	Plazi	ffb07bec-2d10-492d-9c37-361fe0b79427	8eddca4b-08a5-433a-8e3a-c89fb483818e
404	309	-95	GBIF Germany	4f6826f2-4ff6-443d-b966-e6913bd24013	9180cc52-f762-11e1-a439-00145eb45e9a
3016	1102	-1914	GBIF Germany	4f6826f2-4ff6-443d-b966-e6913bd24013	91a7738e-f762-11e1-a439-00145eb45e9a
8	8	0	GBIF Germany	4f6826f2-4ff6-443d-b966-e6913bd24013	922b4b3c-f762-11e1-a439-00145eb45e9a
16830	16830	0	GBIF Germany	4f6826f2-4ff6-443d-b966-e6913bd24013	927f77ea-c8e4-4e77-90bd-1898d5e81fb2
125	125	0	GBIF Germany	4f6826f2-4ff6-443d-b966-e6913bd24013	92851f72-f762-11e1-a439-00145eb45e9a
416	416	0	GBIF Germany	4f6826f2-4ff6-443d-b966-e6913bd24013	93b44a8a-f762-11e1-a439-00145eb45e9a
804	804	0	GBIF Germany	4f6826f2-4ff6-443d-b966-e6913bd24013	93fc9830-f762-11e1-a439-00145eb45e9a
630	630	0	GBIF Germany	4f6826f2-4ff6-443d-b966-e6913bd24013	942e878c-f762-11e1-a439-00145eb45e9a
37	37	0	GBIF Germany	4f6826f2-4ff6-443d-b966-e6913bd24013	95558c78-f762-11e1-a439-00145eb45e9a
10	9	-1	GBIF Germany	4f6826f2-4ff6-443d-b966-e6913bd24013	95774b10-f762-11e1-a439-00145eb45e9a
45	45	0	Plazi	ffb07bec-2d10-492d-9c37-361fe0b79427	95b07770-fe96-4543-a548-276bbdb6586e
2	2	0	Plazi	ffb07bec-2d10-492d-9c37-361fe0b79427	9629e519-7bd2-42e6-aea6-7d480ddd8392
99	98	-1	GBIF Germany	4f6826f2-4ff6-443d-b966-e6913bd24013	967e6160-f762-11e1-a439-00145eb45e9a
15674	15674	0	U.S. Geological Survey	8618c64a-93e0-4300-b546-7249e5148ed2	96e13e19-b9d6-46b4-bb28-5f18bcfb10d0
23	23	0	GBIF Germany	4f6826f2-4ff6-443d-b966-e6913bd24013	977bf7bc-f762-11e1-a439-00145eb45e9a
140	140	0	GBIF Germany	4f6826f2-4ff6-443d-b966-e6913bd24013	97953538-f762-11e1-a439-00145eb45e9a
437	437	0	GBIF France	da44cd31-5901-4687-a106-6d1c7734ee3a	97e82219-6ccd-4a27-891e-4b25de404fa5
1	1	0	Plazi	ffb07bec-2d10-492d-9c37-361fe0b79427	989a8479-e1cf-4b4a-a72d-dda304e289cc
3554	3554	0	GBIF Israel	8cb55387-7802-40e8-86d6-d357a583c596	9f113fae-1666-4bdc-99af-4d0c94beb936
87	87	0	Plazi	ffb07bec-2d10-492d-9c37-361fe0b79427	a2d1f7b5-8049-43dd-8166-d60a2216ca70
22	22	0	Plazi	ffb07bec-2d10-492d-9c37-361fe0b79427	a5ef3313-7177-47aa-bda5-8ead973619fe
412	496	84	Indonesian Biodiversity Information Facility	2ebd91f6-f14f-4375-b525-c011a3774f03	a71c3da3-4cf3-48f2-a468-f2c0b3189db2
92	92	0	GBIF Brazil	cdc9736d-5ff7-4ece-9959-3c744360cdb3	aa1f4729-38eb-4bba-ae40-bc1c5b1e3e87
0	5	5	Plazi	ffb07bec-2d10-492d-9c37-361fe0b79427	acab3edb-1a64-4323-b05d-92824e12a06a
0	1	1	Plazi	ffb07bec-2d10-492d-9c37-361fe0b79427	aea55d09-bd01-4229-93cf-1b9a8b4b1a08
39	39	0	Plazi	ffb07bec-2d10-492d-9c37-361fe0b79427	b0dafbad-9733-48e4-826f-b8e601823c79
236	236	0	Participant Node Managers Committee	7f48e0c8-5c96-49ec-b972-30748e339115	b235404a-29bf-4aed-b6aa-62b7dc05b70d
3	3	0	Plazi	ffb07bec-2d10-492d-9c37-361fe0b79427	b2aec862-e219-4e84-af79-c6a721df5439
0	1120	1120	GBIF Germany	4f6826f2-4ff6-443d-b966-e6913bd24013	b4c3f90f-1d4d-428a-9bee-e2090693d73b
225	225	0	Colombian Biodiversity Information System	7e865cba-7c46-417b-ade5-97f2cf5b7be0	b538fc74-76ff-4dbe-b9eb-8b2c341fe731
4	4	0	Plazi	ffb07bec-2d10-492d-9c37-361fe0b79427	b5428d81-e36e-4a12-b9dd-8a8077ba59b0
4	4	0	Plazi	ffb07bec-2d10-492d-9c37-361fe0b79427	bacb4c81-b314-4900-9ee0-cb5a9e1ba311
69	69	0	Plazi	ffb07bec-2d10-492d-9c37-361fe0b79427	bc73ac48-fb45-413e-94af-84c188ec1850
19513	19513	0	Biodiversity Information System of Mexico	b324e8e9-9a4c-44fa-8f1a-7f39ea7ab576	bddca4a4-60b5-4db5-95fa-be0cce979d3a
202836	202836	0	GBIF New Zealand	4f9fd726-20dd-445e-89a1-8ed93792276f	be62fffc-d0e7-45f2-9404-d4bc4322bc57
2532	2532	0	GBIF Finland	dd514216-5c7c-45f3-910d-797424cb5be6	be8f0b51-2030-4402-80e9-01095875de64
0	19	19	Plazi	ffb07bec-2d10-492d-9c37-361fe0b79427	bec1ec23-b368-4653-bd22-700cf359ccc4
8	8	0	Plazi	ffb07bec-2d10-492d-9c37-361fe0b79427	c091cecf-14bf-4cd0-987f-ae92a47c6fa1
0	21	21	Plazi	ffb07bec-2d10-492d-9c37-361fe0b79427	c3578315-823c-4e08-be7d-3066a308fad9
1716	1716	0	Belgian Biodiversity Platform	fb11cfe1-ebc3-45af-9159-17d9fddbcdac	c3fa13f7-14bd-4f14-9bd5-4f959860f63b
1398	1398	0	Indonesian Biodiversity Information Facility	2ebd91f6-f14f-4375-b525-c011a3774f03	c46b6fda-86e6-47a2-a295-d863c5cf7039
39	39	0	GBIF Sweden	a0b3be64-6525-4387-ac67-a499950f92e1	c5a4ec1d-5534-4181-bfec-1a3eb524c791
149	149	0	Plazi	ffb07bec-2d10-492d-9c37-361fe0b79427	c5f6a690-df39-4d8f-9813-9caa87a114eb
0	89	89	Ocean Biodiversity Information System	ba0670b9-4186-41e6-8e70-f9cb3065551a	c7d1d1a4-54f8-4aa0-93ee-6c1824da31aa
0	1620	1620	Participant Node Managers Committee	7f48e0c8-5c96-49ec-b972-30748e339115	c92e9439-601d-47d4-8727-ff16ef69952f
4	4	0	Plazi	ffb07bec-2d10-492d-9c37-361fe0b79427	c940fa0f-327a-49ed-a653-3cb05b0031dd
0	46576	46576	Netherlands Biodiversity Information Facility	0909d601-bda2-42df-9e63-a6d51847ebce	cc3acca7-e7cb-4eae-9cc1-853f66881bba
528	528	0	National Biodiversity Network	d897a5b9-35ee-4232-94bd-b0bcaac003c2	ccf15a3a-b695-48f4-9a91-2e3e86fb3ffe
3	3	0	Plazi	ffb07bec-2d10-492d-9c37-361fe0b79427	cfa045a7-ab66-48ad-9e4f-f9fae8987bed
983	983	0	National Biodiversity Network	d897a5b9-35ee-4232-94bd-b0bcaac003c2	d03ce806-e16f-4cdb-a964-0b965523b908
0	48	48	Plazi	ffb07bec-2d10-492d-9c37-361fe0b79427	d14924df-bb99-4a8d-a422-6f424821e076
65549	84311	18762	U.S. Geological Survey	8618c64a-93e0-4300-b546-7249e5148ed2	d5fafa95-7de2-48c0-bf10-3480bcca4a2b
12	50	38	Plazi	ffb07bec-2d10-492d-9c37-361fe0b79427	d73d45db-a61c-481d-9e02-685676e51f73
1016612	1016612	0	GBIF France	da44cd31-5901-4687-a106-6d1c7734ee3a	d7cc19ba-7785-4131-ab63-3328a99ecfab
0	6	6	Plazi	ffb07bec-2d10-492d-9c37-361fe0b79427	d7ffbefc-5135-49b3-bb63-851725c56959
0	11	11	Plazi	ffb07bec-2d10-492d-9c37-361fe0b79427	db2db957-779b-4a91-b962-c268e820438e
133	133	0	GBIF Argentina	2426a871-9feb-40a1-96c6-0c593a76b835	de3af2d3-8217-471d-b6a9-9886730f2a98
0	7	7	Plazi	ffb07bec-2d10-492d-9c37-361fe0b79427	e094e473-f8d3-49f6-8d86-49ad57e85df0
10117	10117	0	GBIF Germany	4f6826f2-4ff6-443d-b966-e6913bd24013	e37d0298-8e57-449c-8069-c5d73391e061
290	290	0	GBIF Malawi	2a42e4d7-ad4a-41b3-84c4-de4aa7b74d35	e5c9ca65-d152-478e-8593-b626a6802629
0	8	8	Plazi	ffb07bec-2d10-492d-9c37-361fe0b79427	e635077c-a2fb-4b88-8b49-b253a6f9ce3b
101	101	0	U.S. Geological Survey	8618c64a-93e0-4300-b546-7249e5148ed2	e9652853-c1cc-420d-941d-3a31924f77a5
0	428	428	Ocean Biodiversity Information System	ba0670b9-4186-41e6-8e70-f9cb3065551a	eae32224-05a2-4e3c-90f8-77b1d22a850c
554	554	0	Participant Node Managers Committee	7f48e0c8-5c96-49ec-b972-30748e339115	eb0ebe4c-46e2-4996-b0ec-f92ba783165f
0	4	4	Plazi	ffb07bec-2d10-492d-9c37-361fe0b79427	eb34fd8d-6897-40b4-a149-73b6cb23af22
1	1	0	Plazi	ffb07bec-2d10-492d-9c37-361fe0b79427	ef037a79-bc5e-4c9c-8875-69758d204911
0	4	4	Plazi	ffb07bec-2d10-492d-9c37-361fe0b79427	effec217-1eab-4130-aafc-edeace72baa9
157	157	0	GBIF France	da44cd31-5901-4687-a106-6d1c7734ee3a	f0b11e89-0668-4823-8646-920552139fa9
0	4889	4889	Participant Node Managers Committee	7f48e0c8-5c96-49ec-b972-30748e339115	f1fc8155-1ebb-4b2e-8cb7-213368f0489b
10786	10786	0	Colombian Biodiversity Information System	7e865cba-7c46-417b-ade5-97f2cf5b7be0	f27b41cb-2f1c-4d1a-9b6a-ff64904356b9
36	36	0	Plazi	ffb07bec-2d10-492d-9c37-361fe0b79427	f395431d-3071-48fa-8d94-b4366103476d
2	2	0	GBIF France	da44cd31-5901-4687-a106-6d1c7734ee3a	f3c5d490-bcc0-4639-bb1c-244bd79298a7
55	55	0	GBIF Sweden	a0b3be64-6525-4387-ac67-a499950f92e1	f5988ebf-b7ab-457b-89a5-9e661ab2216c
0	54550	54550	Ocean Biodiversity Information System	ba0670b9-4186-41e6-8e70-f9cb3065551a	f8863ab9-84d6-4c08-b558-4439eeffeadb
0	168	168	Ocean Biodiversity Information System	ba0670b9-4186-41e6-8e70-f9cb3065551a	fb500983-5d60-443d-8e90-67bafccecf49
22	22	0	Plazi	ffb07bec-2d10-492d-9c37-361fe0b79427	fc545a57-4242-4f8d-916d-b99fba5c6bca
53	53	0	Plazi	ffb07bec-2d10-492d-9c37-361fe0b79427	fd6b8bbb-75ef-48be-a4bc-fc3bcc212265
0	3	3	Plazi	ffb07bec-2d10-492d-9c37-361fe0b79427	017989f2-d635-44a4-8746-acf668ba9456
3	3	0	Plazi	ffb07bec-2d10-492d-9c37-361fe0b79427	017d0532-d2dd-496b-8a66-478e4d15a050
3	3	0	Plazi	ffb07bec-2d10-492d-9c37-361fe0b79427	04e35966-a510-41d6-9adc-31e123a79128
1315	1315	0	GBIF Germany	4f6826f2-4ff6-443d-b966-e6913bd24013	0668c2cd-87a2-44e7-b6d5-18023fc6a83e
0	11	11	Plazi	ffb07bec-2d10-492d-9c37-361fe0b79427	0d69081f-0cf4-4be6-92a6-5a785e5ee98e
2	2	0	Plazi	ffb07bec-2d10-492d-9c37-361fe0b79427	0e8ea3a7-eba8-40d2-b9c3-81dc1f6eec54
61	61	0	Plazi	ffb07bec-2d10-492d-9c37-361fe0b79427	0ebdd44c-54d8-45f3-a351-e45613035393
807	807	0	Participant Node Managers Committee	7f48e0c8-5c96-49ec-b972-30748e339115	0f243a11-1cef-442e-98be-a743ace6085f
0	109	109	Colombian Biodiversity Information System	7e865cba-7c46-417b-ade5-97f2cf5b7be0	0f6c9a72-bb0c-453b-9666-1a5b22247202
4	4	0	Plazi	ffb07bec-2d10-492d-9c37-361fe0b79427	0ff22c77-9d57-4501-8dcf-efa0e0695efa
31180	35305	4125	National Biodiversity Network	d897a5b9-35ee-4232-94bd-b0bcaac003c2	127246c7-144e-4e06-a5fa-90828a4bdabb
0	15	15	Plazi	ffb07bec-2d10-492d-9c37-361fe0b79427	1361fbca-2ed1-4f60-85cc-1a3f62f73d79
287	287	0	Atlas of Living Australia	4a6f1b71-969e-4fc5-a693-282b05e1220c	141682ad-290d-42c1-936d-0a7209147b1c
0	4	4	Plazi	ffb07bec-2d10-492d-9c37-361fe0b79427	152bc79c-0c3c-4470-9547-ff72f85ec17c
133	133	0	Plazi	ffb07bec-2d10-492d-9c37-361fe0b79427	15fc4668-833d-4d5a-a3da-2aea5eb56079
739	739	0	National Biodiversity Network	d897a5b9-35ee-4232-94bd-b0bcaac003c2	16c06df8-e68f-4eb8-a04d-dc426ad596e0
6	6	0	GBIF Brazil	cdc9736d-5ff7-4ece-9959-3c744360cdb3	173a8bfe-59e7-433e-9867-ce885c0f09a8
135	135	0	Colombian Biodiversity Information System	7e865cba-7c46-417b-ade5-97f2cf5b7be0	1aa3d0ff-020b-4456-985f-cf88b4e0fb23
28339	30855	2516	U.S. Geological Survey	8618c64a-93e0-4300-b546-7249e5148ed2	1b72b75a-fd98-42de-9d9d-c87c47631c0d
0	25	25	Ocean Biodiversity Information System	ba0670b9-4186-41e6-8e70-f9cb3065551a	1d5edacd-8caa-4f77-aab6-44263843d28b
1738	1738	0	U.S. Geological Survey	8618c64a-93e0-4300-b546-7249e5148ed2	2526aea6-ccd0-4d83-a55d-46efcdb3f010
3059	3059	0	Colombian Biodiversity Information System	7e865cba-7c46-417b-ade5-97f2cf5b7be0	2751799f-c1e3-4f78-9d91-80b9596a2aa0
0	350	350	Colombian Biodiversity Information System	7e865cba-7c46-417b-ade5-97f2cf5b7be0	2a9c6430-b7eb-481a-8279-50c4950e5c87
307	307	0	Plazi	ffb07bec-2d10-492d-9c37-361fe0b79427	31fc11cb-e4a0-4587-8312-300525996a24
242860	262622	19762	U.S. Geological Survey	8618c64a-93e0-4300-b546-7249e5148ed2	323b0e80-5e4b-4cc4-936a-d93fc8cae9bc
0	21440	21440	U.S. Geological Survey	8618c64a-93e0-4300-b546-7249e5148ed2	33b4ca40-0a46-4fa7-8ed4-4f51d1e3304c
1470	1470	0	GBIF Spain	1f94b3ca-9345-4d65-afe2-4bace93aa0fe	3485d98d-3769-473f-b5f1-2ddc2ffb7708
1	1	0	Plazi	ffb07bec-2d10-492d-9c37-361fe0b79427	3604a1c2-aff1-423b-885b-25377fd194e1
10	10	0	Plazi	ffb07bec-2d10-492d-9c37-361fe0b79427	37aa80dd-bac0-413b-bc00-ad4294b0003a
16	16	0	Plazi	ffb07bec-2d10-492d-9c37-361fe0b79427	3a543dbc-eae5-48b2-82e9-6442a1dad911
0	17	17	Ocean Biodiversity Information System	ba0670b9-4186-41e6-8e70-f9cb3065551a	3b10a302-c9ff-4fdc-a648-cf7b26886c9b
4588	4588	0	Netherlands Biodiversity Information Facility	0909d601-bda2-42df-9e63-a6d51847ebce	3c2eb73a-82c8-4373-956f-1cb9473f76ba
189	65	-124	GBIF Germany	4f6826f2-4ff6-443d-b966-e6913bd24013	3f1bbe5c-6ed5-470c-8a30-1a574f05eacc
2132	2132	0	GBIF France	da44cd31-5901-4687-a106-6d1c7734ee3a	45465090-7ad9-4874-94af-9aecd16c06ac
688	688	0	GBIF Norway	4f829580-180d-46a9-9c87-ed8ec959b545	4894f2f8-74b5-403e-bd8d-6fe5123a3f71
7	7	0	Plazi	ffb07bec-2d10-492d-9c37-361fe0b79427	49d1e797-32b4-414b-a993-63ec0110d8db
0	3	3	Ocean Biodiversity Information System	ba0670b9-4186-41e6-8e70-f9cb3065551a	4e2c6d26-18db-45c4-a13d-8e841c477756
497	282	-215	Biodiversity Information System of Mexico	b324e8e9-9a4c-44fa-8f1a-7f39ea7ab576	4f59d35c-4f92-419d-b5e1-cb9cee50685e
241	241	0	Plazi	ffb07bec-2d10-492d-9c37-361fe0b79427	4f5ec7f1-d96a-426d-9f73-4332e2077eef
1084	1084	0	National Biodiversity Network	d897a5b9-35ee-4232-94bd-b0bcaac003c2	512b457b-c410-4381-9911-900956ceb2dd
229	229	0	GBIF Germany	4f6826f2-4ff6-443d-b966-e6913bd24013	559aba2c-2f3b-42da-8fc3-2a90edb22c45
5	5	0	Plazi	ffb07bec-2d10-492d-9c37-361fe0b79427	56688e37-14f5-4616-bca2-229f769b15a4
21749	21749	0	Canada Biodiversity Information Facility	8f83fc96-c966-4126-83f7-bf044dc49efa	5678b0b3-450b-4513-82e1-2b32c3c50b54
3	3	0	Plazi	ffb07bec-2d10-492d-9c37-361fe0b79427	573cc6d8-d62b-4e27-a15d-1a546f5da4b1
527	527	0	Colombian Biodiversity Information System	7e865cba-7c46-417b-ade5-97f2cf5b7be0	5847c3fb-dce6-4b16-b816-c20635898e04
3	3	0	Plazi	ffb07bec-2d10-492d-9c37-361fe0b79427	5c09ca3f-6625-4d6d-a3e6-d31b7d30ba91
3143	3143	0	National Biodiversity Network	d897a5b9-35ee-4232-94bd-b0bcaac003c2	5c87763e-daa1-4ea4-9c6a-210e78922dd8
0	2	2	Plazi	ffb07bec-2d10-492d-9c37-361fe0b79427	5ebeeee4-5f68-4923-8ceb-ee332a21609e
0	9	9	Plazi	ffb07bec-2d10-492d-9c37-361fe0b79427	645a7e49-5099-4d46-b6de-7c66d2b1475e
39	39	0	GBIF Germany	4f6826f2-4ff6-443d-b966-e6913bd24013	64d45174-f762-11e1-a439-00145eb45e9a
0	23	23	Plazi	ffb07bec-2d10-492d-9c37-361fe0b79427	67a876f5-744b-45c2-9264-bb3cfcb61cbf
43	43	0	GBIF Germany	4f6826f2-4ff6-443d-b966-e6913bd24013	67caf28e-f762-11e1-a439-00145eb45e9a
7027	7027	0	GBIF France	da44cd31-5901-4687-a106-6d1c7734ee3a	67e8af0c-3c38-4c9e-b3cf-e9c5316a8d23
175	175	0	Plazi	ffb07bec-2d10-492d-9c37-361fe0b79427	68658be2-96b9-49b8-82ca-7046054a16c6
0	2	2	Plazi	ffb07bec-2d10-492d-9c37-361fe0b79427	68b9200f-f68e-47c5-b6bf-d34b4f8f7318
59	59	0	GBIF Germany	4f6826f2-4ff6-443d-b966-e6913bd24013	698c36be-f762-11e1-a439-00145eb45e9a
0	50	50	GBIF Japan	db5705aa-6a6e-42f1-8942-d77b9f4896ea	6a20b279-d347-4ba6-afd0-0e3a06083f88
4	4	0	GBIF Germany	4f6826f2-4ff6-443d-b966-e6913bd24013	6b4711c2-f762-11e1-a439-00145eb45e9a
27	27	0	GBIF Germany	4f6826f2-4ff6-443d-b966-e6913bd24013	6beb1df8-f762-11e1-a439-00145eb45e9a
194	194	0	GBIF Germany	4f6826f2-4ff6-443d-b966-e6913bd24013	6c34cdae-f762-11e1-a439-00145eb45e9a
50	50	0	GBIF Germany	4f6826f2-4ff6-443d-b966-e6913bd24013	6cbaff00-f762-11e1-a439-00145eb45e9a
48	48	0	GBIF Germany	4f6826f2-4ff6-443d-b966-e6913bd24013	6cd1d2d4-f762-11e1-a439-00145eb45e9a
14562	14562	0	GBIF Brazil	cdc9736d-5ff7-4ece-9959-3c744360cdb3	6cf2d179-0e25-49e1-af67-ff2571293c63
105	105	0	GBIF Germany	4f6826f2-4ff6-443d-b966-e6913bd24013	6d520b66-f762-11e1-a439-00145eb45e9a
4129	4129	0	Nordic Genetic Resource Centre	fa6bdac4-51e2-4334-940c-ba6cdf6e1257	6e2b3706-4e87-428d-a860-beae8ccfef9f
0	1	1	Plazi	ffb07bec-2d10-492d-9c37-361fe0b79427	6e49fa12-d848-4e8c-b7b9-f4b1f2ca61be
9	9	0	GBIF Germany	4f6826f2-4ff6-443d-b966-e6913bd24013	6fa1f8e0-f762-11e1-a439-00145eb45e9a
223	223	0	GBIF France	da44cd31-5901-4687-a106-6d1c7734ee3a	6fe1ab34-e550-45ed-af39-78489af04ce8
1659	1280	-379	GBIF Germany	4f6826f2-4ff6-443d-b966-e6913bd24013	70932954-f762-11e1-a439-00145eb45e9a
92	92	0	GBIF Germany	4f6826f2-4ff6-443d-b966-e6913bd24013	733902f0-f762-11e1-a439-00145eb45e9a
19	19	0	GBIF Germany	4f6826f2-4ff6-443d-b966-e6913bd24013	738d6188-f762-11e1-a439-00145eb45e9a
1405	1405	0	Biodiversity Information System of Mexico	b324e8e9-9a4c-44fa-8f1a-7f39ea7ab576	74065585-3d70-4a56-ab96-39d664933cac
3	3	0	Plazi	ffb07bec-2d10-492d-9c37-361fe0b79427	740eba2d-27da-4765-8559-74e357162f7f
11	11	0	GBIF Germany	4f6826f2-4ff6-443d-b966-e6913bd24013	74affdbe-f762-11e1-a439-00145eb45e9a
5	5	0	Plazi	ffb07bec-2d10-492d-9c37-361fe0b79427	752ae550-7a98-40d0-a3dd-5bca1b83a62d
18	18	0	Plazi	ffb07bec-2d10-492d-9c37-361fe0b79427	756e1a74-a63b-4b70-9f12-8614644aef91
672	672	0	GBIF Argentina	2426a871-9feb-40a1-96c6-0c593a76b835	7615e6d1-9ebd-4302-9a7e-4913ca8b2bb4
3	3	0	Plazi	ffb07bec-2d10-492d-9c37-361fe0b79427	766e5a66-1e87-4a8c-938c-f7ec0f5c6ea4
43	43	0	GBIF Germany	4f6826f2-4ff6-443d-b966-e6913bd24013	79216572-f762-11e1-a439-00145eb45e9a
313	313	0	GBIF Spain	1f94b3ca-9345-4d65-afe2-4bace93aa0fe	7a4ab5e8-f762-11e1-a439-00145eb45e9a
1364	1370	6	GBIF Germany	4f6826f2-4ff6-443d-b966-e6913bd24013	7a63ca74-f762-11e1-a439-00145eb45e9a
8	8	0	Plazi	ffb07bec-2d10-492d-9c37-361fe0b79427	7a890fa5-7993-4637-8454-7dcbd6839278
427	427	0	GBIF Germany	4f6826f2-4ff6-443d-b966-e6913bd24013	7be7fe10-f762-11e1-a439-00145eb45e9a
43	43	0	Plazi	ffb07bec-2d10-492d-9c37-361fe0b79427	7bf48e48-e22f-442f-bbd0-b38feeab0d79
3920	2320	-1600	GBIF Germany	4f6826f2-4ff6-443d-b966-e6913bd24013	7c2c5240-f762-11e1-a439-00145eb45e9a
8	8	0	GBIF Germany	4f6826f2-4ff6-443d-b966-e6913bd24013	7c393762-f762-11e1-a439-00145eb45e9a
9037	9037	0	GBIF Germany	4f6826f2-4ff6-443d-b966-e6913bd24013	7e2989f0-f762-11e1-a439-00145eb45e9a
10	10	0	Participant Node Managers Committee	7f48e0c8-5c96-49ec-b972-30748e339115	7f27ceda-811e-476e-a5f2-304ae6f20248
412	412	0	Biodiversity Information System of Mexico	b324e8e9-9a4c-44fa-8f1a-7f39ea7ab576	801273c6-f762-11e1-a439-00145eb45e9a
29	29	0	Participant Node Managers Committee	7f48e0c8-5c96-49ec-b972-30748e339115	8260db39-8776-4ad6-bd80-46e4e1168bf7
7076556	7076556	0	U.S. Geological Survey	8618c64a-93e0-4300-b546-7249e5148ed2	82cb293c-f762-11e1-a439-00145eb45e9a
0	3	3	Plazi	ffb07bec-2d10-492d-9c37-361fe0b79427	82cd2fc8-efdd-454c-882a-19e9c45009af
5638	5638	0	GBIF Spain	1f94b3ca-9345-4d65-afe2-4bace93aa0fe	8360b042-f762-11e1-a439-00145eb45e9a
577	577	0	DanBIF - Danish Biodiversity Information Facility	4ddd294f-02b7-4359-ac33-0806a9ca9c6b	84cb653a-f762-11e1-a439-00145eb45e9a
20	20	0	Plazi	ffb07bec-2d10-492d-9c37-361fe0b79427	84d835b8-260b-4447-94d5-a944bec3eff1
12730	12730	0	GBIF Spain	1f94b3ca-9345-4d65-afe2-4bace93aa0fe	85864fc6-f762-11e1-a439-00145eb45e9a
235	235	0	GBIF Germany	4f6826f2-4ff6-443d-b966-e6913bd24013	86372972-f762-11e1-a439-00145eb45e9a
4	4	0	GBIF Japan	db5705aa-6a6e-42f1-8942-d77b9f4896ea	87530d66-1254-4141-8a6f-0fc282037470
1800	1800	0	Colombian Biodiversity Information System	7e865cba-7c46-417b-ade5-97f2cf5b7be0	87c22676-55df-4e72-b2fa-6488700576d1
408	299	-109	GBIF Germany	4f6826f2-4ff6-443d-b966-e6913bd24013	8805b20a-f762-11e1-a439-00145eb45e9a
162	162	0	Belgian Biodiversity Platform	fb11cfe1-ebc3-45af-9159-17d9fddbcdac	8854d25e-05f9-48f0-88da-7c413b24f535
72	72	0	Participant Node Managers Committee	7f48e0c8-5c96-49ec-b972-30748e339115	885a0b69-3f54-4d79-aabf-cc68df89533d
3	3	0	Plazi	ffb07bec-2d10-492d-9c37-361fe0b79427	8ad6b28d-196c-44cc-aec9-34eb13aacc56
6	6	0	Plazi	ffb07bec-2d10-492d-9c37-361fe0b79427	8ba798da-ca55-49da-be5d-239d992ab414
0	1171	1171	National Biodiversity Network	d897a5b9-35ee-4232-94bd-b0bcaac003c2	8c1f38ba-29a2-4fa1-a668-b259df5e6388
319	319	0	GBIF Germany	4f6826f2-4ff6-443d-b966-e6913bd24013	8e287cf8-f762-11e1-a439-00145eb45e9a
137	92	-45	GBIF Germany	4f6826f2-4ff6-443d-b966-e6913bd24013	8e863cda-f762-11e1-a439-00145eb45e9a
2579	2579	0	Biodiversity Information System of Mexico	b324e8e9-9a4c-44fa-8f1a-7f39ea7ab576	8e9ec96f-1d90-4d8c-9e05-9551aea70b0c
2	2	0	Plazi	ffb07bec-2d10-492d-9c37-361fe0b79427	8ee2b4b4-00b4-4a8a-a95a-b747829eaefa
72	61	-11	GBIF Germany	4f6826f2-4ff6-443d-b966-e6913bd24013	8f5c4a6e-f762-11e1-a439-00145eb45e9a
4094	4094	0	Polish Biodiversity Information Network	2618bfdf-e194-4911-a241-80db3107bc51	90088b00-13de-11de-b2e1-b8a03c50a862
2	2	0	Plazi	ffb07bec-2d10-492d-9c37-361fe0b79427	90d94000-38de-4ad3-ba7d-ec7cfb68df57
45	32	-13	GBIF Germany	4f6826f2-4ff6-443d-b966-e6913bd24013	9110d38e-f762-11e1-a439-00145eb45e9a
20	16	-4	GBIF Germany	4f6826f2-4ff6-443d-b966-e6913bd24013	916e4db6-f762-11e1-a439-00145eb45e9a
138	138	0	GBIF Germany	4f6826f2-4ff6-443d-b966-e6913bd24013	92a3f0dc-f762-11e1-a439-00145eb45e9a
527	527	0	GBIF Germany	4f6826f2-4ff6-443d-b966-e6913bd24013	944a15ba-f762-11e1-a439-00145eb45e9a
175	164	-11	GBIF Germany	4f6826f2-4ff6-443d-b966-e6913bd24013	9542ba12-f762-11e1-a439-00145eb45e9a
0	266	266	Plazi	ffb07bec-2d10-492d-9c37-361fe0b79427	98b4e594-9ada-44f7-a122-08c31fd8409f
13	13	0	Plazi	ffb07bec-2d10-492d-9c37-361fe0b79427	999795e1-244b-4ca9-bf21-1875ec184037
8	8	0	Plazi	ffb07bec-2d10-492d-9c37-361fe0b79427	9a058e52-8778-42c8-9430-befa9a7e2a9d
1490	1614	124	Participant Node Managers Committee	7f48e0c8-5c96-49ec-b972-30748e339115	9ad675c5-1182-4b25-bb2a-4acc5f51ea16
0	5	5	Plazi	ffb07bec-2d10-492d-9c37-361fe0b79427	9ba63bf6-0493-4ecb-8d13-47a0e54a73fd
2	2	0	Plazi	ffb07bec-2d10-492d-9c37-361fe0b79427	9d99406e-0252-4e51-b39a-f24ac1f5deea
206	206	0	Plazi	ffb07bec-2d10-492d-9c37-361fe0b79427	9de0df67-a93a-40f5-a1c5-75aa694a53ca
5	5	0	Plazi	ffb07bec-2d10-492d-9c37-361fe0b79427	a4c40c61-5a04-4db4-ab72-132cf13a1eb3
15672	15672	0	GBIF France	da44cd31-5901-4687-a106-6d1c7734ee3a	a81d01b9-1322-4487-b9e1-f0322941ba0e
27	27	0	Participant Node Managers Committee	7f48e0c8-5c96-49ec-b972-30748e339115	aa5192d3-8c98-42aa-8ea6-c25b83ded118
1375095	1379780	4685	U.S. Geological Survey	8618c64a-93e0-4300-b546-7249e5148ed2	aae308f4-9f9c-4cdd-b4ef-c026f48be551
19	19	0	GBIF Germany	4f6826f2-4ff6-443d-b966-e6913bd24013	ac3ed947-b0ab-43e2-8ce4-7dc202f5d22c
4101	4101	0	National Biodiversity Network	d897a5b9-35ee-4232-94bd-b0bcaac003c2	acf61beb-083e-416f-86bb-74eda379afa4
64	64	0	Plazi	ffb07bec-2d10-492d-9c37-361fe0b79427	ad1afe46-7393-4fac-9a6d-79c44b1377d7
2	2	0	Participant Node Managers Committee	7f48e0c8-5c96-49ec-b972-30748e339115	ad94eb30-d2de-413d-91e2-41c95db4c6f1
7	7	0	Plazi	ffb07bec-2d10-492d-9c37-361fe0b79427	ade0ad77-5500-4bce-8dd4-8b7a412692fd
2	2	0	Plazi	ffb07bec-2d10-492d-9c37-361fe0b79427	ae518b88-ae03-4875-9174-619da4dc29dc
7423	7442	19	GBIF Brazil	cdc9736d-5ff7-4ece-9959-3c744360cdb3	aed35888-68cb-4574-8a98-d13b89cf0f38
340799	348187	7388	U.S. Geological Survey	8618c64a-93e0-4300-b546-7249e5148ed2	b15d4952-7d20-46f1-8a3e-556a512b04c5
0	3721	3721	Ocean Biodiversity Information System	ba0670b9-4186-41e6-8e70-f9cb3065551a	b653f3e2-ad57-45e9-86d1-40d526ff1e7d
11	11	0	GBIF Germany	4f6826f2-4ff6-443d-b966-e6913bd24013	b6b88eb6-b348-4c11-9198-7b72ffa19fe4
37743	37743	0	National Biodiversity Network	d897a5b9-35ee-4232-94bd-b0bcaac003c2	b759ea83-a822-4f52-8eba-8fd1073781ef
0	2	2	Plazi	ffb07bec-2d10-492d-9c37-361fe0b79427	b7b981f7-15dd-4417-8231-46237f184f8f
1	1	0	Plazi	ffb07bec-2d10-492d-9c37-361fe0b79427	b92f4f7a-6ea8-4ef5-aa0e-8333a88cae1c
0	19	19	Plazi	ffb07bec-2d10-492d-9c37-361fe0b79427	b96176d0-ad6f-43bd-b631-a3e3789e5250
3359	3359	0	Biodiversity Information System of Mexico	b324e8e9-9a4c-44fa-8f1a-7f39ea7ab576	b98b81af-cc62-4a0b-b503-3da65c9f4a91
56	56	0	Plazi	ffb07bec-2d10-492d-9c37-361fe0b79427	bba007ee-151d-47e5-9114-cd906a109bdb
43	43	0	Plazi	ffb07bec-2d10-492d-9c37-361fe0b79427	bce38a29-3fdd-4d4b-a5df-1ccf3b44b71c
1312	1312	0	GBIF Germany	4f6826f2-4ff6-443d-b966-e6913bd24013	be976cee-5365-4f0b-9ab4-48cdc27b177c
844	367	-477	Biodiversity Information System of Mexico	b324e8e9-9a4c-44fa-8f1a-7f39ea7ab576	bf4cf2f3-d1d3-42a8-8496-0445f063a92f
9	9	0	Plazi	ffb07bec-2d10-492d-9c37-361fe0b79427	bf6bbd16-4517-4814-8ec6-9b42014ed797
3	3	0	Plazi	ffb07bec-2d10-492d-9c37-361fe0b79427	c2dfa611-f356-43d7-aa12-5498a068492a
348	348	0	Participant Node Managers Committee	7f48e0c8-5c96-49ec-b972-30748e339115	c64ea13f-f1a4-4d83-8409-d7da9b841b40
1154	1154	0	GBIF France	da44cd31-5901-4687-a106-6d1c7734ee3a	c6bc1cf3-10bc-4ff3-b788-e40ce4261e78
909	909	0	Biodiversity Information System of Mexico	b324e8e9-9a4c-44fa-8f1a-7f39ea7ab576	c79375d7-9ddd-4113-9d75-cebe56513c9c
1	1	0	Plazi	ffb07bec-2d10-492d-9c37-361fe0b79427	caa92fbc-06ea-4d3e-a9b1-5d420e31c08b
4	4	0	Plazi	ffb07bec-2d10-492d-9c37-361fe0b79427	cd2ea154-a1f5-4aeb-914c-fa2ea6fe1dd4
0	43	43	Plazi	ffb07bec-2d10-492d-9c37-361fe0b79427	cd35f8b1-58c5-4841-947a-7d392dee1503
76	76	0	GBIF France	da44cd31-5901-4687-a106-6d1c7734ee3a	cd86b71f-222c-4bde-adc2-c853e8d0e056
0	7655	7655	U.S. Geological Survey	8618c64a-93e0-4300-b546-7249e5148ed2	cf4bbc6b-2b61-4e44-b1fa-453839491ac2
145	327	182	Colombian Biodiversity Information System	7e865cba-7c46-417b-ade5-97f2cf5b7be0	cf557dff-b9cb-4a23-bf74-a927fef0d7b6
0	12	12	Plazi	ffb07bec-2d10-492d-9c37-361fe0b79427	d0c2bd3b-b59c-40cd-ba2f-d850d7c288b5
0	2	2	Plazi	ffb07bec-2d10-492d-9c37-361fe0b79427	d42ee3e7-eee4-41ab-aa49-65b69a5bcb5f
22	22	0	Plazi	ffb07bec-2d10-492d-9c37-361fe0b79427	d4804d31-3db2-4ef8-9f80-a858935d3396
0	182	182	Plazi	ffb07bec-2d10-492d-9c37-361fe0b79427	d54a604d-13dd-478c-99e5-b31c1411e111
0	156	156	Ocean Biodiversity Information System	ba0670b9-4186-41e6-8e70-f9cb3065551a	d7567520-39d3-4df0-9c8e-4db23e887a21
6	6	0	Plazi	ffb07bec-2d10-492d-9c37-361fe0b79427	d9066a75-c46b-49fb-84bf-3a85c4de35be
0	11	11	Plazi	ffb07bec-2d10-492d-9c37-361fe0b79427	d992fdcf-1198-49f3-a2bc-faa855c86722
8077	8077	0	Participant Node Managers Committee	7f48e0c8-5c96-49ec-b972-30748e339115	dbebf070-6954-404f-af12-d61be85a99c0
1871	1871	0	GBIF France	da44cd31-5901-4687-a106-6d1c7734ee3a	dcb022ba-6a6b-4ed1-955b-5bf795b54f07
0	17	17	Ocean Biodiversity Information System	ba0670b9-4186-41e6-8e70-f9cb3065551a	dccbb9f9-afff-4393-aeb8-a6e6bcfeb465
7	7	0	Plazi	ffb07bec-2d10-492d-9c37-361fe0b79427	e0c6aebb-8662-4f01-b3a6-2599244f8496
0	34	34	Plazi	ffb07bec-2d10-492d-9c37-361fe0b79427	e161fdff-ea50-4837-8642-8a134f58f18c
1	1	0	Plazi	ffb07bec-2d10-492d-9c37-361fe0b79427	e2399e8a-169a-4da7-88a5-9b8d59199748
16510	16510	0	GBIF France	da44cd31-5901-4687-a106-6d1c7734ee3a	e3dddc3c-da91-4deb-bffa-c956c1f7060f
860	860	0	GBIF France	da44cd31-5901-4687-a106-6d1c7734ee3a	e42904bf-69b6-42f7-bc44-68bc093405b8
187670	187670	0	U.S. Geological Survey	8618c64a-93e0-4300-b546-7249e5148ed2	e62db8c8-4ae7-4bbb-9401-97b279cbf126
0	4	4	Plazi	ffb07bec-2d10-492d-9c37-361fe0b79427	e64b875c-b198-49df-a36f-9d286c8d5b60
0	378	378	GBIF Portugal	673f7038-4262-4149-b753-5658a4e912f6	e9543008-b26d-458e-b334-a201c5c3b7e5
152	152	0	Colombian Biodiversity Information System	7e865cba-7c46-417b-ade5-97f2cf5b7be0	ebb1ed03-11a0-4f02-b5e5-5a913288d688
9177	9177	0	South African Biodiversity Information Facility	7190b835-4e86-4b6e-85c1-19cc6677c250	eecf6418-a9a4-48cb-b1a7-a59dcdb09a9d
50	50	0	Plazi	ffb07bec-2d10-492d-9c37-361fe0b79427	f1fb5c6e-9a8a-4a9e-bc57-8ff820619473
33954	33951	-3	GBIF Brazil	cdc9736d-5ff7-4ece-9959-3c744360cdb3	f2f31bf8-abd3-4bbc-b55e-8fa88c5c8222
5	5	0	Plazi	ffb07bec-2d10-492d-9c37-361fe0b79427	f5a0808f-24fc-430b-affe-0fff72a35bfe
0	12	12	Plazi	ffb07bec-2d10-492d-9c37-361fe0b79427	f6141a90-40c2-4f56-9bfc-c574bc810d0c
0	4	4	Plazi	ffb07bec-2d10-492d-9c37-361fe0b79427	f7dff4ee-4cbc-4ef4-8db0-202258218681
1264	1264	0	GBIF France	da44cd31-5901-4687-a106-6d1c7734ee3a	f83f6f51-e103-4bc6-a1b6-2fd78623cf25
18	18	0	GBIF France	da44cd31-5901-4687-a106-6d1c7734ee3a	f99d7fc5-5021-45cd-818a-ef6e22380423
6468324	6468324	0	GBIF Spain	1f94b3ca-9345-4d65-afe2-4bace93aa0fe	fa7e6ad8-0a2e-49f2-b95d-e9f1e380fadf
16	16	0	Inter American Biodiversity Information Network	69f8ea9e-b2a6-4e5a-896f-3bf8fc23cc8d	ff918604-48cc-4f28-a77e-9e454830d7c7
0	10	10	Plazi	ffb07bec-2d10-492d-9c37-361fe0b79427	0023e7b0-8489-4506-92f1-9aa703737d85
4059	4059	0	Colombian Biodiversity Information System	7e865cba-7c46-417b-ade5-97f2cf5b7be0	00d324d6-5211-47a1-a84d-82175f84e678
0	13	13	Plazi	ffb07bec-2d10-492d-9c37-361fe0b79427	02ba2da4-9de8-498c-a1a5-c4fe50a78255
0	38	38	Ocean Biodiversity Information System	ba0670b9-4186-41e6-8e70-f9cb3065551a	07828046-08d0-4c79-88e1-c49e78f835a5
2	2	0	Plazi	ffb07bec-2d10-492d-9c37-361fe0b79427	086c3e28-0783-44b2-adbe-566ff7a4a251
0	128	128	Plazi	ffb07bec-2d10-492d-9c37-361fe0b79427	09411512-24e4-4f35-90f9-b19a85ea0535
0	12	12	Plazi	ffb07bec-2d10-492d-9c37-361fe0b79427	098595e6-fe5b-4631-880a-8ae21e4419f2
3137	3137	0	GBIF Kenya	2a44d626-9f7a-4120-8a7a-4ab5ac15ff2a	0b43443a-2599-42c1-b7c5-f9e2ff93d449
212	212	0	Plazi	ffb07bec-2d10-492d-9c37-361fe0b79427	0bffa033-64f0-4e6f-ba44-287e52d7c2f9
12	12	0	Ocean Biodiversity Information System	ba0670b9-4186-41e6-8e70-f9cb3065551a	0c27b712-832d-4f0e-8e03-97af404e83ff
5811	5811	0	GBIF France	da44cd31-5901-4687-a106-6d1c7734ee3a	0d244e22-1d10-494e-9e85-68c9c6e53fcd
0	5	5	Plazi	ffb07bec-2d10-492d-9c37-361fe0b79427	0d73c9ae-3dbd-47c6-af30-984a7709afd7
12847	12847	0	GBIF Nigeria	6529bcb5-a542-4fda-be87-54a624515335	0e89ef93-34c2-4942-97f6-9d995edb1f8f
93	93	0	Plazi	ffb07bec-2d10-492d-9c37-361fe0b79427	0ea3c1bd-7938-4961-b91e-18b886ef1446
561820	561820	0	U.S. Geological Survey	8618c64a-93e0-4300-b546-7249e5148ed2	10e44c48-0839-4a20-86d5-f0e23ae2e366
0	1	1	Plazi	ffb07bec-2d10-492d-9c37-361fe0b79427	1150cf0d-33e8-45c8-baf1-c9dafa9e2693
176	176	0	Biodiversity Information System of Mexico	b324e8e9-9a4c-44fa-8f1a-7f39ea7ab576	12d298fc-0adb-4450-88c2-af25b38560af
2	2	0	Plazi	ffb07bec-2d10-492d-9c37-361fe0b79427	12e8f236-a02c-4a83-95df-a7d22a47d2b8
0	298	298	National Biodiversity Network	d897a5b9-35ee-4232-94bd-b0bcaac003c2	1391d9e2-8f1e-45e7-84b4-f7b1d160858e
2052	2052	0	GBIF France	da44cd31-5901-4687-a106-6d1c7734ee3a	13d8111e-1021-497f-bd84-59ce6be5c47e
0	290	290	Colombian Biodiversity Information System	7e865cba-7c46-417b-ade5-97f2cf5b7be0	13de2146-3a79-4c6f-a87c-6ac85a95c5d4
2	2	0	Plazi	ffb07bec-2d10-492d-9c37-361fe0b79427	15225a4f-bd5e-488b-8648-058f4b8a1854
1930	1930	0	GBIF France	da44cd31-5901-4687-a106-6d1c7734ee3a	2179175b-0d66-4b64-abfb-3e8ea95cb0fb
2524	2524	0	GBIF France	da44cd31-5901-4687-a106-6d1c7734ee3a	22eda51a-cffe-4c7e-b974-446a5fb0e1bb
26	26	0	U.S. Geological Survey	8618c64a-93e0-4300-b546-7249e5148ed2	24764109-7e9f-4dc0-80cd-289d11bfd9e1
92	92	0	Participant Node Managers Committee	7f48e0c8-5c96-49ec-b972-30748e339115	267cc444-4df8-4d9e-8a6b-6b13e3600a84
0	1000	1000	Ocean Biodiversity Information System	ba0670b9-4186-41e6-8e70-f9cb3065551a	27eb2ad4-bba4-4de3-91da-97f7e53fc3df
0	2	2	Plazi	ffb07bec-2d10-492d-9c37-361fe0b79427	28098330-b4da-4b17-b691-e142d969ee46
0	11	11	Plazi	ffb07bec-2d10-492d-9c37-361fe0b79427	286cdb2d-6cf1-4263-920f-7cd93fa67fc3
3	3	0	Plazi	ffb07bec-2d10-492d-9c37-361fe0b79427	2a2712a2-05c7-4bd5-85b2-c7cb7b07b378
246	246	0	Colombian Biodiversity Information System	7e865cba-7c46-417b-ade5-97f2cf5b7be0	2eaa0ff5-7217-4827-a6b1-5aadcecb4f0e
100	100	0	Colombian Biodiversity Information System	7e865cba-7c46-417b-ade5-97f2cf5b7be0	2f51827d-8e69-4ecc-9318-d93bdba79986
384195	384195	0	U.S. Geological Survey	8618c64a-93e0-4300-b546-7249e5148ed2	3063fd20-83ba-4716-9a5e-07fcea584f06
731	731	0	GBIF France	da44cd31-5901-4687-a106-6d1c7734ee3a	32ff6715-d810-411f-90d7-025804c64e10
4160	4160	0	GBIF Finland	dd514216-5c7c-45f3-910d-797424cb5be6	34135c23-a595-43bc-b3f0-a08a4748d861
4	4	0	Plazi	ffb07bec-2d10-492d-9c37-361fe0b79427	37131b4f-e3ef-46e7-8bde-0f544951df74
334	334	0	GBIF Germany	4f6826f2-4ff6-443d-b966-e6913bd24013	387bc8dd-f191-4761-a663-41b81c1ab439
1	1	0	Plazi	ffb07bec-2d10-492d-9c37-361fe0b79427	38fd24df-4471-45a4-ac5a-e85c57f94b07
75	75	0	Plazi	ffb07bec-2d10-492d-9c37-361fe0b79427	39f7fe40-f980-44e4-b0cf-4ad557bbd71f
0	5	5	Plazi	ffb07bec-2d10-492d-9c37-361fe0b79427	3ad779fb-97fc-4d3a-b39b-712c359c954f
16632	16632	0	GBIF Argentina	2426a871-9feb-40a1-96c6-0c593a76b835	3af84f96-376e-46f2-b701-cf5aa58463f1
2	2	0	Plazi	ffb07bec-2d10-492d-9c37-361fe0b79427	3d0cf163-2322-4e4b-bdd0-358f68ae6fd0
57	57	0	Atlas of Living Australia	4a6f1b71-969e-4fc5-a693-282b05e1220c	3ea595af-7af0-44b6-9253-f5c120dbac73
0	633060	633060	GBIF Norway	4f829580-180d-46a9-9c87-ed8ec959b545	42a084c5-bf29-47ee-8cf6-022cfdd67758
26109	26109	0	National Biodiversity Network	d897a5b9-35ee-4232-94bd-b0bcaac003c2	43b370d3-2980-4ab3-998b-b467b2194a79
2	2	0	Plazi	ffb07bec-2d10-492d-9c37-361fe0b79427	4ae9dcec-7279-45ab-894d-bac61493631f
0	12	12	Plazi	ffb07bec-2d10-492d-9c37-361fe0b79427	4e161704-42e4-49e9-8601-8cf1f206aaa9
0	11	11	Plazi	ffb07bec-2d10-492d-9c37-361fe0b79427	4edeeee0-1c47-4869-b9c7-13139fc7db58
6	6	0	Plazi	ffb07bec-2d10-492d-9c37-361fe0b79427	4f307d20-75bc-47c4-b57e-90cbbb5b0c84
41	41	0	Participant Node Managers Committee	7f48e0c8-5c96-49ec-b972-30748e339115	50313b08-dc39-493b-bdb4-313aa337a33e
2	2	0	Plazi	ffb07bec-2d10-492d-9c37-361fe0b79427	50a15901-18dc-44de-830b-7707971992a3
165	165	0	National Biodiversity Network	d897a5b9-35ee-4232-94bd-b0bcaac003c2	5159a505-7349-493b-ba39-971824c8c02c
12	12	0	Plazi	ffb07bec-2d10-492d-9c37-361fe0b79427	5254faaf-70f9-4992-8fad-2cfda3728d3b
0	4722	4722	GBIF Portugal	673f7038-4262-4149-b753-5658a4e912f6	5288f839-b9f7-493d-a0dd-4dddf22938ba
2295	2295	0	Belgian Biodiversity Platform	fb11cfe1-ebc3-45af-9159-17d9fddbcdac	53762f29-61a9-40a8-9f3c-06238cc59dd4
16	16	0	Plazi	ffb07bec-2d10-492d-9c37-361fe0b79427	53922b30-4955-41d1-a097-69374e90cf29
43420	43420	0	GBIF Cameroon	cfe0cad9-2bf4-4d16-ae33-c3dfb0da1ed9	572a4f02-fae9-4052-a10d-03fecbeb18de
3	3	0	Plazi	ffb07bec-2d10-492d-9c37-361fe0b79427	594e9f99-e745-4aba-b1c9-139484a57642
0	937	937	Plazi	ffb07bec-2d10-492d-9c37-361fe0b79427	5994a538-4735-4a87-817e-5e3e7d6213ca
0	60	60	GBIF Uganda	71b40829-6a12-4c3d-8fee-5746f5e9cf8c	5a53f318-2cba-42ea-ab8c-01335c2ac646
3	3	0	Plazi	ffb07bec-2d10-492d-9c37-361fe0b79427	5a5c7895-dc6e-46dc-8a97-11812cd0f025
0	796	796	Canada Biodiversity Information Facility	8f83fc96-c966-4126-83f7-bf044dc49efa	5b11525e-c116-48a0-956f-4147ecd97237
0	307	307	Plazi	ffb07bec-2d10-492d-9c37-361fe0b79427	5b4eaeb3-5722-4021-84ad-125ccd80855f
0	57	57	Ocean Biodiversity Information System	ba0670b9-4186-41e6-8e70-f9cb3065551a	5d573a12-1078-4bcb-8302-a02e676129ae
41	41	0	Plazi	ffb07bec-2d10-492d-9c37-361fe0b79427	611050b9-15f9-4400-8074-778f071d446d
0	2	2	Plazi	ffb07bec-2d10-492d-9c37-361fe0b79427	6136754b-8f12-422f-bc1a-1962892aa1dc
6960	6960	0	GBIF Portugal	673f7038-4262-4149-b753-5658a4e912f6	61e5f775-f706-435a-8026-225bdb2d6392
42	42	0	GBIF Germany	4f6826f2-4ff6-443d-b966-e6913bd24013	626d33ce-f762-11e1-a439-00145eb45e9a
221	221	0	GBIF Germany	4f6826f2-4ff6-443d-b966-e6913bd24013	628c0696-f762-11e1-a439-00145eb45e9a
94	94	0	GBIF Germany	4f6826f2-4ff6-443d-b966-e6913bd24013	63380c7a-f762-11e1-a439-00145eb45e9a
280	280	0	GBIF Germany	4f6826f2-4ff6-443d-b966-e6913bd24013	639e4f94-f762-11e1-a439-00145eb45e9a
354	354	0	GBIF Germany	4f6826f2-4ff6-443d-b966-e6913bd24013	654aa7de-f762-11e1-a439-00145eb45e9a
8	8	0	Plazi	ffb07bec-2d10-492d-9c37-361fe0b79427	6656f91c-a30c-4253-b42f-2400e04e7e2e
72	72	0	GBIF Germany	4f6826f2-4ff6-443d-b966-e6913bd24013	67428282-f762-11e1-a439-00145eb45e9a
148	148	0	GBIF Germany	4f6826f2-4ff6-443d-b966-e6913bd24013	67959d8c-f762-11e1-a439-00145eb45e9a
118	118	0	GBIF Germany	4f6826f2-4ff6-443d-b966-e6913bd24013	68969128-f762-11e1-a439-00145eb45e9a
0	23	23	Plazi	ffb07bec-2d10-492d-9c37-361fe0b79427	699f43c2-b33c-4720-9b41-44f7f2d4b83b
5	5	0	Plazi	ffb07bec-2d10-492d-9c37-361fe0b79427	6a00d899-3a3b-499f-a2d1-92fb0d526eea
24	24	0	GBIF Germany	4f6826f2-4ff6-443d-b966-e6913bd24013	6a01a304-f762-11e1-a439-00145eb45e9a
892	892	0	GBIF Germany	4f6826f2-4ff6-443d-b966-e6913bd24013	6a64cf42-f762-11e1-a439-00145eb45e9a
680	680	0	GBIF Germany	4f6826f2-4ff6-443d-b966-e6913bd24013	6a6cabae-f762-11e1-a439-00145eb45e9a
2	2	0	Plazi	ffb07bec-2d10-492d-9c37-361fe0b79427	6aa23c04-eb98-43a7-bc8f-d9d32a0c1750
18	18	0	GBIF Germany	4f6826f2-4ff6-443d-b966-e6913bd24013	6b878572-f762-11e1-a439-00145eb45e9a
11	11	0	Plazi	ffb07bec-2d10-492d-9c37-361fe0b79427	6c0c4a13-180c-43db-b19e-f828948b3224
55	55	0	GBIF Germany	4f6826f2-4ff6-443d-b966-e6913bd24013	6d325794-f762-11e1-a439-00145eb45e9a
1205	1205	0	National Biodiversity Network	d897a5b9-35ee-4232-94bd-b0bcaac003c2	6df0a69a-07d0-49b1-ad0e-294d7b338d3f
12	12	0	GBIF Germany	4f6826f2-4ff6-443d-b966-e6913bd24013	6fab09e4-f762-11e1-a439-00145eb45e9a
12	12	0	GBIF Germany	4f6826f2-4ff6-443d-b966-e6913bd24013	6fd34a9e-f762-11e1-a439-00145eb45e9a
18	18	0	GBIF Germany	4f6826f2-4ff6-443d-b966-e6913bd24013	70057258-f762-11e1-a439-00145eb45e9a
78	78	0	GBIF Germany	4f6826f2-4ff6-443d-b966-e6913bd24013	7157af0e-f762-11e1-a439-00145eb45e9a
77	77	0	GBIF Germany	4f6826f2-4ff6-443d-b966-e6913bd24013	724256d0-f762-11e1-a439-00145eb45e9a
43	43	0	GBIF Germany	4f6826f2-4ff6-443d-b966-e6913bd24013	72b58f10-f762-11e1-a439-00145eb45e9a
15	15	0	GBIF Germany	4f6826f2-4ff6-443d-b966-e6913bd24013	7381ae80-2a0d-45fb-9054-962cff0d3261
15	15	0	GBIF Germany	4f6826f2-4ff6-443d-b966-e6913bd24013	738fdf94-f762-11e1-a439-00145eb45e9a
0	2	2	Ocean Biodiversity Information System	ba0670b9-4186-41e6-8e70-f9cb3065551a	78427cd4-b27a-40ce-bb59-bda857f1a1d3
53	53	0	Biodiversity Information System of Mexico	b324e8e9-9a4c-44fa-8f1a-7f39ea7ab576	78cf2963-1bc2-48d2-bf11-6f36cd64d79c
109	109	0	GBIF France	da44cd31-5901-4687-a106-6d1c7734ee3a	7a92b76b-d40d-48b8-8cf7-663a10612b1c
162	162	0	Ocean Biodiversity Information System	ba0670b9-4186-41e6-8e70-f9cb3065551a	7b5e800e-f762-11e1-a439-00145eb45e9a
335	212	-123	GBIF Germany	4f6826f2-4ff6-443d-b966-e6913bd24013	7d038daa-f762-11e1-a439-00145eb45e9a
828	162	-666	GBIF Germany	4f6826f2-4ff6-443d-b966-e6913bd24013	7d422164-f762-11e1-a439-00145eb45e9a
1323	1323	0	GBIF Spain	1f94b3ca-9345-4d65-afe2-4bace93aa0fe	7d515e86-f762-11e1-a439-00145eb45e9a
8	8	0	Plazi	ffb07bec-2d10-492d-9c37-361fe0b79427	7dad899f-aa0c-4ae6-869b-822a6686570e
896	896	0	GBIF Germany	4f6826f2-4ff6-443d-b966-e6913bd24013	7db9b288-f762-11e1-a439-00145eb45e9a
0	12	12	Participant Node Managers Committee	7f48e0c8-5c96-49ec-b972-30748e339115	7ff51f9e-565f-4009-8a82-255ef83147b4
73	73	0	National Biodiversity Network	d897a5b9-35ee-4232-94bd-b0bcaac003c2	83b69c34-0ab1-4bf7-af03-aafe208a0825
10	10	0	Plazi	ffb07bec-2d10-492d-9c37-361fe0b79427	8446c8e2-60b9-4f2d-988a-b444804fe93b
6	6	0	Plazi	ffb07bec-2d10-492d-9c37-361fe0b79427	84eeefe4-0fe7-4f80-aa80-413da27a4e48
56727	56727	0	GBIF Spain	1f94b3ca-9345-4d65-afe2-4bace93aa0fe	8583f4f6-f762-11e1-a439-00145eb45e9a
0	2	2	Plazi	ffb07bec-2d10-492d-9c37-361fe0b79427	87a7bd61-e8ec-4bf2-b9cb-f0194edea885
16	16	0	GBIF Germany	4f6826f2-4ff6-443d-b966-e6913bd24013	888b7eee-f762-11e1-a439-00145eb45e9a
418	418	0	GBIF Germany	4f6826f2-4ff6-443d-b966-e6913bd24013	89f68c42-f762-11e1-a439-00145eb45e9a
0	9	9	Plazi	ffb07bec-2d10-492d-9c37-361fe0b79427	8ae2190e-71d1-4280-ab1f-9eefc77a1aee
41	41	0	GBIF France	da44cd31-5901-4687-a106-6d1c7734ee3a	8b80bbeb-1ec4-48ee-8af7-b1043a8a3baa
76	76	0	GBIF Germany	4f6826f2-4ff6-443d-b966-e6913bd24013	8b974bb8-f762-11e1-a439-00145eb45e9a
33	33	0	GBIF Germany	4f6826f2-4ff6-443d-b966-e6913bd24013	8c77221a-f762-11e1-a439-00145eb45e9a
51	40	-11	GBIF Germany	4f6826f2-4ff6-443d-b966-e6913bd24013	8c931ad8-f762-11e1-a439-00145eb45e9a
19	19	0	GBIF Germany	4f6826f2-4ff6-443d-b966-e6913bd24013	8ca3d7a6-f762-11e1-a439-00145eb45e9a
13	13	0	Plazi	ffb07bec-2d10-492d-9c37-361fe0b79427	8e9ee39e-ead8-422f-8073-d4f32670a81e
4	4	0	Plazi	ffb07bec-2d10-492d-9c37-361fe0b79427	9025390c-90d8-4942-914a-b7dc84b262aa
280	154	-126	GBIF Germany	4f6826f2-4ff6-443d-b966-e6913bd24013	906df98e-f762-11e1-a439-00145eb45e9a
2497	2099	-398	GBIF Germany	4f6826f2-4ff6-443d-b966-e6913bd24013	907c2f40-f762-11e1-a439-00145eb45e9a
75	49	-26	GBIF Germany	4f6826f2-4ff6-443d-b966-e6913bd24013	90c4becc-f762-11e1-a439-00145eb45e9a
0	8	8	Ocean Biodiversity Information System	ba0670b9-4186-41e6-8e70-f9cb3065551a	92eeebdb-ee1c-437b-9708-81a650085867
182	79	-103	GBIF Germany	4f6826f2-4ff6-443d-b966-e6913bd24013	93029cf4-f762-11e1-a439-00145eb45e9a
11868	11868	0	GBIF Argentina	2426a871-9feb-40a1-96c6-0c593a76b835	93efdc85-10ca-448c-a3e3-01bce24479c9
972	972	0	GBIF Germany	4f6826f2-4ff6-443d-b966-e6913bd24013	941fff64-f762-11e1-a439-00145eb45e9a
927	927	0	GBIF France	da44cd31-5901-4687-a106-6d1c7734ee3a	9435de2c-5e84-4d1f-acfc-3a302453509c
0	2	2	Plazi	ffb07bec-2d10-492d-9c37-361fe0b79427	960f8a78-6e0e-400c-a757-139d33b178bd
40725	40725	0	U.S. Geological Survey	8618c64a-93e0-4300-b546-7249e5148ed2	96ccdb74-f762-11e1-a439-00145eb45e9a
1279	1279	0	GBIF France	da44cd31-5901-4687-a106-6d1c7734ee3a	99ce61d0-c702-4b40-8eb5-0b202a056b01
14	14	0	Plazi	ffb07bec-2d10-492d-9c37-361fe0b79427	9a715a96-332a-4aed-8952-a2b1899be448
0	291175	291175	National Biodiversity Network	d897a5b9-35ee-4232-94bd-b0bcaac003c2	9fad752d-4bf9-4adf-9535-3cf6339a70fb
0	90	90	Plazi	ffb07bec-2d10-492d-9c37-361fe0b79427	a1584a70-08c3-4429-b49e-69ae45cb14ba
0	637	637	Atlas of Living Australia	4a6f1b71-969e-4fc5-a693-282b05e1220c	a560b5f5-1271-4410-9271-e6f77821191d
0	1	1	Plazi	ffb07bec-2d10-492d-9c37-361fe0b79427	af836fce-e26a-488f-a117-0e24da6247a4
0	168	168	Plazi	ffb07bec-2d10-492d-9c37-361fe0b79427	b103e491-89e5-47c7-ad48-dfdfd0399d90
4	4	0	Plazi	ffb07bec-2d10-492d-9c37-361fe0b79427	b387aa15-04e0-4fbd-9ca7-fe8d4dde42ae
4	4	0	Participant Node Managers Committee	7f48e0c8-5c96-49ec-b972-30748e339115	b3e96cd3-bb16-49d9-b49e-0c30c49f156d
0	3	3	Plazi	ffb07bec-2d10-492d-9c37-361fe0b79427	b45a302b-7b6a-493d-a63d-d93bcfd5c84e
2	2	0	Plazi	ffb07bec-2d10-492d-9c37-361fe0b79427	babcd3dc-0627-457d-8f70-5e510a9596e2
467	467	0	Colombian Biodiversity Information System	7e865cba-7c46-417b-ade5-97f2cf5b7be0	bb2c4ae2-106a-45c6-83da-36155c4640f4
0	28	28	Plazi	ffb07bec-2d10-492d-9c37-361fe0b79427	bc74c09a-42b6-496a-920a-c091d73a3dbc
50	50	0	Colombian Biodiversity Information System	7e865cba-7c46-417b-ade5-97f2cf5b7be0	bd7a3612-f2da-49ff-a181-7fe39d31ccc2
1	1	0	Plazi	ffb07bec-2d10-492d-9c37-361fe0b79427	be821e5b-bf9e-43f9-9d06-7aa95a809e0b
12	12	0	Plazi	ffb07bec-2d10-492d-9c37-361fe0b79427	c0535584-eb1e-43b0-9d53-cb700789d423
25	25	0	Biodiversity Information System of Mexico	b324e8e9-9a4c-44fa-8f1a-7f39ea7ab576	c13def4c-bc1d-4506-a654-8b4aadbfbd0b
0	191	191	Plazi	ffb07bec-2d10-492d-9c37-361fe0b79427	c195a6b1-bb09-49a2-8071-5847ca114556
965	965	0	National Biodiversity Network	d897a5b9-35ee-4232-94bd-b0bcaac003c2	c3e7ca6f-b065-444d-ba71-80180c796a18
326086	326086	0	GBIF Estonia	2c11b821-d22b-4c64-8cd3-c1578173b129	c6bbb6ef-ad16-4f3c-99e2-f693760173e0
0	9	9	Plazi	ffb07bec-2d10-492d-9c37-361fe0b79427	c6cde8ed-24fd-430c-b2c6-0af1196b0b5b
24	24	0	Plazi	ffb07bec-2d10-492d-9c37-361fe0b79427	c8335540-0201-4710-ae6f-99e20d7f3592
0	9	9	Plazi	ffb07bec-2d10-492d-9c37-361fe0b79427	c9056261-2c17-4f2a-a6ec-c5a2ba79e0e6
0	1	1	Ocean Biodiversity Information System	ba0670b9-4186-41e6-8e70-f9cb3065551a	c98b675a-6821-44a1-a6b3-13553f86ddb6
2	2	0	Plazi	ffb07bec-2d10-492d-9c37-361fe0b79427	cabc386a-0045-451e-a2fd-6a63ee969a52
8	8	0	Plazi	ffb07bec-2d10-492d-9c37-361fe0b79427	cc9fd001-3a10-46c1-b7ef-934f0fa18aea
2	2	0	Plazi	ffb07bec-2d10-492d-9c37-361fe0b79427	cd265c2e-7627-47cb-b692-8efee608aebe
2	2	0	Plazi	ffb07bec-2d10-492d-9c37-361fe0b79427	cd8ba8a5-8504-4c96-a097-2d359247f7bc
3165	3165	0	Colombian Biodiversity Information System	7e865cba-7c46-417b-ade5-97f2cf5b7be0	cfd3bd8b-1fdf-46c9-be81-39b624fd26ab
0	4	4	Plazi	ffb07bec-2d10-492d-9c37-361fe0b79427	d027edda-ab37-4d09-a47f-42d6f69662e6
0	52	52	Plazi	ffb07bec-2d10-492d-9c37-361fe0b79427	d0f0400d-eb9b-4114-9a4e-a7f7f680e3a3
1	1	0	Plazi	ffb07bec-2d10-492d-9c37-361fe0b79427	d168a1e0-88f9-48ab-a871-cc2d24b026d7
0	6	6	Plazi	ffb07bec-2d10-492d-9c37-361fe0b79427	d493b9e4-397d-4b55-a522-c938a81369e5
0	4	4	Ocean Biodiversity Information System	ba0670b9-4186-41e6-8e70-f9cb3065551a	d5c6cd07-73ae-4f08-8d6b-b46d6ab7d5c5
3	5	2	Plazi	ffb07bec-2d10-492d-9c37-361fe0b79427	d63f2eb6-2ca6-4dc3-bb58-c9a9ba73e7e5
3	3	0	Plazi	ffb07bec-2d10-492d-9c37-361fe0b79427	d71f3b4a-f7a9-4f8b-92a3-f4dcbe49ae17
0	1	1	Plazi	ffb07bec-2d10-492d-9c37-361fe0b79427	da760037-a600-4064-a801-f3e965da7bcf
20	20	0	Plazi	ffb07bec-2d10-492d-9c37-361fe0b79427	db74863d-e285-40fd-813b-3caf3cc64f1f
0	14	14	Plazi	ffb07bec-2d10-492d-9c37-361fe0b79427	dddc4705-c466-4ba8-bd19-0bfee188a1fd
0	6	6	Plazi	ffb07bec-2d10-492d-9c37-361fe0b79427	e109e486-affb-4cc2-a159-1decff4e8853
36	36	0	GBIF France	da44cd31-5901-4687-a106-6d1c7734ee3a	e53c7695-7057-4e8f-9170-be1e9a2873d4
1969174	1969174	0	GBIF France	da44cd31-5901-4687-a106-6d1c7734ee3a	e5f16d86-e225-4822-97be-a64ce17079c7
0	7	7	Plazi	ffb07bec-2d10-492d-9c37-361fe0b79427	e864ab2d-df97-4b23-a62c-902bc88f0eed
0	2	2	Plazi	ffb07bec-2d10-492d-9c37-361fe0b79427	ec1c8bca-c18b-49cb-b4c1-ce7e33180d29
2	2	0	Plazi	ffb07bec-2d10-492d-9c37-361fe0b79427	efe5e5c7-e587-4f72-951e-47630f753d99
143443	146160	2717	Belgian Biodiversity Platform	fb11cfe1-ebc3-45af-9159-17d9fddbcdac	f145c27d-b1c3-4136-85b1-c21674d2d1c3
0	96	96	Ocean Biodiversity Information System	ba0670b9-4186-41e6-8e70-f9cb3065551a	f42628b4-328a-4a77-9ff6-720a5c58f01f
1	1	0	Plazi	ffb07bec-2d10-492d-9c37-361fe0b79427	f6e0271b-972c-4244-bb86-c21e1a7814d1
64	64	0	Plazi	ffb07bec-2d10-492d-9c37-361fe0b79427	f779e870-fe8f-4ad1-bfcb-e9f1c80cea29
5046	3689	-1357	Colombian Biodiversity Information System	7e865cba-7c46-417b-ade5-97f2cf5b7be0	f8f6714c-e846-4ce8-819e-7d39839c2bf7
1	1	0	Plazi	ffb07bec-2d10-492d-9c37-361fe0b79427	f9ddd01d-a1c3-4ace-be6e-5e678ef8cdd2
0	158	158	Colombian Biodiversity Information System	7e865cba-7c46-417b-ade5-97f2cf5b7be0	ffc3e595-60dc-4aac-91d0-ad8b38c9a941
0	336	336	GBIF Luxembourg	b0ccbf42-26b3-412e-b38a-339889154d77	fffb695b-1354-491f-9f69-08530acb322f
0	6	6	Plazi	ffb07bec-2d10-492d-9c37-361fe0b79427	00749f6d-5799-44c5-a5c6-05ecc880a565
38	38	0	Plazi	ffb07bec-2d10-492d-9c37-361fe0b79427	009bde2d-2f94-4126-9299-a54554945982
0	32	32	Plazi	ffb07bec-2d10-492d-9c37-361fe0b79427	00c29333-4029-4b1b-b61b-dc86d7e84bce
3	3	0	Plazi	ffb07bec-2d10-492d-9c37-361fe0b79427	03921aa7-44d3-421f-8821-064c2ec9177a
4	4	0	Plazi	ffb07bec-2d10-492d-9c37-361fe0b79427	07d138bf-2b95-40bc-93d3-fa0913f7a2a0
290	290	0	Participant Node Managers Committee	7f48e0c8-5c96-49ec-b972-30748e339115	0ac41cc1-7d5c-480a-bddd-f3a45e9477ed
0	357	357	Ocean Biodiversity Information System	ba0670b9-4186-41e6-8e70-f9cb3065551a	0c142cd0-6cce-4583-9e6c-0e2841ad7437
3	3	0	Plazi	ffb07bec-2d10-492d-9c37-361fe0b79427	0f8ef623-8084-4f9b-9fba-769954158a82
27	27	0	Colombian Biodiversity Information System	7e865cba-7c46-417b-ade5-97f2cf5b7be0	10368923-5547-4e6c-9eb2-9d674c406283
962	962	0	GBIF Germany	4f6826f2-4ff6-443d-b966-e6913bd24013	10bd62f6-e752-490d-92da-a07b54979975
1	1	0	Plazi	ffb07bec-2d10-492d-9c37-361fe0b79427	10bdfabc-7b1e-4e21-af0e-33d9cf2d8290
0	13	13	Plazi	ffb07bec-2d10-492d-9c37-361fe0b79427	146beedf-2d3c-4ba4-944a-c6050ffde9cd
843	843	0	Atlas of Living Australia	4a6f1b71-969e-4fc5-a693-282b05e1220c	149e44e7-fb0b-4db0-a40a-86e64eb8baf3
0	3	3	Plazi	ffb07bec-2d10-492d-9c37-361fe0b79427	15689915-8842-4d97-badd-a96114a94b4e
3835	3835	0	Ocean Biodiversity Information System	ba0670b9-4186-41e6-8e70-f9cb3065551a	187ca9af-82cb-4255-8613-7b65c8710364
1	1	0	Plazi	ffb07bec-2d10-492d-9c37-361fe0b79427	1a35b0e1-2128-477d-b81f-8c05f3773f36
2	2	0	Plazi	ffb07bec-2d10-492d-9c37-361fe0b79427	1ac3fe79-8ecc-4017-82cf-421f4cd85818
14965	14965	0	GBIF Spain	1f94b3ca-9345-4d65-afe2-4bace93aa0fe	1d743188-1e65-4d99-a814-fa3fd51f1490
152	152	0	U.S. Geological Survey	8618c64a-93e0-4300-b546-7249e5148ed2	1ea11487-c5e7-46d6-982a-0567ba66b802
9216	9216	0	Netherlands Biodiversity Information Facility	0909d601-bda2-42df-9e63-a6d51847ebce	1ed365f0-6167-11de-84c0-b8a03c50a862
0	232	232	GBIF Spain	1f94b3ca-9345-4d65-afe2-4bace93aa0fe	20eb55d9-e808-4ae1-af7a-172a3358f926
1	1	0	Plazi	ffb07bec-2d10-492d-9c37-361fe0b79427	23bda654-50eb-4b8b-8ebb-f03d65d94860
10366	10366	0	National Biodiversity Network	d897a5b9-35ee-4232-94bd-b0bcaac003c2	252b301c-b8d1-4407-8f44-4351055e16c6
367	367	0	Polish Biodiversity Information Network	2618bfdf-e194-4911-a241-80db3107bc51	2553f2c0-139f-11de-b2de-b8a03c50a862
11	11	0	Plazi	ffb07bec-2d10-492d-9c37-361fe0b79427	25db71cd-00c5-4ae7-bc62-4d8e77738231
0	3	3	Plazi	ffb07bec-2d10-492d-9c37-361fe0b79427	28f12d1c-5f28-44bd-b794-10f24aae01f0
106826	110690	3864	U.S. Geological Survey	8618c64a-93e0-4300-b546-7249e5148ed2	2a79f202-3f3a-4d54-88fa-09aa8de1ac73
1	1	0	Plazi	ffb07bec-2d10-492d-9c37-361fe0b79427	2cb435ee-3255-4960-a7b3-ed95a54adf8f
11	11	0	Plazi	ffb07bec-2d10-492d-9c37-361fe0b79427	304f9c12-1474-4a89-a037-cb3cf4cc65b2
0	30	30	GBIF Malawi	2a42e4d7-ad4a-41b3-84c4-de4aa7b74d35	34bf9e92-431e-4761-8efb-794ad8ffe0be
44314	44314	0	National Biodiversity Network	d897a5b9-35ee-4232-94bd-b0bcaac003c2	3968e868-da6f-4120-a0e0-47a5bb6cb5dc
1280	1280	0	Biodiversity Information System of Mexico	b324e8e9-9a4c-44fa-8f1a-7f39ea7ab576	397bcffd-6e9f-4ff2-97ef-8bc2789fd9de
1320	1320	0	GBIF Germany	4f6826f2-4ff6-443d-b966-e6913bd24013	3b5d5701-9cb0-4209-8075-63ba16b5aa0c
0	17840	17840	U.S. Geological Survey	8618c64a-93e0-4300-b546-7249e5148ed2	3eb2dcfd-5a51-4576-a12e-b7bdeea251a6
0	70	70	Netherlands Biodiversity Information Facility	0909d601-bda2-42df-9e63-a6d51847ebce	3f65cbba-e2d6-4fb2-b01b-89c021c294a5
878	878	0	GBIF France	da44cd31-5901-4687-a106-6d1c7734ee3a	4064747c-b4dd-410e-bb1b-fde32038e0a1
2	2	0	Plazi	ffb07bec-2d10-492d-9c37-361fe0b79427	40e29b8c-3460-4f77-9c5c-0de4579d4450
244573	244573	0	GBIF Sweden	a0b3be64-6525-4387-ac67-a499950f92e1	41b59050-0a12-11dd-953d-b8a03c50a862
0	21	21	Plazi	ffb07bec-2d10-492d-9c37-361fe0b79427	4321d317-546a-43e0-b149-3471384daca0
45697	45697	0	Participant Node Managers Committee	7f48e0c8-5c96-49ec-b972-30748e339115	451eb991-c1f4-479f-b1f8-7c1b4e8f9114
23	23	0	Plazi	ffb07bec-2d10-492d-9c37-361fe0b79427	46eb0ca3-9aaa-49d2-8d9b-257d85764630
227	227	0	GBIF France	da44cd31-5901-4687-a106-6d1c7734ee3a	4abcaea9-44ee-444e-9ec8-9698872fa8ce
51	51	0	GBIF France	da44cd31-5901-4687-a106-6d1c7734ee3a	4c227680-af08-4f2b-adf9-f48c1e84fb8c
2	2	0	Plazi	ffb07bec-2d10-492d-9c37-361fe0b79427	4e1a16a5-f22c-40ee-91e8-c131742e6cd8
1	1	0	Plazi	ffb07bec-2d10-492d-9c37-361fe0b79427	5562ad20-07ee-41ef-af3a-963583f5159f
0	1	1	Plazi	ffb07bec-2d10-492d-9c37-361fe0b79427	5de89f6c-aa0e-4f40-bd33-883dce6bb1ba
2	2	0	Plazi	ffb07bec-2d10-492d-9c37-361fe0b79427	5e58bde4-d425-44a1-bb2e-eee6cfabed3b
98	98	0	GBIF France	da44cd31-5901-4687-a106-6d1c7734ee3a	5e5c5111-99b6-4e50-a98a-02fd164a42c7
1	1	0	Plazi	ffb07bec-2d10-492d-9c37-361fe0b79427	5fcf81e9-75d1-41e9-b916-535168614aaa
95	95	0	GBIF Germany	4f6826f2-4ff6-443d-b966-e6913bd24013	61289d82-f762-11e1-a439-00145eb45e9a
158	158	0	GBIF Germany	4f6826f2-4ff6-443d-b966-e6913bd24013	618fbbac-f762-11e1-a439-00145eb45e9a
325	325	0	GBIF Germany	4f6826f2-4ff6-443d-b966-e6913bd24013	61939e52-f762-11e1-a439-00145eb45e9a
89	89	0	GBIF Germany	4f6826f2-4ff6-443d-b966-e6913bd24013	63ab782c-f762-11e1-a439-00145eb45e9a
102	102	0	GBIF Germany	4f6826f2-4ff6-443d-b966-e6913bd24013	63d014e8-f762-11e1-a439-00145eb45e9a
18	18	0	GBIF Germany	4f6826f2-4ff6-443d-b966-e6913bd24013	645d06e6-f762-11e1-a439-00145eb45e9a
75	75	0	GBIF Germany	4f6826f2-4ff6-443d-b966-e6913bd24013	659d1ac8-f762-11e1-a439-00145eb45e9a
11	11	0	GBIF Germany	4f6826f2-4ff6-443d-b966-e6913bd24013	65c3d62c-f762-11e1-a439-00145eb45e9a
144	144	0	Plazi	ffb07bec-2d10-492d-9c37-361fe0b79427	65d843de-4c04-449f-8e5b-168e825cd314
14	14	0	GBIF Germany	4f6826f2-4ff6-443d-b966-e6913bd24013	666e0fd4-f762-11e1-a439-00145eb45e9a
1217	1217	0	National Biodiversity Network	d897a5b9-35ee-4232-94bd-b0bcaac003c2	6670bce5-d324-4a28-b625-7e4ddd8e89d8
499	499	0	GBIF Finland	dd514216-5c7c-45f3-910d-797424cb5be6	669671c6-83f0-4f4d-a1b4-b42799000b35
61	61	0	GBIF Germany	4f6826f2-4ff6-443d-b966-e6913bd24013	66c16954-f762-11e1-a439-00145eb45e9a
8	8	0	Plazi	ffb07bec-2d10-492d-9c37-361fe0b79427	67b19f09-43b9-45ce-9455-a3f7b84207cc
7	7	0	GBIF Germany	4f6826f2-4ff6-443d-b966-e6913bd24013	68cc0dc6-f762-11e1-a439-00145eb45e9a
0	53	53	Plazi	ffb07bec-2d10-492d-9c37-361fe0b79427	69cdb251-ce94-4cf1-b172-06184d5e9cca
11271	11271	0	GBIF Brazil	cdc9736d-5ff7-4ece-9959-3c744360cdb3	6a1267c2-eae0-404f-a827-6dc27b3e1ba2
2	2	0	GBIF Germany	4f6826f2-4ff6-443d-b966-e6913bd24013	6b64b8e4-f762-11e1-a439-00145eb45e9a
18	18	0	GBIF Germany	4f6826f2-4ff6-443d-b966-e6913bd24013	6b9de39e-f762-11e1-a439-00145eb45e9a
2338	7727	5389	National Biodiversity Network	d897a5b9-35ee-4232-94bd-b0bcaac003c2	6d255bce-0129-42c7-bfee-467843015242
9	9	0	Plazi	ffb07bec-2d10-492d-9c37-361fe0b79427	6e8828fd-d525-4cb4-be04-1febefc3b77e
1157	1157	0	GBIF France	da44cd31-5901-4687-a106-6d1c7734ee3a	6f3e9752-048d-4664-98f0-c939750e1cab
6	6	0	Plazi	ffb07bec-2d10-492d-9c37-361fe0b79427	6f796cb4-7f0a-4612-93dc-948bd28a6b3c
2	2	0	GBIF France	da44cd31-5901-4687-a106-6d1c7734ee3a	6fa90780-f0ae-4f62-87ae-3acc4c5893e4
10	10	0	GBIF France	da44cd31-5901-4687-a106-6d1c7734ee3a	6fae9fea-696f-488f-861e-9186d49c4316
0	4	4	Plazi	ffb07bec-2d10-492d-9c37-361fe0b79427	70e4e2ae-37ab-4960-ad7d-e3396013b137
168	168	0	GBIF Germany	4f6826f2-4ff6-443d-b966-e6913bd24013	716809e4-f762-11e1-a439-00145eb45e9a
2	2	0	Plazi	ffb07bec-2d10-492d-9c37-361fe0b79427	7181ae7f-c1f6-453c-a7af-1c430e111afa
6	6	0	Plazi	ffb07bec-2d10-492d-9c37-361fe0b79427	7229be3c-4dd2-48fd-842c-8cb3339df39e
0	2103	2103	Ocean Biodiversity Information System	ba0670b9-4186-41e6-8e70-f9cb3065551a	72ea2b98-32a9-4803-8dc3-5e8813cb2322
56	56	0	GBIF Germany	4f6826f2-4ff6-443d-b966-e6913bd24013	74d503de-f762-11e1-a439-00145eb45e9a
0	26	26	Plazi	ffb07bec-2d10-492d-9c37-361fe0b79427	75068901-feb2-4e3b-9b55-8e235049af46
123	123	0	GBIF Germany	4f6826f2-4ff6-443d-b966-e6913bd24013	75416286-f762-11e1-a439-00145eb45e9a
901638	901638	0	Atlas of Living Australia	4a6f1b71-969e-4fc5-a693-282b05e1220c	7565c55d-9dc8-442d-95cf-19d5ebb3d2b0
219	219	0	GBIF Germany	4f6826f2-4ff6-443d-b966-e6913bd24013	75db5792-f762-11e1-a439-00145eb45e9a
50399	51947	1548	GBIF Norway	4f829580-180d-46a9-9c87-ed8ec959b545	78c1a71e-abb2-49cf-abc8-efafb981b0e4
0	35	35	Ocean Biodiversity Information System	ba0670b9-4186-41e6-8e70-f9cb3065551a	78f86251-fb2f-4935-9051-036790a52393
5	5	0	Plazi	ffb07bec-2d10-492d-9c37-361fe0b79427	79864385-217b-4c12-9df4-cc67235fee7d
24583	24583	0	Canada Biodiversity Information Facility	8f83fc96-c966-4126-83f7-bf044dc49efa	7a7244fc-13b9-43ee-93c9-0d5c4457a86a
825	825	0	GBIF Norway	4f829580-180d-46a9-9c87-ed8ec959b545	7b330f7a-0ec3-4e19-8fbe-727a004df693
3236	3236	0	GBIF Germany	4f6826f2-4ff6-443d-b966-e6913bd24013	7b7dea7a-f762-11e1-a439-00145eb45e9a
101	101	0	GBIF Germany	4f6826f2-4ff6-443d-b966-e6913bd24013	7cf6505e-f762-11e1-a439-00145eb45e9a
289	193	-96	GBIF Germany	4f6826f2-4ff6-443d-b966-e6913bd24013	7dedb04c-f762-11e1-a439-00145eb45e9a
586	586	0	Biodiversity Information System of Mexico	b324e8e9-9a4c-44fa-8f1a-7f39ea7ab576	802cbd26-f762-11e1-a439-00145eb45e9a
4	4	0	Plazi	ffb07bec-2d10-492d-9c37-361fe0b79427	8094226d-1400-4866-ae65-c854b6bafabd
3	3	0	Plazi	ffb07bec-2d10-492d-9c37-361fe0b79427	80adbb44-4263-4972-9c80-19217c50b612
125351	125351	0	GBIF Slovakia	477b14bb-3d5c-474b-8dec-6bd73dd67dec	812c1e24-f762-11e1-a439-00145eb45e9a
122	129	7	GBIF Germany	4f6826f2-4ff6-443d-b966-e6913bd24013	81a9d67a-f762-11e1-a439-00145eb45e9a
301340	304732	3392	GBIF New Zealand	4f9fd726-20dd-445e-89a1-8ed93792276f	83ae84cf-88e4-4b5c-80b2-271a15a3e0fc
1	1	0	Plazi	ffb07bec-2d10-492d-9c37-361fe0b79427	84867756-fb8e-44e0-9dc2-0472215c147f
9	9	0	Plazi	ffb07bec-2d10-492d-9c37-361fe0b79427	84d5fdc0-aca8-4c4a-b581-79723d78d80e
299	220	-79	GBIF Germany	4f6826f2-4ff6-443d-b966-e6913bd24013	86cbf430-f762-11e1-a439-00145eb45e9a
431	319	-112	GBIF Germany	4f6826f2-4ff6-443d-b966-e6913bd24013	87cb5c4a-f762-11e1-a439-00145eb45e9a
9255	9910	655	GBIF Brazil	cdc9736d-5ff7-4ece-9959-3c744360cdb3	880f942a-d574-46e7-b781-2a101a922d2e
1	1	0	Plazi	ffb07bec-2d10-492d-9c37-361fe0b79427	8989262a-2ec9-432a-8826-8b6da7e7a4b6
354	354	0	GBIF Germany	4f6826f2-4ff6-443d-b966-e6913bd24013	89e8b7d4-f762-11e1-a439-00145eb45e9a
531	531	0	GBIF Germany	4f6826f2-4ff6-443d-b966-e6913bd24013	89ee5cde-f762-11e1-a439-00145eb45e9a
3	3	0	Plazi	ffb07bec-2d10-492d-9c37-361fe0b79427	8a173e64-7f56-4310-9046-e48062533e20
124	124	0	GBIF Germany	4f6826f2-4ff6-443d-b966-e6913bd24013	8a48a02c-f762-11e1-a439-00145eb45e9a
2	2	0	Plazi	ffb07bec-2d10-492d-9c37-361fe0b79427	8aa4f1f0-3da1-4e40-af63-3310adbf45f1
0	12	12	Plazi	ffb07bec-2d10-492d-9c37-361fe0b79427	8ab6d0a6-41bc-4301-8b6a-b616e37390bf
430	430	0	GBIF France	da44cd31-5901-4687-a106-6d1c7734ee3a	8ace7c41-51a1-47ca-bac5-409dfb7ee5ce
39	27	-12	GBIF Germany	4f6826f2-4ff6-443d-b966-e6913bd24013	8c817756-f762-11e1-a439-00145eb45e9a
3	3	0	Plazi	ffb07bec-2d10-492d-9c37-361fe0b79427	8ce9bcef-5ff1-4797-a4b2-dd05cb3ab1eb
15	7	-8	GBIF Germany	4f6826f2-4ff6-443d-b966-e6913bd24013	8cf52ce6-f762-11e1-a439-00145eb45e9a
16	7	-9	GBIF Germany	4f6826f2-4ff6-443d-b966-e6913bd24013	8d198ac8-f762-11e1-a439-00145eb45e9a
1286	426	-860	GBIF Germany	4f6826f2-4ff6-443d-b966-e6913bd24013	8e083be6-f762-11e1-a439-00145eb45e9a
2062	2062	0	National Biodiversity Network	d897a5b9-35ee-4232-94bd-b0bcaac003c2	8f72428e-8bff-4745-aa7c-d58b652c1170
763	587	-176	GBIF Germany	4f6826f2-4ff6-443d-b966-e6913bd24013	8fbd4562-f762-11e1-a439-00145eb45e9a
244	187	-57	GBIF Germany	4f6826f2-4ff6-443d-b966-e6913bd24013	8fbe7946-f762-11e1-a439-00145eb45e9a
418	382	-36	GBIF Germany	4f6826f2-4ff6-443d-b966-e6913bd24013	8fc9e15a-f762-11e1-a439-00145eb45e9a
783	313	-470	GBIF Germany	4f6826f2-4ff6-443d-b966-e6913bd24013	90f1fb12-f762-11e1-a439-00145eb45e9a
575	575	0	GBIF Germany	4f6826f2-4ff6-443d-b966-e6913bd24013	91bf1926-f762-11e1-a439-00145eb45e9a
0	2280	2280	Participant Node Managers Committee	7f48e0c8-5c96-49ec-b972-30748e339115	91f04313-0699-41a7-87ef-2b0c13180778
57	57	0	GBIF Germany	4f6826f2-4ff6-443d-b966-e6913bd24013	92921b0a-f762-11e1-a439-00145eb45e9a
65	65	0	GBIF Germany	4f6826f2-4ff6-443d-b966-e6913bd24013	959d80f0-f762-11e1-a439-00145eb45e9a
5998	5678	-320	National Biodiversity Network	d897a5b9-35ee-4232-94bd-b0bcaac003c2	95c79da4-a323-474d-92ae-6c252701db1e
42	42	0	Plazi	ffb07bec-2d10-492d-9c37-361fe0b79427	95dd362c-59b3-409a-8846-a51b6e839ff1
17	17	0	Colombian Biodiversity Information System	7e865cba-7c46-417b-ade5-97f2cf5b7be0	96d123bf-cb92-48a3-a5f8-47d306e2e566
0	12	12	Plazi	ffb07bec-2d10-492d-9c37-361fe0b79427	98172de9-175e-4333-9cbe-eeda12ae448e
0	2	2	Plazi	ffb07bec-2d10-492d-9c37-361fe0b79427	987191fb-df1e-4522-8ac5-5fe5321e2060
1	1	0	Plazi	ffb07bec-2d10-492d-9c37-361fe0b79427	9947b8bd-51ab-4790-b966-56ff1a66e9b7
17	17	0	Plazi	ffb07bec-2d10-492d-9c37-361fe0b79427	9a8e166e-b20d-4c78-b26e-5175b2a1e10b
0	77	77	Colombian Biodiversity Information System	7e865cba-7c46-417b-ade5-97f2cf5b7be0	9b0a2e42-3bf2-4152-8cf1-84552caecbc4
28	28	0	GBIF Germany	4f6826f2-4ff6-443d-b966-e6913bd24013	9ee20b2c-b060-4d6d-8982-9955c6a5f9bd
281	281	0	Plazi	ffb07bec-2d10-492d-9c37-361fe0b79427	9fce96d4-8e89-4264-944a-4aef2a8046cb
0	6	6	Plazi	ffb07bec-2d10-492d-9c37-361fe0b79427	a166177a-6054-4611-abca-a571a3647c61
0	779	779	Ocean Biodiversity Information System	ba0670b9-4186-41e6-8e70-f9cb3065551a	a5662ff8-18f5-4ffc-a40a-d750f1f84fb0
0	1091	1091	Atlas of Living Australia	4a6f1b71-969e-4fc5-a693-282b05e1220c	a59435cf-8cb7-4c09-917d-937c156f054e
0	2	2	Ocean Biodiversity Information System	ba0670b9-4186-41e6-8e70-f9cb3065551a	a8ac13a1-8863-4cce-86ea-ace0432ca819
185	185	0	GBIF Argentina	2426a871-9feb-40a1-96c6-0c593a76b835	ab6a3642-0f18-4f76-98f5-da9e99ef09ca
215	215	0	GBIF France	da44cd31-5901-4687-a106-6d1c7734ee3a	aeb30eee-e770-4b24-86f2-b74918610519
3	3	0	Plazi	ffb07bec-2d10-492d-9c37-361fe0b79427	afe65a87-5307-4488-8450-89036d9e018e
81	81	0	GBIF Germany	4f6826f2-4ff6-443d-b966-e6913bd24013	b006f68f-c6ed-4f9d-b952-48e323f0de5f
2505	2971	466	GBIF Brazil	cdc9736d-5ff7-4ece-9959-3c744360cdb3	b0d19078-0cb5-48a8-841c-d0d3afb2a074
5	5	0	Plazi	ffb07bec-2d10-492d-9c37-361fe0b79427	b1eb82cd-2851-49c4-9397-bbddbb965cc1
0	16	16	Plazi	ffb07bec-2d10-492d-9c37-361fe0b79427	b24b2dea-b1dd-4746-bce2-6c0e059da8d7
0	4	4	Plazi	ffb07bec-2d10-492d-9c37-361fe0b79427	b2701eb2-3a17-4e33-907b-37e810df5ce3
16	16	0	Plazi	ffb07bec-2d10-492d-9c37-361fe0b79427	b2c6b8ea-ae44-4fc9-bb48-d419ddb7aeb1
231	231	0	GBIF Sweden	a0b3be64-6525-4387-ac67-a499950f92e1	b441a3a1-e679-46fa-8095-a909c53a5506
17	17	0	Plazi	ffb07bec-2d10-492d-9c37-361fe0b79427	b45d8c59-075d-4c9f-a912-367e906a447e
0	35	35	Ocean Biodiversity Information System	ba0670b9-4186-41e6-8e70-f9cb3065551a	b4f69e5a-d2b2-453d-b3ae-3ed389e30bff
0	247	247	Plazi	ffb07bec-2d10-492d-9c37-361fe0b79427	b57353e3-eb49-4e99-8bbc-663c127b6842
4	4	0	Plazi	ffb07bec-2d10-492d-9c37-361fe0b79427	b8c4cd82-b49a-4e44-8947-27d66251ed72
0	24	24	Ocean Biodiversity Information System	ba0670b9-4186-41e6-8e70-f9cb3065551a	b8ea59b7-02b2-4ecf-aca3-669b8011dff3
6	6	0	Plazi	ffb07bec-2d10-492d-9c37-361fe0b79427	b9acaac4-8c44-4aee-9f65-0024469b24de
183	183	0	Participant Node Managers Committee	7f48e0c8-5c96-49ec-b972-30748e339115	bbeed253-5f28-4a94-a0b2-398609d570f4
0	315	315	GBIF Portugal	673f7038-4262-4149-b753-5658a4e912f6	c162fd2f-5254-43fa-a32f-681084e8a293
0	16	16	Plazi	ffb07bec-2d10-492d-9c37-361fe0b79427	c4a3ab5c-5976-4f9b-a21c-d4903aca6390
19	19	0	Plazi	ffb07bec-2d10-492d-9c37-361fe0b79427	c5e9551c-68b3-4d87-b2aa-a8cbe0a82cac
52	52	0	GBIF Brazil	cdc9736d-5ff7-4ece-9959-3c744360cdb3	c6609a9b-1c94-4571-a419-8a90c365cc69
823	823	0	South African Biodiversity Information Facility	7190b835-4e86-4b6e-85c1-19cc6677c250	c6ad8415-263a-4674-81fc-f590bcaaaea0
0	1	1	Plazi	ffb07bec-2d10-492d-9c37-361fe0b79427	c939fce7-155d-44c6-ab27-abb7e4a11a51
0	2	2	Plazi	ffb07bec-2d10-492d-9c37-361fe0b79427	c9e0c08b-364d-40bc-add8-3b74814199b3
60	60	0	GBIF France	da44cd31-5901-4687-a106-6d1c7734ee3a	cb7b533c-104f-4cd9-af7e-2007f7d5ece8
1	1	0	Plazi	ffb07bec-2d10-492d-9c37-361fe0b79427	cf0541cf-da9e-4125-a167-9b0ee0631484
0	538	538	GBIF Benin	efb9c00e-f802-45dd-8826-a52ec45b89ff	d163d7c6-0694-47b2-934c-7305f56ad479
0	2	2	Plazi	ffb07bec-2d10-492d-9c37-361fe0b79427	d68b8780-6292-4329-96db-a70b2d842086
23	23	0	National Biodiversity Network	d897a5b9-35ee-4232-94bd-b0bcaac003c2	daf9babb-bbc0-4404-be67-3812cb8eb89d
22	22	0	Colombian Biodiversity Information System	7e865cba-7c46-417b-ade5-97f2cf5b7be0	dfd89bcc-538c-4c81-868b-0497497f2c08
468	468	0	GBIF Germany	4f6826f2-4ff6-443d-b966-e6913bd24013	e00491e3-e9da-4c24-8fcc-4ac89496ece9
3	3	0	Plazi	ffb07bec-2d10-492d-9c37-361fe0b79427	e12cf913-921c-47ec-b175-6b3c316abea4
32877	92932	60055	GBIF Estonia	2c11b821-d22b-4c64-8cd3-c1578173b129	e1539f14-f749-4f73-8c18-3355277f94f4
212	212	0	U.S. Geological Survey	8618c64a-93e0-4300-b546-7249e5148ed2	e1d6517b-a0fd-4e7a-851e-74cdf6087c12
20414	20414	0	GBIF New Zealand	4f9fd726-20dd-445e-89a1-8ed93792276f	e2980e63-d152-4219-8c1e-0ffdef3ea6aa
0	5	5	Ocean Biodiversity Information System	ba0670b9-4186-41e6-8e70-f9cb3065551a	e48cdc69-298b-49de-9c2c-f449d7eb7a01
755	755	0	GBIF Norway	4f829580-180d-46a9-9c87-ed8ec959b545	e5daba37-255f-4ac9-b45a-b3ac722ec488
8	8	0	Plazi	ffb07bec-2d10-492d-9c37-361fe0b79427	e679a1e4-43cc-4ab1-bb7d-e788fc23dc7a
18	18	0	Plazi	ffb07bec-2d10-492d-9c37-361fe0b79427	e69bebc4-3979-4935-9ce5-1f4adb60006f
5	5	0	Plazi	ffb07bec-2d10-492d-9c37-361fe0b79427	e88901ca-0462-458b-8c97-ee56e79fe9c1
0	9	9	Plazi	ffb07bec-2d10-492d-9c37-361fe0b79427	eb5297a4-9107-4eef-8c81-109ee8948145
22	22	0	Plazi	ffb07bec-2d10-492d-9c37-361fe0b79427	eda0d38a-f1b2-43cb-bb9b-7b8296e4f60f
0	227	227	U.S. Geological Survey	8618c64a-93e0-4300-b546-7249e5148ed2	f0abd990-8209-44b2-891d-04a3cb30830b
1296	1296	0	GBIF Japan	db5705aa-6a6e-42f1-8942-d77b9f4896ea	f1b180c7-b103-47f2-9636-3fe7ccf1343a
21	21	0	Plazi	ffb07bec-2d10-492d-9c37-361fe0b79427	f65561ec-cbbc-4c7a-a477-acbcd804a495
8	8	0	Plazi	ffb07bec-2d10-492d-9c37-361fe0b79427	f98bf04b-5258-48c9-8f36-cd153f554967
36	36	0	Plazi	ffb07bec-2d10-492d-9c37-361fe0b79427	fa2a6380-86e0-4589-8cb9-2438a8ede5c7
17517	29847	12330	National Biodiversity Network	d897a5b9-35ee-4232-94bd-b0bcaac003c2	fb1ff97d-b030-4a37-9fd4-5c65f12db810
3253	3253	0	U.S. Geological Survey	8618c64a-93e0-4300-b546-7249e5148ed2	fcba1f2e-c8b8-491f-8b5f-62fae3157cc7
0	7	7	Plazi	ffb07bec-2d10-492d-9c37-361fe0b79427	fed2a029-b04a-47b8-94dd-f5e86b35829e
6	6	0	Plazi	ffb07bec-2d10-492d-9c37-361fe0b79427	00277876-8cee-488e-a7ff-1b16c68ef515
0	3	3	Plazi	ffb07bec-2d10-492d-9c37-361fe0b79427	0184f1c3-9f92-4a74-a2b9-061f66884e6d
3	3	0	Plazi	ffb07bec-2d10-492d-9c37-361fe0b79427	02ba62cc-666f-490d-81d6-485a751257d3
11	11	0	Plazi	ffb07bec-2d10-492d-9c37-361fe0b79427	03111e3b-fb1a-4034-834c-e995f8e85e8e
829	829	0	GBIF France	da44cd31-5901-4687-a106-6d1c7734ee3a	0387f456-7b71-44bc-bb41-04478624021c
80	80	0	Plazi	ffb07bec-2d10-492d-9c37-361fe0b79427	054f51a7-8cd3-40a9-8780-709583a5de6a
2583	2583	0	Korean Biodiversity Information Facility	e0a1e772-0177-4800-94b4-2d023fe6cdf4	0580c96f-63d3-4c6a-ae8a-64d6ef9f5fd3
62	62	0	GBIF France	da44cd31-5901-4687-a106-6d1c7734ee3a	0d5b3cfd-88d4-41d6-83de-4e0dd2ed7ab5
0	2	2	Participant Node Managers Committee	7f48e0c8-5c96-49ec-b972-30748e339115	0fbbb5ab-4ea8-45a8-bd3e-82adb9c01268
0	1	1	Plazi	ffb07bec-2d10-492d-9c37-361fe0b79427	10cfd605-c696-4422-bdce-2865fc404275
225	225	0	Ocean Biodiversity Information System	ba0670b9-4186-41e6-8e70-f9cb3065551a	116fd540-36a8-4c36-8274-67d90815fd5f
20256	35713	15457	GBIF Japan	db5705aa-6a6e-42f1-8942-d77b9f4896ea	168f92f9-8738-4959-8d42-e98cd18a7746
277	277	0	South African Biodiversity Information Facility	7190b835-4e86-4b6e-85c1-19cc6677c250	16905d82-40c5-416c-a82a-c4effc339f07
34	34	0	GBIF France	da44cd31-5901-4687-a106-6d1c7734ee3a	1897931a-ad28-4293-a7da-91f891be805e
1456	1456	0	National Biodiversity Network	d897a5b9-35ee-4232-94bd-b0bcaac003c2	1ab98b49-9f71-4fa8-894a-4d57b08c8135
49	49	0	Plazi	ffb07bec-2d10-492d-9c37-361fe0b79427	1ca4d646-ef92-4c3d-94b0-376566b09210
304	304	0	GBIF France	da44cd31-5901-4687-a106-6d1c7734ee3a	1ccba4d3-b708-4024-a01d-4061d9eb2f80
0	3	3	Plazi	ffb07bec-2d10-492d-9c37-361fe0b79427	1f8e9559-cf3e-46f5-ac23-9dd2faf907b3
0	25	25	Plazi	ffb07bec-2d10-492d-9c37-361fe0b79427	204ef7e8-5ba9-4591-8275-598a53611feb
14	14	0	Participant Node Managers Committee	7f48e0c8-5c96-49ec-b972-30748e339115	231acf5a-0727-4315-b97d-957746e5f197
152	152	0	GBIF Nigeria	6529bcb5-a542-4fda-be87-54a624515335	26e549a9-07f7-48b1-a289-7f7f08cc6377
9	9	0	Colombian Biodiversity Information System	7e865cba-7c46-417b-ade5-97f2cf5b7be0	275b895d-7c74-40d4-a78f-4a75a3c7879b
5	5	0	Plazi	ffb07bec-2d10-492d-9c37-361fe0b79427	27e78288-1765-4ce5-aa1f-ad1281ecdfe3
0	3958	3958	Ocean Biodiversity Information System	ba0670b9-4186-41e6-8e70-f9cb3065551a	280f02be-49c4-4dff-9f7f-9515e7b5fb17
8	8	0	Plazi	ffb07bec-2d10-492d-9c37-361fe0b79427	29c8f46f-e68c-4636-bb7c-f596a8bed886
0	32776	32776	Ocean Biodiversity Information System	ba0670b9-4186-41e6-8e70-f9cb3065551a	2a975c3c-24ce-43f4-87ba-d58856ffd529
1	1	0	Plazi	ffb07bec-2d10-492d-9c37-361fe0b79427	2bf7bbf1-b215-4683-a285-3407eb1d2dc7
0	5	5	Plazi	ffb07bec-2d10-492d-9c37-361fe0b79427	2d946906-07b4-44cb-abbd-18d19d7d30d1
111	111	0	Plazi	ffb07bec-2d10-492d-9c37-361fe0b79427	312733bb-486b-4f4c-b8b3-260aea3285a9
2	2	0	Plazi	ffb07bec-2d10-492d-9c37-361fe0b79427	348e1a52-72a5-4809-b533-a158fc7a298a
0	250	250	Ocean Biodiversity Information System	ba0670b9-4186-41e6-8e70-f9cb3065551a	34b60255-3e3d-472c-948d-b653cec3b6d3
327	327	0	GBIF Germany	4f6826f2-4ff6-443d-b966-e6913bd24013	351a7a4b-5126-4cb7-8ace-3e1a726fe660
326	326	0	Colombian Biodiversity Information System	7e865cba-7c46-417b-ade5-97f2cf5b7be0	38012fb6-c779-4ef8-8b02-3f458709b5a0
736	736	0	Colombian Biodiversity Information System	7e865cba-7c46-417b-ade5-97f2cf5b7be0	3858f505-2693-4327-81c0-12148a3a810f
0	11	11	Plazi	ffb07bec-2d10-492d-9c37-361fe0b79427	38808f1d-0656-4659-bc31-0e5eee066ed6
493	493	0	Participant Node Managers Committee	7f48e0c8-5c96-49ec-b972-30748e339115	38f2594c-d424-4ac3-a560-a69bfeb6dc3b
137	137	0	National Biodiversity Network	d897a5b9-35ee-4232-94bd-b0bcaac003c2	3a6ab9d2-a0e2-4c16-8040-2e1ad912547c
777	777	0	GBIF France	da44cd31-5901-4687-a106-6d1c7734ee3a	3bad05e1-2fe0-469e-9560-45e7d1d1b70c
0	80	80	Participant Node Managers Committee	7f48e0c8-5c96-49ec-b972-30748e339115	3d3f3dbc-5926-458e-95fa-e5950ba72367
5	5	0	Plazi	ffb07bec-2d10-492d-9c37-361fe0b79427	3da62e39-7304-4933-a4eb-aecbc1c5d77e
233	233	0	GBIF Germany	4f6826f2-4ff6-443d-b966-e6913bd24013	406ffe78-2000-43c4-8793-f2109cfad0f3
3	3	0	GBIF Germany	4f6826f2-4ff6-443d-b966-e6913bd24013	445dc244-3a0c-11e2-b0ce-00145eb45e9a
218	218	0	GBIF Germany	4f6826f2-4ff6-443d-b966-e6913bd24013	44ed3d7a-3a0c-11e2-b0ce-00145eb45e9a
454	454	0	GBIF Germany	4f6826f2-4ff6-443d-b966-e6913bd24013	458a8b22-7f21-428e-a2d0-4f7076c47441
8	8	0	National Biodiversity Network	d897a5b9-35ee-4232-94bd-b0bcaac003c2	45db4709-e256-40e5-8f23-3bac72f842d6
3	3	0	Plazi	ffb07bec-2d10-492d-9c37-361fe0b79427	483422c1-72de-4da3-926d-5df6c1d6310c
9	9	0	Plazi	ffb07bec-2d10-492d-9c37-361fe0b79427	4a340d87-34e5-4fc5-98e0-d8f63f40986a
8914	8914	0	GBIF Norway	4f829580-180d-46a9-9c87-ed8ec959b545	4b456e0f-a945-4083-8a72-79ea06898258
0	71	71	Plazi	ffb07bec-2d10-492d-9c37-361fe0b79427	4c61138f-c521-4710-9429-ba232d0bef4a
0	57941	57941	Taiwan Biodiversity Information Facility	e1b85abc-61f9-430f-ba79-6813dec53a0f	4daa291b-0e9d-4e21-b78d-6b4e96093adc
0	50	50	Ocean Biodiversity Information System	ba0670b9-4186-41e6-8e70-f9cb3065551a	50188f1f-0f68-423a-a59e-6e14399cfd4c
1	1	0	Plazi	ffb07bec-2d10-492d-9c37-361fe0b79427	508268f7-507e-479b-8b08-1db3a24798cf
0	22	22	Ocean Biodiversity Information System	ba0670b9-4186-41e6-8e70-f9cb3065551a	56f3f088-29c5-4359-afea-bbf68665b7fb
4486	4486	0	Biodiversity Information System of Mexico	b324e8e9-9a4c-44fa-8f1a-7f39ea7ab576	57746ff2-ac01-4889-899f-713f4de3226d
0	5	5	Plazi	ffb07bec-2d10-492d-9c37-361fe0b79427	587335ef-885f-4157-b0c2-920ce11cf5cc
0	67	67	Plazi	ffb07bec-2d10-492d-9c37-361fe0b79427	592c9898-f961-4f9b-a833-5de174eb834b
5	5	0	Plazi	ffb07bec-2d10-492d-9c37-361fe0b79427	592d61c6-57d1-4f7d-83b7-be124e1c14b7
26	26	0	Plazi	ffb07bec-2d10-492d-9c37-361fe0b79427	5ed7f7fb-b6df-4c99-a5db-1934f372b3c7
101	101	0	GBIF Germany	4f6826f2-4ff6-443d-b966-e6913bd24013	61a64322-f762-11e1-a439-00145eb45e9a
299	299	0	GBIF Germany	4f6826f2-4ff6-443d-b966-e6913bd24013	6267690e-41aa-4953-8e72-6c09bb34e297
268	268	0	GBIF Germany	4f6826f2-4ff6-443d-b966-e6913bd24013	6549794a-f762-11e1-a439-00145eb45e9a
132	87	-45	GBIF Germany	4f6826f2-4ff6-443d-b966-e6913bd24013	660343f2-f762-11e1-a439-00145eb45e9a
343	343	0	National Biodiversity Network	d897a5b9-35ee-4232-94bd-b0bcaac003c2	66bafa47-bcfa-4141-8628-98a41a9ca5a4
0	20144	20144	Ocean Biodiversity Information System	ba0670b9-4186-41e6-8e70-f9cb3065551a	66cc4704-24c5-469b-8490-f726141c996d
53	53	0	GBIF Germany	4f6826f2-4ff6-443d-b966-e6913bd24013	677d6b18-f762-11e1-a439-00145eb45e9a
29	29	0	GBIF Germany	4f6826f2-4ff6-443d-b966-e6913bd24013	6807ce3e-f762-11e1-a439-00145eb45e9a
64	64	0	GBIF Germany	4f6826f2-4ff6-443d-b966-e6913bd24013	681fe028-f762-11e1-a439-00145eb45e9a
202	202	0	GBIF France	da44cd31-5901-4687-a106-6d1c7734ee3a	683a71b4-3fc0-45da-8e45-ef3b8303963f
15	15	0	GBIF Germany	4f6826f2-4ff6-443d-b966-e6913bd24013	687fef18-f762-11e1-a439-00145eb45e9a
138	138	0	GBIF Germany	4f6826f2-4ff6-443d-b966-e6913bd24013	68887462-f762-11e1-a439-00145eb45e9a
121	121	0	GBIF Germany	4f6826f2-4ff6-443d-b966-e6913bd24013	690f72dc-f762-11e1-a439-00145eb45e9a
5833	5833	0	Polish Biodiversity Information Network	2618bfdf-e194-4911-a241-80db3107bc51	693c2044-5fe9-489d-a07d-cc4583cbf6b0
22	22	0	GBIF Germany	4f6826f2-4ff6-443d-b966-e6913bd24013	6a944efc-f762-11e1-a439-00145eb45e9a
8726	8726	0	National Biodiversity Network	d897a5b9-35ee-4232-94bd-b0bcaac003c2	6ad35c63-fa06-48c3-966f-d2089c7b5d6e
18	18	0	GBIF Germany	4f6826f2-4ff6-443d-b966-e6913bd24013	6b94e37a-f762-11e1-a439-00145eb45e9a
1200	1200	0	GBIF Germany	4f6826f2-4ff6-443d-b966-e6913bd24013	6ba31bfc-f762-11e1-a439-00145eb45e9a
2872	2872	0	GBIF France	da44cd31-5901-4687-a106-6d1c7734ee3a	6e3b0205-06fb-4005-a90c-91b7c70238d1
508	508	0	GBIF Germany	4f6826f2-4ff6-443d-b966-e6913bd24013	7150f38c-4d01-4364-94c5-829e608cd113
0	2	2	Ocean Biodiversity Information System	ba0670b9-4186-41e6-8e70-f9cb3065551a	716f4ac9-617a-447f-8027-d1217e153f06
42702	42702	0	GBIF Germany	4f6826f2-4ff6-443d-b966-e6913bd24013	71f4c974-f762-11e1-a439-00145eb45e9a
1127	1127	0	GBIF Madagascar	2dbfc5c5-51b5-4494-9dfc-4d3f013a3b64	72414bd9-69dc-461c-8034-b7d895eccf63
29	29	0	GBIF Germany	4f6826f2-4ff6-443d-b966-e6913bd24013	745b9f9e-f762-11e1-a439-00145eb45e9a
0	19	19	Plazi	ffb07bec-2d10-492d-9c37-361fe0b79427	74c8a3cd-c737-41aa-b574-04ef00c173f7
0	257	257	Ocean Biodiversity Information System	ba0670b9-4186-41e6-8e70-f9cb3065551a	7549d2c2-f76a-494b-b6eb-195ef6e434e6
25	25	0	Plazi	ffb07bec-2d10-492d-9c37-361fe0b79427	77681f01-edd3-4313-9ecf-f1ffb7a127de
1226	1226	0	National Biodiversity Network	d897a5b9-35ee-4232-94bd-b0bcaac003c2	77c9df08-bf54-4705-86e4-42e778f8694f
53	53	0	GBIF Germany	4f6826f2-4ff6-443d-b966-e6913bd24013	784de31e-f762-11e1-a439-00145eb45e9a
42	42	0	GBIF Germany	4f6826f2-4ff6-443d-b966-e6913bd24013	78cf05a2-f762-11e1-a439-00145eb45e9a
66	66	0	GBIF Germany	4f6826f2-4ff6-443d-b966-e6913bd24013	791e2b78-f762-11e1-a439-00145eb45e9a
162	162	0	GBIF Germany	4f6826f2-4ff6-443d-b966-e6913bd24013	79497f1c-f762-11e1-a439-00145eb45e9a
1	1	0	Plazi	ffb07bec-2d10-492d-9c37-361fe0b79427	7990becb-b13a-449c-bb35-4ee9d033c9a5
353280	353280	0	U.S. Geological Survey	8618c64a-93e0-4300-b546-7249e5148ed2	7c1373e6-36e2-486f-9e09-ef36cd12c6ed
475	235	-240	GBIF Germany	4f6826f2-4ff6-443d-b966-e6913bd24013	7c1a76a6-f762-11e1-a439-00145eb45e9a
235	235	0	Biodiversity Information System of Mexico	b324e8e9-9a4c-44fa-8f1a-7f39ea7ab576	7cce36e9-a60e-466c-9468-dc0485461881
113	113	0	Atlas of Living Australia	4a6f1b71-969e-4fc5-a693-282b05e1220c	7d08feb6-f762-11e1-a439-00145eb45e9a
174	174	0	Korean Biodiversity Information Facility	e0a1e772-0177-4800-94b4-2d023fe6cdf4	7d981632-c6f6-446d-a987-239704ac0641
17499	17500	1	U.S. Geological Survey	8618c64a-93e0-4300-b546-7249e5148ed2	7d9be62e-5c69-4537-8559-a851e16118f0
35	38	3	GBIF Germany	4f6826f2-4ff6-443d-b966-e6913bd24013	7e0a28a8-f762-11e1-a439-00145eb45e9a
71	67	-4	GBIF Germany	4f6826f2-4ff6-443d-b966-e6913bd24013	7e81f568-f762-11e1-a439-00145eb45e9a
1503	1503	0	GBIF Germany	4f6826f2-4ff6-443d-b966-e6913bd24013	7e932658-f762-11e1-a439-00145eb45e9a
4	4	0	Plazi	ffb07bec-2d10-492d-9c37-361fe0b79427	7f2671b2-d26a-4f72-ad1e-5dd3fd67ffc8
0	5	5	Plazi	ffb07bec-2d10-492d-9c37-361fe0b79427	7fce7c7b-e1aa-4235-9d84-70cfbf263777
1164	1164	0	GBIF France	da44cd31-5901-4687-a106-6d1c7734ee3a	805d6fc6-d434-4d3f-840d-8343b8a7a56c
3527	679	-2848	Biodiversity Information System of Mexico	b324e8e9-9a4c-44fa-8f1a-7f39ea7ab576	80850062-f762-11e1-a439-00145eb45e9a
0	8	8	Participant Node Managers Committee	7f48e0c8-5c96-49ec-b972-30748e339115	80b8d3bf-179d-4059-811d-6d3571d22cb1
11	11	0	GBIF Japan	db5705aa-6a6e-42f1-8942-d77b9f4896ea	80f50d26-f762-11e1-a439-00145eb45e9a
44	44	0	GBIF Germany	4f6826f2-4ff6-443d-b966-e6913bd24013	81772e14-f762-11e1-a439-00145eb45e9a
13	13	0	GBIF Germany	4f6826f2-4ff6-443d-b966-e6913bd24013	8258687a-f762-11e1-a439-00145eb45e9a
400427	400427	0	National Biodiversity Network	d897a5b9-35ee-4232-94bd-b0bcaac003c2	832fa9ed-1aa9-47dd-9cba-6a58d91b8a12
165591	165591	0	U.S. Geological Survey	8618c64a-93e0-4300-b546-7249e5148ed2	84aa5ee4-f762-11e1-a439-00145eb45e9a
7918	7918	0	Canada Biodiversity Information Facility	8f83fc96-c966-4126-83f7-bf044dc49efa	84f728be-f762-11e1-a439-00145eb45e9a
188	188	0	Biodiversity Information System of Mexico	b324e8e9-9a4c-44fa-8f1a-7f39ea7ab576	85114140-f762-11e1-a439-00145eb45e9a
0	5	5	Ocean Biodiversity Information System	ba0670b9-4186-41e6-8e70-f9cb3065551a	8567bc27-321e-4788-86ee-c2faaa35c4d0
30917	30917	0	U.S. Geological Survey	8618c64a-93e0-4300-b546-7249e5148ed2	861f9a3c-f762-11e1-a439-00145eb45e9a
5	5	0	Plazi	ffb07bec-2d10-492d-9c37-361fe0b79427	86a7188c-a474-4fc5-a8e5-b9384c223736
574	574	0	GBIF Germany	4f6826f2-4ff6-443d-b966-e6913bd24013	86ff13c4-f762-11e1-a439-00145eb45e9a
886	655	-231	GBIF Germany	4f6826f2-4ff6-443d-b966-e6913bd24013	87ed3ed2-f762-11e1-a439-00145eb45e9a
52	52	0	GBIF Germany	4f6826f2-4ff6-443d-b966-e6913bd24013	87f38035-820c-444c-afc3-c98f1fdb4438
5836	5836	0	Participant Node Managers Committee	7f48e0c8-5c96-49ec-b972-30748e339115	882145dc-e998-4808-bb2e-c2bdd5c7edd0
980	980	0	GBIF Germany	4f6826f2-4ff6-443d-b966-e6913bd24013	893afe00-f762-11e1-a439-00145eb45e9a
44	44	0	Plazi	ffb07bec-2d10-492d-9c37-361fe0b79427	898ecee8-1c5a-4969-b340-03a52d6bb1bd
4	4	0	GBIF Germany	4f6826f2-4ff6-443d-b966-e6913bd24013	8ba4d846-f762-11e1-a439-00145eb45e9a
33	33	0	GBIF Germany	4f6826f2-4ff6-443d-b966-e6913bd24013	8bda2118-f762-11e1-a439-00145eb45e9a
770	660	-110	GBIF Germany	4f6826f2-4ff6-443d-b966-e6913bd24013	8d88942c-f762-11e1-a439-00145eb45e9a
182	57	-125	GBIF Germany	4f6826f2-4ff6-443d-b966-e6913bd24013	8dddb952-f762-11e1-a439-00145eb45e9a
238	107	-131	GBIF Germany	4f6826f2-4ff6-443d-b966-e6913bd24013	8f0408ae-f762-11e1-a439-00145eb45e9a
34	31	-3	GBIF Germany	4f6826f2-4ff6-443d-b966-e6913bd24013	914dbfd8-f762-11e1-a439-00145eb45e9a
2430	1674	-756	GBIF Germany	4f6826f2-4ff6-443d-b966-e6913bd24013	91b5ef68-f762-11e1-a439-00145eb45e9a
0	7	7	Plazi	ffb07bec-2d10-492d-9c37-361fe0b79427	923e6ea3-280a-4537-9c89-f2f6900ab904
0	69	69	Ocean Biodiversity Information System	ba0670b9-4186-41e6-8e70-f9cb3065551a	92676046-aad9-42e8-b7a7-3a8334177060
122	122	0	GBIF Germany	4f6826f2-4ff6-443d-b966-e6913bd24013	936b6342-f762-11e1-a439-00145eb45e9a
0	144	144	GBIF France	da44cd31-5901-4687-a106-6d1c7734ee3a	938ba530-f997-462e-b79f-399e572c6be6
290	290	0	GBIF Germany	4f6826f2-4ff6-443d-b966-e6913bd24013	93b57b9e-f762-11e1-a439-00145eb45e9a
355	355	0	GBIF Germany	4f6826f2-4ff6-443d-b966-e6913bd24013	97c08bb6-f762-11e1-a439-00145eb45e9a
30070	30070	0	National Biodiversity Network	d897a5b9-35ee-4232-94bd-b0bcaac003c2	9b1158e7-2283-4ea6-950d-ad522790cf7f
1051	1051	0	Netherlands Biodiversity Information Facility	0909d601-bda2-42df-9e63-a6d51847ebce	9cbcf2b3-448f-48ce-9510-39e25c6234a8
2661	2661	0	GBIF Benin	efb9c00e-f802-45dd-8826-a52ec45b89ff	9e9aa5e4-3717-4212-94f0-089e4a24f501
4	4	0	Plazi	ffb07bec-2d10-492d-9c37-361fe0b79427	9fa78a2b-54eb-4e26-8bc2-c14b2b7ae946
3	3	0	Plazi	ffb07bec-2d10-492d-9c37-361fe0b79427	a056a6d5-d43d-475e-aa60-6a02fff9896b
0	2	2	Plazi	ffb07bec-2d10-492d-9c37-361fe0b79427	a10a831f-2740-452e-991f-825dc53f80bc
64	64	0	GBIF France	da44cd31-5901-4687-a106-6d1c7734ee3a	a15c72e0-9673-4218-a371-492deaf8a26b
6854	6854	0	U.S. Geological Survey	8618c64a-93e0-4300-b546-7249e5148ed2	a204e694-be91-47b9-9ddd-0f63784e9626
63	63	0	Plazi	ffb07bec-2d10-492d-9c37-361fe0b79427	a20dc7bd-2f44-4d2e-a5e6-bfd99c1f3b77
200	200	0	Korean Biodiversity Information Facility	e0a1e772-0177-4800-94b4-2d023fe6cdf4	a7418919-3235-4cd5-97c7-2e9961c5fc97
592	592	0	Colombian Biodiversity Information System	7e865cba-7c46-417b-ade5-97f2cf5b7be0	a9255982-bbf4-4185-808a-30ad4ea4aab9
74	74	0	GBIF France	da44cd31-5901-4687-a106-6d1c7734ee3a	a9efc668-76e1-4255-a4ab-0ef55b66b634
21485	21485	0	GBIF Germany	4f6826f2-4ff6-443d-b966-e6913bd24013	afaa80a2-6167-47e1-baae-5450206d07dd
664024	728055	64031	GBIF Switzerland	169eb292-376b-4cc6-8e31-9c2c432de0ad	b087c908-e2fb-413e-b107-c507b212169f
8690	8012	-678	Biodiversity Information System of Mexico	b324e8e9-9a4c-44fa-8f1a-7f39ea7ab576	b14cd984-dfc4-499d-b1bd-650ceef3608a
391	391	0	GBIF France	da44cd31-5901-4687-a106-6d1c7734ee3a	b46bac86-8a8e-443a-859a-f117dd378b7a
1723	1723	0	GBIF Germany	4f6826f2-4ff6-443d-b966-e6913bd24013	ba946df7-e5a6-4856-80af-340b88965aba
2	2	0	Plazi	ffb07bec-2d10-492d-9c37-361fe0b79427	bb173d14-d9c2-48bb-8f2b-0054ce6955be
6	6	0	Plazi	ffb07bec-2d10-492d-9c37-361fe0b79427	bc36d20e-1cfa-407c-b521-1cc0d981a615
0	59	59	Plazi	ffb07bec-2d10-492d-9c37-361fe0b79427	bd70ee4d-0ae3-4785-9cae-a389c9b11121
0	2	2	Participant Node Managers Committee	7f48e0c8-5c96-49ec-b972-30748e339115	be4c306d-8d16-4390-8604-2b836af47879
26	26	0	Plazi	ffb07bec-2d10-492d-9c37-361fe0b79427	bf7bf5a5-c3b9-4e4e-bf70-3a1bf9d16c5e
457	457	0	Plazi	ffb07bec-2d10-492d-9c37-361fe0b79427	c374bffb-02ad-4cfd-ab69-fc74b15c27a8
18	18	0	GBIF Argentina	2426a871-9feb-40a1-96c6-0c593a76b835	c45f0877-c9c0-47ed-b710-d5a9e0393f7d
136	136	0	Colombian Biodiversity Information System	7e865cba-7c46-417b-ade5-97f2cf5b7be0	c503e9fc-fd1c-4da5-b862-9bdc3ab69f18
6947	6947	0	Netherlands Biodiversity Information Facility	0909d601-bda2-42df-9e63-a6d51847ebce	c8db36cf-6b3e-403f-b609-dc0b6ef0cc05
0	2	2	Plazi	ffb07bec-2d10-492d-9c37-361fe0b79427	c93e8e91-6c74-47fe-b1d1-1f556c02874c
0	12	12	Plazi	ffb07bec-2d10-492d-9c37-361fe0b79427	c96d8c18-56f6-4f64-817a-2e90cc58a8e3
0	3	3	Plazi	ffb07bec-2d10-492d-9c37-361fe0b79427	cc20e37b-ecd6-4e0b-a00a-69cf0f4ab919
0	22	22	Ocean Biodiversity Information System	ba0670b9-4186-41e6-8e70-f9cb3065551a	cf6d38ac-3789-4d63-bced-d67b3cc05280
0	9	9	Plazi	ffb07bec-2d10-492d-9c37-361fe0b79427	d26984c9-7a06-41e0-a1a7-0fd305bbbf79
98	98	0	GBIF Germany	4f6826f2-4ff6-443d-b966-e6913bd24013	d2ccf2da-abfb-4762-bb37-64d139d29b00
39	39	0	GBIF France	da44cd31-5901-4687-a106-6d1c7734ee3a	d360cd4d-901d-4247-9a2c-dbbe512ffd0c
2967	2967	0	GBIF Cameroon	cfe0cad9-2bf4-4d16-ae33-c3dfb0da1ed9	d469da6c-c56c-4332-ad91-3af0f2c6fbeb
38	38	0	Ocean Biodiversity Information System	ba0670b9-4186-41e6-8e70-f9cb3065551a	d4f8fd34-c724-4af0-a140-095c97a81516
2660	2660	0	GBIF France	da44cd31-5901-4687-a106-6d1c7734ee3a	d6a3ccff-1a58-4b45-9a5e-b27d5c2796a6
874	874	0	GBIF France	da44cd31-5901-4687-a106-6d1c7734ee3a	d8cb2703-b53b-480a-aecb-8234d893bdb4
0	10	10	Plazi	ffb07bec-2d10-492d-9c37-361fe0b79427	da3a8e32-ba5c-4043-90c3-909cd8ceff35
468	468	0	GBIF Germany	4f6826f2-4ff6-443d-b966-e6913bd24013	dbc2d368-b09f-11e2-a01d-00145eb45e9a
0	11	11	Plazi	ffb07bec-2d10-492d-9c37-361fe0b79427	dd304d25-18d2-4f50-968b-bcdbfce8f4ad
14	14	0	Plazi	ffb07bec-2d10-492d-9c37-361fe0b79427	dd576c9b-d9d2-4991-ab16-7b6a5061568f
0	8750	8750	Korean Biodiversity Information Facility	e0a1e772-0177-4800-94b4-2d023fe6cdf4	e06c51b2-b942-4807-ad02-14e5320fe27e
0	3	3	Plazi	ffb07bec-2d10-492d-9c37-361fe0b79427	e10ab63b-6038-41a2-b575-2fe9531cb9ec
80	80	0	Plazi	ffb07bec-2d10-492d-9c37-361fe0b79427	e1ccc1ae-df73-4c82-8df3-71545f424c5b
19	19	0	National Biodiversity Network	d897a5b9-35ee-4232-94bd-b0bcaac003c2	e1d22861-0e15-40eb-84ec-6ebe716e66ec
0	450	450	Korean Biodiversity Information Facility	e0a1e772-0177-4800-94b4-2d023fe6cdf4	e3a8858f-8cc5-457e-8252-5d39675bee7d
33	33	0	GBIF France	da44cd31-5901-4687-a106-6d1c7734ee3a	e55596c5-eeca-43eb-8eaf-c5ae3a82814b
5207	5207	0	National Biodiversity Network	d897a5b9-35ee-4232-94bd-b0bcaac003c2	e5cd9465-308d-436b-ba68-cfda9aad6af1
2080	2080	0	Colombian Biodiversity Information System	7e865cba-7c46-417b-ade5-97f2cf5b7be0	e64db70b-e7d9-4c3f-973a-458cc04949a8
6400	6400	0	Participant Node Managers Committee	7f48e0c8-5c96-49ec-b972-30748e339115	e79ec95a-a90f-4f99-819c-8e4ec58e6bd3
37	37	0	Plazi	ffb07bec-2d10-492d-9c37-361fe0b79427	ec4f28bb-c90c-494f-b4ce-d61f70aa8357
17520	17520	0	GBIF Norway	4f829580-180d-46a9-9c87-ed8ec959b545	ed527c71-23aa-40cf-b16b-1a5b8ec6770a
10	10	0	Plazi	ffb07bec-2d10-492d-9c37-361fe0b79427	ed7dc9b4-c502-4e6d-84f7-e7cb614e9211
2	2	0	Plazi	ffb07bec-2d10-492d-9c37-361fe0b79427	f0a02ad8-8709-4da6-a647-d93d2803d756
97321	97321	0	U.S. Geological Survey	8618c64a-93e0-4300-b546-7249e5148ed2	f0a7ca6e-8da6-4629-97bd-0368705a4d6b
0	30	30	Ocean Biodiversity Information System	ba0670b9-4186-41e6-8e70-f9cb3065551a	f0af4f61-af39-4a48-9a52-1f8df470bf7c
21	21	0	Plazi	ffb07bec-2d10-492d-9c37-361fe0b79427	f1ba7d62-d6eb-4d7a-92dc-6896b5b06913
588	588	0	Colombian Biodiversity Information System	7e865cba-7c46-417b-ade5-97f2cf5b7be0	f3a47394-1eb4-4889-a656-957439a1a82d
0	44	44	Ocean Biodiversity Information System	ba0670b9-4186-41e6-8e70-f9cb3065551a	f5ba9d9b-707a-4897-bc81-a87e4a811e4e
1	1	0	Plazi	ffb07bec-2d10-492d-9c37-361fe0b79427	f5f101ed-a88c-4d65-9e10-c1567c48963d
110	110	0	National Biodiversity Network	d897a5b9-35ee-4232-94bd-b0bcaac003c2	f6830cb5-7e7d-4d61-b360-796e9af68968
1005	1005	0	Biodiversity Information System of Mexico	b324e8e9-9a4c-44fa-8f1a-7f39ea7ab576	f69bab24-acf8-4ec8-a65a-832317314e38
0	10	10	Plazi	ffb07bec-2d10-492d-9c37-361fe0b79427	f786929c-60be-4659-a2c2-214c363c634e
24	24	0	Colombian Biodiversity Information System	7e865cba-7c46-417b-ade5-97f2cf5b7be0	f7bb8f09-db25-4a2a-bdda-d6feda377aac
1558	1672	114	Biodiversity Information System of Mexico	b324e8e9-9a4c-44fa-8f1a-7f39ea7ab576	f841662a-c6fb-4aad-bee8-d96356c93531
1	1	0	Plazi	ffb07bec-2d10-492d-9c37-361fe0b79427	f9ca5f83-6010-4580-ad47-8b9b7d8b8374
4	4	0	Plazi	ffb07bec-2d10-492d-9c37-361fe0b79427	f9d4eeac-c927-43bd-b23c-5a5724d8a49f
458	458	0	GBIF France	da44cd31-5901-4687-a106-6d1c7734ee3a	fa609d5b-f9e9-487b-803e-b3ff77e15790
105	105	0	Biodiversity Information System of Mexico	b324e8e9-9a4c-44fa-8f1a-7f39ea7ab576	faeb7430-9940-4131-8982-9986bc4a0952
4296	4296	0	Biodiversity Information System of Mexico	b324e8e9-9a4c-44fa-8f1a-7f39ea7ab576	08a2981f-1e9e-4353-8599-65c448bac864
55	55	0	GBIF Argentina	2426a871-9feb-40a1-96c6-0c593a76b835	0b3e642d-2259-4800-8af0-56b0641fc834
0	17	17	Plazi	ffb07bec-2d10-492d-9c37-361fe0b79427	0bb26949-8468-457c-8096-3947995f9cdc
5	5	0	Plazi	ffb07bec-2d10-492d-9c37-361fe0b79427	0cb0c88f-3e8b-4552-9567-18b4178d846d
0	11	11	Plazi	ffb07bec-2d10-492d-9c37-361fe0b79427	0ccfa02b-ad51-4a1e-bcb0-f570370d6441
89874	89874	0	GBIF France	da44cd31-5901-4687-a106-6d1c7734ee3a	0e3d6f05-a287-4ffd-852d-4e17db22d810
5	5	0	Plazi	ffb07bec-2d10-492d-9c37-361fe0b79427	0e90d391-1a90-437c-b8a9-7d8002d9eeb1
7	7	0	Plazi	ffb07bec-2d10-492d-9c37-361fe0b79427	0f0310ca-ef91-4f63-8a4a-8bb404b1be6c
76	76	0	Colombian Biodiversity Information System	7e865cba-7c46-417b-ade5-97f2cf5b7be0	10c7f262-df1b-45a5-bab0-bba608920293
0	239	239	Ocean Biodiversity Information System	ba0670b9-4186-41e6-8e70-f9cb3065551a	146a4750-5f3b-4cab-aa82-d56af2e4813f
1014	1014	0	GBIF France	da44cd31-5901-4687-a106-6d1c7734ee3a	1708b7a0-39c9-494b-bf38-f2b8d9008d57
0	46	46	Plazi	ffb07bec-2d10-492d-9c37-361fe0b79427	1a2ba1ca-028f-4b95-8dda-5ddec4e63524
11	11	0	Plazi	ffb07bec-2d10-492d-9c37-361fe0b79427	1aadaf3e-7c01-4a89-ba32-120f97b146fa
646	646	0	GBIF Malawi	2a42e4d7-ad4a-41b3-84c4-de4aa7b74d35	1c13a825-dc25-462d-8df3-583b055caac9
63999	64172	173	GBIF Brazil	cdc9736d-5ff7-4ece-9959-3c744360cdb3	1e0f3d99-eb02-4806-b6a4-e903568129ec
45	45	0	Plazi	ffb07bec-2d10-492d-9c37-361fe0b79427	23903efe-ba7a-438c-a04f-d4b08680b640
0	14580	14580	Ocean Biodiversity Information System	ba0670b9-4186-41e6-8e70-f9cb3065551a	23bebe58-2fbc-4522-930f-6e32b2499aee
6029	6029	0	GBIF Benin	efb9c00e-f802-45dd-8826-a52ec45b89ff	25c6f98b-1820-4822-b575-a192eec9c321
11163	11163	0	GBIF France	da44cd31-5901-4687-a106-6d1c7734ee3a	2789b16e-f00b-4f0f-9200-5eaa05acbf15
510	510	0	GBIF France	da44cd31-5901-4687-a106-6d1c7734ee3a	297e4c67-dccc-4922-a95e-b51f53d06530
495600	495600	0	GBIF New Zealand	4f9fd726-20dd-445e-89a1-8ed93792276f	2a636fd6-dc73-49c0-9e5b-26bd05532313
5	5	0	Participant Node Managers Committee	7f48e0c8-5c96-49ec-b972-30748e339115	2ab222f2-2293-4398-9bdf-0223462d9399
108	252	144	National Biodiversity Data Centre	422b00b2-6c94-4bb6-976b-c359916efdb8	2b656601-8b91-4ae1-a6ab-06a6cd94f9fb
6071	6071	0	Colombian Biodiversity Information System	7e865cba-7c46-417b-ade5-97f2cf5b7be0	2bee4a91-9d92-430e-a87e-ab32d3b1ce47
1408	374	-1034	GBIF Germany	4f6826f2-4ff6-443d-b966-e6913bd24013	2de5f224-3a10-4d06-bbd0-440233775f8a
432	326	-106	Biodiversity Information System of Mexico	b324e8e9-9a4c-44fa-8f1a-7f39ea7ab576	2e03ac6f-316e-48d9-9cbb-23f408705b94
2782	2782	0	Colombian Biodiversity Information System	7e865cba-7c46-417b-ade5-97f2cf5b7be0	2e13e783-dbff-4ecf-a3ff-f1bb434fec81
0	9	9	Plazi	ffb07bec-2d10-492d-9c37-361fe0b79427	2edc02f0-9992-4016-acaf-97b462513991
46	46	0	GBIF Brazil	cdc9736d-5ff7-4ece-9959-3c744360cdb3	309dfa3f-b8bf-41e5-937a-a3022fe49db4
2301	2301	0	National Biodiversity Network	d897a5b9-35ee-4232-94bd-b0bcaac003c2	3154be8c-11da-4433-a6a8-7a110984281d
143	33	-110	GBIF Germany	4f6826f2-4ff6-443d-b966-e6913bd24013	343e05a1-04f4-4127-b444-f0a2dbccdf6f
5747	5747	0	Ocean Biodiversity Information System	ba0670b9-4186-41e6-8e70-f9cb3065551a	35bc2b2e-47f7-4bdd-a291-596f4b3376ad
10	10	0	Plazi	ffb07bec-2d10-492d-9c37-361fe0b79427	35edb1bb-d2a1-4824-87af-8c9e6e7349bf
7	7	0	Plazi	ffb07bec-2d10-492d-9c37-361fe0b79427	3884cd58-c4dc-49fa-aa6d-ecb8faa5b506
10	10	0	Plazi	ffb07bec-2d10-492d-9c37-361fe0b79427	3a37e924-c1a7-4c8f-9075-48b64f5f354b
118	118	0	GBIF France	da44cd31-5901-4687-a106-6d1c7734ee3a	3aa0ac8a-493e-4001-9145-e26792275993
1292	1292	0	GBIF Madagascar	2dbfc5c5-51b5-4494-9dfc-4d3f013a3b64	3b4d8218-cbcf-47f3-a65e-b4ca5f966503
0	4	4	Ocean Biodiversity Information System	ba0670b9-4186-41e6-8e70-f9cb3065551a	3df0f3a6-37fd-46a3-873a-6fc437ba35b7
229	229	0	Biodiversity Information System of Mexico	b324e8e9-9a4c-44fa-8f1a-7f39ea7ab576	40d0144d-b34a-4c17-87b3-108d9109f250
0	1	1	Plazi	ffb07bec-2d10-492d-9c37-361fe0b79427	41b14463-de8e-42ab-8f94-732aa5447ac5
2	2	0	Plazi	ffb07bec-2d10-492d-9c37-361fe0b79427	424c0ab2-4b56-44ed-a7da-6ea77d90b7bf
220	198	-22	GBIF Germany	4f6826f2-4ff6-443d-b966-e6913bd24013	42f47817-e24a-4dea-ba48-0909261091df
29	29	0	Colombian Biodiversity Information System	7e865cba-7c46-417b-ade5-97f2cf5b7be0	44c28cce-f455-4002-b6d3-96ccdd30e8b3
13	13	0	GBIF Japan	db5705aa-6a6e-42f1-8942-d77b9f4896ea	4868fe29-3ad6-41b7-825d-f39233b37fbd
0	42	42	Plazi	ffb07bec-2d10-492d-9c37-361fe0b79427	4b691c56-9b16-4c47-bfe1-0a24acaa5c72
42	42	0	U.S. Geological Survey	8618c64a-93e0-4300-b546-7249e5148ed2	4c13483d-a2ac-4c61-9087-c4e1a3c7b91d
0	5	5	Plazi	ffb07bec-2d10-492d-9c37-361fe0b79427	4dce5e5a-9601-41d1-a4d0-d1c7b7b19ccd
0	8	8	Ocean Biodiversity Information System	ba0670b9-4186-41e6-8e70-f9cb3065551a	4efedfee-8651-495f-a778-f2b67a06c552
7418	7418	0	GBIF France	da44cd31-5901-4687-a106-6d1c7734ee3a	50a71fb1-2da5-411b-b0f8-b49eb5e822cd
19683	17609	-2074	Biodiversity Information System of Mexico	b324e8e9-9a4c-44fa-8f1a-7f39ea7ab576	5140e9ce-ca14-4f1f-a5b3-f9023f4e4043
10	10	0	GBIF Japan	db5705aa-6a6e-42f1-8942-d77b9f4896ea	5299d81c-113a-4c24-8f56-8deccb1fa4e1
105	105	0	National Biodiversity Network	d897a5b9-35ee-4232-94bd-b0bcaac003c2	53c36c0e-ae07-4f51-bc1d-983922c8df73
43802	43962	160	U.S. Geological Survey	8618c64a-93e0-4300-b546-7249e5148ed2	54086159-ab02-4669-bc8a-0ad4be3dbfef
2304	2304	0	GBIF Germany	4f6826f2-4ff6-443d-b966-e6913bd24013	58b7924a-9a1e-43aa-96b2-695990167ba1
1	1	0	Plazi	ffb07bec-2d10-492d-9c37-361fe0b79427	58f86b60-9f82-4bdb-a617-a03852815525
0	51	51	Colombian Biodiversity Information System	7e865cba-7c46-417b-ade5-97f2cf5b7be0	59c36a19-7aed-4961-9ff9-b2dc787c2e45
0	479	479	National Biodiversity Network	d897a5b9-35ee-4232-94bd-b0bcaac003c2	5b3e56b8-4a15-4ede-ab18-731fec30dce0
24	24	0	GBIF Germany	4f6826f2-4ff6-443d-b966-e6913bd24013	5bc9f3a1-87a0-42b6-a5aa-4816dfcefe96
4	4	0	Plazi	ffb07bec-2d10-492d-9c37-361fe0b79427	5dbd8193-53c1-4b85-8a47-94281cb54775
2413	9992	7579	GBIF Japan	db5705aa-6a6e-42f1-8942-d77b9f4896ea	6018941d-c361-456d-a615-c3d34a033f6f
3	3	0	Plazi	ffb07bec-2d10-492d-9c37-361fe0b79427	60a62369-ff1f-47c3-bef8-18a1abab115d
25	25	0	GBIF France	da44cd31-5901-4687-a106-6d1c7734ee3a	60b1bca2-26c6-41ff-ab7e-4fdc44416728
89	89	0	GBIF Germany	4f6826f2-4ff6-443d-b966-e6913bd24013	62733f26-f762-11e1-a439-00145eb45e9a
371	371	0	GBIF Germany	4f6826f2-4ff6-443d-b966-e6913bd24013	636fde0c-f762-11e1-a439-00145eb45e9a
188	188	0	GBIF Germany	4f6826f2-4ff6-443d-b966-e6913bd24013	663a2368-f762-11e1-a439-00145eb45e9a
26	26	0	GBIF Germany	4f6826f2-4ff6-443d-b966-e6913bd24013	668f9b68-f762-11e1-a439-00145eb45e9a
442	442	0	GBIF Madagascar	2dbfc5c5-51b5-4494-9dfc-4d3f013a3b64	67b8da16-2b1b-42e0-b072-3318e430dffe
53	53	0	GBIF Germany	4f6826f2-4ff6-443d-b966-e6913bd24013	67ba9a9c-f762-11e1-a439-00145eb45e9a
125	125	0	GBIF Germany	4f6826f2-4ff6-443d-b966-e6913bd24013	6849d5ae-f762-11e1-a439-00145eb45e9a
14	14	0	GBIF Germany	4f6826f2-4ff6-443d-b966-e6913bd24013	68e846bc-f762-11e1-a439-00145eb45e9a
34	34	0	GBIF Germany	4f6826f2-4ff6-443d-b966-e6913bd24013	69a0cd72-f762-11e1-a439-00145eb45e9a
106	106	0	GBIF Germany	4f6826f2-4ff6-443d-b966-e6913bd24013	6a1efb2a-f762-11e1-a439-00145eb45e9a
3018	3018	0	GBIF Spain	1f94b3ca-9345-4d65-afe2-4bace93aa0fe	6baf52f1-f65e-463d-9538-1610febdc06f
7	7	0	GBIF Germany	4f6826f2-4ff6-443d-b966-e6913bd24013	6fd60df6-f762-11e1-a439-00145eb45e9a
14	14	0	Plazi	ffb07bec-2d10-492d-9c37-361fe0b79427	70213048-4950-4064-b085-e13bb570ae0a
3249	3249	0	GBIF Germany	4f6826f2-4ff6-443d-b966-e6913bd24013	712244c2-f762-11e1-a439-00145eb45e9a
0	24	24	Plazi	ffb07bec-2d10-492d-9c37-361fe0b79427	73118235-60d5-4680-bde2-8e96b0663fc7
2	2	0	GBIF Germany	4f6826f2-4ff6-443d-b966-e6913bd24013	7391343e-f762-11e1-a439-00145eb45e9a
9	9	0	GBIF Germany	4f6826f2-4ff6-443d-b966-e6913bd24013	7455176e-f762-11e1-a439-00145eb45e9a
79	79	0	GBIF Germany	4f6826f2-4ff6-443d-b966-e6913bd24013	7485a4c4-f762-11e1-a439-00145eb45e9a
372	372	0	GBIF Germany	4f6826f2-4ff6-443d-b966-e6913bd24013	74b5c883-1756-4ab6-8919-0db2ef89c497
1219	621	-598	GBIF Germany	4f6826f2-4ff6-443d-b966-e6913bd24013	784b6f26-f762-11e1-a439-00145eb45e9a
499	400	-99	GBIF Germany	4f6826f2-4ff6-443d-b966-e6913bd24013	797dfb16-f762-11e1-a439-00145eb45e9a
287	287	0	GBIF Germany	4f6826f2-4ff6-443d-b966-e6913bd24013	79c78880-f762-11e1-a439-00145eb45e9a
24408	24408	0	Korean Biodiversity Information Facility	e0a1e772-0177-4800-94b4-2d023fe6cdf4	7afa8518-f762-11e1-a439-00145eb45e9a
13	13	0	GBIF Germany	4f6826f2-4ff6-443d-b966-e6913bd24013	7cdfe45e-f762-11e1-a439-00145eb45e9a
228	228	0	GBIF Germany	4f6826f2-4ff6-443d-b966-e6913bd24013	7dc6b7e4-f762-11e1-a439-00145eb45e9a
0	2809	2809	Ocean Biodiversity Information System	ba0670b9-4186-41e6-8e70-f9cb3065551a	7f1bf640-dd56-41e2-a827-a3175aed4d95
74	74	0	GBIF Germany	4f6826f2-4ff6-443d-b966-e6913bd24013	7f273ef6-f762-11e1-a439-00145eb45e9a
323	323	0	Biodiversity Information System of Mexico	b324e8e9-9a4c-44fa-8f1a-7f39ea7ab576	8083c8fa-f762-11e1-a439-00145eb45e9a
2399	2212	-187	Biodiversity Information System of Mexico	b324e8e9-9a4c-44fa-8f1a-7f39ea7ab576	809e70d8-f762-11e1-a439-00145eb45e9a
5080	5080	0	Biodiversity Information System of Mexico	b324e8e9-9a4c-44fa-8f1a-7f39ea7ab576	80adb142-f762-11e1-a439-00145eb45e9a
1	1	0	GBIF France	da44cd31-5901-4687-a106-6d1c7734ee3a	80f79f9a-cc71-4e3e-bad4-62712f40dae6
550	550	0	GBIF Germany	4f6826f2-4ff6-443d-b966-e6913bd24013	81cf34a6-f762-11e1-a439-00145eb45e9a
299	299	0	National Biodiversity Network	d897a5b9-35ee-4232-94bd-b0bcaac003c2	820ff166-940d-4d9c-b2c9-5abda213ac45
5	5	0	GBIF Germany	4f6826f2-4ff6-443d-b966-e6913bd24013	82178e4a-f762-11e1-a439-00145eb45e9a
128	88	-40	GBIF Germany	4f6826f2-4ff6-443d-b966-e6913bd24013	821a137c-f762-11e1-a439-00145eb45e9a
2380	1184	-1196	GBIF Germany	4f6826f2-4ff6-443d-b966-e6913bd24013	823b1e6e-f762-11e1-a439-00145eb45e9a
1180	1180	0	GBIF France	da44cd31-5901-4687-a106-6d1c7734ee3a	82d63fc5-8df1-4748-a038-931f363313a9
59235	59235	0	GBIF Spain	1f94b3ca-9345-4d65-afe2-4bace93aa0fe	83598aa6-f762-11e1-a439-00145eb45e9a
0	133	133	Colombian Biodiversity Information System	7e865cba-7c46-417b-ade5-97f2cf5b7be0	84393a94-21b9-4f21-a018-e0095eb325e7
36	36	0	U.S. Geological Survey	8618c64a-93e0-4300-b546-7249e5148ed2	85206c74-f762-11e1-a439-00145eb45e9a
1	1	0	GBIF Finland	dd514216-5c7c-45f3-910d-797424cb5be6	852b19da-f762-11e1-a439-00145eb45e9a
0	161	161	Ocean Biodiversity Information System	ba0670b9-4186-41e6-8e70-f9cb3065551a	85881c39-e58a-4f38-862b-deff162bbf17
6	6	0	Plazi	ffb07bec-2d10-492d-9c37-361fe0b79427	85e4dc75-26c2-4da8-8414-08185bfe44ad
351	248	-103	GBIF Germany	4f6826f2-4ff6-443d-b966-e6913bd24013	877e04fe-f762-11e1-a439-00145eb45e9a
16	16	0	GBIF Germany	4f6826f2-4ff6-443d-b966-e6913bd24013	886a82a2-f762-11e1-a439-00145eb45e9a
6066	6066	0	Participant Node Managers Committee	7f48e0c8-5c96-49ec-b972-30748e339115	892a2c22-d234-4e74-a3b7-d1fb82fc731b
26	26	0	Plazi	ffb07bec-2d10-492d-9c37-361fe0b79427	8951d1d9-2f42-479c-bbc8-3cd002ced019
232	232	0	GBIF Germany	4f6826f2-4ff6-443d-b966-e6913bd24013	8a6d7302-f762-11e1-a439-00145eb45e9a
77	77	0	GBIF Germany	4f6826f2-4ff6-443d-b966-e6913bd24013	8bddcafc-f762-11e1-a439-00145eb45e9a
0	8	8	Plazi	ffb07bec-2d10-492d-9c37-361fe0b79427	8beb2282-5d7d-47fc-9d5f-d68401fa0cfd
38	25	-13	GBIF Germany	4f6826f2-4ff6-443d-b966-e6913bd24013	8c8b8ad4-f762-11e1-a439-00145eb45e9a
22	22	0	Plazi	ffb07bec-2d10-492d-9c37-361fe0b79427	8c98e9f6-7bd0-4a15-9fe2-6015700904d1
129	105	-24	GBIF Germany	4f6826f2-4ff6-443d-b966-e6913bd24013	8ccbada8-f762-11e1-a439-00145eb45e9a
28	21	-7	GBIF Germany	4f6826f2-4ff6-443d-b966-e6913bd24013	8e1c0388-f762-11e1-a439-00145eb45e9a
10	6	-4	GBIF Germany	4f6826f2-4ff6-443d-b966-e6913bd24013	8e54fc38-f762-11e1-a439-00145eb45e9a
171	125	-46	GBIF Germany	4f6826f2-4ff6-443d-b966-e6913bd24013	900503d4-f762-11e1-a439-00145eb45e9a
281336	281336	0	U.S. Geological Survey	8618c64a-93e0-4300-b546-7249e5148ed2	91641b5c-7afa-4262-9fe0-d22d067ce299
165	100	-65	GBIF Germany	4f6826f2-4ff6-443d-b966-e6913bd24013	918ddfe6-f762-11e1-a439-00145eb45e9a
5	5	0	Plazi	ffb07bec-2d10-492d-9c37-361fe0b79427	922d80a2-bdb6-483f-b98f-1ad000cfe001
394	394	0	GBIF Germany	4f6826f2-4ff6-443d-b966-e6913bd24013	93c75a3a-f762-11e1-a439-00145eb45e9a
4	4	0	Plazi	ffb07bec-2d10-492d-9c37-361fe0b79427	96e04e64-f59c-427f-99ab-6ee1eed8b762
30	30	0	GBIF Germany	4f6826f2-4ff6-443d-b966-e6913bd24013	97693442-f762-11e1-a439-00145eb45e9a
2864	2864	0	Canada Biodiversity Information Facility	8f83fc96-c966-4126-83f7-bf044dc49efa	989befd8-6125-4b6a-8f58-51eca5354ae1
0	30	30	Plazi	ffb07bec-2d10-492d-9c37-361fe0b79427	99846b7b-971a-4553-bec8-9e03107c8d8d
1229	1229	0	GBIF France	da44cd31-5901-4687-a106-6d1c7734ee3a	9c655684-0ccf-4bb7-8c23-1d879f4ab142
29	29	0	Plazi	ffb07bec-2d10-492d-9c37-361fe0b79427	9d77686c-259b-431c-a3c4-074d3ba1620b
200	200	0	GBIF Japan	db5705aa-6a6e-42f1-8942-d77b9f4896ea	9e5a422c-aaab-4e23-ae1c-2b921f6363cb
11	11	0	Plazi	ffb07bec-2d10-492d-9c37-361fe0b79427	9e965fe4-24cc-4b6f-ada9-8029fc75aff7
0	317	317	Colombian Biodiversity Information System	7e865cba-7c46-417b-ade5-97f2cf5b7be0	9ed638f3-8b32-49be-8d21-b4645fd20e5e
8	8	0	Plazi	ffb07bec-2d10-492d-9c37-361fe0b79427	9f0cd0ac-792a-4566-8880-b61e0125a5ad
8	8	0	Plazi	ffb07bec-2d10-492d-9c37-361fe0b79427	a129ad80-fc88-43e7-bee1-6e0f91fda3aa
518	518	0	Albertine Rift Conservation Society	90a939d3-e99c-4f6d-915f-2616423b3735	a215589e-e7df-45ed-9014-8305a60bda9f
3	3	0	Participant Node Managers Committee	7f48e0c8-5c96-49ec-b972-30748e339115	a2d976bd-fee0-4181-87ab-57718c17804c
16	16	0	Plazi	ffb07bec-2d10-492d-9c37-361fe0b79427	a36dc3b4-e5c0-4996-a102-cf61d4410733
399	57	-342	GBIF Germany	4f6826f2-4ff6-443d-b966-e6913bd24013	aa245d5b-43cb-4518-8f28-dd917a650709
63	63	0	GBIF France	da44cd31-5901-4687-a106-6d1c7734ee3a	b040a13e-2e47-4bce-9f12-8a45e4943367
29	29	0	Plazi	ffb07bec-2d10-492d-9c37-361fe0b79427	b172810f-7d7b-4d53-a0cf-8202def8ce26
0	38	38	Ocean Biodiversity Information System	ba0670b9-4186-41e6-8e70-f9cb3065551a	b3be552e-b48c-4f62-8ace-d53f5f85d65d
0	6	6	Plazi	ffb07bec-2d10-492d-9c37-361fe0b79427	b6a4101e-984b-4f6f-b7a8-e03244748249
10941	10941	0	GBIF France	da44cd31-5901-4687-a106-6d1c7734ee3a	b73fafed-f8d0-4d6e-b7b8-1c765f94be04
0	2	2	Plazi	ffb07bec-2d10-492d-9c37-361fe0b79427	bdd76a6b-fcaf-4e2a-a070-000f41862b9d
0	152	152	Plazi	ffb07bec-2d10-492d-9c37-361fe0b79427	be160b91-029a-4201-9739-ab3e8a242547
2233	2234	1	U.S. Geological Survey	8618c64a-93e0-4300-b546-7249e5148ed2	beddb937-47b8-48f6-8efb-e347383aa9b5
2	2	0	Plazi	ffb07bec-2d10-492d-9c37-361fe0b79427	c764de00-dfbb-4234-ab79-8ef31e8900f0
399	399	0	Colombian Biodiversity Information System	7e865cba-7c46-417b-ade5-97f2cf5b7be0	c92f622c-8409-4946-9747-06eeb0beeef1
126	126	0	GBIF Germany	4f6826f2-4ff6-443d-b966-e6913bd24013	cc3e7da9-c9f6-4518-a3d2-748bf3034820
5	5	0	Plazi	ffb07bec-2d10-492d-9c37-361fe0b79427	cc43949b-1b8c-4def-a7ea-d8f56c2e2682
10	10	0	Plazi	ffb07bec-2d10-492d-9c37-361fe0b79427	cd0f7302-9d9e-4e0e-aba7-be5ddc783a6f
1	1	0	Plazi	ffb07bec-2d10-492d-9c37-361fe0b79427	cf71c5fb-e106-440f-9f50-530e723f187f
5	5	0	Plazi	ffb07bec-2d10-492d-9c37-361fe0b79427	d099762b-e620-43a2-984b-93c58c41bca7
1230	750	-480	GBIF Germany	4f6826f2-4ff6-443d-b966-e6913bd24013	d2126148-daac-4b9b-918c-5d6532c3ea15
0	15	15	Plazi	ffb07bec-2d10-492d-9c37-361fe0b79427	d2a76db8-6bb1-4183-86ad-e1e2d792fc53
7	7	0	Plazi	ffb07bec-2d10-492d-9c37-361fe0b79427	d39c549a-bc90-4ed8-a859-3ec77338a501
0	56	56	Plazi	ffb07bec-2d10-492d-9c37-361fe0b79427	d3a29685-2703-4df5-9f16-2766bb5dd803
1	1	0	Plazi	ffb07bec-2d10-492d-9c37-361fe0b79427	d6a894fd-7b5b-453c-8ff4-55bdbc4f9738
0	8980	8980	Canada Biodiversity Information Facility	8f83fc96-c966-4126-83f7-bf044dc49efa	d80c46be-b600-44d5-9758-ef5159d40002
1	1	0	Plazi	ffb07bec-2d10-492d-9c37-361fe0b79427	dda5adec-c4aa-4721-b490-9ac17f61bbfb
6	6	0	Plazi	ffb07bec-2d10-492d-9c37-361fe0b79427	de2f897b-3d16-4bcd-99a7-fb46a61b5bd1
0	104	104	Ocean Biodiversity Information System	ba0670b9-4186-41e6-8e70-f9cb3065551a	df6c58df-6c20-4395-98a6-63af7e83e307
36	36	0	U.S. Geological Survey	8618c64a-93e0-4300-b546-7249e5148ed2	e4d07f67-39a9-4dec-8623-038c671c4b88
160	160	0	GBIF France	da44cd31-5901-4687-a106-6d1c7734ee3a	e4ec56ab-850f-42ac-a5f0-232802f0f1e6
68	68	0	Biodiversity Information System of Mexico	b324e8e9-9a4c-44fa-8f1a-7f39ea7ab576	e7193f24-050b-4867-817d-5bb39f18dd05
3411	8186	4775	U.S. Geological Survey	8618c64a-93e0-4300-b546-7249e5148ed2	e919e7e9-b0d2-4b77-92b4-ba3510096417
169	169	0	Plazi	ffb07bec-2d10-492d-9c37-361fe0b79427	e9f2bc10-d1ef-4e84-86ca-c6243b97ce80
0	511825	511825	Netherlands Biodiversity Information Facility	0909d601-bda2-42df-9e63-a6d51847ebce	ea233ece-c4fb-4fb8-bf98-f16235c4144c
13	13	0	Plazi	ffb07bec-2d10-492d-9c37-361fe0b79427	ed4d1bf6-284a-4898-952a-58943d5a3026
531	531	0	GBIF France	da44cd31-5901-4687-a106-6d1c7734ee3a	ee15ca4e-88f4-4325-90e9-0f77567f95dc
314	314	0	Colombian Biodiversity Information System	7e865cba-7c46-417b-ade5-97f2cf5b7be0	f11b55db-cf5d-484a-9acd-55e064e437fb
0	62	62	Plazi	ffb07bec-2d10-492d-9c37-361fe0b79427	f2d18848-9c6d-4687-98f6-59077da83f93
0	4	4	Ocean Biodiversity Information System	ba0670b9-4186-41e6-8e70-f9cb3065551a	f3c5557f-11c4-4d72-817b-70eb3ff8ef42
1003	954	-49	Biodiversity Information System of Mexico	b324e8e9-9a4c-44fa-8f1a-7f39ea7ab576	f566a9c8-e82c-4c67-9de3-da5a0812f506
6	6	0	Plazi	ffb07bec-2d10-492d-9c37-361fe0b79427	f694842b-3af3-4198-b01e-13d0b5466b5d
33144	33144	0	U.S. Geological Survey	8618c64a-93e0-4300-b546-7249e5148ed2	f93694b5-e994-4c07-a95f-90b14d5cf5e7
403	403	0	GBIF Germany	4f6826f2-4ff6-443d-b966-e6913bd24013	fae8d0fd-7254-4cc9-ad5c-e9873e273e69
26	26	0	Plazi	ffb07bec-2d10-492d-9c37-361fe0b79427	fb795361-83e6-40cd-9325-a88391da6226
5042	5042	0	GBIF Germany	4f6826f2-4ff6-443d-b966-e6913bd24013	fcac5aab-8388-4810-be8c-6b8eae51b542
0	4	4	Participant Node Managers Committee	7f48e0c8-5c96-49ec-b972-30748e339115	fe54eb8c-3a15-4743-a37f-584c901abf97
0	243	243	Plazi	ffb07bec-2d10-492d-9c37-361fe0b79427	ffb2d1bf-4968-4716-9049-7dd3666d2c31
0	5	5	Plazi	ffb07bec-2d10-492d-9c37-361fe0b79427	00024397-569d-43a8-9e08-9a1072e201df
85	85	0	Plazi	ffb07bec-2d10-492d-9c37-361fe0b79427	000a7240-3d12-4025-aa65-16abe083cea0
0	271	271	Belgian Biodiversity Platform	fb11cfe1-ebc3-45af-9159-17d9fddbcdac	00ea3465-c5da-4c2f-a1ef-93feba240658
4	4	0	Plazi	ffb07bec-2d10-492d-9c37-361fe0b79427	035e2dcd-a21a-46a9-accd-910477d3ce3b
256	256	0	Atlas of Living Australia	4a6f1b71-969e-4fc5-a693-282b05e1220c	04106094-0ced-419a-8216-17efdae78b90
36	36	0	Plazi	ffb07bec-2d10-492d-9c37-361fe0b79427	05505758-61b6-4935-8864-c80c214788a1
0	157	157	Plazi	ffb07bec-2d10-492d-9c37-361fe0b79427	05b76ae0-dcec-434c-8897-bd71572268c1
0	1795	1795	Colombian Biodiversity Information System	7e865cba-7c46-417b-ade5-97f2cf5b7be0	06a4eea1-b8fd-43fe-a8ef-b7ca22e97f2a
20	20	0	Plazi	ffb07bec-2d10-492d-9c37-361fe0b79427	072944da-d9ad-4749-98b1-99e1f66dda24
7582	6416	-1166	GBIF Germany	4f6826f2-4ff6-443d-b966-e6913bd24013	08a79618-374c-4014-9e71-3194ef3cf69a
20	20	0	GBIF Germany	4f6826f2-4ff6-443d-b966-e6913bd24013	091e5013-6b6f-4620-bc02-0bc4a3a78950
1355031	1355031	0	GBIF Sweden	a0b3be64-6525-4387-ac67-a499950f92e1	0943f690-fde5-11dd-83f4-b8a03c50a862
0	1	1	Plazi	ffb07bec-2d10-492d-9c37-361fe0b79427	0bbbb5b2-6e76-4999-8266-2b4314af6bf6
0	3	3	Plazi	ffb07bec-2d10-492d-9c37-361fe0b79427	0bce98a9-eaaf-46ca-abf9-fe0c94e1779c
70	70	0	Plazi	ffb07bec-2d10-492d-9c37-361fe0b79427	0c523d70-0815-45f8-a69d-1698f78a0998
3676	3676	0	GBIF Finland	dd514216-5c7c-45f3-910d-797424cb5be6	0d0f1fc9-3dff-435d-ad51-907485ea584c
0	50	50	Plazi	ffb07bec-2d10-492d-9c37-361fe0b79427	1071adf4-248e-4f65-862f-7e0ee7f51b01
8545	8545	0	Polish Biodiversity Information Network	2618bfdf-e194-4911-a241-80db3107bc51	10cea170-30b3-11de-b171-b8a03c50a862
1346	1346	0	National Biodiversity Network	d897a5b9-35ee-4232-94bd-b0bcaac003c2	11a32da2-2694-40c8-9bc7-b9724f993754
5	5	0	Plazi	ffb07bec-2d10-492d-9c37-361fe0b79427	1366babe-c0d7-4d41-b614-f3794a5cc51e
31	31	0	Plazi	ffb07bec-2d10-492d-9c37-361fe0b79427	14f552f4-8ce5-441d-a284-e0ef461cf16e
147	147	0	National Biodiversity Network	d897a5b9-35ee-4232-94bd-b0bcaac003c2	175d0d57-5c0c-439d-bb60-a3061a4cb592
8	8	0	Plazi	ffb07bec-2d10-492d-9c37-361fe0b79427	18e02032-7e1d-474b-9bde-5ecf6b121c7c
4	4	0	GBIF France	da44cd31-5901-4687-a106-6d1c7734ee3a	1c29dd68-8c41-4817-892d-5010d462a170
2	2	0	Plazi	ffb07bec-2d10-492d-9c37-361fe0b79427	1d149c68-8fdf-4aef-9ce3-b75b94021f12
2402	2402	0	GBIF Benin	efb9c00e-f802-45dd-8826-a52ec45b89ff	1d37d177-141a-4bcd-afdb-d5c80d326504
11059	11059	0	GBIF France	da44cd31-5901-4687-a106-6d1c7734ee3a	1f180ec9-b5cc-4417-a700-51a7eb3c415b
0	1	1	Plazi	ffb07bec-2d10-492d-9c37-361fe0b79427	21f8a2f3-add6-43ec-b7a1-1e9cc348cd7d
3	3	0	Plazi	ffb07bec-2d10-492d-9c37-361fe0b79427	229fb464-0e2e-4132-9204-4ee0cee8f7ee
40	40	0	Colombian Biodiversity Information System	7e865cba-7c46-417b-ade5-97f2cf5b7be0	23db4323-6471-4e16-b8d5-aeb8c59cbfac
94	94	0	GBIF France	da44cd31-5901-4687-a106-6d1c7734ee3a	254eb2a9-d720-42c5-af20-8ce45476fbbb
22	22	0	Plazi	ffb07bec-2d10-492d-9c37-361fe0b79427	2661db2d-4d26-4391-aed0-a1fe6ce07eca
1	1	0	Plazi	ffb07bec-2d10-492d-9c37-361fe0b79427	273811c9-ad13-4911-b87d-a1afd3bdfcf8
23	23	0	Plazi	ffb07bec-2d10-492d-9c37-361fe0b79427	2b50eca4-32c8-432c-96b6-45caecbb142e
61129	61129	0	Biodiversity Information System of Mexico	b324e8e9-9a4c-44fa-8f1a-7f39ea7ab576	2dad0cd2-e880-4ec3-90e5-d3f479528cbd
280	280	0	GBIF Malawi	2a42e4d7-ad4a-41b3-84c4-de4aa7b74d35	2fd0fc45-8c94-4b08-ad5c-d7714d8f1d0c
6402	6402	0	Ocean Biodiversity Information System	ba0670b9-4186-41e6-8e70-f9cb3065551a	3256a52e-1892-4425-b4dc-5ebb474692e8
382	382	0	National Biodiversity Network	d897a5b9-35ee-4232-94bd-b0bcaac003c2	339d7931-baca-4660-b650-93836399567f
123	123	0	Plazi	ffb07bec-2d10-492d-9c37-361fe0b79427	34311ed9-34bd-47f8-87cc-f4d34ce42eee
0	2	2	Plazi	ffb07bec-2d10-492d-9c37-361fe0b79427	34e891f8-4979-4395-b912-375b86f509fb
151	151	0	Taiwan Biodiversity Information Facility	e1b85abc-61f9-430f-ba79-6813dec53a0f	3586d3f4-5178-46aa-be2d-77036191e2ae
1	1	0	Atlas of Living Australia	4a6f1b71-969e-4fc5-a693-282b05e1220c	390fe826-ee2f-4d82-ba45-01d5747c3e6c
79	79	0	GBIF Germany	4f6826f2-4ff6-443d-b966-e6913bd24013	401af0e9-b138-47f9-b0c0-6c0617f67806
0	316	316	Plazi	ffb07bec-2d10-492d-9c37-361fe0b79427	42735fab-49be-4bca-be2b-a271641121a8
0	4	4	Plazi	ffb07bec-2d10-492d-9c37-361fe0b79427	4321cb4f-ae34-41c5-b94d-ed6a680d12fb
689	689	0	GBIF France	da44cd31-5901-4687-a106-6d1c7734ee3a	432a8936-9048-40f3-adf2-dd8b70456d57
650	521	-129	GBIF Germany	4f6826f2-4ff6-443d-b966-e6913bd24013	43d84a6b-15f9-4c96-b99a-cfa25ab00548
1	1	0	Plazi	ffb07bec-2d10-492d-9c37-361fe0b79427	44ded8dc-3187-42db-a283-a59fec2c467d
0	41	41	Plazi	ffb07bec-2d10-492d-9c37-361fe0b79427	4a7f6cf9-ce81-4120-908b-a43bb1a68567
7	7	0	Plazi	ffb07bec-2d10-492d-9c37-361fe0b79427	4bd957a1-4346-4339-bb01-293e2f3c31f1
4	4	0	Plazi	ffb07bec-2d10-492d-9c37-361fe0b79427	4d921320-afec-4d33-af93-5ff1658f07cb
28	28	0	Plazi	ffb07bec-2d10-492d-9c37-361fe0b79427	4f72a449-eddb-4fec-929b-ca59ad9d8980
1	1	0	GBIF France	da44cd31-5901-4687-a106-6d1c7734ee3a	511c1a6d-736f-412f-b18b-a03b3963077b
145	145	0	Albertine Rift Conservation Society	90a939d3-e99c-4f6d-915f-2616423b3735	55e3ccc2-3530-4c10-8476-346acac24741
0	14304	14304	GBIF Switzerland	169eb292-376b-4cc6-8e31-9c2c432de0ad	59f14999-c588-4272-b18a-2ef0cc9fc7b5
12	12	0	Plazi	ffb07bec-2d10-492d-9c37-361fe0b79427	5ab481de-4d58-4fd0-a117-2a69558723be
800	800	0	Biodiversity Information System of Mexico	b324e8e9-9a4c-44fa-8f1a-7f39ea7ab576	5b605e9d-4e61-424d-950b-68ffbd010d20
14141	14141	0	GBIF France	da44cd31-5901-4687-a106-6d1c7734ee3a	5cb36cde-7306-4e47-a904-d03419ed83d7
199782	199782	0	GBIF France	da44cd31-5901-4687-a106-6d1c7734ee3a	5d467c2a-b758-4005-bd0e-9f76fdb4effa
29137	29137	0	South African Biodiversity Information Facility	7190b835-4e86-4b6e-85c1-19cc6677c250	5edbfe13-c150-43d3-ac38-729b6aeb6147
1390	1390	0	Ocean Biodiversity Information System	ba0670b9-4186-41e6-8e70-f9cb3065551a	60c45f15-135d-42fb-8b8e-dd11c6375ad8
0	101	101	Ocean Biodiversity Information System	ba0670b9-4186-41e6-8e70-f9cb3065551a	6131ad0b-7cd3-421c-bdf7-6f3e26767424
10	10	0	GBIF Germany	4f6826f2-4ff6-443d-b966-e6913bd24013	61a391f4-f762-11e1-a439-00145eb45e9a
0	4	4	Plazi	ffb07bec-2d10-492d-9c37-361fe0b79427	622acedf-56a1-458f-8497-4494b7047662
2984	2984	0	National Biodiversity Data Centre	422b00b2-6c94-4bb6-976b-c359916efdb8	626fca6f-8590-478b-a662-b9c82afad2b5
22	22	0	GBIF Germany	4f6826f2-4ff6-443d-b966-e6913bd24013	62c2f728-f762-11e1-a439-00145eb45e9a
100	100	0	GBIF Germany	4f6826f2-4ff6-443d-b966-e6913bd24013	63c695b2-f762-11e1-a439-00145eb45e9a
30	30	0	GBIF Germany	4f6826f2-4ff6-443d-b966-e6913bd24013	64654a36-f762-11e1-a439-00145eb45e9a
172	163	-9	GBIF Germany	4f6826f2-4ff6-443d-b966-e6913bd24013	64f8ac7c-f762-11e1-a439-00145eb45e9a
555	555	0	GBIF Germany	4f6826f2-4ff6-443d-b966-e6913bd24013	6555b674-f762-11e1-a439-00145eb45e9a
216	214	-2	GBIF Germany	4f6826f2-4ff6-443d-b966-e6913bd24013	65e8e926-f762-11e1-a439-00145eb45e9a
700	682	-18	GBIF Germany	4f6826f2-4ff6-443d-b966-e6913bd24013	660bd760-f762-11e1-a439-00145eb45e9a
35	35	0	GBIF Germany	4f6826f2-4ff6-443d-b966-e6913bd24013	673d951a-f762-11e1-a439-00145eb45e9a
0	71475	71475	U.S. Geological Survey	8618c64a-93e0-4300-b546-7249e5148ed2	677aece2-a65b-4b78-b391-0f2e21a2b7ed
0	3	3	Plazi	ffb07bec-2d10-492d-9c37-361fe0b79427	6acf051f-ca0c-4884-880c-d9b144ed23f2
3	3	0	Plazi	ffb07bec-2d10-492d-9c37-361fe0b79427	6b4d595e-19a2-4975-81f7-ffb87c766a43
78	78	0	Colombian Biodiversity Information System	7e865cba-7c46-417b-ade5-97f2cf5b7be0	6cc9dd4a-27ea-4b6d-b835-69266124e1eb
0	2	2	Plazi	ffb07bec-2d10-492d-9c37-361fe0b79427	6cd3d259-465d-4ab3-8a32-d57a812bb6e0
0	2	2	Plazi	ffb07bec-2d10-492d-9c37-361fe0b79427	6e1e8064-37e6-486f-b4fa-de0170edfb5d
47	47	0	Plazi	ffb07bec-2d10-492d-9c37-361fe0b79427	6edfbba0-7127-4512-89a1-3e211ff396f4
69	69	0	GBIF France	da44cd31-5901-4687-a106-6d1c7734ee3a	6f0b2ce0-d93c-4e9b-a4ad-8f623d60bc14
0	3	3	Plazi	ffb07bec-2d10-492d-9c37-361fe0b79427	7008c46f-036d-4bce-9ebe-9aa28bd73bd8
1879	1879	0	National Biodiversity Network	d897a5b9-35ee-4232-94bd-b0bcaac003c2	704b9f21-a694-4e8b-b8c4-8cd865576a59
364	364	0	GBIF Germany	4f6826f2-4ff6-443d-b966-e6913bd24013	7166b170-f762-11e1-a439-00145eb45e9a
0	4102	4102	Colombian Biodiversity Information System	7e865cba-7c46-417b-ade5-97f2cf5b7be0	7289ce5c-e560-455e-9dd4-e2e003b10a17
57	57	0	GBIF Germany	4f6826f2-4ff6-443d-b966-e6913bd24013	72e132e6-f762-11e1-a439-00145eb45e9a
44	44	0	GBIF Germany	4f6826f2-4ff6-443d-b966-e6913bd24013	7323b256-f762-11e1-a439-00145eb45e9a
3	3	0	GBIF Germany	4f6826f2-4ff6-443d-b966-e6913bd24013	7341c0e8-f762-11e1-a439-00145eb45e9a
151	151	0	South African Biodiversity Information Facility	7190b835-4e86-4b6e-85c1-19cc6677c250	73db9279-966f-4029-9cdb-0c491e7da518
6	6	0	GBIF Germany	4f6826f2-4ff6-443d-b966-e6913bd24013	742b8142-f762-11e1-a439-00145eb45e9a
4	4	0	Plazi	ffb07bec-2d10-492d-9c37-361fe0b79427	779dde75-8044-4c56-89cd-32f639a8d3b3
0	3004	3004	Participant Node Managers Committee	7f48e0c8-5c96-49ec-b972-30748e339115	77f88e2e-77a5-48eb-8e90-14d0945c0188
1676	1676	0	GBIF Germany	4f6826f2-4ff6-443d-b966-e6913bd24013	7872fece-f762-11e1-a439-00145eb45e9a
15	15	0	GBIF Germany	4f6826f2-4ff6-443d-b966-e6913bd24013	78a18bb8-f762-11e1-a439-00145eb45e9a
29	29	0	Plazi	ffb07bec-2d10-492d-9c37-361fe0b79427	78e35da3-442f-48a2-801a-034286ac2c69
39	39	0	Participant Node Managers Committee	7f48e0c8-5c96-49ec-b972-30748e339115	79411ac9-2bee-443b-970a-47197751c777
37	37	0	GBIF Germany	4f6826f2-4ff6-443d-b966-e6913bd24013	79a30a14-f762-11e1-a439-00145eb45e9a
48	48	0	Canada Biodiversity Information Facility	8f83fc96-c966-4126-83f7-bf044dc49efa	7a2e6fb2-8e8c-436e-a1fb-520fcf20deab
0	7	7	Plazi	ffb07bec-2d10-492d-9c37-361fe0b79427	7ade6912-d3c9-4d41-8292-ef315e673c9d
51	51	0	Ocean Biodiversity Information System	ba0670b9-4186-41e6-8e70-f9cb3065551a	7b4e25a6-f762-11e1-a439-00145eb45e9a
638	638	0	GBIF Germany	4f6826f2-4ff6-443d-b966-e6913bd24013	7d60d6cc-f762-11e1-a439-00145eb45e9a
874	874	0	GBIF Germany	4f6826f2-4ff6-443d-b966-e6913bd24013	7de49016-f762-11e1-a439-00145eb45e9a
0	333	333	Belgian Biodiversity Platform	fb11cfe1-ebc3-45af-9159-17d9fddbcdac	7eb05281-e922-4465-a8f9-129607dbd66a
7791	6791	-1000	Biodiversity Information System of Mexico	b324e8e9-9a4c-44fa-8f1a-7f39ea7ab576	80931f9e-f762-11e1-a439-00145eb45e9a
102	102	0	Biodiversity Information System of Mexico	b324e8e9-9a4c-44fa-8f1a-7f39ea7ab576	80ab2346-f762-11e1-a439-00145eb45e9a
6450	6450	0	GBIF Germany	4f6826f2-4ff6-443d-b966-e6913bd24013	81f1ce08-f762-11e1-a439-00145eb45e9a
375	372	-3	GBIF Germany	4f6826f2-4ff6-443d-b966-e6913bd24013	820ebc70-f762-11e1-a439-00145eb45e9a
0	192	192	Plazi	ffb07bec-2d10-492d-9c37-361fe0b79427	838b9f93-4322-4793-944f-fae06f7b7053
109481	109481	0	GBIF Japan	db5705aa-6a6e-42f1-8942-d77b9f4896ea	8492ecf0-f762-11e1-a439-00145eb45e9a
111899	88418	-23481	GBIF Germany	4f6826f2-4ff6-443d-b966-e6913bd24013	85727f1e-f762-11e1-a439-00145eb45e9a
704	704	0	GBIF Germany	4f6826f2-4ff6-443d-b966-e6913bd24013	859d978a-f762-11e1-a439-00145eb45e9a
148	128	-20	GBIF Germany	4f6826f2-4ff6-443d-b966-e6913bd24013	88446fd6-f762-11e1-a439-00145eb45e9a
13	13	0	GBIF Germany	4f6826f2-4ff6-443d-b966-e6913bd24013	889919d2-f762-11e1-a439-00145eb45e9a
10	10	0	Plazi	ffb07bec-2d10-492d-9c37-361fe0b79427	8b05b0ac-4721-4918-900e-99b1ab2b56ef
2691	2691	0	U.S. Geological Survey	8618c64a-93e0-4300-b546-7249e5148ed2	8b75c4df-e81c-40d0-8420-5c7966298bc6
0	5	5	Plazi	ffb07bec-2d10-492d-9c37-361fe0b79427	8bb41fa7-7f16-433a-a83f-6d88a88a4cba
595	595	0	GBIF Germany	4f6826f2-4ff6-443d-b966-e6913bd24013	8be54b74-f762-11e1-a439-00145eb45e9a
5	5	0	Participant Node Managers Committee	7f48e0c8-5c96-49ec-b972-30748e339115	8c48aedb-a93b-4a6e-acfe-8c0e75758f64
225073	239797	14724	U.S. Geological Survey	8618c64a-93e0-4300-b546-7249e5148ed2	8e02e1dd-ec54-405e-b4d7-7abdecd29cc7
39	39	0	GBIF Germany	4f6826f2-4ff6-443d-b966-e6913bd24013	8ed0fc70-f762-11e1-a439-00145eb45e9a
22	20	-2	GBIF Germany	4f6826f2-4ff6-443d-b966-e6913bd24013	8f31ac8c-f762-11e1-a439-00145eb45e9a
52	44	-8	GBIF Germany	4f6826f2-4ff6-443d-b966-e6913bd24013	8f6dd63a-f762-11e1-a439-00145eb45e9a
96	60	-36	GBIF Germany	4f6826f2-4ff6-443d-b966-e6913bd24013	90a2d1c2-f762-11e1-a439-00145eb45e9a
0	10	10	Plazi	ffb07bec-2d10-492d-9c37-361fe0b79427	935ddcb1-d943-4ee3-97bd-aa295badd9ac
1136	1136	0	GBIF Germany	4f6826f2-4ff6-443d-b966-e6913bd24013	941aaf28-f762-11e1-a439-00145eb45e9a
1032	979	-53	GBIF Germany	4f6826f2-4ff6-443d-b966-e6913bd24013	945b9f74-f762-11e1-a439-00145eb45e9a
0	87	87	GBIF Uganda	71b40829-6a12-4c3d-8fee-5746f5e9cf8c	949cff8a-d15c-4213-86f4-3804e8f5fea8
61	61	0	GBIF Germany	4f6826f2-4ff6-443d-b966-e6913bd24013	95a1d8ee-f762-11e1-a439-00145eb45e9a
22	22	0	Plazi	ffb07bec-2d10-492d-9c37-361fe0b79427	96b40299-afd6-442d-ad37-898a3728b2d9
414	414	0	National Biodiversity Network	d897a5b9-35ee-4232-94bd-b0bcaac003c2	97bb8f4c-2526-4a12-91d8-340c3020e8ec
9	9	0	Plazi	ffb07bec-2d10-492d-9c37-361fe0b79427	9ab7ddd1-eb2d-416d-af4c-6fb576cd0a22
82933	97986	15053	Colombian Biodiversity Information System	7e865cba-7c46-417b-ade5-97f2cf5b7be0	9b73f44e-bbe1-4fd1-a7a9-c96c38dcf884
3880	3880	0	GBIF Brazil	cdc9736d-5ff7-4ece-9959-3c744360cdb3	9b748fc6-08eb-4e29-84be-1574571b0c96
0	26	26	Plazi	ffb07bec-2d10-492d-9c37-361fe0b79427	9f6a1d45-f725-42d1-a64c-b6ffaaae23d7
196	196	0	Colombian Biodiversity Information System	7e865cba-7c46-417b-ade5-97f2cf5b7be0	a01b35da-e766-415c-b62e-dcf67becb9f9
2006	986	-1020	GBIF Germany	4f6826f2-4ff6-443d-b966-e6913bd24013	a180ca75-2e2d-43dd-a42e-14bca2202926
699	699	0	Biodiversity Information System of Mexico	b324e8e9-9a4c-44fa-8f1a-7f39ea7ab576	a2daf4ff-656f-4a27-bee6-9233ba8f811f
201	201	0	GBIF Germany	4f6826f2-4ff6-443d-b966-e6913bd24013	a3f57ea9-fad6-46ca-a1ee-0e47d1073ec0
0	154	154	Plazi	ffb07bec-2d10-492d-9c37-361fe0b79427	a8118ca5-6988-4abd-8bb7-f0ef0020a93f
12205	3520	-8685	Biodiversity Information System of Mexico	b324e8e9-9a4c-44fa-8f1a-7f39ea7ab576	abd00b46-4c59-4437-85c0-c1b8d5c67029
232	232	0	GBIF Benin	efb9c00e-f802-45dd-8826-a52ec45b89ff	ae88e6e0-1003-4216-bfc2-b41050ca7fde
19	19	0	GBIF France	da44cd31-5901-4687-a106-6d1c7734ee3a	af16135a-4cd4-4cb5-baef-4a9dfd926626
70	79	9	Biodiversity Information System of Mexico	b324e8e9-9a4c-44fa-8f1a-7f39ea7ab576	b0b35c6e-54c2-4440-a3f3-5800edaf6458
0	18	18	Plazi	ffb07bec-2d10-492d-9c37-361fe0b79427	b285f5f3-def2-412f-ad24-c2070b7f59fc
0	2	2	Plazi	ffb07bec-2d10-492d-9c37-361fe0b79427	b59aaefc-61ef-42a0-b886-5d82586ca782
8	8	0	Participant Node Managers Committee	7f48e0c8-5c96-49ec-b972-30748e339115	b645f6e2-7998-4dae-91bf-66ad60a9db22
15674	16910	1236	National Biodiversity Network	d897a5b9-35ee-4232-94bd-b0bcaac003c2	b8866a8d-adc7-4a3a-887b-e59f830bb988
39270	39270	0	National Biodiversity Network	d897a5b9-35ee-4232-94bd-b0bcaac003c2	bcaf4baa-1b17-4469-a34f-d7091b806c42
161	151	-10	GBIF Germany	4f6826f2-4ff6-443d-b966-e6913bd24013	bd715c62-bb6a-4389-862c-1c04e63197ab
41	41	0	GBIF France	da44cd31-5901-4687-a106-6d1c7734ee3a	bdc8d3fe-9972-4ad9-a34d-cd43a31447c5
1	1	0	Plazi	ffb07bec-2d10-492d-9c37-361fe0b79427	c10d5368-f143-4b0a-8e53-5e284ee4e7ea
405	405	0	GBIF Finland	dd514216-5c7c-45f3-910d-797424cb5be6	c28aed67-1d46-471c-bad1-e875d5515b59
6922	6922	0	GBIF Norway	4f829580-180d-46a9-9c87-ed8ec959b545	c2e0fa78-45b5-4e28-919b-4ff81d3304a9
35	35	0	GBIF Germany	4f6826f2-4ff6-443d-b966-e6913bd24013	c4441013-117c-4d5e-adb3-97f8c3d945e0
293	293	0	GBIF France	da44cd31-5901-4687-a106-6d1c7734ee3a	c4c27df9-5c88-457e-9899-e7e088ce9744
277	277	0	GBIF France	da44cd31-5901-4687-a106-6d1c7734ee3a	c9fa131c-800f-4a27-bdd8-32623feb8eeb
2153	2153	0	National Biodiversity Network	d897a5b9-35ee-4232-94bd-b0bcaac003c2	ca6a9d5e-1136-45ca-976e-747356122081
532	532	0	GBIF Germany	4f6826f2-4ff6-443d-b966-e6913bd24013	cc2529be-09c9-4087-9299-f971e591ee57
0	1258	1258	Chinese Academy of Sciences	e760dc6f-dd68-474d-ab41-bd3588571793	cd451e0f-789e-4416-94f4-e583e57f20ce
1575	1575	0	Atlas of Living Australia	4a6f1b71-969e-4fc5-a693-282b05e1220c	d170f08a-3fe7-478a-9a0a-a68544f15f2f
0	652169	652169	U.S. Geological Survey	8618c64a-93e0-4300-b546-7249e5148ed2	d1e9202b-7300-4712-868c-d25133fb6f08
1908	1908	0	GBIF France	da44cd31-5901-4687-a106-6d1c7734ee3a	d291da67-4928-4b3f-ae7e-ac130e844fcd
0	1	1	Plazi	ffb07bec-2d10-492d-9c37-361fe0b79427	d4683243-5ec7-4349-a0b7-b441c1691733
9342	9342	0	GBIF Germany	4f6826f2-4ff6-443d-b966-e6913bd24013	d48675ea-c39e-4ebb-b889-b9a65a9b40b2
0	40	40	Plazi	ffb07bec-2d10-492d-9c37-361fe0b79427	d4ef2df1-7e15-49c7-9c1b-a2f1bf23af38
2	2	0	Plazi	ffb07bec-2d10-492d-9c37-361fe0b79427	d92184a8-cc20-4612-af6a-791106c083d1
97	97	0	National Biodiversity Network	d897a5b9-35ee-4232-94bd-b0bcaac003c2	d9b47a6f-c15b-44e0-9694-c6ac202a23e1
0	1	1	Plazi	ffb07bec-2d10-492d-9c37-361fe0b79427	db76b413-4e0b-4561-8ed8-ebbd173594c0
0	1	1	Plazi	ffb07bec-2d10-492d-9c37-361fe0b79427	dbd3b48a-e38e-4fb7-a5cb-84443130c3da
0	54	54	Plazi	ffb07bec-2d10-492d-9c37-361fe0b79427	dc575a8c-e0d1-45dc-9648-9cc1c3812b44
41	41	0	Plazi	ffb07bec-2d10-492d-9c37-361fe0b79427	dce22a1f-999d-49d8-bde7-31f7e816eed1
54	54	0	GBIF Nigeria	6529bcb5-a542-4fda-be87-54a624515335	dffb5e6b-d847-46ac-a851-70e2cf0bddd0
1092	1092	0	GBIF Germany	4f6826f2-4ff6-443d-b966-e6913bd24013	e012f0da-a212-45b3-82ef-4e8120900795
4	4	0	GBIF Finland	dd514216-5c7c-45f3-910d-797424cb5be6	e1cdaba9-2a54-4558-a161-cac9c22287f1
17	17	0	Plazi	ffb07bec-2d10-492d-9c37-361fe0b79427	e428cf00-9528-45d4-a882-40857faff42e
5	5	0	Plazi	ffb07bec-2d10-492d-9c37-361fe0b79427	e4de6594-5075-4058-895e-67eb0e3004e3
4662	4662	0	Participant Node Managers Committee	7f48e0c8-5c96-49ec-b972-30748e339115	e5386a70-12e7-4dfe-a307-dbd547e167fb
0	96	96	Participant Node Managers Committee	7f48e0c8-5c96-49ec-b972-30748e339115	e6991f49-1239-4d69-b8b2-bfe6993ea636
640	640	0	GBIF Germany	4f6826f2-4ff6-443d-b966-e6913bd24013	edf0d62c-668e-4923-ab03-d164afaf86e9
99749	99749	0	GBIF Germany	4f6826f2-4ff6-443d-b966-e6913bd24013	f29ab192-5964-40ae-a397-fa48ffdf0661
28108	28537	429	Canada Biodiversity Information Facility	8f83fc96-c966-4126-83f7-bf044dc49efa	f318309f-f9db-453d-9b93-39acd4a67227
580	580	0	Plazi	ffb07bec-2d10-492d-9c37-361fe0b79427	f33bc6aa-2e0c-4f4f-a0e2-a3776a407c3c
1	1	0	Participant Node Managers Committee	7f48e0c8-5c96-49ec-b972-30748e339115	f3a651ab-4ed4-4d7d-bc7c-94a4728a39a2
15652	15723	71	GBIF Brazil	cdc9736d-5ff7-4ece-9959-3c744360cdb3	f70fdd5a-e761-43b6-a854-462826cc7933
0	1	1	Plazi	ffb07bec-2d10-492d-9c37-361fe0b79427	f82f289e-66e0-4d1a-a325-7791aa5cc5e1
0	6	6	Plazi	ffb07bec-2d10-492d-9c37-361fe0b79427	ff26439d-c993-4893-a384-a19ab699ebb7
3	3	0	GBIF Germany	4f6826f2-4ff6-443d-b966-e6913bd24013	ffdf4f60-081d-47e3-87a7-22d3888f2734
4	4	0	Plazi	ffb07bec-2d10-492d-9c37-361fe0b79427	fff8098d-23d2-45b4-840c-c5aa8539713a
104	104	0	GBIF Argentina	2426a871-9feb-40a1-96c6-0c593a76b835	024ae086-5ec0-489c-a02a-0414f4222e18
72252	73798	1546	U.S. Geological Survey	8618c64a-93e0-4300-b546-7249e5148ed2	032f1fbe-d21f-407d-be46-5cd1bb1ea397
39	39	0	Plazi	ffb07bec-2d10-492d-9c37-361fe0b79427	08d6b159-99f8-4a24-b8c0-c7f5f6a33b54
0	116	116	National Biodiversity Network	d897a5b9-35ee-4232-94bd-b0bcaac003c2	0d348ed7-42d6-4fb1-bb53-504f329bcbf8
0	92	92	Colombian Biodiversity Information System	7e865cba-7c46-417b-ade5-97f2cf5b7be0	0e52defb-573e-456c-b883-665bebcc8ec5
2	2	0	Plazi	ffb07bec-2d10-492d-9c37-361fe0b79427	0e91b8d2-3f61-4ccd-b13f-cd3b102a2f0e
248	248	0	Participant Node Managers Committee	7f48e0c8-5c96-49ec-b972-30748e339115	0ee9877b-755d-4527-923e-5b848ea41eb6
0	24	24	Plazi	ffb07bec-2d10-492d-9c37-361fe0b79427	10168f0c-fedd-466b-ac34-d221df8dfb8c
612	612	0	Biodiversity Information System of Mexico	b324e8e9-9a4c-44fa-8f1a-7f39ea7ab576	13311ec2-96b0-45ed-8a99-2e3134fb3416
6	6	0	Plazi	ffb07bec-2d10-492d-9c37-361fe0b79427	13357846-fe24-4eea-9631-2cf681ed71f1
0	31	31	Plazi	ffb07bec-2d10-492d-9c37-361fe0b79427	17adfe62-71be-4ddf-bbe2-9137253a2007
95	95	0	Plazi	ffb07bec-2d10-492d-9c37-361fe0b79427	1b46b231-55b1-4d03-bfc2-23b19e1014d8
118	118	0	Participant Node Managers Committee	7f48e0c8-5c96-49ec-b972-30748e339115	1b64016a-cf65-439b-bd43-4ad75f66b37c
1597	1597	0	GBIF France	da44cd31-5901-4687-a106-6d1c7734ee3a	1b98c4ee-a3ec-477c-a27e-40a213174b84
0	2	2	Plazi	ffb07bec-2d10-492d-9c37-361fe0b79427	23166e4c-7f7d-4832-8bdd-c589af7fe546
12014	15121	3107	GBIF Japan	db5705aa-6a6e-42f1-8942-d77b9f4896ea	25be1800-4a11-499c-a1af-6d91158f5f51
6	6	0	Plazi	ffb07bec-2d10-492d-9c37-361fe0b79427	26ab2b4e-2944-4b6c-a6df-204b1148d599
173415	173415	0	GBIF Japan	db5705aa-6a6e-42f1-8942-d77b9f4896ea	279c8d3e-5f97-4fe9-a99b-ef0e4b0441c3
1200	1200	0	Korean Biodiversity Information Facility	e0a1e772-0177-4800-94b4-2d023fe6cdf4	2899c9af-8e85-4c44-ae2f-0a0df53f8394
0	60	60	Plazi	ffb07bec-2d10-492d-9c37-361fe0b79427	2a4ba42f-746a-4199-9f23-0f6e59ef5f83
0	116	116	National Biodiversity Network	d897a5b9-35ee-4232-94bd-b0bcaac003c2	2b08c46f-903f-440e-9b53-ac0e54da0a65
1071	1071	0	Belgian Biodiversity Platform	fb11cfe1-ebc3-45af-9159-17d9fddbcdac	2ddd55b1-6f6e-48ed-a361-394bd7d24f81
58112	58112	0	GBIF Brazil	cdc9736d-5ff7-4ece-9959-3c744360cdb3	2f676abc-4503-489e-8f0c-fcb6e1bc554b
2	2	0	Plazi	ffb07bec-2d10-492d-9c37-361fe0b79427	39c05430-876f-4dce-9213-c442942660ce
3	3	0	Plazi	ffb07bec-2d10-492d-9c37-361fe0b79427	3b46d4f3-8a5a-4d63-b338-48c6da9e8f3c
381	381	0	GBIF Norway	4f829580-180d-46a9-9c87-ed8ec959b545	3b778b3e-c784-4df6-bd89-364e0ab503ed
6	6	0	GBIF Germany	4f6826f2-4ff6-443d-b966-e6913bd24013	3c6106dd-2948-4bce-894e-e5f8258cc5e7
46	46	0	Plazi	ffb07bec-2d10-492d-9c37-361fe0b79427	3ca15213-a1ac-469c-b2d8-452eeeff31a3
81	81	0	Plazi	ffb07bec-2d10-492d-9c37-361fe0b79427	406e61f4-d6e6-4e1e-ae43-67f46cfa2a9a
13	13	0	Plazi	ffb07bec-2d10-492d-9c37-361fe0b79427	4094357b-2829-4b56-9d10-8fb7e0cae706
21439	21439	0	Participant Node Managers Committee	7f48e0c8-5c96-49ec-b972-30748e339115	423e89b5-3c05-4ebe-8671-ddade9409b11
659	659	0	GBIF France	da44cd31-5901-4687-a106-6d1c7734ee3a	44d1c017-773b-4277-917e-bdfb9fd55de7
13665	13665	0	GBIF France	da44cd31-5901-4687-a106-6d1c7734ee3a	44f91be3-bac6-4280-bb01-6888b0f94181
29	29	0	Plazi	ffb07bec-2d10-492d-9c37-361fe0b79427	477a2ecd-25bb-445c-bd8c-6ed5c0466b6c
247	247	0	Colombian Biodiversity Information System	7e865cba-7c46-417b-ade5-97f2cf5b7be0	48ae5cd9-5ba1-4bfa-8e80-de9dae0e07e1
1	1	0	Plazi	ffb07bec-2d10-492d-9c37-361fe0b79427	48e044d1-2b64-4958-8789-f8cd296015cf
1	1	0	Plazi	ffb07bec-2d10-492d-9c37-361fe0b79427	4ac58256-d670-494a-9d0d-356c475fd0f7
0	4	4	Participant Node Managers Committee	7f48e0c8-5c96-49ec-b972-30748e339115	4ae32db9-db10-4dcf-a475-c146a4b30ff3
12542	12542	0	Belgian Biodiversity Platform	fb11cfe1-ebc3-45af-9159-17d9fddbcdac	4c05cc60-97a5-11de-b36a-b8a03c50a862
154	154	0	Plazi	ffb07bec-2d10-492d-9c37-361fe0b79427	4c9c5163-7fce-43f3-be05-c64780788e96
169	169	0	Participant Node Managers Committee	7f48e0c8-5c96-49ec-b972-30748e339115	4fe5b469-98fc-48e4-ba6d-5bb552657b7f
0	4	4	Plazi	ffb07bec-2d10-492d-9c37-361fe0b79427	558fe5b9-0efe-42cd-b93a-9159cecf5273
18	18	0	Plazi	ffb07bec-2d10-492d-9c37-361fe0b79427	56a43dc1-9576-49d5-8650-255e66c48add
2	2	0	Plazi	ffb07bec-2d10-492d-9c37-361fe0b79427	5ae2527e-c687-40a7-87b1-8ea14f68c83c
234	234	0	GBIF Germany	4f6826f2-4ff6-443d-b966-e6913bd24013	5d539d7a-da18-4d0a-8ef4-170b857d3e36
0	32	32	Plazi	ffb07bec-2d10-492d-9c37-361fe0b79427	5dc7af8b-c327-411d-9a95-79bf0b2b4b74
1	1	0	Plazi	ffb07bec-2d10-492d-9c37-361fe0b79427	615d9b12-afe8-4913-b787-68b7ae083d84
9	9	0	Plazi	ffb07bec-2d10-492d-9c37-361fe0b79427	6223c924-366b-4672-bbec-bfc90b9e7415
10	10	0	GBIF Germany	4f6826f2-4ff6-443d-b966-e6913bd24013	62b18ed4-f762-11e1-a439-00145eb45e9a
81	81	0	GBIF Germany	4f6826f2-4ff6-443d-b966-e6913bd24013	62c9640a-f762-11e1-a439-00145eb45e9a
114	114	0	GBIF Germany	4f6826f2-4ff6-443d-b966-e6913bd24013	641af544-f762-11e1-a439-00145eb45e9a
35	35	0	GBIF Germany	4f6826f2-4ff6-443d-b966-e6913bd24013	64bf09a4-f762-11e1-a439-00145eb45e9a
122	122	0	GBIF Germany	4f6826f2-4ff6-443d-b966-e6913bd24013	662b0dc4-f762-11e1-a439-00145eb45e9a
158	158	0	GBIF Germany	4f6826f2-4ff6-443d-b966-e6913bd24013	663dcd24-f762-11e1-a439-00145eb45e9a
37	37	0	GBIF Germany	4f6826f2-4ff6-443d-b966-e6913bd24013	68262ce4-f762-11e1-a439-00145eb45e9a
57	57	0	GBIF Germany	4f6826f2-4ff6-443d-b966-e6913bd24013	68efff74-9529-4d39-87cf-7d8a227498e4
286	286	0	GBIF Germany	4f6826f2-4ff6-443d-b966-e6913bd24013	697df54a-f762-11e1-a439-00145eb45e9a
97	97	0	GBIF Germany	4f6826f2-4ff6-443d-b966-e6913bd24013	69d0522c-f762-11e1-a439-00145eb45e9a
827	827	0	GBIF Sweden	a0b3be64-6525-4387-ac67-a499950f92e1	6a2fd7e1-43ea-4eda-8ad2-3d66b3caf61a
2	2	0	GBIF Germany	4f6826f2-4ff6-443d-b966-e6913bd24013	6ae2e5e4-f762-11e1-a439-00145eb45e9a
18	18	0	GBIF Germany	4f6826f2-4ff6-443d-b966-e6913bd24013	6b32f20a-f762-11e1-a439-00145eb45e9a
56	56	0	GBIF Germany	4f6826f2-4ff6-443d-b966-e6913bd24013	6d363fd0-f762-11e1-a439-00145eb45e9a
1975	1975	0	GBIF Japan	db5705aa-6a6e-42f1-8942-d77b9f4896ea	6f38fa00-6a51-4339-bb34-096e8d3f4eab
27	27	0	GBIF Germany	4f6826f2-4ff6-443d-b966-e6913bd24013	70db8cf8-f762-11e1-a439-00145eb45e9a
1	1	0	Plazi	ffb07bec-2d10-492d-9c37-361fe0b79427	70f30818-47a1-4f8f-97ff-db22e04e16bf
0	163	163	Plazi	ffb07bec-2d10-492d-9c37-361fe0b79427	710afcac-f353-49bf-a397-3c71ba1508be
23	23	0	Plazi	ffb07bec-2d10-492d-9c37-361fe0b79427	71c7082b-e951-4c10-85c8-93d31aff3550
18	18	0	GBIF Germany	4f6826f2-4ff6-443d-b966-e6913bd24013	72906e2e-f762-11e1-a439-00145eb45e9a
69	69	0	GBIF Germany	4f6826f2-4ff6-443d-b966-e6913bd24013	7352224e-f762-11e1-a439-00145eb45e9a
82	82	0	GBIF Germany	4f6826f2-4ff6-443d-b966-e6913bd24013	737e46ee-f762-11e1-a439-00145eb45e9a
237	237	0	GBIF Germany	4f6826f2-4ff6-443d-b966-e6913bd24013	741d496a-f762-11e1-a439-00145eb45e9a
313	313	0	GBIF Germany	4f6826f2-4ff6-443d-b966-e6913bd24013	74c5272a-f762-11e1-a439-00145eb45e9a
9525	9489	-36	Atlas of Living Australia	4a6f1b71-969e-4fc5-a693-282b05e1220c	75bfed9c-679d-4c8f-ab46-feb2eb98512a
65	65	0	GBIF Germany	4f6826f2-4ff6-443d-b966-e6913bd24013	78c24b28-f762-11e1-a439-00145eb45e9a
88	88	0	GBIF Germany	4f6826f2-4ff6-443d-b966-e6913bd24013	7aa7a550-f762-11e1-a439-00145eb45e9a
0	215	215	Ocean Biodiversity Information System	ba0670b9-4186-41e6-8e70-f9cb3065551a	7b4059c8-abb3-4d3a-a2b2-1bc7b24f557b
539	539	0	GBIF Germany	4f6826f2-4ff6-443d-b966-e6913bd24013	7be6885a-f762-11e1-a439-00145eb45e9a
2183	1517	-666	GBIF Germany	4f6826f2-4ff6-443d-b966-e6913bd24013	7c074c8e-f762-11e1-a439-00145eb45e9a
20	20	0	Atlas of Living Australia	4a6f1b71-969e-4fc5-a693-282b05e1220c	7d2d674c-f762-11e1-a439-00145eb45e9a
5	5	0	Plazi	ffb07bec-2d10-492d-9c37-361fe0b79427	7dae26af-c623-4e61-9e79-c26b964035a7
408	408	0	GBIF Germany	4f6826f2-4ff6-443d-b966-e6913bd24013	7eff84ec-f762-11e1-a439-00145eb45e9a
108	112	4	GBIF Germany	4f6826f2-4ff6-443d-b966-e6913bd24013	81a75ca6-f762-11e1-a439-00145eb45e9a
25	25	0	GBIF Germany	4f6826f2-4ff6-443d-b966-e6913bd24013	825afb26-f762-11e1-a439-00145eb45e9a
9222	9331	109	GBIF Germany	4f6826f2-4ff6-443d-b966-e6913bd24013	829026f2-f762-11e1-a439-00145eb45e9a
27	27	0	GBIF Germany	4f6826f2-4ff6-443d-b966-e6913bd24013	831e218a-a16c-40eb-82db-dd620f272ba0
53482	53482	0	GBIF Iceland	4dbdcae6-9ac9-4005-ac15-4a95a3eb7701	83435394-f762-11e1-a439-00145eb45e9a
0	7	7	Plazi	ffb07bec-2d10-492d-9c37-361fe0b79427	836e6558-6d05-4ad0-8a82-d11b7c8f9b37
21678	21678	0	GBIF Japan	db5705aa-6a6e-42f1-8942-d77b9f4896ea	8499f554-f762-11e1-a439-00145eb45e9a
6838	6852	14	U.S. Geological Survey	8618c64a-93e0-4300-b546-7249e5148ed2	8597c4c8-8433-4527-9dea-286c4b37fcb9
0	13	13	Plazi	ffb07bec-2d10-492d-9c37-361fe0b79427	8731bec2-715d-4739-a90f-3f8625c6c4ad
112	80	-32	GBIF Germany	4f6826f2-4ff6-443d-b966-e6913bd24013	87518c12-f762-11e1-a439-00145eb45e9a
12003	12003	0	National Biodiversity Network	d897a5b9-35ee-4232-94bd-b0bcaac003c2	87fa522e-9dee-46bd-90de-618d9e918491
470	470	0	GBIF Germany	4f6826f2-4ff6-443d-b966-e6913bd24013	8998952e-f762-11e1-a439-00145eb45e9a
39969765	39969765	0	Observation International	ad048418-7cd8-4070-a151-fe1c1f303129	8a863029-f435-446a-821e-275f4f641165
2	2	0	Plazi	ffb07bec-2d10-492d-9c37-361fe0b79427	8c601af0-d8d0-44f2-902b-e29e3fa2cc6a
20	20	0	GBIF Germany	4f6826f2-4ff6-443d-b966-e6913bd24013	8c8e1466-f762-11e1-a439-00145eb45e9a
0	5	5	Participant Node Managers Committee	7f48e0c8-5c96-49ec-b972-30748e339115	8d619e0e-dc22-4985-a2c9-43132c6ae0d6
3	3	0	Plazi	ffb07bec-2d10-492d-9c37-361fe0b79427	8e6d948f-754b-442c-879b-2365ff39e7e2
31	26	-5	GBIF Germany	4f6826f2-4ff6-443d-b966-e6913bd24013	8ece42d2-f762-11e1-a439-00145eb45e9a
6	6	0	Plazi	ffb07bec-2d10-492d-9c37-361fe0b79427	9097484e-f853-4356-a68f-213f6d60c7f6
215	215	0	GBIF Germany	4f6826f2-4ff6-443d-b966-e6913bd24013	92b889de-f762-11e1-a439-00145eb45e9a
2	2	0	Plazi	ffb07bec-2d10-492d-9c37-361fe0b79427	931e4bf3-bda5-411f-9e5d-085d30182301
110	110	0	GBIF Germany	4f6826f2-4ff6-443d-b966-e6913bd24013	9322e96e-f762-11e1-a439-00145eb45e9a
5	5	0	Plazi	ffb07bec-2d10-492d-9c37-361fe0b79427	9377f747-1418-44f6-9b47-301e4b408e8f
11840	11840	0	U.S. Geological Survey	8618c64a-93e0-4300-b546-7249e5148ed2	9498a2a0-3a65-4942-8a93-49d3b1bdea14
1075	1046	-29	GBIF Germany	4f6826f2-4ff6-443d-b966-e6913bd24013	95293f38-f762-11e1-a439-00145eb45e9a
18	18	0	Plazi	ffb07bec-2d10-492d-9c37-361fe0b79427	9573c6be-c2dc-45cc-befd-e44d02392676
91	91	0	Atlas of Living Australia	4a6f1b71-969e-4fc5-a693-282b05e1220c	95e02f86-f762-11e1-a439-00145eb45e9a
0	29	29	Plazi	ffb07bec-2d10-492d-9c37-361fe0b79427	96fd1ba3-d7b3-402d-a5a4-7e4df747ed2e
0	3	3	Plazi	ffb07bec-2d10-492d-9c37-361fe0b79427	9a6fdd6c-cc00-475b-aa18-154257c1717e
0	1	1	Plazi	ffb07bec-2d10-492d-9c37-361fe0b79427	9bd5a483-8f40-4d81-b20d-b46a4b9dffe7
1685	1685	0	Plazi	ffb07bec-2d10-492d-9c37-361fe0b79427	9e062836-3946-4ac6-8910-304cadff0d4b
416	416	0	GBIF France	da44cd31-5901-4687-a106-6d1c7734ee3a	a098b3bd-b2e9-4714-94aa-2d94bb088d28
1	1	0	Plazi	ffb07bec-2d10-492d-9c37-361fe0b79427	a09a8fc5-0d55-48dd-a807-387786736b09
1636	1636	0	GBIF Norway	4f829580-180d-46a9-9c87-ed8ec959b545	a1bd8c5d-cfb3-4d55-943a-cebcd6c32be6
1830	1830	0	GBIF France	da44cd31-5901-4687-a106-6d1c7734ee3a	a1db3e3d-517f-4063-bf41-65bf12f6e5ab
0	59	59	Plazi	ffb07bec-2d10-492d-9c37-361fe0b79427	a4583583-90dc-415f-923c-334c5dc9ce60
0	1321	1321	GBIF Portugal	673f7038-4262-4149-b753-5658a4e912f6	a543fbea-2c4a-4dd9-860e-75ac94734210
2012	2012	0	Colombian Biodiversity Information System	7e865cba-7c46-417b-ade5-97f2cf5b7be0	a77fe17a-6678-4996-b998-206c7c8430b3
2	2	0	Colombian Biodiversity Information System	7e865cba-7c46-417b-ade5-97f2cf5b7be0	aa3222d7-fc9d-4e99-9d2e-b3ea21dafed7
1095751	1128107	32356	GBIF Sweden	a0b3be64-6525-4387-ac67-a499950f92e1	aab0cf80-0c64-11dd-84d1-b8a03c50a862
980	980	0	GBIF Germany	4f6826f2-4ff6-443d-b966-e6913bd24013	aca85dde-6399-4f2b-bf4a-6acaa74ffbf1
5	5	0	Plazi	ffb07bec-2d10-492d-9c37-361fe0b79427	acf8c4fe-9a21-4b1c-91c6-ae01c0e310b9
26094	27466	1372	Canada Biodiversity Information Facility	8f83fc96-c966-4126-83f7-bf044dc49efa	b22b10e7-86da-4b80-8f49-f3f958a2463d
0	2	2	Plazi	ffb07bec-2d10-492d-9c37-361fe0b79427	b3f79d18-7662-43ac-bbc1-cee66f250a94
1060	1060	0	Colombian Biodiversity Information System	7e865cba-7c46-417b-ade5-97f2cf5b7be0	b5e9e6f3-3214-4aae-9af7-92d08d8f8a9d
322	322	0	GBIF France	da44cd31-5901-4687-a106-6d1c7734ee3a	b69980f9-1895-48a0-9a18-e31f4755a6c3
299	299	0	GBIF Germany	4f6826f2-4ff6-443d-b966-e6913bd24013	b99721f1-c62b-45b5-8070-77d13b86f0df
91	91	0	Plazi	ffb07bec-2d10-492d-9c37-361fe0b79427	b9fd5656-332a-4ee5-9722-81ddef756ca0
20	20	0	Plazi	ffb07bec-2d10-492d-9c37-361fe0b79427	ba06db54-0f24-486e-8573-e0d9002188e8
69	69	0	Participant Node Managers Committee	7f48e0c8-5c96-49ec-b972-30748e339115	c086e70f-8132-4558-b2d7-186c8926708e
3	3	0	Plazi	ffb07bec-2d10-492d-9c37-361fe0b79427	c4c5a6db-ede2-4797-a9bb-fd7f7df6fed3
413	413	0	National Biodiversity Network	d897a5b9-35ee-4232-94bd-b0bcaac003c2	c630029e-0e66-4b9a-ab78-7a63fa1d7779
14331	14331	0	U.S. Geological Survey	8618c64a-93e0-4300-b546-7249e5148ed2	cc7cd3f8-1ff5-4273-ad34-f89351392925
123	123	0	GBIF France	da44cd31-5901-4687-a106-6d1c7734ee3a	ccb12adc-94b3-4f6e-92d1-5cf7d3b99dbb
3509	3509	0	GBIF Spain	1f94b3ca-9345-4d65-afe2-4bace93aa0fe	cd74782f-2ba4-4e68-8029-a8737978ef18
504	504	0	GBIF Germany	4f6826f2-4ff6-443d-b966-e6913bd24013	cee7444c-e015-4421-9556-e2eb72f5e9af
6	6	0	Plazi	ffb07bec-2d10-492d-9c37-361fe0b79427	cfaab9c0-29f0-4f25-90d3-0b810c656bc1
0	4	4	Plazi	ffb07bec-2d10-492d-9c37-361fe0b79427	d162c24e-0b15-469f-a8d8-abd436e43eac
610	610	0	GBIF Germany	4f6826f2-4ff6-443d-b966-e6913bd24013	d44f84b0-e947-11e2-961f-00145eb45e9a
0	4761734	4761734	National Biodiversity Network	d897a5b9-35ee-4232-94bd-b0bcaac003c2	d8cd16ba-bb74-4420-821e-083f2bac17c2
285118	285577	459	National Biodiversity Network	d897a5b9-35ee-4232-94bd-b0bcaac003c2	daaf1560-e484-43c8-a93d-c3b9dfcbc6f1
4	4	0	Plazi	ffb07bec-2d10-492d-9c37-361fe0b79427	daf88fc9-3b0d-45cb-a4ae-97edc4d9f425
1	1	0	Plazi	ffb07bec-2d10-492d-9c37-361fe0b79427	dbf201e4-ef74-4e8c-a96c-6f6246b157d2
264	264	0	U.S. Geological Survey	8618c64a-93e0-4300-b546-7249e5148ed2	dc1126b3-4d7d-4059-8108-86d52af10473
2	2	0	Plazi	ffb07bec-2d10-492d-9c37-361fe0b79427	dc1355a6-6693-471c-b91b-ad64e7a9cbcf
0	11	11	Plazi	ffb07bec-2d10-492d-9c37-361fe0b79427	dca94007-2ae6-4e2c-b937-439e79a71a9a
1101	1101	0	GBIF Argentina	2426a871-9feb-40a1-96c6-0c593a76b835	dd1b0ec8-8e0f-43ff-ad7b-46281037579c
23607	10502	-13105	Biodiversity Information System of Mexico	b324e8e9-9a4c-44fa-8f1a-7f39ea7ab576	dd22ba99-bd1c-4950-b97f-5e43066b6791
6	6	0	Plazi	ffb07bec-2d10-492d-9c37-361fe0b79427	dfbcd01b-2ea6-4898-af4b-bb8ee425d26b
296	296	0	Colombian Biodiversity Information System	7e865cba-7c46-417b-ade5-97f2cf5b7be0	dfef0b61-aa28-4794-97bc-3f8791fb0ab2
12	12	0	Plazi	ffb07bec-2d10-492d-9c37-361fe0b79427	e0f57b53-fede-40d9-94dd-015c5f4a27b5
265	265	0	Plazi	ffb07bec-2d10-492d-9c37-361fe0b79427	e1a3cc15-4c28-478d-a067-52c7f9224b6a
1	1	0	Plazi	ffb07bec-2d10-492d-9c37-361fe0b79427	e1e20b66-1c1a-4865-8ad9-b64aac7620db
3087	3087	0	GBIF France	da44cd31-5901-4687-a106-6d1c7734ee3a	e3499c45-0801-4c49-9b6a-e587e4f0283f
0	209	209	Plazi	ffb07bec-2d10-492d-9c37-361fe0b79427	e3cf467a-9a31-4c9d-bea4-9ab279abd932
2205	2205	0	GBIF Argentina	2426a871-9feb-40a1-96c6-0c593a76b835	e4246e96-58c0-4241-8e3d-e3ec33538a35
15	15	0	Colombian Biodiversity Information System	7e865cba-7c46-417b-ade5-97f2cf5b7be0	e89171c8-38a8-4bc7-89fc-87953f7ed8ab
1812	1809	-3	Plazi	ffb07bec-2d10-492d-9c37-361fe0b79427	e8b0cf7e-6ff3-40d9-8e92-87e099b9cefe
50543	51261	718	Canada Biodiversity Information Facility	8f83fc96-c966-4126-83f7-bf044dc49efa	e9c27954-85d1-4a87-bce4-1715bd606268
1	1	0	Plazi	ffb07bec-2d10-492d-9c37-361fe0b79427	ea5e9a37-550b-41c5-be6e-c71c42945fe8
0	1486	1486	Participant Node Managers Committee	7f48e0c8-5c96-49ec-b972-30748e339115	ef233925-3e68-43b6-ae69-9c5ec29b2630
0	279	279	Ocean Biodiversity Information System	ba0670b9-4186-41e6-8e70-f9cb3065551a	efdeabdf-e126-4046-a7a7-e1a11b72cbe7
1151	1151	0	Ocean Biodiversity Information System	ba0670b9-4186-41e6-8e70-f9cb3065551a	f0882781-3601-4bdb-afa7-0a32ee9b9f32
7	7	0	Plazi	ffb07bec-2d10-492d-9c37-361fe0b79427	f852ad09-189e-4314-b0e2-932dc517010d
1004	1004	0	Society for the Management of Electronic Biodiversity Data	97818ee4-1461-4180-bf1d-b3201050124f	fb6835d0-b72e-464e-b49a-b69e5b9cc0b6
41308	41308	0	U.S. Geological Survey	8618c64a-93e0-4300-b546-7249e5148ed2	fcdd34e6-43cf-4fbb-a2a9-07163619b872
268930	268930	0	National Biodiversity Network	d897a5b9-35ee-4232-94bd-b0bcaac003c2	fd5b4916-122e-48bb-abe5-33dfd04f95e6
0	12	12	Plazi	ffb07bec-2d10-492d-9c37-361fe0b79427	013bf857-98ef-4282-8211-80fcf0494cd5
3	3	0	Plazi	ffb07bec-2d10-492d-9c37-361fe0b79427	03a8e03b-2787-488b-b9ca-a245110a7181
384	384	0	National Biodiversity Network	d897a5b9-35ee-4232-94bd-b0bcaac003c2	0500ce54-96c2-4a78-9b28-8df29b2e475e
15	15	0	Colombian Biodiversity Information System	7e865cba-7c46-417b-ade5-97f2cf5b7be0	066e6a44-0641-4a3f-bee8-c26a9747525c
0	386	386	Ocean Biodiversity Information System	ba0670b9-4186-41e6-8e70-f9cb3065551a	06af91e0-be1c-41a1-b947-2f9a6b67ef17
7	7	0	Plazi	ffb07bec-2d10-492d-9c37-361fe0b79427	08c51001-d194-4a6f-b1c3-7f8ecd2e1265
0	150	150	Colombian Biodiversity Information System	7e865cba-7c46-417b-ade5-97f2cf5b7be0	0ac3a3c7-bd73-4ea0-98ba-7497a9c156bb
26303	29727	3424	GBIF Brazil	cdc9736d-5ff7-4ece-9959-3c744360cdb3	0bcbd3a8-f22e-4350-a19d-a94fe6ca9738
0	21	21	Ocean Biodiversity Information System	ba0670b9-4186-41e6-8e70-f9cb3065551a	0e753773-b0a3-4b8d-92fd-fd30b10bec09
1654	1654	0	Netherlands Biodiversity Information Facility	0909d601-bda2-42df-9e63-a6d51847ebce	0e7bd6f7-7fc6-4150-a531-2209f7156a91
500	500	0	Participant Node Managers Committee	7f48e0c8-5c96-49ec-b972-30748e339115	0ede0c42-61c1-44d2-b689-603848bbe219
173	173	0	Biodiversity Information System of Mexico	b324e8e9-9a4c-44fa-8f1a-7f39ea7ab576	10ceb6bb-6733-4858-b78a-aaba792e3fe4
1	1	0	GBIF Norway	4f829580-180d-46a9-9c87-ed8ec959b545	150f1700-e93d-47c6-92f5-de44ab80e353
2	2	0	Plazi	ffb07bec-2d10-492d-9c37-361fe0b79427	152accf4-f82d-475d-841d-fa828687d9f6
665	665	0	GBIF Germany	4f6826f2-4ff6-443d-b966-e6913bd24013	152b73c1-6da1-4824-8e05-5bc442e445a5
0	23	23	Plazi	ffb07bec-2d10-492d-9c37-361fe0b79427	16f6ef92-619b-417b-946c-22d9b1445e7d
3	3	0	Plazi	ffb07bec-2d10-492d-9c37-361fe0b79427	246b9a5c-234a-48d9-b846-9060047bcb04
4093	4097	4	Indonesian Biodiversity Information Facility	2ebd91f6-f14f-4375-b525-c011a3774f03	24a02aae-d6b8-40c8-8f90-64eb3e780f2b
154	154	0	GBIF France	da44cd31-5901-4687-a106-6d1c7734ee3a	267d479c-5922-4723-85d9-a12a9a7285d3
3	3	0	Plazi	ffb07bec-2d10-492d-9c37-361fe0b79427	269f79b2-c909-42d4-b619-dbaa9e0bf2d3
5701	5701	0	GBIF Norway	4f829580-180d-46a9-9c87-ed8ec959b545	28c6444b-d35e-4863-a342-820a82ba63b7
3006	3006	0	Colombian Biodiversity Information System	7e865cba-7c46-417b-ade5-97f2cf5b7be0	33785ae9-207b-4cad-9511-56d8a6ee58a3
0	103	103	GBIF France	da44cd31-5901-4687-a106-6d1c7734ee3a	359fc1ba-09d2-4d50-89ba-68eb702236f7
0	433	433	Plazi	ffb07bec-2d10-492d-9c37-361fe0b79427	364756e4-12a8-4ce5-b4d3-2d8cd2817b4e
1	1	0	Plazi	ffb07bec-2d10-492d-9c37-361fe0b79427	3694a5b6-d12b-4bdf-ad8c-aea2000cec4e
4236	4236	0	GBIF Germany	4f6826f2-4ff6-443d-b966-e6913bd24013	36bc8aea-bfb3-4d72-8379-c9c5d162b676
368	368	0	GBIF Germany	4f6826f2-4ff6-443d-b966-e6913bd24013	37d8c1cc-1e0a-4f9a-b45c-0695f4a3d9e2
902	902	0	GBIF France	da44cd31-5901-4687-a106-6d1c7734ee3a	3cca017b-f649-41b6-8984-9c90f931a281
3	3	0	Plazi	ffb07bec-2d10-492d-9c37-361fe0b79427	3e05cb0b-85e8-449f-ad03-6803b40403be
122	122	0	GBIF France	da44cd31-5901-4687-a106-6d1c7734ee3a	3e114c57-d47e-4937-9070-01afe66ae05a
179	179	0	Plazi	ffb07bec-2d10-492d-9c37-361fe0b79427	4036285a-e386-454b-ac37-faa8db1687af
0	21948	21948	U.S. Geological Survey	8618c64a-93e0-4300-b546-7249e5148ed2	415cdd20-b2a4-45b1-8918-b6a4bf188ffe
1692	1692	0	GBIF Portugal	673f7038-4262-4149-b753-5658a4e912f6	44a69cc0-5c7d-4d47-8904-f3455c483e99
7	7	0	Plazi	ffb07bec-2d10-492d-9c37-361fe0b79427	4652277f-8bcf-4660-a1bf-835a940a6549
2080	2080	0	U.S. Geological Survey	8618c64a-93e0-4300-b546-7249e5148ed2	47881e45-febd-4622-b7a1-6efbce4fd7b3
2	2	0	Plazi	ffb07bec-2d10-492d-9c37-361fe0b79427	4a27dee2-348c-40f1-9d6d-c0e4306d58c1
0	681	681	Ocean Biodiversity Information System	ba0670b9-4186-41e6-8e70-f9cb3065551a	4c2cc260-f3a4-4107-a306-791b5840eb6f
1	1	0	Plazi	ffb07bec-2d10-492d-9c37-361fe0b79427	4d375b8e-b54b-4730-92d6-c10a6edd8eb7
0	286	286	Ocean Biodiversity Information System	ba0670b9-4186-41e6-8e70-f9cb3065551a	50f684c4-035f-4cd5-a59f-89c2c1866832
0	10	10	Plazi	ffb07bec-2d10-492d-9c37-361fe0b79427	5104bf59-10f0-4cad-9c15-5721097347a1
4	4	0	Plazi	ffb07bec-2d10-492d-9c37-361fe0b79427	53604b4a-2403-4cad-89ee-402e2e342247
0	506	506	Participant Node Managers Committee	7f48e0c8-5c96-49ec-b972-30748e339115	53954347-bd7d-4caf-ba26-0126748e3597
119	119	0	Plazi	ffb07bec-2d10-492d-9c37-361fe0b79427	53f2f6fa-441c-4bde-b230-56109cf9d648
415	415	0	Atlas of Living Australia	4a6f1b71-969e-4fc5-a693-282b05e1220c	543c7a69-38bc-4506-9d20-aa10e4ae2876
303	303	0	GBIF France	da44cd31-5901-4687-a106-6d1c7734ee3a	59670186-8444-4ff7-b2c0-a8e7294e3b22
7046	7046	0	GBIF Brazil	cdc9736d-5ff7-4ece-9959-3c744360cdb3	5a0f2fe0-5516-4dc2-87df-6664c14249e0
0	2	2	Plazi	ffb07bec-2d10-492d-9c37-361fe0b79427	5a820ad2-8af8-44ee-8e0e-f77557e699ca
0	1000	1000	DanBIF - Danish Biodiversity Information Facility	4ddd294f-02b7-4359-ac33-0806a9ca9c6b	5b5305ae-35d1-4992-9d1a-f447db84b471
5	5	0	Plazi	ffb07bec-2d10-492d-9c37-361fe0b79427	5cb64c13-76bb-45f3-9a12-c2413c64c537
2620	2620	0	Atlas of Living Australia	4a6f1b71-969e-4fc5-a693-282b05e1220c	5cff5cac-c511-4cb4-89b1-c9a49cc77f49
1636	1636	0	Belgian Biodiversity Platform	fb11cfe1-ebc3-45af-9159-17d9fddbcdac	5d78d011-4390-4b5f-9aae-958b337a3031
2084	2084	0	Tanzania Biodiversity Information Facility	abd95ca6-3959-4db9-aaa6-2de1aeecf514	5e5d014b-2bd1-45b2-a266-af3064370085
318	318	0	Participant Node Managers Committee	7f48e0c8-5c96-49ec-b972-30748e339115	5e8bab95-57f4-47b2-8ff2-e65e09ea6743
2	2	0	Plazi	ffb07bec-2d10-492d-9c37-361fe0b79427	612f61e4-97bf-4cfc-ac43-9370854acbc1
43	43	0	GBIF Germany	4f6826f2-4ff6-443d-b966-e6913bd24013	6218c4ba-f762-11e1-a439-00145eb45e9a
45	45	0	GBIF Germany	4f6826f2-4ff6-443d-b966-e6913bd24013	63098d6e-f762-11e1-a439-00145eb45e9a
54	54	0	GBIF Germany	4f6826f2-4ff6-443d-b966-e6913bd24013	643222be-f762-11e1-a439-00145eb45e9a
183	183	0	GBIF Germany	4f6826f2-4ff6-443d-b966-e6913bd24013	64a45de8-f762-11e1-a439-00145eb45e9a
10	10	0	GBIF Germany	4f6826f2-4ff6-443d-b966-e6913bd24013	64c00e44-f762-11e1-a439-00145eb45e9a
24	22	-2	GBIF Germany	4f6826f2-4ff6-443d-b966-e6913bd24013	64e910f0-f762-11e1-a439-00145eb45e9a
43	43	0	GBIF Germany	4f6826f2-4ff6-443d-b966-e6913bd24013	67d3d4d0-f762-11e1-a439-00145eb45e9a
107	107	0	GBIF Germany	4f6826f2-4ff6-443d-b966-e6913bd24013	68b57a70-f762-11e1-a439-00145eb45e9a
180	90	-90	GBIF Germany	4f6826f2-4ff6-443d-b966-e6913bd24013	694d1cb8-f762-11e1-a439-00145eb45e9a
16	16	0	GBIF Germany	4f6826f2-4ff6-443d-b966-e6913bd24013	6a8877ee-f762-11e1-a439-00145eb45e9a
3	3	0	GBIF Germany	4f6826f2-4ff6-443d-b966-e6913bd24013	6ba99874-f762-11e1-a439-00145eb45e9a
12	12	0	GBIF Germany	4f6826f2-4ff6-443d-b966-e6913bd24013	6bb9f048-f762-11e1-a439-00145eb45e9a
23	23	0	GBIF Germany	4f6826f2-4ff6-443d-b966-e6913bd24013	6bdb7272-f762-11e1-a439-00145eb45e9a
22	22	0	GBIF Germany	4f6826f2-4ff6-443d-b966-e6913bd24013	6bf6e818-f762-11e1-a439-00145eb45e9a
774	774	0	GBIF Germany	4f6826f2-4ff6-443d-b966-e6913bd24013	6c7b4494-9eb8-4ab4-949c-78b8cfbd482e
44	44	0	GBIF Germany	4f6826f2-4ff6-443d-b966-e6913bd24013	6cb29d42-f762-11e1-a439-00145eb45e9a
0	13	13	Plazi	ffb07bec-2d10-492d-9c37-361fe0b79427	6f145036-397c-4332-8c04-de9e31643aa7
6	6	0	Plazi	ffb07bec-2d10-492d-9c37-361fe0b79427	6f2deb98-cbd4-4ef1-b0c0-7c65e774bd74
0	78	78	Plazi	ffb07bec-2d10-492d-9c37-361fe0b79427	6fbdf92c-91de-4031-8fc1-3e414e7e237c
0	74	74	Plazi	ffb07bec-2d10-492d-9c37-361fe0b79427	70890c1c-cbf0-4135-9bf3-5e22b64e3cd3
1173	1173	0	GBIF Germany	4f6826f2-4ff6-443d-b966-e6913bd24013	70a94540-f762-11e1-a439-00145eb45e9a
6	6	0	GBIF Germany	4f6826f2-4ff6-443d-b966-e6913bd24013	71488e8e-f762-11e1-a439-00145eb45e9a
1	1	0	Plazi	ffb07bec-2d10-492d-9c37-361fe0b79427	73b2460e-39c9-4d19-8c55-f631f4a964e5
98	98	0	GBIF Germany	4f6826f2-4ff6-443d-b966-e6913bd24013	74b94a7c-f762-11e1-a439-00145eb45e9a
0	15	15	Plazi	ffb07bec-2d10-492d-9c37-361fe0b79427	75ce5686-6074-442f-8b7d-23234b23dc60
0	207	207	Colombian Biodiversity Information System	7e865cba-7c46-417b-ade5-97f2cf5b7be0	75fa3127-515f-43c1-a6c2-6d7f9582ad5f
0	41	41	Plazi	ffb07bec-2d10-492d-9c37-361fe0b79427	7700299b-eb39-4c24-86fe-2eabb15beda7
27	27	0	GBIF Germany	4f6826f2-4ff6-443d-b966-e6913bd24013	78505c2a-f762-11e1-a439-00145eb45e9a
43	43	0	GBIF Germany	4f6826f2-4ff6-443d-b966-e6913bd24013	78645c98-f762-11e1-a439-00145eb45e9a
11	11	0	GBIF Germany	4f6826f2-4ff6-443d-b966-e6913bd24013	78f39fb6-f762-11e1-a439-00145eb45e9a
305	305	0	Plazi	ffb07bec-2d10-492d-9c37-361fe0b79427	79a76a5f-97b3-47cc-9bff-086a712cf3e2
2000	2000	0	Korean Biodiversity Information Facility	e0a1e772-0177-4800-94b4-2d023fe6cdf4	7aef2ec0-f762-11e1-a439-00145eb45e9a
88576	88576	0	GBIF France	da44cd31-5901-4687-a106-6d1c7734ee3a	7b573d12-767c-4d2c-a434-651c4e7764e8
64	64	0	Ocean Biodiversity Information System	ba0670b9-4186-41e6-8e70-f9cb3065551a	7b5fa9de-f762-11e1-a439-00145eb45e9a
9	9	0	Plazi	ffb07bec-2d10-492d-9c37-361fe0b79427	7b733324-5ae1-4f77-9a65-14a08913a3b4
2988	3012	24	GBIF Germany	4f6826f2-4ff6-443d-b966-e6913bd24013	7b8bae4e-f762-11e1-a439-00145eb45e9a
2689	2689	0	GBIF Germany	4f6826f2-4ff6-443d-b966-e6913bd24013	7c6cfeee-f762-11e1-a439-00145eb45e9a
63	63	0	GBIF Germany	4f6826f2-4ff6-443d-b966-e6913bd24013	7c9d2aec-f762-11e1-a439-00145eb45e9a
3	3	0	Plazi	ffb07bec-2d10-492d-9c37-361fe0b79427	7f372a4a-9104-48cc-8f6a-e609a7b313f3
30	30	0	GBIF Japan	db5705aa-6a6e-42f1-8942-d77b9f4896ea	80fb0c26-f762-11e1-a439-00145eb45e9a
530	497	-33	GBIF Germany	4f6826f2-4ff6-443d-b966-e6913bd24013	81ba0e00-f762-11e1-a439-00145eb45e9a
0	154	154	Ocean Biodiversity Information System	ba0670b9-4186-41e6-8e70-f9cb3065551a	820ebc77-bba5-4921-ac3c-398772ec9267
63	63	0	Participant Node Managers Committee	7f48e0c8-5c96-49ec-b972-30748e339115	830a425a-3e5d-4796-bc0c-269630f3187c
0	36	36	Plazi	ffb07bec-2d10-492d-9c37-361fe0b79427	832b9be7-a0af-4598-922c-61c95ccf2876
7004	7004	0	GBIF Germany	4f6826f2-4ff6-443d-b966-e6913bd24013	8591ecaa-f762-11e1-a439-00145eb45e9a
28628	29605	977	GBIF Japan	db5705aa-6a6e-42f1-8942-d77b9f4896ea	8696eec0-f762-11e1-a439-00145eb45e9a
68377	68377	0	Atlas of Living Australia	4a6f1b71-969e-4fc5-a693-282b05e1220c	86cd718d-eb8d-46a0-aeec-3b0089a69ab9
647	493	-154	GBIF Germany	4f6826f2-4ff6-443d-b966-e6913bd24013	87005ad6-f762-11e1-a439-00145eb45e9a
6404	6193	-211	GBIF Germany	4f6826f2-4ff6-443d-b966-e6913bd24013	874ee232-f762-11e1-a439-00145eb45e9a
1442	1227	-215	GBIF Germany	4f6826f2-4ff6-443d-b966-e6913bd24013	878df3dc-f762-11e1-a439-00145eb45e9a
1	1	0	Plazi	ffb07bec-2d10-492d-9c37-361fe0b79427	8808813a-0c82-4a03-858b-19a6dca9eb5e
40	40	0	GBIF Germany	4f6826f2-4ff6-443d-b966-e6913bd24013	894061c4-f762-11e1-a439-00145eb45e9a
75	56	-19	GBIF Germany	4f6826f2-4ff6-443d-b966-e6913bd24013	8cbdfa00-f762-11e1-a439-00145eb45e9a
67	67	0	GBIF Germany	4f6826f2-4ff6-443d-b966-e6913bd24013	8cd0ae3e-f762-11e1-a439-00145eb45e9a
441	214	-227	GBIF Germany	4f6826f2-4ff6-443d-b966-e6913bd24013	8dbadb08-f762-11e1-a439-00145eb45e9a
0	7	7	Plazi	ffb07bec-2d10-492d-9c37-361fe0b79427	8e961a32-fadb-471a-bf45-51eeaa44d4df
0	34	34	Plazi	ffb07bec-2d10-492d-9c37-361fe0b79427	8fc137c7-4dc6-4725-8cd6-001cfaa6f764
33	28	-5	GBIF Germany	4f6826f2-4ff6-443d-b966-e6913bd24013	911df97e-f762-11e1-a439-00145eb45e9a
846	846	0	GBIF Madagascar	2dbfc5c5-51b5-4494-9dfc-4d3f013a3b64	9142fb42-44fa-458c-b0aa-2041b1fd617c
4	4	0	Participant Node Managers Committee	7f48e0c8-5c96-49ec-b972-30748e339115	914d133e-5cd4-4e3a-91a7-82c0da6c37c6
17	17	0	Ocean Biodiversity Information System	ba0670b9-4186-41e6-8e70-f9cb3065551a	91ede23a-79a7-4605-9c8c-a3fe4c8812d3
127	127	0	GBIF Germany	4f6826f2-4ff6-443d-b966-e6913bd24013	92b9d5fa-f762-11e1-a439-00145eb45e9a
2227	2227	0	GBIF Cameroon	cfe0cad9-2bf4-4d16-ae33-c3dfb0da1ed9	93706f0d-e64b-46ad-990e-efb82cf5e8a4
6279	6279	0	Participant Node Managers Committee	7f48e0c8-5c96-49ec-b972-30748e339115	941c9436-9171-4e26-b623-74765d5e3362
0	70263	70263	Ocean Biodiversity Information System	ba0670b9-4186-41e6-8e70-f9cb3065551a	956b0a07-2e0d-4e82-bb01-c78ad3f986e1
2	2	0	Plazi	ffb07bec-2d10-492d-9c37-361fe0b79427	965c4bbe-fbd6-4b4a-b918-b75b8b133efb
1	1	0	Plazi	ffb07bec-2d10-492d-9c37-361fe0b79427	975858f9-d7b5-42d8-9e93-403499295fe3
0	45	45	GBIF France	da44cd31-5901-4687-a106-6d1c7734ee3a	9af3cdb1-ead9-40bf-a4d4-932f4ab80206
3	3	0	Plazi	ffb07bec-2d10-492d-9c37-361fe0b79427	9cb2d6c1-7227-4038-8e48-e082fc237182
9	9	0	Plazi	ffb07bec-2d10-492d-9c37-361fe0b79427	9d63e00c-9a09-47ca-a4f5-de3238d5aea1
232	232	0	GBIF France	da44cd31-5901-4687-a106-6d1c7734ee3a	9e42a4da-ed0d-4067-85b3-cb07329e1da7
101	101	0	GBIF France	da44cd31-5901-4687-a106-6d1c7734ee3a	9ed19dfd-2c0c-4a26-b7bd-ea81438b8696
5	5	0	Plazi	ffb07bec-2d10-492d-9c37-361fe0b79427	9f85794a-1101-4168-a39f-f0e6d6d77d01
0	7145	7145	Netherlands Biodiversity Information Facility	0909d601-bda2-42df-9e63-a6d51847ebce	9fd8e0a3-5df0-4125-9643-58ca6bc52cb7
0	884	884	Ocean Biodiversity Information System	ba0670b9-4186-41e6-8e70-f9cb3065551a	a0fd25ac-4b8c-4931-886d-8c905d9fcdf0
16	16	0	Plazi	ffb07bec-2d10-492d-9c37-361fe0b79427	a4358cde-3ef0-4e08-9142-06ca894eefa4
18	18	0	Colombian Biodiversity Information System	7e865cba-7c46-417b-ade5-97f2cf5b7be0	a443e8e3-0a5f-45ab-93c5-9e1aa069321d
2	2	0	Plazi	ffb07bec-2d10-492d-9c37-361fe0b79427	a4f630cf-547e-4244-b7e9-b3a8ce74c59c
7	7	0	GBIF France	da44cd31-5901-4687-a106-6d1c7734ee3a	a7b69e27-3dd1-457c-952d-92b92dad4a04
543000	543000	0	DanBIF - Danish Biodiversity Information Facility	4ddd294f-02b7-4359-ac33-0806a9ca9c6b	a9e763c8-f674-4492-94a8-4fd4eb9342a5
5	5	0	Plazi	ffb07bec-2d10-492d-9c37-361fe0b79427	aa49ff29-614f-4110-b95d-5be099faa2f6
0	2	2	Plazi	ffb07bec-2d10-492d-9c37-361fe0b79427	ab1d3d82-3c24-454a-9352-0a5450712b50
0	2098	2098	GBIF Germany	4f6826f2-4ff6-443d-b966-e6913bd24013	af0e9077-cfce-4559-9fca-70ad730eb57f
4712	4712	0	Atlas of Living Australia	4a6f1b71-969e-4fc5-a693-282b05e1220c	af194990-12ae-4403-a66b-c1499d2f756b
2	2	0	Plazi	ffb07bec-2d10-492d-9c37-361fe0b79427	b265a226-48a4-432f-ba14-6fa61342f5c2
1634	1634	0	Colombian Biodiversity Information System	7e865cba-7c46-417b-ade5-97f2cf5b7be0	b342ae04-f7fc-4120-969f-4353410d6baa
3594	3594	0	National Biodiversity Network	d897a5b9-35ee-4232-94bd-b0bcaac003c2	b5209d78-638b-4af9-942e-76fcf1f17bd9
0	7	7	Plazi	ffb07bec-2d10-492d-9c37-361fe0b79427	b58a1513-492f-45c0-bc72-21ae072fe689
1417677	1417671	-6	National Biodiversity Network	d897a5b9-35ee-4232-94bd-b0bcaac003c2	b7cd5ad0-f65a-4de1-a1bb-318cf5ae12f8
6	6	0	Plazi	ffb07bec-2d10-492d-9c37-361fe0b79427	b915f279-8484-48bf-88a8-dce52826b363
7	7	0	GBIF Norway	4f829580-180d-46a9-9c87-ed8ec959b545	b9f90d91-53c5-4c0f-b950-5678a7ecd571
30792	30792	0	GBIF Brazil	cdc9736d-5ff7-4ece-9959-3c744360cdb3	ba06a193-82fc-425b-a7e5-f3df809fe378
19	19	0	Plazi	ffb07bec-2d10-492d-9c37-361fe0b79427	bb3fc841-77f2-446e-809c-51db75786e47
14	14	0	Plazi	ffb07bec-2d10-492d-9c37-361fe0b79427	bca0e227-e4fb-4f93-b99b-c8794b19de8d
0	2	2	GBIF Germany	4f6826f2-4ff6-443d-b966-e6913bd24013	bf010c68-0a73-4a59-a32c-c8fa597eaa5c
2418	372	-2046	GBIF Germany	4f6826f2-4ff6-443d-b966-e6913bd24013	bf55e566-5a8f-4215-86df-1335760c46a5
0	211	211	GBIF Benin	efb9c00e-f802-45dd-8826-a52ec45b89ff	c0b29c06-74b1-46b5-8929-9fdf5f30c7a8
3788	3788	0	Participant Node Managers Committee	7f48e0c8-5c96-49ec-b972-30748e339115	c4b68667-0f9c-4329-86ca-f632b0fec773
1	1	0	Plazi	ffb07bec-2d10-492d-9c37-361fe0b79427	c8cdb89c-6c03-4be9-939e-a00042630014
1653	1653	0	National Biodiversity Network	d897a5b9-35ee-4232-94bd-b0bcaac003c2	ca1d84cf-07a4-4e86-ba3a-e157676a6686
1856	1856	0	Belgian Biodiversity Platform	fb11cfe1-ebc3-45af-9159-17d9fddbcdac	ca4df07d-4d10-402a-8d2f-3c8a1fdf45c0
1426	1426	0	GBIF Norway	4f829580-180d-46a9-9c87-ed8ec959b545	ced15900-3164-48a3-8b62-12f818cd9fac
0	6821	6821	National Biodiversity Network	d897a5b9-35ee-4232-94bd-b0bcaac003c2	d6cd327a-7911-48e5-93e5-8664cb8a4ea8
26	26	0	Plazi	ffb07bec-2d10-492d-9c37-361fe0b79427	d6d872a2-3c11-41e9-a32e-6606bfe5d410
4	4	0	Plazi	ffb07bec-2d10-492d-9c37-361fe0b79427	d9b9e6f4-c8af-4b94-818b-72061226085e
83644	84496	852	U.S. Geological Survey	8618c64a-93e0-4300-b546-7249e5148ed2	db9e34bd-e647-46bd-9f9d-ffee56a5d3c4
0	2003	2003	Colombian Biodiversity Information System	7e865cba-7c46-417b-ade5-97f2cf5b7be0	dbb0f0f5-97c0-484e-9c8f-3fce032db463
10	10	0	Plazi	ffb07bec-2d10-492d-9c37-361fe0b79427	ddf01fc8-a165-492e-aa9a-25316f7f4ab6
16	16	0	Plazi	ffb07bec-2d10-492d-9c37-361fe0b79427	dfce4512-2062-4cd8-8ce7-bfe59cbbe6aa
0	20	20	Plazi	ffb07bec-2d10-492d-9c37-361fe0b79427	e2c40cdd-768b-4061-8021-04054628d2bc
2	2	0	Plazi	ffb07bec-2d10-492d-9c37-361fe0b79427	e6a6a4db-ad9f-43e6-83f7-ed335d0a8400
90	90	0	GBIF Benin	efb9c00e-f802-45dd-8826-a52ec45b89ff	e92b9edf-27b5-4e21-bbdd-70d29b962ae7
0	30	30	Plazi	ffb07bec-2d10-492d-9c37-361fe0b79427	e978428c-44fe-4739-9db1-8884891e8f54
3620	3620	0	GBIF Japan	db5705aa-6a6e-42f1-8942-d77b9f4896ea	eaa402fc-d235-400e-84af-1051603320af
11791	11791	0	GBIF Argentina	2426a871-9feb-40a1-96c6-0c593a76b835	eae731a7-3e82-4295-b0b3-ec72d75a402d
0	7	7	Plazi	ffb07bec-2d10-492d-9c37-361fe0b79427	ec72c234-7abe-4e84-b99f-2f4d451c48bb
1192	948	-244	GBIF Germany	4f6826f2-4ff6-443d-b966-e6913bd24013	ee1ae008-7c58-47ec-b7f7-d6e52edadf9d
303495	303495	0	GBIF France	da44cd31-5901-4687-a106-6d1c7734ee3a	ee74ecf1-7acf-4c5d-8dcb-43e09fae474c
2	2	0	Plazi	ffb07bec-2d10-492d-9c37-361fe0b79427	efb8fe7a-3432-4338-86d7-0a305ebac47d
16506	16506	0	GBIF Germany	4f6826f2-4ff6-443d-b966-e6913bd24013	f0c74a2c-4bd8-49d0-837a-92bb835fd2f3
461	461	0	GBIF Germany	4f6826f2-4ff6-443d-b966-e6913bd24013	f118b70a-2877-4955-8034-ccd043f72dca
4254	4254	0	National Biodiversity Network	d897a5b9-35ee-4232-94bd-b0bcaac003c2	f38773f9-2255-408e-9d17-44fa8ca4b962
0	3	3	Plazi	ffb07bec-2d10-492d-9c37-361fe0b79427	f4ac6b24-8b65-49c5-875a-fe920b32c9ce
314	314	0	Netherlands Biodiversity Information Facility	0909d601-bda2-42df-9e63-a6d51847ebce	f5d17a6d-5b53-4bac-b952-d6503839aed7
52	52	0	National Biodiversity Network	d897a5b9-35ee-4232-94bd-b0bcaac003c2	f6f57752-c273-45f7-a6f0-1b51e82d1208
20	20	0	Plazi	ffb07bec-2d10-492d-9c37-361fe0b79427	f80b497f-b264-4b3f-86b7-0918ecbec68f
847	758	-89	GBIF Germany	4f6826f2-4ff6-443d-b966-e6913bd24013	f8bab1a4-1bc9-4297-a569-1bb63fc16fba
19	19	0	Plazi	ffb07bec-2d10-492d-9c37-361fe0b79427	f90d8a3f-2c97-416f-a478-df637f9f9b99
36	36	0	Plazi	ffb07bec-2d10-492d-9c37-361fe0b79427	f9c8b5f5-c9ff-4235-8d18-915e3ada344c
6	6	0	Plazi	ffb07bec-2d10-492d-9c37-361fe0b79427	fcf573d5-4a59-4e55-b6c9-bfabe1c10964
64004	64004	0	National Biodiversity Network	d897a5b9-35ee-4232-94bd-b0bcaac003c2	05d6ca91-1c63-429e-8801-3b59e2de2707
12473	12473	0	Participant Node Managers Committee	7f48e0c8-5c96-49ec-b972-30748e339115	08afaadf-34ba-4aeb-be23-027da1e38676
14	14	0	Plazi	ffb07bec-2d10-492d-9c37-361fe0b79427	0960c53d-1140-49a6-bb0a-eb977dea6d8c
5432	5432	0	Netherlands Biodiversity Information Facility	0909d601-bda2-42df-9e63-a6d51847ebce	0d873cae-ef13-40cd-ac8b-08804bbc4fd0
1333	1333	0	Biodiversity Information System of Mexico	b324e8e9-9a4c-44fa-8f1a-7f39ea7ab576	0dd60212-0793-485a-a04d-f6d50208861d
0	1	1	Plazi	ffb07bec-2d10-492d-9c37-361fe0b79427	0fae01ce-7cf7-4392-9773-98a4febfc4b8
0	2	2	Plazi	ffb07bec-2d10-492d-9c37-361fe0b79427	14a39a10-9abe-4c85-ba83-1766af50f9fd
3	3	0	Plazi	ffb07bec-2d10-492d-9c37-361fe0b79427	14d5ad89-9e69-45f8-bc61-e14ca9deafbd
17	17	0	Plazi	ffb07bec-2d10-492d-9c37-361fe0b79427	14ec68a3-1d9a-4689-9eb4-fc1d3fce4e54
145	145	0	Colombian Biodiversity Information System	7e865cba-7c46-417b-ade5-97f2cf5b7be0	165f88fc-4163-4ef8-a515-67326e7282d0
63415	63415	0	U.S. Geological Survey	8618c64a-93e0-4300-b546-7249e5148ed2	175d2868-a330-4179-ba25-35da91a8214d
2	2	0	Plazi	ffb07bec-2d10-492d-9c37-361fe0b79427	195c4a70-8aba-4166-9516-048bcd43451b
0	163	163	Ocean Biodiversity Information System	ba0670b9-4186-41e6-8e70-f9cb3065551a	19b5dcf6-00e0-46ab-bf43-1d00862f6726
0	311	311	GBIF Malawi	2a42e4d7-ad4a-41b3-84c4-de4aa7b74d35	1b703c7d-e6a2-4990-8c09-1e02f0e955cc
5	5	0	Plazi	ffb07bec-2d10-492d-9c37-361fe0b79427	1c40a05c-06f7-41ec-a70a-370d524093fc
3	3	0	Plazi	ffb07bec-2d10-492d-9c37-361fe0b79427	1cc87763-a6ff-48a8-a1d4-ff1d44766f22
2	2	0	Plazi	ffb07bec-2d10-492d-9c37-361fe0b79427	1e1be7bb-5fbe-4720-8846-ffbd532b6bb2
1	1	0	Plazi	ffb07bec-2d10-492d-9c37-361fe0b79427	235da605-d088-41da-98ce-5e9c7d141a47
102	102	0	GBIF France	da44cd31-5901-4687-a106-6d1c7734ee3a	23e52a18-90fa-45b6-b045-401abb757ab2
1357	1357	0	Atlas of Living Australia	4a6f1b71-969e-4fc5-a693-282b05e1220c	23fa1c7a-1f3e-45c7-9997-cb718f8975b6
0	4679	4679	Colombian Biodiversity Information System	7e865cba-7c46-417b-ade5-97f2cf5b7be0	264eed56-6854-4634-b872-9f18a5d334d3
11	11	0	Plazi	ffb07bec-2d10-492d-9c37-361fe0b79427	2f6f78b7-1b17-4886-911c-53f10ddb79f2
4998	4998	0	Biodiversity Information System of Mexico	b324e8e9-9a4c-44fa-8f1a-7f39ea7ab576	372fc871-64bd-4fd3-bc32-7dc6eb4dcfd4
30	30	0	National Biodiversity Network	d897a5b9-35ee-4232-94bd-b0bcaac003c2	37a3ca0a-4a5c-45ab-b36e-bdaff9aad83d
1845	1845	0	GBIF France	da44cd31-5901-4687-a106-6d1c7734ee3a	3b7c6871-7f02-4990-a684-c43800ce373d
248496	248496	0	National Biodiversity Network	d897a5b9-35ee-4232-94bd-b0bcaac003c2	4ac5f415-6f44-43d0-a19b-2d91e5dcbe2b
0	8	8	Plazi	ffb07bec-2d10-492d-9c37-361fe0b79427	4b7c7633-875a-4524-8e6f-a8eca2da89fb
237	237	0	Plazi	ffb07bec-2d10-492d-9c37-361fe0b79427	4ff066c7-8444-476a-92b6-ab545a1c6489
90	90	0	Ocean Biodiversity Information System	ba0670b9-4186-41e6-8e70-f9cb3065551a	50965b5c-b6ac-4cea-9c73-1afe5bb0ec91
313	313	0	GBIF Norway	4f829580-180d-46a9-9c87-ed8ec959b545	50c2ac41-1578-4828-9fde-026bfda97146
5787	5787	0	Atlas of Living Australia	4a6f1b71-969e-4fc5-a693-282b05e1220c	51c51934-43f1-467c-b1b5-2e1c48fdd51b
51	51	0	Participant Node Managers Committee	7f48e0c8-5c96-49ec-b972-30748e339115	52a921c2-83ea-450f-95f2-5a6bd5c9093a
1	1	0	Plazi	ffb07bec-2d10-492d-9c37-361fe0b79427	559ef97a-3f53-457a-aebd-72c0652cd9f6
193	193	0	GBIF France	da44cd31-5901-4687-a106-6d1c7734ee3a	5639c736-f473-4656-a3db-aa535610bda5
844	844	0	GBIF France	da44cd31-5901-4687-a106-6d1c7734ee3a	5a2eac42-2b86-4740-bc83-c0154105749e
2633	6282	3649	U.S. Geological Survey	8618c64a-93e0-4300-b546-7249e5148ed2	5ab197be-317f-438f-b1a6-daa2e9381cb2
31	31	0	Plazi	ffb07bec-2d10-492d-9c37-361fe0b79427	5d1b6532-1244-4673-b4f6-1dd9a2028480
100	100	0	GBIF Germany	4f6826f2-4ff6-443d-b966-e6913bd24013	60850fe4-97df-4bb1-82a6-370bc5e58f74
3	3	0	Plazi	ffb07bec-2d10-492d-9c37-361fe0b79427	62d8bc9d-2dc0-44dc-8f78-6c6b0560c0a9
258	258	0	GBIF Germany	4f6826f2-4ff6-443d-b966-e6913bd24013	63a637ea-f762-11e1-a439-00145eb45e9a
95	95	0	GBIF Germany	4f6826f2-4ff6-443d-b966-e6913bd24013	63bcfe8a-f762-11e1-a439-00145eb45e9a
22633	22628	-5	Biodiversity Information System of Mexico	b324e8e9-9a4c-44fa-8f1a-7f39ea7ab576	63ed64cb-90b7-4ecc-b94c-3a0317742379
232	232	0	GBIF France	da44cd31-5901-4687-a106-6d1c7734ee3a	66e0591c-cb2e-45b3-a6cd-6e44e1163a83
53	53	0	GBIF Germany	4f6826f2-4ff6-443d-b966-e6913bd24013	6771c43e-f762-11e1-a439-00145eb45e9a
43	43	0	GBIF Germany	4f6826f2-4ff6-443d-b966-e6913bd24013	68148fe8-f762-11e1-a439-00145eb45e9a
48	48	0	GBIF Germany	4f6826f2-4ff6-443d-b966-e6913bd24013	682ef6a8-f762-11e1-a439-00145eb45e9a
379	379	0	Atlas of Living Australia	4a6f1b71-969e-4fc5-a693-282b05e1220c	68733b96-0244-495c-af7e-1c8d6a4a8dd3
0	2	2	Plazi	ffb07bec-2d10-492d-9c37-361fe0b79427	68b44f1a-fa6c-4e51-ad6d-50816b5c5d1b
68	68	0	GBIF Germany	4f6826f2-4ff6-443d-b966-e6913bd24013	698d7a9c-f762-11e1-a439-00145eb45e9a
50	50	0	Plazi	ffb07bec-2d10-492d-9c37-361fe0b79427	69cdc9dc-3d8a-4d67-b230-09e1c3207af2
0	2	2	Plazi	ffb07bec-2d10-492d-9c37-361fe0b79427	6a7ff04e-ab0e-41b5-b2e2-712b4a2a4633
36	36	0	GBIF Germany	4f6826f2-4ff6-443d-b966-e6913bd24013	6ab11032-f762-11e1-a439-00145eb45e9a
205	205	0	Secretariat of the Pacific Regional Environment Programme	29c6a139-ea7f-41f5-8d9b-c55af8736182	6acec881-19f3-43a6-ad0b-84dba9af6640
0	394	394	Ocean Biodiversity Information System	ba0670b9-4186-41e6-8e70-f9cb3065551a	6ca9da86-bf7e-488f-ba23-c3f99853e9cc
136	136	0	GBIF Germany	4f6826f2-4ff6-443d-b966-e6913bd24013	6d2d6310-f762-11e1-a439-00145eb45e9a
30	30	0	GBIF Germany	4f6826f2-4ff6-443d-b966-e6913bd24013	6d4a92fa-f762-11e1-a439-00145eb45e9a
4216	4216	0	GBIF Japan	db5705aa-6a6e-42f1-8942-d77b9f4896ea	705c0c0a-cf0a-4dd2-9332-d42db4601ffd
61	38	-23	GBIF Germany	4f6826f2-4ff6-443d-b966-e6913bd24013	722b6d4e-f762-11e1-a439-00145eb45e9a
49	49	0	GBIF Germany	4f6826f2-4ff6-443d-b966-e6913bd24013	74da4a92-f762-11e1-a439-00145eb45e9a
53	53	0	GBIF Germany	4f6826f2-4ff6-443d-b966-e6913bd24013	753d2a2c-f762-11e1-a439-00145eb45e9a
6	6	0	Plazi	ffb07bec-2d10-492d-9c37-361fe0b79427	7723cb57-f3e8-4ee2-b188-d95b8d34983e
2099	2099	0	GBIF Spain	1f94b3ca-9345-4d65-afe2-4bace93aa0fe	78ba4493-432d-4458-8696-7901cbe5e113
63	63	0	GBIF Germany	4f6826f2-4ff6-443d-b966-e6913bd24013	79c4ea62-f762-11e1-a439-00145eb45e9a
66	66	0	GBIF Germany	4f6826f2-4ff6-443d-b966-e6913bd24013	79c8cb1e-f762-11e1-a439-00145eb45e9a
5586	2352	-3234	GBIF Germany	4f6826f2-4ff6-443d-b966-e6913bd24013	79ede7e6-f762-11e1-a439-00145eb45e9a
667	667	0	GBIF Germany	4f6826f2-4ff6-443d-b966-e6913bd24013	7a193bee-f762-11e1-a439-00145eb45e9a
0	45	45	Plazi	ffb07bec-2d10-492d-9c37-361fe0b79427	7a19aeba-3ce6-471a-ad6a-ea27f47927fb
104	104	0	Ocean Biodiversity Information System	ba0670b9-4186-41e6-8e70-f9cb3065551a	7b644c6e-f762-11e1-a439-00145eb45e9a
75	75	0	GBIF France	da44cd31-5901-4687-a106-6d1c7734ee3a	7be7faff-def5-46f8-b80b-3d7f894be4f1
144	144	0	GBIF Germany	4f6826f2-4ff6-443d-b966-e6913bd24013	7c232fc6-f762-11e1-a439-00145eb45e9a
0	24	24	Plazi	ffb07bec-2d10-492d-9c37-361fe0b79427	7c41b53c-ee11-4186-a25e-bb3102a1f2f4
414	414	0	GBIF Germany	4f6826f2-4ff6-443d-b966-e6913bd24013	7ca7dce4-f762-11e1-a439-00145eb45e9a
105	105	0	National Biodiversity Network	d897a5b9-35ee-4232-94bd-b0bcaac003c2	7cd2b553-dbc1-483c-84ad-37e41d2026a1
9900	9900	0	GBIF Spain	1f94b3ca-9345-4d65-afe2-4bace93aa0fe	7e331736-f762-11e1-a439-00145eb45e9a
870	261	-609	GBIF Germany	4f6826f2-4ff6-443d-b966-e6913bd24013	7f1667b6-f762-11e1-a439-00145eb45e9a
6149	6146	-3	Biodiversity Information System of Mexico	b324e8e9-9a4c-44fa-8f1a-7f39ea7ab576	7f790c86-f762-11e1-a439-00145eb45e9a
100	100	0	Plazi	ffb07bec-2d10-492d-9c37-361fe0b79427	8053cc5c-900d-490b-84e9-1ca29a46aa3c
238	238	0	South African Biodiversity Information Facility	7190b835-4e86-4b6e-85c1-19cc6677c250	81350afc-a9e4-449c-9138-e09d23380695
728	728	0	GBIF Germany	4f6826f2-4ff6-443d-b966-e6913bd24013	81cb7816-f762-11e1-a439-00145eb45e9a
186	186	0	GBIF Germany	4f6826f2-4ff6-443d-b966-e6913bd24013	8270a5b6-f762-11e1-a439-00145eb45e9a
25140	38830	13690	GBIF Spain	1f94b3ca-9345-4d65-afe2-4bace93aa0fe	8346c3a8-f762-11e1-a439-00145eb45e9a
750	750	0	GBIF Spain	1f94b3ca-9345-4d65-afe2-4bace93aa0fe	83893c4c-f762-11e1-a439-00145eb45e9a
522	522	0	U.S. Geological Survey	8618c64a-93e0-4300-b546-7249e5148ed2	8521931a-f762-11e1-a439-00145eb45e9a
182	182	0	Colombian Biodiversity Information System	7e865cba-7c46-417b-ade5-97f2cf5b7be0	85b644e5-eda5-4e2f-b515-10cd555883ba
11622	11622	0	GBIF France	da44cd31-5901-4687-a106-6d1c7734ee3a	8647fbe0-3ba4-4ff3-91b7-1ccd2c9cc7bc
2562	2562	0	Biodiversity Information System of Mexico	b324e8e9-9a4c-44fa-8f1a-7f39ea7ab576	866fd8c4-0a74-4788-8fff-e4569a9ecf07
335	285	-50	GBIF Germany	4f6826f2-4ff6-443d-b966-e6913bd24013	86cf21fa-f762-11e1-a439-00145eb45e9a
0	221	221	Plazi	ffb07bec-2d10-492d-9c37-361fe0b79427	878bc664-23c5-4b8f-92dc-df86aa07242d
631	456	-175	GBIF Germany	4f6826f2-4ff6-443d-b966-e6913bd24013	87d5e5f2-f762-11e1-a439-00145eb45e9a
1	1	0	Plazi	ffb07bec-2d10-492d-9c37-361fe0b79427	88bd3577-8352-45e5-90b2-ac487d1e7841
227	227	0	GBIF France	da44cd31-5901-4687-a106-6d1c7734ee3a	89aadb74-dba5-443d-8ff6-7e2628835121
195	195	0	GBIF Germany	4f6826f2-4ff6-443d-b966-e6913bd24013	8aa0482c-f762-11e1-a439-00145eb45e9a
214	214	0	GBIF Germany	4f6826f2-4ff6-443d-b966-e6913bd24013	8aac5e78-f762-11e1-a439-00145eb45e9a
5	1	-4	GBIF Germany	4f6826f2-4ff6-443d-b966-e6913bd24013	8dc98bf8-f762-11e1-a439-00145eb45e9a
65	26	-39	GBIF Germany	4f6826f2-4ff6-443d-b966-e6913bd24013	8e0c7a9e-f762-11e1-a439-00145eb45e9a
56	39	-17	GBIF Germany	4f6826f2-4ff6-443d-b966-e6913bd24013	8e4fafbc-f762-11e1-a439-00145eb45e9a
1050	1050	0	GBIF New Zealand	4f9fd726-20dd-445e-89a1-8ed93792276f	8ec73638-2c0b-45b1-a399-be159f3799dc
0	620	620	Plazi	ffb07bec-2d10-492d-9c37-361fe0b79427	8f948bf9-6e6b-4167-aa50-bf648409d0e5
1635	961	-674	GBIF Germany	4f6826f2-4ff6-443d-b966-e6913bd24013	907d6c2a-f762-11e1-a439-00145eb45e9a
75	66	-9	GBIF Germany	4f6826f2-4ff6-443d-b966-e6913bd24013	926d6148-f762-11e1-a439-00145eb45e9a
18	18	0	GBIF Germany	4f6826f2-4ff6-443d-b966-e6913bd24013	934c4fac-f762-11e1-a439-00145eb45e9a
0	155	155	Ocean Biodiversity Information System	ba0670b9-4186-41e6-8e70-f9cb3065551a	94e8affd-ed66-4d5e-83a2-2f88255077c9
0	7	7	Plazi	ffb07bec-2d10-492d-9c37-361fe0b79427	958d0fe6-06ad-4f49-ac70-93adf230554e
28	28	0	GBIF France	da44cd31-5901-4687-a106-6d1c7734ee3a	97e52438-a0f4-467f-b8cb-14adc486e897
4635	4635	0	GBIF France	da44cd31-5901-4687-a106-6d1c7734ee3a	99ce2b9e-816a-47a7-ad68-b2915763a576
0	2	2	Plazi	ffb07bec-2d10-492d-9c37-361fe0b79427	9ce7bd13-bc0f-48f3-ba30-cda6c2a22dda
0	34	34	Plazi	ffb07bec-2d10-492d-9c37-361fe0b79427	9d402fa7-54cf-4147-b17a-44d15ac482a4
8	8	0	GBIF Germany	4f6826f2-4ff6-443d-b966-e6913bd24013	9f34341d-df33-45bc-a6be-0e423e9aee51
0	86	86	Plazi	ffb07bec-2d10-492d-9c37-361fe0b79427	a108311a-65d1-431d-b108-40e585c2646b
256	256	0	Plazi	ffb07bec-2d10-492d-9c37-361fe0b79427	a2728517-c791-44c7-852e-db6234e35eda
33	33	0	Plazi	ffb07bec-2d10-492d-9c37-361fe0b79427	a349f585-a56b-4aee-b082-58d671a15523
200	200	0	Plazi	ffb07bec-2d10-492d-9c37-361fe0b79427	a629b4a3-a209-4b25-a284-7fbde6431aaf
0	4	4	Plazi	ffb07bec-2d10-492d-9c37-361fe0b79427	a8afae65-b261-4a69-8618-d4daf757c0c6
23	23	0	Atlas of Living Australia	4a6f1b71-969e-4fc5-a693-282b05e1220c	a9a01e83-571b-42ff-b1ef-dab048029b32
0	16	16	Plazi	ffb07bec-2d10-492d-9c37-361fe0b79427	aa4fb5eb-d529-46e5-a8ee-233d2c9ec349
53	53	0	Plazi	ffb07bec-2d10-492d-9c37-361fe0b79427	ac53680f-6358-4d6b-8880-ccf3dd73297e
100	100	0	GBIF Germany	4f6826f2-4ff6-443d-b966-e6913bd24013	ae076571-8071-4beb-b3da-547096d61b0e
107	107	0	Plazi	ffb07bec-2d10-492d-9c37-361fe0b79427	ae4cf61a-06d2-4fd9-a12c-3457bf050e88
8	8	0	Plazi	ffb07bec-2d10-492d-9c37-361fe0b79427	aef8fd78-8592-4090-bcff-353eaebf47a2
78	78	0	Colombian Biodiversity Information System	7e865cba-7c46-417b-ade5-97f2cf5b7be0	b3e5097c-9629-45eb-9dd4-21ddb5f45f99
27	27	0	Plazi	ffb07bec-2d10-492d-9c37-361fe0b79427	b5150fe8-e62c-4754-8daa-641db7533221
14	14	0	Plazi	ffb07bec-2d10-492d-9c37-361fe0b79427	b7622904-4534-4fc0-aebd-d4766d680eb9
144	144	0	GBIF France	da44cd31-5901-4687-a106-6d1c7734ee3a	b8065cc7-69b5-490d-b55c-6938ac9e017a
41	41	0	GBIF France	da44cd31-5901-4687-a106-6d1c7734ee3a	b91c1edf-3103-446a-ba20-b1915b3c354e
0	6	6	Plazi	ffb07bec-2d10-492d-9c37-361fe0b79427	ba2476d0-97a3-44f7-9abc-8d444a4bcd6c
335075	335075	0	GBIF France	da44cd31-5901-4687-a106-6d1c7734ee3a	baa86fb2-7346-4507-a34f-44e4c1bd0d57
0	2	2	Participant Node Managers Committee	7f48e0c8-5c96-49ec-b972-30748e339115	bbfa44a1-b154-4ce5-90f9-bde3055c5b58
2010	2010	0	National Biodiversity Network	d897a5b9-35ee-4232-94bd-b0bcaac003c2	bc0e461c-7b8f-4b9a-9310-0f0ed283a7ae
9393	3813	-5580	GBIF Germany	4f6826f2-4ff6-443d-b966-e6913bd24013	bddd78ea-0913-4c48-bd6c-98704d757ed3
5757	5757	0	Biodiversity Information System of Mexico	b324e8e9-9a4c-44fa-8f1a-7f39ea7ab576	c13173f5-f372-4b1b-815f-2cd4f6f963a0
558453	558453	0	GBIF Finland	dd514216-5c7c-45f3-910d-797424cb5be6	c3a08655-9951-4d4e-b57e-27d494a643d6
258	258	0	GBIF France	da44cd31-5901-4687-a106-6d1c7734ee3a	c3db4af0-1266-42e4-9b6b-e18798b757a7
0	6	6	Plazi	ffb07bec-2d10-492d-9c37-361fe0b79427	c4fe2e75-875c-42f9-875f-7b2e9504418a
7	7	0	Plazi	ffb07bec-2d10-492d-9c37-361fe0b79427	c5d46c52-27c5-4b8d-a9d3-b4b3ff22de8f
54056	54056	0	Atlas of Living Australia	4a6f1b71-969e-4fc5-a693-282b05e1220c	c60d0b4f-4e51-4a5a-95dc-babc74ba3db0
200	200	0	GBIF Germany	4f6826f2-4ff6-443d-b966-e6913bd24013	c7979ea4-1a59-42e3-bd57-3abc9c263e8c
766	766	0	National Biodiversity Data Centre	422b00b2-6c94-4bb6-976b-c359916efdb8	c810fd00-c7b8-11de-b279-fa3206fbc3ce
3	3	0	Participant Node Managers Committee	7f48e0c8-5c96-49ec-b972-30748e339115	d29a09f7-a402-4664-821c-fa0adf825dcf
142124	146969	4845	GBIF Estonia	2c11b821-d22b-4c64-8cd3-c1578173b129	d3c28e6c-1192-4ef4-a38a-df790df16dc3
10	10	0	Plazi	ffb07bec-2d10-492d-9c37-361fe0b79427	d62ef848-a453-4d1b-ad5d-4df32cc62c78
5	5	0	Plazi	ffb07bec-2d10-492d-9c37-361fe0b79427	d7dee720-286b-47c2-9016-b4bd868d2654
4	4	0	Plazi	ffb07bec-2d10-492d-9c37-361fe0b79427	d7f1d8bc-6c4b-4ddf-a4a2-a4166e9ab0b7
1	1	0	Plazi	ffb07bec-2d10-492d-9c37-361fe0b79427	d95fb7d0-bf2c-49ad-9356-e0f279a08bd3
62208	62401	193	Canada Biodiversity Information Facility	8f83fc96-c966-4126-83f7-bf044dc49efa	dc3bfd08-0141-45ae-9603-91ac50cdc33b
0	2	2	Plazi	ffb07bec-2d10-492d-9c37-361fe0b79427	dc662b9a-0d0e-4025-a97b-a5bdae63b19e
1	1	0	Participant Node Managers Committee	7f48e0c8-5c96-49ec-b972-30748e339115	dcb19e1f-ab7a-47af-a031-2ff3b9ccebb7
0	14526	14526	U.S. Geological Survey	8618c64a-93e0-4300-b546-7249e5148ed2	de7ec8f9-44da-4cbf-9a3a-897ff2198c01
1863	1863	0	Canada Biodiversity Information Facility	8f83fc96-c966-4126-83f7-bf044dc49efa	df9c8b86-9d36-4e29-91b3-4274dff053e5
132	132	0	GBIF France	da44cd31-5901-4687-a106-6d1c7734ee3a	e030b8bc-bd4d-440e-80d8-12b764e85db5
0	30	30	Plazi	ffb07bec-2d10-492d-9c37-361fe0b79427	e0c68699-90c8-4b60-8ed4-e0bd6a7d066f
61	61	0	Plazi	ffb07bec-2d10-492d-9c37-361fe0b79427	e1247957-611f-42a3-960d-c3b73556976f
0	87	87	Plazi	ffb07bec-2d10-492d-9c37-361fe0b79427	e1eaf13c-9009-4e84-836e-91bbf7d2c81e
272770	272769	-1	National Biodiversity Network	d897a5b9-35ee-4232-94bd-b0bcaac003c2	e36c72ed-3b15-49f8-97fc-faaa467eb59e
135	135	0	GBIF Germany	4f6826f2-4ff6-443d-b966-e6913bd24013	e388c62a-e180-4563-9c31-8ce60b79f708
0	3	3	Plazi	ffb07bec-2d10-492d-9c37-361fe0b79427	e4cc5b58-4d5b-4451-a73f-abd0b5963e49
136	136	0	GBIF France	da44cd31-5901-4687-a106-6d1c7734ee3a	e75ba23e-efff-4ef3-a676-8397083765fb
0	11	11	Participant Node Managers Committee	7f48e0c8-5c96-49ec-b972-30748e339115	e8493b71-eb33-455d-bd20-e773ce30fe48
7	7	0	Plazi	ffb07bec-2d10-492d-9c37-361fe0b79427	eb9cfc36-2b27-408f-b08a-e32d95cd3420
426	426	0	GBIF France	da44cd31-5901-4687-a106-6d1c7734ee3a	ed29555c-f0d2-4ec7-84f5-86c20f2d52d2
6610	6610	0	GBIF Benin	efb9c00e-f802-45dd-8826-a52ec45b89ff	ee37f1cd-9359-4d8f-ad7e-22e3ac4a740c
0	30	30	Participant Node Managers Committee	7f48e0c8-5c96-49ec-b972-30748e339115	f1ddda5a-ac85-46a3-955c-b75277c6a600
2	2	0	Plazi	ffb07bec-2d10-492d-9c37-361fe0b79427	f1ef7c3e-5e47-4ac3-882f-10428c1a8129
59717	59717	0	U.S. Geological Survey	8618c64a-93e0-4300-b546-7249e5148ed2	f42d2be3-1264-4b68-a3bd-39363bcc437f
1300	1300	0	GBIF Germany	4f6826f2-4ff6-443d-b966-e6913bd24013	f45af3e5-a93e-4702-84de-09158202b5d5
18	18	0	Plazi	ffb07bec-2d10-492d-9c37-361fe0b79427	f52c7899-f718-4526-8a17-8367f405af4a
392	392	0	GBIF France	da44cd31-5901-4687-a106-6d1c7734ee3a	f6612473-7914-461b-aed6-b14990d63e9a
54952	54952	0	GBIF France	da44cd31-5901-4687-a106-6d1c7734ee3a	f870ac2b-3b10-4ce9-a512-fad62bcddc32
48769	48769	0	Polish Biodiversity Information Network	2618bfdf-e194-4911-a241-80db3107bc51	f9261370-af9d-11db-ad75-b8a03c50a862
0	12	12	Plazi	ffb07bec-2d10-492d-9c37-361fe0b79427	fa172759-c7a8-4682-b992-8871c155eb3a
13323	13323	0	Biodiversity Information System of Mexico	b324e8e9-9a4c-44fa-8f1a-7f39ea7ab576	ff6580f3-8fba-4f4f-9c09-64dbb002d89f
6	6	0	GBIF France	da44cd31-5901-4687-a106-6d1c7734ee3a	00d09ece-c0bd-4b1c-b740-152ae13dfaae
3105	3105	0	GBIF Germany	4f6826f2-4ff6-443d-b966-e6913bd24013	02d03809-ca95-40a8-8767-3af423d1b5af
15	15	0	Plazi	ffb07bec-2d10-492d-9c37-361fe0b79427	07b433c8-b689-48f7-b97a-b6877164e17e
139	139	0	Participant Node Managers Committee	7f48e0c8-5c96-49ec-b972-30748e339115	08595a87-8668-421b-b045-8b1b50215583
268	268	0	GBIF France	da44cd31-5901-4687-a106-6d1c7734ee3a	09dc6ae5-df52-4419-b36a-3c1541ad64c9
54	54	0	Participant Node Managers Committee	7f48e0c8-5c96-49ec-b972-30748e339115	0c77bfef-bbbc-43f9-9583-98bd4b9d5b77
2	2	0	Plazi	ffb07bec-2d10-492d-9c37-361fe0b79427	0ccf7e92-6352-4e31-b410-e32f3ffefbf8
53517	101664	48147	U.S. Geological Survey	8618c64a-93e0-4300-b546-7249e5148ed2	0d8d90f4-973a-46a1-9ea1-55b0c7b222ea
173	173	0	Plazi	ffb07bec-2d10-492d-9c37-361fe0b79427	0e6ccf7f-8e43-40c1-99a4-616658ec790b
21	21	0	Plazi	ffb07bec-2d10-492d-9c37-361fe0b79427	1277a981-e80a-4159-9e4e-f9dfe7e5e10c
928	928	0	GBIF France	da44cd31-5901-4687-a106-6d1c7734ee3a	1507bd69-1257-4a68-921e-4287e3ea7761
8	8	0	Plazi	ffb07bec-2d10-492d-9c37-361fe0b79427	1945ba02-8dff-402c-a5bb-fd400a98b332
0	7	7	Plazi	ffb07bec-2d10-492d-9c37-361fe0b79427	1adfb85d-e74b-429e-967e-8c3fa8517951
27	27	0	National Biodiversity Network	d897a5b9-35ee-4232-94bd-b0bcaac003c2	1ecc4252-ce67-4f4e-aa86-4250ddd07e6d
81	81	0	GBIF France	da44cd31-5901-4687-a106-6d1c7734ee3a	1f95271a-ac7f-4eff-b8fc-02b314e4b604
13	13	0	Plazi	ffb07bec-2d10-492d-9c37-361fe0b79427	20e99045-6615-4e94-965f-db36c9fa25b9
0	43	43	Plazi	ffb07bec-2d10-492d-9c37-361fe0b79427	2315fd5b-b9f0-4c78-956c-8c9ee7a8d35b
0	81	81	Plazi	ffb07bec-2d10-492d-9c37-361fe0b79427	2316f656-f5b3-4501-b9f0-2c8d26ea6868
13	13	0	Plazi	ffb07bec-2d10-492d-9c37-361fe0b79427	23ff8380-5503-4d06-b5ec-9d003c2d2506
7479	7479	0	GBIF Israel	8cb55387-7802-40e8-86d6-d357a583c596	25314346-645c-4197-8339-607c3ef4e273
3	3	0	Plazi	ffb07bec-2d10-492d-9c37-361fe0b79427	27fc7eb1-4781-4a1f-9cbb-f268e80ebb85
7	7	0	Plazi	ffb07bec-2d10-492d-9c37-361fe0b79427	281121d9-27e3-4b1f-b41c-1ca916544e3e
0	1	1	Plazi	ffb07bec-2d10-492d-9c37-361fe0b79427	2956d27c-7521-4396-ba38-b3dacf6d45ce
62161	62161	0	National Biodiversity Network	d897a5b9-35ee-4232-94bd-b0bcaac003c2	2ac4b2f0-9887-4d25-a8fa-f94391e87919
1481	1481	0	GBIF Norway	4f829580-180d-46a9-9c87-ed8ec959b545	2af62ff7-0608-462e-a8f8-798e323bbd71
5414	5414	0	Canada Biodiversity Information Facility	8f83fc96-c966-4126-83f7-bf044dc49efa	2c12acd9-1600-487d-a809-2c2743381112
27972	27972	0	National Biodiversity Network	d897a5b9-35ee-4232-94bd-b0bcaac003c2	2c913302-43b2-4e8e-813f-2d6bb33f4c7e
1	1	0	Plazi	ffb07bec-2d10-492d-9c37-361fe0b79427	2d517638-f7f9-411c-a102-88124f3c638a
0	543	543	Ocean Biodiversity Information System	ba0670b9-4186-41e6-8e70-f9cb3065551a	2f12f211-ccdc-46c3-9d9e-00d155ddd6af
0	76	76	Participant Node Managers Committee	7f48e0c8-5c96-49ec-b972-30748e339115	2f8e31e3-b105-45d0-9222-986c6bb206a5
171669	176012	4343	Canada Biodiversity Information Facility	8f83fc96-c966-4126-83f7-bf044dc49efa	2fd02649-fc08-4957-9ac5-2830e072c097
88	88	0	Plazi	ffb07bec-2d10-492d-9c37-361fe0b79427	30dcdff1-e248-474c-b536-a139cc9800e3
208	208	0	GBIF Benin	efb9c00e-f802-45dd-8826-a52ec45b89ff	356e8538-d6c7-4935-9450-821a68dea158
23	23	0	Plazi	ffb07bec-2d10-492d-9c37-361fe0b79427	35b898c1-e4e9-4d6c-a6b3-e4446126e593
14	14	0	Plazi	ffb07bec-2d10-492d-9c37-361fe0b79427	360c7984-05d2-4850-83a0-c0a5a55df206
95950	95950	0	National Biodiversity Data Centre	422b00b2-6c94-4bb6-976b-c359916efdb8	3a30ab5c-d1cf-4c22-8c25-1fd110ddd30d
3	3	0	Plazi	ffb07bec-2d10-492d-9c37-361fe0b79427	3b2a5ed1-7880-48cc-b736-b1389f136ba6
38168	38168	0	Atlas of Living Australia	4a6f1b71-969e-4fc5-a693-282b05e1220c	3b7f6307-2f03-4f25-9f64-6aa4c3a3aea1
3	3	0	Plazi	ffb07bec-2d10-492d-9c37-361fe0b79427	433bfc26-5b08-49bc-806c-bff705808511
4	4	0	Plazi	ffb07bec-2d10-492d-9c37-361fe0b79427	43c923cf-a02c-4a41-95a5-c7622d6ac652
6257	6257	0	Participant Node Managers Committee	7f48e0c8-5c96-49ec-b972-30748e339115	447944f5-3897-46ec-ad05-9b9d7a3ae39c
17	17	0	GBIF Germany	4f6826f2-4ff6-443d-b966-e6913bd24013	469dece4-cadd-441c-9ac4-affea494845e
19700	19700	0	Netherlands Biodiversity Information Facility	0909d601-bda2-42df-9e63-a6d51847ebce	494ceb90-924c-483d-ae58-9dd89efb85a1
9	9	0	Plazi	ffb07bec-2d10-492d-9c37-361fe0b79427	4ba5eb60-ce4d-4b2c-9c36-0a633570563d
1189	1189	0	Participant Node Managers Committee	7f48e0c8-5c96-49ec-b972-30748e339115	4be877d9-b751-4c27-83e3-56eba52348d7
0	2	2	Plazi	ffb07bec-2d10-492d-9c37-361fe0b79427	4cd6f6f1-b7dc-4544-aaa0-63db83057922
3	3	0	Plazi	ffb07bec-2d10-492d-9c37-361fe0b79427	4d4d356c-2abf-49de-a6aa-c529b11b5517
875	875	0	Colombian Biodiversity Information System	7e865cba-7c46-417b-ade5-97f2cf5b7be0	4df57e87-369b-418b-b9a4-5b69fc64857c
6211	421	-5790	U.S. Geological Survey	8618c64a-93e0-4300-b546-7249e5148ed2	4e50e3a6-8d31-44bc-ad3d-de6311ad0943
2	2	0	Plazi	ffb07bec-2d10-492d-9c37-361fe0b79427	50118f26-9f46-40da-9739-2ca57527370c
119	119	0	GBIF France	da44cd31-5901-4687-a106-6d1c7734ee3a	51694e4b-bc00-451c-881a-02e4a12c9a82
997	997	0	Plazi	ffb07bec-2d10-492d-9c37-361fe0b79427	53b4d580-0d02-4bfd-8792-2bec3516454d
7	7	0	Plazi	ffb07bec-2d10-492d-9c37-361fe0b79427	54df4dc5-0117-46a7-ae72-ccd9cfd5f707
1523	1523	0	National Biodiversity Network	d897a5b9-35ee-4232-94bd-b0bcaac003c2	5520dc44-3ed6-4825-8a69-9e93c3829371
1226	1226	0	Colombian Biodiversity Information System	7e865cba-7c46-417b-ade5-97f2cf5b7be0	5623a2e3-54ad-490a-ae30-8cb24f194c0d
0	195	195	National Biodiversity Network	d897a5b9-35ee-4232-94bd-b0bcaac003c2	59407d0a-3dfc-4384-a767-b45bf177fdb9
0	2	2	Plazi	ffb07bec-2d10-492d-9c37-361fe0b79427	5bcc0758-154b-4f93-8387-0e2bc0e3c0b2
11090	11090	0	Participant Node Managers Committee	7f48e0c8-5c96-49ec-b972-30748e339115	609f3aaf-8aaa-4cdc-9f44-369702e1bc01
81	81	0	GBIF Germany	4f6826f2-4ff6-443d-b966-e6913bd24013	623f74f5-8a71-4166-b66d-200459275785
60	60	0	GBIF Germany	4f6826f2-4ff6-443d-b966-e6913bd24013	6244a53a-f762-11e1-a439-00145eb45e9a
110	110	0	GBIF Germany	4f6826f2-4ff6-443d-b966-e6913bd24013	6252e12c-f762-11e1-a439-00145eb45e9a
5235	5235	0	Belgian Biodiversity Platform	fb11cfe1-ebc3-45af-9159-17d9fddbcdac	62e90e63-932a-4664-b0c6-5c08555fa3ca
21	21	0	GBIF Germany	4f6826f2-4ff6-443d-b966-e6913bd24013	6316812c-f762-11e1-a439-00145eb45e9a
54	54	0	GBIF Germany	4f6826f2-4ff6-443d-b966-e6913bd24013	64183a5c-f762-11e1-a439-00145eb45e9a
10	10	0	Plazi	ffb07bec-2d10-492d-9c37-361fe0b79427	64190d5b-0175-4254-8d8f-c3657b2aceaa
47	47	0	GBIF Germany	4f6826f2-4ff6-443d-b966-e6913bd24013	6462842c-f762-11e1-a439-00145eb45e9a
53	53	0	GBIF Germany	4f6826f2-4ff6-443d-b966-e6913bd24013	64779c72-f762-11e1-a439-00145eb45e9a
163	163	0	GBIF Germany	4f6826f2-4ff6-443d-b966-e6913bd24013	655a572e-f762-11e1-a439-00145eb45e9a
18	15	-3	GBIF Germany	4f6826f2-4ff6-443d-b966-e6913bd24013	65bf13e4-f762-11e1-a439-00145eb45e9a
0	47	47	Ocean Biodiversity Information System	ba0670b9-4186-41e6-8e70-f9cb3065551a	65f7ea41-568c-49c3-808f-41317daeec99
182	182	0	GBIF Germany	4f6826f2-4ff6-443d-b966-e6913bd24013	675ef07a-f762-11e1-a439-00145eb45e9a
40	40	0	GBIF Germany	4f6826f2-4ff6-443d-b966-e6913bd24013	678791e2-f762-11e1-a439-00145eb45e9a
48	48	0	GBIF Germany	4f6826f2-4ff6-443d-b966-e6913bd24013	68067520-f762-11e1-a439-00145eb45e9a
156	156	0	GBIF Germany	4f6826f2-4ff6-443d-b966-e6913bd24013	6850f35c-f762-11e1-a439-00145eb45e9a
95	95	0	GBIF Germany	4f6826f2-4ff6-443d-b966-e6913bd24013	687afa12-f762-11e1-a439-00145eb45e9a
18	18	0	GBIF Germany	4f6826f2-4ff6-443d-b966-e6913bd24013	68f75c2e-f762-11e1-a439-00145eb45e9a
46	46	0	GBIF Germany	4f6826f2-4ff6-443d-b966-e6913bd24013	69b4384e-f762-11e1-a439-00145eb45e9a
8	8	0	Plazi	ffb07bec-2d10-492d-9c37-361fe0b79427	6ab0c810-4a49-4a9a-8830-66e044e66255
15	15	0	GBIF Germany	4f6826f2-4ff6-443d-b966-e6913bd24013	6ba15d13-dd67-4d24-aa91-bf6a26cd7181
142	142	0	GBIF Germany	4f6826f2-4ff6-443d-b966-e6913bd24013	6ba1d0b2-f762-11e1-a439-00145eb45e9a
1140	1140	0	GBIF Portugal	673f7038-4262-4149-b753-5658a4e912f6	6bfdaa32-6a59-4b1f-8c99-ce8f1f7a4d52
0	3	3	Plazi	ffb07bec-2d10-492d-9c37-361fe0b79427	6c68ffec-a5cc-4d0e-88d0-eeb1ba6c8130
69	69	0	GBIF Germany	4f6826f2-4ff6-443d-b966-e6913bd24013	6c92a172-f762-11e1-a439-00145eb45e9a
36	31	-5	GBIF Germany	4f6826f2-4ff6-443d-b966-e6913bd24013	6f87b67e-f762-11e1-a439-00145eb45e9a
0	4	4	Plazi	ffb07bec-2d10-492d-9c37-361fe0b79427	702b3b1f-bd77-4ce5-a439-32b6d953cbac
7774	7774	0	GBIF Israel	8cb55387-7802-40e8-86d6-d357a583c596	70575325-3566-40cd-95d2-7747822170ad
119	119	0	GBIF Germany	4f6826f2-4ff6-443d-b966-e6913bd24013	70efe72a-f762-11e1-a439-00145eb45e9a
64	64	0	GBIF Germany	4f6826f2-4ff6-443d-b966-e6913bd24013	717dbaf0-f762-11e1-a439-00145eb45e9a
3	3	0	GBIF Germany	4f6826f2-4ff6-443d-b966-e6913bd24013	71a8a7ce-f762-11e1-a439-00145eb45e9a
0	9	9	Plazi	ffb07bec-2d10-492d-9c37-361fe0b79427	71d234ed-3258-4023-8347-cd621c71f14c
2268	2268	0	GBIF Japan	db5705aa-6a6e-42f1-8942-d77b9f4896ea	71dc664a-f762-11e1-a439-00145eb45e9a
1200	1200	0	GBIF Japan	db5705aa-6a6e-42f1-8942-d77b9f4896ea	71dd9326-f762-11e1-a439-00145eb45e9a
5715	6758	1043	GBIF Germany	4f6826f2-4ff6-443d-b966-e6913bd24013	71edea50-f762-11e1-a439-00145eb45e9a
54	54	0	GBIF Germany	4f6826f2-4ff6-443d-b966-e6913bd24013	72b30cc2-f762-11e1-a439-00145eb45e9a
6	6	0	GBIF Germany	4f6826f2-4ff6-443d-b966-e6913bd24013	73587400-f762-11e1-a439-00145eb45e9a
126934	148846	21912	Symbiota Support Hub	612b5a0b-908b-4b4e-b9bf-ca15dfdc94fa	750b7bfc-3577-4b26-8aaf-3e4be9f0d639
51	51	0	GBIF Germany	4f6826f2-4ff6-443d-b966-e6913bd24013	752684e8-f762-11e1-a439-00145eb45e9a
661	661	0	National Biodiversity Network	d897a5b9-35ee-4232-94bd-b0bcaac003c2	756dd557-2127-4a52-af58-482b543d508a
143	143	0	GBIF Germany	4f6826f2-4ff6-443d-b966-e6913bd24013	75fd951e-f762-11e1-a439-00145eb45e9a
2349	2349	0	GBIF France	da44cd31-5901-4687-a106-6d1c7734ee3a	76cff260-eb1c-40a0-9cea-140ab0236dcf
122	122	0	GBIF Germany	4f6826f2-4ff6-443d-b966-e6913bd24013	78c8ddda-f762-11e1-a439-00145eb45e9a
0	5309	5309	GBIF Finland	dd514216-5c7c-45f3-910d-797424cb5be6	78d38015-7cb8-425a-a328-cac5634f480e
0	2	2	Plazi	ffb07bec-2d10-492d-9c37-361fe0b79427	7994c4b7-754c-44e0-b4b7-12dbb5e1f719
191	110	-81	GBIF Germany	4f6826f2-4ff6-443d-b966-e6913bd24013	7a143c34-f762-11e1-a439-00145eb45e9a
50	50	0	GBIF Germany	4f6826f2-4ff6-443d-b966-e6913bd24013	7a8cc046-f762-11e1-a439-00145eb45e9a
91	91	0	GBIF Germany	4f6826f2-4ff6-443d-b966-e6913bd24013	7a91d4d2-f762-11e1-a439-00145eb45e9a
0	40	40	Plazi	ffb07bec-2d10-492d-9c37-361fe0b79427	7b960500-f4a3-4b8f-8b56-440fdc9431c9
180	162	-18	GBIF Germany	4f6826f2-4ff6-443d-b966-e6913bd24013	7cac11d8-f762-11e1-a439-00145eb45e9a
2088	2088	0	GBIF Germany	4f6826f2-4ff6-443d-b966-e6913bd24013	7cca04e0-f762-11e1-a439-00145eb45e9a
58	58	0	Plazi	ffb07bec-2d10-492d-9c37-361fe0b79427	7d17090e-0622-406d-bd6d-48649b686239
630	270	-360	GBIF Germany	4f6826f2-4ff6-443d-b966-e6913bd24013	7d2fd900-f762-11e1-a439-00145eb45e9a
0	5	5	Plazi	ffb07bec-2d10-492d-9c37-361fe0b79427	7d706b2d-59b7-4297-bca3-6758058242b8
552	552	0	GBIF Germany	4f6826f2-4ff6-443d-b966-e6913bd24013	7dae0e74-f762-11e1-a439-00145eb45e9a
102	102	0	GBIF Germany	4f6826f2-4ff6-443d-b966-e6913bd24013	7edd459e-f762-11e1-a439-00145eb45e9a
50238	50240	2	Biodiversity Information System of Mexico	b324e8e9-9a4c-44fa-8f1a-7f39ea7ab576	7fd2f6e2-f762-11e1-a439-00145eb45e9a
88	88	0	GBIF France	da44cd31-5901-4687-a106-6d1c7734ee3a	7ff16573-afe0-4326-ad20-3c2d33e6fc88
168	168	0	Biodiversity Information System of Mexico	b324e8e9-9a4c-44fa-8f1a-7f39ea7ab576	8026a170-f762-11e1-a439-00145eb45e9a
3	3	0	Plazi	ffb07bec-2d10-492d-9c37-361fe0b79427	806f3a8f-219d-48ff-9b05-8ff10546940a
62324	62324	0	GBIF Japan	db5705aa-6a6e-42f1-8942-d77b9f4896ea	81031dbc-47f2-470d-9efa-e809b8310d62
1694	1694	0	GBIF Germany	4f6826f2-4ff6-443d-b966-e6913bd24013	81c024c0-f762-11e1-a439-00145eb45e9a
7869	7869	0	GBIF Germany	4f6826f2-4ff6-443d-b966-e6913bd24013	81c8e8e4-f762-11e1-a439-00145eb45e9a
2686	1426	-1260	GBIF Germany	4f6826f2-4ff6-443d-b966-e6913bd24013	823da684-f762-11e1-a439-00145eb45e9a
0	130	130	Ocean Biodiversity Information System	ba0670b9-4186-41e6-8e70-f9cb3065551a	8267ad5b-16d0-4815-856b-4bdf02f96031
16	16	0	Ocean Biodiversity Information System	ba0670b9-4186-41e6-8e70-f9cb3065551a	82e9c125-bfdb-4d7b-b617-b8a6b97d2fc4
0	7000	7000	GBIF Japan	db5705aa-6a6e-42f1-8942-d77b9f4896ea	83b9c52f-c787-4b5d-ab38-51623c47bef9
5184	5184	0	Canada Biodiversity Information Facility	8f83fc96-c966-4126-83f7-bf044dc49efa	8477542c-f762-11e1-a439-00145eb45e9a
272	208	-64	GBIF Germany	4f6826f2-4ff6-443d-b966-e6913bd24013	871b8ad6-f762-11e1-a439-00145eb45e9a
54	54	0	Colombian Biodiversity Information System	7e865cba-7c46-417b-ade5-97f2cf5b7be0	889c0b31-0950-4133-b7d0-7078de6e41e1
232661	232661	0	U.S. Geological Survey	8618c64a-93e0-4300-b546-7249e5148ed2	8937328e-f762-11e1-a439-00145eb45e9a
11	11	0	Plazi	ffb07bec-2d10-492d-9c37-361fe0b79427	8956e01a-34c4-4cf2-a0f4-ad4f6c085d99
1	1	0	Plazi	ffb07bec-2d10-492d-9c37-361fe0b79427	8987221d-2607-4d89-b01d-df350d3d8d61
22	22	0	GBIF Germany	4f6826f2-4ff6-443d-b966-e6913bd24013	8a6aca38-97e7-446c-a821-7d035ef9b712
0	13	13	Plazi	ffb07bec-2d10-492d-9c37-361fe0b79427	8ab5fd07-c866-4c5a-aee3-e5c6f3e18f8d
0	138	138	Plazi	ffb07bec-2d10-492d-9c37-361fe0b79427	8adfa0f6-06a7-44b5-a3be-351d0bdc7a62
1445	1445	0	National Biodiversity Network	d897a5b9-35ee-4232-94bd-b0bcaac003c2	8c037c79-3540-485b-bc50-ace2cf8068b5
0	13	13	Plazi	ffb07bec-2d10-492d-9c37-361fe0b79427	8c493d71-3599-4b1d-ac3e-1ec696b42e43
99	75	-24	GBIF Germany	4f6826f2-4ff6-443d-b966-e6913bd24013	8c91e1ea-f762-11e1-a439-00145eb45e9a
55	55	0	Plazi	ffb07bec-2d10-492d-9c37-361fe0b79427	8ca25900-3a6f-4f10-9331-dff9eeccbb8d
79	79	0	GBIF Germany	4f6826f2-4ff6-443d-b966-e6913bd24013	8cca7d20-f762-11e1-a439-00145eb45e9a
15	9	-6	GBIF Germany	4f6826f2-4ff6-443d-b966-e6913bd24013	8ceff37a-f762-11e1-a439-00145eb45e9a
4	1	-3	GBIF Germany	4f6826f2-4ff6-443d-b966-e6913bd24013	8d0c664a-f762-11e1-a439-00145eb45e9a
52	47	-5	GBIF Germany	4f6826f2-4ff6-443d-b966-e6913bd24013	8d2df594-f762-11e1-a439-00145eb45e9a
18	18	0	GBIF Germany	4f6826f2-4ff6-443d-b966-e6913bd24013	8d5c2a18-f762-11e1-a439-00145eb45e9a
0	10	10	Plazi	ffb07bec-2d10-492d-9c37-361fe0b79427	8e366d34-1f76-46cf-a9af-463f664de818
8	7	-1	GBIF Germany	4f6826f2-4ff6-443d-b966-e6913bd24013	8e6d9dba-f762-11e1-a439-00145eb45e9a
1232	436	-796	GBIF Germany	4f6826f2-4ff6-443d-b966-e6913bd24013	8f7bfb16-f762-11e1-a439-00145eb45e9a
7214	7214	0	GBIF Uganda	71b40829-6a12-4c3d-8fee-5746f5e9cf8c	90b6055a-c12b-4c91-951a-7efbe184bca1
119	99	-20	GBIF Germany	4f6826f2-4ff6-443d-b966-e6913bd24013	90c360ae-f762-11e1-a439-00145eb45e9a
22	9	-13	GBIF Germany	4f6826f2-4ff6-443d-b966-e6913bd24013	90f721c8-f762-11e1-a439-00145eb45e9a
0	13	13	Plazi	ffb07bec-2d10-492d-9c37-361fe0b79427	92f89e27-1608-4dad-b794-bd1371e192b8
117	117	0	GBIF Germany	4f6826f2-4ff6-443d-b966-e6913bd24013	937e2784-f762-11e1-a439-00145eb45e9a
82	82	0	Plazi	ffb07bec-2d10-492d-9c37-361fe0b79427	9387eaf9-976d-4067-96a5-fae2e0a17b07
0	61	61	Participant Node Managers Committee	7f48e0c8-5c96-49ec-b972-30748e339115	94ac7b77-fc60-4ce6-9994-93499027e274
4	4	0	Plazi	ffb07bec-2d10-492d-9c37-361fe0b79427	956ddd8d-6abf-44df-8877-7ecae2491d16
6	6	0	GBIF Germany	4f6826f2-4ff6-443d-b966-e6913bd24013	95789736-f762-11e1-a439-00145eb45e9a
2550	2550	0	Ocean Biodiversity Information System	ba0670b9-4186-41e6-8e70-f9cb3065551a	970454b6-8939-4719-a1ae-8a8a8f647e17
1268	1268	0	GBIF Madagascar	2dbfc5c5-51b5-4494-9dfc-4d3f013a3b64	977e06c0-e58a-11de-ad5c-998cc9e29689
50	50	0	GBIF Germany	4f6826f2-4ff6-443d-b966-e6913bd24013	97c492ec-f762-11e1-a439-00145eb45e9a
5	5	0	Plazi	ffb07bec-2d10-492d-9c37-361fe0b79427	97e1deb1-310c-4cfc-a816-bb26f91ce0a1
10	10	0	Biodiversity Information System of Mexico	b324e8e9-9a4c-44fa-8f1a-7f39ea7ab576	9814a951-48a2-41a4-80a7-bc1daf466bbb
0	17	17	Plazi	ffb07bec-2d10-492d-9c37-361fe0b79427	992a1126-487d-4ac6-b5c7-e83590fea7bd
1942	1942	0	Colombian Biodiversity Information System	7e865cba-7c46-417b-ade5-97f2cf5b7be0	99b1c33f-113b-4477-8075-a9bbe5df0246
0	6	6	Plazi	ffb07bec-2d10-492d-9c37-361fe0b79427	9aeaf039-f5f1-487a-ad2d-f3504e883691
10	10	0	Plazi	ffb07bec-2d10-492d-9c37-361fe0b79427	9e229a2d-818f-4b6f-875c-73da87bf1648
3	3	0	Plazi	ffb07bec-2d10-492d-9c37-361fe0b79427	9ff0d63c-0ecd-40d5-aacb-4daa2c43856e
0	7	7	Plazi	ffb07bec-2d10-492d-9c37-361fe0b79427	a1f031f6-001b-4b4d-ac30-c4ded463c0c7
126	126	0	National Biodiversity Network	d897a5b9-35ee-4232-94bd-b0bcaac003c2	a2ae2c7a-9be1-40ed-b555-d77178a91da6
0	54	54	Plazi	ffb07bec-2d10-492d-9c37-361fe0b79427	a34a76c4-f490-4ef5-8a4d-4fad13aae029
281	281	0	Colombian Biodiversity Information System	7e865cba-7c46-417b-ade5-97f2cf5b7be0	a38bf3d5-359b-465d-a198-2418a1b9ef60
0	4	4	Plazi	ffb07bec-2d10-492d-9c37-361fe0b79427	a4fd4c93-6954-4d53-bc35-546804b1919a
0	1	1	Plazi	ffb07bec-2d10-492d-9c37-361fe0b79427	a53b8864-aedf-47e1-96ce-e3ea9d801b58
10718	10718	0	GBIF France	da44cd31-5901-4687-a106-6d1c7734ee3a	a58685c7-1308-4ddd-a3e2-4555173fde07
0	7	7	Plazi	ffb07bec-2d10-492d-9c37-361fe0b79427	a69af48a-a7ad-4345-b181-8d2d476a3631
0	54	54	Plazi	ffb07bec-2d10-492d-9c37-361fe0b79427	a7d818e1-e9d1-4960-8f6d-937c00a8fa6c
22	22	0	Plazi	ffb07bec-2d10-492d-9c37-361fe0b79427	a8900ee5-94e5-4848-a190-100931b099bc
1212	1212	0	DanBIF - Danish Biodiversity Information Facility	4ddd294f-02b7-4359-ac33-0806a9ca9c6b	ad331dcc-d0fa-4816-b1e6-d36f9f899c49
2548	2548	0	GBIF Israel	8cb55387-7802-40e8-86d6-d357a583c596	add0eb9b-5d2c-40c3-a0c6-d4a9a0105312
208	208	0	Colombian Biodiversity Information System	7e865cba-7c46-417b-ade5-97f2cf5b7be0	af85469c-ed5f-45ea-8217-993b6e41dde4
2	2	0	GBIF France	da44cd31-5901-4687-a106-6d1c7734ee3a	b1614ad0-874f-4f77-8404-3927018503bf
3	3	0	Plazi	ffb07bec-2d10-492d-9c37-361fe0b79427	b3389edb-0c16-44bb-a82c-cd7736b59b01
5509684	5531415	21731	GBIF France	da44cd31-5901-4687-a106-6d1c7734ee3a	b5cdf794-8fa4-4a85-8b26-755d087bf531
0	1	1	Plazi	ffb07bec-2d10-492d-9c37-361fe0b79427	b70f9ab5-4626-464f-bb6a-ce5d9ef54e96
1	1	0	Plazi	ffb07bec-2d10-492d-9c37-361fe0b79427	b8fc1dc9-ebcf-4c2a-9154-5bbc421b291e
9	9	0	Plazi	ffb07bec-2d10-492d-9c37-361fe0b79427	ba033418-9a5b-4bec-9da6-350f8501d71b
2104	2104	0	GBIF France	da44cd31-5901-4687-a106-6d1c7734ee3a	ba14a95c-84b3-40c0-91c1-ad4bfca23573
30	30	0	Participant Node Managers Committee	7f48e0c8-5c96-49ec-b972-30748e339115	ba3d7313-be25-4775-b4cf-5bb207f905b4
69396	69396	0	GBIF Germany	4f6826f2-4ff6-443d-b966-e6913bd24013	bd63a93c-8283-11e2-b873-00145eb45e9a
2	2	0	Plazi	ffb07bec-2d10-492d-9c37-361fe0b79427	bd7d6423-9948-45b3-8b1f-1c157c6f42ff
0	4	4	Plazi	ffb07bec-2d10-492d-9c37-361fe0b79427	be536923-5177-47fa-b06d-8bab755faaf3
0	6	6	Plazi	ffb07bec-2d10-492d-9c37-361fe0b79427	be7351e3-6f99-4978-a80c-169b7e47fd14
4658	4658	0	Ocean Biodiversity Information System	ba0670b9-4186-41e6-8e70-f9cb3065551a	bf6ec1a0-c7dd-456c-bbd9-465e626a3267
24077	24077	0	GBIF France	da44cd31-5901-4687-a106-6d1c7734ee3a	c0077f76-b76a-437e-a030-e6eddad55157
2326	2326	0	National Biodiversity Network	d897a5b9-35ee-4232-94bd-b0bcaac003c2	c0b42347-f97d-407b-8d68-038f1664c8a1
60	60	0	GBIF France	da44cd31-5901-4687-a106-6d1c7734ee3a	c17a5c51-dc4b-4ba7-b249-3c58e9e5df8e
3652	2280	-1372	Biodiversity Information System of Mexico	b324e8e9-9a4c-44fa-8f1a-7f39ea7ab576	c39c4f05-412f-4c0f-86f3-2fc1df00988f
10	10	0	Plazi	ffb07bec-2d10-492d-9c37-361fe0b79427	c43655c0-bbf6-4c5d-aeb5-cac62ef4ff5e
0	29260	29260	GBIF Norway	4f829580-180d-46a9-9c87-ed8ec959b545	c6f8c4f2-31aa-4ea8-9668-985e40496698
198230	198230	0	National Biodiversity Network	d897a5b9-35ee-4232-94bd-b0bcaac003c2	c71f0638-584d-4cae-87f7-a8d2e3d99fca
0	165	165	Plazi	ffb07bec-2d10-492d-9c37-361fe0b79427	c7ac2c61-e8c5-483c-83ae-8af28635f4ac
970067	1036383	66316	U.S. Geological Survey	8618c64a-93e0-4300-b546-7249e5148ed2	c8d12f8a-7e39-4e2c-92d7-825d590ad15b
0	68	68	Colombian Biodiversity Information System	7e865cba-7c46-417b-ade5-97f2cf5b7be0	c9287046-fe89-4e91-a8c5-536f36e1d3c6
0	2	2	Participant Node Managers Committee	7f48e0c8-5c96-49ec-b972-30748e339115	cb1be4d6-c06d-4f48-b632-2ffc3226b955
83	83	0	Plazi	ffb07bec-2d10-492d-9c37-361fe0b79427	cdd567ed-ebd8-4801-a6a4-af6c9fb964fd
0	7	7	Plazi	ffb07bec-2d10-492d-9c37-361fe0b79427	ceb677fa-1aec-4d3c-bd12-ad41c762c044
0	1627	1627	U.S. Geological Survey	8618c64a-93e0-4300-b546-7249e5148ed2	cf6a5ca0-c9ca-4d99-85df-598bc118226d
20375	20375	0	GBIF France	da44cd31-5901-4687-a106-6d1c7734ee3a	d0e4fd1c-171e-4e75-a539-324bfbd82ec0
0	11	11	Ocean Biodiversity Information System	ba0670b9-4186-41e6-8e70-f9cb3065551a	d3061efd-17f0-4eab-9580-e01f9d7d93b4
724	724	0	National Biodiversity Network	d897a5b9-35ee-4232-94bd-b0bcaac003c2	d59a5dc3-9944-4f1e-9069-64353d706ba5
0	607	607	Ocean Biodiversity Information System	ba0670b9-4186-41e6-8e70-f9cb3065551a	d5f4d94b-f274-46fd-8236-6f83cf7f6016
63	63	0	GBIF France	da44cd31-5901-4687-a106-6d1c7734ee3a	d7d8f639-5435-4890-a2c2-d90bc950ee2a
25794	25794	0	GBIF France	da44cd31-5901-4687-a106-6d1c7734ee3a	d8ad40fb-908b-462c-a21c-88fecad83389
0	36	36	Plazi	ffb07bec-2d10-492d-9c37-361fe0b79427	d8c11bac-08ff-4b29-8ffc-81e6fd471afb
0	995	995	Ocean Biodiversity Information System	ba0670b9-4186-41e6-8e70-f9cb3065551a	dcb8bc54-8caf-4442-a1f9-b7d71af4bfae
0	4707	4707	National Biodiversity Network	d897a5b9-35ee-4232-94bd-b0bcaac003c2	e0074b38-e321-4ea9-844f-73a14a753283
2659	2659	0	Belgian Biodiversity Platform	fb11cfe1-ebc3-45af-9159-17d9fddbcdac	e1e5921c-5d04-4015-9943-137790fc3bc0
379	379	0	GBIF Malawi	2a42e4d7-ad4a-41b3-84c4-de4aa7b74d35	e27843f7-0ba7-4730-a70e-293b9bb84e17
2	2	0	Plazi	ffb07bec-2d10-492d-9c37-361fe0b79427	e30f7fa7-414f-45e4-8478-9f0a64a1b405
11	11	0	Plazi	ffb07bec-2d10-492d-9c37-361fe0b79427	e3a07839-6f1e-45e4-a5b8-e1342d18cedf
31	31	0	GBIF Germany	4f6826f2-4ff6-443d-b966-e6913bd24013	e531ffea-75e1-480d-a3c7-d25110559a84
0	76	76	Ocean Biodiversity Information System	ba0670b9-4186-41e6-8e70-f9cb3065551a	e75cd3e3-bc2f-46e7-9dc7-85274b3a39eb
1	1	0	Plazi	ffb07bec-2d10-492d-9c37-361fe0b79427	e9d0cf7c-5b10-45ba-bee8-65c72f631afb
1	1	0	Plazi	ffb07bec-2d10-492d-9c37-361fe0b79427	ea64fb7a-708f-477d-9e46-e426a0c906b3
11	11	0	Plazi	ffb07bec-2d10-492d-9c37-361fe0b79427	ea9c1db3-0c63-4178-938d-2beae7cf3864
691	691	0	National Biodiversity Network	d897a5b9-35ee-4232-94bd-b0bcaac003c2	eaee9bce-dc55-4c89-b092-1ce88923b6fc
98	98	0	Plazi	ffb07bec-2d10-492d-9c37-361fe0b79427	eb57c406-2497-4874-973d-fadf11c1e9ba
35	35	0	Plazi	ffb07bec-2d10-492d-9c37-361fe0b79427	ed1d7758-f2a5-4ad9-87ec-a91337a88c98
0	23	23	Plazi	ffb07bec-2d10-492d-9c37-361fe0b79427	eddc86e0-1454-4b55-85ba-108dbfa056de
0	2	2	Plazi	ffb07bec-2d10-492d-9c37-361fe0b79427	ef3377e1-d4c8-4285-acfd-48ca23a902e0
0	4	4	Plazi	ffb07bec-2d10-492d-9c37-361fe0b79427	ef5b919c-7c0a-491c-92ec-0ca8d09d830b
0	19	19	Plazi	ffb07bec-2d10-492d-9c37-361fe0b79427	f05bc4e8-863b-496a-9453-e56a67576ba3
30	30	0	GBIF Germany	4f6826f2-4ff6-443d-b966-e6913bd24013	f1211821-5fa1-4e4e-850c-367360fd0b78
1076	1076	0	Colombian Biodiversity Information System	7e865cba-7c46-417b-ade5-97f2cf5b7be0	f17944d0-0ea4-4106-aee7-d9860892e3a2
8976	8976	0	U.S. Geological Survey	8618c64a-93e0-4300-b546-7249e5148ed2	f8e14cc1-cd02-4882-87f7-c5744714b962
0	7	7	Plazi	ffb07bec-2d10-492d-9c37-361fe0b79427	fb07eab9-4a13-4540-b534-824d47cdd7a8
11	11	0	Plazi	ffb07bec-2d10-492d-9c37-361fe0b79427	fc802397-f995-4145-93d7-fee098887602
15515	15515	0	GBIF France	da44cd31-5901-4687-a106-6d1c7734ee3a	fca6b467-9d35-493a-9a43-56b096814536
16	16	0	Plazi	ffb07bec-2d10-492d-9c37-361fe0b79427	fd568ba9-4fd4-4f51-9a5f-42061140c137
1	1	0	Plazi	ffb07bec-2d10-492d-9c37-361fe0b79427	033201e5-e78f-475b-a631-cc84a41cdcee
215	215	0	National Biodiversity Network	d897a5b9-35ee-4232-94bd-b0bcaac003c2	03a82ae6-9680-48d8-92c4-2edb51c8248c
1	1	0	GBIF France	da44cd31-5901-4687-a106-6d1c7734ee3a	047bc1cc-9d80-4a17-a5a6-abe676ae50e4
225	225	0	GBIF Guinea	b1cd2e84-c4ba-47bd-b72a-dfd1f92dce0a	04a90778-3508-4c71-a293-defc4d633e74
7368	7398	30	U.S. Geological Survey	8618c64a-93e0-4300-b546-7249e5148ed2	04daaaf2-0d57-414d-8656-28c0137b638a
15	15	0	Plazi	ffb07bec-2d10-492d-9c37-361fe0b79427	0566a11e-d6a3-4283-89c7-c7feea96fdbf
0	1527	1527	Ocean Biodiversity Information System	ba0670b9-4186-41e6-8e70-f9cb3065551a	0649104b-c7d5-4bfc-8804-5d7b8e25be37
5069	5069	0	Biodiversity Information System of Mexico	b324e8e9-9a4c-44fa-8f1a-7f39ea7ab576	06c2da70-2196-4a80-ae2c-436243645ced
184941	184941	0	GBIF France	da44cd31-5901-4687-a106-6d1c7734ee3a	0797c245-3f7f-42db-b822-550a36b2a922
0	72	72	Colombian Biodiversity Information System	7e865cba-7c46-417b-ade5-97f2cf5b7be0	0916db31-9b9a-4722-ae81-a5edaa309a3b
1	1	0	Plazi	ffb07bec-2d10-492d-9c37-361fe0b79427	09298009-5dd4-4966-b880-14736c18e5f4
3	3	0	Plazi	ffb07bec-2d10-492d-9c37-361fe0b79427	0a955b0b-5832-4c6d-87c3-b71ed8d1e8cc
8	8	0	Plazi	ffb07bec-2d10-492d-9c37-361fe0b79427	0ba05318-1eec-44bc-8017-b6e2789b4811
249	249	0	GBIF New Zealand	4f9fd726-20dd-445e-89a1-8ed93792276f	0d862dd2-12af-4445-92c9-d81d76598b19
486	486	0	Colombian Biodiversity Information System	7e865cba-7c46-417b-ade5-97f2cf5b7be0	0e240ab8-9620-4be8-b489-7c4adc78f8a4
0	19	19	Plazi	ffb07bec-2d10-492d-9c37-361fe0b79427	0eff1796-ad42-48d3-b0da-b0d02c554f09
449	449	0	Colombian Biodiversity Information System	7e865cba-7c46-417b-ade5-97f2cf5b7be0	11b7aae0-6cf5-4531-a215-2d0c8de726a9
92	92	0	GBIF Germany	4f6826f2-4ff6-443d-b966-e6913bd24013	11d064cb-5e22-4d4b-82b4-5759ee98a3f1
50	50	0	Plazi	ffb07bec-2d10-492d-9c37-361fe0b79427	17c1467e-126a-47e1-93af-a9f192d1928f
3287	3287	0	Colombian Biodiversity Information System	7e865cba-7c46-417b-ade5-97f2cf5b7be0	1beb7859-5eba-42a3-8aec-843e63d16185
0	10000	10000	GBIF Japan	db5705aa-6a6e-42f1-8942-d77b9f4896ea	1cbed1d0-f9ac-4b9e-bf3f-a26272bca39e
0	9972	9972	Participant Node Managers Committee	7f48e0c8-5c96-49ec-b972-30748e339115	1e7b25d0-ec44-4fa8-8338-6e38e7a11214
13	13	0	Plazi	ffb07bec-2d10-492d-9c37-361fe0b79427	1fb4f153-ffd3-4a35-8c38-928fd9908878
4	4	0	Plazi	ffb07bec-2d10-492d-9c37-361fe0b79427	22249957-a026-4e29-8a3d-cb31812ed2a8
2	2	0	Plazi	ffb07bec-2d10-492d-9c37-361fe0b79427	23dede93-1d5f-4a8f-b0bc-788314b1276b
0	438	438	Plazi	ffb07bec-2d10-492d-9c37-361fe0b79427	24613fca-e696-4d64-aa28-68862191fa60
0	1	1	Ocean Biodiversity Information System	ba0670b9-4186-41e6-8e70-f9cb3065551a	25da6d17-16b7-42d8-974c-dcae5cf038b1
51	51	0	Biodiversity Information System of Mexico	b324e8e9-9a4c-44fa-8f1a-7f39ea7ab576	25fc070d-7699-459b-b9c3-f106633a71eb
3	3	0	Plazi	ffb07bec-2d10-492d-9c37-361fe0b79427	27637276-6ce8-4b6c-8688-36d04bb47616
3	3	0	Plazi	ffb07bec-2d10-492d-9c37-361fe0b79427	27bc3ce6-b070-40ca-a349-0e5d57558f40
1757	1757	0	GBIF Chile	a8b16421-d80b-4ef3-8f22-098b01a89255	291a9c9c-2b4b-4593-ae88-7b17c5e41592
57	57	0	Plazi	ffb07bec-2d10-492d-9c37-361fe0b79427	2a157755-470d-47e1-bc4e-43727dd77748
2	2	0	Plazi	ffb07bec-2d10-492d-9c37-361fe0b79427	2dff18aa-d8a9-4a8f-96ae-aebcead2a535
4524	4524	0	Colombian Biodiversity Information System	7e865cba-7c46-417b-ade5-97f2cf5b7be0	2e6917b2-44b4-4af7-94ce-47ac40677784
0	19	19	Plazi	ffb07bec-2d10-492d-9c37-361fe0b79427	2e99c4c0-2bbf-4f72-8eea-3b7ca008bc62
4	4	0	Plazi	ffb07bec-2d10-492d-9c37-361fe0b79427	2ec81c3c-e799-4c40-87ae-e62e7d91e292
19153	19153	0	Colombian Biodiversity Information System	7e865cba-7c46-417b-ade5-97f2cf5b7be0	2f7208c8-b31d-4287-84b4-fc10ab376302
0	12017	12017	Participant Node Managers Committee	7f48e0c8-5c96-49ec-b972-30748e339115	32644372-48da-4b95-b0dc-d0c5961610c9
310	310	0	Colombian Biodiversity Information System	7e865cba-7c46-417b-ade5-97f2cf5b7be0	343ab865-2c0a-4a49-b774-3c0334a4f261
0	1100	1100	Netherlands Biodiversity Information Facility	0909d601-bda2-42df-9e63-a6d51847ebce	34b382fc-8add-4565-965e-ca707d6fe48c
2	2	0	Plazi	ffb07bec-2d10-492d-9c37-361fe0b79427	3e56984a-c342-4053-ba1d-4902e47a6f4f
5	5	0	Plazi	ffb07bec-2d10-492d-9c37-361fe0b79427	3f8abc0d-c427-4d47-94d5-0ecd66ae8e5e
1	1	0	Plazi	ffb07bec-2d10-492d-9c37-361fe0b79427	3fe5346f-06e3-4c2c-b3da-3998dded7962
2	2	0	Plazi	ffb07bec-2d10-492d-9c37-361fe0b79427	40bba96c-8fe7-42b5-b37c-f19e79f28819
48	48	0	Participant Node Managers Committee	7f48e0c8-5c96-49ec-b972-30748e339115	43bb68e1-a118-4b97-ae1c-28965f45cb54
4174	4174	0	Tanzania Biodiversity Information Facility	abd95ca6-3959-4db9-aaa6-2de1aeecf514	4405aa78-0622-4f21-a37c-75a0dbe7ca7b
3808	3808	0	GBIF France	da44cd31-5901-4687-a106-6d1c7734ee3a	45043b88-1ebd-4d62-9fd9-61c808edc832
40	40	0	Plazi	ffb07bec-2d10-492d-9c37-361fe0b79427	45ce91e2-3e09-4ff1-a1bf-f3ca8f1f592c
0	4	4	Plazi	ffb07bec-2d10-492d-9c37-361fe0b79427	46f6eaae-3910-4e4b-95f0-4f86b69662d8
18	18	0	Plazi	ffb07bec-2d10-492d-9c37-361fe0b79427	473e530c-0d8d-48d0-ba64-67c50157c188
6	6	0	Plazi	ffb07bec-2d10-492d-9c37-361fe0b79427	482193ad-9476-4aa0-bd03-1001e6156506
5	5	0	Plazi	ffb07bec-2d10-492d-9c37-361fe0b79427	483ae67b-5782-498a-baad-479157bed37e
0	18	18	Plazi	ffb07bec-2d10-492d-9c37-361fe0b79427	485e61f0-1275-4b5f-9d88-0a11d60e02e6
1	1	0	Plazi	ffb07bec-2d10-492d-9c37-361fe0b79427	4a075e63-72d6-4ad7-8c96-9643507f1325
6	6	0	Plazi	ffb07bec-2d10-492d-9c37-361fe0b79427	4b530f65-124b-4cf8-a190-dd1690f1aab9
30	30	0	Ocean Biodiversity Information System	ba0670b9-4186-41e6-8e70-f9cb3065551a	4bac4236-64a0-4aa9-b7c9-9b1658ffaa84
1	1	0	Plazi	ffb07bec-2d10-492d-9c37-361fe0b79427	4f0f7a06-546d-4247-b1e1-8112510611b5
71	1667	1596	GBIF Germany	4f6826f2-4ff6-443d-b966-e6913bd24013	55334f5b-39bb-46d5-80f3-f8d74190a953
0	84573	84573	Participant Node Managers Committee	7f48e0c8-5c96-49ec-b972-30748e339115	5b4ba541-ad87-4d28-b8ca-a803335fd49d
1186	1186	0	Plazi	ffb07bec-2d10-492d-9c37-361fe0b79427	607932e4-c3eb-42a7-ae75-a68dbcd4064a
0	124	124	Plazi	ffb07bec-2d10-492d-9c37-361fe0b79427	60d937e4-d9be-45e7-a532-afd33e2c5283
2	2	0	Plazi	ffb07bec-2d10-492d-9c37-361fe0b79427	61350670-7b6a-4bb2-bac9-d0ad945e5549
4849	4849	0	National Biodiversity Network	d897a5b9-35ee-4232-94bd-b0bcaac003c2	62f14a7b-2e5a-4932-aec8-405b7b41fe71
97	97	0	GBIF Germany	4f6826f2-4ff6-443d-b966-e6913bd24013	63c11f9c-f762-11e1-a439-00145eb45e9a
277	277	0	GBIF Germany	4f6826f2-4ff6-443d-b966-e6913bd24013	63fce98c-f762-11e1-a439-00145eb45e9a
38998	38998	0	National Biodiversity Network	d897a5b9-35ee-4232-94bd-b0bcaac003c2	6647ca7e-cf35-4eb1-8b0c-b8756a1ba6bd
74	74	0	GBIF Germany	4f6826f2-4ff6-443d-b966-e6913bd24013	66b26508-f762-11e1-a439-00145eb45e9a
12815	13552	737	Netherlands Biodiversity Information Facility	0909d601-bda2-42df-9e63-a6d51847ebce	66e240a7-ae35-4f59-9ad9-c62687015ed8
0	8	8	Plazi	ffb07bec-2d10-492d-9c37-361fe0b79427	679da4a9-a1a5-4095-95b7-d216d744334c
1	1	0	Plazi	ffb07bec-2d10-492d-9c37-361fe0b79427	6ad5b42c-2c29-49d7-bb7d-06813f9b883e
3	3	0	Plazi	ffb07bec-2d10-492d-9c37-361fe0b79427	6ba5edc7-407c-41e6-81ca-bff60e226cb8
20	20	0	GBIF Germany	4f6826f2-4ff6-443d-b966-e6913bd24013	6bbde130-f762-11e1-a439-00145eb45e9a
92	92	0	Plazi	ffb07bec-2d10-492d-9c37-361fe0b79427	6cea38d1-7168-4640-847a-448478a342bd
0	2	2	Ocean Biodiversity Information System	ba0670b9-4186-41e6-8e70-f9cb3065551a	702f753f-dd2f-44d5-bdb6-e66ce954333d
61	61	0	GBIF Germany	4f6826f2-4ff6-443d-b966-e6913bd24013	72388aa6-f762-11e1-a439-00145eb45e9a
1	1	0	Plazi	ffb07bec-2d10-492d-9c37-361fe0b79427	7241cccf-a1ad-4a08-acb6-cff27cb2b883
3	3	0	Plazi	ffb07bec-2d10-492d-9c37-361fe0b79427	733f891c-36a4-4be1-9d7f-b1fd1e7378b5
19	19	0	GBIF Germany	4f6826f2-4ff6-443d-b966-e6913bd24013	754ee5dc-f762-11e1-a439-00145eb45e9a
11	11	0	GBIF Germany	4f6826f2-4ff6-443d-b966-e6913bd24013	75dca03e-f762-11e1-a439-00145eb45e9a
17	17	0	GBIF Argentina	2426a871-9feb-40a1-96c6-0c593a76b835	7839575a-84e3-43f5-ade3-4c7ebfd2c846
17	17	0	GBIF Germany	4f6826f2-4ff6-443d-b966-e6913bd24013	78b069bc-f762-11e1-a439-00145eb45e9a
24	12	-12	GBIF Germany	4f6826f2-4ff6-443d-b966-e6913bd24013	794e0082-f762-11e1-a439-00145eb45e9a
22	22	0	GBIF Germany	4f6826f2-4ff6-443d-b966-e6913bd24013	7a71dbbe-f762-11e1-a439-00145eb45e9a
6	6	0	GBIF Germany	4f6826f2-4ff6-443d-b966-e6913bd24013	7b7f1300-f762-11e1-a439-00145eb45e9a
123	123	0	GBIF Germany	4f6826f2-4ff6-443d-b966-e6913bd24013	7b8708c6-f762-11e1-a439-00145eb45e9a
523	523	0	Colombian Biodiversity Information System	7e865cba-7c46-417b-ade5-97f2cf5b7be0	7b8bb6b4-b245-4079-ad21-89d5e9d4aa0f
120	108	-12	GBIF Germany	4f6826f2-4ff6-443d-b966-e6913bd24013	7bfe8428-f762-11e1-a439-00145eb45e9a
748	636	-112	GBIF Germany	4f6826f2-4ff6-443d-b966-e6913bd24013	7c6a6094-f762-11e1-a439-00145eb45e9a
82	82	0	GBIF Germany	4f6826f2-4ff6-443d-b966-e6913bd24013	7d37a6da-f762-11e1-a439-00145eb45e9a
0	299179	299179	Netherlands Biodiversity Information Facility	0909d601-bda2-42df-9e63-a6d51847ebce	7d75109d-a6cb-4e90-89d0-79d08577c580
11	11	0	Plazi	ffb07bec-2d10-492d-9c37-361fe0b79427	7f1c7500-472a-4211-beaf-3277b400f99f
0	2	2	Plazi	ffb07bec-2d10-492d-9c37-361fe0b79427	7fbb065d-e2c2-48d4-bcb2-1e6ac6f1edce
16396	16386	-10	Biodiversity Information System of Mexico	b324e8e9-9a4c-44fa-8f1a-7f39ea7ab576	7fddb564-f762-11e1-a439-00145eb45e9a
20945	124405	103460	GBIF Spain	1f94b3ca-9345-4d65-afe2-4bace93aa0fe	834f1756-f762-11e1-a439-00145eb45e9a
67	67	0	U.S. Geological Survey	8618c64a-93e0-4300-b546-7249e5148ed2	851e2ebe-f762-11e1-a439-00145eb45e9a
405	405	0	National Biodiversity Network	d897a5b9-35ee-4232-94bd-b0bcaac003c2	871892af-36d7-42ad-9dd3-e830d9b29dbc
371	371	0	GBIF Germany	4f6826f2-4ff6-443d-b966-e6913bd24013	8748370c-f762-11e1-a439-00145eb45e9a
93	57	-36	GBIF Germany	4f6826f2-4ff6-443d-b966-e6913bd24013	87fc7ff0-f762-11e1-a439-00145eb45e9a
10	10	0	GBIF Germany	4f6826f2-4ff6-443d-b966-e6913bd24013	88097bb0-f762-11e1-a439-00145eb45e9a
252	200	-52	GBIF Germany	4f6826f2-4ff6-443d-b966-e6913bd24013	8812ad66-f762-11e1-a439-00145eb45e9a
449	354	-95	GBIF Germany	4f6826f2-4ff6-443d-b966-e6913bd24013	884ae38e-f762-11e1-a439-00145eb45e9a
1	1	0	Plazi	ffb07bec-2d10-492d-9c37-361fe0b79427	88e01b2e-0a8e-45a8-b38d-7a6bd3a28251
0	24	24	Plazi	ffb07bec-2d10-492d-9c37-361fe0b79427	8a8c811f-09f8-4f22-a0b5-ce7aa5525f37
19	19	0	GBIF Germany	4f6826f2-4ff6-443d-b966-e6913bd24013	8b1d57cc-f762-11e1-a439-00145eb45e9a
6	6	0	GBIF Germany	4f6826f2-4ff6-443d-b966-e6913bd24013	8cb8e164-f762-11e1-a439-00145eb45e9a
5	2	-3	GBIF Germany	4f6826f2-4ff6-443d-b966-e6913bd24013	8cd97438-f762-11e1-a439-00145eb45e9a
221	221	0	Atlas of Living Australia	4a6f1b71-969e-4fc5-a693-282b05e1220c	8cf29185-bc61-4d54-980f-407cf8bea5c2
71	71	0	Plazi	ffb07bec-2d10-492d-9c37-361fe0b79427	8d4d91e2-7ba2-41dd-a5d3-47a50b82837c
5	4	-1	GBIF Germany	4f6826f2-4ff6-443d-b966-e6913bd24013	8d5d7f26-f762-11e1-a439-00145eb45e9a
4663	2139	-2524	GBIF Germany	4f6826f2-4ff6-443d-b966-e6913bd24013	8ded9854-f762-11e1-a439-00145eb45e9a
968	666	-302	GBIF Germany	4f6826f2-4ff6-443d-b966-e6913bd24013	8e8fcc3c-f762-11e1-a439-00145eb45e9a
577	424	-153	GBIF Germany	4f6826f2-4ff6-443d-b966-e6913bd24013	8f306b2e-f762-11e1-a439-00145eb45e9a
5258	5258	0	Biodiversity Information System of Mexico	b324e8e9-9a4c-44fa-8f1a-7f39ea7ab576	91c888e7-3fac-4d2b-9c24-3b3d2687bfa5
1001	1001	0	GBIF Germany	4f6826f2-4ff6-443d-b966-e6913bd24013	91db9c68-f762-11e1-a439-00145eb45e9a
1741	1741	0	GBIF Germany	4f6826f2-4ff6-443d-b966-e6913bd24013	91fd9354-f762-11e1-a439-00145eb45e9a
38	38	0	Atlas of Living Australia	4a6f1b71-969e-4fc5-a693-282b05e1220c	93788243-3b92-47f5-8658-d04868b5b00e
19324	19728	404	National Biodiversity Network	d897a5b9-35ee-4232-94bd-b0bcaac003c2	94c74198-9eaf-4b43-a349-0b566dcd648a
42	43	1	GBIF Germany	4f6826f2-4ff6-443d-b966-e6913bd24013	94f842d4-f762-11e1-a439-00145eb45e9a
27	27	0	GBIF Germany	4f6826f2-4ff6-443d-b966-e6913bd24013	95a4ca54-f762-11e1-a439-00145eb45e9a
5056	5056	0	Atlas of Living Australia	4a6f1b71-969e-4fc5-a693-282b05e1220c	964f1f04-f762-11e1-a439-00145eb45e9a
213	213	0	Biodiversity Information System of Mexico	b324e8e9-9a4c-44fa-8f1a-7f39ea7ab576	96ab697f-6031-4e22-bb7a-964ac91914ff
1	1	0	Colombian Biodiversity Information System	7e865cba-7c46-417b-ade5-97f2cf5b7be0	97a04187-4dd3-478d-97ec-953300fa1161
98	98	0	Atlas of Living Australia	4a6f1b71-969e-4fc5-a693-282b05e1220c	9824fc39-2ab3-44b8-b4a8-530e18c01db4
42	42	0	Plazi	ffb07bec-2d10-492d-9c37-361fe0b79427	9b0003a0-e8c3-4b11-b1e0-06612e1e0307
162	162	0	GBIF France	da44cd31-5901-4687-a106-6d1c7734ee3a	9b9deb68-e4e2-40d1-9898-0a1db8e4e47f
518	518	0	Plazi	ffb07bec-2d10-492d-9c37-361fe0b79427	a0bbe9e3-8fd9-4764-82a7-fe129aa3c095
15035	15035	0	GBIF France	da44cd31-5901-4687-a106-6d1c7734ee3a	a1d21898-1f56-4e38-8f71-e2b821187790
0	75	75	Colombian Biodiversity Information System	7e865cba-7c46-417b-ade5-97f2cf5b7be0	a791fc18-4662-47f0-befb-054b40a9ea4b
11	11	0	Plazi	ffb07bec-2d10-492d-9c37-361fe0b79427	a8295b09-28eb-4dc9-a662-01366ae5b9e8
18	18	0	Participant Node Managers Committee	7f48e0c8-5c96-49ec-b972-30748e339115	ac84d475-b474-459f-ba70-ab004a6eaa6e
2	2	0	Plazi	ffb07bec-2d10-492d-9c37-361fe0b79427	ac8de351-7c23-4c56-8e74-5714c75c2522
88	88	0	Plazi	ffb07bec-2d10-492d-9c37-361fe0b79427	ac9cc78c-c2cd-453f-8715-8f38648de567
113	113	0	GBIF France	da44cd31-5901-4687-a106-6d1c7734ee3a	ad12b74f-8856-4dee-9525-bf1423f9edf3
6	6	0	Plazi	ffb07bec-2d10-492d-9c37-361fe0b79427	ae9a0ea1-86c5-4565-99d6-e074236b5bc8
2	2	0	Plazi	ffb07bec-2d10-492d-9c37-361fe0b79427	af2e56b9-7755-4f2f-9988-20c5041d5a98
1728	856	-872	Biodiversity Information System of Mexico	b324e8e9-9a4c-44fa-8f1a-7f39ea7ab576	afa36eb1-34d3-4acf-bf5b-ace515ea0f74
0	5	5	Plazi	ffb07bec-2d10-492d-9c37-361fe0b79427	b078aa68-0f0b-40a0-b97c-49da26fad12f
382	382	0	Participant Node Managers Committee	7f48e0c8-5c96-49ec-b972-30748e339115	b0c0fea3-f43e-49b4-93b7-3683143de843
3	3	0	Plazi	ffb07bec-2d10-492d-9c37-361fe0b79427	b57e723e-e081-4ca8-a220-b85188ab36be
4681	4681	0	Atlas of Living Australia	4a6f1b71-969e-4fc5-a693-282b05e1220c	b6162578-e753-40b4-bd69-0658221aee4c
0	316	316	Colombian Biodiversity Information System	7e865cba-7c46-417b-ade5-97f2cf5b7be0	b8e5fa9e-a430-4e44-b39e-90c38ede6167
34	34	0	Plazi	ffb07bec-2d10-492d-9c37-361fe0b79427	c2ee8256-6332-43ee-afa4-cd49bbb5a3f3
7	7	0	Plazi	ffb07bec-2d10-492d-9c37-361fe0b79427	c4c23fc2-2586-49bc-b6ca-5ed8cb867965
4164	4164	0	South African Biodiversity Information Facility	7190b835-4e86-4b6e-85c1-19cc6677c250	c5648934-4ab9-4650-a1d0-8824328132b1
3	3	0	Plazi	ffb07bec-2d10-492d-9c37-361fe0b79427	c5a61dd3-2b32-4805-b3a5-4170e2fdc974
0	24	24	Plazi	ffb07bec-2d10-492d-9c37-361fe0b79427	c78c53c4-7cca-49b2-8818-d14a5392b0fc
10	10	0	Plazi	ffb07bec-2d10-492d-9c37-361fe0b79427	c794700a-60e9-4d5a-b1c2-d484de364e5e
0	2	2	Plazi	ffb07bec-2d10-492d-9c37-361fe0b79427	c80686fc-e984-41fc-879a-8742f61f5918
677113	717836	40723	U.S. Geological Survey	8618c64a-93e0-4300-b546-7249e5148ed2	c8681cc2-9d0a-4c5f-b620-5c753abfe2bc
0	35	35	Plazi	ffb07bec-2d10-492d-9c37-361fe0b79427	cb9ccc99-abbe-4e59-8fa1-db9072a07fc1
2	2	0	Plazi	ffb07bec-2d10-492d-9c37-361fe0b79427	cd140ca4-bbb8-4022-9679-c9439d982bff
5767	5767	0	Participant Node Managers Committee	7f48e0c8-5c96-49ec-b972-30748e339115	ceac3273-94ef-4793-9789-fb8154d43436
0	3	3	Plazi	ffb07bec-2d10-492d-9c37-361fe0b79427	cec45842-65e1-491b-b5db-054def0f46a8
0	21	21	Plazi	ffb07bec-2d10-492d-9c37-361fe0b79427	d14f3ac3-d8da-4173-92aa-3613b1022566
37	37	0	Participant Node Managers Committee	7f48e0c8-5c96-49ec-b972-30748e339115	d27fe7f2-0f22-41cb-95d0-1c0acc58887e
1584	1584	0	GBIF Brazil	cdc9736d-5ff7-4ece-9959-3c744360cdb3	d887b568-22df-44b1-b931-6580f46cfd9e
4709	4709	0	GBIF France	da44cd31-5901-4687-a106-6d1c7734ee3a	d921f444-3029-4ff9-876f-4bd412b1d3e4
52	52	0	Belgian Biodiversity Platform	fb11cfe1-ebc3-45af-9159-17d9fddbcdac	d93a707d-e232-4b46-947b-67fcd4000d86
175	175	0	GBIF France	da44cd31-5901-4687-a106-6d1c7734ee3a	d93eb64d-00b3-4830-8030-5829e1147597
1	1	0	GBIF Finland	dd514216-5c7c-45f3-910d-797424cb5be6	d97804e3-6777-42b8-9389-494e6e4a5572
51903	51903	0	GBIF France	da44cd31-5901-4687-a106-6d1c7734ee3a	d9e6df9f-4d2f-4450-b730-e9070e9fab06
1852	1852	0	GBIF France	da44cd31-5901-4687-a106-6d1c7734ee3a	dd015612-5037-4f57-840e-e7644c0e0248
198	198	0	Plazi	ffb07bec-2d10-492d-9c37-361fe0b79427	dd4e443a-ce3e-4e06-8f3d-7d5bb2548ae9
149	149	0	GBIF France	da44cd31-5901-4687-a106-6d1c7734ee3a	e079b738-03a4-4dd7-b609-9752a0c91f10
4121	4121	0	Belgian Biodiversity Platform	fb11cfe1-ebc3-45af-9159-17d9fddbcdac	e1dcd575-eb28-4df0-b42e-ba5ef433f9f0
243	243	0	Biodiversity Information System of Mexico	b324e8e9-9a4c-44fa-8f1a-7f39ea7ab576	e522ac84-5da1-4c70-b423-437c6dd801a1
9760	9760	0	Canada Biodiversity Information Facility	8f83fc96-c966-4126-83f7-bf044dc49efa	e6acc36b-4149-4458-a26f-17fbeb0df90b
0	103	103	Participant Node Managers Committee	7f48e0c8-5c96-49ec-b972-30748e339115	e96386c0-5f58-4e56-b57e-0ec4947b09db
0	25	25	Plazi	ffb07bec-2d10-492d-9c37-361fe0b79427	e9dd101f-7983-47b9-a633-635b10d56e33
5	5	0	Plazi	ffb07bec-2d10-492d-9c37-361fe0b79427	ebe77389-4375-43aa-8406-3ff94e391b8f
976	976	0	Ocean Biodiversity Information System	ba0670b9-4186-41e6-8e70-f9cb3065551a	ee51f04c-addc-4d04-99a7-61e53fd641ad
26	26	0	Colombian Biodiversity Information System	7e865cba-7c46-417b-ade5-97f2cf5b7be0	ef191765-2e15-42d3-ba84-7e8c7fcf0820
1716	1717	1	Participant Node Managers Committee	7f48e0c8-5c96-49ec-b972-30748e339115	f0b2d5a4-0063-4cdc-8e6c-1df53b51ac0f
0	450	450	Korean Biodiversity Information Facility	e0a1e772-0177-4800-94b4-2d023fe6cdf4	f1b4e02a-86c1-47c1-a24b-6e74fa3d70c2
76	76	0	Plazi	ffb07bec-2d10-492d-9c37-361fe0b79427	f34766b7-ef49-4a2a-8dee-77be61a3aad7
9	9	0	Plazi	ffb07bec-2d10-492d-9c37-361fe0b79427	f4ba36d3-e8ac-4947-a467-5068062fc405
566	566	0	Biodiversity Information System of Mexico	b324e8e9-9a4c-44fa-8f1a-7f39ea7ab576	f4c99a6b-4993-4bfb-acbc-952315842215
28	28	0	Plazi	ffb07bec-2d10-492d-9c37-361fe0b79427	f8eb471f-471a-4b29-8a58-ef3da4eb2c87
246	246	0	GBIF Brazil	cdc9736d-5ff7-4ece-9959-3c744360cdb3	fa016246-9ec9-426f-8f3c-2997c13ce7aa
794	794	0	DanBIF - Danish Biodiversity Information Facility	4ddd294f-02b7-4359-ac33-0806a9ca9c6b	fb375f1e-75fd-4249-9230-3e6489696107
0	5	5	Plazi	ffb07bec-2d10-492d-9c37-361fe0b79427	fd598a1b-4c52-4752-a8ce-f46bc7564f02
554	554	0	GBIF Portugal	673f7038-4262-4149-b753-5658a4e912f6	0120f0b0-46ad-4327-a23e-affcbdb6d575
9	9	0	Participant Node Managers Committee	7f48e0c8-5c96-49ec-b972-30748e339115	02814861-781a-46e7-990c-e35498a3ce44
4092	4092	0	GBIF New Zealand	4f9fd726-20dd-445e-89a1-8ed93792276f	03e5566b-7802-45cc-a1be-bac840e2a133
0	32	32	Ocean Biodiversity Information System	ba0670b9-4186-41e6-8e70-f9cb3065551a	03fdaaf6-227f-4731-9ee4-72ad5b28d80d
5094	5094	0	U.S. Geological Survey	8618c64a-93e0-4300-b546-7249e5148ed2	054ebfc9-d81c-4182-8f65-cda33f4abc96
0	247	247	Ocean Biodiversity Information System	ba0670b9-4186-41e6-8e70-f9cb3065551a	0575e1c5-73ad-4aa5-b6f2-b7ec4dca4dba
457	457	0	GBIF France	da44cd31-5901-4687-a106-6d1c7734ee3a	06767399-de21-42de-90ef-2d29e5e301fb
0	5	5	Plazi	ffb07bec-2d10-492d-9c37-361fe0b79427	067e9fe1-910c-42f8-829f-ded1324ff8b0
150	150	0	Plazi	ffb07bec-2d10-492d-9c37-361fe0b79427	09167b37-7594-4dc3-823b-b8b3104ce31f
135	135	0	Participant Node Managers Committee	7f48e0c8-5c96-49ec-b972-30748e339115	0a600588-7e2c-414a-9e33-69d8f35285c2
0	4	4	Plazi	ffb07bec-2d10-492d-9c37-361fe0b79427	0b63bf08-8d1b-45c3-86c8-b591d108492c
0	150	150	Ocean Biodiversity Information System	ba0670b9-4186-41e6-8e70-f9cb3065551a	0c77e38a-51d5-4db0-ba9f-bfd2c0730d97
0	785	785	Ocean Biodiversity Information System	ba0670b9-4186-41e6-8e70-f9cb3065551a	0c9296fd-48e2-4d98-a297-0b7af006fa31
0	26	26	Plazi	ffb07bec-2d10-492d-9c37-361fe0b79427	0d093a91-ff5f-4b20-b699-ebdabdb104ef
0	17	17	Plazi	ffb07bec-2d10-492d-9c37-361fe0b79427	1240a246-e73d-4763-a1c5-a599d65f428f
0	33	33	Korean Biodiversity Information Facility	e0a1e772-0177-4800-94b4-2d023fe6cdf4	13ad6e77-4d29-42cc-a2fb-b021edf5e450
5621	5621	0	GBIF Benin	efb9c00e-f802-45dd-8826-a52ec45b89ff	1b4f3056-a565-4b7e-abff-a996105000e5
5	5	0	Plazi	ffb07bec-2d10-492d-9c37-361fe0b79427	1f3c8dcd-8af3-4e7e-81f7-f63364d22085
819	819	0	National Biodiversity Network	d897a5b9-35ee-4232-94bd-b0bcaac003c2	21301076-8df7-4c82-b018-b00e4d31200d
0	1037	1037	Plazi	ffb07bec-2d10-492d-9c37-361fe0b79427	2171c1ed-ce68-4577-9dc0-ac4df911dee4
75	75	0	Plazi	ffb07bec-2d10-492d-9c37-361fe0b79427	2a5398e2-e87f-4007-9eeb-bb46d2a5c56a
0	19	19	Plazi	ffb07bec-2d10-492d-9c37-361fe0b79427	2ab49e31-d925-463d-891e-f7061492af8b
23	23	0	Atlas of Living Australia	4a6f1b71-969e-4fc5-a693-282b05e1220c	2c57f133-13e3-4016-ac63-d3f9299da2cc
752	752	0	National Biodiversity Network	d897a5b9-35ee-4232-94bd-b0bcaac003c2	2d7c9b0f-08e4-46fb-a829-4f10eebd987e
0	79	79	Participant Node Managers Committee	7f48e0c8-5c96-49ec-b972-30748e339115	32297ae8-6745-4062-a219-180765595379
77	77	0	GBIF France	da44cd31-5901-4687-a106-6d1c7734ee3a	3233f351-b133-45e2-bfee-0ba982297a00
0	3	3	Plazi	ffb07bec-2d10-492d-9c37-361fe0b79427	32dc2999-ebd8-496d-9c2b-5f0fb6bc8f69
0	50	50	GBIF Japan	db5705aa-6a6e-42f1-8942-d77b9f4896ea	32de56e2-db99-4f9a-bc23-54d629013809
660	660	0	Colombian Biodiversity Information System	7e865cba-7c46-417b-ade5-97f2cf5b7be0	334d4a59-eef7-4a92-8b0b-ea7c19f8f8d1
682	682	0	Atlas of Living Australia	4a6f1b71-969e-4fc5-a693-282b05e1220c	34877684-bbd1-45f2-a205-8f1cc9ad58d7
6949	6949	0	Ocean Biodiversity Information System	ba0670b9-4186-41e6-8e70-f9cb3065551a	36094b2b-bd50-4c6d-af52-264a155fc76f
352	352	0	National Biodiversity Network	d897a5b9-35ee-4232-94bd-b0bcaac003c2	39b8c5d7-8f45-40cb-877b-608693c8b629
3252	3252	0	GBIF Brazil	cdc9736d-5ff7-4ece-9959-3c744360cdb3	39d7aefb-89e9-49f3-bdd8-1a114ace672e
156	156	0	Atlas of Living Australia	4a6f1b71-969e-4fc5-a693-282b05e1220c	4085b735-e486-400f-baaa-4dfcbec0aab3
2579	2579	0	GBIF France	da44cd31-5901-4687-a106-6d1c7734ee3a	42410f5c-2e8e-4cea-8073-39a8d6afad48
0	4	4	Plazi	ffb07bec-2d10-492d-9c37-361fe0b79427	431bd365-be40-4b26-b860-386998126957
0	9165	9165	U.S. Geological Survey	8618c64a-93e0-4300-b546-7249e5148ed2	44262c91-b3fd-48e4-8e47-1ee03ac2d496
22	22	0	National Biodiversity Network	d897a5b9-35ee-4232-94bd-b0bcaac003c2	44e53414-5443-4b98-99ba-740ac6701449
35	35	0	Plazi	ffb07bec-2d10-492d-9c37-361fe0b79427	48a508ae-e2ef-460d-a2e8-ad76b4b5274f
0	11	11	Ocean Biodiversity Information System	ba0670b9-4186-41e6-8e70-f9cb3065551a	491a8670-4d9a-4266-a18c-8102042a1d2a
0	25	25	National Biodiversity Network	d897a5b9-35ee-4232-94bd-b0bcaac003c2	4975ab58-9277-48ff-81f2-f320411bc2a2
2510	2510	0	GBIF Germany	4f6826f2-4ff6-443d-b966-e6913bd24013	49990939-fa06-434c-8927-8490d5678f35
12	12	0	Plazi	ffb07bec-2d10-492d-9c37-361fe0b79427	4d91ee89-0fe3-48fd-a542-1c807f1da7b0
3	3	0	Plazi	ffb07bec-2d10-492d-9c37-361fe0b79427	4de1fb75-1a31-4228-bc0c-6ad2f4b99c45
49	49	0	Colombian Biodiversity Information System	7e865cba-7c46-417b-ade5-97f2cf5b7be0	4ec90048-9a58-4f98-9a67-93a04e6c351a
0	2164	2164	GBIF Japan	db5705aa-6a6e-42f1-8942-d77b9f4896ea	4f97d2a1-be2b-4ef2-8963-afdb937bc8e3
0	30	30	Ocean Biodiversity Information System	ba0670b9-4186-41e6-8e70-f9cb3065551a	5003f7d8-f040-4c2e-ba4c-83e0a4b843cb
0	7	7	Plazi	ffb07bec-2d10-492d-9c37-361fe0b79427	546a0add-f2c5-4906-8023-05962929747b
0	9859	9859	Korean Biodiversity Information Facility	e0a1e772-0177-4800-94b4-2d023fe6cdf4	576bf234-17f2-4360-9946-87ae270f3c83
63	63	0	GBIF France	da44cd31-5901-4687-a106-6d1c7734ee3a	57a75d72-22ff-4991-9714-65c56a0f2e7c
703	703	0	GBIF Germany	4f6826f2-4ff6-443d-b966-e6913bd24013	58ee99d7-68f2-4790-a784-62bf21c590c2
120	120	0	GBIF Germany	4f6826f2-4ff6-443d-b966-e6913bd24013	610d81fa-f762-11e1-a439-00145eb45e9a
62	62	0	GBIF Germany	4f6826f2-4ff6-443d-b966-e6913bd24013	61f7d3ae-f762-11e1-a439-00145eb45e9a
166	166	0	GBIF Germany	4f6826f2-4ff6-443d-b966-e6913bd24013	623ffe40-f762-11e1-a439-00145eb45e9a
113	113	0	GBIF Germany	4f6826f2-4ff6-443d-b966-e6913bd24013	626e6a0a-f762-11e1-a439-00145eb45e9a
14	14	0	GBIF Germany	4f6826f2-4ff6-443d-b966-e6913bd24013	63225312-f762-11e1-a439-00145eb45e9a
66	66	0	GBIF Germany	4f6826f2-4ff6-443d-b966-e6913bd24013	64053560-f762-11e1-a439-00145eb45e9a
13	13	0	GBIF Germany	4f6826f2-4ff6-443d-b966-e6913bd24013	64e7f4b8-f762-11e1-a439-00145eb45e9a
18	18	0	GBIF Germany	4f6826f2-4ff6-443d-b966-e6913bd24013	6672e306-f762-11e1-a439-00145eb45e9a
76	76	0	GBIF Germany	4f6826f2-4ff6-443d-b966-e6913bd24013	66b9e31e-f762-11e1-a439-00145eb45e9a
161	161	0	GBIF Germany	4f6826f2-4ff6-443d-b966-e6913bd24013	6723c6b2-f762-11e1-a439-00145eb45e9a
133	133	0	GBIF Germany	4f6826f2-4ff6-443d-b966-e6913bd24013	674ebb06-f762-11e1-a439-00145eb45e9a
146	146	0	GBIF Germany	4f6826f2-4ff6-443d-b966-e6913bd24013	686f27d2-f762-11e1-a439-00145eb45e9a
25	25	0	GBIF Germany	4f6826f2-4ff6-443d-b966-e6913bd24013	68fc6494-f762-11e1-a439-00145eb45e9a
166	166	0	GBIF Germany	4f6826f2-4ff6-443d-b966-e6913bd24013	6980971e-f762-11e1-a439-00145eb45e9a
427	427	0	GBIF Germany	4f6826f2-4ff6-443d-b966-e6913bd24013	6a0a66ce-f762-11e1-a439-00145eb45e9a
452	427	-25	GBIF Germany	4f6826f2-4ff6-443d-b966-e6913bd24013	6a80c954-f762-11e1-a439-00145eb45e9a
2	2	0	GBIF Germany	4f6826f2-4ff6-443d-b966-e6913bd24013	6aed888c-f762-11e1-a439-00145eb45e9a
12	12	0	Plazi	ffb07bec-2d10-492d-9c37-361fe0b79427	6b3be5ea-c730-4c19-878e-5a447fe03bed
214	214	0	GBIF Germany	4f6826f2-4ff6-443d-b966-e6913bd24013	6c3b7c3a-f762-11e1-a439-00145eb45e9a
1871	1871	0	GBIF France	da44cd31-5901-4687-a106-6d1c7734ee3a	6cdfe092-cd6a-4f80-8d21-523c9f4a75e8
5	5	0	Plazi	ffb07bec-2d10-492d-9c37-361fe0b79427	6cf6162b-e578-4bc8-a519-2e3c9c7cf19c
128089	128087	-2	U.S. Geological Survey	8618c64a-93e0-4300-b546-7249e5148ed2	6d2cfc0a-9903-40b8-802b-403398218e4a
34	34	0	GBIF Germany	4f6826f2-4ff6-443d-b966-e6913bd24013	6d41961e-f762-11e1-a439-00145eb45e9a
96	96	0	GBIF Germany	4f6826f2-4ff6-443d-b966-e6913bd24013	6d533cde-f762-11e1-a439-00145eb45e9a
3024	3024	0	GBIF Germany	4f6826f2-4ff6-443d-b966-e6913bd24013	6e374a64-f762-11e1-a439-00145eb45e9a
8	8	0	GBIF Germany	4f6826f2-4ff6-443d-b966-e6913bd24013	70367165-bf36-4b44-88b7-cd803ea093c7
46	46	0	GBIF Germany	4f6826f2-4ff6-443d-b966-e6913bd24013	70de18c4-f762-11e1-a439-00145eb45e9a
0	28	28	Plazi	ffb07bec-2d10-492d-9c37-361fe0b79427	7105965a-d386-4781-a69d-065979d6b621
15491	16013	522	National Biodiversity Network	d897a5b9-35ee-4232-94bd-b0bcaac003c2	7445a910-faa2-4f43-b650-d2f055bfb0d7
2540	2540	0	Biodiversity Information System of Mexico	b324e8e9-9a4c-44fa-8f1a-7f39ea7ab576	74756cd8-f522-4204-ba2e-f4c659023a08
338	338	0	GBIF Kenya	2a44d626-9f7a-4120-8a7a-4ab5ac15ff2a	74d2f733-66fd-469c-9da0-cea7e5b4a3ac
117	117	0	GBIF Germany	4f6826f2-4ff6-443d-b966-e6913bd24013	750fcb86-f762-11e1-a439-00145eb45e9a
2	2	0	Plazi	ffb07bec-2d10-492d-9c37-361fe0b79427	752b7b58-640a-46bb-bf01-52c5a2539f65
53	53	0	GBIF Germany	4f6826f2-4ff6-443d-b966-e6913bd24013	75519e26-f762-11e1-a439-00145eb45e9a
379	379	0	GBIF Germany	4f6826f2-4ff6-443d-b966-e6913bd24013	759fc1f0-f762-11e1-a439-00145eb45e9a
66	66	0	GBIF Germany	4f6826f2-4ff6-443d-b966-e6913bd24013	7645b4b6-310a-4b4f-aff3-05702231a5a4
1136	1136	0	Atlas of Living Australia	4a6f1b71-969e-4fc5-a693-282b05e1220c	7707d56d-ae12-442a-8481-5e72eec64621
3	3	0	GBIF Germany	4f6826f2-4ff6-443d-b966-e6913bd24013	7881ced6-f762-11e1-a439-00145eb45e9a
0	64	64	Plazi	ffb07bec-2d10-492d-9c37-361fe0b79427	7a1b8415-08c2-4b38-946d-168674ed1854
437	437	0	GBIF Japan	db5705aa-6a6e-42f1-8942-d77b9f4896ea	7ae11cae-f762-11e1-a439-00145eb45e9a
0	56	56	Colombian Biodiversity Information System	7e865cba-7c46-417b-ade5-97f2cf5b7be0	7bf3e38a-8882-4646-8a41-33c3175a1701
32867	32867	0	GBIF France	da44cd31-5901-4687-a106-6d1c7734ee3a	7c411d81-3534-4cc3-8444-885e82ccdfa3
539	539	0	GBIF Germany	4f6826f2-4ff6-443d-b966-e6913bd24013	7c5b3a38-f762-11e1-a439-00145eb45e9a
300	300	0	GBIF Germany	4f6826f2-4ff6-443d-b966-e6913bd24013	7cb99010-f762-11e1-a439-00145eb45e9a
10389	10389	0	National Biodiversity Network	d897a5b9-35ee-4232-94bd-b0bcaac003c2	7d0b6ec7-e2af-40f3-980f-6a6c68bc7573
17	17	0	GBIF Germany	4f6826f2-4ff6-443d-b966-e6913bd24013	7d40e254-f762-11e1-a439-00145eb45e9a
240	200	-40	GBIF Germany	4f6826f2-4ff6-443d-b966-e6913bd24013	7d591090-f762-11e1-a439-00145eb45e9a
180	180	0	GBIF Germany	4f6826f2-4ff6-443d-b966-e6913bd24013	7dd64da8-f762-11e1-a439-00145eb45e9a
0	89	89	Ocean Biodiversity Information System	ba0670b9-4186-41e6-8e70-f9cb3065551a	7defa0e3-67db-420b-8ef6-e1d25b460750
1	1	0	Plazi	ffb07bec-2d10-492d-9c37-361fe0b79427	7df393d6-691e-4b9a-9cb6-fd28189409ba
12	12	0	GBIF France	da44cd31-5901-4687-a106-6d1c7734ee3a	7e3d3488-8380-41c8-a6aa-b60b8da8c86d
6322	6333	11	GBIF Germany	4f6826f2-4ff6-443d-b966-e6913bd24013	7ef15372-1387-11e2-bb2e-00145eb45e9a
20	20	0	Plazi	ffb07bec-2d10-492d-9c37-361fe0b79427	7f59b45c-7221-470f-9efa-50a5c813cd4e
174	174	0	GBIF Germany	4f6826f2-4ff6-443d-b966-e6913bd24013	81965da2-f762-11e1-a439-00145eb45e9a
296	296	0	GBIF Germany	4f6826f2-4ff6-443d-b966-e6913bd24013	81c2b870-f762-11e1-a439-00145eb45e9a
105	93	-12	GBIF Germany	4f6826f2-4ff6-443d-b966-e6913bd24013	81d8ffcc-f762-11e1-a439-00145eb45e9a
0	10	10	Plazi	ffb07bec-2d10-492d-9c37-361fe0b79427	82a57aa0-f648-4dc8-93ab-3384e396afa1
0	4	4	Plazi	ffb07bec-2d10-492d-9c37-361fe0b79427	8578b356-6535-4e76-adf7-153f49c0617d
33	33	0	National Biodiversity Network	d897a5b9-35ee-4232-94bd-b0bcaac003c2	8620ab7c-23a6-4a56-b0ef-1f7a487f1dae
3	3	0	GBIF Germany	4f6826f2-4ff6-443d-b966-e6913bd24013	87009668-c14f-448e-9833-76c5240eeed0
18501	18501	0	National Biodiversity Network	d897a5b9-35ee-4232-94bd-b0bcaac003c2	88159c93-b888-46df-9b97-a3f96c73b75f
184	144	-40	GBIF Germany	4f6826f2-4ff6-443d-b966-e6913bd24013	881818d2-f762-11e1-a439-00145eb45e9a
17	17	0	Plazi	ffb07bec-2d10-492d-9c37-361fe0b79427	882f5e2c-f717-486b-85b3-80679ce2ee73
570	570	0	Biodiversity Information System of Mexico	b324e8e9-9a4c-44fa-8f1a-7f39ea7ab576	88f2cdff-323a-43f2-9c75-3bae018baa5d
266	266	0	GBIF France	da44cd31-5901-4687-a106-6d1c7734ee3a	89a795c6-374b-411a-be0a-f340a0a9f753
96	96	0	GBIF Germany	4f6826f2-4ff6-443d-b966-e6913bd24013	8a301aca-f762-11e1-a439-00145eb45e9a
10	10	0	GBIF Germany	4f6826f2-4ff6-443d-b966-e6913bd24013	8c13c6de-f762-11e1-a439-00145eb45e9a
1	1	0	GBIF Germany	4f6826f2-4ff6-443d-b966-e6913bd24013	8ce71200-f762-11e1-a439-00145eb45e9a
38	24	-14	GBIF Germany	4f6826f2-4ff6-443d-b966-e6913bd24013	8cf8d8dc-f762-11e1-a439-00145eb45e9a
23	18	-5	GBIF Germany	4f6826f2-4ff6-443d-b966-e6913bd24013	8d07f074-f762-11e1-a439-00145eb45e9a
160	107	-53	GBIF Germany	4f6826f2-4ff6-443d-b966-e6913bd24013	8e8babb6-f762-11e1-a439-00145eb45e9a
13	12	-1	GBIF Germany	4f6826f2-4ff6-443d-b966-e6913bd24013	9164b6de-f762-11e1-a439-00145eb45e9a
32	32	0	Plazi	ffb07bec-2d10-492d-9c37-361fe0b79427	92833ad4-74ab-4f1c-a7ad-967a0e556ecd
1469	1469	0	GBIF Germany	4f6826f2-4ff6-443d-b966-e6913bd24013	9432d3d2-f762-11e1-a439-00145eb45e9a
14381	14381	0	Colombian Biodiversity Information System	7e865cba-7c46-417b-ade5-97f2cf5b7be0	94dce9c1-e2f0-45cb-a77b-8e5caa871a41
0	3	3	Plazi	ffb07bec-2d10-492d-9c37-361fe0b79427	94eb1c38-5132-4fae-aedb-c0e4b81595ae
521	521	0	GBIF Germany	4f6826f2-4ff6-443d-b966-e6913bd24013	95104a00-f762-11e1-a439-00145eb45e9a
251	251	0	GBIF Germany	4f6826f2-4ff6-443d-b966-e6913bd24013	96247dd1-7a4c-48de-8f3e-c751e2bd0710
55	55	0	GBIF Kenya	2a44d626-9f7a-4120-8a7a-4ab5ac15ff2a	969455e4-44ae-46d1-869a-2a75890236e7
57145	57145	0	U.S. Geological Survey	8618c64a-93e0-4300-b546-7249e5148ed2	96c25708-f762-11e1-a439-00145eb45e9a
551	551	0	GBIF Germany	4f6826f2-4ff6-443d-b966-e6913bd24013	9caef926-c71a-4a11-8615-f0ee8ce57d74
2800	2800	0	GBIF Germany	4f6826f2-4ff6-443d-b966-e6913bd24013	9cfb40df-edce-4ca7-bab5-123ce2e492b7
179	179	0	GBIF France	da44cd31-5901-4687-a106-6d1c7734ee3a	9d3b09dc-d846-40f9-bbac-3f169893f53f
944	944	0	GBIF France	da44cd31-5901-4687-a106-6d1c7734ee3a	9e611889-d71d-4931-9e68-7b2a5acbba77
243	243	0	GBIF Germany	4f6826f2-4ff6-443d-b966-e6913bd24013	a48e2384-9ead-4adb-8d6c-5fcde77ff358
63	63	0	GBIF Portugal	673f7038-4262-4149-b753-5658a4e912f6	a4ffebe0-6711-4687-8c74-0a4da3fd84f9
149	2522	2373	Participant Node Managers Committee	7f48e0c8-5c96-49ec-b972-30748e339115	a59ee310-03a5-43df-9737-4843b634e252
0	2	2	Plazi	ffb07bec-2d10-492d-9c37-361fe0b79427	a63cc08a-d769-418a-a39c-2c31cb441ede
2	2	0	Plazi	ffb07bec-2d10-492d-9c37-361fe0b79427	a81d1b34-1393-4371-9f01-336c2a60c3c8
0	2	2	Plazi	ffb07bec-2d10-492d-9c37-361fe0b79427	a98cde14-7d94-4b79-80d3-bfc0ebcc87ce
0	20	20	Plazi	ffb07bec-2d10-492d-9c37-361fe0b79427	ab1c2bbe-9a7c-4796-9318-103a96c50a9c
1	1	0	Plazi	ffb07bec-2d10-492d-9c37-361fe0b79427	abdef4f8-71b7-4682-aa5e-fced474ffcc2
0	3	3	Plazi	ffb07bec-2d10-492d-9c37-361fe0b79427	ad049f22-b6c8-4101-b439-13a393bd66e0
3	3	0	Plazi	ffb07bec-2d10-492d-9c37-361fe0b79427	b00ed0a2-fbd4-4623-9cfa-94f681b4c467
1334	1334	0	GBIF Germany	4f6826f2-4ff6-443d-b966-e6913bd24013	b02bfe2c-9dfe-4d18-aa83-dacaf536a3aa
0	296	296	Ocean Biodiversity Information System	ba0670b9-4186-41e6-8e70-f9cb3065551a	b181b698-3ef7-4ff1-b0b1-3be1099529e6
406	406	0	GBIF France	da44cd31-5901-4687-a106-6d1c7734ee3a	b7272456-93cf-4396-8724-903f42e4a4f4
3862	3862	0	Colombian Biodiversity Information System	7e865cba-7c46-417b-ade5-97f2cf5b7be0	b997a951-75c0-4ffa-b048-d02b2fa33d04
0	17	17	Ocean Biodiversity Information System	ba0670b9-4186-41e6-8e70-f9cb3065551a	bc10f352-adff-496e-8b17-74fbcb630501
886	886	0	Colombian Biodiversity Information System	7e865cba-7c46-417b-ade5-97f2cf5b7be0	bd837c6d-5519-42c1-b311-9265ce64571a
23448	23448	0	National Biodiversity Network	d897a5b9-35ee-4232-94bd-b0bcaac003c2	bef0339d-e5d3-4236-bf85-8d78ce350048
0	466	466	Ocean Biodiversity Information System	ba0670b9-4186-41e6-8e70-f9cb3065551a	c3ebbdba-8395-434f-838c-619128439f89
0	3858	3858	Belgian Biodiversity Platform	fb11cfe1-ebc3-45af-9159-17d9fddbcdac	c504799c-060b-4e4a-b580-a8597350d1b7
159	159	0	Plazi	ffb07bec-2d10-492d-9c37-361fe0b79427	c50d2a91-7b34-472c-bbdb-e5d16a21d14e
6	6	0	Plazi	ffb07bec-2d10-492d-9c37-361fe0b79427	c6d13881-fd44-4aea-b3f0-379c90895b3c
2	2	0	Plazi	ffb07bec-2d10-492d-9c37-361fe0b79427	c6d2390f-4fb0-4c4b-a32e-37f402d49d51
0	87	87	GBIF Japan	db5705aa-6a6e-42f1-8942-d77b9f4896ea	c70d309c-a421-49d7-ad4e-44a1ce02a967
160	160	0	Plazi	ffb07bec-2d10-492d-9c37-361fe0b79427	c76ec731-0dc9-4fc4-8ea4-d90d90da9438
1	1	0	Atlas of Living Australia	4a6f1b71-969e-4fc5-a693-282b05e1220c	c848f703-f22d-4517-892d-d2fbbbb8269f
2901	17638	14737	GBIF Japan	db5705aa-6a6e-42f1-8942-d77b9f4896ea	c949d538-3f66-4c15-81db-f7bee8c870d4
0	2	2	Plazi	ffb07bec-2d10-492d-9c37-361fe0b79427	cb5085a2-a154-4fcb-94bf-77be72857b19
6	6	0	Biodiversity Information System of Mexico	b324e8e9-9a4c-44fa-8f1a-7f39ea7ab576	cb7bfd0f-4f11-445c-9b7c-be74472bcfc4
34966	34966	0	GBIF Germany	4f6826f2-4ff6-443d-b966-e6913bd24013	cce04086-6c7c-11e2-90ce-00145eb45e9a
382	382	0	Colombian Biodiversity Information System	7e865cba-7c46-417b-ade5-97f2cf5b7be0	ce38c451-3cae-4d01-b2a6-7b9250947d81
3	3	0	Plazi	ffb07bec-2d10-492d-9c37-361fe0b79427	cf05c28d-74ba-474f-a669-3145aa58b691
0	20658	20658	Atlas of Living Australia	4a6f1b71-969e-4fc5-a693-282b05e1220c	d05bc4e1-e484-4cff-81c8-45f6faebef8c
1104	1104	0	GBIF Germany	4f6826f2-4ff6-443d-b966-e6913bd24013	d10ac872-a7dd-4ab7-9d13-384a7c7de673
0	18	18	Plazi	ffb07bec-2d10-492d-9c37-361fe0b79427	d1407171-9323-4a91-a1ec-b83b56fd8d2c
0	700	700	Korean Biodiversity Information Facility	e0a1e772-0177-4800-94b4-2d023fe6cdf4	d2c145b8-7750-43bd-9370-6ed0c8c87376
5	5	0	Plazi	ffb07bec-2d10-492d-9c37-361fe0b79427	d2de6583-a1e0-4642-aabb-cc97194fd96b
3	3	0	Plazi	ffb07bec-2d10-492d-9c37-361fe0b79427	d599fd7a-4986-4850-b04e-e51657b31e60
0	3	3	Participant Node Managers Committee	7f48e0c8-5c96-49ec-b972-30748e339115	d75a7bfa-4559-4567-b205-dd08e7dce524
846	846	0	National Biodiversity Network	d897a5b9-35ee-4232-94bd-b0bcaac003c2	d87f990c-432b-4986-a8c1-1bc8ebd4276e
1279	1279	0	GBIF Finland	dd514216-5c7c-45f3-910d-797424cb5be6	daee2e33-786c-4162-8781-e9a75daa189f
50	50	0	GBIF Argentina	2426a871-9feb-40a1-96c6-0c593a76b835	db28c28a-e525-45d0-af51-c4dcacc69cad
0	1	1	Plazi	ffb07bec-2d10-492d-9c37-361fe0b79427	dbe0f9ce-59ad-47e0-aa3e-621a4380da0c
9	9	0	Plazi	ffb07bec-2d10-492d-9c37-361fe0b79427	dc129fe8-e654-4d74-a92b-231c89d544f2
455	455	0	Colombian Biodiversity Information System	7e865cba-7c46-417b-ade5-97f2cf5b7be0	dd223a19-c7f6-4847-9422-614c6e8bc623
0	1	1	Plazi	ffb07bec-2d10-492d-9c37-361fe0b79427	dded951d-35d4-4390-a8cd-320b64cc0b5d
0	13329	13329	Belgian Biodiversity Platform	fb11cfe1-ebc3-45af-9159-17d9fddbcdac	e89c4d84-f5c7-43ea-882b-1569609ff4e6
5	5	0	Plazi	ffb07bec-2d10-492d-9c37-361fe0b79427	eba22c69-b7e4-4fb7-8408-eaa5718f014c
5	5	0	Plazi	ffb07bec-2d10-492d-9c37-361fe0b79427	ef85928f-5415-43ef-9f52-4731114085de
1163	1163	0	Participant Node Managers Committee	7f48e0c8-5c96-49ec-b972-30748e339115	efa4152c-0765-41a2-a2f4-823cf4d924a0
4	4	0	Plazi	ffb07bec-2d10-492d-9c37-361fe0b79427	f0710dd0-7372-4bdd-bf34-0574f087a060
148	148	0	National Biodiversity Network	d897a5b9-35ee-4232-94bd-b0bcaac003c2	f0c88992-d15a-4d5d-8931-0fe6c9626bf2
0	20429	20429	U.S. Geological Survey	8618c64a-93e0-4300-b546-7249e5148ed2	f1c0241b-6c64-414e-914f-ebaf764b3d9b
0	101	101	Plazi	ffb07bec-2d10-492d-9c37-361fe0b79427	f399e6d5-8c36-4871-ae88-64c70850516c
2342	2342	0	GBIF France	da44cd31-5901-4687-a106-6d1c7734ee3a	f4319512-a82d-4d24-8ded-54c5dd44910e
6	6	0	Plazi	ffb07bec-2d10-492d-9c37-361fe0b79427	f78933b8-613e-4f05-a609-eaef3a53c3f2
20283	20283	0	National Biodiversity Network	d897a5b9-35ee-4232-94bd-b0bcaac003c2	fca80fca-5376-4362-a417-2b61c0bda412
0	3	3	Plazi	ffb07bec-2d10-492d-9c37-361fe0b79427	fee5a48f-68cc-4a9d-86cf-933f08eb6ea6
0	2	2	Plazi	ffb07bec-2d10-492d-9c37-361fe0b79427	0284de61-7094-4aea-b089-12bce87a9b9b
9	9	0	Plazi	ffb07bec-2d10-492d-9c37-361fe0b79427	029d4e90-6c66-413a-ab4a-a8f431ad0671
1036	1036	0	GBIF France	da44cd31-5901-4687-a106-6d1c7734ee3a	02a6c056-deea-4085-b5e2-313499583ae0
123	123	0	National Biodiversity Network	d897a5b9-35ee-4232-94bd-b0bcaac003c2	02c23566-1d5b-4f0c-9d2f-07f3ae24381b
5642	5642	0	Netherlands Biodiversity Information Facility	0909d601-bda2-42df-9e63-a6d51847ebce	0354f54c-12a1-457c-a5dd-53386a0758fd
3	3	0	Plazi	ffb07bec-2d10-492d-9c37-361fe0b79427	0391cade-8527-453f-ba4c-155443830708
4	4	0	Plazi	ffb07bec-2d10-492d-9c37-361fe0b79427	05644708-9cff-44a4-b43e-9dacef387ab2
0	11	11	Plazi	ffb07bec-2d10-492d-9c37-361fe0b79427	07c8b825-166b-4de5-93c5-0d6075615c23
0	308	308	Ocean Biodiversity Information System	ba0670b9-4186-41e6-8e70-f9cb3065551a	08ecd719-2e5d-4de7-916d-b486c0dcc095
406	406	0	Plazi	ffb07bec-2d10-492d-9c37-361fe0b79427	09f3f499-00d5-4b1f-af77-f1db57427cdb
0	2	2	Plazi	ffb07bec-2d10-492d-9c37-361fe0b79427	0cd18e61-7a65-4511-a8c5-f059b015ac6b
165	165	0	GBIF Norway	4f829580-180d-46a9-9c87-ed8ec959b545	0ce0ef1a-dcb0-4649-8960-093429d0b396
0	1	1	Colombian Biodiversity Information System	7e865cba-7c46-417b-ade5-97f2cf5b7be0	0de79570-3046-41eb-9651-0935609fe9f7
0	46	46	Colombian Biodiversity Information System	7e865cba-7c46-417b-ade5-97f2cf5b7be0	0e065425-b7fe-4fcb-a8ba-afa4e26c7729
24	24	0	Participant Node Managers Committee	7f48e0c8-5c96-49ec-b972-30748e339115	0f127474-67c6-4e4f-8bd6-74de0963e53b
1349	1349	0	National Biodiversity Network	d897a5b9-35ee-4232-94bd-b0bcaac003c2	0f973260-8204-4037-bed5-aa064b1036cd
0	5275	5275	GBIF Benin	efb9c00e-f802-45dd-8826-a52ec45b89ff	1388e4a7-2427-442d-97d2-16e5e2859204
0	4	4	Plazi	ffb07bec-2d10-492d-9c37-361fe0b79427	16d4c471-a8fd-4821-af0e-924ae9bfce37
188	188	0	GBIF France	da44cd31-5901-4687-a106-6d1c7734ee3a	17c61be8-18d9-4a97-bedf-df6f5a03b986
0	2084	2084	Biodiversity Information System of Mexico	b324e8e9-9a4c-44fa-8f1a-7f39ea7ab576	1a903bc5-bedf-4414-809c-7439843dc336
0	10	10	Plazi	ffb07bec-2d10-492d-9c37-361fe0b79427	1cf627a1-1b1c-48c0-925d-32a318eacc4a
0	8	8	Plazi	ffb07bec-2d10-492d-9c37-361fe0b79427	1d9a56fa-4902-425c-a9dc-8e17fb74d2fc
1	1	0	Plazi	ffb07bec-2d10-492d-9c37-361fe0b79427	202f1fea-aa6f-4fc7-bfad-5a1a10d28703
9	9	0	Plazi	ffb07bec-2d10-492d-9c37-361fe0b79427	20b5a2de-ebc3-4441-8867-f04b10215142
8	8	0	Plazi	ffb07bec-2d10-492d-9c37-361fe0b79427	25d25c9c-2c28-42a3-b050-31fbfc498faa
137	137	0	GBIF France	da44cd31-5901-4687-a106-6d1c7734ee3a	27efa2e7-c7d1-4cc8-9360-b9600cba732f
0	3	3	Plazi	ffb07bec-2d10-492d-9c37-361fe0b79427	2b146d0d-5ab7-43ff-aa0e-1c2d5a4bb1e2
1	1	0	Plazi	ffb07bec-2d10-492d-9c37-361fe0b79427	2b3b5fd1-85a4-4c0c-a72e-159014ae6201
0	58	58	Plazi	ffb07bec-2d10-492d-9c37-361fe0b79427	2ca41b6f-e201-4093-9c51-f79abb72b834
2380	2380	0	GBIF France	da44cd31-5901-4687-a106-6d1c7734ee3a	329d2323-9fe5-47b2-ac4b-6d1c984cd4ac
163058	165030	1972	GBIF Norway	4f829580-180d-46a9-9c87-ed8ec959b545	346a9b13-5c96-4793-bcd7-d6614950e726
2114	2114	0	Belgian Biodiversity Platform	fb11cfe1-ebc3-45af-9159-17d9fddbcdac	35327b62-a8d4-46b7-bd21-95d5287c8baf
1952	1952	0	U.S. Geological Survey	8618c64a-93e0-4300-b546-7249e5148ed2	360a3e6f-da4e-48a8-a57e-1db31db64110
8	8	0	Plazi	ffb07bec-2d10-492d-9c37-361fe0b79427	364e4422-d988-45d4-acb7-3e35edca084a
0	5	5	Plazi	ffb07bec-2d10-492d-9c37-361fe0b79427	368d2d63-f7d4-48e2-bc0d-7ebb81fb68c1
66	66	0	GBIF Germany	4f6826f2-4ff6-443d-b966-e6913bd24013	3ba47554-1afd-482a-aea6-b79661b7724a
592	368	-224	GBIF Germany	4f6826f2-4ff6-443d-b966-e6913bd24013	3be0f16e-fd4c-4513-a454-ab63373541bc
1611	1611	0	GBIF Guinea	b1cd2e84-c4ba-47bd-b72a-dfd1f92dce0a	4179bbb7-eb1f-4318-9bfa-7280dbb46f79
8131	8131	0	National Biodiversity Network	d897a5b9-35ee-4232-94bd-b0bcaac003c2	41b91856-5c80-43b8-97cb-e492a14a3abd
760	760	0	GBIF France	da44cd31-5901-4687-a106-6d1c7734ee3a	422226d2-2ac1-4a29-8d97-b77896722104
7581	7649	68	U.S. Geological Survey	8618c64a-93e0-4300-b546-7249e5148ed2	43e54c60-d6e0-41df-80a3-ca9487a3342a
352	352	0	Atlas of Living Australia	4a6f1b71-969e-4fc5-a693-282b05e1220c	4790dd85-b9d2-4a40-b3f6-dc4010cf3be3
488	488	0	GBIF France	da44cd31-5901-4687-a106-6d1c7734ee3a	4a0eadd4-ce7e-40e9-9b51-231ea9a22e56
0	6	6	Plazi	ffb07bec-2d10-492d-9c37-361fe0b79427	4a3c0d1e-976d-4d85-a670-4cbfba769960
7856	7856	0	GBIF Brazil	cdc9736d-5ff7-4ece-9959-3c744360cdb3	4a65752a-525b-4fb3-ae0f-5348aaa1e6d8
0	118	118	Ocean Biodiversity Information System	ba0670b9-4186-41e6-8e70-f9cb3065551a	4db2eadc-dc53-4168-9974-217418d19577
1	1	0	Plazi	ffb07bec-2d10-492d-9c37-361fe0b79427	5149aaa6-360f-4f55-9665-9c525486221e
0	1	1	Plazi	ffb07bec-2d10-492d-9c37-361fe0b79427	54f467d2-fdf6-4933-8a3f-bc9f9aabb20d
7	7	0	Plazi	ffb07bec-2d10-492d-9c37-361fe0b79427	554f1c1d-a68d-49fb-bbd3-cda1216d52b4
138	138	0	GBIF France	da44cd31-5901-4687-a106-6d1c7734ee3a	569c824c-ea6d-4314-a77d-0ff238bebd87
39385	39385	0	South African Biodiversity Information Facility	7190b835-4e86-4b6e-85c1-19cc6677c250	570ceb60-ac58-4b98-9723-54000ee7b391
0	2	2	Plazi	ffb07bec-2d10-492d-9c37-361fe0b79427	573cbdf3-37de-422a-9fca-9a34315d2cf9
125	125	0	Plazi	ffb07bec-2d10-492d-9c37-361fe0b79427	58d86c58-b7b6-4495-98de-0743c98191de
2	2	0	Plazi	ffb07bec-2d10-492d-9c37-361fe0b79427	59b44e2f-36c8-48d4-a369-054f73007423
115	115	0	GBIF Sweden	a0b3be64-6525-4387-ac67-a499950f92e1	5b758296-ca0a-43b7-ae8e-32709cdbbf02
4	4	0	Plazi	ffb07bec-2d10-492d-9c37-361fe0b79427	5ba665c5-e3c0-469c-bc09-233dfaac0168
25128	25128	0	Belgian Biodiversity Platform	fb11cfe1-ebc3-45af-9159-17d9fddbcdac	5bba3c0c-4cfe-4e9c-a744-25eeb5adf2fe
19747	19535	-212	GBIF Portugal	673f7038-4262-4149-b753-5658a4e912f6	5cc85d78-4313-4959-b17d-cd3dc32cc155
3419	3419	0	National Biodiversity Network	d897a5b9-35ee-4232-94bd-b0bcaac003c2	5cd9bee8-4bd9-4b36-9658-cf41c71ef21c
918	918	0	Atlas of Living Australia	4a6f1b71-969e-4fc5-a693-282b05e1220c	5cf2e899-2c17-499d-8b55-357d50d7a453
13	13	0	Plazi	ffb07bec-2d10-492d-9c37-361fe0b79427	5d01d0ba-9009-45b4-aef1-bea31993f0d9
301340	355502	54162	National Biodiversity Network	d897a5b9-35ee-4232-94bd-b0bcaac003c2	5e43a220-a91d-485b-b608-58fd22693be7
0	10855	10855	Participant Node Managers Committee	7f48e0c8-5c96-49ec-b972-30748e339115	60fe3a6d-9f49-4425-8f4f-63a4faf2dfbc
163	163	0	GBIF Germany	4f6826f2-4ff6-443d-b966-e6913bd24013	620d97e8-f762-11e1-a439-00145eb45e9a
100	100	0	GBIF Germany	4f6826f2-4ff6-443d-b966-e6913bd24013	6265ed44-f762-11e1-a439-00145eb45e9a
36	36	0	GBIF Germany	4f6826f2-4ff6-443d-b966-e6913bd24013	62a630ac-f762-11e1-a439-00145eb45e9a
3357	3357	0	National Biodiversity Network	d897a5b9-35ee-4232-94bd-b0bcaac003c2	62e2715e-414d-49cf-84cc-47debfa23f71
80	80	0	GBIF Germany	4f6826f2-4ff6-443d-b966-e6913bd24013	63b0f586-f762-11e1-a439-00145eb45e9a
0	2	2	Plazi	ffb07bec-2d10-492d-9c37-361fe0b79427	63c0ff18-ee53-46ff-b516-73e23e86c8e8
120	120	0	GBIF Germany	4f6826f2-4ff6-443d-b966-e6913bd24013	64578144-f762-11e1-a439-00145eb45e9a
0	28	28	Plazi	ffb07bec-2d10-492d-9c37-361fe0b79427	64aa8730-a90c-4c26-aea9-9e7dff068dc1
68	65	-3	GBIF Germany	4f6826f2-4ff6-443d-b966-e6913bd24013	6578b174-f762-11e1-a439-00145eb45e9a
345	345	0	GBIF Germany	4f6826f2-4ff6-443d-b966-e6913bd24013	661f156e-f762-11e1-a439-00145eb45e9a
418	418	0	GBIF France	da44cd31-5901-4687-a106-6d1c7734ee3a	663200ed-cfc7-43d5-82c5-9975e6645a0c
80	80	0	GBIF Germany	4f6826f2-4ff6-443d-b966-e6913bd24013	666444cc-f762-11e1-a439-00145eb45e9a
57	57	0	GBIF Germany	4f6826f2-4ff6-443d-b966-e6913bd24013	66946bac-f762-11e1-a439-00145eb45e9a
0	4	4	Plazi	ffb07bec-2d10-492d-9c37-361fe0b79427	674ff9ea-62f2-4ede-a0ad-ca877d4e2eda
63	63	0	GBIF Germany	4f6826f2-4ff6-443d-b966-e6913bd24013	68ac7506-f762-11e1-a439-00145eb45e9a
45006	45006	0	GBIF Norway	4f829580-180d-46a9-9c87-ed8ec959b545	695de7d9-e608-49fd-8fe2-dafb59810784
142	142	0	GBIF Germany	4f6826f2-4ff6-443d-b966-e6913bd24013	69da20f4-f762-11e1-a439-00145eb45e9a
44	44	0	GBIF Germany	4f6826f2-4ff6-443d-b966-e6913bd24013	6aae75b6-f762-11e1-a439-00145eb45e9a
12	12	0	Plazi	ffb07bec-2d10-492d-9c37-361fe0b79427	6bf7731a-866f-42dd-ac96-7c354e7bf6c6
14	14	0	GBIF Germany	4f6826f2-4ff6-443d-b966-e6913bd24013	6c001730-f762-11e1-a439-00145eb45e9a
26	26	0	GBIF Germany	4f6826f2-4ff6-443d-b966-e6913bd24013	6c80d1b8-f762-11e1-a439-00145eb45e9a
65	65	0	GBIF Germany	4f6826f2-4ff6-443d-b966-e6913bd24013	6cc2a656-f762-11e1-a439-00145eb45e9a
171215	179050	7835	GBIF Norway	4f829580-180d-46a9-9c87-ed8ec959b545	6ce9819a-d82b-41e1-9059-0dd201f15993
0	2250	2250	Participant Node Managers Committee	7f48e0c8-5c96-49ec-b972-30748e339115	6f26b1fe-4f27-46d9-9802-90d9b2db445f
104	104	0	GBIF Sweden	a0b3be64-6525-4387-ac67-a499950f92e1	705d5876-7a47-4e89-add7-cd85bdd6cfc1
3	3	0	Plazi	ffb07bec-2d10-492d-9c37-361fe0b79427	709065b6-f03c-45c0-922a-79ec55cdd8bc
129	129	0	GBIF Germany	4f6826f2-4ff6-443d-b966-e6913bd24013	70ec2784-f762-11e1-a439-00145eb45e9a
105	105	0	GBIF Germany	4f6826f2-4ff6-443d-b966-e6913bd24013	70f4d4c4-f762-11e1-a439-00145eb45e9a
3125	2679	-446	GBIF Germany	4f6826f2-4ff6-443d-b966-e6913bd24013	7128542d-ca8f-48cc-9855-aced1ad15303
11	11	0	GBIF Germany	4f6826f2-4ff6-443d-b966-e6913bd24013	72329bc8-f762-11e1-a439-00145eb45e9a
206	206	0	GBIF Germany	4f6826f2-4ff6-443d-b966-e6913bd24013	734d0e26-f762-11e1-a439-00145eb45e9a
327	327	0	GBIF Germany	4f6826f2-4ff6-443d-b966-e6913bd24013	741e9158-f762-11e1-a439-00145eb45e9a
1090	1090	0	Atlas of Living Australia	4a6f1b71-969e-4fc5-a693-282b05e1220c	75db885c-65a7-499e-a28a-4206723007d0
0	15	15	Plazi	ffb07bec-2d10-492d-9c37-361fe0b79427	77199e8e-6f4a-47fc-b0ba-2201e9c55df1
2535	2535	0	GBIF Germany	4f6826f2-4ff6-443d-b966-e6913bd24013	776e27c4-f762-11e1-a439-00145eb45e9a
6	6	0	Plazi	ffb07bec-2d10-492d-9c37-361fe0b79427	782bf37b-19dc-4b7c-bfa1-b88b5358d29e
13790	13790	0	GBIF Norway	4f829580-180d-46a9-9c87-ed8ec959b545	78ab5416-bf56-4714-a2bf-096b16f0e1d8
109270	109270	0	Colombian Biodiversity Information System	7e865cba-7c46-417b-ade5-97f2cf5b7be0	79684ec1-01e8-46cc-83cb-cd5bdfb469fe
8	8	0	Plazi	ffb07bec-2d10-492d-9c37-361fe0b79427	799ec8d3-c3f8-4fc9-92e7-d3b7935c04f7
9	9	0	National Biodiversity Network	d897a5b9-35ee-4232-94bd-b0bcaac003c2	79bdb726-f6f4-4a4a-9dc1-99f71e903cf8
14252	14252	0	Korean Biodiversity Information Facility	e0a1e772-0177-4800-94b4-2d023fe6cdf4	7aee0a22-f762-11e1-a439-00145eb45e9a
406	406	0	GBIF Germany	4f6826f2-4ff6-443d-b966-e6913bd24013	7c1bb75a-f762-11e1-a439-00145eb45e9a
12140	12140	0	Biodiversity Information System of Mexico	b324e8e9-9a4c-44fa-8f1a-7f39ea7ab576	7c95ae39-b477-4863-8dda-2d74dc48b067
520	520	0	National Biodiversity Network	d897a5b9-35ee-4232-94bd-b0bcaac003c2	7cb4a425-3aab-440e-8df2-7f0ef9b17ed4
1180	1144	-36	GBIF Germany	4f6826f2-4ff6-443d-b966-e6913bd24013	7ce7cdb8-f762-11e1-a439-00145eb45e9a
253	186	-67	GBIF Germany	4f6826f2-4ff6-443d-b966-e6913bd24013	7cfa5e1a-f762-11e1-a439-00145eb45e9a
117	117	0	GBIF Germany	4f6826f2-4ff6-443d-b966-e6913bd24013	7d216cc6-f762-11e1-a439-00145eb45e9a
0	9	9	Plazi	ffb07bec-2d10-492d-9c37-361fe0b79427	7f46c88c-7ef7-44f6-acc2-1cc3d034ff41
237	237	0	GBIF Germany	4f6826f2-4ff6-443d-b966-e6913bd24013	7f48bea0-f762-11e1-a439-00145eb45e9a
5704	5704	0	GBIF Sweden	a0b3be64-6525-4387-ac67-a499950f92e1	7fcf98b0-0c63-11dd-84d0-b8a03c50a862
3111	3111	0	Atlas of Living Australia	4a6f1b71-969e-4fc5-a693-282b05e1220c	8037efce-aa87-49fe-a7ad-1962f53b2f51
0	2	2	Plazi	ffb07bec-2d10-492d-9c37-361fe0b79427	8062965c-ea3e-44a4-8cf6-4855d472e264
757	757	0	GBIF Germany	4f6826f2-4ff6-443d-b966-e6913bd24013	81b65972-f762-11e1-a439-00145eb45e9a
3148	3148	0	Canada Biodiversity Information Facility	8f83fc96-c966-4126-83f7-bf044dc49efa	846e334c-f762-11e1-a439-00145eb45e9a
31898	34751	2853	GBIF Japan	db5705aa-6a6e-42f1-8942-d77b9f4896ea	848c1560-f762-11e1-a439-00145eb45e9a
4	4	0	Plazi	ffb07bec-2d10-492d-9c37-361fe0b79427	84ee7aa9-b217-40fb-9a7d-d94dd8c906de
3537	3537	0	World Federation for Culture Collections	a6bdc523-5368-4e0f-9d2e-de1c262ac092	855199ca-f762-11e1-a439-00145eb45e9a
57	19	-38	GBIF Germany	4f6826f2-4ff6-443d-b966-e6913bd24013	86fc8c94-f762-11e1-a439-00145eb45e9a
258	258	0	Plazi	ffb07bec-2d10-492d-9c37-361fe0b79427	875593a5-0add-4d4f-9317-b0e444c93deb
57	57	0	GBIF Germany	4f6826f2-4ff6-443d-b966-e6913bd24013	8a2380d0-f762-11e1-a439-00145eb45e9a
0	2	2	Plazi	ffb07bec-2d10-492d-9c37-361fe0b79427	8a5afe06-fbde-4eaa-bed2-cd9d5d8365de
47	47	0	GBIF Germany	4f6826f2-4ff6-443d-b966-e6913bd24013	8a99c2b8-f762-11e1-a439-00145eb45e9a
213	213	0	GBIF Germany	4f6826f2-4ff6-443d-b966-e6913bd24013	8aa56500-f762-11e1-a439-00145eb45e9a
142	142	0	GBIF Germany	4f6826f2-4ff6-443d-b966-e6913bd24013	8acc7faa-f762-11e1-a439-00145eb45e9a
25	25	0	Plazi	ffb07bec-2d10-492d-9c37-361fe0b79427	8d478a33-1bef-46aa-be91-f286eee0fb18
1464	684	-780	GBIF Germany	4f6826f2-4ff6-443d-b966-e6913bd24013	8e004dbe-f762-11e1-a439-00145eb45e9a
825	693	-132	GBIF Germany	4f6826f2-4ff6-443d-b966-e6913bd24013	8ea18cec-f762-11e1-a439-00145eb45e9a
2849	2233	-616	GBIF Germany	4f6826f2-4ff6-443d-b966-e6913bd24013	8f3d286e-f762-11e1-a439-00145eb45e9a
73	43	-30	GBIF Germany	4f6826f2-4ff6-443d-b966-e6913bd24013	904ec622-f762-11e1-a439-00145eb45e9a
4083	5386	1303	National Biodiversity Network	d897a5b9-35ee-4232-94bd-b0bcaac003c2	926f5a1c-8995-498a-913b-fe0312e1071f
1796	1796	0	Colombian Biodiversity Information System	7e865cba-7c46-417b-ade5-97f2cf5b7be0	948986e9-1f4d-484e-b1e2-35355081033e
2326	2326	0	GBIF Spain	1f94b3ca-9345-4d65-afe2-4bace93aa0fe	96232278-f762-11e1-a439-00145eb45e9a
82	82	0	GBIF France	da44cd31-5901-4687-a106-6d1c7734ee3a	974da508-be8f-487f-ad1e-ecb7423eb994
54	54	0	Plazi	ffb07bec-2d10-492d-9c37-361fe0b79427	993bafa5-6141-4ae2-b080-9bb2c2a3429c
231	231	0	Belgian Biodiversity Platform	fb11cfe1-ebc3-45af-9159-17d9fddbcdac	9b5fd002-17a9-4061-ac4c-39b516e26c9d
28435	28435	0	Participant Node Managers Committee	7f48e0c8-5c96-49ec-b972-30748e339115	9c2cc134-5b4c-497a-8445-c45610722317
14	14	0	Plazi	ffb07bec-2d10-492d-9c37-361fe0b79427	9d33e395-07ba-4dda-b6e9-e89dd2b8c776
24	25	1	U.S. Geological Survey	8618c64a-93e0-4300-b546-7249e5148ed2	9f5e2bfa-8ea0-46c5-bc6b-909a82f67af4
83	83	0	GBIF France	da44cd31-5901-4687-a106-6d1c7734ee3a	9f5fe520-8ae7-4b42-8834-0c306ad5ca2c
2	2	0	Plazi	ffb07bec-2d10-492d-9c37-361fe0b79427	9fded863-4b93-41c1-ae6e-e6056a3c258d
24	24	0	Plazi	ffb07bec-2d10-492d-9c37-361fe0b79427	a3aa3617-4870-49f3-91c7-b49221dc5489
0	2	2	Plazi	ffb07bec-2d10-492d-9c37-361fe0b79427	a522b457-92e9-459b-8c66-b52bd32bc1fb
29559	29559	0	GBIF Benin	efb9c00e-f802-45dd-8826-a52ec45b89ff	a542f2ae-f48e-48eb-95a4-db7b6cc83e99
0	5	5	Plazi	ffb07bec-2d10-492d-9c37-361fe0b79427	a6c9c1a3-2826-4b60-a5b3-a29ad52549f2
152	152	0	GBIF Germany	4f6826f2-4ff6-443d-b966-e6913bd24013	a70eaa21-a406-4c0e-9e8d-38f76000ac0f
0	89	89	Plazi	ffb07bec-2d10-492d-9c37-361fe0b79427	a9587d18-3817-4ac6-9810-f793eecb426e
0	5	5	Plazi	ffb07bec-2d10-492d-9c37-361fe0b79427	aa3fe220-2645-46dd-8689-7f23979ffc31
36	36	0	Belgian Biodiversity Platform	fb11cfe1-ebc3-45af-9159-17d9fddbcdac	abde7512-bec5-4734-8746-e7a2e2c5035c
6677	6677	0	Colombian Biodiversity Information System	7e865cba-7c46-417b-ade5-97f2cf5b7be0	ac2d4971-4b88-4339-ad10-0ed2b0b4d690
5262	5262	0	GBIF France	da44cd31-5901-4687-a106-6d1c7734ee3a	ac60a288-fcc9-43fe-a7d4-e732b748a981
15	15	0	Plazi	ffb07bec-2d10-492d-9c37-361fe0b79427	ad7f9288-3077-4ab3-96ea-d3653ca3b967
4174	11198	7024	GBIF Norway	4f829580-180d-46a9-9c87-ed8ec959b545	ae77cf87-0f7f-4a08-91cc-5d55230fb421
10758	10758	0	GBIF France	da44cd31-5901-4687-a106-6d1c7734ee3a	aea6d6c7-9d6a-43b0-9d55-0d03cbe991ce
0	3	3	Plazi	ffb07bec-2d10-492d-9c37-361fe0b79427	af22ce47-34f5-4324-bfa4-af35f23eb5c0
48243	48243	0	National Biodiversity Network	d897a5b9-35ee-4232-94bd-b0bcaac003c2	b0a1b3d7-4383-4fa5-a5c9-ae2c1124297e
519	519	0	Participant Node Managers Committee	7f48e0c8-5c96-49ec-b972-30748e339115	b1a45d42-f677-473b-93d1-f93b117efe1e
1353	1353	0	Atlas of Living Australia	4a6f1b71-969e-4fc5-a693-282b05e1220c	b25c3e4d-4742-4d1a-a8cb-4b7648bace74
302	302	0	GBIF France	da44cd31-5901-4687-a106-6d1c7734ee3a	b2d9cdff-8103-42af-8501-4b58a5cba6bc
0	150	150	U.S. Geological Survey	8618c64a-93e0-4300-b546-7249e5148ed2	b36d8640-8746-45ea-ba88-f8b5a967a6d9
498	498	0	GBIF France	da44cd31-5901-4687-a106-6d1c7734ee3a	b6c51404-ffa0-4682-862e-a48d3384aff1
3	3	0	Plazi	ffb07bec-2d10-492d-9c37-361fe0b79427	b80078f0-c5d2-4eda-9a1c-fa72cfa672ff
20	20	0	Plazi	ffb07bec-2d10-492d-9c37-361fe0b79427	b9072187-c8b1-45c8-9650-a1656389c2a8
2379	2379	0	GBIF Finland	dd514216-5c7c-45f3-910d-797424cb5be6	bc5f47f3-8006-4039-b454-9d25348b6e3f
0	31	31	Ocean Biodiversity Information System	ba0670b9-4186-41e6-8e70-f9cb3065551a	bc88ac0f-35ad-4883-a7a1-689e71fd9bf2
5699	5699	0	GBIF France	da44cd31-5901-4687-a106-6d1c7734ee3a	be5fd087-a839-4a1e-9fdf-811119db26da
7363	7363	0	GBIF Benin	efb9c00e-f802-45dd-8826-a52ec45b89ff	be9a09a9-7eb8-4f74-b4a7-e4247c580ee9
4	4	0	Plazi	ffb07bec-2d10-492d-9c37-361fe0b79427	bfec807a-63bf-4b93-9474-c42a676122c0
1441	1441	0	Plazi	ffb07bec-2d10-492d-9c37-361fe0b79427	c141f9ba-ee69-4c19-906c-285ef92e9a6b
156	156	0	GBIF Togo	c9659a3e-07e9-4fcb-83c6-de8b9009a02e	c1fde599-9bc7-426c-8e4b-fa3941ec784b
48	48	0	GBIF France	da44cd31-5901-4687-a106-6d1c7734ee3a	c5dae770-82b9-449c-8b74-cee67381fa59
6	6	0	Participant Node Managers Committee	7f48e0c8-5c96-49ec-b972-30748e339115	c6bd3fec-9193-45d6-be32-09195cf644bb
55	55	0	Colombian Biodiversity Information System	7e865cba-7c46-417b-ade5-97f2cf5b7be0	ccc2db5d-3236-479b-8c61-4828a8736e62
3438	3438	0	GBIF Germany	4f6826f2-4ff6-443d-b966-e6913bd24013	ce47cb9e-ecc5-4ed9-b5e8-9aa4d45fd456
12	12	0	Plazi	ffb07bec-2d10-492d-9c37-361fe0b79427	ce6d1aca-d253-4093-a91b-8a18b5a532df
12	12	0	Plazi	ffb07bec-2d10-492d-9c37-361fe0b79427	d1b97f75-6ff9-40e5-ba71-e734073aaf91
1	1	0	Plazi	ffb07bec-2d10-492d-9c37-361fe0b79427	d53b2861-96be-4e97-8f4d-4e24613089b5
1941	2223	282	National Biodiversity Network	d897a5b9-35ee-4232-94bd-b0bcaac003c2	d57e08b7-391c-44fd-bdcd-0694f7e223a3
54	54	0	Colombian Biodiversity Information System	7e865cba-7c46-417b-ade5-97f2cf5b7be0	d6814a02-1ba6-4001-9bee-5fbca142fdcc
9258	9367	109	Canada Biodiversity Information Facility	8f83fc96-c966-4126-83f7-bf044dc49efa	d99823ca-d779-40ab-be33-955a99216e4e
4	4	0	Plazi	ffb07bec-2d10-492d-9c37-361fe0b79427	da9858c5-4f9f-4765-8652-d7c8ccd3f400
2	2	0	Plazi	ffb07bec-2d10-492d-9c37-361fe0b79427	db5d7725-8bc6-4db4-bedb-b0a0627e0620
0	10	10	Plazi	ffb07bec-2d10-492d-9c37-361fe0b79427	dfcf0206-b55e-4e91-958d-2765d0011944
3	3	0	Plazi	ffb07bec-2d10-492d-9c37-361fe0b79427	e0cf56be-bebb-4808-9299-aaa02c6c6fe3
0	352	352	National Biodiversity Network	d897a5b9-35ee-4232-94bd-b0bcaac003c2	e3654114-85ba-4100-8b14-d7a85525f68e
0	1260	1260	Ocean Biodiversity Information System	ba0670b9-4186-41e6-8e70-f9cb3065551a	e419b21e-f6a0-4b2d-a70a-497f957f146f
0	1823	1823	Ocean Biodiversity Information System	ba0670b9-4186-41e6-8e70-f9cb3065551a	e55abf34-bbc4-433a-b378-98df9a7e158f
2	2	0	Plazi	ffb07bec-2d10-492d-9c37-361fe0b79427	e650e9d7-bb29-4504-8868-07448fb3ca49
0	4	4	Plazi	ffb07bec-2d10-492d-9c37-361fe0b79427	ea8b9fe0-0b6a-4309-8a4c-e28a19340274
111	111	0	GBIF France	da44cd31-5901-4687-a106-6d1c7734ee3a	ed4b684e-68c9-4d82-88c0-a916f3175d44
16098	16098	0	National Biodiversity Network	d897a5b9-35ee-4232-94bd-b0bcaac003c2	edf03db8-68cf-48ac-a545-15f89c88e113
20	20	0	Plazi	ffb07bec-2d10-492d-9c37-361fe0b79427	ef209b80-8915-4fe9-a46b-c0ef681bdba0
1	1	0	Plazi	ffb07bec-2d10-492d-9c37-361fe0b79427	f2a70818-caef-412c-99dd-482aaa829858
0	4	4	Participant Node Managers Committee	7f48e0c8-5c96-49ec-b972-30748e339115	f5e2812f-0c9d-4c1b-8f8c-8ce10702ac2a
0	34	34	Ocean Biodiversity Information System	ba0670b9-4186-41e6-8e70-f9cb3065551a	f643caf4-2a4d-4224-ac0d-3c5035882f82
938	938	0	GBIF France	da44cd31-5901-4687-a106-6d1c7734ee3a	f69d7b88-6aa3-4372-9bd7-f81df97dafde
9946	9946	0	National Biodiversity Network	d897a5b9-35ee-4232-94bd-b0bcaac003c2	f84902b2-ef45-4e89-83e7-5d1f190f0562
30644	31149	505	GBIF Brazil	cdc9736d-5ff7-4ece-9959-3c744360cdb3	fdf55163-54d8-4bc7-862d-7e41068589e3
1	1	0	Plazi	ffb07bec-2d10-492d-9c37-361fe0b79427	0193e9ae-4e53-4dd3-baf5-82a186793c33
1	1	0	Plazi	ffb07bec-2d10-492d-9c37-361fe0b79427	07eb2372-a07c-4780-bf63-abe7d7ad30fd
35	35	0	Plazi	ffb07bec-2d10-492d-9c37-361fe0b79427	086cbbca-58b1-4012-a9f4-3bfdb5ffbe93
0	12	12	Plazi	ffb07bec-2d10-492d-9c37-361fe0b79427	090e88c1-0287-4f8a-8493-d6d0ecf6c930
18636	18636	0	Belgian Biodiversity Platform	fb11cfe1-ebc3-45af-9159-17d9fddbcdac	0b0bc0f0-bfad-11dd-aa16-b8a03c50a862
1008	1008	0	GBIF Chile	a8b16421-d80b-4ef3-8f22-098b01a89255	0e8fb1e3-4486-4526-99ec-6decdff4d331
0	34	34	Plazi	ffb07bec-2d10-492d-9c37-361fe0b79427	0f4ee0b0-7d0e-443c-b4c9-0b40ecd08854
2	2	0	Plazi	ffb07bec-2d10-492d-9c37-361fe0b79427	128dfed7-a482-46b0-b976-61f73748bc7b
4	4	0	Plazi	ffb07bec-2d10-492d-9c37-361fe0b79427	17afda72-dc03-4cdc-bcdb-157b0c0af602
40280	40280	0	National Biodiversity Network	d897a5b9-35ee-4232-94bd-b0bcaac003c2	17bd871c-1a81-4517-883d-eaab24a7ee98
373368	373966	598	GBIF Finland	dd514216-5c7c-45f3-910d-797424cb5be6	181eab51-9399-4baa-a0df-8de01a3acf19
11840	11840	0	U.S. Geological Survey	8618c64a-93e0-4300-b546-7249e5148ed2	198c2601-0dd5-4467-b64c-ca2824b9a17a
6417	6417	0	Participant Node Managers Committee	7f48e0c8-5c96-49ec-b972-30748e339115	1ccf6240-9a89-4c0e-bf1a-3e4ddd6197ba
4985	4985	0	National Biodiversity Network	d897a5b9-35ee-4232-94bd-b0bcaac003c2	1eb70e31-78cb-4181-9a25-88d11f0d0b02
0	1	1	Plazi	ffb07bec-2d10-492d-9c37-361fe0b79427	1fd37dd2-5a19-478a-8c48-5bc648717e76
815	815	0	National Biodiversity Network	d897a5b9-35ee-4232-94bd-b0bcaac003c2	20505953-6f56-4b92-bbb6-a21724ad6987
0	11	11	Plazi	ffb07bec-2d10-492d-9c37-361fe0b79427	2060c6f8-fcbc-48e6-9d2d-8237a55cf059
1553	1553	0	GBIF France	da44cd31-5901-4687-a106-6d1c7734ee3a	21641d2f-655a-415d-9de9-a74da6062473
2	2	0	Plazi	ffb07bec-2d10-492d-9c37-361fe0b79427	225be4d7-365e-43db-bd69-8864262e10a8
0	1	1	Plazi	ffb07bec-2d10-492d-9c37-361fe0b79427	23760704-d8d6-404c-8d8d-bc9f5bcbef76
4	4	0	Plazi	ffb07bec-2d10-492d-9c37-361fe0b79427	243e4f17-37dc-46b5-bfd5-5cc6f3dc8499
3	3	0	Plazi	ffb07bec-2d10-492d-9c37-361fe0b79427	2697b081-f3fa-4256-a62d-f084ee352b1c
2	2	0	Participant Node Managers Committee	7f48e0c8-5c96-49ec-b972-30748e339115	271fbd67-c524-4ffd-aefa-3a9188a63c60
2	2	0	Plazi	ffb07bec-2d10-492d-9c37-361fe0b79427	27a65bbd-651d-438b-9f2b-93cfd23d2a1f
0	1	1	Plazi	ffb07bec-2d10-492d-9c37-361fe0b79427	29631e62-f1ea-4d49-b249-147251696b97
3633	3633	0	GBIF Benin	efb9c00e-f802-45dd-8826-a52ec45b89ff	2a5ec2a2-ca47-469c-9ccd-43826d9bf7a8
19	19	0	Plazi	ffb07bec-2d10-492d-9c37-361fe0b79427	2f717d39-95db-4cc9-b2b9-3a4cbbad7bdb
5770	8139	2369	U.S. Geological Survey	8618c64a-93e0-4300-b546-7249e5148ed2	3144bbc8-9ebc-47fe-9f23-c575716eb357
0	12	12	Ocean Biodiversity Information System	ba0670b9-4186-41e6-8e70-f9cb3065551a	326f241d-f15c-4350-a07f-cbaaf7415cd2
42	42	0	National Biodiversity Network	d897a5b9-35ee-4232-94bd-b0bcaac003c2	32c8a198-945e-436f-a945-88a15fc10581
62453	62566	113	GBIF Brazil	cdc9736d-5ff7-4ece-9959-3c744360cdb3	330d773a-abe3-4234-b423-129dc4d00963
158252	158252	0	Bioversity International	b8a5be24-9225-4ba5-b664-159308a4b537	33795d9d-3f94-4b0e-a2f6-d3a03cfce7aa
91	91	0	GBIF Germany	4f6826f2-4ff6-443d-b966-e6913bd24013	36b5e629-3493-4385-a262-c308a6bf6af4
449	478	29	GBIF Germany	4f6826f2-4ff6-443d-b966-e6913bd24013	36dca302-e1c2-4570-990e-c6417ec8eacc
825	825	0	GBIF France	da44cd31-5901-4687-a106-6d1c7734ee3a	37b814a3-8ff3-44a5-aee6-a5b3c917e6d0
0	2	2	Plazi	ffb07bec-2d10-492d-9c37-361fe0b79427	39fb051c-0f86-4904-a095-5e3041ae38d1
5207	5207	0	Participant Node Managers Committee	7f48e0c8-5c96-49ec-b972-30748e339115	3d0a0197-32a0-4149-8db4-051991148176
175805	175805	0	National Biodiversity Network	d897a5b9-35ee-4232-94bd-b0bcaac003c2	3e2c98bb-44f8-4c93-8dfb-ac7f0c21f399
13771	13771	0	National Biodiversity Network	d897a5b9-35ee-4232-94bd-b0bcaac003c2	415860c4-137b-4617-9d10-a51885e35491
4	4	0	Plazi	ffb07bec-2d10-492d-9c37-361fe0b79427	4298f5cf-d85e-48fb-afe8-f12c99ad65b3
190	38	-152	GBIF Germany	4f6826f2-4ff6-443d-b966-e6913bd24013	44176f10-08d5-413d-9e99-706d76da561f
9	9	0	Plazi	ffb07bec-2d10-492d-9c37-361fe0b79427	445d08c6-2840-4857-825d-cd488ecd76d8
195	195	0	GBIF Niger	dc9041d6-a5ae-4217-92ea-f7674794d760	4496b1b1-1ea9-4eef-bcca-90adc41038df
1	1	0	Plazi	ffb07bec-2d10-492d-9c37-361fe0b79427	483c1bad-3cf8-4b77-9c80-0d5c5f9be274
0	721	721	Plazi	ffb07bec-2d10-492d-9c37-361fe0b79427	48769858-fe3b-415b-9ac8-3feeb42a9bae
13503	13503	0	GBIF Norway	4f829580-180d-46a9-9c87-ed8ec959b545	4cfd80a7-d630-4d7f-89fb-d2d1e749a418
1	1	0	Plazi	ffb07bec-2d10-492d-9c37-361fe0b79427	4dc9ee1f-1dda-4278-aec8-618d24715d40
6	6	0	Korean Biodiversity Information Facility	e0a1e772-0177-4800-94b4-2d023fe6cdf4	500331a3-0089-4056-9254-7d21a6d49fd3
0	1268	1268	Ocean Biodiversity Information System	ba0670b9-4186-41e6-8e70-f9cb3065551a	519461fd-3978-4f40-b73a-7dac4a50e21b
0	82	82	Plazi	ffb07bec-2d10-492d-9c37-361fe0b79427	56506ca4-4d4e-4cba-8923-71db1cf42005
1	1	0	Plazi	ffb07bec-2d10-492d-9c37-361fe0b79427	5943a8d6-434e-430c-bc40-9f43601dd7b2
77	77	0	GBIF France	da44cd31-5901-4687-a106-6d1c7734ee3a	5c1f5ba2-91de-40d6-a761-760bf3abd53d
0	12118	12118	U.S. Geological Survey	8618c64a-93e0-4300-b546-7249e5148ed2	5c7ff628-c336-4635-9746-38d24a4607e7
0	11034	11034	GBIF Benin	efb9c00e-f802-45dd-8826-a52ec45b89ff	5d6d06a2-339a-441f-9401-914acb75fa2a
0	10	10	Plazi	ffb07bec-2d10-492d-9c37-361fe0b79427	5dd903f5-b398-4a17-83e5-364766291411
0	10	10	Plazi	ffb07bec-2d10-492d-9c37-361fe0b79427	601527d2-08fd-4b88-a3d6-92769bd43c83
245	245	0	GBIF Germany	4f6826f2-4ff6-443d-b966-e6913bd24013	6166a992-f762-11e1-a439-00145eb45e9a
3	3	0	Plazi	ffb07bec-2d10-492d-9c37-361fe0b79427	63c6c073-b7fc-4f85-a0ff-4ea15d8cc205
4	4	0	Plazi	ffb07bec-2d10-492d-9c37-361fe0b79427	642976d4-ab93-4619-9c04-816476bd29aa
1145	1145	0	Participant Node Managers Committee	7f48e0c8-5c96-49ec-b972-30748e339115	6461be2b-49e4-4a4e-a0de-a90eae602e78
15	15	0	GBIF Germany	4f6826f2-4ff6-443d-b966-e6913bd24013	64c9b016-f762-11e1-a439-00145eb45e9a
2486	2486	0	Pacific Biodiversity Information Forum	3b9510fc-5943-45d3-b08d-5b4e1e7c385e	6614b710-1dc5-11de-be11-b8a03c50a862
138	138	0	GBIF Germany	4f6826f2-4ff6-443d-b966-e6913bd24013	665be2e6-f762-11e1-a439-00145eb45e9a
144	144	0	GBIF Germany	4f6826f2-4ff6-443d-b966-e6913bd24013	67376474-f762-11e1-a439-00145eb45e9a
156	156	0	GBIF Germany	4f6826f2-4ff6-443d-b966-e6913bd24013	67da6d4a-f762-11e1-a439-00145eb45e9a
1171	1171	0	Belgian Biodiversity Platform	fb11cfe1-ebc3-45af-9159-17d9fddbcdac	67fa6403-d5c3-401b-b35d-ec70538ea41d
9	9	0	GBIF Germany	4f6826f2-4ff6-443d-b966-e6913bd24013	68eac28e-f762-11e1-a439-00145eb45e9a
79	79	0	GBIF Germany	4f6826f2-4ff6-443d-b966-e6913bd24013	692b16c2-f762-11e1-a439-00145eb45e9a
40	40	0	GBIF Brazil	cdc9736d-5ff7-4ece-9959-3c744360cdb3	6944aef2-c57f-45f6-bc04-b044fe8ae508
2838	2838	0	GBIF Portugal	673f7038-4262-4149-b753-5658a4e912f6	6a601736-7c43-4270-887c-58c3ecdb6983
1172	1172	0	GBIF France	da44cd31-5901-4687-a106-6d1c7734ee3a	6a981484-3fb0-4202-b3ac-095f07411be7
20	20	0	Plazi	ffb07bec-2d10-492d-9c37-361fe0b79427	6b1f8c1f-1ebb-46ff-a749-c773c5426015
0	6	6	Plazi	ffb07bec-2d10-492d-9c37-361fe0b79427	6b3ec79a-c3f0-4d86-80c8-7929ff32f53f
13	13	0	Plazi	ffb07bec-2d10-492d-9c37-361fe0b79427	6f963d48-83e5-4fe9-8373-34cb90bad830
8	8	0	GBIF Germany	4f6826f2-4ff6-443d-b966-e6913bd24013	6fb54846-f762-11e1-a439-00145eb45e9a
189	82	-107	GBIF Germany	4f6826f2-4ff6-443d-b966-e6913bd24013	707900e2-f762-11e1-a439-00145eb45e9a
140	134	-6	GBIF Germany	4f6826f2-4ff6-443d-b966-e6913bd24013	71171066-f762-11e1-a439-00145eb45e9a
31	31	0	GBIF Germany	4f6826f2-4ff6-443d-b966-e6913bd24013	7141aee8-f762-11e1-a439-00145eb45e9a
53	42	-11	GBIF Germany	4f6826f2-4ff6-443d-b966-e6913bd24013	722c95b6-f762-11e1-a439-00145eb45e9a
470	470	0	GBIF France	da44cd31-5901-4687-a106-6d1c7734ee3a	72ad5e8a-b82e-4bb6-a6eb-3a7114b533f5
94	94	0	Ocean Biodiversity Information System	ba0670b9-4186-41e6-8e70-f9cb3065551a	7677de14-fdde-44fa-b673-d335c571b084
0	1018	1018	Colombian Biodiversity Information System	7e865cba-7c46-417b-ade5-97f2cf5b7be0	777644eb-118c-4040-9d17-2e23cacaeaf6
0	104	104	Plazi	ffb07bec-2d10-492d-9c37-361fe0b79427	77c72766-2575-400f-9f6b-aa27987bd658
22	22	0	GBIF Germany	4f6826f2-4ff6-443d-b966-e6913bd24013	7851a47c-f762-11e1-a439-00145eb45e9a
33	33	0	Plazi	ffb07bec-2d10-492d-9c37-361fe0b79427	79099d96-0cce-480d-94e1-14d78e615ee7
92	92	0	GBIF Germany	4f6826f2-4ff6-443d-b966-e6913bd24013	7934c644-f762-11e1-a439-00145eb45e9a
15398	18615	3217	U.S. Geological Survey	8618c64a-93e0-4300-b546-7249e5148ed2	7a0fb075-53c5-470b-a1c9-579bb3147ddf
23	23	0	GBIF Germany	4f6826f2-4ff6-443d-b966-e6913bd24013	7a877d20-f762-11e1-a439-00145eb45e9a
146891	146891	0	GBIF Japan	db5705aa-6a6e-42f1-8942-d77b9f4896ea	7ae5b4c6-f762-11e1-a439-00145eb45e9a
38	38	0	Plazi	ffb07bec-2d10-492d-9c37-361fe0b79427	7bd96683-bf30-45ce-b932-cf51b278701d
3	3	0	Plazi	ffb07bec-2d10-492d-9c37-361fe0b79427	7bfcae7f-c17a-49ed-8b27-0dd9a2995bd4
813	813	0	GBIF Germany	4f6826f2-4ff6-443d-b966-e6913bd24013	7c25d096-f762-11e1-a439-00145eb45e9a
291	291	0	GBIF Germany	4f6826f2-4ff6-443d-b966-e6913bd24013	7c441c85-aaba-4775-87b0-180e1afa7e53
444	385	-59	GBIF Germany	4f6826f2-4ff6-443d-b966-e6913bd24013	7c7dd412-f762-11e1-a439-00145eb45e9a
32640	32640	0	GBIF Portugal	673f7038-4262-4149-b753-5658a4e912f6	7cdb0b34-ac56-454a-b4b3-38f5bb905fd5
192	192	0	Biodiversity Information System of Mexico	b324e8e9-9a4c-44fa-8f1a-7f39ea7ab576	7d02d2e8-657a-4a41-b563-0792cff4cecf
0	27	27	Plazi	ffb07bec-2d10-492d-9c37-361fe0b79427	7df98a98-71ab-478e-a1ad-4e193fdff912
18	18	0	GBIF Germany	4f6826f2-4ff6-443d-b966-e6913bd24013	7e3d8766-f762-11e1-a439-00145eb45e9a
533	580	47	GBIF Germany	4f6826f2-4ff6-443d-b966-e6913bd24013	7ee5753e-f762-11e1-a439-00145eb45e9a
0	23	23	Ocean Biodiversity Information System	ba0670b9-4186-41e6-8e70-f9cb3065551a	7f146b88-6ce5-4dc3-82aa-df11d96bdfca
5089	5089	0	GBIF Malawi	2a42e4d7-ad4a-41b3-84c4-de4aa7b74d35	7f1dc982-02f3-4ae7-8fe8-d2cf6d079ccd
36	36	0	Plazi	ffb07bec-2d10-492d-9c37-361fe0b79427	7f7f36b4-db90-4f32-a034-4ff4502d24c3
61127	60862	-265	Biodiversity Information System of Mexico	b324e8e9-9a4c-44fa-8f1a-7f39ea7ab576	7feba584-f762-11e1-a439-00145eb45e9a
1225	1225	0	GBIF Germany	4f6826f2-4ff6-443d-b966-e6913bd24013	814efdd6-f762-11e1-a439-00145eb45e9a
55	55	0	GBIF Germany	4f6826f2-4ff6-443d-b966-e6913bd24013	818c7dc8-f762-11e1-a439-00145eb45e9a
2	2	0	Plazi	ffb07bec-2d10-492d-9c37-361fe0b79427	81a36e5a-fa4f-49e3-a070-d73f7c1668f6
1350	1375	25	GBIF Germany	4f6826f2-4ff6-443d-b966-e6913bd24013	81b15b34-f762-11e1-a439-00145eb45e9a
0	10	10	Plazi	ffb07bec-2d10-492d-9c37-361fe0b79427	833b0f76-aa56-46c0-a9ba-3652e981cb68
156	156	0	GBIF Benin	efb9c00e-f802-45dd-8826-a52ec45b89ff	8357bd0a-8bd6-44ce-a448-74985e7d7293
4015	4015	0	GBIF Spain	1f94b3ca-9345-4d65-afe2-4bace93aa0fe	837e52dc-f762-11e1-a439-00145eb45e9a
877586	969060	91474	DanBIF - Danish Biodiversity Information Facility	4ddd294f-02b7-4359-ac33-0806a9ca9c6b	84d26682-f762-11e1-a439-00145eb45e9a
3477	3477	0	Colombian Biodiversity Information System	7e865cba-7c46-417b-ade5-97f2cf5b7be0	86edb965-2c51-4298-b527-2fa75c2d58e4
602	602	0	GBIF Germany	4f6826f2-4ff6-443d-b966-e6913bd24013	8a7f6b0c-f762-11e1-a439-00145eb45e9a
76	76	0	GBIF Germany	4f6826f2-4ff6-443d-b966-e6913bd24013	8bba098c-f762-11e1-a439-00145eb45e9a
1	1	0	GBIF Germany	4f6826f2-4ff6-443d-b966-e6913bd24013	8cc41f84-f762-11e1-a439-00145eb45e9a
1	1	0	GBIF Germany	4f6826f2-4ff6-443d-b966-e6913bd24013	8cdfb29e-f762-11e1-a439-00145eb45e9a
476	476	0	South African Biodiversity Information Facility	7190b835-4e86-4b6e-85c1-19cc6677c250	8d543818-fd03-4f36-954b-e2874f4b5a0b
150	120	-30	GBIF Germany	4f6826f2-4ff6-443d-b966-e6913bd24013	8d67ff32-f762-11e1-a439-00145eb45e9a
933208	933208	0	DanBIF - Danish Biodiversity Information Facility	4ddd294f-02b7-4359-ac33-0806a9ca9c6b	8df9af24-1fbd-4699-a545-9a2867ff25fe
5503	5503	0	GBIF Finland	dd514216-5c7c-45f3-910d-797424cb5be6	8e08523b-4f29-4cb7-b4c4-ff673ee09b9b
0	623	623	Participant Node Managers Committee	7f48e0c8-5c96-49ec-b972-30748e339115	8e3c688d-9e44-488c-9fb3-89618fd185d7
283	201	-82	GBIF Germany	4f6826f2-4ff6-443d-b966-e6913bd24013	8e75c6ac-f762-11e1-a439-00145eb45e9a
1015	592	-423	GBIF Germany	4f6826f2-4ff6-443d-b966-e6913bd24013	90961db0-f762-11e1-a439-00145eb45e9a
40	26	-14	GBIF Germany	4f6826f2-4ff6-443d-b966-e6913bd24013	913ad6de-f762-11e1-a439-00145eb45e9a
209740	209740	0	National Biodiversity Network	d897a5b9-35ee-4232-94bd-b0bcaac003c2	921ae6e9-d890-4826-b6ff-aef43cdcb409
2	2	0	Plazi	ffb07bec-2d10-492d-9c37-361fe0b79427	92a4d7d5-ef3f-4aa1-802c-51f316f7f113
12398	12398	0	National Biodiversity Network	d897a5b9-35ee-4232-94bd-b0bcaac003c2	93744ccf-f8b7-4652-ae35-cff1b899a6a7
2	2	0	GBIF Germany	4f6826f2-4ff6-443d-b966-e6913bd24013	93820610-f762-11e1-a439-00145eb45e9a
2	5	3	U.S. Geological Survey	8618c64a-93e0-4300-b546-7249e5148ed2	94b543f1-1dad-4434-a2f4-6beed9be8b71
0	19	19	Plazi	ffb07bec-2d10-492d-9c37-361fe0b79427	95382da1-de88-4f01-b5b9-5232bb2bdf37
130505	136683	6178	GBIF Germany	4f6826f2-4ff6-443d-b966-e6913bd24013	966426ce-f762-11e1-a439-00145eb45e9a
0	4212	4212	U.S. Geological Survey	8618c64a-93e0-4300-b546-7249e5148ed2	9aba7c73-533c-4366-a984-061fec0ebed7
4	4	0	Plazi	ffb07bec-2d10-492d-9c37-361fe0b79427	9dc40601-3490-4a5f-b56e-00ce03fbeaa7
965	965	0	GBIF Germany	4f6826f2-4ff6-443d-b966-e6913bd24013	a116559e-1ed9-4340-b490-1eb12ea3fd22
0	3	3	Plazi	ffb07bec-2d10-492d-9c37-361fe0b79427	a1ce0f78-f04f-45bb-a52b-95eb3fbb5dee
5	5	0	Plazi	ffb07bec-2d10-492d-9c37-361fe0b79427	a2533170-b900-4d5a-9ce4-feb70e66daa3
585	585	0	GBIF France	da44cd31-5901-4687-a106-6d1c7734ee3a	a39def5b-57a0-47e9-814d-ad778131254f
3	3	0	Plazi	ffb07bec-2d10-492d-9c37-361fe0b79427	a3a0ed95-6968-4792-b451-81d8acba882e
0	121	121	Colombian Biodiversity Information System	7e865cba-7c46-417b-ade5-97f2cf5b7be0	a51b1fb9-6e67-42b9-879b-5f21e4d85642
173	173	0	Participant Node Managers Committee	7f48e0c8-5c96-49ec-b972-30748e339115	a65807ea-c9e7-4173-8ed2-8c41e1b3a0fe
287	287	0	Plazi	ffb07bec-2d10-492d-9c37-361fe0b79427	a7f36fd8-5c40-4232-bee1-33b4c6528a0c
220	220	0	GBIF Germany	4f6826f2-4ff6-443d-b966-e6913bd24013	a800dea1-f88e-4654-ac19-ca2e27ff4677
1	1	0	Plazi	ffb07bec-2d10-492d-9c37-361fe0b79427	a9faf3de-5a4d-4674-93f2-4bfcdd94b0fd
4	4	0	Plazi	ffb07bec-2d10-492d-9c37-361fe0b79427	aa0db457-960f-417f-865e-89252373960b
77	77	0	Biodiversity Information System of Mexico	b324e8e9-9a4c-44fa-8f1a-7f39ea7ab576	ac61c890-7d55-4a60-bb9b-3de5550e8eee
680090	680090	0	GBIF France	da44cd31-5901-4687-a106-6d1c7734ee3a	af0c7238-b6c5-4a4d-9fa7-7fb94516d0bc
0	81	81	Participant Node Managers Committee	7f48e0c8-5c96-49ec-b972-30748e339115	b1978713-12d5-4a4a-ba14-29cf79fb3751
601	601	0	Biodiversity Information System of Mexico	b324e8e9-9a4c-44fa-8f1a-7f39ea7ab576	b76c7793-e18b-4825-9232-a20eff625cc2
85	85	0	Plazi	ffb07bec-2d10-492d-9c37-361fe0b79427	b7e93c79-44a6-4d9c-8b78-dcb62033fb0d
0	3	3	Plazi	ffb07bec-2d10-492d-9c37-361fe0b79427	bb85247a-5f3d-482c-96a5-23552bdd848e
400	400	0	GBIF Japan	db5705aa-6a6e-42f1-8942-d77b9f4896ea	be906189-e80e-4fbc-b675-af1834558503
0	1	1	Plazi	ffb07bec-2d10-492d-9c37-361fe0b79427	c17c41d2-55c6-4274-9ae9-945fe832a886
0	5	5	Ocean Biodiversity Information System	ba0670b9-4186-41e6-8e70-f9cb3065551a	c1d45276-21d6-4c82-8e06-e5accc14f238
112	112	0	U.S. Geological Survey	8618c64a-93e0-4300-b546-7249e5148ed2	c1e163c3-30f4-4230-a551-bbfc0677853e
263	263	0	Colombian Biodiversity Information System	7e865cba-7c46-417b-ade5-97f2cf5b7be0	c1f304a0-6e43-4fc4-8a12-ab55b732d72f
90	90	0	Plazi	ffb07bec-2d10-492d-9c37-361fe0b79427	c36bd7d3-dbbf-4070-baaf-01783a413fa6
7	7	0	Plazi	ffb07bec-2d10-492d-9c37-361fe0b79427	c423acaf-5168-4364-b614-8681ab11169c
3010	3330	320	Colombian Biodiversity Information System	7e865cba-7c46-417b-ade5-97f2cf5b7be0	c59e89fc-2fec-4fd8-8c3c-073843eb6441
2	2	0	Plazi	ffb07bec-2d10-492d-9c37-361fe0b79427	c5a38230-2c50-4d80-9aa9-876d7f687b54
46	46	0	Plazi	ffb07bec-2d10-492d-9c37-361fe0b79427	c5f1a337-0059-4c38-9cf2-1cd57827909e
0	2000	2000	GBIF Japan	db5705aa-6a6e-42f1-8942-d77b9f4896ea	c6669979-6952-4910-b4b1-d9677a1d3c4b
10	10	0	Colombian Biodiversity Information System	7e865cba-7c46-417b-ade5-97f2cf5b7be0	c7090ced-91f1-4463-ae0e-69a83f2f82b9
0	3	3	Plazi	ffb07bec-2d10-492d-9c37-361fe0b79427	c7d219a6-ef1b-49a8-ae63-c24bdba57173
1	1	0	Plazi	ffb07bec-2d10-492d-9c37-361fe0b79427	c97016b0-24b2-404d-b54d-f85e04d55672
7	7	0	Participant Node Managers Committee	7f48e0c8-5c96-49ec-b972-30748e339115	c9c44f90-8141-400d-8709-08bc1762d808
0	8	8	Plazi	ffb07bec-2d10-492d-9c37-361fe0b79427	d083a11c-b019-438b-8a97-8a03f91e5a8c
326	26	-300	Biodiversity Information System of Mexico	b324e8e9-9a4c-44fa-8f1a-7f39ea7ab576	d54974b5-c680-44fa-b82a-9f84148d46b5
296	234	-62	GBIF Germany	4f6826f2-4ff6-443d-b966-e6913bd24013	d5824726-1a60-4131-a0a9-233a154db2cf
0	25	25	Plazi	ffb07bec-2d10-492d-9c37-361fe0b79427	dabcdcb7-4070-423d-b6b4-29ade9b10a54
4	4	0	Plazi	ffb07bec-2d10-492d-9c37-361fe0b79427	db432b11-0927-494f-af83-23ded68c5706
0	1	1	Plazi	ffb07bec-2d10-492d-9c37-361fe0b79427	dbbb0b74-219c-442d-b8ae-6c80250364a9
0	3	3	Plazi	ffb07bec-2d10-492d-9c37-361fe0b79427	dcdbd97b-4319-4b8b-b036-41fb901fc36b
164159	164159	0	National Biodiversity Network	d897a5b9-35ee-4232-94bd-b0bcaac003c2	df4787e0-161f-44ae-9dc6-10cf76d7c4d5
0	70705	70705	Ocean Biodiversity Information System	ba0670b9-4186-41e6-8e70-f9cb3065551a	e152d1e3-dac6-4165-92fa-d965bcb473fa
726	726	0	Colombian Biodiversity Information System	7e865cba-7c46-417b-ade5-97f2cf5b7be0	e5b03456-78b2-4ceb-8d3e-3a6860c23d03
0	3	3	Plazi	ffb07bec-2d10-492d-9c37-361fe0b79427	e73ba3d2-d277-4320-8c74-70d81d61986f
97	97	0	GBIF Sweden	a0b3be64-6525-4387-ac67-a499950f92e1	e88fd06f-49f9-477c-afd4-7373d0ed2444
2	2	0	Participant Node Managers Committee	7f48e0c8-5c96-49ec-b972-30748e339115	e95d43d3-e6e4-49b0-8473-6c0608c7c768
5	5	0	Plazi	ffb07bec-2d10-492d-9c37-361fe0b79427	ea6ba28f-024d-4115-a4b0-6aa0c06521fd
9	9	0	Plazi	ffb07bec-2d10-492d-9c37-361fe0b79427	ec6004e3-6ec6-40e7-8832-2344baf1bd63
43	43	0	Plazi	ffb07bec-2d10-492d-9c37-361fe0b79427	ed2a9e9b-1fb7-486b-a2c4-9d0f6ff392e5
104	104	0	Plazi	ffb07bec-2d10-492d-9c37-361fe0b79427	ef99bdcd-19cd-4ebf-9e4c-74d532fd2a66
105	105	0	Plazi	ffb07bec-2d10-492d-9c37-361fe0b79427	f20000df-2649-402a-a27b-127d8f94e681
34	34	0	GBIF Guinea	b1cd2e84-c4ba-47bd-b72a-dfd1f92dce0a	f4f109b3-df2e-48ac-9809-adae80033ec4
0	26	26	Plazi	ffb07bec-2d10-492d-9c37-361fe0b79427	f53aac91-e701-4129-a0dc-a9fcb282fddf
0	98	98	Plazi	ffb07bec-2d10-492d-9c37-361fe0b79427	f551439a-a5a5-4123-9fb5-a8dbecb0d6de
0	7078	7078	National Biodiversity Network	d897a5b9-35ee-4232-94bd-b0bcaac003c2	f5815965-adce-4f6a-a56c-af93032b7e3f
157	157	0	Plazi	ffb07bec-2d10-492d-9c37-361fe0b79427	f59e1e92-ed51-43e7-8a5b-6b12f19b37e2
0	1	1	Plazi	ffb07bec-2d10-492d-9c37-361fe0b79427	f60d2dcc-f293-423c-9c89-1490c5a2537b
2	2	0	Plazi	ffb07bec-2d10-492d-9c37-361fe0b79427	f9db7b4c-11e2-4abb-86a0-8217d52cb61c
0	32	32	Colombian Biodiversity Information System	7e865cba-7c46-417b-ade5-97f2cf5b7be0	fd1a0357-23ee-4ea8-9cab-24cc8c0fa313
0	2	2	Plazi	ffb07bec-2d10-492d-9c37-361fe0b79427	033bd93a-75a8-4dda-8a42-0f7f551f099b
118	172	54	National Biodiversity Network	d897a5b9-35ee-4232-94bd-b0bcaac003c2	053cc2c4-c0c9-4024-8cdb-9f45b93700bf
4	4	0	Plazi	ffb07bec-2d10-492d-9c37-361fe0b79427	0944f359-f71a-4070-9513-9be3325abc60
31	31	0	Plazi	ffb07bec-2d10-492d-9c37-361fe0b79427	0973fa16-cbab-4b38-b71c-8eb6e086dd1a
8445	8445	0	National Biodiversity Network	d897a5b9-35ee-4232-94bd-b0bcaac003c2	0c8a1eba-904f-4ed9-aef2-44b3acb00351
56471	56471	0	GBIF France	da44cd31-5901-4687-a106-6d1c7734ee3a	1876c0d1-bc99-42e6-bf9e-f9e4831023e0
461	461	0	National Biodiversity Network	d897a5b9-35ee-4232-94bd-b0bcaac003c2	1eb3c7fa-412f-4c74-9831-9865ab216674
18	23	5	GBIF Japan	db5705aa-6a6e-42f1-8942-d77b9f4896ea	1f1c8776-ab46-40a2-85d7-97fb4d6391aa
72	72	0	GBIF Sweden	a0b3be64-6525-4387-ac67-a499950f92e1	1ff55956-e56b-447e-9797-4f30a13ba7d5
7	7	0	GBIF Argentina	2426a871-9feb-40a1-96c6-0c593a76b835	202a2719-84d9-4c7d-8023-3e951cc74b5c
2	2	0	Plazi	ffb07bec-2d10-492d-9c37-361fe0b79427	212c015f-e802-486a-a79b-8f93801adbf6
68791	68791	0	GBIF Portugal	673f7038-4262-4149-b753-5658a4e912f6	231c5bcf-1b56-4905-a398-6d0e18f6de1a
3534	3534	0	GBIF Germany	4f6826f2-4ff6-443d-b966-e6913bd24013	2349b8d4-0de1-4e64-b186-b00a5dc60a8a
0	4	4	Plazi	ffb07bec-2d10-492d-9c37-361fe0b79427	26cfc499-2c62-46f8-bd6a-364a3d4123a4
2	2	0	Plazi	ffb07bec-2d10-492d-9c37-361fe0b79427	28928d07-ffe7-4d70-9e03-4acdbcab45b3
0	1	1	Plazi	ffb07bec-2d10-492d-9c37-361fe0b79427	2a65779f-e493-49a5-bd6a-d0b9accbe2fd
53	53	0	U.S. Geological Survey	8618c64a-93e0-4300-b546-7249e5148ed2	2abba580-96a7-4a7c-bef9-84764f755408
467	467	0	GBIF France	da44cd31-5901-4687-a106-6d1c7734ee3a	2e0b1a39-0143-45b8-aeee-e0fbc73845a8
16664	16664	0	Participant Node Managers Committee	7f48e0c8-5c96-49ec-b972-30748e339115	2f41cb78-04a3-4322-ab2d-1eaa2c296aa4
12572	12572	0	GBIF Togo	c9659a3e-07e9-4fcb-83c6-de8b9009a02e	3294d36a-987c-4dcb-8ecf-bd2082796f08
3	3	0	Plazi	ffb07bec-2d10-492d-9c37-361fe0b79427	36151b6a-2a79-4690-9027-aa0f7c704e23
230	230	0	GBIF France	da44cd31-5901-4687-a106-6d1c7734ee3a	361974e1-ce5b-43b8-aa23-4da0d541cc3c
32	32	0	Ocean Biodiversity Information System	ba0670b9-4186-41e6-8e70-f9cb3065551a	3a288cf3-4038-4759-a2d9-4541b10e41e3
4707	4707	0	GBIF Argentina	2426a871-9feb-40a1-96c6-0c593a76b835	3cc9ba97-17dc-4a4a-8a12-bb36038021c4
840	840	0	Belgian Biodiversity Platform	fb11cfe1-ebc3-45af-9159-17d9fddbcdac	3f8c4aec-388f-487a-90fd-1db7ae56e4fc
801	801	0	Colombian Biodiversity Information System	7e865cba-7c46-417b-ade5-97f2cf5b7be0	40a8aeb8-cf10-40b8-878d-54e6804ae9f9
236488	236488	0	U.S. Geological Survey	8618c64a-93e0-4300-b546-7249e5148ed2	41fc5c40-5e81-496f-9733-6b5681b3b7a5
646	643	-3	Participant Node Managers Committee	7f48e0c8-5c96-49ec-b972-30748e339115	42a55f11-4aeb-46cd-b7e0-b6cff2eef92b
151886	136756	-15130	U.S. Geological Survey	8618c64a-93e0-4300-b546-7249e5148ed2	44fb5823-c1f5-4ac7-8e06-795a09a138f2
150	150	0	GBIF Germany	4f6826f2-4ff6-443d-b966-e6913bd24013	4851e742-2e08-4f7f-80a0-1aebeba63dbc
23	23	0	Atlas of Living Australia	4a6f1b71-969e-4fc5-a693-282b05e1220c	4a2fdba3-6aa5-4a28-b0f3-ae8f1a0aa532
0	10951	10951	Ocean Biodiversity Information System	ba0670b9-4186-41e6-8e70-f9cb3065551a	4b1e7a5e-7bc8-4c22-81c6-0c37583a244b
8	8	0	Plazi	ffb07bec-2d10-492d-9c37-361fe0b79427	4dac0eec-895f-4cf5-b86e-367198d2ba9a
3	3	0	Participant Node Managers Committee	7f48e0c8-5c96-49ec-b972-30748e339115	4f13c7c8-532c-48ca-bc84-9dc2b289685d
9657	9657	0	GBIF France	da44cd31-5901-4687-a106-6d1c7734ee3a	52706381-1873-4712-b567-30deecde79fa
8	8	0	Participant Node Managers Committee	7f48e0c8-5c96-49ec-b972-30748e339115	5386431c-613e-4568-b9ec-053fba9bda18
3	3	0	Plazi	ffb07bec-2d10-492d-9c37-361fe0b79427	555f42f9-9135-45a6-b7aa-c0b4c064c7db
108267	108267	0	National Biodiversity Network	d897a5b9-35ee-4232-94bd-b0bcaac003c2	56142378-96f1-481a-b54e-9c75bc7712d0
9259	9259	0	GBIF Benin	efb9c00e-f802-45dd-8826-a52ec45b89ff	563a2a42-3e49-456a-806e-153213f6e097
556	556	0	GBIF Germany	4f6826f2-4ff6-443d-b966-e6913bd24013	5754271b-88f5-4bc2-9c07-32649a96bd70
6	6	0	Plazi	ffb07bec-2d10-492d-9c37-361fe0b79427	58c56caa-1771-41ea-86c5-7cf35f953108
46	46	0	Plazi	ffb07bec-2d10-492d-9c37-361fe0b79427	5916d93e-11d4-49c5-8085-8bcd37d3739b
0	32437	32437	Colombian Biodiversity Information System	7e865cba-7c46-417b-ade5-97f2cf5b7be0	5aa8c4ed-3df2-4179-8e6a-16222f2dbe1c
3	3	0	Plazi	ffb07bec-2d10-492d-9c37-361fe0b79427	5b3eb44b-2b98-4894-bd0f-2d7888e11b37
106	106	0	Plazi	ffb07bec-2d10-492d-9c37-361fe0b79427	5b403f82-4758-4aa4-8f1e-39df79ca4e23
121	115	-6	GBIF Germany	4f6826f2-4ff6-443d-b966-e6913bd24013	5c4a3ff9-b0a6-4c14-a9cf-b3d14cebc5ad
3109	3109	0	GBIF France	da44cd31-5901-4687-a106-6d1c7734ee3a	5d10f2d4-c995-49cd-85a9-a79153d68020
29	29	0	Plazi	ffb07bec-2d10-492d-9c37-361fe0b79427	5d5945e4-d636-44c0-84eb-7eb926b1b91a
29764	38572	8808	GBIF Norway	4f829580-180d-46a9-9c87-ed8ec959b545	609217ee-054d-441d-a850-356cbc2fb385
118	118	0	GBIF Germany	4f6826f2-4ff6-443d-b966-e6913bd24013	6112270a-f762-11e1-a439-00145eb45e9a
34	34	0	GBIF Germany	4f6826f2-4ff6-443d-b966-e6913bd24013	61e8d2aa-f762-11e1-a439-00145eb45e9a
881	881	0	GBIF Portugal	673f7038-4262-4149-b753-5658a4e912f6	622f5dd7-f626-4364-9932-ce785cacd9ec
35	35	0	Plazi	ffb07bec-2d10-492d-9c37-361fe0b79427	6240929e-7b36-4e0f-8222-f03bcbb9ab6e
135	135	0	GBIF Germany	4f6826f2-4ff6-443d-b966-e6913bd24013	6347fffe-f762-11e1-a439-00145eb45e9a
0	2	2	Plazi	ffb07bec-2d10-492d-9c37-361fe0b79427	65d0e599-a276-4b59-b68f-3efa9624ea34
715	720	5	GBIF Germany	4f6826f2-4ff6-443d-b966-e6913bd24013	6612e3c0-f762-11e1-a439-00145eb45e9a
22	22	0	GBIF Germany	4f6826f2-4ff6-443d-b966-e6913bd24013	661b86d8-f762-11e1-a439-00145eb45e9a
2541	2541	0	GBIF Argentina	2426a871-9feb-40a1-96c6-0c593a76b835	6735107a-7cc6-47b9-b66a-ff667a50f497
9	9	0	Plazi	ffb07bec-2d10-492d-9c37-361fe0b79427	67a26273-5dd3-49d5-a963-7269c8284987
3	3	0	Plazi	ffb07bec-2d10-492d-9c37-361fe0b79427	68749531-5011-4ec9-93e5-f48416d0843f
583	583	0	GBIF Germany	4f6826f2-4ff6-443d-b966-e6913bd24013	696d2198-f762-11e1-a439-00145eb45e9a
1	1	0	Plazi	ffb07bec-2d10-492d-9c37-361fe0b79427	69f4b5c3-9946-4478-bbbf-75adecb4ba0a
32	32	0	GBIF Germany	4f6826f2-4ff6-443d-b966-e6913bd24013	6b6cb5e4-f762-11e1-a439-00145eb45e9a
12	12	0	GBIF Germany	4f6826f2-4ff6-443d-b966-e6913bd24013	6bb30c6a-f762-11e1-a439-00145eb45e9a
2116	2116	0	GBIF France	da44cd31-5901-4687-a106-6d1c7734ee3a	6e34a84f-fb9c-49bd-bd78-b3988bc70d03
7	7	0	GBIF Germany	4f6826f2-4ff6-443d-b966-e6913bd24013	6f8cbd86-f762-11e1-a439-00145eb45e9a
4	4	0	GBIF Germany	4f6826f2-4ff6-443d-b966-e6913bd24013	6fc1d8d6-f762-11e1-a439-00145eb45e9a
8	8	0	GBIF Germany	4f6826f2-4ff6-443d-b966-e6913bd24013	6fce02f0-f762-11e1-a439-00145eb45e9a
77	77	0	GBIF Germany	4f6826f2-4ff6-443d-b966-e6913bd24013	70b78eca-f762-11e1-a439-00145eb45e9a
115	115	0	GBIF Germany	4f6826f2-4ff6-443d-b966-e6913bd24013	70f25a46-f762-11e1-a439-00145eb45e9a
63	63	0	GBIF Germany	4f6826f2-4ff6-443d-b966-e6913bd24013	718cfed4-f762-11e1-a439-00145eb45e9a
1	1	0	Plazi	ffb07bec-2d10-492d-9c37-361fe0b79427	71d0759f-cb83-4eda-855b-afdc3d1d2c9e
503	503	0	GBIF Germany	4f6826f2-4ff6-443d-b966-e6913bd24013	7206c19c-f762-11e1-a439-00145eb45e9a
911	911	0	GBIF Germany	4f6826f2-4ff6-443d-b966-e6913bd24013	7231732e-f762-11e1-a439-00145eb45e9a
177	156	-21	GBIF Germany	4f6826f2-4ff6-443d-b966-e6913bd24013	7456f9ac-3dfd-4427-b15e-532cecca811a
34	32	-2	GBIF Germany	4f6826f2-4ff6-443d-b966-e6913bd24013	75831ece-f762-11e1-a439-00145eb45e9a
117	117	0	GBIF Germany	4f6826f2-4ff6-443d-b966-e6913bd24013	75ac87a0-f762-11e1-a439-00145eb45e9a
2	2	0	Plazi	ffb07bec-2d10-492d-9c37-361fe0b79427	761bbdff-7cc0-4940-a666-28a3a302f5e4
3	3	0	Plazi	ffb07bec-2d10-492d-9c37-361fe0b79427	7685b37e-a8b5-4d0c-b048-c6d3b640c3c5
0	2	2	Plazi	ffb07bec-2d10-492d-9c37-361fe0b79427	78522be2-86e2-49d7-a083-0a229bfa9755
24	24	0	GBIF Germany	4f6826f2-4ff6-443d-b966-e6913bd24013	7852fb9c-f762-11e1-a439-00145eb45e9a
34	34	0	Plazi	ffb07bec-2d10-492d-9c37-361fe0b79427	78871bd6-f4f5-4104-a5f6-f333d3054bec
153	153	0	GBIF Germany	4f6826f2-4ff6-443d-b966-e6913bd24013	78bd5d0c-f762-11e1-a439-00145eb45e9a
24	24	0	GBIF Germany	4f6826f2-4ff6-443d-b966-e6913bd24013	7c192bb6-f762-11e1-a439-00145eb45e9a
203	109	-94	GBIF Germany	4f6826f2-4ff6-443d-b966-e6913bd24013	7e1518e4-f762-11e1-a439-00145eb45e9a
569	569	0	Biodiversity Information System of Mexico	b324e8e9-9a4c-44fa-8f1a-7f39ea7ab576	7f9d5a5a-f762-11e1-a439-00145eb45e9a
16336	16336	0	Tanzania Biodiversity Information Facility	abd95ca6-3959-4db9-aaa6-2de1aeecf514	7fa4ed8c-e879-465f-acd2-2e65f398cc96
0	17244	17244	Colombian Biodiversity Information System	7e865cba-7c46-417b-ade5-97f2cf5b7be0	7fbc7c55-1468-4163-85dd-29aa7fa85254
5	5	0	Plazi	ffb07bec-2d10-492d-9c37-361fe0b79427	7fc3c435-d3ed-45db-bd7d-48398d831f01
0	3	3	Plazi	ffb07bec-2d10-492d-9c37-361fe0b79427	856145fd-eda5-422c-a5e8-c1665d57bf3d
3570	3570	0	GBIF France	da44cd31-5901-4687-a106-6d1c7734ee3a	860ebeef-240a-455c-997c-bd0e79806f26
3231	2285	-946	Atlas of Living Australia	4a6f1b71-969e-4fc5-a693-282b05e1220c	86442d3e-f762-11e1-a439-00145eb45e9a
52873	57873	5000	GBIF Japan	db5705aa-6a6e-42f1-8942-d77b9f4896ea	8684bbe2-f762-11e1-a439-00145eb45e9a
2029	1886	-143	GBIF Germany	4f6826f2-4ff6-443d-b966-e6913bd24013	870e8caa-f762-11e1-a439-00145eb45e9a
2	2	0	Plazi	ffb07bec-2d10-492d-9c37-361fe0b79427	8799e916-86ad-4a46-951a-885bb61c4cf8
18460	18482	22	U.S. Geological Survey	8618c64a-93e0-4300-b546-7249e5148ed2	88d8974c-f762-11e1-a439-00145eb45e9a
19	19	0	Ocean Biodiversity Information System	ba0670b9-4186-41e6-8e70-f9cb3065551a	8916f050-f762-11e1-a439-00145eb45e9a
2095	794	-1301	GBIF Germany	4f6826f2-4ff6-443d-b966-e6913bd24013	894316bc-f762-11e1-a439-00145eb45e9a
5	5	0	Plazi	ffb07bec-2d10-492d-9c37-361fe0b79427	8a217c82-c8c9-4341-bf51-7483b6558a46
91	91	0	GBIF Germany	4f6826f2-4ff6-443d-b966-e6913bd24013	8c2a2550-f762-11e1-a439-00145eb45e9a
3	3	0	Plazi	ffb07bec-2d10-492d-9c37-361fe0b79427	8cab214b-bc27-488b-a184-267eb1d0f58e
46	46	0	Plazi	ffb07bec-2d10-492d-9c37-361fe0b79427	8d3a91d3-f83e-42ce-be3e-e4fda29c52a7
16	9	-7	GBIF Germany	4f6826f2-4ff6-443d-b966-e6913bd24013	8d439750-f762-11e1-a439-00145eb45e9a
163	163	0	GBIF France	da44cd31-5901-4687-a106-6d1c7734ee3a	8ed6732e-c1bb-4558-b258-34eef1584c89
4641	4277	-364	GBIF Germany	4f6826f2-4ff6-443d-b966-e6913bd24013	8f0564ce-f762-11e1-a439-00145eb45e9a
6	6	0	Plazi	ffb07bec-2d10-492d-9c37-361fe0b79427	8f136b20-3354-4c4c-9a1a-177459e45962
0	1	1	Plazi	ffb07bec-2d10-492d-9c37-361fe0b79427	8f452bde-ac26-4ddc-9d1b-7f3cd622a6b2
19950	19950	0	U.S. Geological Survey	8618c64a-93e0-4300-b546-7249e5148ed2	900a5b09-234c-4c60-8422-87ecc61c01fb
36	18	-18	GBIF Germany	4f6826f2-4ff6-443d-b966-e6913bd24013	909761a2-f762-11e1-a439-00145eb45e9a
77	77	0	GBIF Germany	4f6826f2-4ff6-443d-b966-e6913bd24013	93618a0c-f762-11e1-a439-00145eb45e9a
77	65	-12	GBIF Germany	4f6826f2-4ff6-443d-b966-e6913bd24013	936ddb90-f762-11e1-a439-00145eb45e9a
8	8	0	GBIF Germany	4f6826f2-4ff6-443d-b966-e6913bd24013	93dd9ba6-f762-11e1-a439-00145eb45e9a
5576	5576	0	National Biodiversity Network	d897a5b9-35ee-4232-94bd-b0bcaac003c2	9550c2bf-29ae-44cf-b691-1aa514785df0
4	4	0	Plazi	ffb07bec-2d10-492d-9c37-361fe0b79427	99ca680a-4cc1-42d0-82e8-e686851d3f0c
1872	1872	0	South African Biodiversity Information Facility	7190b835-4e86-4b6e-85c1-19cc6677c250	9b39760c-6b42-468e-9059-9f1a5d65f490
892	892	0	GBIF Brazil	cdc9736d-5ff7-4ece-9959-3c744360cdb3	9c48ee0b-404a-4c84-9af0-946eef39ddca
1429	1429	0	Atlas of Living Australia	4a6f1b71-969e-4fc5-a693-282b05e1220c	9c584871-a0c0-42f4-8ab5-e7ac74fd1e9f
0	28	28	Plazi	ffb07bec-2d10-492d-9c37-361fe0b79427	9e4b8160-11b2-4bcd-bcbf-2604a74c7d7f
235	235	0	GBIF France	da44cd31-5901-4687-a106-6d1c7734ee3a	9e84be57-3b59-4486-99d7-26f260cfb1ad
0	15	15	Plazi	ffb07bec-2d10-492d-9c37-361fe0b79427	a04a207e-141e-424f-bb72-d37cba24a72b
41	41	0	Plazi	ffb07bec-2d10-492d-9c37-361fe0b79427	a0a76453-f5d6-4758-8545-7ce2a6e0b092
0	636	636	GBIF Portugal	673f7038-4262-4149-b753-5658a4e912f6	a1bac6a0-65d1-4bb0-a533-3ca5d185c0b7
0	1	1	Participant Node Managers Committee	7f48e0c8-5c96-49ec-b972-30748e339115	a1db563f-aa28-47d4-9fe8-cfd47aea3d2c
282695	295113	12418	U.S. Geological Survey	8618c64a-93e0-4300-b546-7249e5148ed2	a36438d0-bec7-4b7b-9bfa-2c31e7610c39
7404	7404	0	National Biodiversity Network	d897a5b9-35ee-4232-94bd-b0bcaac003c2	ad73fa3b-cc93-4709-a41d-dbac4ac3d21d
1538	1538	0	Colombian Biodiversity Information System	7e865cba-7c46-417b-ade5-97f2cf5b7be0	aea58d1a-8d3a-484c-b186-bd2af003bfde
5	5	0	Plazi	ffb07bec-2d10-492d-9c37-361fe0b79427	af31502e-3df0-4f1a-bea6-e24ed3f38a88
0	5452	5452	GBIF Argentina	2426a871-9feb-40a1-96c6-0c593a76b835	b317a7f6-3171-4aec-b6d8-4b9d61716a9e
378	378	0	GBIF Norway	4f829580-180d-46a9-9c87-ed8ec959b545	b848f1f3-3955-4725-8ad8-e711e4a9e0ac
19	19	0	Plazi	ffb07bec-2d10-492d-9c37-361fe0b79427	baa8b9ec-6032-4ccd-b538-4d772e9701e4
1497	1497	0	Biodiversity Information System of Mexico	b324e8e9-9a4c-44fa-8f1a-7f39ea7ab576	bc9f6237-f373-493a-a783-11b0c5eca844
70	70	0	Plazi	ffb07bec-2d10-492d-9c37-361fe0b79427	be14260a-1914-45f2-aa02-bcf5028b7a24
505	505	0	GBIF France	da44cd31-5901-4687-a106-6d1c7734ee3a	be4cfdac-95b7-4eba-8ebc-c8892e703201
0	1	1	Plazi	ffb07bec-2d10-492d-9c37-361fe0b79427	c033fd50-8671-41a6-aaca-eeb2a9e97e70
0	1532	1532	Belgian Biodiversity Platform	fb11cfe1-ebc3-45af-9159-17d9fddbcdac	c3fb1eb1-7ff8-439a-b244-3152af5c270a
139	139	0	GBIF France	da44cd31-5901-4687-a106-6d1c7734ee3a	c4356fc0-83fa-4542-b754-d32471e67348
7967	7967	0	Participant Node Managers Committee	7f48e0c8-5c96-49ec-b972-30748e339115	c61f14e7-95fd-4785-8d08-3ea6507c162e
0	7	7	Plazi	ffb07bec-2d10-492d-9c37-361fe0b79427	cf1be670-edea-4303-99ad-dd44690eb12a
476	476	0	National Biodiversity Network	d897a5b9-35ee-4232-94bd-b0bcaac003c2	cf37ae76-f7ec-4b0e-bb21-f3bbd835c1ef
0	2	2	Plazi	ffb07bec-2d10-492d-9c37-361fe0b79427	d0628152-a7d4-4d45-8613-017b4ca9dcfe
2458	2458	0	GBIF Argentina	2426a871-9feb-40a1-96c6-0c593a76b835	d08f77c2-aca2-400a-a3a0-aaab23738146
27	27	0	Plazi	ffb07bec-2d10-492d-9c37-361fe0b79427	d2d146be-d297-4c55-a744-c51d71221e78
0	5594	5594	GBIF Benin	efb9c00e-f802-45dd-8826-a52ec45b89ff	d3328a70-6fe1-42bf-b75f-1dd5d45baa7f
3855	3855	0	Biodiversity Information System of Mexico	b324e8e9-9a4c-44fa-8f1a-7f39ea7ab576	d5bb611e-54b0-4d6d-ab8f-adc2fa6edc96
5	5	0	Plazi	ffb07bec-2d10-492d-9c37-361fe0b79427	d834becb-5ecb-428a-9c88-e8a1c4c31fc7
12888	12888	0	GBIF Germany	4f6826f2-4ff6-443d-b966-e6913bd24013	d8ea9662-ada2-11e2-8fbc-00145eb45e9a
1	1	0	Plazi	ffb07bec-2d10-492d-9c37-361fe0b79427	da249a30-2cc3-4e4c-89c1-6f142781cccb
6224	6092	-132	Participant Node Managers Committee	7f48e0c8-5c96-49ec-b972-30748e339115	dc383f1f-6456-40bd-9ef1-0780cdb0c66d
1	1	0	Plazi	ffb07bec-2d10-492d-9c37-361fe0b79427	dd54be2c-62fd-4680-92c9-d7f55b1bab35
0	7	7	Plazi	ffb07bec-2d10-492d-9c37-361fe0b79427	e235705c-4d4e-4c03-8ef8-4d122c9a953f
0	2	2	Plazi	ffb07bec-2d10-492d-9c37-361fe0b79427	e2e5f76c-f669-444b-a6de-48c0b68856bd
9	9	0	Plazi	ffb07bec-2d10-492d-9c37-361fe0b79427	e3342d38-eb94-4277-82ad-a13389c8c24a
14	14	0	Plazi	ffb07bec-2d10-492d-9c37-361fe0b79427	e3b84795-947d-4260-8873-45da5294bfe9
8	8	0	Plazi	ffb07bec-2d10-492d-9c37-361fe0b79427	e4d11526-fb89-404b-8045-244c654d6255
3	3	0	Plazi	ffb07bec-2d10-492d-9c37-361fe0b79427	e5e4d07b-7071-4efa-bb4b-884da12541cf
47	47	0	Participant Node Managers Committee	7f48e0c8-5c96-49ec-b972-30748e339115	e605458e-0106-414b-87d1-69669726db09
0	10	10	Ocean Biodiversity Information System	ba0670b9-4186-41e6-8e70-f9cb3065551a	e62272d6-6927-48ec-abfa-d294fb30aa10
13	13	0	Plazi	ffb07bec-2d10-492d-9c37-361fe0b79427	e7301bfe-b613-46b9-ae92-75d98ac4e6b3
0	1	1	Plazi	ffb07bec-2d10-492d-9c37-361fe0b79427	e79b4a8e-bf11-465c-bb55-df4188ca3993
39	39	0	Plazi	ffb07bec-2d10-492d-9c37-361fe0b79427	e7c82ac0-d5ec-43de-939d-8d5fab040ee4
0	50076	50076	Canada Biodiversity Information Facility	8f83fc96-c966-4126-83f7-bf044dc49efa	e908605e-fb40-4db1-bff7-de1c241284a9
1665	1831	166	Colombian Biodiversity Information System	7e865cba-7c46-417b-ade5-97f2cf5b7be0	eaad657f-7bda-4705-a181-053d9e38033f
248	248	0	Colombian Biodiversity Information System	7e865cba-7c46-417b-ade5-97f2cf5b7be0	ee7ef593-06b8-483c-95b3-20e17619f54d
0	14496	14496	Atlas of Living Australia	4a6f1b71-969e-4fc5-a693-282b05e1220c	ef225632-6819-4eee-906c-03e3261a91ea
0	1	1	Plazi	ffb07bec-2d10-492d-9c37-361fe0b79427	effbadc6-2dde-4a6f-8153-76905ffea93d
118	118	0	GBIF Germany	4f6826f2-4ff6-443d-b966-e6913bd24013	f1d8b81b-4c3c-467d-87ea-bad6fe626441
962	962	0	GBIF Germany	4f6826f2-4ff6-443d-b966-e6913bd24013	f2c9f468-1b96-491f-82b4-f6cb318a887c
14	14	0	Plazi	ffb07bec-2d10-492d-9c37-361fe0b79427	f64e8e3b-8b5e-48d6-968a-68ca461e5d9b
15	15	0	Plazi	ffb07bec-2d10-492d-9c37-361fe0b79427	f9d30657-3b3b-4b92-897a-185d53f8df7e
159	159	0	GBIF France	da44cd31-5901-4687-a106-6d1c7734ee3a	facf9b6f-7b85-40b3-bf08-22841c471c7a
0	5	5	Plazi	ffb07bec-2d10-492d-9c37-361fe0b79427	fbfe438c-1eae-40cb-b56f-ff8167b283c2
16048	16048	0	GBIF France	da44cd31-5901-4687-a106-6d1c7734ee3a	fddb5997-0587-4585-88af-57855f120908
1	1	0	Plazi	ffb07bec-2d10-492d-9c37-361fe0b79427	fe006ef9-ac7d-4440-860c-56c73690a5c9
798	709	-89	GBIF Germany	4f6826f2-4ff6-443d-b966-e6913bd24013	004397a7-6bf4-49d1-8067-09b036a4776a
0	1	1	Plazi	ffb07bec-2d10-492d-9c37-361fe0b79427	0149072c-8820-4a65-98c0-08622a889824
0	5	5	Plazi	ffb07bec-2d10-492d-9c37-361fe0b79427	0438ff1a-1dc7-45bf-b86f-f2aee96b6a86
21	21	0	Plazi	ffb07bec-2d10-492d-9c37-361fe0b79427	04905579-31ca-4c1f-ab84-4a65f99c09f3
5000	5000	0	GBIF Spain	1f94b3ca-9345-4d65-afe2-4bace93aa0fe	058a6684-fbe4-416b-b247-accee284027d
6104	6104	0	GBIF Germany	4f6826f2-4ff6-443d-b966-e6913bd24013	0595745d-7fa2-4e05-a3e7-6fef70796dbc
82	82	0	Participant Node Managers Committee	7f48e0c8-5c96-49ec-b972-30748e339115	05f10202-2407-4424-b13a-45e6376c1efb
1060	1060	0	GBIF France	da44cd31-5901-4687-a106-6d1c7734ee3a	0a03ca5c-4fd2-4b52-ae12-af4ff8fc6f00
565	565	0	GBIF France	da44cd31-5901-4687-a106-6d1c7734ee3a	0ba9e717-078e-4611-83db-f3b91ef03339
5	5	0	Plazi	ffb07bec-2d10-492d-9c37-361fe0b79427	0f99f703-80de-4ca8-a703-dc65713f5eda
0	449	449	Ocean Biodiversity Information System	ba0670b9-4186-41e6-8e70-f9cb3065551a	10f4cbce-4f2c-4789-871e-531625352cc4
13	13	0	Plazi	ffb07bec-2d10-492d-9c37-361fe0b79427	1209f677-869b-4bb7-8456-997e7c214bbd
11786	11786	0	Biodiversity Information System of Mexico	b324e8e9-9a4c-44fa-8f1a-7f39ea7ab576	129704b4-762b-4f0c-8eab-ef3f8aedd478
17886	17886	0	National Biodiversity Network	d897a5b9-35ee-4232-94bd-b0bcaac003c2	141b8a8c-7f5b-429f-8efb-ade3d6e101bb
0	4	4	Plazi	ffb07bec-2d10-492d-9c37-361fe0b79427	17af339c-2b7a-444d-8ab4-c559e940ba29
4	4	0	Plazi	ffb07bec-2d10-492d-9c37-361fe0b79427	17fa983e-cb1c-4260-b826-788966e198e4
57227	57227	0	National Biodiversity Network	d897a5b9-35ee-4232-94bd-b0bcaac003c2	1a7546cc-da20-44e0-a5b3-448e41ffd9c8
0	39417	39417	U.S. Geological Survey	8618c64a-93e0-4300-b546-7249e5148ed2	1da75725-1eb5-4e17-b586-ffad7b783987
2	2	0	Plazi	ffb07bec-2d10-492d-9c37-361fe0b79427	2493f24c-015e-4a8f-a0f8-ca95dcdb4200
1	1	0	Colombian Biodiversity Information System	7e865cba-7c46-417b-ade5-97f2cf5b7be0	2768403d-accb-40eb-bdad-abf2cf8baaea
47236	47236	0	U.S. Geological Survey	8618c64a-93e0-4300-b546-7249e5148ed2	2f9c368b-9011-4c6c-bcb2-c34e05637f1c
582	582	0	DanBIF - Danish Biodiversity Information Facility	4ddd294f-02b7-4359-ac33-0806a9ca9c6b	2fce3ac5-5bd1-4c11-82c8-68bfb937399a
0	150	150	Colombian Biodiversity Information System	7e865cba-7c46-417b-ade5-97f2cf5b7be0	315c5bbc-bb2c-44a0-bb6d-016dcd465b44
0	2	2	Plazi	ffb07bec-2d10-492d-9c37-361fe0b79427	34448ee1-f9cc-4b23-84e5-c822b02f96ce
128	128	0	National Biodiversity Network	d897a5b9-35ee-4232-94bd-b0bcaac003c2	35decbde-4b8a-4ef3-b805-604ac799a86f
20	20	0	GBIF Japan	db5705aa-6a6e-42f1-8942-d77b9f4896ea	3a7d21cc-37fc-4b25-a553-0b6ea2dbc651
56	56	0	Plazi	ffb07bec-2d10-492d-9c37-361fe0b79427	3b3ac8e3-69fc-487a-9ef3-82e8c26f1bab
0	7	7	Plazi	ffb07bec-2d10-492d-9c37-361fe0b79427	3b644b6a-2a10-4153-9a6b-11ed35c7526e
0	4	4	Plazi	ffb07bec-2d10-492d-9c37-361fe0b79427	3e0a9af7-a24f-4bba-9e00-eaea04188e73
0	14	14	Plazi	ffb07bec-2d10-492d-9c37-361fe0b79427	3e7841bd-d48b-41a0-be2e-fd67652b5aec
0	6	6	Plazi	ffb07bec-2d10-492d-9c37-361fe0b79427	40dc8d3a-ff4d-4dbc-b2fb-399bf7e9dc5e
2	2	0	Plazi	ffb07bec-2d10-492d-9c37-361fe0b79427	427c1962-d5b8-4737-8751-281595a33457
140	140	0	GBIF France	da44cd31-5901-4687-a106-6d1c7734ee3a	43d5bc68-ee15-419b-982a-3b5f67f40a12
3	3	0	Plazi	ffb07bec-2d10-492d-9c37-361fe0b79427	4474424d-176b-4799-b758-85f890cedb7a
5205	5205	0	Participant Node Managers Committee	7f48e0c8-5c96-49ec-b972-30748e339115	45183eb4-0416-4d4f-9439-e8146f4fdc59
1151	1151	0	GBIF Brazil	cdc9736d-5ff7-4ece-9959-3c744360cdb3	4725681f-06af-4b1e-8fff-e31e266e0a8f
4	4	0	Plazi	ffb07bec-2d10-492d-9c37-361fe0b79427	47520ee0-faa4-4f41-9712-cb65e705e1e3
342	342	0	Plazi	ffb07bec-2d10-492d-9c37-361fe0b79427	475fd53e-c5c6-4a99-bb2e-cc2382f0171f
3773	3773	0	National Biodiversity Network	d897a5b9-35ee-4232-94bd-b0bcaac003c2	4a3999b7-f5ce-4b5d-a063-2166d762ba22
2256	2256	0	National Biodiversity Network	d897a5b9-35ee-4232-94bd-b0bcaac003c2	4a8e73de-6628-44be-b3e7-41fc9d52b765
22	22	0	Plazi	ffb07bec-2d10-492d-9c37-361fe0b79427	4b767a37-3a18-48a2-8007-d1ae9e507fbd
233	233	0	Colombian Biodiversity Information System	7e865cba-7c46-417b-ade5-97f2cf5b7be0	4bb3ef51-df03-42f9-8104-76e9446367b8
0	41	41	Plazi	ffb07bec-2d10-492d-9c37-361fe0b79427	5215fd67-a869-4b94-8e03-422d4bdea44c
34	34	0	Polish Biodiversity Information Network	2618bfdf-e194-4911-a241-80db3107bc51	52cd21a0-13e4-11de-b2e1-b8a03c50a862
377	377	0	South African Biodiversity Information Facility	7190b835-4e86-4b6e-85c1-19cc6677c250	5524d3c3-9675-4d3d-96e0-e9a748eca457
73	73	0	Colombian Biodiversity Information System	7e865cba-7c46-417b-ade5-97f2cf5b7be0	55bbc8b5-c586-43b6-b824-4f56fcbe3995
2040	2040	0	GBIF Germany	4f6826f2-4ff6-443d-b966-e6913bd24013	5666d4ba-98f8-4a38-a91d-48a27f7caadd
3	3	0	Plazi	ffb07bec-2d10-492d-9c37-361fe0b79427	57d048d5-dafe-4800-989e-60a618c9982e
2332	2332	0	GBIF Finland	dd514216-5c7c-45f3-910d-797424cb5be6	5b2042ab-b98d-457b-94c3-22870cac4cfd
0	4	4	Plazi	ffb07bec-2d10-492d-9c37-361fe0b79427	5b796faf-7080-431e-8f1c-e6005e182ad9
10	10	0	Plazi	ffb07bec-2d10-492d-9c37-361fe0b79427	5bbec969-c8ad-4360-80da-49f001d6c9c0
68	68	0	Colombian Biodiversity Information System	7e865cba-7c46-417b-ade5-97f2cf5b7be0	5c0dff10-3ac7-4c63-b018-6f5d5cae7599
193	193	0	Participant Node Managers Committee	7f48e0c8-5c96-49ec-b972-30748e339115	5ccdb68f-6b41-478b-bef3-034ad06cbaf4
11	11	0	Plazi	ffb07bec-2d10-492d-9c37-361fe0b79427	5cd5973d-27f6-42d5-9a70-d345a437d9e4
0	1905	1905	Ocean Biodiversity Information System	ba0670b9-4186-41e6-8e70-f9cb3065551a	5dcaa90f-0ce2-46c4-b25e-7ba792429832
53985	53985	0	National Biodiversity Data Centre	422b00b2-6c94-4bb6-976b-c359916efdb8	5df3c9be-d9a1-4c36-a5bc-bdf88b78dbe3
4	4	0	Plazi	ffb07bec-2d10-492d-9c37-361fe0b79427	5e826d3b-553a-4525-9381-b3b25136364c
494	494	0	National Biodiversity Network	d897a5b9-35ee-4232-94bd-b0bcaac003c2	5fe8fc90-ed14-46c3-8bac-9dbd2d4b92d7
136	136	0	GBIF Germany	4f6826f2-4ff6-443d-b966-e6913bd24013	62295492-f762-11e1-a439-00145eb45e9a
127	127	0	GBIF Germany	4f6826f2-4ff6-443d-b966-e6913bd24013	624f61d2-f762-11e1-a439-00145eb45e9a
46264	47152	888	U.S. Geological Survey	8618c64a-93e0-4300-b546-7249e5148ed2	62cccd4d-eafc-4287-a070-5701aa6ef4a2
82	82	0	GBIF Germany	4f6826f2-4ff6-443d-b966-e6913bd24013	63b24a76-f762-11e1-a439-00145eb45e9a
41	41	0	GBIF Germany	4f6826f2-4ff6-443d-b966-e6913bd24013	64b88e4e-f762-11e1-a439-00145eb45e9a
336	336	0	Colombian Biodiversity Information System	7e865cba-7c46-417b-ade5-97f2cf5b7be0	65775fa4-8165-4fdc-99ff-b548e33a6a79
208	206	-2	GBIF Germany	4f6826f2-4ff6-443d-b966-e6913bd24013	65e7af48-f762-11e1-a439-00145eb45e9a
5405	5405	0	GBIF Germany	4f6826f2-4ff6-443d-b966-e6913bd24013	6608106c-f762-11e1-a439-00145eb45e9a
2	2	0	Plazi	ffb07bec-2d10-492d-9c37-361fe0b79427	66d86ea3-e671-4144-b8be-7704010c10e9
7	7	0	GBIF Germany	4f6826f2-4ff6-443d-b966-e6913bd24013	694577e2-f762-11e1-a439-00145eb45e9a
80	80	0	GBIF Germany	4f6826f2-4ff6-443d-b966-e6913bd24013	69c05214-f762-11e1-a439-00145eb45e9a
0	8	8	Plazi	ffb07bec-2d10-492d-9c37-361fe0b79427	6a2a0bc4-fd11-46e6-9ae5-b945a61fe842
3166	3166	0	National Biodiversity Network	d897a5b9-35ee-4232-94bd-b0bcaac003c2	6a341c6b-8446-44df-8910-c8a8072b7d06
16	16	0	GBIF Germany	4f6826f2-4ff6-443d-b966-e6913bd24013	6af58726-f762-11e1-a439-00145eb45e9a
7917	7917	0	National Biodiversity Network	d897a5b9-35ee-4232-94bd-b0bcaac003c2	6b55d2a6-58a6-4e70-8be4-cad305ba8382
0	168895	168895	GBIF Estonia	2c11b821-d22b-4c64-8cd3-c1578173b129	6b5e4c2d-127f-492e-bf1c-2026d515e0de
42	42	0	GBIF Germany	4f6826f2-4ff6-443d-b966-e6913bd24013	6b74b08c-f762-11e1-a439-00145eb45e9a
33	33	0	GBIF Germany	4f6826f2-4ff6-443d-b966-e6913bd24013	6c7b9d2e-f762-11e1-a439-00145eb45e9a
73	73	0	GBIF Germany	4f6826f2-4ff6-443d-b966-e6913bd24013	6cca15da-f762-11e1-a439-00145eb45e9a
87	87	0	GBIF Germany	4f6826f2-4ff6-443d-b966-e6913bd24013	6d58564c-f762-11e1-a439-00145eb45e9a
4	4	0	Plazi	ffb07bec-2d10-492d-9c37-361fe0b79427	6e46db2a-d938-4778-8ce1-f992f95049fa
0	378	378	Colombian Biodiversity Information System	7e865cba-7c46-417b-ade5-97f2cf5b7be0	6ed9ae85-9c68-47bd-b83d-aa986ede714a
7	7	0	Plazi	ffb07bec-2d10-492d-9c37-361fe0b79427	6f3c6f15-0603-4ac3-85c7-deab0279cfec
1979	1979	0	GBIF Germany	4f6826f2-4ff6-443d-b966-e6913bd24013	6f59202a-f762-11e1-a439-00145eb45e9a
1183	1183	0	Colombian Biodiversity Information System	7e865cba-7c46-417b-ade5-97f2cf5b7be0	6f722aca-6e7f-4b8b-969a-9422bc17ada0
15	15	0	GBIF Germany	4f6826f2-4ff6-443d-b966-e6913bd24013	6fb02e74-f762-11e1-a439-00145eb45e9a
64	64	0	Plazi	ffb07bec-2d10-492d-9c37-361fe0b79427	6fcd11fa-9e65-49eb-887f-eff390757adf
92	92	0	GBIF Germany	4f6826f2-4ff6-443d-b966-e6913bd24013	6ff1384c-f762-11e1-a439-00145eb45e9a
189	189	0	GBIF Germany	4f6826f2-4ff6-443d-b966-e6913bd24013	71a76bca-f762-11e1-a439-00145eb45e9a
58	58	0	Plazi	ffb07bec-2d10-492d-9c37-361fe0b79427	727232c0-d4a6-4959-b04d-3ae146281fd8
18	18	0	GBIF Germany	4f6826f2-4ff6-443d-b966-e6913bd24013	72a78adc-f762-11e1-a439-00145eb45e9a
129	129	0	GBIF France	da44cd31-5901-4687-a106-6d1c7734ee3a	730e3970-ce2d-4643-843b-8d93a3d6b4da
2	2	0	Plazi	ffb07bec-2d10-492d-9c37-361fe0b79427	73623a87-b020-4bbf-ba0b-0f521af92a82
75	75	0	GBIF Germany	4f6826f2-4ff6-443d-b966-e6913bd24013	741550b6-f762-11e1-a439-00145eb45e9a
269	269	0	GBIF Germany	4f6826f2-4ff6-443d-b966-e6913bd24013	74d3b0f6-f762-11e1-a439-00145eb45e9a
102	102	0	GBIF Germany	4f6826f2-4ff6-443d-b966-e6913bd24013	7604251e-f762-11e1-a439-00145eb45e9a
312	312	0	GBIF Germany	4f6826f2-4ff6-443d-b966-e6913bd24013	773ff55c-f762-11e1-a439-00145eb45e9a
44	44	0	Colombian Biodiversity Information System	7e865cba-7c46-417b-ade5-97f2cf5b7be0	784e7087-0f83-41fb-8443-527eed272cc9
39	39	0	GBIF Germany	4f6826f2-4ff6-443d-b966-e6913bd24013	7927c066-f762-11e1-a439-00145eb45e9a
254	210	-44	GBIF Germany	4f6826f2-4ff6-443d-b966-e6913bd24013	796a7f46-f762-11e1-a439-00145eb45e9a
0	3	3	Participant Node Managers Committee	7f48e0c8-5c96-49ec-b972-30748e339115	7a0f4ed3-8ba7-4286-9edd-4408c80380ee
2967	2347	-620	GBIF Germany	4f6826f2-4ff6-443d-b966-e6913bd24013	7a1d0134-f762-11e1-a439-00145eb45e9a
55509	58509	3000	GBIF Japan	db5705aa-6a6e-42f1-8942-d77b9f4896ea	7a506a42-f762-11e1-a439-00145eb45e9a
3000	3000	0	Korean Biodiversity Information Facility	e0a1e772-0177-4800-94b4-2d023fe6cdf4	7bd55aae-61fb-42da-986f-ceedff623749
935	680	-255	GBIF Germany	4f6826f2-4ff6-443d-b966-e6913bd24013	7d57b164-f762-11e1-a439-00145eb45e9a
87	87	0	GBIF Germany	4f6826f2-4ff6-443d-b966-e6913bd24013	7d95efec-f762-11e1-a439-00145eb45e9a
5	5	0	Plazi	ffb07bec-2d10-492d-9c37-361fe0b79427	7df8f6a9-dbb2-4c9a-a4f8-b8bc08ed622d
120	72	-48	GBIF Germany	4f6826f2-4ff6-443d-b966-e6913bd24013	7e1a726c-f762-11e1-a439-00145eb45e9a
5144	5144	0	GBIF Germany	4f6826f2-4ff6-443d-b966-e6913bd24013	816c32a2-f762-11e1-a439-00145eb45e9a
1455	1482	27	GBIF Germany	4f6826f2-4ff6-443d-b966-e6913bd24013	81b01d64-f762-11e1-a439-00145eb45e9a
1616	1616	0	GBIF Germany	4f6826f2-4ff6-443d-b966-e6913bd24013	81b8c87e-f762-11e1-a439-00145eb45e9a
0	139292	139292	Belgian Biodiversity Platform	fb11cfe1-ebc3-45af-9159-17d9fddbcdac	81b909c7-5612-4148-8e70-99fea2cdb572
132	132	0	GBIF Brazil	cdc9736d-5ff7-4ece-9959-3c744360cdb3	81dd5b5a-9f13-488d-9a4e-dab2bfe0c8b6
1110	1110	0	GBIF Germany	4f6826f2-4ff6-443d-b966-e6913bd24013	821295d4-f762-11e1-a439-00145eb45e9a
3	3	0	Plazi	ffb07bec-2d10-492d-9c37-361fe0b79427	834018f9-03b1-42ad-b6e2-5c292ac0dddd
0	1	1	Plazi	ffb07bec-2d10-492d-9c37-361fe0b79427	835e455c-8d6e-4e91-9b36-57c31b5443da
3079	3079	0	Canada Biodiversity Information Facility	8f83fc96-c966-4126-83f7-bf044dc49efa	8443c83c-f762-11e1-a439-00145eb45e9a
7	7	0	Plazi	ffb07bec-2d10-492d-9c37-361fe0b79427	845847ee-c68b-49a6-b66f-9bfe7b5e3fcd
42	42	0	GBIF Germany	4f6826f2-4ff6-443d-b966-e6913bd24013	85d1878e-f762-11e1-a439-00145eb45e9a
44992	47992	3000	GBIF Japan	db5705aa-6a6e-42f1-8942-d77b9f4896ea	86185376-f762-11e1-a439-00145eb45e9a
21	16	-5	GBIF Germany	4f6826f2-4ff6-443d-b966-e6913bd24013	87584872-f762-11e1-a439-00145eb45e9a
41	27	-14	GBIF Germany	4f6826f2-4ff6-443d-b966-e6913bd24013	87e81e16-f762-11e1-a439-00145eb45e9a
184	149	-35	GBIF Germany	4f6826f2-4ff6-443d-b966-e6913bd24013	880e9ffa-f762-11e1-a439-00145eb45e9a
4	4	0	Plazi	ffb07bec-2d10-492d-9c37-361fe0b79427	88429339-9cac-4f11-8693-215094d35ec8
17	17	0	GBIF Germany	4f6826f2-4ff6-443d-b966-e6913bd24013	88a48bbe-f762-11e1-a439-00145eb45e9a
11840	11840	0	U.S. Geological Survey	8618c64a-93e0-4300-b546-7249e5148ed2	8927617b-86ac-47a2-8b22-957bf05b8ad1
17	17	0	Plazi	ffb07bec-2d10-492d-9c37-361fe0b79427	89395d3a-4455-4040-8bbe-17c630a3b091
235	235	0	GBIF Germany	4f6826f2-4ff6-443d-b966-e6913bd24013	89795042-f762-11e1-a439-00145eb45e9a
0	64	64	Plazi	ffb07bec-2d10-492d-9c37-361fe0b79427	89939ee2-6007-48d1-a04c-25ba569310ed
2	2	0	GBIF Germany	4f6826f2-4ff6-443d-b966-e6913bd24013	8ca65332-f762-11e1-a439-00145eb45e9a
5	5	0	GBIF Germany	4f6826f2-4ff6-443d-b966-e6913bd24013	8cb53adc-f762-11e1-a439-00145eb45e9a
2056	2056	0	GBIF Finland	dd514216-5c7c-45f3-910d-797424cb5be6	8e2b6e47-e033-4b97-ba1d-e4a598c8ac48
1161	920	-241	GBIF Germany	4f6826f2-4ff6-443d-b966-e6913bd24013	8f65024e-f762-11e1-a439-00145eb45e9a
857	552	-305	GBIF Germany	4f6826f2-4ff6-443d-b966-e6913bd24013	8fed1f44-f762-11e1-a439-00145eb45e9a
121	75	-46	GBIF Germany	4f6826f2-4ff6-443d-b966-e6913bd24013	900651bc-f762-11e1-a439-00145eb45e9a
71	37	-34	GBIF Germany	4f6826f2-4ff6-443d-b966-e6913bd24013	90235f0a-f762-11e1-a439-00145eb45e9a
49	139	90	GBIF Japan	db5705aa-6a6e-42f1-8942-d77b9f4896ea	90fda018-0a42-4bf1-b3fc-a37c5b3e4e80
402	345	-57	GBIF Germany	4f6826f2-4ff6-443d-b966-e6913bd24013	915b0602-f762-11e1-a439-00145eb45e9a
0	11	11	Plazi	ffb07bec-2d10-492d-9c37-361fe0b79427	9194d13f-ee38-4281-94fc-12ac35e93d17
111	111	0	GBIF Germany	4f6826f2-4ff6-443d-b966-e6913bd24013	9259910e-f762-11e1-a439-00145eb45e9a
174	183	9	GBIF Germany	4f6826f2-4ff6-443d-b966-e6913bd24013	92d46d0c-f762-11e1-a439-00145eb45e9a
816	787	-29	GBIF Germany	4f6826f2-4ff6-443d-b966-e6913bd24013	92eb945a-f762-11e1-a439-00145eb45e9a
1	1	0	GBIF Germany	4f6826f2-4ff6-443d-b966-e6913bd24013	9372e4f0-f762-11e1-a439-00145eb45e9a
41	41	0	GBIF Germany	4f6826f2-4ff6-443d-b966-e6913bd24013	93ea87d0-f762-11e1-a439-00145eb45e9a
660	660	0	GBIF Madagascar	2dbfc5c5-51b5-4494-9dfc-4d3f013a3b64	940ae027-9d82-4a5f-ab28-bffac221f2af
2801055	2730861	-70194	GBIF Luxembourg	b0ccbf42-26b3-412e-b38a-339889154d77	962f59bc-f762-11e1-a439-00145eb45e9a
6567	45242	38675	DanBIF - Danish Biodiversity Information Facility	4ddd294f-02b7-4359-ac33-0806a9ca9c6b	963a6b96-4d22-4428-86e4-afee52cf4a8e
10	10	0	Plazi	ffb07bec-2d10-492d-9c37-361fe0b79427	97820d29-ba06-4777-9f5a-4003b72f0bd1
911	911	0	GBIF Germany	4f6826f2-4ff6-443d-b966-e6913bd24013	9799170c-f762-11e1-a439-00145eb45e9a
56	56	0	Plazi	ffb07bec-2d10-492d-9c37-361fe0b79427	9c4d25fb-5ff7-4ebd-87f9-9d53b2d53038
0	69	69	Plazi	ffb07bec-2d10-492d-9c37-361fe0b79427	9d75c14e-cd9a-4b98-b48c-4a4a97b8be4d
19011	19011	0	Biodiversity Information System of Mexico	b324e8e9-9a4c-44fa-8f1a-7f39ea7ab576	9e018d96-2264-4207-a7bc-00483885b368
0	69	69	Ocean Biodiversity Information System	ba0670b9-4186-41e6-8e70-f9cb3065551a	a2bbf927-8f93-4c6c-986e-11bb1203e783
2	2	0	Plazi	ffb07bec-2d10-492d-9c37-361fe0b79427	a44ff2c0-9279-428d-9ed3-840c6a061dcc
78	78	0	Plazi	ffb07bec-2d10-492d-9c37-361fe0b79427	a4aa9980-a6de-4e8d-bda1-4c4c3b8067ff
3	3	0	Plazi	ffb07bec-2d10-492d-9c37-361fe0b79427	a4c488eb-e390-45d1-ace1-e99fd2d3ff36
85	85	0	Plazi	ffb07bec-2d10-492d-9c37-361fe0b79427	a5562c36-5c76-4b1b-9278-b0d3ce04c20e
44	44	0	Plazi	ffb07bec-2d10-492d-9c37-361fe0b79427	a55cada0-a34a-4733-ba22-22c096b3c07b
18	18	0	Plazi	ffb07bec-2d10-492d-9c37-361fe0b79427	a64be282-1ec2-42f0-8857-950e77e56e4c
640	640	0	Biodiversity Information System of Mexico	b324e8e9-9a4c-44fa-8f1a-7f39ea7ab576	a77a3c1f-50e8-4426-b48b-76ed2b9ab521
1105	1105	0	GBIF Portugal	673f7038-4262-4149-b753-5658a4e912f6	aba82d28-5a92-46b9-b38c-e8774caab20d
59	59	0	Plazi	ffb07bec-2d10-492d-9c37-361fe0b79427	af08637c-3c84-42d2-9b58-a3c88c5b6e28
0	1	1	GBIF Germany	4f6826f2-4ff6-443d-b966-e6913bd24013	afee6fd5-08fb-45d3-92e3-7b35f0e1b746
12199	12199	0	South African Biodiversity Information Facility	7190b835-4e86-4b6e-85c1-19cc6677c250	b2ee8537-2a6c-4b4b-965a-538b47788606
0	56	56	Plazi	ffb07bec-2d10-492d-9c37-361fe0b79427	b389c293-742c-439a-8c41-fdac1e9df55d
0	2	2	Plazi	ffb07bec-2d10-492d-9c37-361fe0b79427	b4156e50-c9ca-4575-b472-94db5a92b601
16107	54323	38216	Colombian Biodiversity Information System	7e865cba-7c46-417b-ade5-97f2cf5b7be0	b56fbfec-cf01-458a-b772-2df2c8403201
24970	24970	0	National Biodiversity Network	d897a5b9-35ee-4232-94bd-b0bcaac003c2	b660c51c-17cc-44e7-973a-bec13da75166
1495	1495	0	GBIF France	da44cd31-5901-4687-a106-6d1c7734ee3a	b8697f09-9b81-474b-8c3c-e8954533537b
34	72	38	Plazi	ffb07bec-2d10-492d-9c37-361fe0b79427	bac254cb-b59c-44ed-895c-303c05e2b7f4
0	627	627	Colombian Biodiversity Information System	7e865cba-7c46-417b-ade5-97f2cf5b7be0	bb1f4643-8a9a-4d72-b631-88a41c0528bc
1	1	0	GBIF Argentina	2426a871-9feb-40a1-96c6-0c593a76b835	bb21ceea-5804-480f-a7d3-f3df73fcd729
4973	4973	0	Belgian Biodiversity Platform	fb11cfe1-ebc3-45af-9159-17d9fddbcdac	bcffbc19-b28c-42ae-995a-ff852e158ce5
16	16	0	Plazi	ffb07bec-2d10-492d-9c37-361fe0b79427	bda85876-5e1a-46a4-83ac-bb42fd72b390
25	25	0	Colombian Biodiversity Information System	7e865cba-7c46-417b-ade5-97f2cf5b7be0	be99973c-e3ca-46d8-b8ad-af5b033c422d
4176	4176	0	National Biodiversity Data Centre	422b00b2-6c94-4bb6-976b-c359916efdb8	bfe82ca9-01ec-4eff-be5d-b7ea15faf59c
742	742	0	Colombian Biodiversity Information System	7e865cba-7c46-417b-ade5-97f2cf5b7be0	c0717c48-e182-4bcf-b722-71c9af936058
0	15	15	Plazi	ffb07bec-2d10-492d-9c37-361fe0b79427	c0b26a15-be0c-4473-9af4-e0f8dd180642
167	167	0	National Biodiversity Network	d897a5b9-35ee-4232-94bd-b0bcaac003c2	c24f73ee-326c-4b23-8b66-2a1e1ffeb191
0	2	2	Plazi	ffb07bec-2d10-492d-9c37-361fe0b79427	c3e10ccb-bbbe-429a-923e-d26c53ed923b
61111	61111	0	Colombian Biodiversity Information System	7e865cba-7c46-417b-ade5-97f2cf5b7be0	c99d545d-7218-4a6b-845f-a3c75e7711b3
74699	74699	0	Inter American Biodiversity Information Network	69f8ea9e-b2a6-4e5a-896f-3bf8fc23cc8d	ca0d1f8f-4ba5-4187-82ec-ed8a66745b67
985	985	0	Society for the Management of Electronic Biodiversity Data	97818ee4-1461-4180-bf1d-b3201050124f	cb9ee548-5c8b-415d-90c8-58de7782d7d0
502	502	0	National Biodiversity Network	d897a5b9-35ee-4232-94bd-b0bcaac003c2	cba8b010-34a6-4924-b7c8-9cf02a894b4f
2686	2686	0	Colombian Biodiversity Information System	7e865cba-7c46-417b-ade5-97f2cf5b7be0	d0996e5a-6ae2-46e2-94ca-1b6a3ce1f3d4
1176	1176	0	National Biodiversity Network	d897a5b9-35ee-4232-94bd-b0bcaac003c2	d09dc56c-46c5-4040-a9d0-fdd27026dc58
40	40	0	Scientific Committee on Antarctic Research	51e4e8ff-bff0-4996-8b27-9107d61b3478	d2744050-427f-4b3f-824d-e96b7bd26368
19	19	0	National Biodiversity Network	d897a5b9-35ee-4232-94bd-b0bcaac003c2	d2e6f957-fad6-4dde-8490-8816d537b8dc
0	23	23	Plazi	ffb07bec-2d10-492d-9c37-361fe0b79427	d55485b6-392e-49a4-823f-a70ed21caedf
1	1	0	Plazi	ffb07bec-2d10-492d-9c37-361fe0b79427	d717ced4-9fe2-4b4d-8361-807178b587ef
1618	1618	0	GBIF Spain	1f94b3ca-9345-4d65-afe2-4bace93aa0fe	dbc709b9-e36e-4dd7-ab5b-c3cb08c2779d
3137	3137	0	Costa Rica Biodiversity Facility	3379bb09-1a58-41e7-9c57-e3b66c3eb5a0	dcf2e144-9956-491f-a5ac-8990c7fea3b9
3000	3000	0	Biodiversity Information System of Mexico	b324e8e9-9a4c-44fa-8f1a-7f39ea7ab576	e0638e8b-f649-4a4b-a88f-2469a9c08763
4	4	0	Plazi	ffb07bec-2d10-492d-9c37-361fe0b79427	e1352deb-12d2-4902-adce-635a620aa4b2
14	14	0	Plazi	ffb07bec-2d10-492d-9c37-361fe0b79427	e2ed26bf-60f8-4dca-b769-b6029e9e00fa
0	17	17	Plazi	ffb07bec-2d10-492d-9c37-361fe0b79427	e3f811ba-4daf-4623-8f44-565eafea7fba
260411	264747	4336	U.S. Geological Survey	8618c64a-93e0-4300-b546-7249e5148ed2	e42c4be9-dc6d-466b-8df2-60ac8c47fadd
6	6	0	Plazi	ffb07bec-2d10-492d-9c37-361fe0b79427	e5971a71-001b-473f-93da-18bd7f3a8274
25	25	0	Plazi	ffb07bec-2d10-492d-9c37-361fe0b79427	e6caadab-b699-4b4d-9096-94ebac4fe86e
0	4	4	Plazi	ffb07bec-2d10-492d-9c37-361fe0b79427	e820ab38-e6b9-4a10-b0e2-f7577ad62014
17	17	0	Plazi	ffb07bec-2d10-492d-9c37-361fe0b79427	e8fe845c-9626-4eb0-a248-264b26c4ad26
6	6	0	Plazi	ffb07bec-2d10-492d-9c37-361fe0b79427	e90a3628-d826-4264-9fb2-62c3b1a157a6
139	139	0	Plazi	ffb07bec-2d10-492d-9c37-361fe0b79427	ebeeb807-c44f-49ca-be8d-c9be9f1a9575
27	27	0	Plazi	ffb07bec-2d10-492d-9c37-361fe0b79427	ed9f2536-1317-48d5-85a9-2d98062a3cd1
1	1	0	Plazi	ffb07bec-2d10-492d-9c37-361fe0b79427	f0239101-9af3-41a2-b2a6-d9e9f0c15dbb
772	772	0	South African Biodiversity Information Facility	7190b835-4e86-4b6e-85c1-19cc6677c250	f12967b8-55a1-4d81-b390-5656a1b73ebc
0	5	5	Plazi	ffb07bec-2d10-492d-9c37-361fe0b79427	f1e63d5e-979a-4ed6-b7b0-e4686a61a4b8
2	2	0	Plazi	ffb07bec-2d10-492d-9c37-361fe0b79427	f31ce0a7-43fb-4bbc-9ce4-14e39372e55e
3886	3886	0	National Biodiversity Network	d897a5b9-35ee-4232-94bd-b0bcaac003c2	f4bf0ddf-4904-45f7-af95-0635b1ba2674
14	16	2	Participant Node Managers Committee	7f48e0c8-5c96-49ec-b972-30748e339115	f53896ee-f62f-4b03-ade3-f5a73ce7e35e
0	5	5	Ocean Biodiversity Information System	ba0670b9-4186-41e6-8e70-f9cb3065551a	f8997241-5f0d-49fe-86da-1ae3756e6464
4731	4731	0	Belgian Biodiversity Platform	fb11cfe1-ebc3-45af-9159-17d9fddbcdac	f8de3f7e-0325-4a15-aab4-3412f428676e
0	106	106	Plazi	ffb07bec-2d10-492d-9c37-361fe0b79427	fa2b89f7-1b3c-45a7-89cf-6d6e7efd45d1
373	373	0	Participant Node Managers Committee	7f48e0c8-5c96-49ec-b972-30748e339115	fb64e98e-2650-4df6-89de-1fa4fe673615
15	15	0	Plazi	ffb07bec-2d10-492d-9c37-361fe0b79427	fb6de4a9-e368-4d18-9251-94cf4d0891fe
1277	1277	0	GBIF Brazil	cdc9736d-5ff7-4ece-9959-3c744360cdb3	fb7082a0-5e66-4382-94df-4c5c4e57cda3
336	336	0	Colombian Biodiversity Information System	7e865cba-7c46-417b-ade5-97f2cf5b7be0	01c5963f-25c7-4361-8ee8-30f6a6ff98e4
14	14	0	Plazi	ffb07bec-2d10-492d-9c37-361fe0b79427	01f19564-584c-492f-b376-29fd5a02c1b4
180616	180616	0	Atlas of Living Australia	4a6f1b71-969e-4fc5-a693-282b05e1220c	02abb9d1-7d81-42b3-ac9a-3b3d0c7a5280
0	8	8	Plazi	ffb07bec-2d10-492d-9c37-361fe0b79427	02be5213-e3d7-46e5-abb8-849d34865e75
4	4	0	Plazi	ffb07bec-2d10-492d-9c37-361fe0b79427	031856dd-4818-40c5-9645-c4ad5f4e88ee
0	590	590	Scientific Committee on Antarctic Research	51e4e8ff-bff0-4996-8b27-9107d61b3478	03d5d1d2-934c-4c70-b4f1-e18402af109d
796	796	0	U.S. Geological Survey	8618c64a-93e0-4300-b546-7249e5148ed2	0bf094c6-8a9a-4164-9902-f245920e016d
200	200	0	Colombian Biodiversity Information System	7e865cba-7c46-417b-ade5-97f2cf5b7be0	0d0e8b80-7598-4f59-947d-639fbc7d70f2
19	19	0	Plazi	ffb07bec-2d10-492d-9c37-361fe0b79427	0ef0cb22-414e-4ef6-8c76-2c19e76d4200
0	2	2	Plazi	ffb07bec-2d10-492d-9c37-361fe0b79427	0ff7e7e2-1cda-442c-9b14-a03b06eca0dd
4	4	0	Plazi	ffb07bec-2d10-492d-9c37-361fe0b79427	1868fc13-49ca-421e-9aff-a7f34212df86
25	25	0	Plazi	ffb07bec-2d10-492d-9c37-361fe0b79427	1bd912b3-b11e-4ee1-bf25-827ce2558c2e
0	1	1	Plazi	ffb07bec-2d10-492d-9c37-361fe0b79427	1da0e352-6915-43ff-a63e-42f703e8a2b1
45951	45951	0	National Biodiversity Network	d897a5b9-35ee-4232-94bd-b0bcaac003c2	1f847390-5c72-4ef6-9419-d964c39de654
293	293	0	Plazi	ffb07bec-2d10-492d-9c37-361fe0b79427	219e17a1-0dfe-4e44-b432-84301e1aaa6f
198	198	0	Colombian Biodiversity Information System	7e865cba-7c46-417b-ade5-97f2cf5b7be0	219f6374-2c55-4901-a2f9-ad8aabf8902c
0	1	1	Plazi	ffb07bec-2d10-492d-9c37-361fe0b79427	25461134-191d-419b-acc4-fdbb42da4b3e
0	3	3	Plazi	ffb07bec-2d10-492d-9c37-361fe0b79427	2869e484-ce09-44b9-ac38-f3b98723feec
761	761	0	National Biodiversity Network	d897a5b9-35ee-4232-94bd-b0bcaac003c2	2b87996c-8a30-4b2c-aca5-effa7d0fd0a7
38197	38197	0	National Biodiversity Network	d897a5b9-35ee-4232-94bd-b0bcaac003c2	2c27c186-4ce8-483c-8b4d-c3d98beaabd9
0	3	3	Plazi	ffb07bec-2d10-492d-9c37-361fe0b79427	2d26eac2-e73d-493c-a17d-5f71cdece746
5	5	0	GBIF France	da44cd31-5901-4687-a106-6d1c7734ee3a	2e82f997-f629-4316-a2b6-c4e5d238146c
778	1215	437	National Biodiversity Network	d897a5b9-35ee-4232-94bd-b0bcaac003c2	2f8ec7b5-87d7-43d4-bafc-2de617998c34
1	1	0	Plazi	ffb07bec-2d10-492d-9c37-361fe0b79427	330a9e8d-7033-42aa-b1b5-dae085f1bf36
2023	2023	0	GBIF France	da44cd31-5901-4687-a106-6d1c7734ee3a	36eb7766-a926-4903-b195-9e342fe588d5
0	2	2	Plazi	ffb07bec-2d10-492d-9c37-361fe0b79427	38a7ff37-34bc-4331-8476-7d539028c4ef
348269	348269	0	Atlas of Living Australia	4a6f1b71-969e-4fc5-a693-282b05e1220c	38f06820-08c5-42b2-94f6-47cc3e83a54a
0	2848	2848	Belgian Biodiversity Platform	fb11cfe1-ebc3-45af-9159-17d9fddbcdac	3979878f-43e5-450b-8aad-9e9525f999fc
3947	3947	0	GBIF Norway	4f829580-180d-46a9-9c87-ed8ec959b545	39a80c99-56c2-482c-beef-fa960a8eec4d
84364	84364	0	National Biodiversity Network	d897a5b9-35ee-4232-94bd-b0bcaac003c2	3cb3a142-8a6c-45e3-a5d1-80b7d6522ad7
2	2	0	Plazi	ffb07bec-2d10-492d-9c37-361fe0b79427	3f4842a7-9014-4cc4-b03e-648b5c4b041f
778	778	0	GBIF Brazil	cdc9736d-5ff7-4ece-9959-3c744360cdb3	400de9f2-ea1e-43f1-baa6-c6cf8c1eac6d
50	50	0	GBIF France	da44cd31-5901-4687-a106-6d1c7734ee3a	410eba4f-6e2d-4b57-a22b-bac4aeb82de8
0	13	13	Ocean Biodiversity Information System	ba0670b9-4186-41e6-8e70-f9cb3065551a	41d68b93-7392-45ee-9812-a3d2ca0bc949
306	306	0	Atlas of Living Australia	4a6f1b71-969e-4fc5-a693-282b05e1220c	41eb63f5-9a19-4f2c-8bf3-a1247e6b6c69
0	1	1	Plazi	ffb07bec-2d10-492d-9c37-361fe0b79427	47a8dfce-0203-4f18-b330-9fc2794c4736
3	3	0	Plazi	ffb07bec-2d10-492d-9c37-361fe0b79427	47e59df4-d248-477a-9a4b-132d584206cd
3	3	0	Plazi	ffb07bec-2d10-492d-9c37-361fe0b79427	4809e341-99ce-476f-a3a8-5229de62f5eb
11	11	0	Plazi	ffb07bec-2d10-492d-9c37-361fe0b79427	49a7912a-a125-46eb-91a4-0c5fb338a716
343	343	0	Albertine Rift Conservation Society	90a939d3-e99c-4f6d-915f-2616423b3735	4a7f53e7-3835-4f02-ad40-cf6e5219d910
0	9	9	Plazi	ffb07bec-2d10-492d-9c37-361fe0b79427	4b490b43-734d-48b2-8f7a-d1ffa2402e1e
1	1	0	Plazi	ffb07bec-2d10-492d-9c37-361fe0b79427	4bae1828-7db4-48e2-bff5-b9baf2647467
2	2	0	Plazi	ffb07bec-2d10-492d-9c37-361fe0b79427	4e9354af-e624-4d84-9b60-7addf3d10ab8
0	5	5	Plazi	ffb07bec-2d10-492d-9c37-361fe0b79427	4fbccdaa-67a7-44e2-a56a-53b462e52b3b
3317	3317	0	Biodiversity Information System of Mexico	b324e8e9-9a4c-44fa-8f1a-7f39ea7ab576	5000c6ca-d69a-4cc7-a4d2-1747803ce7e1
0	8	8	Plazi	ffb07bec-2d10-492d-9c37-361fe0b79427	52b03d71-cefc-44da-9b75-e7cc270ed280
21618	21618	0	GBIF France	da44cd31-5901-4687-a106-6d1c7734ee3a	5492d04f-683d-4512-b77a-6d57f989810c
2	2	0	Plazi	ffb07bec-2d10-492d-9c37-361fe0b79427	56702c4d-3ed4-47db-8d48-bece681ddfab
41	41	0	Plazi	ffb07bec-2d10-492d-9c37-361fe0b79427	594bb190-aacd-4326-b9ad-01a5c3123366
1	1	0	Plazi	ffb07bec-2d10-492d-9c37-361fe0b79427	5bacfb63-9554-4d6d-906f-70489506a2c8
5	5	0	Plazi	ffb07bec-2d10-492d-9c37-361fe0b79427	5be94d4e-9f7e-477d-ad93-1320f4446885
1	1	0	Participant Node Managers Committee	7f48e0c8-5c96-49ec-b972-30748e339115	5d7b2d0c-3801-44d0-941e-385dc6553069
5081	5081	0	U.S. Geological Survey	8618c64a-93e0-4300-b546-7249e5148ed2	60447648-5bd7-4e29-a1c5-d2d981384ee5
9	9	0	National Biodiversity Network	d897a5b9-35ee-4232-94bd-b0bcaac003c2	60f4c323-8715-435b-9e51-49ac83cacdec
130	130	0	GBIF Germany	4f6826f2-4ff6-443d-b966-e6913bd24013	617d0e44-f762-11e1-a439-00145eb45e9a
40	40	0	GBIF Germany	4f6826f2-4ff6-443d-b966-e6913bd24013	61edb464-f762-11e1-a439-00145eb45e9a
39	39	0	GBIF Germany	4f6826f2-4ff6-443d-b966-e6913bd24013	6284683c-f762-11e1-a439-00145eb45e9a
0	2	2	Plazi	ffb07bec-2d10-492d-9c37-361fe0b79427	6321a78c-fd96-4a82-b786-96cdc4ae7035
278	278	0	GBIF Germany	4f6826f2-4ff6-443d-b966-e6913bd24013	6394f02a-f762-11e1-a439-00145eb45e9a
3047	3047	0	GBIF Brazil	cdc9736d-5ff7-4ece-9959-3c744360cdb3	65021239-bcce-4943-b440-f4195d5d6d70
911	911	0	GBIF Germany	4f6826f2-4ff6-443d-b966-e6913bd24013	65740b74-f762-11e1-a439-00145eb45e9a
0	3	3	Plazi	ffb07bec-2d10-492d-9c37-361fe0b79427	6595b9ba-d31a-4694-bf6c-1415cc1a9dba
40	40	0	GBIF Germany	4f6826f2-4ff6-443d-b966-e6913bd24013	65b15038-f762-11e1-a439-00145eb45e9a
143	143	0	GBIF Germany	4f6826f2-4ff6-443d-b966-e6913bd24013	67fdadaa-f762-11e1-a439-00145eb45e9a
22	22	0	GBIF Germany	4f6826f2-4ff6-443d-b966-e6913bd24013	69238380-f762-11e1-a439-00145eb45e9a
59	59	0	GBIF Germany	4f6826f2-4ff6-443d-b966-e6913bd24013	69afb0d0-f762-11e1-a439-00145eb45e9a
121	121	0	GBIF France	da44cd31-5901-4687-a106-6d1c7734ee3a	69c6cc10-8473-4902-8386-1145075adad8
32	32	0	GBIF Germany	4f6826f2-4ff6-443d-b966-e6913bd24013	6ac4ccd0-f762-11e1-a439-00145eb45e9a
2060	2060	0	U.S. Geological Survey	8618c64a-93e0-4300-b546-7249e5148ed2	6cc9b613-5f76-4654-9270-6eed8f57a34e
116	116	0	GBIF Germany	4f6826f2-4ff6-443d-b966-e6913bd24013	6ccdebd8-f762-11e1-a439-00145eb45e9a
0	1	1	Plazi	ffb07bec-2d10-492d-9c37-361fe0b79427	6e311374-8bff-4997-92cc-7865571cb795
3	3	0	Plazi	ffb07bec-2d10-492d-9c37-361fe0b79427	6ec71c9e-1dcc-4135-a1e3-7389872abdcd
15	15	0	Plazi	ffb07bec-2d10-492d-9c37-361fe0b79427	6ee5fe37-06bc-4b27-9d5c-64db6fb64d77
12	12	0	GBIF Germany	4f6826f2-4ff6-443d-b966-e6913bd24013	6fa9bfa8-f762-11e1-a439-00145eb45e9a
73	73	0	GBIF France	da44cd31-5901-4687-a106-6d1c7734ee3a	70259d98-7d16-4b80-bb5c-5bb1627e330c
572	572	0	GBIF Germany	4f6826f2-4ff6-443d-b966-e6913bd24013	7041b055-10b2-4bcc-9032-9ad6383eb94f
0	7	7	Plazi	ffb07bec-2d10-492d-9c37-361fe0b79427	70db1eca-74c8-4901-823a-79cfd01d993f
246	246	0	National Biodiversity Network	d897a5b9-35ee-4232-94bd-b0bcaac003c2	710f72d0-2b22-452d-89ac-462164a9a369
198	198	0	GBIF Germany	4f6826f2-4ff6-443d-b966-e6913bd24013	72dd7138-f762-11e1-a439-00145eb45e9a
18	18	0	GBIF Germany	4f6826f2-4ff6-443d-b966-e6913bd24013	73495830-f762-11e1-a439-00145eb45e9a
150	150	0	GBIF Germany	4f6826f2-4ff6-443d-b966-e6913bd24013	74195094-f762-11e1-a439-00145eb45e9a
0	600	600	GBIF Ecuador	2dc472f1-c3d9-486d-b3c1-12ca7ba1ed22	7482c011-1692-412d-a87c-220a579ccfd2
6899	6899	0	National Biodiversity Network	d897a5b9-35ee-4232-94bd-b0bcaac003c2	7821f2de-9896-40a1-a195-37d60fc7201c
1155	1155	0	GBIF Germany	4f6826f2-4ff6-443d-b966-e6913bd24013	784bce8b-cfb8-4719-b401-ccc4f3b8fa55
14	14	0	Secretariat of the Pacific Regional Environment Programme	29c6a139-ea7f-41f5-8d9b-c55af8736182	78dbf7bd-3b3d-4437-96b7-d69985f43f91
267	235	-32	GBIF Germany	4f6826f2-4ff6-443d-b966-e6913bd24013	797a49ee-f762-11e1-a439-00145eb45e9a
275	245	-30	GBIF Germany	4f6826f2-4ff6-443d-b966-e6913bd24013	7982c538-f762-11e1-a439-00145eb45e9a
56	46	-10	GBIF Germany	4f6826f2-4ff6-443d-b966-e6913bd24013	799cf21e-f762-11e1-a439-00145eb45e9a
45872	45872	0	DanBIF - Danish Biodiversity Information Facility	4ddd294f-02b7-4359-ac33-0806a9ca9c6b	7a47414c-f762-11e1-a439-00145eb45e9a
114	114	0	Participant Node Managers Committee	7f48e0c8-5c96-49ec-b972-30748e339115	7b828d22-ab17-4f6a-b6b6-7b7ff8c32ea4
22	22	0	Plazi	ffb07bec-2d10-492d-9c37-361fe0b79427	7c024acd-b45e-4aee-830d-ee4749e0c68d
4	4	0	Plazi	ffb07bec-2d10-492d-9c37-361fe0b79427	7c3caf8e-cb0b-4aa1-9a8a-186dce3e5d13
360	360	0	GBIF Germany	4f6826f2-4ff6-443d-b966-e6913bd24013	7c9a4c82-f762-11e1-a439-00145eb45e9a
378	64	-314	GBIF Germany	4f6826f2-4ff6-443d-b966-e6913bd24013	7cb2d360-f762-11e1-a439-00145eb45e9a
72	72	0	GBIF Germany	4f6826f2-4ff6-443d-b966-e6913bd24013	7d3e4274-f762-11e1-a439-00145eb45e9a
1495	1495	0	GBIF France	da44cd31-5901-4687-a106-6d1c7734ee3a	7ddc2055-2b29-4171-bdf6-85c960278acf
0	12	12	Plazi	ffb07bec-2d10-492d-9c37-361fe0b79427	7dedbc72-4305-4931-a961-dda7730dac6e
47	47	0	GBIF Germany	4f6826f2-4ff6-443d-b966-e6913bd24013	7e04e064-f762-11e1-a439-00145eb45e9a
2488	2488	0	Biodiversity Information System of Mexico	b324e8e9-9a4c-44fa-8f1a-7f39ea7ab576	7ff8361e-f762-11e1-a439-00145eb45e9a
31	31	0	GBIF Germany	4f6826f2-4ff6-443d-b966-e6913bd24013	8143d014-f762-11e1-a439-00145eb45e9a
2	2	0	GBIF Germany	4f6826f2-4ff6-443d-b966-e6913bd24013	81be3ea4-4f4f-4b3b-8abc-524da1299720
0	264	264	Plazi	ffb07bec-2d10-492d-9c37-361fe0b79427	81e47d68-d09e-4609-af50-db862a19c216
0	2	2	Plazi	ffb07bec-2d10-492d-9c37-361fe0b79427	8260832b-9a33-48e0-b1ab-a0cb90656b9a
1216	1216	0	GBIF Benin	efb9c00e-f802-45dd-8826-a52ec45b89ff	847af172-1fb2-4a4e-ac60-4b9cfd80eea0
1340	996	-344	GBIF Germany	4f6826f2-4ff6-443d-b966-e6913bd24013	8713aadc-f762-11e1-a439-00145eb45e9a
24	16	-8	GBIF Germany	4f6826f2-4ff6-443d-b966-e6913bd24013	875d8efe-f762-11e1-a439-00145eb45e9a
121	121	0	GBIF Germany	4f6826f2-4ff6-443d-b966-e6913bd24013	8832365e-f762-11e1-a439-00145eb45e9a
109	53	-56	GBIF Germany	4f6826f2-4ff6-443d-b966-e6913bd24013	88b7db74-f762-11e1-a439-00145eb45e9a
0	12	12	Plazi	ffb07bec-2d10-492d-9c37-361fe0b79427	88cc79b6-ea26-4742-b872-6f5df6544661
126	126	0	GBIF Germany	4f6826f2-4ff6-443d-b966-e6913bd24013	8a75b56c-f762-11e1-a439-00145eb45e9a
34	34	0	Plazi	ffb07bec-2d10-492d-9c37-361fe0b79427	8b3957bc-d1bb-4d32-a0fe-761ff31060ed
127	127	0	GBIF Germany	4f6826f2-4ff6-443d-b966-e6913bd24013	8b9c386c-f762-11e1-a439-00145eb45e9a
1588	1588	0	GBIF France	da44cd31-5901-4687-a106-6d1c7734ee3a	8bcb10e8-12f6-4fd7-8884-90690ea1b9a0
10	10	0	GBIF Germany	4f6826f2-4ff6-443d-b966-e6913bd24013	8c086aaa-f762-11e1-a439-00145eb45e9a
2078	2078	0	National Biodiversity Network	d897a5b9-35ee-4232-94bd-b0bcaac003c2	8de4fda9-edee-4060-a131-5dd9984c8cb5
83	83	0	Plazi	ffb07bec-2d10-492d-9c37-361fe0b79427	8e19d5d0-be5e-4022-a16c-b3ce0e554c54
3	3	0	Plazi	ffb07bec-2d10-492d-9c37-361fe0b79427	8f35e7a7-2f3c-4d59-8373-2b9a8989b870
346	111	-235	GBIF Germany	4f6826f2-4ff6-443d-b966-e6913bd24013	8f6b55c2-f762-11e1-a439-00145eb45e9a
536	413	-123	GBIF Germany	4f6826f2-4ff6-443d-b966-e6913bd24013	8f97ab4a-f762-11e1-a439-00145eb45e9a
0	85	85	Ocean Biodiversity Information System	ba0670b9-4186-41e6-8e70-f9cb3065551a	90aebd4e-9353-48de-b009-fd76bce2926d
33	26	-7	GBIF Germany	4f6826f2-4ff6-443d-b966-e6913bd24013	910b922a-f762-11e1-a439-00145eb45e9a
189	175	-14	GBIF Germany	4f6826f2-4ff6-443d-b966-e6913bd24013	9123347a-f762-11e1-a439-00145eb45e9a
9	6	-3	GBIF Germany	4f6826f2-4ff6-443d-b966-e6913bd24013	9184a4d0-f762-11e1-a439-00145eb45e9a
152	152	0	Atlas of Living Australia	4a6f1b71-969e-4fc5-a693-282b05e1220c	920aa899-7c31-44a4-8a73-c3644f570228
104	104	0	GBIF Germany	4f6826f2-4ff6-443d-b966-e6913bd24013	925ca8b2-f762-11e1-a439-00145eb45e9a
2	2	0	Plazi	ffb07bec-2d10-492d-9c37-361fe0b79427	937580ed-d707-404f-a701-615f9c0dd01c
241	241	0	GBIF Germany	4f6826f2-4ff6-443d-b966-e6913bd24013	94438e16-f762-11e1-a439-00145eb45e9a
24	24	0	GBIF Germany	4f6826f2-4ff6-443d-b966-e6913bd24013	95a7b110-f762-11e1-a439-00145eb45e9a
7	7	0	GBIF Germany	4f6826f2-4ff6-443d-b966-e6913bd24013	95ac1e4e-f762-11e1-a439-00145eb45e9a
632	632	0	GBIF Germany	4f6826f2-4ff6-443d-b966-e6913bd24013	95be1cf2-f762-11e1-a439-00145eb45e9a
2	2	0	Plazi	ffb07bec-2d10-492d-9c37-361fe0b79427	973a7dee-1edd-4eca-b42d-4a440118ba5f
4689	4689	0	GBIF Brazil	cdc9736d-5ff7-4ece-9959-3c744360cdb3	99482781-3e53-4ab4-8463-3fbdd7b0888a
0	22	22	Plazi	ffb07bec-2d10-492d-9c37-361fe0b79427	999f8840-af59-4165-83cf-739584729e9f
8	8	0	Plazi	ffb07bec-2d10-492d-9c37-361fe0b79427	9ac702b0-ddd3-4f52-a0b9-386ffbf2e4d5
1	1	0	Plazi	ffb07bec-2d10-492d-9c37-361fe0b79427	9d53403a-b5e3-4b02-8c0c-3d2c233d92d6
0	94	94	U.S. Geological Survey	8618c64a-93e0-4300-b546-7249e5148ed2	9d691e2b-fdf1-4d06-beae-f95fb2bbe69c
0	94	94	Plazi	ffb07bec-2d10-492d-9c37-361fe0b79427	9de2e923-4b2c-4a60-9ea1-3ef0ac7972f2
0	33	33	Plazi	ffb07bec-2d10-492d-9c37-361fe0b79427	9e3374a3-73e0-4609-a80d-0de905904a37
29	29	0	Plazi	ffb07bec-2d10-492d-9c37-361fe0b79427	9e67a942-2592-41d5-a7e2-b7771e20ba9e
1009	1009	0	Colombian Biodiversity Information System	7e865cba-7c46-417b-ade5-97f2cf5b7be0	a1061ba5-2506-470f-a76c-ee978de78245
0	5	5	Plazi	ffb07bec-2d10-492d-9c37-361fe0b79427	a3bd24c5-60d2-4617-ba43-a96c97382e64
79	79	0	Plazi	ffb07bec-2d10-492d-9c37-361fe0b79427	a43674d7-4491-4f82-8475-45234af02d3a
0	22223	22223	U.S. Geological Survey	8618c64a-93e0-4300-b546-7249e5148ed2	a6f37a35-cb18-4395-9a0c-5be222c8e6c8
35517	35517	0	South African Biodiversity Information Facility	7190b835-4e86-4b6e-85c1-19cc6677c250	aa4916c3-3dc7-4c90-9f8e-b81d986df153
18961	18961	0	Atlas of Living Australia	4a6f1b71-969e-4fc5-a693-282b05e1220c	ab30baed-1f40-48c4-a37b-ae7cf9d5266f
0	10	10	Plazi	ffb07bec-2d10-492d-9c37-361fe0b79427	aba90381-a21c-44d1-8538-621d561de658
26	26	0	Participant Node Managers Committee	7f48e0c8-5c96-49ec-b972-30748e339115	acbb4fb4-94b9-4eff-9659-03fce17bbc72
0	2	2	Plazi	ffb07bec-2d10-492d-9c37-361fe0b79427	b04e1fba-4c09-4ad1-9c1a-f1dff9c7b13b
0	11046	11046	U.S. Geological Survey	8618c64a-93e0-4300-b546-7249e5148ed2	b2974853-6c41-4c63-a11b-7989e58a3ad4
7812	7812	0	GBIF Kenya	2a44d626-9f7a-4120-8a7a-4ab5ac15ff2a	b35a84e1-9584-4240-8186-c2461c4b6a06
0	1677	1677	Ocean Biodiversity Information System	ba0670b9-4186-41e6-8e70-f9cb3065551a	b635be2e-76ea-4600-8f83-549601653c0a
10	10	0	Plazi	ffb07bec-2d10-492d-9c37-361fe0b79427	b8830828-f6a1-4af1-b344-a5bc92fb1b20
13806	13806	0	U.S. Geological Survey	8618c64a-93e0-4300-b546-7249e5148ed2	b902eee0-ecf4-4269-8af0-0e67d753b89a
14472	14499	27	GBIF Finland	dd514216-5c7c-45f3-910d-797424cb5be6	baeca59f-e986-49fb-b322-1f940c446bc1
3	3	0	Plazi	ffb07bec-2d10-492d-9c37-361fe0b79427	bd8983b8-3732-4410-a7b7-df76c2572d9f
0	20	20	Plazi	ffb07bec-2d10-492d-9c37-361fe0b79427	c176c1fb-0892-4318-827a-9506b774cf2a
0	2	2	Plazi	ffb07bec-2d10-492d-9c37-361fe0b79427	c36799a7-3d03-4f10-994a-8621f026a70c
317	317	0	National Biodiversity Network	d897a5b9-35ee-4232-94bd-b0bcaac003c2	c4ded37c-17e4-4848-b21d-cc17c16d86e6
3	3	0	Plazi	ffb07bec-2d10-492d-9c37-361fe0b79427	c506d8d6-6cbd-43f0-99ba-c1527ee0c41f
0	58	58	Plazi	ffb07bec-2d10-492d-9c37-361fe0b79427	c52f9144-998c-47f8-9b7c-9dc386f6fd87
115	115	0	GBIF France	da44cd31-5901-4687-a106-6d1c7734ee3a	c5c2e112-b79c-40c8-b32a-7a963f3d8bef
0	9	9	Plazi	ffb07bec-2d10-492d-9c37-361fe0b79427	c66dee64-6ecd-4df5-b951-fbb2ee87ca1b
14659	14659	0	Korean Biodiversity Information Facility	e0a1e772-0177-4800-94b4-2d023fe6cdf4	c6b0f7e3-5fd9-4566-8fd4-8f12c26fa8b6
4	4	0	Plazi	ffb07bec-2d10-492d-9c37-361fe0b79427	c95d4f1b-857a-4982-85aa-01651bf451bb
4	4	0	Plazi	ffb07bec-2d10-492d-9c37-361fe0b79427	caeead37-b6ce-4f03-96d2-ae8c8beb8573
0	30	30	Ocean Biodiversity Information System	ba0670b9-4186-41e6-8e70-f9cb3065551a	caf4d6a4-64ae-4335-a710-3d0dddc10b50
283	283	0	Secretariat of the Pacific Regional Environment Programme	29c6a139-ea7f-41f5-8d9b-c55af8736182	cd6bb071-b4c6-4e7a-b328-da53662128b1
130004	134233	4229	GBIF Brazil	cdc9736d-5ff7-4ece-9959-3c744360cdb3	d2470ef8-edfa-4ba7-821e-c3e1a537bdba
16	16	0	Plazi	ffb07bec-2d10-492d-9c37-361fe0b79427	d2c5d8c4-d2e2-44a7-add4-3a94812d2581
48	48	0	Plazi	ffb07bec-2d10-492d-9c37-361fe0b79427	d6a4aaf4-4045-4302-8220-413a7eca4f99
2	2	0	Plazi	ffb07bec-2d10-492d-9c37-361fe0b79427	d84e6a89-a7db-42aa-beb5-d368571b616e
0	33	33	Ocean Biodiversity Information System	ba0670b9-4186-41e6-8e70-f9cb3065551a	d8c5c8ee-50a9-410c-845d-438e77ed9fd0
29	29	0	Plazi	ffb07bec-2d10-492d-9c37-361fe0b79427	da5b3047-b669-4276-89ef-69ecf31d33ff
2370	100	-2270	Biodiversity Information System of Mexico	b324e8e9-9a4c-44fa-8f1a-7f39ea7ab576	dab1c0f0-2547-4d5a-9463-05c5e946863e
46416	46416	0	Taiwan Biodiversity Information Facility	e1b85abc-61f9-430f-ba79-6813dec53a0f	db09684b-0fd1-431e-b5fa-4c1532fbdb14
527	527	0	GBIF Japan	db5705aa-6a6e-42f1-8942-d77b9f4896ea	e1607db2-1867-43bf-a472-442057592565
2	2	0	Plazi	ffb07bec-2d10-492d-9c37-361fe0b79427	e2ca607c-68f4-46a6-b847-581b3253eb24
0	6	6	Plazi	ffb07bec-2d10-492d-9c37-361fe0b79427	e33543a3-9336-4e50-9bb1-40503ec8f724
36	36	0	Plazi	ffb07bec-2d10-492d-9c37-361fe0b79427	e495fafd-5457-440e-9907-95f81759f9d8
65	65	0	GBIF Germany	4f6826f2-4ff6-443d-b966-e6913bd24013	e5295eaa-415e-477e-a7b5-538bd21d0114
0	7	7	Plazi	ffb07bec-2d10-492d-9c37-361fe0b79427	e68a27e9-a434-4eb8-a9f5-e4d4e02fa423
5	5	0	Participant Node Managers Committee	7f48e0c8-5c96-49ec-b972-30748e339115	e6b352be-3f52-43ab-9cd8-ffb00f0b8883
194	194	0	Plazi	ffb07bec-2d10-492d-9c37-361fe0b79427	e6ea8eea-7156-4785-8313-f4bd88dadad1
468	468	0	Participant Node Managers Committee	7f48e0c8-5c96-49ec-b972-30748e339115	e7e82c33-d94f-4b20-a2f9-19bce518e571
1609	1609	0	Taiwan Biodiversity Information Facility	e1b85abc-61f9-430f-ba79-6813dec53a0f	ea9608d2-7101-4d46-a7d0-9add260cd28c
2	2	0	Plazi	ffb07bec-2d10-492d-9c37-361fe0b79427	ec9650f2-c3b7-4a0d-ae1a-24c3433a2539
6499	6499	0	GBIF France	da44cd31-5901-4687-a106-6d1c7734ee3a	ecdf78fd-3bc4-4ee6-8479-f4f260613910
0	8	8	Plazi	ffb07bec-2d10-492d-9c37-361fe0b79427	ee90cb23-3c1b-48ca-afab-10b66f43ab30
313	313	0	GBIF France	da44cd31-5901-4687-a106-6d1c7734ee3a	f4265d18-ab77-462e-9aa4-f7fae08c9838
12	12	0	GBIF Germany	4f6826f2-4ff6-443d-b966-e6913bd24013	f698976d-e373-42ee-b74d-67fba73691a8
0	204	204	Ocean Biodiversity Information System	ba0670b9-4186-41e6-8e70-f9cb3065551a	f78f8bf9-b3b5-4be2-a163-06d29b60ab33
290016	290016	0	Atlas of Living Australia	4a6f1b71-969e-4fc5-a693-282b05e1220c	f906d1c4-6e1a-46dd-8805-ec98b5091908
2	2	0	GBIF Portugal	673f7038-4262-4149-b753-5658a4e912f6	f90de717-7b3f-483f-aca2-46c300fe36a8
2556	2556	0	GBIF France	da44cd31-5901-4687-a106-6d1c7734ee3a	fb62063b-faee-4c51-b126-1546f1c1a93a
1	1	0	Plazi	ffb07bec-2d10-492d-9c37-361fe0b79427	fc5a84b5-635b-4fad-870d-442a6b0983e8
0	36	36	Ocean Biodiversity Information System	ba0670b9-4186-41e6-8e70-f9cb3065551a	fcbf1bf6-3add-4b4c-8678-a95c954a479d
2	2	0	Plazi	ffb07bec-2d10-492d-9c37-361fe0b79427	01b4cf78-dd72-4ec1-8759-024e5a4ec85b
8	8	0	Plazi	ffb07bec-2d10-492d-9c37-361fe0b79427	04b589cc-2cd4-4f49-be80-4a4a9edf6752
3035	3035	0	GBIF Brazil	cdc9736d-5ff7-4ece-9959-3c744360cdb3	08360d4a-43dc-4573-86a2-9695d0ad3c90
117	117	0	Belgian Biodiversity Platform	fb11cfe1-ebc3-45af-9159-17d9fddbcdac	099911ec-84c6-453f-995a-3ad064ec9d71
23	23	0	Atlas of Living Australia	4a6f1b71-969e-4fc5-a693-282b05e1220c	0a19563f-bc70-4a63-b41b-30a90dd8e1a8
1328	1559	231	Participant Node Managers Committee	7f48e0c8-5c96-49ec-b972-30748e339115	0c4eacef-79ba-4b22-8822-291b2ce69f21
0	101	101	Ocean Biodiversity Information System	ba0670b9-4186-41e6-8e70-f9cb3065551a	0d5553a5-57e4-472a-a143-b65de50f4811
1	1	0	Plazi	ffb07bec-2d10-492d-9c37-361fe0b79427	0df19d36-8f35-4ff8-82b2-da7b57be0594
173	173	0	Colombian Biodiversity Information System	7e865cba-7c46-417b-ade5-97f2cf5b7be0	104597f2-c4ae-417b-9098-50dc0db2fd6b
4	4	0	Plazi	ffb07bec-2d10-492d-9c37-361fe0b79427	115434de-7633-4401-baac-5b4cfe616488
0	1268	1268	Ocean Biodiversity Information System	ba0670b9-4186-41e6-8e70-f9cb3065551a	174f740e-8e52-4c74-94b2-bfca8fd37b66
0	18	18	Plazi	ffb07bec-2d10-492d-9c37-361fe0b79427	19fb1fd0-d579-4f4a-8c53-3a7171309bc7
2112	2279	167	Colombian Biodiversity Information System	7e865cba-7c46-417b-ade5-97f2cf5b7be0	1a58ec89-e5d4-4b2b-9ed3-1c8b5f70f4fc
32	32	0	Plazi	ffb07bec-2d10-492d-9c37-361fe0b79427	1b0654ea-eecb-4242-ad9a-850602f7d185
5	5	0	Plazi	ffb07bec-2d10-492d-9c37-361fe0b79427	1b259352-877d-478f-af23-1319751dd65e
246	246	0	GBIF Norway	4f829580-180d-46a9-9c87-ed8ec959b545	1c8154f9-a6a9-4302-b09a-78ab079dccc8
70	70	0	Plazi	ffb07bec-2d10-492d-9c37-361fe0b79427	1eb2dc70-e7de-40c5-83b4-9116045d48fe
11482	11482	0	National Biodiversity Network	d897a5b9-35ee-4232-94bd-b0bcaac003c2	22f40db4-cdeb-499c-82fe-5d401829747d
430	430	0	Plazi	ffb07bec-2d10-492d-9c37-361fe0b79427	23c131dd-5ac6-4ce7-ba1b-7baf3c4e5e34
90	90	0	Biodiversity Information System of Mexico	b324e8e9-9a4c-44fa-8f1a-7f39ea7ab576	2838b79f-bd50-46cd-ac42-2bef5771a646
2673	2673	0	National Biodiversity Network	d897a5b9-35ee-4232-94bd-b0bcaac003c2	2ce65268-cf51-4ecb-bb36-ce615564c255
16203	17767	1564	GBIF Brazil	cdc9736d-5ff7-4ece-9959-3c744360cdb3	2deca60c-f147-417f-9af4-b52067589e99
7	7	0	Plazi	ffb07bec-2d10-492d-9c37-361fe0b79427	3460e70b-3367-418d-b5d4-ee5f3ba6c74e
1562	1562	0	GBIF Brazil	cdc9736d-5ff7-4ece-9959-3c744360cdb3	34c5f30d-675b-4bc0-8c63-3af03bf6210d
38445	38445	0	Atlas of Living Australia	4a6f1b71-969e-4fc5-a693-282b05e1220c	34cb7d73-fce2-46f2-b4df-f8ec6085b8c2
0	1112	1112	Ocean Biodiversity Information System	ba0670b9-4186-41e6-8e70-f9cb3065551a	3ab60647-07fb-4ed5-bc18-68ecae74899e
8	8	0	Plazi	ffb07bec-2d10-492d-9c37-361fe0b79427	3ca4c8aa-1ac9-4cc7-9a62-1fc867196dc3
514	514	0	GBIF France	da44cd31-5901-4687-a106-6d1c7734ee3a	3da4ec27-5b85-4ecd-9fe1-87d8a1ed49dc
90	90	0	GBIF France	da44cd31-5901-4687-a106-6d1c7734ee3a	3fdcb96f-9c96-4864-b52f-39c9b71ece78
1897	1897	0	Biodiversity Information System of Mexico	b324e8e9-9a4c-44fa-8f1a-7f39ea7ab576	413e35f1-88f9-4174-aab4-ad808116a910
0	7	7	Plazi	ffb07bec-2d10-492d-9c37-361fe0b79427	4151d25e-e425-4e19-a9a0-8b049ca211b2
27719	27719	0	GBIF France	da44cd31-5901-4687-a106-6d1c7734ee3a	464a48c6-d90c-4570-8e19-5e62e6bb1e57
48	48	0	Participant Node Managers Committee	7f48e0c8-5c96-49ec-b972-30748e339115	47f0f51f-183e-4a51-9d13-c69f2ed28c56
718	718	0	U.S. Geological Survey	8618c64a-93e0-4300-b546-7249e5148ed2	4cbc1722-e236-4496-8422-d49bb9310d57
1001482	1000468	-1014	Atlas of Living Australia	4a6f1b71-969e-4fc5-a693-282b05e1220c	4ce8e3f9-2546-4af1-b28d-e2eadf05dfd4
0	4	4	Plazi	ffb07bec-2d10-492d-9c37-361fe0b79427	4d0d31b3-ff97-4393-ac47-c0fb67d6c07e
0	25	25	Plazi	ffb07bec-2d10-492d-9c37-361fe0b79427	4fa02c9b-92c6-4c41-bc6c-265a30ffda5f
0	2	2	Plazi	ffb07bec-2d10-492d-9c37-361fe0b79427	51bab0c0-d141-4448-a899-615a71f2967d
946	946	0	Colombian Biodiversity Information System	7e865cba-7c46-417b-ade5-97f2cf5b7be0	528d764c-c43f-46d7-b192-27361ea378f5
48	48	0	Colombian Biodiversity Information System	7e865cba-7c46-417b-ade5-97f2cf5b7be0	55591114-cdec-443a-becc-45851cb29fb0
11	11	0	GBIF France	da44cd31-5901-4687-a106-6d1c7734ee3a	55593c15-b679-4352-9b03-4d38bd27c1b0
116	116	0	National Biodiversity Network	d897a5b9-35ee-4232-94bd-b0bcaac003c2	564c852e-026b-456b-ad05-7ae77657a066
0	3	3	Plazi	ffb07bec-2d10-492d-9c37-361fe0b79427	567b6953-7707-4078-a4d3-54bfe787094c
3	3	0	Plazi	ffb07bec-2d10-492d-9c37-361fe0b79427	578272bd-a696-4065-b739-dbf6966706f8
3	3	0	Plazi	ffb07bec-2d10-492d-9c37-361fe0b79427	58c8ec85-77bc-49f4-ada7-3c923d1ec269
0	11849	11849	Belgian Biodiversity Platform	fb11cfe1-ebc3-45af-9159-17d9fddbcdac	597829f7-08a8-4b3f-b419-2b735df45638
27	27	0	Colombian Biodiversity Information System	7e865cba-7c46-417b-ade5-97f2cf5b7be0	5bb8e3f0-fb03-4ed5-a33b-e7ccfa188606
0	10	10	Plazi	ffb07bec-2d10-492d-9c37-361fe0b79427	5bc54bc4-a879-4841-afd1-633eda9a3a68
239	239	0	Plazi	ffb07bec-2d10-492d-9c37-361fe0b79427	5be04284-fa94-4421-950c-44e924e7bdec
11	11	0	Plazi	ffb07bec-2d10-492d-9c37-361fe0b79427	5ed08b95-646d-41d0-bcf6-54ff44603e27
72199	72941	742	U.S. Geological Survey	8618c64a-93e0-4300-b546-7249e5148ed2	5f0d32a4-6902-481b-9694-6393ad40b973
0	3	3	Plazi	ffb07bec-2d10-492d-9c37-361fe0b79427	5f5264b3-c5aa-4b65-b186-07aa2137ac01
103	103	0	GBIF Germany	4f6826f2-4ff6-443d-b966-e6913bd24013	61d8651e-f762-11e1-a439-00145eb45e9a
12	12	0	GBIF Germany	4f6826f2-4ff6-443d-b966-e6913bd24013	6336bd66-f762-11e1-a439-00145eb45e9a
0	162	162	Plazi	ffb07bec-2d10-492d-9c37-361fe0b79427	63dbbe6e-64af-434b-a219-b643b33eed48
36	36	0	Participant Node Managers Committee	7f48e0c8-5c96-49ec-b972-30748e339115	63e504cb-59ea-4043-b390-a4639f9c71c6
110	110	0	GBIF Germany	4f6826f2-4ff6-443d-b966-e6913bd24013	63f4b19a-f762-11e1-a439-00145eb45e9a
1	1	0	Plazi	ffb07bec-2d10-492d-9c37-361fe0b79427	6433b7b7-e1e4-4638-a186-88f89473b9d4
58	58	0	GBIF Germany	4f6826f2-4ff6-443d-b966-e6913bd24013	6438f7b0-f762-11e1-a439-00145eb45e9a
22936	22936	0	National Biodiversity Network	d897a5b9-35ee-4232-94bd-b0bcaac003c2	64493723-85d9-4234-ae31-643a9ca1a7ea
77	58	-19	GBIF Germany	4f6826f2-4ff6-443d-b966-e6913bd24013	660e4b58-f762-11e1-a439-00145eb45e9a
0	5	5	Plazi	ffb07bec-2d10-492d-9c37-361fe0b79427	66142ef3-f406-4cee-bef3-af3efb4fa5ee
0	871	871	Ocean Biodiversity Information System	ba0670b9-4186-41e6-8e70-f9cb3065551a	679b7cb7-462c-4354-9273-b22b9a0fdc80
0	9	9	Plazi	ffb07bec-2d10-492d-9c37-361fe0b79427	686337a2-1528-43d0-ae32-68ca023d8df3
95	95	0	GBIF Germany	4f6826f2-4ff6-443d-b966-e6913bd24013	69171712-f762-11e1-a439-00145eb45e9a
4295	4295	0	GBIF Benin	efb9c00e-f802-45dd-8826-a52ec45b89ff	6a01a01f-10a9-49bc-b0d1-2bd04493dc20
16	16	0	GBIF Germany	4f6826f2-4ff6-443d-b966-e6913bd24013	6afec6a6-f762-11e1-a439-00145eb45e9a
21	21	0	GBIF Germany	4f6826f2-4ff6-443d-b966-e6913bd24013	6b431c3e-f762-11e1-a439-00145eb45e9a
29946	29946	0	GBIF France	da44cd31-5901-4687-a106-6d1c7734ee3a	6be61052-e67e-4143-8c1a-5683d4d5da4e
0	37	37	Plazi	ffb07bec-2d10-492d-9c37-361fe0b79427	6dc43d48-b722-4035-be54-6161e669e45b
0	40	40	Ocean Biodiversity Information System	ba0670b9-4186-41e6-8e70-f9cb3065551a	6e1d5b58-a39b-44e9-9700-695420b1d5f3
54	54	0	GBIF Germany	4f6826f2-4ff6-443d-b966-e6913bd24013	6f9bb994-f762-11e1-a439-00145eb45e9a
77	77	0	GBIF Germany	4f6826f2-4ff6-443d-b966-e6913bd24013	6ff3c102-f762-11e1-a439-00145eb45e9a
26	26	0	GBIF Germany	4f6826f2-4ff6-443d-b966-e6913bd24013	7004324e-f762-11e1-a439-00145eb45e9a
66	66	0	GBIF Germany	4f6826f2-4ff6-443d-b966-e6913bd24013	70773668-f762-11e1-a439-00145eb45e9a
46	46	0	Participant Node Managers Committee	7f48e0c8-5c96-49ec-b972-30748e339115	70d21e0d-7e59-493d-b5d7-eeff5079fd96
16	16	0	GBIF Germany	4f6826f2-4ff6-443d-b966-e6913bd24013	729c0e14-f762-11e1-a439-00145eb45e9a
0	2	2	Plazi	ffb07bec-2d10-492d-9c37-361fe0b79427	72eac1c6-3417-4475-b7a3-f45e31700c41
31	31	0	GBIF Germany	4f6826f2-4ff6-443d-b966-e6913bd24013	73aa5e8c-f762-11e1-a439-00145eb45e9a
0	5	5	Plazi	ffb07bec-2d10-492d-9c37-361fe0b79427	73cd2f85-a2e7-40f1-a258-94860fdf747e
30	30	0	GBIF Germany	4f6826f2-4ff6-443d-b966-e6913bd24013	749e92e0-f762-11e1-a439-00145eb45e9a
132	132	0	GBIF Germany	4f6826f2-4ff6-443d-b966-e6913bd24013	74f32ac6-f762-11e1-a439-00145eb45e9a
575	575	0	GBIF Germany	4f6826f2-4ff6-443d-b966-e6913bd24013	7517c19c-f762-11e1-a439-00145eb45e9a
207	207	0	GBIF Germany	4f6826f2-4ff6-443d-b966-e6913bd24013	751bce68-f762-11e1-a439-00145eb45e9a
37	37	0	GBIF Germany	4f6826f2-4ff6-443d-b966-e6913bd24013	756047e6-f762-11e1-a439-00145eb45e9a
3784	3784	0	GBIF France	da44cd31-5901-4687-a106-6d1c7734ee3a	75e787b4-14c4-4040-9bd8-477d343e3a91
0	2	2	Plazi	ffb07bec-2d10-492d-9c37-361fe0b79427	78a0fe19-93a2-44ac-a58d-83341d3165a8
246	246	0	GBIF Germany	4f6826f2-4ff6-443d-b966-e6913bd24013	7a17fa5e-f762-11e1-a439-00145eb45e9a
61	61	0	GBIF Germany	4f6826f2-4ff6-443d-b966-e6913bd24013	7a771002-f762-11e1-a439-00145eb45e9a
0	2	2	Plazi	ffb07bec-2d10-492d-9c37-361fe0b79427	7a7fe717-ef8a-4509-83fb-b8940b9e1ec2
1357	1357	0	GBIF Germany	4f6826f2-4ff6-443d-b966-e6913bd24013	7c3e66d8-f762-11e1-a439-00145eb45e9a
180	180	0	GBIF Germany	4f6826f2-4ff6-443d-b966-e6913bd24013	7e6156e6-f762-11e1-a439-00145eb45e9a
99	99	0	GBIF Germany	4f6826f2-4ff6-443d-b966-e6913bd24013	7e62c256-f762-11e1-a439-00145eb45e9a
819	819	0	GBIF Germany	4f6826f2-4ff6-443d-b966-e6913bd24013	7f08266a-f762-11e1-a439-00145eb45e9a
180	180	0	Biodiversity Information System of Mexico	b324e8e9-9a4c-44fa-8f1a-7f39ea7ab576	7fb836c2-f762-11e1-a439-00145eb45e9a
10	10	0	Plazi	ffb07bec-2d10-492d-9c37-361fe0b79427	8004ac24-5295-475a-85c8-bbf2b651c671
1881	1881	0	GBIF Germany	4f6826f2-4ff6-443d-b966-e6913bd24013	814c7c46-f762-11e1-a439-00145eb45e9a
41575	41575	0	South African Biodiversity Information Facility	7190b835-4e86-4b6e-85c1-19cc6677c250	823c374e-b830-4ff2-9e97-0e86c39a3d8a
164357	164357	0	GBIF Switzerland	169eb292-376b-4cc6-8e31-9c2c432de0ad	82a53efc-f762-11e1-a439-00145eb45e9a
6	6	0	Colombian Biodiversity Information System	7e865cba-7c46-417b-ade5-97f2cf5b7be0	82e8c15e-10e8-42fe-b42c-99a45b344177
3	3	0	Plazi	ffb07bec-2d10-492d-9c37-361fe0b79427	83a6ad93-a32f-489f-9f85-5c34a0d5a073
9767	9767	0	Ocean Biodiversity Information System	ba0670b9-4186-41e6-8e70-f9cb3065551a	83b1eeda-f762-11e1-a439-00145eb45e9a
1809	1801	-8	Ocean Biodiversity Information System	ba0670b9-4186-41e6-8e70-f9cb3065551a	83fc8030-f762-11e1-a439-00145eb45e9a
5224	5224	0	GBIF Japan	db5705aa-6a6e-42f1-8942-d77b9f4896ea	84979f16-f762-11e1-a439-00145eb45e9a
12520	12520	0	National Biodiversity Network	d897a5b9-35ee-4232-94bd-b0bcaac003c2	852348b9-453f-4aa2-a9db-69f9cda6fc77
35	35	0	GBIF France	da44cd31-5901-4687-a106-6d1c7734ee3a	86866d88-96f1-42bc-a47e-e277c101fba9
0	2	2	Plazi	ffb07bec-2d10-492d-9c37-361fe0b79427	8845917e-f9eb-4267-9a41-6923562e2bfd
0	5531	5531	Biodiversity Information System of Mexico	b324e8e9-9a4c-44fa-8f1a-7f39ea7ab576	88c8a7ea-a0bd-4aa5-9331-ac81895c2dd7
1636	1636	0	Ocean Biodiversity Information System	ba0670b9-4186-41e6-8e70-f9cb3065551a	890d62e2-f762-11e1-a439-00145eb45e9a
3678	3678	0	Ocean Biodiversity Information System	ba0670b9-4186-41e6-8e70-f9cb3065551a	89148f22-f762-11e1-a439-00145eb45e9a
336	336	0	GBIF Germany	4f6826f2-4ff6-443d-b966-e6913bd24013	89fc1662-f762-11e1-a439-00145eb45e9a
0	678	678	Participant Node Managers Committee	7f48e0c8-5c96-49ec-b972-30748e339115	8b69f029-f987-4fae-8c8b-e90575885fc3
284	284	0	GBIF Spain	1f94b3ca-9345-4d65-afe2-4bace93aa0fe	8c6bb163-3308-4430-9d5f-c5a4ec78d188
44	44	0	GBIF Germany	4f6826f2-4ff6-443d-b966-e6913bd24013	8d4a5540-f762-11e1-a439-00145eb45e9a
485	456	-29	GBIF Germany	4f6826f2-4ff6-443d-b966-e6913bd24013	8d9456fe-f762-11e1-a439-00145eb45e9a
3	3	0	Plazi	ffb07bec-2d10-492d-9c37-361fe0b79427	8ea5df1f-c223-485d-99ac-43d611b42607
515	362	-153	GBIF Germany	4f6826f2-4ff6-443d-b966-e6913bd24013	8ebaa7f4-f762-11e1-a439-00145eb45e9a
24	24	0	Plazi	ffb07bec-2d10-492d-9c37-361fe0b79427	8f333c71-5a78-4c67-8a0e-1debc2cfd643
658	462	-196	GBIF Germany	4f6826f2-4ff6-443d-b966-e6913bd24013	902eddbc-f762-11e1-a439-00145eb45e9a
140	77	-63	GBIF Germany	4f6826f2-4ff6-443d-b966-e6913bd24013	90745dce-f762-11e1-a439-00145eb45e9a
732	543	-189	GBIF Germany	4f6826f2-4ff6-443d-b966-e6913bd24013	909fb58c-f762-11e1-a439-00145eb45e9a
9	5	-4	GBIF Germany	4f6826f2-4ff6-443d-b966-e6913bd24013	90c74408-f762-11e1-a439-00145eb45e9a
39	34	-5	GBIF Germany	4f6826f2-4ff6-443d-b966-e6913bd24013	9148643e-f762-11e1-a439-00145eb45e9a
470	412	-58	GBIF Germany	4f6826f2-4ff6-443d-b966-e6913bd24013	917252b2-f762-11e1-a439-00145eb45e9a
209	209	0	Belgian Biodiversity Platform	fb11cfe1-ebc3-45af-9159-17d9fddbcdac	927e0a83-e166-4c00-b27d-a814e87dd074
231	231	0	GBIF Germany	4f6826f2-4ff6-443d-b966-e6913bd24013	928f2f4e-f762-11e1-a439-00145eb45e9a
455	455	0	GBIF France	da44cd31-5901-4687-a106-6d1c7734ee3a	92b3e8d2-f171-457a-988b-84ee5a03bd31
156	156	0	GBIF Spain	1f94b3ca-9345-4d65-afe2-4bace93aa0fe	95e8b28c-f762-11e1-a439-00145eb45e9a
14	14	0	Plazi	ffb07bec-2d10-492d-9c37-361fe0b79427	9773657e-8372-45b6-b04f-5df047fb3f6b
1167	1167	0	Korean Biodiversity Information Facility	e0a1e772-0177-4800-94b4-2d023fe6cdf4	9948a0b6-27fc-11e2-85e3-00145eb45e9a
1951	1945	-6	Taiwan Biodiversity Information Facility	e1b85abc-61f9-430f-ba79-6813dec53a0f	994c1c46-9837-4548-869d-8f69668e245a
1140	1140	0	Biodiversity Information System of Mexico	b324e8e9-9a4c-44fa-8f1a-7f39ea7ab576	99f882de-a7c6-45bf-bb5b-d0975a50f5e6
95	95	0	Plazi	ffb07bec-2d10-492d-9c37-361fe0b79427	9a3c6348-e81b-4b2c-bc2d-aed97387419b
3391	3391	0	Biodiversity Information System of Mexico	b324e8e9-9a4c-44fa-8f1a-7f39ea7ab576	9c4cf345-3f51-4155-8cb7-cd9f72efc58c
306	306	0	Biodiversity Information System of Mexico	b324e8e9-9a4c-44fa-8f1a-7f39ea7ab576	9df34318-5dc2-4edd-85ed-a2368e5c2cc7
0	11387	11387	GBIF Sweden	a0b3be64-6525-4387-ac67-a499950f92e1	9e29a2fe-d780-48a8-a93f-9ce041f9202f
129100	129100	0	U.S. Geological Survey	8618c64a-93e0-4300-b546-7249e5148ed2	a0a4d131-f53f-43b2-a1ba-254473b8a006
15	15	0	Plazi	ffb07bec-2d10-492d-9c37-361fe0b79427	a1d73d3e-e33e-4a19-aab8-55876eb1408b
0	8	8	Plazi	ffb07bec-2d10-492d-9c37-361fe0b79427	a3f095d8-9659-471a-9ca3-a1b1f066dc98
0	940	940	Ocean Biodiversity Information System	ba0670b9-4186-41e6-8e70-f9cb3065551a	a4b72121-0e8a-45bd-a151-b2b65f6b787b
10120	12713	2593	GBIF Germany	4f6826f2-4ff6-443d-b966-e6913bd24013	a5458d08-3a0c-11e2-b0ce-00145eb45e9a
0	329	329	Ocean Biodiversity Information System	ba0670b9-4186-41e6-8e70-f9cb3065551a	a56a589b-1419-40e6-9220-d23cde945667
20	20	0	Plazi	ffb07bec-2d10-492d-9c37-361fe0b79427	a9fc01a1-cd41-459f-b9d5-addaf795dce4
143	143	0	Plazi	ffb07bec-2d10-492d-9c37-361fe0b79427	abf4bd0e-f807-48ce-b161-8fa6e38eae9a
2	2	0	Plazi	ffb07bec-2d10-492d-9c37-361fe0b79427	ac5a7c87-f97d-468e-b6cf-288ce1960482
1142431	1142431	0	GBIF Germany	4f6826f2-4ff6-443d-b966-e6913bd24013	ad0d1a24-e952-11e2-961f-00145eb45e9a
4	4	0	Plazi	ffb07bec-2d10-492d-9c37-361fe0b79427	aeb5f27b-9b28-4c91-82bd-2e9f1519b650
0	2531	2531	Participant Node Managers Committee	7f48e0c8-5c96-49ec-b972-30748e339115	aedc4318-7e34-453e-8c43-cc9abf9563d3
7	7	0	Plazi	ffb07bec-2d10-492d-9c37-361fe0b79427	b4a5ff90-f85d-4aff-a856-8be6b5dc0559
92	92	0	GBIF Germany	4f6826f2-4ff6-443d-b966-e6913bd24013	b55fd2a1-9ff5-4d4a-a8d7-e5a69d3c4043
6	6	0	Plazi	ffb07bec-2d10-492d-9c37-361fe0b79427	b7070d9b-285e-47c3-b614-8333be2e2121
40914	40914	0	Participant Node Managers Committee	7f48e0c8-5c96-49ec-b972-30748e339115	b8bf1fd9-e2d3-444a-a0b3-bc02794d961d
1261	1261	0	Participant Node Managers Committee	7f48e0c8-5c96-49ec-b972-30748e339115	ba616e95-4ac1-4c4c-965d-bec83859c6a7
8693	8693	0	GBIF Brazil	cdc9736d-5ff7-4ece-9959-3c744360cdb3	bcf92a29-8c8d-4938-aa53-554ee99116ac
289	289	0	Colombian Biodiversity Information System	7e865cba-7c46-417b-ade5-97f2cf5b7be0	bd1bfcf0-a796-47b8-b56e-50c840216b12
273	273	0	U.S. Geological Survey	8618c64a-93e0-4300-b546-7249e5148ed2	c12a720a-b381-40ce-9746-7cecb8a7735c
11	11	0	GBIF Togo	c9659a3e-07e9-4fcb-83c6-de8b9009a02e	c34f4089-16c3-4cbd-8bf7-02184f093633
5	5	0	Plazi	ffb07bec-2d10-492d-9c37-361fe0b79427	c5fc96db-45da-4fc2-b5ca-28ec8855615c
1	1	0	Plazi	ffb07bec-2d10-492d-9c37-361fe0b79427	c7de5376-020b-41e8-b84e-b32151e3735e
3	3	0	Plazi	ffb07bec-2d10-492d-9c37-361fe0b79427	c9d4217b-1806-4bdb-8a7a-decf8a03468e
661	661	0	Participant Node Managers Committee	7f48e0c8-5c96-49ec-b972-30748e339115	caaa6bf4-c6a1-4960-8b40-c817be0caaf0
54	54	0	GBIF Argentina	2426a871-9feb-40a1-96c6-0c593a76b835	cc2aef5c-82d4-402e-95c4-de1e551efc31
37465	39442	1977	GBIF Norway	4f829580-180d-46a9-9c87-ed8ec959b545	d0e09c39-ec7a-4821-8232-027f8e56e302
6521	6521	0	National Biodiversity Network	d897a5b9-35ee-4232-94bd-b0bcaac003c2	d0e5358e-700d-454f-9cf2-8134fcebbe8b
3	3	0	Plazi	ffb07bec-2d10-492d-9c37-361fe0b79427	d2042781-1ae2-49d4-9913-c61bbc591b90
94	94	0	GBIF France	da44cd31-5901-4687-a106-6d1c7734ee3a	d3075fe8-3e38-42fa-b168-0594e05c7ca8
41	41	0	Plazi	ffb07bec-2d10-492d-9c37-361fe0b79427	d41c057e-5b64-4634-84dc-bd5f56a9d789
4	4	0	Plazi	ffb07bec-2d10-492d-9c37-361fe0b79427	d816eb1e-43e3-4440-8f0f-4121aa0909bd
0	2	2	Plazi	ffb07bec-2d10-492d-9c37-361fe0b79427	d8609289-d574-44c4-bf34-3a9c46488a60
11	11	0	GBIF Argentina	2426a871-9feb-40a1-96c6-0c593a76b835	da10eb67-960b-4df0-957e-10d9591ef802
421	421	0	Ocean Biodiversity Information System	ba0670b9-4186-41e6-8e70-f9cb3065551a	dc529695-b67e-4cf5-ad45-9fd6dd63902e
0	573	573	Ocean Biodiversity Information System	ba0670b9-4186-41e6-8e70-f9cb3065551a	de8134a7-3912-4f14-aa73-c2e6b690004a
3	3	0	Plazi	ffb07bec-2d10-492d-9c37-361fe0b79427	e093df50-57c6-4db3-83c4-1a7c8b3bfe6c
924	396	-528	GBIF Germany	4f6826f2-4ff6-443d-b966-e6913bd24013	e19d6490-240b-4a51-9c2a-265532a5207b
0	4	4	Plazi	ffb07bec-2d10-492d-9c37-361fe0b79427	e2f96cb3-bff4-4190-8bf1-bbd05896601e
258	258	0	GBIF Benin	efb9c00e-f802-45dd-8826-a52ec45b89ff	e322c569-8644-47a5-a319-3fde606e1a25
12	12	0	Plazi	ffb07bec-2d10-492d-9c37-361fe0b79427	e42fbbb4-d375-4137-88de-264bcd467de2
285727	282874	-2853	U.S. Geological Survey	8618c64a-93e0-4300-b546-7249e5148ed2	e48d6c49-34a3-4df6-8206-121c061f190d
305	305	0	GBIF India	59d15a9b-ba51-43c3-a53f-304fe6732c04	e61455a4-352d-4c55-83ea-dbca254e3b29
332384	332384	0	U.S. Geological Survey	8618c64a-93e0-4300-b546-7249e5148ed2	e6712257-e922-4bc3-8b5e-e567a0458ad2
1	1	0	Plazi	ffb07bec-2d10-492d-9c37-361fe0b79427	e7f7c319-f97b-4ab7-945c-4c88158d3a29
4573	4573	0	Taiwan Biodiversity Information Facility	e1b85abc-61f9-430f-ba79-6813dec53a0f	e94cb3b1-3c64-422d-a575-c8a12af50dd0
2730	2730	0	GBIF France	da44cd31-5901-4687-a106-6d1c7734ee3a	eb7373a4-ec87-4a14-b812-ec1cd05692b1
0	9	9	Plazi	ffb07bec-2d10-492d-9c37-361fe0b79427	ede3d1b3-f1b2-4ab9-a956-58eced8e13a5
46	46	0	Plazi	ffb07bec-2d10-492d-9c37-361fe0b79427	ee50cb84-97f6-4c92-9412-fd0dfa9466af
0	2	2	Plazi	ffb07bec-2d10-492d-9c37-361fe0b79427	f29b1e52-a2b0-4ba2-a1c4-4b5762ecb918
3535	3535	0	GBIF Norway	4f829580-180d-46a9-9c87-ed8ec959b545	f3c5a8cd-dd9c-4307-be91-195464f016bd
555	505	-50	GBIF Germany	4f6826f2-4ff6-443d-b966-e6913bd24013	f6c15229-c4eb-4afa-aa7f-aee3c95f3dd6
3	3	0	Plazi	ffb07bec-2d10-492d-9c37-361fe0b79427	f6d47c34-f7d4-4ec3-b557-07d9c6ed1a78
2	2	0	Plazi	ffb07bec-2d10-492d-9c37-361fe0b79427	f7fa812b-185d-4610-b6b0-1ea2b3253941
11603	11603	0	South African Biodiversity Information Facility	7190b835-4e86-4b6e-85c1-19cc6677c250	f8cd9c4d-4693-40d7-9c0c-a3ce2ea2a1c3
5	5	0	Plazi	ffb07bec-2d10-492d-9c37-361fe0b79427	f910478a-92a3-4de6-8d96-d8d37ce28163
3	3	0	Plazi	ffb07bec-2d10-492d-9c37-361fe0b79427	fc2de404-139d-463a-8a7c-f7f217deef24
42	42	0	Plazi	ffb07bec-2d10-492d-9c37-361fe0b79427	fca28bef-b5bc-44e0-bab0-a9d527e5784a
40	40	0	Participant Node Managers Committee	7f48e0c8-5c96-49ec-b972-30748e339115	fdfbc4d7-9acb-4fe1-b9ee-d4f8e72aa3a1
0	3	3	Plazi	ffb07bec-2d10-492d-9c37-361fe0b79427	fe006f9f-65ea-4233-bea6-b31aa20d884c
0	27	27	Plazi	ffb07bec-2d10-492d-9c37-361fe0b79427	fe519fa4-c277-4c66-a296-06e098779e50
3777	3777	0	Taiwan Biodiversity Information Facility	e1b85abc-61f9-430f-ba79-6813dec53a0f	00dfc6d8-0463-4302-862d-328a374965b9
0	42	42	Plazi	ffb07bec-2d10-492d-9c37-361fe0b79427	017e2143-04a5-43f8-a28a-724562013398
54	54	0	Plazi	ffb07bec-2d10-492d-9c37-361fe0b79427	03f22113-15fb-454c-9dc9-83b126ba0276
23	23	0	Plazi	ffb07bec-2d10-492d-9c37-361fe0b79427	03f57e34-275a-41b9-9fa1-10e22aba156e
328	328	0	GBIF France	da44cd31-5901-4687-a106-6d1c7734ee3a	09617a20-caf5-4d18-b49f-e2d339297e6f
1945	1945	0	GBIF France	da44cd31-5901-4687-a106-6d1c7734ee3a	0afa5933-71b8-4339-959f-fd9a11d36e5a
785	785	0	Plazi	ffb07bec-2d10-492d-9c37-361fe0b79427	0cbe0b8e-2019-4f5a-8336-2d4d9fcd8bf6
9	9	0	Plazi	ffb07bec-2d10-492d-9c37-361fe0b79427	0efbdd38-954d-4d75-a2c7-11b09da49774
28618	38743	10125	GBIF Japan	db5705aa-6a6e-42f1-8942-d77b9f4896ea	10a9ffed-8062-454b-bd7e-9c36b4006728
15	15	0	GBIF France	da44cd31-5901-4687-a106-6d1c7734ee3a	10b007f2-2d09-455d-b339-c5898d90bab5
4	4	0	Plazi	ffb07bec-2d10-492d-9c37-361fe0b79427	112f950a-a2bb-42bc-bece-1a8a75ce9b02
10	10	0	Plazi	ffb07bec-2d10-492d-9c37-361fe0b79427	13e985ad-20e7-440c-83f1-b5bf4cd4c0fd
4	5	1	Plazi	ffb07bec-2d10-492d-9c37-361fe0b79427	158f3ecb-a409-4a99-aaa4-4d9805fd0bed
0	1276	1276	Ocean Biodiversity Information System	ba0670b9-4186-41e6-8e70-f9cb3065551a	185fe247-2db3-4cc8-bae1-8b0ad2bb1899
0	250	250	Colombian Biodiversity Information System	7e865cba-7c46-417b-ade5-97f2cf5b7be0	1a5ef5b4-7b16-4881-bd13-2f5a9085a38b
0	13	13	Plazi	ffb07bec-2d10-492d-9c37-361fe0b79427	1c4bc124-fdc8-485c-bd5a-d618cef85997
125	125	0	GBIF France	da44cd31-5901-4687-a106-6d1c7734ee3a	1e67913c-258f-44e8-97c2-c2834b45d490
14564	14566	2	Canada Biodiversity Information Facility	8f83fc96-c966-4126-83f7-bf044dc49efa	21a0cb45-f0ec-4901-a868-cd45abe74601
2090	1415	-675	Colombian Biodiversity Information System	7e865cba-7c46-417b-ade5-97f2cf5b7be0	21b5400a-8810-40f1-b46a-7da00ab6ac70
10013	10013	0	GBIF France	da44cd31-5901-4687-a106-6d1c7734ee3a	23499b39-c4cf-4cbf-86fd-344567c9e742
1	1	0	Plazi	ffb07bec-2d10-492d-9c37-361fe0b79427	25b8fc1d-dea8-4040-9b82-c1dac882a344
940745	1008879	68134	National Biodiversity Network	d897a5b9-35ee-4232-94bd-b0bcaac003c2	25d4f82b-b2bc-4197-bc11-27c8e9a25439
4373	8434	4061	Colombian Biodiversity Information System	7e865cba-7c46-417b-ade5-97f2cf5b7be0	26d97e94-6ee9-4d5a-a9b8-7d514ec0345c
334	334	0	GBIF France	da44cd31-5901-4687-a106-6d1c7734ee3a	27496f15-dcb5-450e-b9aa-b77a19d469c2
2	2	0	Plazi	ffb07bec-2d10-492d-9c37-361fe0b79427	298e990c-ba0d-496f-8c3c-edf17846787f
3	3	0	Plazi	ffb07bec-2d10-492d-9c37-361fe0b79427	300ee73b-9e90-41ed-b549-b427504f2dec
618	618	0	GBIF France	da44cd31-5901-4687-a106-6d1c7734ee3a	333bdb41-1324-4f13-a99a-11093146d972
7	7	0	Plazi	ffb07bec-2d10-492d-9c37-361fe0b79427	3d7e1f7b-b917-4ca8-b53b-467f90e99de8
14	14	0	Participant Node Managers Committee	7f48e0c8-5c96-49ec-b972-30748e339115	3e1c846d-b023-4478-bdd7-f710ed254f8a
117	117	0	GBIF Brazil	cdc9736d-5ff7-4ece-9959-3c744360cdb3	3e89cd6f-8453-4994-989a-605896f36ef1
485	711	226	Participant Node Managers Committee	7f48e0c8-5c96-49ec-b972-30748e339115	3f9f5f30-ab03-49de-8652-f75965133fcd
6	6	0	Plazi	ffb07bec-2d10-492d-9c37-361fe0b79427	40a01acc-3d55-4af1-9545-8d9e14d09acb
6	6	0	Plazi	ffb07bec-2d10-492d-9c37-361fe0b79427	414d2dc9-cb64-4199-89f4-93631252aba1
0	4	4	Plazi	ffb07bec-2d10-492d-9c37-361fe0b79427	42f6270b-393f-491a-aa48-78f60f28eeec
145	145	0	GBIF France	da44cd31-5901-4687-a106-6d1c7734ee3a	44fe30c8-1ca1-43e3-8282-a794a7d4118e
278568	278568	0	National Biodiversity Network	d897a5b9-35ee-4232-94bd-b0bcaac003c2	4645a9cc-e357-4630-8bd2-696bf6475850
0	310	310	Belgian Biodiversity Platform	fb11cfe1-ebc3-45af-9159-17d9fddbcdac	46920559-15d6-45d1-ada6-a9cc07d19d76
3	3	0	Plazi	ffb07bec-2d10-492d-9c37-361fe0b79427	475a54d9-e98e-4be3-8f56-0af7063cf66a
0	272522	272522	Canada Biodiversity Information Facility	8f83fc96-c966-4126-83f7-bf044dc49efa	48060741-47d3-4093-86e6-2ec484323cc5
22183	22183	0	Colombian Biodiversity Information System	7e865cba-7c46-417b-ade5-97f2cf5b7be0	4a050d23-ef56-4024-9208-dcfc0717aa71
6812	6812	0	GBIF Finland	dd514216-5c7c-45f3-910d-797424cb5be6	4b5ccd8b-c137-4844-8e87-d681f48fc474
46857	49983	3126	GBIF Brazil	cdc9736d-5ff7-4ece-9959-3c744360cdb3	4d0fa690-1551-46f0-9a22-acfec0e00dd0
0	40	40	Plazi	ffb07bec-2d10-492d-9c37-361fe0b79427	506621bb-94d9-468a-b3c2-46035b28b1a8
55	55	0	Biodiversity Information System of Mexico	b324e8e9-9a4c-44fa-8f1a-7f39ea7ab576	53bdf70e-42b4-49ab-b150-c79669a086a6
0	1890	1890	Colombian Biodiversity Information System	7e865cba-7c46-417b-ade5-97f2cf5b7be0	556bb9f4-6be2-49ea-bb5d-43103d17ec48
5	5	0	Plazi	ffb07bec-2d10-492d-9c37-361fe0b79427	562f768b-5096-463e-b931-bca0fa42c373
3	3	0	Plazi	ffb07bec-2d10-492d-9c37-361fe0b79427	587f4877-4295-4300-83a7-788e71fb680a
847	847	0	GBIF Spain	1f94b3ca-9345-4d65-afe2-4bace93aa0fe	59331c6f-19a5-42f4-8ce4-69263547f751
261	261	0	GBIF France	da44cd31-5901-4687-a106-6d1c7734ee3a	5a45258b-c70d-4939-81a8-0110065c015c
22224	22224	0	Society for the Management of Electronic Biodiversity Data	97818ee4-1461-4180-bf1d-b3201050124f	5e34ffdf-2648-4ecf-ab53-555e3d3d8d2b
1104	1104	0	GBIF Germany	4f6826f2-4ff6-443d-b966-e6913bd24013	5ef42b60-aba6-431b-9e63-2f4ef4958255
0	17072	17072	Colombian Biodiversity Information System	7e865cba-7c46-417b-ade5-97f2cf5b7be0	5f4200de-0744-4c21-b80b-a326a16a65ee
0	20	20	Plazi	ffb07bec-2d10-492d-9c37-361fe0b79427	613998a5-1f0e-46b2-9141-a0bce996b557
2257	2257	0	Ocean Biodiversity Information System	ba0670b9-4186-41e6-8e70-f9cb3065551a	614bcbe3-7edc-42a8-bf1c-cf5a1ecd9c6d
74	74	0	GBIF Germany	4f6826f2-4ff6-443d-b966-e6913bd24013	6207feb4-f762-11e1-a439-00145eb45e9a
27	27	0	GBIF Germany	4f6826f2-4ff6-443d-b966-e6913bd24013	62bca878-f762-11e1-a439-00145eb45e9a
15	15	0	GBIF Germany	4f6826f2-4ff6-443d-b966-e6913bd24013	63000dfc-f762-11e1-a439-00145eb45e9a
2	2	0	GBIF Germany	4f6826f2-4ff6-443d-b966-e6913bd24013	6324e6e0-f762-11e1-a439-00145eb45e9a
9	9	0	GBIF Germany	4f6826f2-4ff6-443d-b966-e6913bd24013	634536a2-f762-11e1-a439-00145eb45e9a
758	470	-288	GBIF Germany	4f6826f2-4ff6-443d-b966-e6913bd24013	65411976-f762-11e1-a439-00145eb45e9a
174	174	0	GBIF Japan	db5705aa-6a6e-42f1-8942-d77b9f4896ea	65dc71be-6965-4c4f-85a9-92bd3bb52196
0	3	3	Ocean Biodiversity Information System	ba0670b9-4186-41e6-8e70-f9cb3065551a	65f8bb22-fdc4-4492-985a-52a2c58596b2
5	5	0	GBIF Germany	4f6826f2-4ff6-443d-b966-e6913bd24013	6666ab86-f762-11e1-a439-00145eb45e9a
2	2	0	Plazi	ffb07bec-2d10-492d-9c37-361fe0b79427	6758be2d-2f80-4f51-8a19-97bd7ee57d47
141	93	-48	GBIF Germany	4f6826f2-4ff6-443d-b966-e6913bd24013	68d263d8-f762-11e1-a439-00145eb45e9a
222	222	0	GBIF Germany	4f6826f2-4ff6-443d-b966-e6913bd24013	695b1dea-f762-11e1-a439-00145eb45e9a
85	85	0	GBIF Germany	4f6826f2-4ff6-443d-b966-e6913bd24013	69ab31e0-f762-11e1-a439-00145eb45e9a
113	113	0	GBIF Germany	4f6826f2-4ff6-443d-b966-e6913bd24013	69e5c1e8-f762-11e1-a439-00145eb45e9a
2	2	0	Plazi	ffb07bec-2d10-492d-9c37-361fe0b79427	6a26e94e-f94d-48b1-a235-1a565d138fa7
24860	24860	0	GBIF Japan	db5705aa-6a6e-42f1-8942-d77b9f4896ea	6b76dc19-eb87-4ca2-b738-3727286f1818
0	12	12	Plazi	ffb07bec-2d10-492d-9c37-361fe0b79427	6c1acdc6-afbe-48ce-9623-581633ffdc98
81	81	0	GBIF Germany	4f6826f2-4ff6-443d-b966-e6913bd24013	6c93dcfe-f762-11e1-a439-00145eb45e9a
1	1	0	Plazi	ffb07bec-2d10-492d-9c37-361fe0b79427	6ee2e869-d702-40de-a386-0b15dd91f55d
2	2	0	GBIF Germany	4f6826f2-4ff6-443d-b966-e6913bd24013	71a9e86e-f762-11e1-a439-00145eb45e9a
6174	6174	0	GBIF Argentina	2426a871-9feb-40a1-96c6-0c593a76b835	7282b774-f547-4f96-9c43-3ad3d16f152e
5	5	0	Plazi	ffb07bec-2d10-492d-9c37-361fe0b79427	73b12833-7340-471c-8eb3-7419a661fec7
5	5	0	GBIF Germany	4f6826f2-4ff6-443d-b966-e6913bd24013	73b2d760-f762-11e1-a439-00145eb45e9a
323	323	0	GBIF Germany	4f6826f2-4ff6-443d-b966-e6913bd24013	75192244-f762-11e1-a439-00145eb45e9a
636	636	0	GBIF Germany	4f6826f2-4ff6-443d-b966-e6913bd24013	753a88c6-f762-11e1-a439-00145eb45e9a
6682	6682	0	Biodiversity Information System of Mexico	b324e8e9-9a4c-44fa-8f1a-7f39ea7ab576	76a3faf1-8534-4a8b-83bf-93bb6d2d12ab
16	16	0	Plazi	ffb07bec-2d10-492d-9c37-361fe0b79427	7714f26f-36c1-42b0-8c0e-411215a89453
0	10	10	Plazi	ffb07bec-2d10-492d-9c37-361fe0b79427	779c732a-3b11-4466-b94a-3785c9b69e4a
7	7	0	GBIF Germany	4f6826f2-4ff6-443d-b966-e6913bd24013	78d83d70-f762-11e1-a439-00145eb45e9a
112	112	0	Plazi	ffb07bec-2d10-492d-9c37-361fe0b79427	79412239-7640-4899-8d98-87f42d238d1f
10	10	0	GBIF Germany	4f6826f2-4ff6-443d-b966-e6913bd24013	7943d7b0-f762-11e1-a439-00145eb45e9a
171	129	-42	GBIF Germany	4f6826f2-4ff6-443d-b966-e6913bd24013	796476a0-f762-11e1-a439-00145eb45e9a
1728	1728	0	Polish Biodiversity Information Network	2618bfdf-e194-4911-a241-80db3107bc51	79bf7c00-c240-11dc-ab55-b8a03c50a862
9000	9000	0	GBIF Japan	db5705aa-6a6e-42f1-8942-d77b9f4896ea	7a52c058-f762-11e1-a439-00145eb45e9a
1638	1638	0	GBIF Japan	db5705aa-6a6e-42f1-8942-d77b9f4896ea	7a54fdaa-f762-11e1-a439-00145eb45e9a
65	65	0	GBIF Brazil	cdc9736d-5ff7-4ece-9959-3c744360cdb3	7a780066-ecd1-4571-94da-1f84a5100e7e
20	20	0	GBIF Germany	4f6826f2-4ff6-443d-b966-e6913bd24013	7e6df32e-f762-11e1-a439-00145eb45e9a
651	651	0	GBIF Germany	4f6826f2-4ff6-443d-b966-e6913bd24013	7e6f7b18-f762-11e1-a439-00145eb45e9a
0	1110	1110	Chinese Academy of Sciences	e760dc6f-dd68-474d-ab41-bd3588571793	7ea1fc18-5e4c-44a6-a5cd-35a746b13dbb
3	3	0	Plazi	ffb07bec-2d10-492d-9c37-361fe0b79427	811bf1df-b38b-420b-a028-ea80c34cb28b
1249	1249	0	GBIF Spain	1f94b3ca-9345-4d65-afe2-4bace93aa0fe	8256c79a-3826-4d40-a65c-35a0321e49c6
22927	22927	0	GBIF Germany	4f6826f2-4ff6-443d-b966-e6913bd24013	8277b324-f762-11e1-a439-00145eb45e9a
0	15	15	Colombian Biodiversity Information System	7e865cba-7c46-417b-ade5-97f2cf5b7be0	838ed64d-8011-43a3-b392-9a02153ca65e
29	29	0	Belgian Biodiversity Platform	fb11cfe1-ebc3-45af-9159-17d9fddbcdac	83c30cce-d66a-44d8-888c-0f1291a18a2a
0	56	56	Plazi	ffb07bec-2d10-492d-9c37-361fe0b79427	853ba078-53ff-421d-89a0-98037d7054c4
141	71	-70	GBIF Germany	4f6826f2-4ff6-443d-b966-e6913bd24013	87348e50-f762-11e1-a439-00145eb45e9a
511	391	-120	GBIF Germany	4f6826f2-4ff6-443d-b966-e6913bd24013	87405bae-f762-11e1-a439-00145eb45e9a
819	684	-135	GBIF Germany	4f6826f2-4ff6-443d-b966-e6913bd24013	880456bc-f762-11e1-a439-00145eb45e9a
459	459	0	GBIF Germany	4f6826f2-4ff6-443d-b966-e6913bd24013	89bba0c8-f762-11e1-a439-00145eb45e9a
75034	76383	1349	U.S. Geological Survey	8618c64a-93e0-4300-b546-7249e5148ed2	89c53edb-0fac-4118-bdc0-d70ca50953dc
7367	7367	0	GBIF France	da44cd31-5901-4687-a106-6d1c7734ee3a	8a1a0836-4d7b-4967-9ffc-e2f52b0d85ec
111	111	0	GBIF Germany	4f6826f2-4ff6-443d-b966-e6913bd24013	8b8c0f6e-f762-11e1-a439-00145eb45e9a
609	609	0	GBIF Germany	4f6826f2-4ff6-443d-b966-e6913bd24013	8bdf109c-f762-11e1-a439-00145eb45e9a
3184	3184	0	Korean Biodiversity Information Facility	e0a1e772-0177-4800-94b4-2d023fe6cdf4	8e899b6f-ef8b-480d-a8c1-b36218908a8f
2166	2166	0	Participant Node Managers Committee	7f48e0c8-5c96-49ec-b972-30748e339115	9060319d-ceb2-44ac-9423-efaa4a88214f
124	114	-10	GBIF Germany	4f6826f2-4ff6-443d-b966-e6913bd24013	9177e470-f762-11e1-a439-00145eb45e9a
224	224	0	GBIF Germany	4f6826f2-4ff6-443d-b966-e6913bd24013	92b5bd3a-f762-11e1-a439-00145eb45e9a
408	408	0	GBIF Germany	4f6826f2-4ff6-443d-b966-e6913bd24013	94094cb0-f762-11e1-a439-00145eb45e9a
864	864	0	GBIF Germany	4f6826f2-4ff6-443d-b966-e6913bd24013	9414bfe6-f762-11e1-a439-00145eb45e9a
54	54	0	Plazi	ffb07bec-2d10-492d-9c37-361fe0b79427	947aa27b-9422-4d62-adc5-2cab2f5a8412
0	3	3	Plazi	ffb07bec-2d10-492d-9c37-361fe0b79427	94a789c7-dd8c-477a-8640-5c5a49178759
331	337	6	GBIF Germany	4f6826f2-4ff6-443d-b966-e6913bd24013	94f2f07c-f762-11e1-a439-00145eb45e9a
4	4	0	National Biodiversity Network	d897a5b9-35ee-4232-94bd-b0bcaac003c2	961ba75f-d9b5-4c0a-837f-adce08f4d647
1262	1561	299	GBIF Germany	4f6826f2-4ff6-443d-b966-e6913bd24013	9673bdaa-f762-11e1-a439-00145eb45e9a
0	4	4	Plazi	ffb07bec-2d10-492d-9c37-361fe0b79427	9c2221bf-bd4c-40ab-8c1a-01c14f878638
19	19	0	Plazi	ffb07bec-2d10-492d-9c37-361fe0b79427	9f3e6df5-cf73-4dc6-9f35-b634241b5670
0	3	3	Plazi	ffb07bec-2d10-492d-9c37-361fe0b79427	a25e2594-71a8-42b5-85eb-576bacfafa70
3420	3420	0	GBIF France	da44cd31-5901-4687-a106-6d1c7734ee3a	a3f0fd8f-95c5-495a-a0d1-ca599d283808
0	35	35	Ocean Biodiversity Information System	ba0670b9-4186-41e6-8e70-f9cb3065551a	a405c932-2f1c-497b-a197-860fa8f6a2f1
124	124	0	GBIF Germany	4f6826f2-4ff6-443d-b966-e6913bd24013	a52e993c-2e3a-433b-9786-7a665550215e
6	6	0	GBIF Germany	4f6826f2-4ff6-443d-b966-e6913bd24013	a80ed172-1e15-417a-bfaa-975e9c1dccec
2	2	0	Plazi	ffb07bec-2d10-492d-9c37-361fe0b79427	a8f0a730-4fef-4c6c-9d2f-58bf5ec2b629
1121	1000	-121	GBIF Germany	4f6826f2-4ff6-443d-b966-e6913bd24013	a96ee3d0-18c8-4162-8e8e-c0e2f97acb42
0	678	678	Plazi	ffb07bec-2d10-492d-9c37-361fe0b79427	ac692e2d-3f49-42b8-8855-02f81512a3c5
16	16	0	Plazi	ffb07bec-2d10-492d-9c37-361fe0b79427	ac7c76de-2ce4-4fec-a338-77570b70ad0a
0	2	2	Plazi	ffb07bec-2d10-492d-9c37-361fe0b79427	ade27266-c8c3-4127-bc9a-2b934d654058
18267	29017	10750	GBIF Brazil	cdc9736d-5ff7-4ece-9959-3c744360cdb3	aefe4840-ce1f-4b7b-b83b-1a0203e9e5e4
0	26	26	Plazi	ffb07bec-2d10-492d-9c37-361fe0b79427	afc365eb-6081-4bc9-9da5-1b8422748938
3331	3331	0	ASEAN Centre for Biodiversity	af2a0fa1-4c8e-4bdc-8954-b1a55e32b0f1	b4d0b488-43c4-4334-a883-2239ffeba2f5
0	147	147	Plazi	ffb07bec-2d10-492d-9c37-361fe0b79427	b739dd1a-47f7-4e15-a8c6-caf0a89947cb
970	970	0	GBIF France	da44cd31-5901-4687-a106-6d1c7734ee3a	b95dcbbf-a817-4c26-a21b-89208a56fd03
702	702	0	Biodiversity Information System of Mexico	b324e8e9-9a4c-44fa-8f1a-7f39ea7ab576	bb1e31f4-99eb-4568-8127-6b4872441f26
0	8	8	Plazi	ffb07bec-2d10-492d-9c37-361fe0b79427	bb4da4b4-c319-4d19-b253-b4b591f57600
3947	3947	0	GBIF Spain	1f94b3ca-9345-4d65-afe2-4bace93aa0fe	bd2be1e9-f2fc-404a-8246-783af0055829
9	9	0	Plazi	ffb07bec-2d10-492d-9c37-361fe0b79427	be238c31-22ba-43c1-8f96-a50e74c4216d
0	39	39	Plazi	ffb07bec-2d10-492d-9c37-361fe0b79427	bf9739f1-4d5e-4b7e-b102-fafc15085b30
0	1252	1252	Colombian Biodiversity Information System	7e865cba-7c46-417b-ade5-97f2cf5b7be0	bff6721e-f469-4320-a55d-1f8e1525a8b0
82	82	0	Plazi	ffb07bec-2d10-492d-9c37-361fe0b79427	c0c5c4e1-5449-4f6e-980b-107a1aebe182
146	146	0	Plazi	ffb07bec-2d10-492d-9c37-361fe0b79427	c0c84e8c-71a2-420f-a42f-c7971f61a2f8
0	278	278	Ghana Biodiversity Information Facility	b5633b75-6a86-4fdf-9cfc-506047fb9dc7	c3407fee-87c9-4b23-8eb5-c3663c76c91f
0	3043	3043	GBIF Brazil	cdc9736d-5ff7-4ece-9959-3c744360cdb3	c3517fc9-7ad5-40d8-94c6-2b2b1e677a67
983	983	0	GBIF Germany	4f6826f2-4ff6-443d-b966-e6913bd24013	c5bcdb1e-5f8a-4ebb-b94c-3a160bb09bc9
6788	6788	0	GBIF Japan	db5705aa-6a6e-42f1-8942-d77b9f4896ea	c5c7b7e6-ca7e-4076-9d64-a58884bf16ad
96	96	0	GBIF Norway	4f829580-180d-46a9-9c87-ed8ec959b545	c6fe2d03-eeb2-4af7-bd7f-f2e5bfef02b3
40	40	0	GBIF Argentina	2426a871-9feb-40a1-96c6-0c593a76b835	c8dd1db0-7104-4085-a7b1-2c4422e1d139
0	129	129	Plazi	ffb07bec-2d10-492d-9c37-361fe0b79427	ca61a8c2-3bad-455c-981c-7d3d9cfe9917
2814	2814	0	GBIF France	da44cd31-5901-4687-a106-6d1c7734ee3a	cc4f713e-a9fb-4f37-b73b-6327f9fee22f
12	12	0	GBIF Germany	4f6826f2-4ff6-443d-b966-e6913bd24013	ceb47ba9-6cd7-4d83-8c65-cdf85dbe6e96
437	437	0	National Biodiversity Network	d897a5b9-35ee-4232-94bd-b0bcaac003c2	cef8c06f-063e-4e7f-a23e-121290bc6ba7
6	6	0	Plazi	ffb07bec-2d10-492d-9c37-361fe0b79427	cf20ae76-a518-43f6-b807-2dd90400e6bb
4	4	0	Plazi	ffb07bec-2d10-492d-9c37-361fe0b79427	cf8cbc6a-80fe-4a63-874c-11ba7ed044a0
7848	7848	0	GBIF Japan	db5705aa-6a6e-42f1-8942-d77b9f4896ea	d06712f6-7ea3-4b31-b3c8-da5b2f7ebbc2
0	141	141	Ocean Biodiversity Information System	ba0670b9-4186-41e6-8e70-f9cb3065551a	d0f30a76-5fb3-4bd8-8cb5-f6d93bfbef48
10094	10094	0	GBIF Iceland	4dbdcae6-9ac9-4005-ac15-4a95a3eb7701	d14d28e6-0fac-4cb5-92e9-bf6a0aadb8bf
7	7	0	GBIF Sweden	a0b3be64-6525-4387-ac67-a499950f92e1	d24da0b3-aec7-4378-9fd4-2bbfdd352ec2
4	4	0	Plazi	ffb07bec-2d10-492d-9c37-361fe0b79427	d2c81be2-c2db-46fd-9ef0-8aead44bae71
6	6	0	Plazi	ffb07bec-2d10-492d-9c37-361fe0b79427	d50fd45f-543b-4273-ab64-21074cc8ceda
1	1	0	Plazi	ffb07bec-2d10-492d-9c37-361fe0b79427	d66c6d71-8d26-4956-89ac-794356266194
757	757	0	GBIF France	da44cd31-5901-4687-a106-6d1c7734ee3a	d7042fc7-efd1-4278-82ad-e3ac1fe51dd1
5	5	0	Plazi	ffb07bec-2d10-492d-9c37-361fe0b79427	d834dbd0-6d0a-44b6-a642-ac416eb9a9a6
41	41	0	Plazi	ffb07bec-2d10-492d-9c37-361fe0b79427	de12a630-0709-4600-b356-971f170b10be
21	21	0	Plazi	ffb07bec-2d10-492d-9c37-361fe0b79427	e10913e0-44a0-4eab-9d19-cc655e790372
3	3	0	Plazi	ffb07bec-2d10-492d-9c37-361fe0b79427	e1c7a0c0-f975-4b96-9bb4-8bef87d84860
101	101	0	GBIF Nigeria	6529bcb5-a542-4fda-be87-54a624515335	e1e99083-3c9d-4d2a-af6d-5c4e2f8b1982
0	2	2	Plazi	ffb07bec-2d10-492d-9c37-361fe0b79427	e1f16239-de9d-4b5e-b430-746abd80ff58
18	18	0	Biodiversity Information System of Mexico	b324e8e9-9a4c-44fa-8f1a-7f39ea7ab576	e1f46cbb-2a8d-4c63-b89c-68e6c3336c0a
6	6	0	Plazi	ffb07bec-2d10-492d-9c37-361fe0b79427	e302a65d-87ae-482c-a2fe-cd587b3af0f0
19	19	0	Plazi	ffb07bec-2d10-492d-9c37-361fe0b79427	e3312098-042c-4aa4-8d6e-f9f744f221c3
1446	1446	0	GBIF France	da44cd31-5901-4687-a106-6d1c7734ee3a	e6a773bf-c826-464b-929c-30b8ffb2fe5a
3	3	0	Plazi	ffb07bec-2d10-492d-9c37-361fe0b79427	e6d7f268-12df-402f-b16b-26bda28d33e8
30	941	911	GBIF Germany	4f6826f2-4ff6-443d-b966-e6913bd24013	eac33a97-0ae9-4b57-8e77-ab31b13d95fc
201	201	0	U.S. Geological Survey	8618c64a-93e0-4300-b546-7249e5148ed2	ead8d850-fc78-4531-9039-48ae8200b4e2
67	67	0	National Biodiversity Network	d897a5b9-35ee-4232-94bd-b0bcaac003c2	eb1244aa-0269-4397-b5fa-6c42299bab36
1	1	0	Plazi	ffb07bec-2d10-492d-9c37-361fe0b79427	ec5e29a1-e446-487a-962a-dfbf703a9519
0	4	4	Plazi	ffb07bec-2d10-492d-9c37-361fe0b79427	ecc8be51-7a2b-4723-9fd8-62fd542fd01a
1	1	0	Plazi	ffb07bec-2d10-492d-9c37-361fe0b79427	f237cf38-4102-4fbc-b97f-3f4946508055
435	432	-3	GBIF Germany	4f6826f2-4ff6-443d-b966-e6913bd24013	f3af1a26-73bf-4015-b432-ae5ea9687b4b
2430	2430	0	GBIF Finland	dd514216-5c7c-45f3-910d-797424cb5be6	f5c7b4f4-e072-4f88-adb5-fb6329a7a5eb
16304	16304	0	U.S. Geological Survey	8618c64a-93e0-4300-b546-7249e5148ed2	f61e69d1-e79f-4ccb-bd92-56a7cefcf1e4
8	8	0	GBIF France	da44cd31-5901-4687-a106-6d1c7734ee3a	f6d0a88f-1e17-4335-9f6b-0696942fa22c
0	70	70	Plazi	ffb07bec-2d10-492d-9c37-361fe0b79427	f6ff06da-a424-4fd8-a960-25bd031b1897
30	30	0	Plazi	ffb07bec-2d10-492d-9c37-361fe0b79427	f779d08b-1402-4687-a80b-b444b12fe863
11520	11525	5	GBIF Brazil	cdc9736d-5ff7-4ece-9959-3c744360cdb3	f973bf0a-d61c-46d6-bb93-5cd5877c80af
155	155	0	Biodiversity Information System of Mexico	b324e8e9-9a4c-44fa-8f1a-7f39ea7ab576	f9b6a4d4-d4a2-4695-ab2a-7b415aa9d939
595	595	0	GBIF Guinea	b1cd2e84-c4ba-47bd-b72a-dfd1f92dce0a	f9be5570-6943-49b8-b317-9780af40effb
1601	1601	0	National Biodiversity Data Centre	422b00b2-6c94-4bb6-976b-c359916efdb8	fafbb2a7-9d64-480e-9021-eab337115aa8
0	15	15	Plazi	ffb07bec-2d10-492d-9c37-361fe0b79427	fcb42055-1ae9-4705-b471-a6b9ab150e33
7	7	0	GBIF Brazil	cdc9736d-5ff7-4ece-9959-3c744360cdb3	fcee13f5-6e61-4d9b-ba52-87f21f827578
23227	23227	0	GBIF Norway	4f829580-180d-46a9-9c87-ed8ec959b545	fe78e7ec-b95e-402d-bbac-e336a26f18f0
51	51	0	Colombian Biodiversity Information System	7e865cba-7c46-417b-ade5-97f2cf5b7be0	fea25ddf-6726-48fc-80f4-848e34461be3
149	149	0	Plazi	ffb07bec-2d10-492d-9c37-361fe0b79427	ffbf71d1-4603-4569-8507-110bd0923477
0	26	26	Plazi	ffb07bec-2d10-492d-9c37-361fe0b79427	02af60c1-b666-4b96-8677-70d2ebc411a4
13089	6580	-6509	Belgian Biodiversity Platform	fb11cfe1-ebc3-45af-9159-17d9fddbcdac	0310b080-ec4b-11dc-b73e-b8a03c50a862
365	365	0	GBIF France	da44cd31-5901-4687-a106-6d1c7734ee3a	04beadec-d2fa-4bf0-94cf-0c30fb5589e8
653	653	0	GBIF France	da44cd31-5901-4687-a106-6d1c7734ee3a	05c4f745-a83b-423e-bb23-a89e02590362
240952	339310	98358	GBIF Switzerland	169eb292-376b-4cc6-8e31-9c2c432de0ad	064508e2-255e-4d82-9f13-05d73476cc03
2	2	0	GBIF France	da44cd31-5901-4687-a106-6d1c7734ee3a	0b5b8952-0cf5-4d46-b18e-1f2ad75feff8
0	43	43	Plazi	ffb07bec-2d10-492d-9c37-361fe0b79427	0f8f850f-4b02-4477-b780-bf054d7c6131
200	200	0	Colombian Biodiversity Information System	7e865cba-7c46-417b-ade5-97f2cf5b7be0	10116252-9e1a-488f-b9c6-bf3e752ef76b
416	416	0	Colombian Biodiversity Information System	7e865cba-7c46-417b-ade5-97f2cf5b7be0	12464931-e8ea-4437-b6df-c280e063b107
0	3	3	Plazi	ffb07bec-2d10-492d-9c37-361fe0b79427	1369629d-8ec3-473c-9c45-478c76cd569c
4	4	0	Plazi	ffb07bec-2d10-492d-9c37-361fe0b79427	16e495f6-1e96-4e0a-af86-df00e3a1fdb5
9	9	0	Plazi	ffb07bec-2d10-492d-9c37-361fe0b79427	17268d78-e4da-4f5f-bc78-670973d36bb8
6237	6237	0	GBIF Norway	4f829580-180d-46a9-9c87-ed8ec959b545	17e622b5-dfbb-487f-94c7-47cc8cb0823b
5	5	0	Participant Node Managers Committee	7f48e0c8-5c96-49ec-b972-30748e339115	1802be83-dc4a-4ea8-83b0-07fd073b105e
34	34	0	Plazi	ffb07bec-2d10-492d-9c37-361fe0b79427	1b154ad3-49f1-4b92-b405-6d78078ba646
624	624	0	GBIF Germany	4f6826f2-4ff6-443d-b966-e6913bd24013	1dd39b7e-c576-49e5-9da9-e3242fa0b108
3	3	0	Plazi	ffb07bec-2d10-492d-9c37-361fe0b79427	2122ec87-41d1-469d-8c87-2a47d947bf31
1	1	0	Plazi	ffb07bec-2d10-492d-9c37-361fe0b79427	22c80f13-5ebf-4b94-9db4-7d6f3b1e6d69
10620	10620	0	Atlas of Living Australia	4a6f1b71-969e-4fc5-a693-282b05e1220c	2754fff5-18b1-4706-bc8c-a647f08b665b
0	133	133	Colombian Biodiversity Information System	7e865cba-7c46-417b-ade5-97f2cf5b7be0	280c1f6a-219f-4994-bb94-35bec5bed4a8
0	142	142	Ocean Biodiversity Information System	ba0670b9-4186-41e6-8e70-f9cb3065551a	281ab377-c990-46f0-95e4-803d8b6afe71
14322	14322	0	National Biodiversity Network	d897a5b9-35ee-4232-94bd-b0bcaac003c2	2952a69a-c159-4e83-849f-738428d5cea6
354	354	0	GBIF France	da44cd31-5901-4687-a106-6d1c7734ee3a	295b6ac2-7fd6-4920-875c-b8752f4df9a1
0	4	4	Plazi	ffb07bec-2d10-492d-9c37-361fe0b79427	2a5bc188-9242-44f4-98a8-eb25a374e637
0	766	766	Ocean Biodiversity Information System	ba0670b9-4186-41e6-8e70-f9cb3065551a	33b215f0-c785-4cba-a394-d23993ffd191
63	65	2	National Biodiversity Network	d897a5b9-35ee-4232-94bd-b0bcaac003c2	3419e2ce-de18-4727-868a-b239c379b3bb
282	282	0	GBIF Japan	db5705aa-6a6e-42f1-8942-d77b9f4896ea	3a849dbd-e36a-480e-81b5-47953428038b
0	90	90	Ocean Biodiversity Information System	ba0670b9-4186-41e6-8e70-f9cb3065551a	3ca765cd-99f3-4467-865d-ca104ae55aae
5891	5891	0	National Biodiversity Network	d897a5b9-35ee-4232-94bd-b0bcaac003c2	3ccfe992-043a-4fff-951d-1e6e158854da
0	1	1	Plazi	ffb07bec-2d10-492d-9c37-361fe0b79427	3dcf53e6-a669-4856-8a9d-0aec244e8dbe
43	43	0	Plazi	ffb07bec-2d10-492d-9c37-361fe0b79427	3f492afe-37c4-4bc9-b7d1-5f8d804cf5bb
5301	5301	0	National Biodiversity Network	d897a5b9-35ee-4232-94bd-b0bcaac003c2	40cd6044-e4dc-440a-a869-f7d1c3e778f1
411	411	0	GBIF Germany	4f6826f2-4ff6-443d-b966-e6913bd24013	41c2febd-9dc8-4cd1-bfcd-038b7c7f550a
15046	15046	0	Colombian Biodiversity Information System	7e865cba-7c46-417b-ade5-97f2cf5b7be0	4289b9cf-37e2-4cba-b00e-c0d3d94ad749
0	447	447	Ocean Biodiversity Information System	ba0670b9-4186-41e6-8e70-f9cb3065551a	44fe2f7f-a3ff-4e32-9093-d1dcc6cf1c10
55	55	0	Plazi	ffb07bec-2d10-492d-9c37-361fe0b79427	475e2cf2-9b5a-4e62-a896-e05bf64a03f2
3	3	0	Plazi	ffb07bec-2d10-492d-9c37-361fe0b79427	4962f32d-61af-4f4a-910f-3ef85db32146
622	622	0	National Biodiversity Network	d897a5b9-35ee-4232-94bd-b0bcaac003c2	4ab1ce38-4add-4cf0-a878-a811faaab2f8
281	281	0	Participant Node Managers Committee	7f48e0c8-5c96-49ec-b972-30748e339115	4ab87d2f-a65c-4f81-9064-352aa746efa3
2526	2526	0	National Biodiversity Network	d897a5b9-35ee-4232-94bd-b0bcaac003c2	4b18f793-6527-4e9e-83eb-06b179dd35f6
12	12	0	GBIF Germany	4f6826f2-4ff6-443d-b966-e6913bd24013	4ce986cf-3d70-4a84-a69d-d78565c3f8b8
3	3	0	Plazi	ffb07bec-2d10-492d-9c37-361fe0b79427	4dd51d9e-4a82-4d03-8156-68f4666579c2
322	322	0	GBIF France	da44cd31-5901-4687-a106-6d1c7734ee3a	4f334096-7243-4231-bdc5-d8390b4885fc
823	823	0	GBIF Andorra	8df8d012-8e64-4c8a-886e-521a3bdfa623	4f43b39d-ebdf-47d0-8de1-c5b45a7beca5
25	25	0	Plazi	ffb07bec-2d10-492d-9c37-361fe0b79427	4f91c293-3d97-44fb-af79-a8e8677de6c2
6	6	0	Plazi	ffb07bec-2d10-492d-9c37-361fe0b79427	50f48e48-1c94-4a50-889b-860b27ca4471
1	1	0	Plazi	ffb07bec-2d10-492d-9c37-361fe0b79427	514d030a-d8cc-4b57-86c5-792681d3ba7e
4790	4790	0	National Biodiversity Network	d897a5b9-35ee-4232-94bd-b0bcaac003c2	51bf6f1f-3e6d-4d8f-bf75-9c05ce29b3f7
96	96	0	Plazi	ffb07bec-2d10-492d-9c37-361fe0b79427	51f1fb11-b518-4930-82cd-6992b1b04325
4	4	0	Plazi	ffb07bec-2d10-492d-9c37-361fe0b79427	53090428-594a-4834-a092-827fa1737f14
2	2	0	Plazi	ffb07bec-2d10-492d-9c37-361fe0b79427	5496fe1c-b44b-4f41-8766-6ddf73acc355
0	7	7	Plazi	ffb07bec-2d10-492d-9c37-361fe0b79427	549807f7-2ce5-43fa-8a14-84f13c4ca82c
3	3	0	Plazi	ffb07bec-2d10-492d-9c37-361fe0b79427	5bf74913-8fc7-40fc-a1a5-40e57058fe24
0	5619	5619	GBIF Kenya	2a44d626-9f7a-4120-8a7a-4ab5ac15ff2a	5c9d65fc-dd85-44cd-add1-16590de266cb
1	1	0	Plazi	ffb07bec-2d10-492d-9c37-361fe0b79427	5db7a582-d943-4ebf-9f5d-da2be9b17f84
18	18	0	ASEAN Centre for Biodiversity	af2a0fa1-4c8e-4bdc-8954-b1a55e32b0f1	608c444e-d7c1-4107-93b5-ceaf2303b53e
5	5	0	GBIF Germany	4f6826f2-4ff6-443d-b966-e6913bd24013	61f57122-f762-11e1-a439-00145eb45e9a
12	12	0	GBIF Germany	4f6826f2-4ff6-443d-b966-e6913bd24013	625b1cb6-f762-11e1-a439-00145eb45e9a
12	12	0	GBIF Germany	4f6826f2-4ff6-443d-b966-e6913bd24013	62f99788-f762-11e1-a439-00145eb45e9a
25	25	0	Plazi	ffb07bec-2d10-492d-9c37-361fe0b79427	644f9a70-a8d0-45ed-a1c6-0623e906bf9e
17	16	-1	GBIF Germany	4f6826f2-4ff6-443d-b966-e6913bd24013	65c639c6-f762-11e1-a439-00145eb45e9a
915	893	-22	GBIF Germany	4f6826f2-4ff6-443d-b966-e6913bd24013	6611b87e-f762-11e1-a439-00145eb45e9a
13310	13310	0	GBIF France	da44cd31-5901-4687-a106-6d1c7734ee3a	663b502e-cab9-4a69-b6eb-4afced8a6366
203	203	0	GBIF Germany	4f6826f2-4ff6-443d-b966-e6913bd24013	678cddc8-f762-11e1-a439-00145eb45e9a
0	11	11	Plazi	ffb07bec-2d10-492d-9c37-361fe0b79427	67a9919a-a451-4ebd-b395-56f98e515ed0
178	178	0	GBIF Germany	4f6826f2-4ff6-443d-b966-e6913bd24013	684e2438-f762-11e1-a439-00145eb45e9a
77	77	0	GBIF Germany	4f6826f2-4ff6-443d-b966-e6913bd24013	6860eadc-f762-11e1-a439-00145eb45e9a
85	85	0	GBIF Germany	4f6826f2-4ff6-443d-b966-e6913bd24013	69146efe-f762-11e1-a439-00145eb45e9a
1840	1285	-555	GBIF Germany	4f6826f2-4ff6-443d-b966-e6913bd24013	69f58952-f762-11e1-a439-00145eb45e9a
777	777	0	National Biodiversity Network	d897a5b9-35ee-4232-94bd-b0bcaac003c2	6a0c4af7-fe6d-42c0-97d8-191b3bd7e2fa
310	310	0	Biodiversity Information System of Mexico	b324e8e9-9a4c-44fa-8f1a-7f39ea7ab576	6a1a22f8-638a-4c20-92ca-ba4cd7891e9a
2	2	0	Plazi	ffb07bec-2d10-492d-9c37-361fe0b79427	6ac8622b-0b3d-48f6-9bfd-5a68da4cddf2
12	12	0	GBIF Germany	4f6826f2-4ff6-443d-b966-e6913bd24013	6b90fcec-f762-11e1-a439-00145eb45e9a
4	4	0	Plazi	ffb07bec-2d10-492d-9c37-361fe0b79427	6bf1a279-6029-4f86-b420-d2e4ca4b35d8
58	58	0	GBIF Germany	4f6826f2-4ff6-443d-b966-e6913bd24013	6cda5954-f762-11e1-a439-00145eb45e9a
4	4	0	GBIF Germany	4f6826f2-4ff6-443d-b966-e6913bd24013	6f930114-f762-11e1-a439-00145eb45e9a
110	110	0	GBIF Germany	4f6826f2-4ff6-443d-b966-e6913bd24013	70bafa9c-f762-11e1-a439-00145eb45e9a
94	94	0	GBIF Germany	4f6826f2-4ff6-443d-b966-e6913bd24013	70c1ce1c-f762-11e1-a439-00145eb45e9a
0	17	17	GBIF Benin	efb9c00e-f802-45dd-8826-a52ec45b89ff	70d19075-945f-47c6-848f-3a54d1073328
0	100	100	Plazi	ffb07bec-2d10-492d-9c37-361fe0b79427	712f8615-91da-4442-99f9-1e0a6a211cb5
4	4	0	GBIF Germany	4f6826f2-4ff6-443d-b966-e6913bd24013	71522052-f762-11e1-a439-00145eb45e9a
77	77	0	GBIF Germany	4f6826f2-4ff6-443d-b966-e6913bd24013	71bc1138-f762-11e1-a439-00145eb45e9a
130	130	0	GBIF Malawi	2a42e4d7-ad4a-41b3-84c4-de4aa7b74d35	71c11c2a-a204-4a3b-a9d2-5cd7ec63c2ec
22	22	0	GBIF Germany	4f6826f2-4ff6-443d-b966-e6913bd24013	72e27106-f762-11e1-a439-00145eb45e9a
23	23	0	GBIF Germany	4f6826f2-4ff6-443d-b966-e6913bd24013	737c5f28-f762-11e1-a439-00145eb45e9a
3	3	0	Plazi	ffb07bec-2d10-492d-9c37-361fe0b79427	7419d79a-1639-4302-b56a-ac5b140c9cf2
53	53	0	GBIF Germany	4f6826f2-4ff6-443d-b966-e6913bd24013	74514d46-f762-11e1-a439-00145eb45e9a
123	123	0	GBIF Germany	4f6826f2-4ff6-443d-b966-e6913bd24013	74a53186-f762-11e1-a439-00145eb45e9a
176	176	0	GBIF Germany	4f6826f2-4ff6-443d-b966-e6913bd24013	75126efe-f762-11e1-a439-00145eb45e9a
4	4	0	Plazi	ffb07bec-2d10-492d-9c37-361fe0b79427	76819e1c-7081-41cb-8e72-f55cff71bb24
0	3	3	Ocean Biodiversity Information System	ba0670b9-4186-41e6-8e70-f9cb3065551a	77cdb5db-7593-4794-a7ff-16d857be4c9c
9	9	0	GBIF Germany	4f6826f2-4ff6-443d-b966-e6913bd24013	79101128-f762-11e1-a439-00145eb45e9a
222	222	0	GBIF Germany	4f6826f2-4ff6-443d-b966-e6913bd24013	7947eeea-f762-11e1-a439-00145eb45e9a
26	20	-6	GBIF Germany	4f6826f2-4ff6-443d-b966-e6913bd24013	795aa666-f762-11e1-a439-00145eb45e9a
17	17	0	Plazi	ffb07bec-2d10-492d-9c37-361fe0b79427	799d241f-7891-4146-a38c-7809efa13368
3	3	0	Plazi	ffb07bec-2d10-492d-9c37-361fe0b79427	79c66f37-88ae-4793-9bb3-2cef26968dd3
41	41	0	Plazi	ffb07bec-2d10-492d-9c37-361fe0b79427	7a2586bd-e52d-4759-819d-235e6f200c3b
49	49	0	GBIF Germany	4f6826f2-4ff6-443d-b966-e6913bd24013	7aa3a5fe-f762-11e1-a439-00145eb45e9a
6	6	0	GBIF Germany	4f6826f2-4ff6-443d-b966-e6913bd24013	7ad843b8-f762-11e1-a439-00145eb45e9a
3362	3362	0	GBIF Portugal	673f7038-4262-4149-b753-5658a4e912f6	7b117ea6-29b0-4575-8cff-c7af7283340f
2838	2838	0	Colombian Biodiversity Information System	7e865cba-7c46-417b-ade5-97f2cf5b7be0	7b384b30-7ced-4784-9fc1-1a8e21fa0a01
0	53	53	Plazi	ffb07bec-2d10-492d-9c37-361fe0b79427	7b869911-dbd0-4455-a6a0-2ef8aedfdc49
32	32	0	GBIF Germany	4f6826f2-4ff6-443d-b966-e6913bd24013	7c770cc2-f762-11e1-a439-00145eb45e9a
0	11	11	Plazi	ffb07bec-2d10-492d-9c37-361fe0b79427	7cedfbfc-f084-4d9b-8222-4d3716e36c5b
0	116	116	Ocean Biodiversity Information System	ba0670b9-4186-41e6-8e70-f9cb3065551a	7d12bfee-8056-4574-84c1-16b7ded30034
0	9	9	Plazi	ffb07bec-2d10-492d-9c37-361fe0b79427	7e37ce44-b7f3-482b-9a9c-fca3b1af5b05
21703	22618	915	GBIF Norway	4f829580-180d-46a9-9c87-ed8ec959b545	7eb54e10-fd36-4139-8764-1fd8abc2bd67
160	160	0	GBIF Germany	4f6826f2-4ff6-443d-b966-e6913bd24013	7ec4c596-f762-11e1-a439-00145eb45e9a
98	98	0	GBIF Germany	4f6826f2-4ff6-443d-b966-e6913bd24013	7ed576ca-f762-11e1-a439-00145eb45e9a
4801	4801	0	Biodiversity Information System of Mexico	b324e8e9-9a4c-44fa-8f1a-7f39ea7ab576	7fa49f72-f762-11e1-a439-00145eb45e9a
1200	1200	0	GBIF Japan	db5705aa-6a6e-42f1-8942-d77b9f4896ea	80e455ee-f762-11e1-a439-00145eb45e9a
333	333	0	GBIF Germany	4f6826f2-4ff6-443d-b966-e6913bd24013	81bb3a1e-f762-11e1-a439-00145eb45e9a
0	5134	5134	GBIF Portugal	673f7038-4262-4149-b753-5658a4e912f6	822f3765-6950-40c5-9353-1f335599007c
103176	103176	0	GBIF Germany	4f6826f2-4ff6-443d-b966-e6913bd24013	82b6ab38-f762-11e1-a439-00145eb45e9a
1424	1424	0	National Biodiversity Network	d897a5b9-35ee-4232-94bd-b0bcaac003c2	854fae95-cecd-4ac7-b3bf-9ea381a77143
1071	273	-798	GBIF Germany	4f6826f2-4ff6-443d-b966-e6913bd24013	869b5a9b-c86d-4836-b248-0c8fa23268ec
0	1	1	Plazi	ffb07bec-2d10-492d-9c37-361fe0b79427	8713f3de-67ef-4823-929b-7b1b5d37e26a
0	12	12	Plazi	ffb07bec-2d10-492d-9c37-361fe0b79427	8721d89e-82a8-425a-8707-f53293bbef22
154	154	0	GBIF France	da44cd31-5901-4687-a106-6d1c7734ee3a	886384f6-1d65-4e9f-ace9-137215745aae
1	1	0	Plazi	ffb07bec-2d10-492d-9c37-361fe0b79427	88d1d529-797f-4764-8311-a2422de05da6
489	489	0	Ocean Biodiversity Information System	ba0670b9-4186-41e6-8e70-f9cb3065551a	890e8604-f762-11e1-a439-00145eb45e9a
0	58	58	Ocean Biodiversity Information System	ba0670b9-4186-41e6-8e70-f9cb3065551a	89318530-0275-4aa4-98aa-6530ef5db0fb
6	6	0	Plazi	ffb07bec-2d10-492d-9c37-361fe0b79427	8b291b94-8022-4966-b1cd-d430c54e31b8
928	907	-21	GBIF Germany	4f6826f2-4ff6-443d-b966-e6913bd24013	8d6aaa84-f762-11e1-a439-00145eb45e9a
787	494	-293	GBIF Germany	4f6826f2-4ff6-443d-b966-e6913bd24013	8e37642a-f762-11e1-a439-00145eb45e9a
6090	3780	-2310	GBIF Germany	4f6826f2-4ff6-443d-b966-e6913bd24013	8e92754a-f762-11e1-a439-00145eb45e9a
27	27	0	GBIF Germany	4f6826f2-4ff6-443d-b966-e6913bd24013	92098e5c-f762-11e1-a439-00145eb45e9a
27	27	0	GBIF Germany	4f6826f2-4ff6-443d-b966-e6913bd24013	921c1bd0-f762-11e1-a439-00145eb45e9a
0	1	1	Plazi	ffb07bec-2d10-492d-9c37-361fe0b79427	9231c31e-fd8b-4ace-9b79-fc4309118084
138	138	0	GBIF France	da44cd31-5901-4687-a106-6d1c7734ee3a	923998b1-97e3-4363-a9bd-9dde099b6e8f
25	23	-2	GBIF Germany	4f6826f2-4ff6-443d-b966-e6913bd24013	926a1024-f762-11e1-a439-00145eb45e9a
0	49	49	Ocean Biodiversity Information System	ba0670b9-4186-41e6-8e70-f9cb3065551a	926af9fb-e54b-41c1-90b7-87ade56b9938
34	29	-5	GBIF Germany	4f6826f2-4ff6-443d-b966-e6913bd24013	927de220-f762-11e1-a439-00145eb45e9a
254	254	0	GBIF Germany	4f6826f2-4ff6-443d-b966-e6913bd24013	92e201b0-f762-11e1-a439-00145eb45e9a
125	125	0	GBIF Germany	4f6826f2-4ff6-443d-b966-e6913bd24013	931ded4c-f762-11e1-a439-00145eb45e9a
13	13	0	GBIF Germany	4f6826f2-4ff6-443d-b966-e6913bd24013	933876ee-f762-11e1-a439-00145eb45e9a
167	167	0	GBIF Germany	4f6826f2-4ff6-443d-b966-e6913bd24013	93c61968-f762-11e1-a439-00145eb45e9a
843	819	-24	GBIF Germany	4f6826f2-4ff6-443d-b966-e6913bd24013	954ee404-f762-11e1-a439-00145eb45e9a
78	78	0	GBIF Germany	4f6826f2-4ff6-443d-b966-e6913bd24013	956a836c-f762-11e1-a439-00145eb45e9a
19	19	0	Plazi	ffb07bec-2d10-492d-9c37-361fe0b79427	958894ce-8994-4cd5-abfc-cac1087a3b5f
36	36	0	GBIF Germany	4f6826f2-4ff6-443d-b966-e6913bd24013	976297ae-f762-11e1-a439-00145eb45e9a
57	57	0	GBIF Germany	4f6826f2-4ff6-443d-b966-e6913bd24013	97653d06-f762-11e1-a439-00145eb45e9a
1	1	0	Plazi	ffb07bec-2d10-492d-9c37-361fe0b79427	99097115-9153-4db8-ba4c-7401c7426c6e
1147	1147	0	National Biodiversity Network	d897a5b9-35ee-4232-94bd-b0bcaac003c2	9c4a7ecc-1d4f-44bb-81ce-8b7f6c585112
89762	89762	0	GBIF Spain	1f94b3ca-9345-4d65-afe2-4bace93aa0fe	9cee82bd-8963-4118-a38d-109e2a613ce2
3207	3207	0	U.S. Geological Survey	8618c64a-93e0-4300-b546-7249e5148ed2	9dc5adb8-b4c0-4642-b1ed-b7c5b0a8c552
0	3	3	Plazi	ffb07bec-2d10-492d-9c37-361fe0b79427	9fd8b232-6ca8-44b1-8d21-1d642511ddb4
27	27	0	Plazi	ffb07bec-2d10-492d-9c37-361fe0b79427	a1ebe5f0-f868-4490-b5ef-3e4dee105f6c
0	1	1	Plazi	ffb07bec-2d10-492d-9c37-361fe0b79427	a23636f4-01d6-48ce-a076-fc2997480faf
143	143	0	GBIF Germany	4f6826f2-4ff6-443d-b966-e6913bd24013	a24fba7a-f34d-4dde-a074-25ba10bb8c66
14	14	0	Colombian Biodiversity Information System	7e865cba-7c46-417b-ade5-97f2cf5b7be0	a2ec48bd-4e1f-4e66-8da7-86ec27b734c6
4	4	0	Plazi	ffb07bec-2d10-492d-9c37-361fe0b79427	a2f78cbb-cc68-42f8-af58-4f3800ddc9ee
0	755	755	Participant Node Managers Committee	7f48e0c8-5c96-49ec-b972-30748e339115	a38f95c7-a83e-4af7-a7f3-06b2e4b6c011
2	2	0	Plazi	ffb07bec-2d10-492d-9c37-361fe0b79427	a6c88076-37c8-4bef-ad3c-7658960f6320
0	104	104	Plazi	ffb07bec-2d10-492d-9c37-361fe0b79427	a9680b33-84a3-4abb-b347-876e5f14f647
9552	9552	0	National Biodiversity Network	d897a5b9-35ee-4232-94bd-b0bcaac003c2	ac567b66-ed97-45c2-bc07-6f8604ee96d7
68	68	0	GBIF Spain	1f94b3ca-9345-4d65-afe2-4bace93aa0fe	ae1927af-f8a2-4838-b9d3-44269b3bfcf3
31	31	0	Plazi	ffb07bec-2d10-492d-9c37-361fe0b79427	aeec426f-76dd-4dfc-ba58-7451fe6289d6
0	3	3	Plazi	ffb07bec-2d10-492d-9c37-361fe0b79427	b0aeca96-481d-4fc5-8eb1-0b584c7a7625
3	3	0	Plazi	ffb07bec-2d10-492d-9c37-361fe0b79427	b2dbeccc-0f3e-424a-882b-85f810bf6301
2813	2813	0	Atlas of Living Australia	4a6f1b71-969e-4fc5-a693-282b05e1220c	b3d40286-603b-47ee-bcaa-e829c383675d
244	244	0	GBIF France	da44cd31-5901-4687-a106-6d1c7734ee3a	b53ca890-892b-4413-8031-9c8ffc7533d7
1	1	0	Plazi	ffb07bec-2d10-492d-9c37-361fe0b79427	b79add95-a479-45e5-ba55-60409cfac833
1	1	0	Plazi	ffb07bec-2d10-492d-9c37-361fe0b79427	b9f105f0-9ba8-4b62-9a43-eb0f2853593f
2554	2554	0	National Biodiversity Network	d897a5b9-35ee-4232-94bd-b0bcaac003c2	bab8dea1-b430-4741-b06a-1a58c26b77a1
4	4	0	Plazi	ffb07bec-2d10-492d-9c37-361fe0b79427	c029f78e-c026-48ac-8c61-8b168fef59ea
1	1	0	Plazi	ffb07bec-2d10-492d-9c37-361fe0b79427	c26ef882-a4b3-4d52-9b9a-9613c5d26680
363	363	0	GBIF France	da44cd31-5901-4687-a106-6d1c7734ee3a	c274cc35-8343-425b-91c1-b23bbfacbc63
14404	14404	0	Colombian Biodiversity Information System	7e865cba-7c46-417b-ade5-97f2cf5b7be0	c2a0198f-4d4b-448a-91cb-ff07ab1532ed
2373	2373	0	Observation International	ad048418-7cd8-4070-a151-fe1c1f303129	c2e643bb-cf05-4089-b6fe-b3389b5d1c44
56	56	0	GBIF Germany	4f6826f2-4ff6-443d-b966-e6913bd24013	c3172674-8417-4f72-83ad-de160bceb924
10793	10793	0	GBIF Germany	4f6826f2-4ff6-443d-b966-e6913bd24013	c40738de-6c7c-11e2-90ce-00145eb45e9a
0	1	1	Ocean Biodiversity Information System	ba0670b9-4186-41e6-8e70-f9cb3065551a	c4d026e3-1a09-47ee-ae0d-a4172d452b84
753	753	0	GBIF France	da44cd31-5901-4687-a106-6d1c7734ee3a	c606f407-2e16-4a75-ab4b-070ce3a69c57
2817	2784	-33	Participant Node Managers Committee	7f48e0c8-5c96-49ec-b972-30748e339115	c65575cf-862f-448b-bef2-fc158fb2e225
0	31	31	Plazi	ffb07bec-2d10-492d-9c37-361fe0b79427	c7ec3f98-b449-4b2c-bb54-12c384385671
44	44	0	GBIF Germany	4f6826f2-4ff6-443d-b966-e6913bd24013	ca429081-8402-49a4-ab8f-e16f5fe3cd8e
6685	6685	0	GBIF France	da44cd31-5901-4687-a106-6d1c7734ee3a	ca8bf280-a344-4912-866d-0fc7e60bb43e
1235	1235	0	National Biodiversity Network	d897a5b9-35ee-4232-94bd-b0bcaac003c2	cd7fd416-bba4-4c96-ba91-e94edc55a867
280	280	0	Participant Node Managers Committee	7f48e0c8-5c96-49ec-b972-30748e339115	ceb1c860-7734-4614-b347-4c7ce38c4e19
7326	7326	0	Atlas of Living Australia	4a6f1b71-969e-4fc5-a693-282b05e1220c	d0582993-28ac-4ac4-937d-cb61497e532c
0	29994	29994	National Biodiversity Network	d897a5b9-35ee-4232-94bd-b0bcaac003c2	d0cee8f6-dbf9-4355-a9c2-62ab51fe36fd
31	31	0	Atlas of Living Australia	4a6f1b71-969e-4fc5-a693-282b05e1220c	d9d37e23-acee-436b-adc6-3659606b6830
0	1	1	Plazi	ffb07bec-2d10-492d-9c37-361fe0b79427	de98cc26-7d60-4967-a7de-2bb5197ee4bc
50419	50419	0	U.S. Geological Survey	8618c64a-93e0-4300-b546-7249e5148ed2	e08d9a49-2ad9-47de-b8d8-8d5efcf4a183
9	9	0	Plazi	ffb07bec-2d10-492d-9c37-361fe0b79427	e0a547f5-dd22-4fe1-9c3a-ff5ee6115e93
11	11	0	Plazi	ffb07bec-2d10-492d-9c37-361fe0b79427	e30fe7b8-d550-4745-b644-806aa36b6b41
0	3	3	Plazi	ffb07bec-2d10-492d-9c37-361fe0b79427	e41c8ef5-a818-45a9-a37d-e450338e9c04
0	1763	1763	GBIF Argentina	2426a871-9feb-40a1-96c6-0c593a76b835	e45a7336-82a8-43b9-9c0a-efc59572b30b
0	3	3	Plazi	ffb07bec-2d10-492d-9c37-361fe0b79427	e7041eb3-3c4a-4ae2-a014-434ca6ef4846
0	11669	11669	GBIF Kenya	2a44d626-9f7a-4120-8a7a-4ab5ac15ff2a	e7534aa4-4d12-4be7-a3d2-5cd38ab6b8a4
2210	2210	0	GBIF Germany	4f6826f2-4ff6-443d-b966-e6913bd24013	e82e760b-499d-4b53-8a84-99d0835c8539
6258	7050	792	Participant Node Managers Committee	7f48e0c8-5c96-49ec-b972-30748e339115	e898796e-d96c-426f-aa67-dc4476b3e37f
637	637	0	Colombian Biodiversity Information System	7e865cba-7c46-417b-ade5-97f2cf5b7be0	e8e716a0-201a-49af-85a1-c21101c6b9d3
78	78	0	GBIF Finland	dd514216-5c7c-45f3-910d-797424cb5be6	ed0d5a20-12e1-49e9-8207-ec4da410aced
26943	26943	0	GBIF Germany	4f6826f2-4ff6-443d-b966-e6913bd24013	ee9c2798-1637-11e3-b987-00145eb45e9a
4371	4371	0	GBIF Germany	4f6826f2-4ff6-443d-b966-e6913bd24013	ef88623c-0b5d-4312-acde-5c102b3ed14b
77627	77627	0	GBIF France	da44cd31-5901-4687-a106-6d1c7734ee3a	f1566792-b416-4692-a09c-7e8aa8d17be6
5573009	5701044	128035	GBIF Finland	dd514216-5c7c-45f3-910d-797424cb5be6	f2e389da-39c3-4f21-8d72-b7d574d924a9
24	24	0	Plazi	ffb07bec-2d10-492d-9c37-361fe0b79427	f2ede65b-b5d7-4443-86e0-12bcdbebf2bf
8	8	0	Plazi	ffb07bec-2d10-492d-9c37-361fe0b79427	f4409b61-2892-4683-a419-757992e0f0fd
4	4	0	Plazi	ffb07bec-2d10-492d-9c37-361fe0b79427	f6827457-6994-4bee-949e-2dd0f5f03afa
0	18	18	Plazi	ffb07bec-2d10-492d-9c37-361fe0b79427	f769f705-8e4e-4c74-be78-ee5ce40f482c
83	83	0	GBIF Finland	dd514216-5c7c-45f3-910d-797424cb5be6	fa2c5df8-8f1d-48e0-9bb1-d4083f1c8596
13199	13233	34	GBIF Norway	4f829580-180d-46a9-9c87-ed8ec959b545	fb716825-2962-4375-8532-3ac7429aa86d
78	78	0	Plazi	ffb07bec-2d10-492d-9c37-361fe0b79427	fd24ef18-76ac-46f1-aec2-2faf5b0ff325
0	22	22	Plazi	ffb07bec-2d10-492d-9c37-361fe0b79427	029de188-d93a-4e54-b452-ea352669af61
284	284	0	GBIF Spain	1f94b3ca-9345-4d65-afe2-4bace93aa0fe	04b949ba-e65a-427c-acce-8a5df15605e8
25	25	0	Plazi	ffb07bec-2d10-492d-9c37-361fe0b79427	0517ac4e-b899-47a1-9747-ded2c8475d1d
0	1	1	Plazi	ffb07bec-2d10-492d-9c37-361fe0b79427	0571babf-d00a-4394-bada-206efee69e80
0	28	28	Plazi	ffb07bec-2d10-492d-9c37-361fe0b79427	06c2a70d-6ed0-4fe6-a03e-6b928b12cb5c
6517	6517	0	National Biodiversity Network	d897a5b9-35ee-4232-94bd-b0bcaac003c2	07a203b7-21a7-4c01-b8a4-cf906f4bc1c0
1238	1238	0	Polish Biodiversity Information Network	2618bfdf-e194-4911-a241-80db3107bc51	086c90f0-ae7d-11dc-b3c6-b8a03c50a862
1723	1723	0	National Biodiversity Network	d897a5b9-35ee-4232-94bd-b0bcaac003c2	0aa1f32a-d1d6-4340-8405-155412d0b576
48	48	0	Plazi	ffb07bec-2d10-492d-9c37-361fe0b79427	0cbaaedc-a2d8-4b38-8310-59cffb64ded5
72	72	0	Plazi	ffb07bec-2d10-492d-9c37-361fe0b79427	0ee202f4-617e-40ef-92d9-7bbf19f33fdb
13	13	0	Plazi	ffb07bec-2d10-492d-9c37-361fe0b79427	111ec1e3-9549-4bc1-84bf-479ba57cfd5b
0	198	198	Ocean Biodiversity Information System	ba0670b9-4186-41e6-8e70-f9cb3065551a	11f443ac-e9ee-4e90-8011-4955147c6efa
2531	2531	0	Biodiversity Information System of Mexico	b324e8e9-9a4c-44fa-8f1a-7f39ea7ab576	12db9486-3bb3-4113-aaa2-8554ec92810c
0	14	14	Plazi	ffb07bec-2d10-492d-9c37-361fe0b79427	1308153a-2d1a-4760-8333-f7184cbb1f43
0	7	7	Plazi	ffb07bec-2d10-492d-9c37-361fe0b79427	13489c64-63b1-46c7-a7dd-9c41b3459975
276401	283799	7398	U.S. Geological Survey	8618c64a-93e0-4300-b546-7249e5148ed2	14f3151a-e95d-493c-a40d-d9938ef62954
157	157	0	National Biodiversity Network	d897a5b9-35ee-4232-94bd-b0bcaac003c2	172149d2-2dc0-43fb-a7b1-57e3e4ec34a2
3	3	0	Plazi	ffb07bec-2d10-492d-9c37-361fe0b79427	18e8beff-2325-487f-a7d6-657900b2bbfa
0	218	218	GBIF Chile	a8b16421-d80b-4ef3-8f22-098b01a89255	1a1fea7c-a319-45b8-8354-c929fd9287e6
0	13	13	Plazi	ffb07bec-2d10-492d-9c37-361fe0b79427	1bbcdb6e-555e-4e19-9160-46753ee0174a
201	201	0	Participant Node Managers Committee	7f48e0c8-5c96-49ec-b972-30748e339115	1c1c6cff-9943-4e9c-bb7b-0cbf5be39c21
1165	1165	0	Biodiversity Information System of Mexico	b324e8e9-9a4c-44fa-8f1a-7f39ea7ab576	1e0337ce-ed10-434e-9078-090289f1f13b
702	702	0	U.S. Geological Survey	8618c64a-93e0-4300-b546-7249e5148ed2	1e165f83-b718-428f-802e-62b0839ea54c
60	60	0	Plazi	ffb07bec-2d10-492d-9c37-361fe0b79427	2170c1a8-db15-4793-a27b-e59752f7165d
47	47	0	Plazi	ffb07bec-2d10-492d-9c37-361fe0b79427	224b9528-9f40-4c79-b9e4-c887bd65df64
3	3	0	Plazi	ffb07bec-2d10-492d-9c37-361fe0b79427	240971f9-b053-4fd8-9612-ce7f71e9661a
56	56	0	GBIF France	da44cd31-5901-4687-a106-6d1c7734ee3a	25ac60f7-a528-437e-83fe-553b9fd26857
151	151	0	GBIF Germany	4f6826f2-4ff6-443d-b966-e6913bd24013	26d29e21-9fc9-47da-90c2-62c0912c9f65
197	197	0	GBIF Finland	dd514216-5c7c-45f3-910d-797424cb5be6	270dc28f-e919-4755-bebe-89346d297e16
40	40	0	Plazi	ffb07bec-2d10-492d-9c37-361fe0b79427	2a809cd9-f17a-4eea-8eb0-ad8f2ee0ef91
2220	2220	0	National Biodiversity Network	d897a5b9-35ee-4232-94bd-b0bcaac003c2	2ae2997e-c6ff-40b1-917f-93227768da6f
2349	2349	0	Biodiversity Information System of Mexico	b324e8e9-9a4c-44fa-8f1a-7f39ea7ab576	32296620-0649-46a5-9c3d-2db44fbb2a18
0	24	24	Ocean Biodiversity Information System	ba0670b9-4186-41e6-8e70-f9cb3065551a	34b42aa8-0dce-4b4e-96eb-805d7f49f38f
12924	12924	0	GBIF France	da44cd31-5901-4687-a106-6d1c7734ee3a	34d4053d-a75e-452b-8aae-44d90a725ba4
76	76	0	GBIF France	da44cd31-5901-4687-a106-6d1c7734ee3a	352f750d-8365-4d63-b233-46fb12cb8f96
0	10	10	Plazi	ffb07bec-2d10-492d-9c37-361fe0b79427	35ad92a2-7944-45c9-80a6-d8fdf9aa6faf
0	5	5	Plazi	ffb07bec-2d10-492d-9c37-361fe0b79427	36f93656-1079-41ad-a92f-45cc8b53cb2c
2	2	0	GBIF Finland	dd514216-5c7c-45f3-910d-797424cb5be6	38af3807-d635-479d-a607-c813931be6ac
0	18	18	Plazi	ffb07bec-2d10-492d-9c37-361fe0b79427	38e1da4f-7e6b-4801-98d3-2fd42bb6c53d
611	611	0	GBIF France	da44cd31-5901-4687-a106-6d1c7734ee3a	38ea9256-20aa-40b0-b70d-34818c9633e2
42	42	0	Plazi	ffb07bec-2d10-492d-9c37-361fe0b79427	3b0c3795-56ed-4afb-99d4-6db0f65b13b7
82	82	0	Belgian Biodiversity Platform	fb11cfe1-ebc3-45af-9159-17d9fddbcdac	3d5af922-1767-4f43-84a5-b459c6725276
1	1	0	Participant Node Managers Committee	7f48e0c8-5c96-49ec-b972-30748e339115	3e8fea4e-3a3a-4fcd-a683-0eb829e3db06
0	353	353	Plazi	ffb07bec-2d10-492d-9c37-361fe0b79427	3f20c135-c448-4c8c-a716-993e4f6d50d0
6	6	0	Plazi	ffb07bec-2d10-492d-9c37-361fe0b79427	4010e46d-214a-425a-b551-a8c40481708b
16	16	0	Participant Node Managers Committee	7f48e0c8-5c96-49ec-b972-30748e339115	413bc3ec-9af3-45c2-abcc-f03b54c23b1c
0	24	24	Plazi	ffb07bec-2d10-492d-9c37-361fe0b79427	414491b2-5167-4605-95ab-f679bf476618
0	71	71	Ocean Biodiversity Information System	ba0670b9-4186-41e6-8e70-f9cb3065551a	42416c65-ea13-4270-855f-fc6346a7d965
0	12	12	Plazi	ffb07bec-2d10-492d-9c37-361fe0b79427	42a1a8bc-7979-4354-925e-9c8604ce1c7d
0	185	185	Colombian Biodiversity Information System	7e865cba-7c46-417b-ade5-97f2cf5b7be0	45a6d7ad-f406-4ef2-a8b2-79a2230aa927
509	509	0	Atlas of Living Australia	4a6f1b71-969e-4fc5-a693-282b05e1220c	496f88c8-7c67-4e93-8f85-bc954e78debc
1695	1695	0	Colombian Biodiversity Information System	7e865cba-7c46-417b-ade5-97f2cf5b7be0	4e56ef9f-5aef-49a8-bc3e-fe77635d0352
372	372	0	GBIF France	da44cd31-5901-4687-a106-6d1c7734ee3a	4e83eae7-520d-411f-8fe0-cc07578fd217
0	5	5	Plazi	ffb07bec-2d10-492d-9c37-361fe0b79427	4e850c9f-64ea-4ce5-80c6-773fbbabcafe
837	837	0	GBIF Argentina	2426a871-9feb-40a1-96c6-0c593a76b835	4fd5035e-d565-4f43-9385-08ca572fa6e5
0	7	7	Plazi	ffb07bec-2d10-492d-9c37-361fe0b79427	535495de-a5ad-4d14-b50e-9891be2e6426
810	810	0	GBIF Estonia	2c11b821-d22b-4c64-8cd3-c1578173b129	580aa7ad-5965-4f6c-9a28-05a3ddfc73bb
0	13	13	Plazi	ffb07bec-2d10-492d-9c37-361fe0b79427	584e2dcf-4364-4770-9fb7-1a4febcc1233
28192	28192	0	National Biodiversity Network	d897a5b9-35ee-4232-94bd-b0bcaac003c2	599e0df5-27c4-4e3e-ba20-7744a832dfbe
5	5	0	Plazi	ffb07bec-2d10-492d-9c37-361fe0b79427	5eea12c8-fe77-4904-9808-9be714ecf68c
22	22	0	Plazi	ffb07bec-2d10-492d-9c37-361fe0b79427	605cdafa-60b6-48fb-a80d-4ed0428d2f33
20	20	0	GBIF Germany	4f6826f2-4ff6-443d-b966-e6913bd24013	62f46826-f762-11e1-a439-00145eb45e9a
6	6	0	GBIF Germany	4f6826f2-4ff6-443d-b966-e6913bd24013	631e5f3c-f762-11e1-a439-00145eb45e9a
61	61	0	GBIF Germany	4f6826f2-4ff6-443d-b966-e6913bd24013	63752b14-f762-11e1-a439-00145eb45e9a
256	256	0	GBIF Germany	4f6826f2-4ff6-443d-b966-e6913bd24013	63a23668-f762-11e1-a439-00145eb45e9a
50	45	-5	GBIF Germany	4f6826f2-4ff6-443d-b966-e6913bd24013	64fd2540-f762-11e1-a439-00145eb45e9a
378	378	0	GBIF Madagascar	2dbfc5c5-51b5-4494-9dfc-4d3f013a3b64	66392a34-7105-40a3-99a1-885a86673d20
133	133	0	GBIF Germany	4f6826f2-4ff6-443d-b966-e6913bd24013	67640ab0-f762-11e1-a439-00145eb45e9a
51	51	0	GBIF Germany	4f6826f2-4ff6-443d-b966-e6913bd24013	67c87df6-f762-11e1-a439-00145eb45e9a
252	252	0	Colombian Biodiversity Information System	7e865cba-7c46-417b-ade5-97f2cf5b7be0	68367736-6990-42f3-b0d1-41b0a6db8236
0	90	90	GBIF Norway	4f829580-180d-46a9-9c87-ed8ec959b545	69227b38-becd-49f3-bfd7-49fabd4e6ea7
0	35	35	Plazi	ffb07bec-2d10-492d-9c37-361fe0b79427	69256a12-9dbf-440b-823d-83e55f117397
628	628	0	GBIF Germany	4f6826f2-4ff6-443d-b966-e6913bd24013	69710042-f762-11e1-a439-00145eb45e9a
179930	179929	-1	National Biodiversity Network	d897a5b9-35ee-4232-94bd-b0bcaac003c2	6b3877d5-4869-43aa-af12-92c703fd5b6d
491	491	0	GBIF Germany	4f6826f2-4ff6-443d-b966-e6913bd24013	6ca82e48-f762-11e1-a439-00145eb45e9a
211	211	0	Colombian Biodiversity Information System	7e865cba-7c46-417b-ade5-97f2cf5b7be0	6cc29922-6fa8-4f82-bb70-f15ffdb9f2a7
1	1	0	Plazi	ffb07bec-2d10-492d-9c37-361fe0b79427	6da81aec-2005-471c-9cf6-d50788fdaa35
11	11	0	Plazi	ffb07bec-2d10-492d-9c37-361fe0b79427	6f1a06d8-dbae-462e-8415-0cb51016c64a
1438	1412	-26	GBIF Germany	4f6826f2-4ff6-443d-b966-e6913bd24013	6f78ce2a-f762-11e1-a439-00145eb45e9a
9	9	0	GBIF Germany	4f6826f2-4ff6-443d-b966-e6913bd24013	6feae302-f762-11e1-a439-00145eb45e9a
8	8	0	Plazi	ffb07bec-2d10-492d-9c37-361fe0b79427	70337b5a-f8e6-4d94-a0cc-ce4a8cdb29ef
147	147	0	GBIF Germany	4f6826f2-4ff6-443d-b966-e6913bd24013	70dcd284-f762-11e1-a439-00145eb45e9a
319	319	0	National Biodiversity Network	d897a5b9-35ee-4232-94bd-b0bcaac003c2	710abb98-2f53-4ce8-9ebb-67bb558860b7
2050	2050	0	GBIF Germany	4f6826f2-4ff6-443d-b966-e6913bd24013	7120fc8e-f762-11e1-a439-00145eb45e9a
1	1	0	Plazi	ffb07bec-2d10-492d-9c37-361fe0b79427	7201bf56-6092-4952-9b6f-029b2250b3ba
1709	1709	0	GBIF France	da44cd31-5901-4687-a106-6d1c7734ee3a	7258e881-b6f9-405d-bc71-e638a21f2df9
13	13	0	GBIF Germany	4f6826f2-4ff6-443d-b966-e6913bd24013	72addfcc-f762-11e1-a439-00145eb45e9a
17	17	0	GBIF Argentina	2426a871-9feb-40a1-96c6-0c593a76b835	72d5868a-0830-4274-803a-425826db155f
16	16	0	GBIF Germany	4f6826f2-4ff6-443d-b966-e6913bd24013	7399a25e-f762-11e1-a439-00145eb45e9a
0	20	20	Ocean Biodiversity Information System	ba0670b9-4186-41e6-8e70-f9cb3065551a	73fe37b2-e9de-4825-9d39-29ffcd52fea6
68	68	0	GBIF Germany	4f6826f2-4ff6-443d-b966-e6913bd24013	740d7e5e-f762-11e1-a439-00145eb45e9a
0	5	5	Plazi	ffb07bec-2d10-492d-9c37-361fe0b79427	759d3fcd-8e23-408d-b28f-63c41f74658c
6537	6537	0	GBIF Madagascar	2dbfc5c5-51b5-4494-9dfc-4d3f013a3b64	76f80707-d78e-4657-9590-7ac74f6283b1
36	31	-5	GBIF Germany	4f6826f2-4ff6-443d-b966-e6913bd24013	79af54fe-f762-11e1-a439-00145eb45e9a
1343	1343	0	GBIF Japan	db5705aa-6a6e-42f1-8942-d77b9f4896ea	7a4e2b38-f762-11e1-a439-00145eb45e9a
122	122	0	GBIF Germany	4f6826f2-4ff6-443d-b966-e6913bd24013	7a7c2dd0-f762-11e1-a439-00145eb45e9a
6	6	0	Plazi	ffb07bec-2d10-492d-9c37-361fe0b79427	7a9dbc1f-429e-4720-8615-e41cba30f050
1	1	0	Plazi	ffb07bec-2d10-492d-9c37-361fe0b79427	7ad1bac1-a871-4c04-96f1-66cc99aeece7
304	304	0	Ocean Biodiversity Information System	ba0670b9-4186-41e6-8e70-f9cb3065551a	7b61ebd6-f762-11e1-a439-00145eb45e9a
206	206	0	GBIF Germany	4f6826f2-4ff6-443d-b966-e6913bd24013	7c5f2328-f762-11e1-a439-00145eb45e9a
60	60	0	GBIF Germany	4f6826f2-4ff6-443d-b966-e6913bd24013	7c8a7bcc-f762-11e1-a439-00145eb45e9a
1007	1007	0	GBIF Germany	4f6826f2-4ff6-443d-b966-e6913bd24013	7d97350a-f762-11e1-a439-00145eb45e9a
2140	2140	0	GBIF France	da44cd31-5901-4687-a106-6d1c7734ee3a	7e25fbf6-0147-4130-ac25-13de6cd9c3ea
1325	1325	0	Ocean Biodiversity Information System	ba0670b9-4186-41e6-8e70-f9cb3065551a	7e3091f0-f762-11e1-a439-00145eb45e9a
363	363	0	Colombian Biodiversity Information System	7e865cba-7c46-417b-ade5-97f2cf5b7be0	7e8d2078-6109-438d-958d-cb3ccd076a1e
223	223	0	GBIF Germany	4f6826f2-4ff6-443d-b966-e6913bd24013	7ec77408-f762-11e1-a439-00145eb45e9a
4	4	0	Plazi	ffb07bec-2d10-492d-9c37-361fe0b79427	7ee7964e-79db-4995-b400-9e9bc54a079c
21795	21795	0	Biodiversity Information System of Mexico	b324e8e9-9a4c-44fa-8f1a-7f39ea7ab576	7f662562-f762-11e1-a439-00145eb45e9a
795	794	-1	Biodiversity Information System of Mexico	b324e8e9-9a4c-44fa-8f1a-7f39ea7ab576	7fd41eb4-f762-11e1-a439-00145eb45e9a
0	3	3	Plazi	ffb07bec-2d10-492d-9c37-361fe0b79427	7fe7faae-7db9-44b1-b632-546fdfe15d70
1208	791	-417	Biodiversity Information System of Mexico	b324e8e9-9a4c-44fa-8f1a-7f39ea7ab576	802b7bb4-f762-11e1-a439-00145eb45e9a
3440	3440	0	Biodiversity Information System of Mexico	b324e8e9-9a4c-44fa-8f1a-7f39ea7ab576	80c24044-f762-11e1-a439-00145eb45e9a
5335	5535	200	GBIF Japan	db5705aa-6a6e-42f1-8942-d77b9f4896ea	81209a18-f762-11e1-a439-00145eb45e9a
1943	1983	40	GBIF Japan	db5705aa-6a6e-42f1-8942-d77b9f4896ea	8121aa20-f762-11e1-a439-00145eb45e9a
236	236	0	Plazi	ffb07bec-2d10-492d-9c37-361fe0b79427	812e0570-38c6-4f6e-840c-7d52d87a8c12
618	529	-89	GBIF Germany	4f6826f2-4ff6-443d-b966-e6913bd24013	824670f2-f762-11e1-a439-00145eb45e9a
0	106	106	Plazi	ffb07bec-2d10-492d-9c37-361fe0b79427	83833785-9beb-4d2f-8448-5657c8400fca
210	210	0	Canada Biodiversity Information Facility	8f83fc96-c966-4126-83f7-bf044dc49efa	844be79c-f762-11e1-a439-00145eb45e9a
125	125	0	GBIF Norway	4f829580-180d-46a9-9c87-ed8ec959b545	85b25e06-1f6b-48ea-8597-136b0ca5f160
1271	1271	0	DanBIF - Danish Biodiversity Information Facility	4ddd294f-02b7-4359-ac33-0806a9ca9c6b	86f101c4-d8fd-4939-9dd2-70cb08f89e70
177	79	-98	GBIF Germany	4f6826f2-4ff6-443d-b966-e6913bd24013	87739cc6-f762-11e1-a439-00145eb45e9a
87	87	0	GBIF Germany	4f6826f2-4ff6-443d-b966-e6913bd24013	882fa45c-f762-11e1-a439-00145eb45e9a
9	9	0	Plazi	ffb07bec-2d10-492d-9c37-361fe0b79427	88a0b95a-f568-4ec4-af8d-8bf15e08035b
249	249	0	GBIF Germany	4f6826f2-4ff6-443d-b966-e6913bd24013	89a89f96-f762-11e1-a439-00145eb45e9a
42	42	0	GBIF Germany	4f6826f2-4ff6-443d-b966-e6913bd24013	8a96ff2e-f762-11e1-a439-00145eb45e9a
239	239	0	GBIF Germany	4f6826f2-4ff6-443d-b966-e6913bd24013	8aa6d58e-f762-11e1-a439-00145eb45e9a
53	53	0	GBIF France	da44cd31-5901-4687-a106-6d1c7734ee3a	8c1e0c6c-ab7c-49d6-a662-021de930aca8
26	18	-8	GBIF Germany	4f6826f2-4ff6-443d-b966-e6913bd24013	8d1e9e50-f762-11e1-a439-00145eb45e9a
92	66	-26	GBIF Germany	4f6826f2-4ff6-443d-b966-e6913bd24013	8db43712-f762-11e1-a439-00145eb45e9a
61	61	0	Plazi	ffb07bec-2d10-492d-9c37-361fe0b79427	8f75cf6f-6fce-41d6-a734-21babf75b7db
332	332	0	GBIF Sweden	a0b3be64-6525-4387-ac67-a499950f92e1	8f8b0e71-4f94-48f5-abe8-f747d64fd532
98	58	-40	GBIF Germany	4f6826f2-4ff6-443d-b966-e6913bd24013	8fde0234-f762-11e1-a439-00145eb45e9a
4	4	0	Plazi	ffb07bec-2d10-492d-9c37-361fe0b79427	9025800c-3cb7-4d51-8d9d-c460523b3f2c
164	152	-12	GBIF Germany	4f6826f2-4ff6-443d-b966-e6913bd24013	913eca14-f762-11e1-a439-00145eb45e9a
98	98	0	GBIF Germany	4f6826f2-4ff6-443d-b966-e6913bd24013	93668020-f762-11e1-a439-00145eb45e9a
349	355	6	GBIF Germany	4f6826f2-4ff6-443d-b966-e6913bd24013	94ec3f34-f762-11e1-a439-00145eb45e9a
1113	1094	-19	GBIF Germany	4f6826f2-4ff6-443d-b966-e6913bd24013	952a900e-f762-11e1-a439-00145eb45e9a
736	736	0	GBIF Germany	4f6826f2-4ff6-443d-b966-e6913bd24013	959a8f80-f762-11e1-a439-00145eb45e9a
149	149	0	GBIF Germany	4f6826f2-4ff6-443d-b966-e6913bd24013	95c570c4-f762-11e1-a439-00145eb45e9a
36	36	0	Plazi	ffb07bec-2d10-492d-9c37-361fe0b79427	95e8c11b-7838-4ad0-a1f2-5002f03b24e3
59928	59928	0	GBIF France	da44cd31-5901-4687-a106-6d1c7734ee3a	96309e26-f762-11e1-a439-00145eb45e9a
5	5	0	Plazi	ffb07bec-2d10-492d-9c37-361fe0b79427	96850fba-29bb-4853-b043-724814f4041b
6253	4484	-1769	GBIF Germany	4f6826f2-4ff6-443d-b966-e6913bd24013	97323848-f762-11e1-a439-00145eb45e9a
42135	43350	1215	GBIF Germany	4f6826f2-4ff6-443d-b966-e6913bd24013	98407d8d-ff58-4298-90f1-0d59f3421df2
12287	12287	0	National Biodiversity Network	d897a5b9-35ee-4232-94bd-b0bcaac003c2	98bb13ef-d64c-49e4-b06e-96bffc8c4ea4
155	155	0	Plazi	ffb07bec-2d10-492d-9c37-361fe0b79427	99728e49-c1bf-494c-8634-7c06340343ee
0	4	4	Plazi	ffb07bec-2d10-492d-9c37-361fe0b79427	99c32064-4486-485b-9325-007d7742386e
2	2	0	Plazi	ffb07bec-2d10-492d-9c37-361fe0b79427	9ba6c3c4-a8fa-42b2-8b4b-01aac514adc5
0	50	50	Plazi	ffb07bec-2d10-492d-9c37-361fe0b79427	9e4bac3a-1f00-4194-a004-99feee254a1c
9	9	0	Plazi	ffb07bec-2d10-492d-9c37-361fe0b79427	9f998bfc-6f97-4e73-92ac-f4a0b7a474cb
27192	32212	5020	GBIF Japan	db5705aa-6a6e-42f1-8942-d77b9f4896ea	a07ef523-a8ee-442c-ab56-3bfc4cbe10b9
53136	54910	1774	GBIF Brazil	cdc9736d-5ff7-4ece-9959-3c744360cdb3	a0cb1f6e-5766-4cc5-a8a0-cfc6a22c5c3d
0	44	44	Plazi	ffb07bec-2d10-492d-9c37-361fe0b79427	a1d8568e-d4c8-4a71-a1cf-0ff9894720e6
682	682	0	DanBIF - Danish Biodiversity Information Facility	4ddd294f-02b7-4359-ac33-0806a9ca9c6b	a3d5f6ba-034e-4167-bd8a-1fb80018ae61
45	45	0	Colombian Biodiversity Information System	7e865cba-7c46-417b-ade5-97f2cf5b7be0	a71b5b32-ea26-447e-bcc7-ad7a421aa96a
0	1	1	Plazi	ffb07bec-2d10-492d-9c37-361fe0b79427	a73b6139-7137-4805-8b79-d5e46ad1286c
28	28	0	Plazi	ffb07bec-2d10-492d-9c37-361fe0b79427	a8730f57-9817-43b3-80bb-3665d38f81ab
56	56	0	Belgian Biodiversity Platform	fb11cfe1-ebc3-45af-9159-17d9fddbcdac	aadace25-8f1f-4a64-96ea-41811724eb6c
52	52	0	Plazi	ffb07bec-2d10-492d-9c37-361fe0b79427	ab419a3d-d290-452e-aed9-902216aa9640
95	95	0	Participant Node Managers Committee	7f48e0c8-5c96-49ec-b972-30748e339115	abf09c39-7e71-4d6c-9787-052c2d3e2842
5794	5794	0	U.S. Geological Survey	8618c64a-93e0-4300-b546-7249e5148ed2	af0496b9-af24-4290-81e6-d25e90ffb9d1
0	6	6	Plazi	ffb07bec-2d10-492d-9c37-361fe0b79427	b12f89b8-b7a7-4431-82c5-50bad83c55e5
34	34	0	Participant Node Managers Committee	7f48e0c8-5c96-49ec-b972-30748e339115	b1be668f-c194-484c-a7fc-adeb5142ec1a
1	1	0	Plazi	ffb07bec-2d10-492d-9c37-361fe0b79427	b38403d2-822e-4d58-b1b8-e603e2f18c48
2162753	2162753	0	South African Biodiversity Information Facility	7190b835-4e86-4b6e-85c1-19cc6677c250	b4ae1720-1431-49ee-bfeb-8146fc42b1a3
0	4	4	Ocean Biodiversity Information System	ba0670b9-4186-41e6-8e70-f9cb3065551a	b5d0e7da-ec12-4cc4-a717-abdeab7a95d9
104	104	0	GBIF Japan	db5705aa-6a6e-42f1-8942-d77b9f4896ea	b9f1eaa8-03d3-458c-bf3a-ae883cd06ca1
6	6	0	Plazi	ffb07bec-2d10-492d-9c37-361fe0b79427	bc8e7b7b-d323-4aa7-9300-52c2b6021b82
1	1	0	Plazi	ffb07bec-2d10-492d-9c37-361fe0b79427	bca5b47a-67e3-46be-adf0-448a95f54e37
18467	18467	0	National Biodiversity Network	d897a5b9-35ee-4232-94bd-b0bcaac003c2	c092728b-d872-4cfa-89aa-041be728e080
1	1	0	Plazi	ffb07bec-2d10-492d-9c37-361fe0b79427	c36c2c3b-e2ff-427c-9cd9-c39fa01dd8c5
7	7	0	Plazi	ffb07bec-2d10-492d-9c37-361fe0b79427	c46b2ceb-0a6e-45fe-acad-3da83b5c1df2
5	5	0	Plazi	ffb07bec-2d10-492d-9c37-361fe0b79427	c7830895-56ed-4251-8221-54365b420864
0	33	33	Colombian Biodiversity Information System	7e865cba-7c46-417b-ade5-97f2cf5b7be0	c8cb5bae-0957-4726-9c5a-e1f81219bd7c
7	7	0	Plazi	ffb07bec-2d10-492d-9c37-361fe0b79427	ccffc43d-6b4a-4b1e-ab57-3a2ff311bde1
10	10	0	Plazi	ffb07bec-2d10-492d-9c37-361fe0b79427	d08ae1d9-ece5-4d88-b51e-62ccdab31f88
0	1	1	Plazi	ffb07bec-2d10-492d-9c37-361fe0b79427	d0dc4743-44cc-4cb4-8d52-17c103711ec4
181	181	0	Colombian Biodiversity Information System	7e865cba-7c46-417b-ade5-97f2cf5b7be0	d8febc11-498e-465d-88ee-d08c0a726bd9
12	12	0	Plazi	ffb07bec-2d10-492d-9c37-361fe0b79427	d959a126-44a7-428d-b4ae-c14268d615a6
6	6	0	Plazi	ffb07bec-2d10-492d-9c37-361fe0b79427	d9cd98cb-9f65-4051-811a-ec5b28d2d8d9
0	1491	1491	National Biodiversity Network	d897a5b9-35ee-4232-94bd-b0bcaac003c2	dac0a667-6beb-4c18-a456-e2a5bb43757d
0	85	85	Plazi	ffb07bec-2d10-492d-9c37-361fe0b79427	daf45c04-3513-431e-9376-ed3e70776d1d
14549	14549	0	Netherlands Biodiversity Information Facility	0909d601-bda2-42df-9e63-a6d51847ebce	dc55fd8a-47af-47fe-a59e-a2890c72fed1
1	1	0	Plazi	ffb07bec-2d10-492d-9c37-361fe0b79427	de4a3144-ea96-4673-8c30-7b3f4a287f83
3	3	0	Plazi	ffb07bec-2d10-492d-9c37-361fe0b79427	defb7e7d-732b-482d-bdab-df7e14fd2663
17	17	0	Plazi	ffb07bec-2d10-492d-9c37-361fe0b79427	dff07d17-ffbb-43ad-a088-800b7726cc0f
260243	263743	3500	Symbiota Support Hub	612b5a0b-908b-4b4e-b9bf-ca15dfdc94fa	e05fd4c2-4d77-4c50-880e-1b22096af300
34	34	0	Participant Node Managers Committee	7f48e0c8-5c96-49ec-b972-30748e339115	e11d99cb-4a96-4e9d-847e-d078cfd59f6c
679	679	0	Colombian Biodiversity Information System	7e865cba-7c46-417b-ade5-97f2cf5b7be0	e2997269-eb19-4667-812e-b35168fa0e6d
334	334	0	National Biodiversity Network	d897a5b9-35ee-4232-94bd-b0bcaac003c2	e612e317-8fa5-4123-b5d1-de62d60c2e00
1	1	0	Plazi	ffb07bec-2d10-492d-9c37-361fe0b79427	e6f6c112-7a4e-4bb9-a129-8115258398fb
165	165	0	Plazi	ffb07bec-2d10-492d-9c37-361fe0b79427	e99997c4-8365-49c9-a6c6-b434c80bdc74
144	144	0	GBIF France	da44cd31-5901-4687-a106-6d1c7734ee3a	eaa274d4-d637-40c7-8441-76db1fa6371c
84	84	0	Plazi	ffb07bec-2d10-492d-9c37-361fe0b79427	ead7ec31-b9d4-49f3-a006-a67fff6ad623
11	11	0	Plazi	ffb07bec-2d10-492d-9c37-361fe0b79427	ed95e404-6108-47c1-92e6-c285d46196ac
2130	2130	0	Atlas of Living Australia	4a6f1b71-969e-4fc5-a693-282b05e1220c	ee412fa2-edc9-4c6b-91f3-ff2a02c245e0
199	199	0	GBIF France	da44cd31-5901-4687-a106-6d1c7734ee3a	ee8b3e9e-6f1b-4fff-b274-f4fd30f04e8e
1863	1863	0	U.S. Geological Survey	8618c64a-93e0-4300-b546-7249e5148ed2	efb5daef-0851-446b-9afd-caec0f023768
0	14	14	Plazi	ffb07bec-2d10-492d-9c37-361fe0b79427	f0e7fdea-7b84-4c69-9ce7-08bf971d3929
165	165	0	Colombian Biodiversity Information System	7e865cba-7c46-417b-ade5-97f2cf5b7be0	f1bd95c5-c819-4e8d-9872-bbd3c160cbe6
83520	84067	547	GBIF Brazil	cdc9736d-5ff7-4ece-9959-3c744360cdb3	f45c5ee0-e5ec-42e3-a80a-07318144efa4
162	162	0	Indonesian Biodiversity Information Facility	2ebd91f6-f14f-4375-b525-c011a3774f03	f53a51f9-ad06-465e-97fd-37ea81a9f732
67	67	0	Plazi	ffb07bec-2d10-492d-9c37-361fe0b79427	f5fbe9b2-8641-4681-8664-ddd6857c44a9
43	43	0	Plazi	ffb07bec-2d10-492d-9c37-361fe0b79427	f7bf0356-c26b-4bdd-8a29-9762939f3bd7
0	2	2	Plazi	ffb07bec-2d10-492d-9c37-361fe0b79427	f7e2e892-6f4e-45e2-b85d-174e93c49766
1861	1863	2	Biodiversity Information System of Mexico	b324e8e9-9a4c-44fa-8f1a-7f39ea7ab576	f9650277-63c3-4612-83ac-812d10b5fbc9
56800	56800	0	U.S. Geological Survey	8618c64a-93e0-4300-b546-7249e5148ed2	f96a6f8c-b992-4159-8039-db8f30bac985
2348	2348	0	National Biodiversity Network	d897a5b9-35ee-4232-94bd-b0bcaac003c2	f9bd9487-2e85-4e4c-8581-3aab3c6db5ee
1	1	0	Plazi	ffb07bec-2d10-492d-9c37-361fe0b79427	fa81fa1c-18f8-46b0-bed9-d778e9cbdf3f
4	4	0	Plazi	ffb07bec-2d10-492d-9c37-361fe0b79427	fdbe32e3-f5b6-4537-b870-6d295865da73
35	35	0	Plazi	ffb07bec-2d10-492d-9c37-361fe0b79427	fe39a11b-43d1-44ed-b047-19f2096eb6c0
3	3	0	Plazi	ffb07bec-2d10-492d-9c37-361fe0b79427	feb69850-4849-41ad-b6a3-fe772f5cf127
53985	53985	0	National Biodiversity Data Centre	422b00b2-6c94-4bb6-976b-c359916efdb8	00255299-4034-4f8d-86ed-805dacc0ec5d
3	3	0	Plazi	ffb07bec-2d10-492d-9c37-361fe0b79427	01112aa0-cdae-4095-a495-bcec546ab512
2	2	0	Plazi	ffb07bec-2d10-492d-9c37-361fe0b79427	03ab9bb4-3e3e-4299-817a-1326f44df429
298	298	0	Plazi	ffb07bec-2d10-492d-9c37-361fe0b79427	03aeb45d-bda0-4791-a1e5-ca526b345afb
0	1690	1690	Participant Node Managers Committee	7f48e0c8-5c96-49ec-b972-30748e339115	0a8e05d9-b23f-45ca-b935-bd5137a0feba
430	430	0	Atlas of Living Australia	4a6f1b71-969e-4fc5-a693-282b05e1220c	0cf9329b-036b-42f8-aa60-e58b6577711d
12499	12499	0	Participant Node Managers Committee	7f48e0c8-5c96-49ec-b972-30748e339115	0e1d85a0-b480-40c6-a4a1-65193806b424
1	1	0	Plazi	ffb07bec-2d10-492d-9c37-361fe0b79427	0edfaa46-fe70-4034-95d0-aa64970fde30
195	195	0	GBIF France	da44cd31-5901-4687-a106-6d1c7734ee3a	0fd450c8-1d47-4746-baab-40b0b23f5f36
0	216	216	Plazi	ffb07bec-2d10-492d-9c37-361fe0b79427	1b0b2cf1-e297-42ef-99da-2e0775c52a3f
0	9	9	Ocean Biodiversity Information System	ba0670b9-4186-41e6-8e70-f9cb3065551a	1d153382-0660-4686-b7e3-b87719d210d5
23	19	-4	GBIF Germany	4f6826f2-4ff6-443d-b966-e6913bd24013	22d43d41-26fd-4136-8f54-8d8e7b639a5c
13	13	0	Plazi	ffb07bec-2d10-492d-9c37-361fe0b79427	22f25700-65a0-4f4f-84ae-74a366220b58
3	3	0	Participant Node Managers Committee	7f48e0c8-5c96-49ec-b972-30748e339115	23264feb-109c-488a-9bfa-e64edf7183a0
704	704	0	GBIF Portugal	673f7038-4262-4149-b753-5658a4e912f6	2944e5fd-fc4b-4e40-8dba-5a737f18cfc3
0	131	131	Colombian Biodiversity Information System	7e865cba-7c46-417b-ade5-97f2cf5b7be0	2cf36976-5312-412e-9725-e5939dc24c07
26557	26557	0	GBIF France	da44cd31-5901-4687-a106-6d1c7734ee3a	32219fa0-4b5f-4f3f-b119-5923d6995b3a
0	43	43	Plazi	ffb07bec-2d10-492d-9c37-361fe0b79427	35fa0ad7-0a81-41e2-ad38-0fba74c6bdab
0	5	5	Plazi	ffb07bec-2d10-492d-9c37-361fe0b79427	3c62dc4f-c55c-44fc-98f0-39df2a4bc88b
74	74	0	Plazi	ffb07bec-2d10-492d-9c37-361fe0b79427	3fc46d02-9b74-434b-a777-46d70967d61f
860	860	0	GBIF Germany	4f6826f2-4ff6-443d-b966-e6913bd24013	4483cba6-3a0c-11e2-b0ce-00145eb45e9a
7	7	0	Plazi	ffb07bec-2d10-492d-9c37-361fe0b79427	46c5c4e6-492c-42c0-a8cd-8ffaaec57d8c
1133	1133	0	GBIF Norway	4f829580-180d-46a9-9c87-ed8ec959b545	4dac6899-124a-40fc-90d3-aa5a872c99c0
30	30	0	Plazi	ffb07bec-2d10-492d-9c37-361fe0b79427	4ea36914-0349-45e5-a83b-77a02968d768
0	2	2	Plazi	ffb07bec-2d10-492d-9c37-361fe0b79427	55332da4-c714-4ca3-b114-9d1b275d5ca2
146	146	0	Plazi	ffb07bec-2d10-492d-9c37-361fe0b79427	55770274-cac7-4dde-871a-6c4cf42522c5
0	32	32	Plazi	ffb07bec-2d10-492d-9c37-361fe0b79427	5a75cc8f-fcc5-4893-870a-4ff7bfdb7d3c
56	56	0	Costa Rica Biodiversity Facility	3379bb09-1a58-41e7-9c57-e3b66c3eb5a0	5b60a2c5-5a31-4236-bbaa-3939a4ee4785
3	3	0	Plazi	ffb07bec-2d10-492d-9c37-361fe0b79427	5c05f11e-7ba4-4b7b-a98b-ccf91c1d26f3
5044	5044	0	GBIF France	da44cd31-5901-4687-a106-6d1c7734ee3a	5d05346f-d7f2-416c-8ee1-deb333cd9b19
0	103	103	Plazi	ffb07bec-2d10-492d-9c37-361fe0b79427	5fce1bf3-66a7-4ba3-8227-6d1373687998
248	248	0	GBIF Germany	4f6826f2-4ff6-443d-b966-e6913bd24013	61ded8a4-f762-11e1-a439-00145eb45e9a
2	2	0	Plazi	ffb07bec-2d10-492d-9c37-361fe0b79427	6285e169-731d-47da-b4dc-e727bb78a4d8
36	36	0	GBIF Germany	4f6826f2-4ff6-443d-b966-e6913bd24013	62e2a51e-f762-11e1-a439-00145eb45e9a
117	76	-41	GBIF Germany	4f6826f2-4ff6-443d-b966-e6913bd24013	65fd24d6-f762-11e1-a439-00145eb45e9a
94	94	0	GBIF Germany	4f6826f2-4ff6-443d-b966-e6913bd24013	676bb4ae-f762-11e1-a439-00145eb45e9a
62	62	0	GBIF Germany	4f6826f2-4ff6-443d-b966-e6913bd24013	67f63598-f762-11e1-a439-00145eb45e9a
62	62	0	GBIF Germany	4f6826f2-4ff6-443d-b966-e6913bd24013	67f77da4-f762-11e1-a439-00145eb45e9a
2	2	0	Plazi	ffb07bec-2d10-492d-9c37-361fe0b79427	68eaf510-1dcc-4a5c-851e-d136b952f953
189	189	0	GBIF Germany	4f6826f2-4ff6-443d-b966-e6913bd24013	69538a08-f762-11e1-a439-00145eb45e9a
583	583	0	GBIF Germany	4f6826f2-4ff6-443d-b966-e6913bd24013	69739aa0-f762-11e1-a439-00145eb45e9a
12	12	0	GBIF Germany	4f6826f2-4ff6-443d-b966-e6913bd24013	6bb85f62-f762-11e1-a439-00145eb45e9a
2	2	0	Plazi	ffb07bec-2d10-492d-9c37-361fe0b79427	6c30f5e1-4ddc-4db0-a340-847fe63ef724
195	195	0	GBIF Germany	4f6826f2-4ff6-443d-b966-e6913bd24013	6c38c9cc-f762-11e1-a439-00145eb45e9a
51	51	0	GBIF Germany	4f6826f2-4ff6-443d-b966-e6913bd24013	6d34fda0-f762-11e1-a439-00145eb45e9a
74	74	0	Plazi	ffb07bec-2d10-492d-9c37-361fe0b79427	6e15e238-774d-468a-b2e6-6e81c64b39c2
2358	2358	0	GBIF Germany	4f6826f2-4ff6-443d-b966-e6913bd24013	6eab259c-f762-11e1-a439-00145eb45e9a
180	180	0	Plazi	ffb07bec-2d10-492d-9c37-361fe0b79427	6efd6d75-a7a1-4fb5-a401-01643c8d3572
14	14	0	Plazi	ffb07bec-2d10-492d-9c37-361fe0b79427	707ce7dd-4746-478b-b5bb-7cc3f96d6185
44	13	-31	GBIF Germany	4f6826f2-4ff6-443d-b966-e6913bd24013	7125f82e-f762-11e1-a439-00145eb45e9a
323	323	0	GBIF Germany	4f6826f2-4ff6-443d-b966-e6913bd24013	734bdab0-f762-11e1-a439-00145eb45e9a
14	14	0	GBIF France	da44cd31-5901-4687-a106-6d1c7734ee3a	735e0f81-a238-4c3b-b05b-d41ffa987d38
0	57	57	Participant Node Managers Committee	7f48e0c8-5c96-49ec-b972-30748e339115	73805fe4-f550-404f-9353-18f83a265c2e
13	13	0	GBIF Germany	4f6826f2-4ff6-443d-b966-e6913bd24013	738a95a2-f762-11e1-a439-00145eb45e9a
31	31	0	GBIF Germany	4f6826f2-4ff6-443d-b966-e6913bd24013	7458f988-f762-11e1-a439-00145eb45e9a
80	80	0	GBIF Germany	4f6826f2-4ff6-443d-b966-e6913bd24013	75497516-f762-11e1-a439-00145eb45e9a
20999334	20999334	0	GBIF France	da44cd31-5901-4687-a106-6d1c7734ee3a	75956ee6-1a2b-4fa3-b3e8-ccda64ce6c2d
20	20	0	Plazi	ffb07bec-2d10-492d-9c37-361fe0b79427	762fe4d7-c776-4f9a-97d9-fc85969f57f0
278030	302271	24241	U.S. Geological Survey	8618c64a-93e0-4300-b546-7249e5148ed2	76525e81-9210-401d-a90d-5509f771c0e7
15	15	0	GBIF Germany	4f6826f2-4ff6-443d-b966-e6913bd24013	78b846c8-f762-11e1-a439-00145eb45e9a
198	198	0	GBIF Germany	4f6826f2-4ff6-443d-b966-e6913bd24013	794690b8-f762-11e1-a439-00145eb45e9a
0	1152	1152	Ocean Biodiversity Information System	ba0670b9-4186-41e6-8e70-f9cb3065551a	79878042-ee45-44b9-bd92-a62b7e9f77b4
0	6	6	Plazi	ffb07bec-2d10-492d-9c37-361fe0b79427	79c377af-2d3e-4e27-9eb2-8bfd4508f835
106	106	0	GBIF Germany	4f6826f2-4ff6-443d-b966-e6913bd24013	79fe6c38-f762-11e1-a439-00145eb45e9a
1462	903	-559	GBIF Germany	4f6826f2-4ff6-443d-b966-e6913bd24013	7c2ee262-f762-11e1-a439-00145eb45e9a
73	73	0	GBIF Germany	4f6826f2-4ff6-443d-b966-e6913bd24013	7ed7c12d-f7c2-4993-97bc-018efaa76565
128557	144557	16000	GBIF Japan	db5705aa-6a6e-42f1-8942-d77b9f4896ea	80f63c1e-f762-11e1-a439-00145eb45e9a
1535	1119	-416	GBIF Germany	4f6826f2-4ff6-443d-b966-e6913bd24013	815afee2-f762-11e1-a439-00145eb45e9a
15718	15718	0	GBIF Austria	1e789bc9-79fc-4e60-a49e-89dfc45a7188	82746a3e-f762-11e1-a439-00145eb45e9a
0	72	72	Plazi	ffb07bec-2d10-492d-9c37-361fe0b79427	839ef813-c58e-4a1a-8131-9ef051a2a1c6
0	389	389	Plazi	ffb07bec-2d10-492d-9c37-361fe0b79427	83f9c900-1849-4f40-a1d7-c4847126ff6d
1196	1126	-70	GBIF Germany	4f6826f2-4ff6-443d-b966-e6913bd24013	856a4bdb-a5b4-46f7-a5f4-05d6aa60e17b
387	387	0	U.S. Geological Survey	8618c64a-93e0-4300-b546-7249e5148ed2	85eb6fc8-8e95-4621-9fe0-661d483ac614
282	181	-101	GBIF Germany	4f6826f2-4ff6-443d-b966-e6913bd24013	8739d1ee-f762-11e1-a439-00145eb45e9a
9	9	0	Plazi	ffb07bec-2d10-492d-9c37-361fe0b79427	8777cbf2-fe5b-4293-ad7e-9ca92a7acba1
67	61	-6	GBIF Germany	4f6826f2-4ff6-443d-b966-e6913bd24013	883f33f4-f762-11e1-a439-00145eb45e9a
83	83	0	GBIF Germany	4f6826f2-4ff6-443d-b966-e6913bd24013	897e6d02-f762-11e1-a439-00145eb45e9a
87	87	0	GBIF Sweden	a0b3be64-6525-4387-ac67-a499950f92e1	8b595b4e-2bab-4bcf-a2fd-208221ad01a5
1140	1140	0	GBIF Germany	4f6826f2-4ff6-443d-b966-e6913bd24013	8b722612-f762-11e1-a439-00145eb45e9a
606	606	0	GBIF France	da44cd31-5901-4687-a106-6d1c7734ee3a	8cca3052-d15a-474e-a0d6-f4d2c8182319
24	17	-7	GBIF Germany	4f6826f2-4ff6-443d-b966-e6913bd24013	8d66bbae-f762-11e1-a439-00145eb45e9a
53	41	-12	GBIF Germany	4f6826f2-4ff6-443d-b966-e6913bd24013	905002da-f762-11e1-a439-00145eb45e9a
0	39	39	Plazi	ffb07bec-2d10-492d-9c37-361fe0b79427	90b859b1-1ce1-43b2-995b-646ea1bc6513
6	6	0	GBIF Germany	4f6826f2-4ff6-443d-b966-e6913bd24013	93cf0848-f762-11e1-a439-00145eb45e9a
1032	1032	0	GBIF Germany	4f6826f2-4ff6-443d-b966-e6913bd24013	94229698-f762-11e1-a439-00145eb45e9a
56	56	0	GBIF Germany	4f6826f2-4ff6-443d-b966-e6913bd24013	943902d1-f681-444d-967f-74849c84f466
525	525	0	GBIF Germany	4f6826f2-4ff6-443d-b966-e6913bd24013	94c30f42-f762-11e1-a439-00145eb45e9a
420	420	0	GBIF Germany	4f6826f2-4ff6-443d-b966-e6913bd24013	955eeed0-f762-11e1-a439-00145eb45e9a
24	24	0	Ocean Biodiversity Information System	ba0670b9-4186-41e6-8e70-f9cb3065551a	95cf2d94-f762-11e1-a439-00145eb45e9a
35	35	0	GBIF Germany	4f6826f2-4ff6-443d-b966-e6913bd24013	9787c3e4-f762-11e1-a439-00145eb45e9a
3450	3450	0	GBIF Spain	1f94b3ca-9345-4d65-afe2-4bace93aa0fe	9cb4fdf2-49b3-4564-a929-00d16a456b67
4	4	0	Plazi	ffb07bec-2d10-492d-9c37-361fe0b79427	9de5d1d2-370c-4827-8be4-e6867f2fa610
269	269	0	GBIF France	da44cd31-5901-4687-a106-6d1c7734ee3a	9ea42582-6c26-4f1b-9587-b8840af983c0
17	17	0	Plazi	ffb07bec-2d10-492d-9c37-361fe0b79427	9f3e8dab-302c-4d15-a2e6-15ea54342f43
25159	25159	0	GBIF France	da44cd31-5901-4687-a106-6d1c7734ee3a	9fc816de-28c7-4484-940a-902af780a96f
59858	59858	0	GBIF France	da44cd31-5901-4687-a106-6d1c7734ee3a	a22a33ca-9f57-49ce-879b-c547a524a733
238	238	0	Secretariat of the Pacific Regional Environment Programme	29c6a139-ea7f-41f5-8d9b-c55af8736182	a2b61e22-8ed3-49fb-881b-ae71c64442ba
35764	35764	0	GBIF Austria	1e789bc9-79fc-4e60-a49e-89dfc45a7188	a4603234-322e-11e2-aba1-00145eb45e9a
2508	2508	0	National Biodiversity Network	d897a5b9-35ee-4232-94bd-b0bcaac003c2	a4c6d8aa-dfac-4f70-a960-d975558cc496
0	2	2	Plazi	ffb07bec-2d10-492d-9c37-361fe0b79427	a5e66613-8700-4cac-9ff1-bfa2f71991ef
1645	2000	355	U.S. Geological Survey	8618c64a-93e0-4300-b546-7249e5148ed2	a6f79c6f-4fbe-4f31-84e6-461e76b0853d
1	1	0	Plazi	ffb07bec-2d10-492d-9c37-361fe0b79427	a9802fb1-e3ff-4b43-819e-2143b8b35a30
143	143	0	Plazi	ffb07bec-2d10-492d-9c37-361fe0b79427	ac892ad5-037a-4486-9fdb-3082b98cbf49
2001	2001	0	National Biodiversity Network	d897a5b9-35ee-4232-94bd-b0bcaac003c2	b0abf52f-a4f8-4ed1-936c-2b8f0dc342ad
3	3	0	Plazi	ffb07bec-2d10-492d-9c37-361fe0b79427	b1462313-e610-4115-a021-2dbe363d14ad
55086	64218	9132	Belgian Biodiversity Platform	fb11cfe1-ebc3-45af-9159-17d9fddbcdac	b2906713-07c4-41b1-887f-adfc0a24b3ab
0	3	3	Plazi	ffb07bec-2d10-492d-9c37-361fe0b79427	b2f6a497-7a04-46af-b0a6-cacc97561526
0	3	3	Plazi	ffb07bec-2d10-492d-9c37-361fe0b79427	b55a04dc-b977-45b5-94af-7fec08d741d9
542	542	0	National Biodiversity Network	d897a5b9-35ee-4232-94bd-b0bcaac003c2	b66d88f8-4b53-4ffc-b1d1-3cb8b048bea6
0	28	28	Plazi	ffb07bec-2d10-492d-9c37-361fe0b79427	b688751a-399c-48d0-afe0-5827f3d4790a
0	67	67	Participant Node Managers Committee	7f48e0c8-5c96-49ec-b972-30748e339115	b73024da-c88c-47ba-9d98-705f386f453e
0	6	6	Plazi	ffb07bec-2d10-492d-9c37-361fe0b79427	b784ac84-3570-4031-a589-34deb0224796
88	88	0	GBIF Germany	4f6826f2-4ff6-443d-b966-e6913bd24013	b96cbd8e-9ebe-4dab-aa63-35803401f4a5
251	251	0	Colombian Biodiversity Information System	7e865cba-7c46-417b-ade5-97f2cf5b7be0	bbaad610-29b7-480e-a7bc-f5a7dc10c191
5634	5634	0	GBIF France	da44cd31-5901-4687-a106-6d1c7734ee3a	bca5f959-ec34-43ee-a671-96bf0b84f2dd
4496	4496	0	National Biodiversity Network	d897a5b9-35ee-4232-94bd-b0bcaac003c2	bf8dbd78-1833-4f09-bb90-4428d01ff1c9
100	100	0	Plazi	ffb07bec-2d10-492d-9c37-361fe0b79427	bfdb90af-9999-4219-985f-5695c398f0f9
177	177	0	Participant Node Managers Committee	7f48e0c8-5c96-49ec-b972-30748e339115	c151307b-d8f4-49e3-878d-ea3ab8f3bd65
0	14	14	Plazi	ffb07bec-2d10-492d-9c37-361fe0b79427	c36b481b-c2c3-4f7c-b5b9-614607673bb8
3	3	0	Plazi	ffb07bec-2d10-492d-9c37-361fe0b79427	c3cb3759-ec86-49ce-94c3-243a2e410ac9
6	6	0	Plazi	ffb07bec-2d10-492d-9c37-361fe0b79427	c6ba0dac-dd4b-4760-9567-3709c14bd650
10	10	0	Plazi	ffb07bec-2d10-492d-9c37-361fe0b79427	c8a490d4-7021-4998-ac5d-2f4fd4e4b0e4
1	1	0	GBIF Argentina	2426a871-9feb-40a1-96c6-0c593a76b835	c9188803-1e23-414e-9fc3-303e56aadde7
0	143	143	Ocean Biodiversity Information System	ba0670b9-4186-41e6-8e70-f9cb3065551a	c95c5920-487b-4280-b341-1092bbf6960f
39957	39957	0	GBIF France	da44cd31-5901-4687-a106-6d1c7734ee3a	cbd241aa-a115-4856-af66-fac5cb90f2cc
492239	492239	0	U.S. Geological Survey	8618c64a-93e0-4300-b546-7249e5148ed2	cca13f2c-0d2c-4c2f-93b9-4446c0cc1629
1925	1925	0	GBIF Benin	efb9c00e-f802-45dd-8826-a52ec45b89ff	cf3753af-0fde-4de8-9bae-efa08bf5c2f6
0	107	107	Plazi	ffb07bec-2d10-492d-9c37-361fe0b79427	d0967b08-98d1-4ccd-b472-a678e0e57eda
0	4	4	Plazi	ffb07bec-2d10-492d-9c37-361fe0b79427	d254f4c6-ccd9-41f9-98c8-a82e920b203a
2	2	0	Plazi	ffb07bec-2d10-492d-9c37-361fe0b79427	d2a18992-1e54-4c80-b28e-c14b052fe3e5
632445	632445	0	GBIF France	da44cd31-5901-4687-a106-6d1c7734ee3a	d9f7b2f6-03b3-4cd3-817b-c61949d79b1d
78612	78612	0	National Biodiversity Network	d897a5b9-35ee-4232-94bd-b0bcaac003c2	daae5a66-7bb4-4431-ac3c-a1bf70ca3407
12	12	0	Plazi	ffb07bec-2d10-492d-9c37-361fe0b79427	ded8bdb6-f8ba-4e0b-bed1-1ec08963edfd
998	998	0	Polish Biodiversity Information Network	2618bfdf-e194-4911-a241-80db3107bc51	e01e6790-13de-11de-b2e1-b8a03c50a862
0	42	42	Plazi	ffb07bec-2d10-492d-9c37-361fe0b79427	e1dc57de-a878-4134-84ee-db752565cff6
11738	11738	0	National Biodiversity Network	d897a5b9-35ee-4232-94bd-b0bcaac003c2	e24d3fb5-f825-4b16-990f-a71fd70052ab
2386	2386	0	Ocean Biodiversity Information System	ba0670b9-4186-41e6-8e70-f9cb3065551a	e6dc3f1d-9ba3-41d2-a4ed-8e31e85cf617
108	108	0	South African Biodiversity Information Facility	7190b835-4e86-4b6e-85c1-19cc6677c250	eb8708e4-5788-4c44-89c9-ef54e4423086
429	429	0	GBIF Germany	4f6826f2-4ff6-443d-b966-e6913bd24013	ed6001f7-7f5c-4d20-ad7d-267016c30afb
42	42	0	GBIF Argentina	2426a871-9feb-40a1-96c6-0c593a76b835	ee2169df-2fff-491a-a7c2-b5cce469925e
16	16	0	Plazi	ffb07bec-2d10-492d-9c37-361fe0b79427	f09380a8-4d31-4e79-9b72-74ee26438553
6	6	0	Plazi	ffb07bec-2d10-492d-9c37-361fe0b79427	f1bbeff3-8e8b-408c-a46c-11595dcf1560
192	177	-15	GBIF Germany	4f6826f2-4ff6-443d-b966-e6913bd24013	f1c59575-eb98-45a5-9b98-671f578ae08c
0	1	1	Plazi	ffb07bec-2d10-492d-9c37-361fe0b79427	f2183545-2ff3-48ba-8249-2c19fba69095
6	6	0	Plazi	ffb07bec-2d10-492d-9c37-361fe0b79427	f47c1ab7-7fc3-40f5-a177-ca4a2474d82b
0	1794	1794	Colombian Biodiversity Information System	7e865cba-7c46-417b-ade5-97f2cf5b7be0	f7cd74a4-001e-4b09-8fe5-bd19c64ae9bd
621	621	0	GBIF Malawi	2a42e4d7-ad4a-41b3-84c4-de4aa7b74d35	004dd275-d1f0-40d9-ba1b-7f0811214da3
7000	8000	1000	GBIF Japan	db5705aa-6a6e-42f1-8942-d77b9f4896ea	04bcbc07-811a-4870-89ec-4055fa88ea8d
170	170	0	Plazi	ffb07bec-2d10-492d-9c37-361fe0b79427	05a90c4a-a1f4-4726-ae24-3bdfdf4da586
14	14	0	Plazi	ffb07bec-2d10-492d-9c37-361fe0b79427	08fe4f6b-5422-45af-bc2e-29ad35fed42f
0	3	3	Plazi	ffb07bec-2d10-492d-9c37-361fe0b79427	091e149b-dd8b-4cdf-b487-a8be5cd058da
91	91	0	GBIF France	da44cd31-5901-4687-a106-6d1c7734ee3a	0c760ed9-6b18-45e2-9945-d6c43e72e244
0	5	5	Colombian Biodiversity Information System	7e865cba-7c46-417b-ade5-97f2cf5b7be0	0d4ad9a6-f821-4fe3-ade8-ad33f7f882aa
471	471	0	Ocean Biodiversity Information System	ba0670b9-4186-41e6-8e70-f9cb3065551a	0e5fdec2-6221-4b42-a9ec-4066b7a55679
2713	2713	0	National Biodiversity Network	d897a5b9-35ee-4232-94bd-b0bcaac003c2	125ce7a4-b7b5-49e5-92d6-2168ca047def
8425	8425	0	Plazi	ffb07bec-2d10-492d-9c37-361fe0b79427	1416a8a0-adc9-486b-b88d-52328522c85b
0	3	3	Plazi	ffb07bec-2d10-492d-9c37-361fe0b79427	150a77f5-c9b0-4901-ba82-352d079a9b61
4	4	0	Plazi	ffb07bec-2d10-492d-9c37-361fe0b79427	152d014b-a846-4f4d-9cb4-8ee3d382186d
0	183	183	Plazi	ffb07bec-2d10-492d-9c37-361fe0b79427	16f599ee-42e4-4042-920d-8c9c4623ea0d
7	7	0	Plazi	ffb07bec-2d10-492d-9c37-361fe0b79427	1835c5e3-9253-49c1-9463-b2e4b0213bc5
8	8	0	Colombian Biodiversity Information System	7e865cba-7c46-417b-ade5-97f2cf5b7be0	189cb31d-9ef2-443b-bd10-e38bfe9d4934
12995	12995	0	Polish Biodiversity Information Network	2618bfdf-e194-4911-a241-80db3107bc51	1933e8e0-3331-11de-8db8-b8a03c50a862
6983	7101	118	GBIF Brazil	cdc9736d-5ff7-4ece-9959-3c744360cdb3	1a86be2b-aa83-424a-9e55-9f6ee344fdfc
9801	9801	0	Biodiversity Information System of Mexico	b324e8e9-9a4c-44fa-8f1a-7f39ea7ab576	1cb3d1bd-b089-4dc8-a8b6-2b4d45d927ee
0	22	22	Plazi	ffb07bec-2d10-492d-9c37-361fe0b79427	1ec7cff3-1bd4-4038-87fc-8a6d87f4c7ef
25	25	0	Plazi	ffb07bec-2d10-492d-9c37-361fe0b79427	22f7f3b4-cfde-4fb8-80f5-f4a5b9ea5217
1847	1847	0	GBIF Norway	4f829580-180d-46a9-9c87-ed8ec959b545	23264cb3-b606-475d-81fb-5f22de3c2368
0	2	2	Plazi	ffb07bec-2d10-492d-9c37-361fe0b79427	23de6432-cc55-4279-a159-c434d312da12
0	15	15	Plazi	ffb07bec-2d10-492d-9c37-361fe0b79427	246061ce-4a39-4b2e-95e5-e192821782e8
9	9	0	Plazi	ffb07bec-2d10-492d-9c37-361fe0b79427	2592bfda-0b03-4e65-baf2-b5b0442b507f
7	7	0	Plazi	ffb07bec-2d10-492d-9c37-361fe0b79427	263fbd47-2940-46fb-b1c9-9d91b9bbac57
0	4860	4860	Canada Biodiversity Information Facility	8f83fc96-c966-4126-83f7-bf044dc49efa	265ad3f1-4fd7-4b22-9957-6fd9f0b9717c
781	781	0	GBIF Argentina	2426a871-9feb-40a1-96c6-0c593a76b835	26ac25ef-8db4-4623-8431-ad22ba7ab404
0	2	2	Plazi	ffb07bec-2d10-492d-9c37-361fe0b79427	26e227b1-516e-41c0-910e-97727d5455a9
287	287	0	Colombian Biodiversity Information System	7e865cba-7c46-417b-ade5-97f2cf5b7be0	28f1d761-f1fe-4f1f-8a3d-00ff2d9ae127
1	1	0	GBIF Japan	db5705aa-6a6e-42f1-8942-d77b9f4896ea	29498dc2-56fa-4b9c-b216-a5b5297511b5
1008	1008	0	GBIF Germany	4f6826f2-4ff6-443d-b966-e6913bd24013	2ce84acf-0e82-4da9-9cda-730973a51d7f
5	5	0	Plazi	ffb07bec-2d10-492d-9c37-361fe0b79427	2eeaf740-99f7-47ba-a646-54d37162df88
0	43	43	Participant Node Managers Committee	7f48e0c8-5c96-49ec-b972-30748e339115	3101bb08-d04d-4447-b916-112713e48198
3744	2472	-1272	Biodiversity Information System of Mexico	b324e8e9-9a4c-44fa-8f1a-7f39ea7ab576	3524e6fa-341d-4afa-a7c2-952faae72b94
10	10	0	Plazi	ffb07bec-2d10-492d-9c37-361fe0b79427	3567f983-bfd1-49d0-9d87-81f5787c4e39
0	93	93	Ocean Biodiversity Information System	ba0670b9-4186-41e6-8e70-f9cb3065551a	3911abad-cec0-4ac3-af06-071bc2cf0765
50	50	0	GBIF Norway	4f829580-180d-46a9-9c87-ed8ec959b545	3b105142-6f9c-4098-a6a8-dd07095fc45c
442	442	0	National Biodiversity Network	d897a5b9-35ee-4232-94bd-b0bcaac003c2	3d10725a-b538-4c1f-b925-42b842f013a1
4	4	0	GBIF France	da44cd31-5901-4687-a106-6d1c7734ee3a	3d4fe4f1-4679-475f-b285-cfd7f879c79f
13708	13708	0	National Biodiversity Network	d897a5b9-35ee-4232-94bd-b0bcaac003c2	40f02899-576f-439f-9756-f3fa78d4ee63
0	27189	27189	GBIF Japan	db5705aa-6a6e-42f1-8942-d77b9f4896ea	4230db27-6316-44f7-96c9-165972014686
0	10	10	Plazi	ffb07bec-2d10-492d-9c37-361fe0b79427	44d94bc7-80f7-4807-aef4-c0bd301d34c5
5	5	0	Plazi	ffb07bec-2d10-492d-9c37-361fe0b79427	45272d12-f088-42ca-b53e-2da7f8b80994
14	14	0	GBIF Germany	4f6826f2-4ff6-443d-b966-e6913bd24013	46b6b336-b656-4336-8db9-85bfc26e258b
10	10	0	Plazi	ffb07bec-2d10-492d-9c37-361fe0b79427	4a2f1ce7-212f-4961-9f19-937ffbb0d21b
49	49	0	Ocean Biodiversity Information System	ba0670b9-4186-41e6-8e70-f9cb3065551a	4a53a180-f0c8-4dd8-a1fb-18768668edc9
0	96	96	Plazi	ffb07bec-2d10-492d-9c37-361fe0b79427	4b7955ee-3859-4b8c-bfb9-e1dc78e948a3
0	2969	2969	Participant Node Managers Committee	7f48e0c8-5c96-49ec-b972-30748e339115	4b901e9a-18c4-473c-a56d-b7689b55ecbc
308	308	0	Colombian Biodiversity Information System	7e865cba-7c46-417b-ade5-97f2cf5b7be0	4b9298bd-99b8-4269-b236-e8a002682b9d
333	333	0	Plazi	ffb07bec-2d10-492d-9c37-361fe0b79427	4bc9a2a0-5eb7-4a14-aa2a-013ccd6ca4b1
6	6	0	GBIF Finland	dd514216-5c7c-45f3-910d-797424cb5be6	4ed38e58-77b1-4710-8c71-7d7085ecf5f4
21868	21868	0	GBIF Spain	1f94b3ca-9345-4d65-afe2-4bace93aa0fe	4f030114-b432-4394-88b4-1b064e146975
3	3	0	Plazi	ffb07bec-2d10-492d-9c37-361fe0b79427	4f3fdc50-52dc-4b53-9e5e-cbcc9b4e5985
146	146	0	Plazi	ffb07bec-2d10-492d-9c37-361fe0b79427	507191c9-df1f-44f0-b809-2de4cfe6805f
17	17	0	GBIF France	da44cd31-5901-4687-a106-6d1c7734ee3a	57251ff4-716e-4457-b50b-63e90c6ce708
3	3	0	Plazi	ffb07bec-2d10-492d-9c37-361fe0b79427	59b59e23-9086-48e0-a2db-33213ffd1e53
1280	1280	0	GBIF Madagascar	2dbfc5c5-51b5-4494-9dfc-4d3f013a3b64	61132471-7cf5-4e6a-9b06-5b90cf50b9fe
3	3	0	Plazi	ffb07bec-2d10-492d-9c37-361fe0b79427	61292ca0-0b53-4c74-8827-08a89aa90a98
19	19	0	GBIF Germany	4f6826f2-4ff6-443d-b966-e6913bd24013	620a45c0-f762-11e1-a439-00145eb45e9a
40	40	0	GBIF Germany	4f6826f2-4ff6-443d-b966-e6913bd24013	62144250-f762-11e1-a439-00145eb45e9a
0	265	265	Plazi	ffb07bec-2d10-492d-9c37-361fe0b79427	6371140c-b2bd-4bf1-8b94-4e80c692f2c6
17	17	0	GBIF Germany	4f6826f2-4ff6-443d-b966-e6913bd24013	6494d404-f762-11e1-a439-00145eb45e9a
71	71	0	GBIF Germany	4f6826f2-4ff6-443d-b966-e6913bd24013	66583696-f762-11e1-a439-00145eb45e9a
76	76	0	GBIF Germany	4f6826f2-4ff6-443d-b966-e6913bd24013	668ad902-f762-11e1-a439-00145eb45e9a
79	79	0	GBIF Germany	4f6826f2-4ff6-443d-b966-e6913bd24013	67e9c9e8-f762-11e1-a439-00145eb45e9a
0	4	4	Plazi	ffb07bec-2d10-492d-9c37-361fe0b79427	6809235a-3afc-486f-ba35-e7b981df9ca4
656321	656321	0	U.S. Geological Survey	8618c64a-93e0-4300-b546-7249e5148ed2	68513375-3aa5-4f6f-9975-d97d56c21d61
15	15	0	Plazi	ffb07bec-2d10-492d-9c37-361fe0b79427	68f409e0-4682-45e1-a2ea-2d9de8d999ba
44	44	0	GBIF Germany	4f6826f2-4ff6-443d-b966-e6913bd24013	6aba50ac-f762-11e1-a439-00145eb45e9a
2	2	0	GBIF Germany	4f6826f2-4ff6-443d-b966-e6913bd24013	6af0356e-f762-11e1-a439-00145eb45e9a
21	21	0	GBIF Germany	4f6826f2-4ff6-443d-b966-e6913bd24013	6b228e1a-f762-11e1-a439-00145eb45e9a
2	2	0	GBIF Germany	4f6826f2-4ff6-443d-b966-e6913bd24013	6b4b184e-f762-11e1-a439-00145eb45e9a
4	4	0	GBIF Germany	4f6826f2-4ff6-443d-b966-e6913bd24013	6b68b7c8-f762-11e1-a439-00145eb45e9a
37	37	0	GBIF Germany	4f6826f2-4ff6-443d-b966-e6913bd24013	6c8ebbfc-f762-11e1-a439-00145eb45e9a
5	5	0	GBIF Germany	4f6826f2-4ff6-443d-b966-e6913bd24013	6fac4e30-f762-11e1-a439-00145eb45e9a
8	8	0	GBIF Germany	4f6826f2-4ff6-443d-b966-e6913bd24013	6fe1e52c-f762-11e1-a439-00145eb45e9a
10	10	0	GBIF Germany	4f6826f2-4ff6-443d-b966-e6913bd24013	6fe3335a-f762-11e1-a439-00145eb45e9a
3	3	0	Plazi	ffb07bec-2d10-492d-9c37-361fe0b79427	7080afbb-67f5-4742-be94-337881dc6935
1825	1825	0	GBIF Germany	4f6826f2-4ff6-443d-b966-e6913bd24013	71237cb6-f762-11e1-a439-00145eb45e9a
356	356	0	GBIF Germany	4f6826f2-4ff6-443d-b966-e6913bd24013	71613c86-f762-11e1-a439-00145eb45e9a
344	344	0	GBIF Germany	4f6826f2-4ff6-443d-b966-e6913bd24013	71697324-f762-11e1-a439-00145eb45e9a
4	4	0	GBIF Germany	4f6826f2-4ff6-443d-b966-e6913bd24013	716ad3e0-f762-11e1-a439-00145eb45e9a
12	12	0	GBIF Germany	4f6826f2-4ff6-443d-b966-e6913bd24013	71c50090-f762-11e1-a439-00145eb45e9a
15	15	0	GBIF Germany	4f6826f2-4ff6-443d-b966-e6913bd24013	736ccfae-f762-11e1-a439-00145eb45e9a
19	19	0	Plazi	ffb07bec-2d10-492d-9c37-361fe0b79427	73bbb6a1-db6a-40d3-b056-883d65441665
41	41	0	GBIF Germany	4f6826f2-4ff6-443d-b966-e6913bd24013	74621612-f762-11e1-a439-00145eb45e9a
165	165	0	GBIF Germany	4f6826f2-4ff6-443d-b966-e6913bd24013	750641b0-f762-11e1-a439-00145eb45e9a
2	2	0	GBIF Germany	4f6826f2-4ff6-443d-b966-e6913bd24013	75e0a012-f762-11e1-a439-00145eb45e9a
513	396	-117	GBIF Germany	4f6826f2-4ff6-443d-b966-e6913bd24013	79533c00-f762-11e1-a439-00145eb45e9a
261	216	-45	GBIF Germany	4f6826f2-4ff6-443d-b966-e6913bd24013	798b28a4-f762-11e1-a439-00145eb45e9a
1	1	0	GBIF Germany	4f6826f2-4ff6-443d-b966-e6913bd24013	7aa122d4-f762-11e1-a439-00145eb45e9a
739	739	0	Korean Biodiversity Information Facility	e0a1e772-0177-4800-94b4-2d023fe6cdf4	7b19ed22-f762-11e1-a439-00145eb45e9a
0	4	4	Plazi	ffb07bec-2d10-492d-9c37-361fe0b79427	7c919c60-2e1a-4498-a628-c91394244478
573	573	0	Ghana Biodiversity Information Facility	b5633b75-6a86-4fdf-9cfc-506047fb9dc7	7d0795c4-a685-4ab1-9fd6-71737a87fe8c
710	710	0	GBIF Germany	4f6826f2-4ff6-443d-b966-e6913bd24013	7d079c38-f762-11e1-a439-00145eb45e9a
2272	2234	-38	GBIF Germany	4f6826f2-4ff6-443d-b966-e6913bd24013	7ea8a226-f762-11e1-a439-00145eb45e9a
840	336	-504	GBIF Germany	4f6826f2-4ff6-443d-b966-e6913bd24013	7f17b04e-f762-11e1-a439-00145eb45e9a
3544	4045	501	U.S. Geological Survey	8618c64a-93e0-4300-b546-7249e5148ed2	7f7fd51e-0ff2-421d-9316-024ee042e88f
29	29	0	Colombian Biodiversity Information System	7e865cba-7c46-417b-ade5-97f2cf5b7be0	7ffbc7b3-4c5d-4e18-b0d4-2d30ebbe0bd6
59743	59743	0	GBIF Brazil	cdc9736d-5ff7-4ece-9959-3c744360cdb3	803eb96c-4779-41e3-a511-fd124732774f
1527	1527	0	Biodiversity Information System of Mexico	b324e8e9-9a4c-44fa-8f1a-7f39ea7ab576	80bfa122-f762-11e1-a439-00145eb45e9a
222	222	0	Biodiversity Information System of Mexico	b324e8e9-9a4c-44fa-8f1a-7f39ea7ab576	80c10738-f762-11e1-a439-00145eb45e9a
57	57	0	National Biodiversity Network	d897a5b9-35ee-4232-94bd-b0bcaac003c2	80ff248c-ae04-4cf2-8f9b-5114a4bc75e5
50	50	0	GBIF Germany	4f6826f2-4ff6-443d-b966-e6913bd24013	8178691e-f762-11e1-a439-00145eb45e9a
10	10	0	GBIF Germany	4f6826f2-4ff6-443d-b966-e6913bd24013	824a6b6c-f762-11e1-a439-00145eb45e9a
55858	55905	47	U.S. Geological Survey	8618c64a-93e0-4300-b546-7249e5148ed2	830eb5d0-f762-11e1-a439-00145eb45e9a
3190	3190	0	Atlas of Living Australia	4a6f1b71-969e-4fc5-a693-282b05e1220c	83a428ff-953a-4aa5-8dd7-2fe281c14889
10877	10877	0	GBIF Spain	1f94b3ca-9345-4d65-afe2-4bace93aa0fe	86bb67fa-f762-11e1-a439-00145eb45e9a
879	639	-240	GBIF Germany	4f6826f2-4ff6-443d-b966-e6913bd24013	87a74a80-f762-11e1-a439-00145eb45e9a
273009	273009	0	National Biodiversity Network	d897a5b9-35ee-4232-94bd-b0bcaac003c2	8821e36f-2d25-44c8-a95e-fb978f38ecde
15	15	0	GBIF Germany	4f6826f2-4ff6-443d-b966-e6913bd24013	888e0f6a-f762-11e1-a439-00145eb45e9a
172	172	0	GBIF Germany	4f6826f2-4ff6-443d-b966-e6913bd24013	89e1d32e-f762-11e1-a439-00145eb45e9a
173	173	0	GBIF Germany	4f6826f2-4ff6-443d-b966-e6913bd24013	8a05c9c8-f762-11e1-a439-00145eb45e9a
1	1	0	GBIF France	da44cd31-5901-4687-a106-6d1c7734ee3a	8a694351-76df-4a9d-b52a-b02d12237f3a
33883	33883	0	National Biodiversity Network	d897a5b9-35ee-4232-94bd-b0bcaac003c2	8b02baa6-36ca-452c-a1e2-6aa128459048
621	621	0	GBIF France	da44cd31-5901-4687-a106-6d1c7734ee3a	8b640f68-7f07-4bf6-82f1-99d9f82e67fa
60	60	0	GBIF Germany	4f6826f2-4ff6-443d-b966-e6913bd24013	8c58cb8a-f762-11e1-a439-00145eb45e9a
26322	26322	0	GBIF Germany	4f6826f2-4ff6-443d-b966-e6913bd24013	8cf7cae1-76b6-4b31-a323-bda75d7e1051
5	2	-3	GBIF Germany	4f6826f2-4ff6-443d-b966-e6913bd24013	8d146b4c-f762-11e1-a439-00145eb45e9a
540	321	-219	GBIF Germany	4f6826f2-4ff6-443d-b966-e6913bd24013	8de833be-f762-11e1-a439-00145eb45e9a
0	22	22	Ocean Biodiversity Information System	ba0670b9-4186-41e6-8e70-f9cb3065551a	8f1ce482-e383-4023-a11f-477dc2f5bc9c
52	52	0	Belgian Biodiversity Platform	fb11cfe1-ebc3-45af-9159-17d9fddbcdac	8f925919-18a5-4bfb-af5b-db45e18e3e14
5578	5579	1	Biodiversity Information System of Mexico	b324e8e9-9a4c-44fa-8f1a-7f39ea7ab576	8fa89c37-9896-46a3-bc5a-ef68c1d09bfd
176	130	-46	GBIF Germany	4f6826f2-4ff6-443d-b966-e6913bd24013	8fc8a736-f762-11e1-a439-00145eb45e9a
401	214	-187	GBIF Germany	4f6826f2-4ff6-443d-b966-e6913bd24013	90485be8-f762-11e1-a439-00145eb45e9a
1543	1120	-423	GBIF Germany	4f6826f2-4ff6-443d-b966-e6913bd24013	90552daa-f762-11e1-a439-00145eb45e9a
415	415	0	GBIF France	da44cd31-5901-4687-a106-6d1c7734ee3a	9115957a-204b-4196-9944-d8c2994f7ec1
151	142	-9	GBIF Germany	4f6826f2-4ff6-443d-b966-e6913bd24013	914f1158-f762-11e1-a439-00145eb45e9a
111	66	-45	GBIF Germany	4f6826f2-4ff6-443d-b966-e6913bd24013	91634ef2-f762-11e1-a439-00145eb45e9a
180	166	-14	GBIF Germany	4f6826f2-4ff6-443d-b966-e6913bd24013	9170e684-f762-11e1-a439-00145eb45e9a
148	148	0	U.S. Geological Survey	8618c64a-93e0-4300-b546-7249e5148ed2	919513a5-3e40-498c-896a-f2df02dc9ceb
550	551	1	GBIF Germany	4f6826f2-4ff6-443d-b966-e6913bd24013	92367f20-f762-11e1-a439-00145eb45e9a
109	84	-25	GBIF Germany	4f6826f2-4ff6-443d-b966-e6913bd24013	923e6c1c-f762-11e1-a439-00145eb45e9a
0	204	204	Plazi	ffb07bec-2d10-492d-9c37-361fe0b79427	92e416e4-89cc-47a9-93a5-9a2fad717484
229	97	-132	GBIF Germany	4f6826f2-4ff6-443d-b966-e6913bd24013	92ea4276-f762-11e1-a439-00145eb45e9a
499	499	0	GBIF Germany	4f6826f2-4ff6-443d-b966-e6913bd24013	92f22f9a-f762-11e1-a439-00145eb45e9a
37	37	0	GBIF Germany	4f6826f2-4ff6-443d-b966-e6913bd24013	92f4e64a-f762-11e1-a439-00145eb45e9a
3032	3032	0	GBIF Spain	1f94b3ca-9345-4d65-afe2-4bace93aa0fe	931d8563-723a-49b3-ad72-ce3cf7615e5e
172	172	0	GBIF Germany	4f6826f2-4ff6-443d-b966-e6913bd24013	932063ce-f762-11e1-a439-00145eb45e9a
4135	4135	0	GBIF Germany	4f6826f2-4ff6-443d-b966-e6913bd24013	934e4fb0-db3e-408a-a841-182c43bf7fc1
21886	21886	0	GBIF Norway	4f829580-180d-46a9-9c87-ed8ec959b545	9678e1a6-b1c4-4e86-9d26-ebb169338655
150	150	0	Plazi	ffb07bec-2d10-492d-9c37-361fe0b79427	96f23551-3542-437c-a6df-2ae6dbe8b2fa
209	209	0	GBIF France	da44cd31-5901-4687-a106-6d1c7734ee3a	97307ab9-6f6b-4749-8760-adb210c9d78e
134	134	0	GBIF France	da44cd31-5901-4687-a106-6d1c7734ee3a	976e1875-2e4f-4568-8ff1-1f7d3f6f632f
82	82	0	GBIF Germany	4f6826f2-4ff6-443d-b966-e6913bd24013	97c73614-f762-11e1-a439-00145eb45e9a
0	3	3	Plazi	ffb07bec-2d10-492d-9c37-361fe0b79427	985f8c4c-c9ad-482b-8e0a-c25f6580b9bd
138339	138339	0	National Biodiversity Network	d897a5b9-35ee-4232-94bd-b0bcaac003c2	989c11ed-bc22-4e5f-a347-372644a38a19
3	3	0	Plazi	ffb07bec-2d10-492d-9c37-361fe0b79427	9b32828c-16c6-48a7-81b5-167839a00cf0
0	27	27	Plazi	ffb07bec-2d10-492d-9c37-361fe0b79427	9ccf3e9f-c4cf-4202-b39c-4a87c9763f81
6	6	0	Plazi	ffb07bec-2d10-492d-9c37-361fe0b79427	9d84ab46-129c-4631-859b-6e930cd7038a
0	48	48	Plazi	ffb07bec-2d10-492d-9c37-361fe0b79427	9f922048-e978-48d5-86c2-edeb0529c500
3	3	0	Plazi	ffb07bec-2d10-492d-9c37-361fe0b79427	a138fb3c-5b32-465d-9fed-9e79e130f803
870	870	0	National Biodiversity Network	d897a5b9-35ee-4232-94bd-b0bcaac003c2	a3ad1858-32f3-4cbe-9b9d-df772e2d18b1
74	74	0	Colombian Biodiversity Information System	7e865cba-7c46-417b-ade5-97f2cf5b7be0	a41071b6-690e-499c-b5f2-0f90d7867764
133	133	0	GBIF Germany	4f6826f2-4ff6-443d-b966-e6913bd24013	a65616ac-83a5-491a-9c14-9db8a26c0e91
0	39	39	Plazi	ffb07bec-2d10-492d-9c37-361fe0b79427	a7f1df89-b055-4ec5-a0bc-ebe88edfc324
5	5	0	Plazi	ffb07bec-2d10-492d-9c37-361fe0b79427	a85b7eb6-6205-4a35-89f2-5697c0f14d2a
0	8	8	Participant Node Managers Committee	7f48e0c8-5c96-49ec-b972-30748e339115	a9b18fb0-6cfc-4d05-af0c-e14ad6ffb9c5
64518	64518	0	Ocean Biodiversity Information System	ba0670b9-4186-41e6-8e70-f9cb3065551a	adb92d68-aaff-47ba-b197-d3d26f72f728
0	5359	5359	World Federation for Culture Collections	a6bdc523-5368-4e0f-9d2e-de1c262ac092	b3e4cecc-7554-419d-a336-1218548370d4
0	18	18	Plazi	ffb07bec-2d10-492d-9c37-361fe0b79427	b413a745-5896-496f-92be-ff43918011d5
0	8	8	Plazi	ffb07bec-2d10-492d-9c37-361fe0b79427	b5e29d7d-8fbf-4aa9-ad25-81f34571ec97
1	1	0	Plazi	ffb07bec-2d10-492d-9c37-361fe0b79427	b77ef7f1-d656-40df-b4a4-83dff22d9bb0
295	295	0	National Biodiversity Network	d897a5b9-35ee-4232-94bd-b0bcaac003c2	b7d97367-acc6-4329-9ee2-7e2b44b9e552
1	1	0	Plazi	ffb07bec-2d10-492d-9c37-361fe0b79427	b8983c46-f29f-4e70-8f2c-484a6434d068
12	12	0	Plazi	ffb07bec-2d10-492d-9c37-361fe0b79427	bb1fb41a-6dba-41ea-b80f-91eafcd8a42d
471508	471508	0	National Biodiversity Network	d897a5b9-35ee-4232-94bd-b0bcaac003c2	bbee118c-a50e-4f7f-bca1-d5bfefc5360b
1	1	0	Plazi	ffb07bec-2d10-492d-9c37-361fe0b79427	bc9ca8be-23d8-427d-a8f4-32908e35d578
4362	4362	0	Belgian Biodiversity Platform	fb11cfe1-ebc3-45af-9159-17d9fddbcdac	bcbfd319-8813-4b6d-b529-07dc5a6ccf56
3	3	0	Plazi	ffb07bec-2d10-492d-9c37-361fe0b79427	be1d57e0-b3b9-42ac-b030-2e667694baa7
2	2	0	Plazi	ffb07bec-2d10-492d-9c37-361fe0b79427	beac85c9-35b0-4510-b8f1-489649182af7
0	5	5	Plazi	ffb07bec-2d10-492d-9c37-361fe0b79427	bee17a33-bc94-43a7-8f47-d16e7525dcd3
3	3	0	Plazi	ffb07bec-2d10-492d-9c37-361fe0b79427	bf9f9a0e-9d7b-46d1-a463-a695b79dffc7
98	98	0	GBIF France	da44cd31-5901-4687-a106-6d1c7734ee3a	c3b29a2e-c449-4426-8561-262a0d0a8b6c
9789	9577	-212	DanBIF - Danish Biodiversity Information Facility	4ddd294f-02b7-4359-ac33-0806a9ca9c6b	c5aa1143-4b20-450e-8f4c-c5940d8e2f81
91370	91370	0	GBIF Brazil	cdc9736d-5ff7-4ece-9959-3c744360cdb3	c71c8000-9fc7-422c-804a-ce6abe751771
15771	15771	0	South African Biodiversity Information Facility	7190b835-4e86-4b6e-85c1-19cc6677c250	c90a0778-e222-406f-bcd7-ed96a2bc5f4c
5219	5219	0	GBIF France	da44cd31-5901-4687-a106-6d1c7734ee3a	ca0dfc4e-6a98-4b1b-b010-c6ce894a72f1
19619	19619	0	Polish Biodiversity Information Network	2618bfdf-e194-4911-a241-80db3107bc51	cd629c30-30b1-11de-b170-b8a03c50a862
0	33419	33419	Ocean Biodiversity Information System	ba0670b9-4186-41e6-8e70-f9cb3065551a	ce516027-5242-4efb-b3f7-29c533b36dd4
594	594	0	U.S. Geological Survey	8618c64a-93e0-4300-b546-7249e5148ed2	ce93b7a1-6103-45fc-9858-159dae55ef7d
66	66	0	GBIF France	da44cd31-5901-4687-a106-6d1c7734ee3a	cee6464f-cae2-4aab-aa8b-0429a2cb3af0
0	6	6	Plazi	ffb07bec-2d10-492d-9c37-361fe0b79427	d42fb88a-2af6-4e2c-ae92-03722a405f60
90	90	0	Plazi	ffb07bec-2d10-492d-9c37-361fe0b79427	dafd0c73-e9bf-43f0-9e11-95a6e69e32d2
1090	1090	0	Colombian Biodiversity Information System	7e865cba-7c46-417b-ade5-97f2cf5b7be0	db191f3a-48ed-4b94-93ef-5c0517fb1b58
0	2	2	Plazi	ffb07bec-2d10-492d-9c37-361fe0b79427	dd3f921c-da4a-4477-8fd8-a063a4249841
114297	114297	0	U.S. Geological Survey	8618c64a-93e0-4300-b546-7249e5148ed2	e05f6e7d-418e-4407-8e0f-7b8ccf21109e
4	4	0	Plazi	ffb07bec-2d10-492d-9c37-361fe0b79427	e0fdbb03-2d4a-47e5-afba-726d40feca7a
0	807	807	GBIF Benin	efb9c00e-f802-45dd-8826-a52ec45b89ff	e11ff3e0-c661-46a2-bf98-123ebbe9830f
63085	63085	0	Taiwan Biodiversity Information Facility	e1b85abc-61f9-430f-ba79-6813dec53a0f	e1f3be55-9f45-474c-8374-502b236e0ad0
93	93	0	Plazi	ffb07bec-2d10-492d-9c37-361fe0b79427	e2a9c13c-56ac-4275-a4d7-a65743d5ff99
814	666	-148	GBIF Germany	4f6826f2-4ff6-443d-b966-e6913bd24013	eaa6765d-a19d-48ba-a8fb-5199c973c246
0	6	6	Plazi	ffb07bec-2d10-492d-9c37-361fe0b79427	ebc123bd-2053-491f-a882-3a9bd6d52026
7	7	0	Plazi	ffb07bec-2d10-492d-9c37-361fe0b79427	ec20e060-b276-48ab-a813-3b34c26ba653
91	91	0	GBIF France	da44cd31-5901-4687-a106-6d1c7734ee3a	ee26684e-8830-465d-9931-be3d5a704691
0	15	15	Plazi	ffb07bec-2d10-492d-9c37-361fe0b79427	eebc16ca-28ea-4eb4-87f7-ea8c213cde31
0	103	103	Plazi	ffb07bec-2d10-492d-9c37-361fe0b79427	ef1132ad-daaf-4dea-97eb-d5a6707208b8
661	661	0	GBIF Nigeria	6529bcb5-a542-4fda-be87-54a624515335	ef308a4f-87f2-4600-80af-45a6ab108512
13	13	0	Plazi	ffb07bec-2d10-492d-9c37-361fe0b79427	f3382433-ea2c-4ec8-b1fe-44320ac0893b
109	109	0	Colombian Biodiversity Information System	7e865cba-7c46-417b-ade5-97f2cf5b7be0	f5038475-fbca-4cdf-8246-68f1a6bbcc5b
59	59	0	Ocean Biodiversity Information System	ba0670b9-4186-41e6-8e70-f9cb3065551a	f7c73da5-09c4-49cb-9efa-3dda387a1373
213	213	0	Colombian Biodiversity Information System	7e865cba-7c46-417b-ade5-97f2cf5b7be0	f867bf08-2836-452d-85eb-9a4a6f460062
1520	1520	0	GBIF France	da44cd31-5901-4687-a106-6d1c7734ee3a	fc0dc229-85cc-4524-aa14-85b6dbd50f5b
15026	15026	0	Colombian Biodiversity Information System	7e865cba-7c46-417b-ade5-97f2cf5b7be0	00a89e1e-8ea5-45ae-bf01-585d867e5488
5	5	0	Plazi	ffb07bec-2d10-492d-9c37-361fe0b79427	02944707-b707-4732-9ca9-4592b53882f2
818213	818213	0	GBIF Finland	dd514216-5c7c-45f3-910d-797424cb5be6	042e5744-80f1-41ef-8e4f-02ce69d86a42
1462	1462	0	National Biodiversity Network	d897a5b9-35ee-4232-94bd-b0bcaac003c2	04f222a1-3d53-4740-80d3-40d3b7ccbe9e
0	1843	1843	Colombian Biodiversity Information System	7e865cba-7c46-417b-ade5-97f2cf5b7be0	05f4d2a6-5159-4395-bf6d-a4910f4edeca
35865	52266	16401	GBIF Japan	db5705aa-6a6e-42f1-8942-d77b9f4896ea	0991f9af-8ff9-4e34-a8b9-990bb522dc0c
3	3	0	Plazi	ffb07bec-2d10-492d-9c37-361fe0b79427	0b02190b-30f6-49ad-a78e-46d9edef273a
130	130	0	Plazi	ffb07bec-2d10-492d-9c37-361fe0b79427	0bb83022-19c6-4caf-9e03-9a5f5388154e
142691	142691	0	GBIF Norway	4f829580-180d-46a9-9c87-ed8ec959b545	0efbb3b3-6473-414a-af91-cdbcbcd8aba1
2144	2144	0	Participant Node Managers Committee	7f48e0c8-5c96-49ec-b972-30748e339115	100e2658-58f3-49d7-b15e-0da98d2b6bd9
170	170	0	GBIF Germany	4f6826f2-4ff6-443d-b966-e6913bd24013	10a858a1-9730-41aa-8c05-cd32c37b25fd
0	2634	2634	GBIF Portugal	673f7038-4262-4149-b753-5658a4e912f6	174e5f4a-8f17-45c3-be14-fd370affc5b8
44	44	0	Plazi	ffb07bec-2d10-492d-9c37-361fe0b79427	180298fc-3735-493b-97d9-8dc787b6b603
31126	31126	0	GBIF France	da44cd31-5901-4687-a106-6d1c7734ee3a	19671673-994b-4100-89ed-dc4cc18e0adc
0	4	4	Plazi	ffb07bec-2d10-492d-9c37-361fe0b79427	1b7187cc-678a-4532-9e9f-d66113973439
3	3	0	Participant Node Managers Committee	7f48e0c8-5c96-49ec-b972-30748e339115	1bb01740-9d11-42b4-9536-9de9a87c8c5c
17	17	0	Plazi	ffb07bec-2d10-492d-9c37-361fe0b79427	1be97f7b-7b0b-439c-ba43-140e04e3d2f2
4	4	0	Plazi	ffb07bec-2d10-492d-9c37-361fe0b79427	1bf97b69-4038-469d-a416-c44c5eba6d6d
3	3	0	Plazi	ffb07bec-2d10-492d-9c37-361fe0b79427	1d41e6ab-f46e-4334-a5dc-1abbba18c404
558	558	0	GBIF Spain	1f94b3ca-9345-4d65-afe2-4bace93aa0fe	1efd542a-de1f-4527-a025-abe60f3458c0
751	751	0	GBIF France	da44cd31-5901-4687-a106-6d1c7734ee3a	1f0919a0-8240-4432-8643-4a8d0f7b1309
85	85	0	Plazi	ffb07bec-2d10-492d-9c37-361fe0b79427	2795e95a-383d-483d-ba83-b18055f25c5e
68483	68483	0	National Biodiversity Network	d897a5b9-35ee-4232-94bd-b0bcaac003c2	2880fe33-38ec-4b8c-9a43-59a5095b1454
3	3	0	Plazi	ffb07bec-2d10-492d-9c37-361fe0b79427	28d1a351-9602-41fb-a8f7-2efb754314c5
2	2	0	Plazi	ffb07bec-2d10-492d-9c37-361fe0b79427	29aabf6b-5f9e-4b44-86ab-028f587c2023
4	4	0	Plazi	ffb07bec-2d10-492d-9c37-361fe0b79427	2c53a7e1-5f62-4eaa-8302-d5a5fdc96549
8	8	0	Plazi	ffb07bec-2d10-492d-9c37-361fe0b79427	2dec43b9-8411-461a-86a4-2031bd607a92
33	33	0	GBIF Germany	4f6826f2-4ff6-443d-b966-e6913bd24013	3289bb25-c4c9-4f4f-8dc4-5ab3c5b9acda
21	21	0	GBIF Germany	4f6826f2-4ff6-443d-b966-e6913bd24013	328e94f6-8ba2-4738-a412-da680274c376
51	51	0	Plazi	ffb07bec-2d10-492d-9c37-361fe0b79427	34e4a5a6-881c-4a1a-b64d-6868e12df7fb
265	265	0	GBIF France	da44cd31-5901-4687-a106-6d1c7734ee3a	3661bc4b-9f68-4729-b691-24dfa027a7a4
2	2	0	Plazi	ffb07bec-2d10-492d-9c37-361fe0b79427	382229db-9c36-4cd8-a9f1-f3b688547601
0	21	21	Plazi	ffb07bec-2d10-492d-9c37-361fe0b79427	38832997-188f-47c3-9bc0-cf0a9a9b5a3a
1059	1059	0	Participant Node Managers Committee	7f48e0c8-5c96-49ec-b972-30748e339115	397b0ae4-460e-4680-9625-73ab82f99ac1
7	7	0	Plazi	ffb07bec-2d10-492d-9c37-361fe0b79427	39ed47ef-c66b-4b81-a1ef-dfa8ed8b30b6
35	35	0	Plazi	ffb07bec-2d10-492d-9c37-361fe0b79427	3aa590ff-aa2a-4e77-b2cb-48ceacc16f8b
93	93	0	Plazi	ffb07bec-2d10-492d-9c37-361fe0b79427	3b9bd2c4-7dee-46a3-a36d-80077b88a78b
4	4	0	Plazi	ffb07bec-2d10-492d-9c37-361fe0b79427	3dd2af36-94a1-4bb9-bbd6-85cffe0d9c22
1664	1664	0	GBIF Argentina	2426a871-9feb-40a1-96c6-0c593a76b835	3e11991b-4438-401e-a513-74693337cb2e
0	468	468	Colombian Biodiversity Information System	7e865cba-7c46-417b-ade5-97f2cf5b7be0	401c3e99-6b73-4634-97d8-9d684dff5243
0	1	1	Plazi	ffb07bec-2d10-492d-9c37-361fe0b79427	458ce86e-4ef6-4133-ade5-96f997dd973d
0	5	5	Plazi	ffb07bec-2d10-492d-9c37-361fe0b79427	45cb427a-19fd-4068-b314-2630db74b60e
941	941	0	Belgian Biodiversity Platform	fb11cfe1-ebc3-45af-9159-17d9fddbcdac	46723a60-13b9-4495-8977-5fc1cf1bf31e
5	5	0	Plazi	ffb07bec-2d10-492d-9c37-361fe0b79427	467d7661-2612-4093-9bde-1ccb1f653152
6131	6131	0	GBIF Benin	efb9c00e-f802-45dd-8826-a52ec45b89ff	499d6265-d9fb-44d4-aec9-02c8bf6cc712
6	6	0	Plazi	ffb07bec-2d10-492d-9c37-361fe0b79427	4a10326b-603b-429a-8b6a-81e4897b0e33
4	4	0	Plazi	ffb07bec-2d10-492d-9c37-361fe0b79427	4a1c96f6-d406-4b11-8a10-3c7c415e4e47
0	1408	1408	Ocean Biodiversity Information System	ba0670b9-4186-41e6-8e70-f9cb3065551a	5136e139-312d-47d0-a665-dc8e6b351254
4	4	0	Plazi	ffb07bec-2d10-492d-9c37-361fe0b79427	5217c4a1-a0dd-478e-bd0c-95df35bad69b
1	1	0	National Biodiversity Network	d897a5b9-35ee-4232-94bd-b0bcaac003c2	527a5ef9-b409-4570-8721-38bc510b35c4
0	5	5	Plazi	ffb07bec-2d10-492d-9c37-361fe0b79427	5722c838-b10a-46b0-acd9-73eb1049b859
0	14	14	Plazi	ffb07bec-2d10-492d-9c37-361fe0b79427	57c139ed-4eae-43a8-ac12-b0a8a805f79c
0	5	5	Plazi	ffb07bec-2d10-492d-9c37-361fe0b79427	590878f6-fa9c-4f3d-be2d-320af1a05c22
0	99	99	Ocean Biodiversity Information System	ba0670b9-4186-41e6-8e70-f9cb3065551a	598bdaae-2b44-4590-ae97-ee904acde92e
264	264	0	Plazi	ffb07bec-2d10-492d-9c37-361fe0b79427	5a7c4049-6179-47df-8537-a81f307a7dc2
23513	23513	0	U.S. Geological Survey	8618c64a-93e0-4300-b546-7249e5148ed2	5e848873-567f-42dd-8a29-88056b9b33a4
191	191	0	GBIF France	da44cd31-5901-4687-a106-6d1c7734ee3a	602d7333-dec8-4e41-be5a-c28e3dba88b4
0	3	3	Plazi	ffb07bec-2d10-492d-9c37-361fe0b79427	610b90bf-c80c-4391-9992-1ec9c3659dd2
76	76	0	GBIF Germany	4f6826f2-4ff6-443d-b966-e6913bd24013	61396c98-f762-11e1-a439-00145eb45e9a
1	1	0	Plazi	ffb07bec-2d10-492d-9c37-361fe0b79427	62e8b36b-aab7-4b39-bead-2b9d744570d1
274	274	0	GBIF Germany	4f6826f2-4ff6-443d-b966-e6913bd24013	63879c9a-f762-11e1-a439-00145eb45e9a
174	174	0	GBIF Germany	4f6826f2-4ff6-443d-b966-e6913bd24013	63dadc98-f762-11e1-a439-00145eb45e9a
44	44	0	GBIF Germany	4f6826f2-4ff6-443d-b966-e6913bd24013	63ffb3ba-f762-11e1-a439-00145eb45e9a
61	61	0	GBIF Germany	4f6826f2-4ff6-443d-b966-e6913bd24013	658b8038-f762-11e1-a439-00145eb45e9a
367	375	8	GBIF Germany	4f6826f2-4ff6-443d-b966-e6913bd24013	660a933c-f762-11e1-a439-00145eb45e9a
130	130	0	GBIF Germany	4f6826f2-4ff6-443d-b966-e6913bd24013	67a25112-f762-11e1-a439-00145eb45e9a
2270	1741	-529	GBIF Germany	4f6826f2-4ff6-443d-b966-e6913bd24013	68ed4932-f762-11e1-a439-00145eb45e9a
1193	1020	-173	GBIF Germany	4f6826f2-4ff6-443d-b966-e6913bd24013	694e7928-f762-11e1-a439-00145eb45e9a
1	1	0	Plazi	ffb07bec-2d10-492d-9c37-361fe0b79427	6a8d52af-2897-436e-b03b-a66a0809b89a
0	2	2	Plazi	ffb07bec-2d10-492d-9c37-361fe0b79427	6ac7702d-58e9-4fc4-a74c-b45d965eb4b4
1195	1195	0	GBIF Germany	4f6826f2-4ff6-443d-b966-e6913bd24013	6c29839a-f762-11e1-a439-00145eb45e9a
184	184	0	GBIF Germany	4f6826f2-4ff6-443d-b966-e6913bd24013	6d192a80-f762-11e1-a439-00145eb45e9a
164	164	0	GBIF Germany	4f6826f2-4ff6-443d-b966-e6913bd24013	6d2c121c-f762-11e1-a439-00145eb45e9a
11	11	0	GBIF Germany	4f6826f2-4ff6-443d-b966-e6913bd24013	6ffcb2a8-f762-11e1-a439-00145eb45e9a
34	34	0	GBIF Germany	4f6826f2-4ff6-443d-b966-e6913bd24013	70c9dae4-f762-11e1-a439-00145eb45e9a
154	154	0	Plazi	ffb07bec-2d10-492d-9c37-361fe0b79427	7130e278-109a-4da2-b2e7-adeca14b5c77
279	279	0	GBIF Germany	4f6826f2-4ff6-443d-b966-e6913bd24013	715913c6-f762-11e1-a439-00145eb45e9a
0	15907	15907	Canada Biodiversity Information Facility	8f83fc96-c966-4126-83f7-bf044dc49efa	727e910d-5d1c-4bff-8e1c-6b13342d8ca0
1716	1716	0	Polish Biodiversity Information Network	2618bfdf-e194-4911-a241-80db3107bc51	733158b0-1495-11de-bab0-b8a03c50a862
0	1	1	Plazi	ffb07bec-2d10-492d-9c37-361fe0b79427	73361324-502a-4711-847b-e8db16a1573e
15	15	0	GBIF Germany	4f6826f2-4ff6-443d-b966-e6913bd24013	7427a28e-f762-11e1-a439-00145eb45e9a
580	580	0	GBIF Germany	4f6826f2-4ff6-443d-b966-e6913bd24013	749c023c-f762-11e1-a439-00145eb45e9a
988	988	0	GBIF Germany	4f6826f2-4ff6-443d-b966-e6913bd24013	74c6733c-f762-11e1-a439-00145eb45e9a
415	342	-73	GBIF Germany	4f6826f2-4ff6-443d-b966-e6913bd24013	75f9fae4-f762-11e1-a439-00145eb45e9a
16	16	0	Plazi	ffb07bec-2d10-492d-9c37-361fe0b79427	777f9d1d-53e8-4a40-ae71-3e93569f5eb4
28	28	0	Plazi	ffb07bec-2d10-492d-9c37-361fe0b79427	782896dd-8191-40e1-beff-66588d05bc74
4533	4533	0	Colombian Biodiversity Information System	7e865cba-7c46-417b-ade5-97f2cf5b7be0	78ca9ba8-a990-4ba1-a038-c37bd91220e6
49	42	-7	GBIF Germany	4f6826f2-4ff6-443d-b966-e6913bd24013	7988b3f8-f762-11e1-a439-00145eb45e9a
292	292	0	GBIF France	da44cd31-5901-4687-a106-6d1c7734ee3a	79db0725-7bd9-4e15-8e6f-a673157343fc
4	4	0	GBIF Germany	4f6826f2-4ff6-443d-b966-e6913bd24013	7ad99af6-f762-11e1-a439-00145eb45e9a
72	63	-9	GBIF Germany	4f6826f2-4ff6-443d-b966-e6913bd24013	7bc80858-f762-11e1-a439-00145eb45e9a
42	42	0	GBIF Germany	4f6826f2-4ff6-443d-b966-e6913bd24013	7cebbcfc-f762-11e1-a439-00145eb45e9a
366	365	-1	GBIF Germany	4f6826f2-4ff6-443d-b966-e6913bd24013	7cee6ef2-f762-11e1-a439-00145eb45e9a
126	126	0	GBIF Germany	4f6826f2-4ff6-443d-b966-e6913bd24013	7da5264c-f762-11e1-a439-00145eb45e9a
2307	2307	0	GBIF Germany	4f6826f2-4ff6-443d-b966-e6913bd24013	7dc94e32-f762-11e1-a439-00145eb45e9a
331	331	0	GBIF Germany	4f6826f2-4ff6-443d-b966-e6913bd24013	7e734590-f762-11e1-a439-00145eb45e9a
0	3454	3454	GBIF Switzerland	169eb292-376b-4cc6-8e31-9c2c432de0ad	7e864146-18c2-469c-9c78-a7082cdbddd7
408	339	-69	Biodiversity Information System of Mexico	b324e8e9-9a4c-44fa-8f1a-7f39ea7ab576	7f5ed794-f762-11e1-a439-00145eb45e9a
1559	11	-1548	Biodiversity Information System of Mexico	b324e8e9-9a4c-44fa-8f1a-7f39ea7ab576	7fac7128-936b-4da9-8baf-6020bb898fb7
28	28	0	GBIF Germany	4f6826f2-4ff6-443d-b966-e6913bd24013	81429848-f762-11e1-a439-00145eb45e9a
668252	668252	0	Polish Biodiversity Information Network	2618bfdf-e194-4911-a241-80db3107bc51	8186b0c0-925e-11da-8900-b8a03c50a862
162	168	6	GBIF Germany	4f6826f2-4ff6-443d-b966-e6913bd24013	81a61e54-f762-11e1-a439-00145eb45e9a
8	8	0	Plazi	ffb07bec-2d10-492d-9c37-361fe0b79427	833c2bc0-2a29-4efa-9058-04bcf3e7beed
378320	466091	87771	GBIF Japan	db5705aa-6a6e-42f1-8942-d77b9f4896ea	848f7570-f762-11e1-a439-00145eb45e9a
1934	1934	0	GBIF Argentina	2426a871-9feb-40a1-96c6-0c593a76b835	84dcae71-5a00-4b50-b23f-849ab4af7be3
0	5	5	Ocean Biodiversity Information System	ba0670b9-4186-41e6-8e70-f9cb3065551a	85113b60-437a-4fc9-9211-3bcdb39623e0
12828	12828	0	Participant Node Managers Committee	7f48e0c8-5c96-49ec-b972-30748e339115	85f38230-f762-11e1-a439-00145eb45e9a
1612	1612	0	GBIF Japan	db5705aa-6a6e-42f1-8942-d77b9f4896ea	869cd77c-f762-11e1-a439-00145eb45e9a
6	6	0	Plazi	ffb07bec-2d10-492d-9c37-361fe0b79427	86a42a54-2f47-458e-a443-13866e9e3191
20	12	-8	GBIF Germany	4f6826f2-4ff6-443d-b966-e6913bd24013	875c4314-f762-11e1-a439-00145eb45e9a
756	553	-203	GBIF Germany	4f6826f2-4ff6-443d-b966-e6913bd24013	87cf5688-f762-11e1-a439-00145eb45e9a
168	66	-102	GBIF Germany	4f6826f2-4ff6-443d-b966-e6913bd24013	88b3d1e6-f762-11e1-a439-00145eb45e9a
4	4	0	Plazi	ffb07bec-2d10-492d-9c37-361fe0b79427	88c03351-a632-4278-90dd-125a8b6ed028
338	338	0	GBIF Germany	4f6826f2-4ff6-443d-b966-e6913bd24013	89eb7c80-f762-11e1-a439-00145eb45e9a
2	2	0	GBIF Germany	4f6826f2-4ff6-443d-b966-e6913bd24013	8a1384f0-f762-11e1-a439-00145eb45e9a
85	85	0	GBIF Germany	4f6826f2-4ff6-443d-b966-e6913bd24013	8a669410-f762-11e1-a439-00145eb45e9a
190	190	0	GBIF Germany	4f6826f2-4ff6-443d-b966-e6913bd24013	8bb15666-f762-11e1-a439-00145eb45e9a
780	660	-120	GBIF Germany	4f6826f2-4ff6-443d-b966-e6913bd24013	8f2a8a1a-f762-11e1-a439-00145eb45e9a
206	206	0	GBIF France	da44cd31-5901-4687-a106-6d1c7734ee3a	9152e072-2de0-4e83-91f0-0a33fdac66f6
0	40734	40734	Korean Biodiversity Information Facility	e0a1e772-0177-4800-94b4-2d023fe6cdf4	91a8fa00-7532-4b66-b653-496ddd65627b
33	33	0	Plazi	ffb07bec-2d10-492d-9c37-361fe0b79427	92568fbc-5aca-4da9-8cc1-1b79de424966
311	311	0	Plazi	ffb07bec-2d10-492d-9c37-361fe0b79427	939f52d6-d58b-4a22-8aec-dd5c6a591067
0	4	4	Plazi	ffb07bec-2d10-492d-9c37-361fe0b79427	984d56bf-e4ad-4e32-8cc0-308f6422523d
374	374	0	Biodiversity Information System of Mexico	b324e8e9-9a4c-44fa-8f1a-7f39ea7ab576	9b91c7f0-9a6e-49f3-bac7-403a1c070bf3
2	2	0	Plazi	ffb07bec-2d10-492d-9c37-361fe0b79427	9c76dbec-95a8-4802-aca2-ecdc9d4a82c2
3	3	0	Plazi	ffb07bec-2d10-492d-9c37-361fe0b79427	9c9444d2-c629-4690-8186-bce7ee1c568e
2	2	0	Plazi	ffb07bec-2d10-492d-9c37-361fe0b79427	9cf94947-8031-4d78-8891-f9ff2f42e384
5629	5629	0	Ocean Biodiversity Information System	ba0670b9-4186-41e6-8e70-f9cb3065551a	a0a72065-2cd9-4542-9fdf-58533734d5ed
72	72	0	Plazi	ffb07bec-2d10-492d-9c37-361fe0b79427	a18c0d1c-bdee-460d-b89a-07f536714c46
0	8908	8908	GBIF Spain	1f94b3ca-9345-4d65-afe2-4bace93aa0fe	a4144680-8b18-4178-aa8a-678842403c59
15547	15546	-1	Biodiversity Information System of Mexico	b324e8e9-9a4c-44fa-8f1a-7f39ea7ab576	a72ac6ef-6f55-4b17-a1d1-b213d5bb8977
10821	10821	0	GBIF France	da44cd31-5901-4687-a106-6d1c7734ee3a	a8c38b89-47ff-4e0e-b16e-646899d1d3fd
41	41	0	Participant Node Managers Committee	7f48e0c8-5c96-49ec-b972-30748e339115	aa11108e-ee0d-40d0-a47e-a0f212d122b2
2	2	0	Plazi	ffb07bec-2d10-492d-9c37-361fe0b79427	acdb221c-3e85-4777-b258-95b81468927c
3	3	0	Plazi	ffb07bec-2d10-492d-9c37-361fe0b79427	b2ccefea-b965-4f52-a78e-5b00c9c0ad8c
1742	1742	0	U.S. Geological Survey	8618c64a-93e0-4300-b546-7249e5148ed2	b6e61b53-a471-4e5a-8378-6920a5a0275d
1	1	0	Plazi	ffb07bec-2d10-492d-9c37-361fe0b79427	bbca077c-3a0e-44a2-ada9-dcd8a368a261
560	560	0	Albertine Rift Conservation Society	90a939d3-e99c-4f6d-915f-2616423b3735	bd6bd671-60f6-4716-9d65-c6dd38dc2f6f
885	885	0	GBIF Japan	db5705aa-6a6e-42f1-8942-d77b9f4896ea	c05774c5-b126-4f9e-90ae-a812f74f67ab
37102	37102	0	National Biodiversity Network	d897a5b9-35ee-4232-94bd-b0bcaac003c2	c0e410ad-0d01-49f3-a837-71982c0e0c32
0	5	5	Plazi	ffb07bec-2d10-492d-9c37-361fe0b79427	c11c23ea-8b8c-461b-a6e3-b90052416577
0	12	12	Plazi	ffb07bec-2d10-492d-9c37-361fe0b79427	c56149ad-1ce1-4abe-93d9-7c2d14c78a73
0	19	19	Plazi	ffb07bec-2d10-492d-9c37-361fe0b79427	ca210c1e-3b76-4b04-8576-57e86ae50caa
154991	154991	0	National Biodiversity Network	d897a5b9-35ee-4232-94bd-b0bcaac003c2	cbc9dc02-6315-4daf-add2-d132ace4662c
27753	27753	0	GBIF Finland	dd514216-5c7c-45f3-910d-797424cb5be6	cdbcc960-d9d9-43b8-bdaa-148fb034a635
57	57	0	GBIF France	da44cd31-5901-4687-a106-6d1c7734ee3a	ce3de0f8-952b-4022-a4c0-47d019cb9a6f
68916	68916	0	GBIF France	da44cd31-5901-4687-a106-6d1c7734ee3a	ce861efd-402f-4c10-a9fb-30ad0426bd15
1684	1684	0	National Biodiversity Network	d897a5b9-35ee-4232-94bd-b0bcaac003c2	cec15c1b-6ea6-4cfe-bc63-28fb77b7323f
2	2	0	Plazi	ffb07bec-2d10-492d-9c37-361fe0b79427	d87e6eec-c94e-4ff2-a8a5-13803e5d1292
177	177	0	GBIF Germany	4f6826f2-4ff6-443d-b966-e6913bd24013	db46287d-21b5-45eb-9428-56b32946cb32
179	179	0	Plazi	ffb07bec-2d10-492d-9c37-361fe0b79427	dd8eeac0-1118-4cdc-b424-363728ad760a
11	11	0	Plazi	ffb07bec-2d10-492d-9c37-361fe0b79427	e16ee99a-5bf1-4889-b873-03ac7df253a0
0	1082	1082	Ocean Biodiversity Information System	ba0670b9-4186-41e6-8e70-f9cb3065551a	e35506ee-7213-4909-9062-3c4e0f5851cf
88	88	0	GBIF France	da44cd31-5901-4687-a106-6d1c7734ee3a	e9b63688-ed8d-4be8-aa35-89646d887a5e
0	24	24	Plazi	ffb07bec-2d10-492d-9c37-361fe0b79427	e9b6381f-da1b-47c3-b232-596c9c9af970
2	2	0	Plazi	ffb07bec-2d10-492d-9c37-361fe0b79427	e9f27cb7-22c9-4477-88e7-15af6bb6e60e
0	39	39	Plazi	ffb07bec-2d10-492d-9c37-361fe0b79427	edb2e6d0-9ff6-46c9-beaa-0b323a0412a9
600	600	0	GBIF Kenya	2a44d626-9f7a-4120-8a7a-4ab5ac15ff2a	eec636b7-914b-421a-9588-7fa3bc42a609
4	4	0	Plazi	ffb07bec-2d10-492d-9c37-361fe0b79427	f0388f56-ed5e-4d43-baf3-8bda92478840
0	5	5	Plazi	ffb07bec-2d10-492d-9c37-361fe0b79427	f3c91b64-d713-48e5-8de2-6dc5788144ab
2728	2728	0	Taiwan Biodiversity Information Facility	e1b85abc-61f9-430f-ba79-6813dec53a0f	f464cad8-531e-4d53-ad36-2e4430f6765e
44088	44088	0	DanBIF - Danish Biodiversity Information Facility	4ddd294f-02b7-4359-ac33-0806a9ca9c6b	f506be53-9221-4b44-a41d-5aa0905ec216
2788	2788	0	Biodiversity Information System of Mexico	b324e8e9-9a4c-44fa-8f1a-7f39ea7ab576	f62a2d6a-f800-4efe-b63a-325762d81f5f
2289	2289	0	GBIF Japan	db5705aa-6a6e-42f1-8942-d77b9f4896ea	f851fd75-32b2-4a23-8046-9c8ae7013a3c
2	2	0	Plazi	ffb07bec-2d10-492d-9c37-361fe0b79427	fba6f08d-2e56-47f6-81d2-dac9346dd00b
17	17	0	Plazi	ffb07bec-2d10-492d-9c37-361fe0b79427	03d6d8b3-0b1d-4516-9d27-3bd02f65a88f
1	1	0	Plazi	ffb07bec-2d10-492d-9c37-361fe0b79427	0446cda6-a718-4458-8777-d5e8c433b8bf
0	4	4	Plazi	ffb07bec-2d10-492d-9c37-361fe0b79427	049857bb-cbe8-45cd-9c47-2cf12934cb43
1650	1650	0	Canadensys	4db9cfd2-1191-4b9d-b579-0b68ceabd968	05bf3655-ef2e-46ba-8732-60517beb3567
3509	3509	0	GBIF Spain	1f94b3ca-9345-4d65-afe2-4bace93aa0fe	05d46db0-71db-42c0-b5cb-b81120093f1d
2	2	0	Plazi	ffb07bec-2d10-492d-9c37-361fe0b79427	065ae61f-a61a-46b5-9288-029c35e65617
1	1	0	Plazi	ffb07bec-2d10-492d-9c37-361fe0b79427	07823904-5b4f-4218-8b4a-c990550b9c30
23	23	0	Plazi	ffb07bec-2d10-492d-9c37-361fe0b79427	082fa0e5-df2b-45d9-b882-110560dc1d54
220	220	0	GBIF Germany	4f6826f2-4ff6-443d-b966-e6913bd24013	09273d49-6a94-4c34-8879-df38d52982b0
32	32	0	Plazi	ffb07bec-2d10-492d-9c37-361fe0b79427	0959b45e-e044-4689-8dbf-7e559b5a985f
560	560	0	GBIF France	da44cd31-5901-4687-a106-6d1c7734ee3a	0b6d8878-cdce-4603-b948-67c099619e91
21	21	0	Plazi	ffb07bec-2d10-492d-9c37-361fe0b79427	0c9b51d3-d5ae-4d20-b47d-ba5c5a4f5d28
9	9	0	Plazi	ffb07bec-2d10-492d-9c37-361fe0b79427	0d965755-b8a9-4a9e-a087-23c13af56bfc
13	13	0	Plazi	ffb07bec-2d10-492d-9c37-361fe0b79427	10aed39d-f494-4164-b41f-5c2e6bcb7be4
0	32	32	Plazi	ffb07bec-2d10-492d-9c37-361fe0b79427	1272fda8-8d05-4c18-a0aa-bf105ca3371e
0	44	44	Plazi	ffb07bec-2d10-492d-9c37-361fe0b79427	1430f8df-baac-425a-990d-e9db0b875e5d
428	428	0	GBIF Sweden	a0b3be64-6525-4387-ac67-a499950f92e1	14ae14f5-a7a5-4393-b45d-e64c80cfc63c
0	9	9	Plazi	ffb07bec-2d10-492d-9c37-361fe0b79427	15c88b50-3c7a-48c4-981d-6d9239529e04
2	2	0	Plazi	ffb07bec-2d10-492d-9c37-361fe0b79427	16698f13-a1dc-4b5c-b588-c89752bebec2
804	804	0	National Biodiversity Network	d897a5b9-35ee-4232-94bd-b0bcaac003c2	168b1364-3253-4c7d-a014-0f976beaf00e
0	3	3	Plazi	ffb07bec-2d10-492d-9c37-361fe0b79427	1b2b96d0-bfba-4010-bfd0-377ffaa32cea
152	9725	9573	U.S. Geological Survey	8618c64a-93e0-4300-b546-7249e5148ed2	1b9eaa10-8441-481c-b50a-391ba168a86f
5	5	0	Plazi	ffb07bec-2d10-492d-9c37-361fe0b79427	1dac5ace-5a1c-4c5e-b81c-487d7f97cd6f
8	8	0	Plazi	ffb07bec-2d10-492d-9c37-361fe0b79427	2104639c-10cf-444c-b406-065936e44914
6	6	0	Plazi	ffb07bec-2d10-492d-9c37-361fe0b79427	240069a3-ea0d-448a-958b-d0ea649a54b2
931	931	0	Ocean Biodiversity Information System	ba0670b9-4186-41e6-8e70-f9cb3065551a	245a00a2-064d-4d80-a380-96cce65c69e3
8	8	0	GBIF France	da44cd31-5901-4687-a106-6d1c7734ee3a	24971172-7b6f-4305-90cc-941c8dd836c8
1128	1128	0	GBIF France	da44cd31-5901-4687-a106-6d1c7734ee3a	2a84b1c7-1f64-47e8-b00a-0d6b712914b6
22944	22944	0	GBIF Brazil	cdc9736d-5ff7-4ece-9959-3c744360cdb3	2ad00feb-1283-40d4-8352-0e4055f31773
0	11	11	Plazi	ffb07bec-2d10-492d-9c37-361fe0b79427	2b1746ca-f92a-4e7c-a39a-eddd88a8cf45
4975	4975	0	GBIF Norway	4f829580-180d-46a9-9c87-ed8ec959b545	2b52369a-7fe0-4d28-b88c-c882c0ce71d8
3945	3945	0	U.S. Geological Survey	8618c64a-93e0-4300-b546-7249e5148ed2	2f897875-210a-43a9-bab3-a724bea8e400
5086	5086	0	Participant Node Managers Committee	7f48e0c8-5c96-49ec-b972-30748e339115	2fdc8f80-3f12-482e-ac28-8683d448e881
28	28	0	Plazi	ffb07bec-2d10-492d-9c37-361fe0b79427	33c4d096-733f-4a1e-843e-9474561bc287
102	102	0	GBIF Germany	4f6826f2-4ff6-443d-b966-e6913bd24013	358c3762-df7f-4c34-ac68-439622c36f6d
1382	1382	0	GBIF Germany	4f6826f2-4ff6-443d-b966-e6913bd24013	35919118-dd7e-4c31-877c-7b1539df5192
1012	1012	0	GBIF France	da44cd31-5901-4687-a106-6d1c7734ee3a	39c979e6-7f99-457b-a467-946c4643d55e
487	487	0	GBIF France	da44cd31-5901-4687-a106-6d1c7734ee3a	3a740b1e-e77b-423b-ac93-fd4916cf91d2
10	10	0	Participant Node Managers Committee	7f48e0c8-5c96-49ec-b972-30748e339115	3b6eb0c3-6695-4869-80b8-910ac0fd6537
1068	1068	0	National Biodiversity Network	d897a5b9-35ee-4232-94bd-b0bcaac003c2	3c84d649-e06a-4bd1-bc71-1c1110fec91c
2429	2429	0	National Biodiversity Network	d897a5b9-35ee-4232-94bd-b0bcaac003c2	3d086cd2-4fbb-4fbb-9b0e-3bfefe1cc3e6
0	386901	386901	Canada Biodiversity Information Facility	8f83fc96-c966-4126-83f7-bf044dc49efa	3d4cac0a-7441-4099-8eed-8a270d522f8f
75	75	0	GBIF France	da44cd31-5901-4687-a106-6d1c7734ee3a	3ee7b61a-85f1-44c3-9301-fbb7df89550d
0	400	400	GBIF France	da44cd31-5901-4687-a106-6d1c7734ee3a	41bbf2ed-6c0d-4e36-934c-a34c7ab97098
697	697	0	Participant Node Managers Committee	7f48e0c8-5c96-49ec-b972-30748e339115	457f9aab-5dce-4dd9-9a71-2d123f80d2f6
12	12	0	Plazi	ffb07bec-2d10-492d-9c37-361fe0b79427	495f641b-a25a-4868-a6b9-3e0a8fab658c
0	154	154	Ocean Biodiversity Information System	ba0670b9-4186-41e6-8e70-f9cb3065551a	49ebc094-6e9e-410b-9553-050f1e8ffe75
147	147	0	Participant Node Managers Committee	7f48e0c8-5c96-49ec-b972-30748e339115	4cb8165d-2c33-442f-b948-ff038cf149e1
4050	4050	0	Biodiversity Information System of Mexico	b324e8e9-9a4c-44fa-8f1a-7f39ea7ab576	4e328d6a-62e2-4b5a-b2f2-e8362c4ff0b7
1	1	0	Plazi	ffb07bec-2d10-492d-9c37-361fe0b79427	4e8a23e4-7372-4ca1-a48b-58bb75433f4b
10369	13350	2981	National Biodiversity Network	d897a5b9-35ee-4232-94bd-b0bcaac003c2	5187a2f9-91f1-4511-b4f0-60a2658a7e36
0	15	15	Plazi	ffb07bec-2d10-492d-9c37-361fe0b79427	519a0a6c-d4ea-4211-8019-771b6d17963c
18	18	0	Plazi	ffb07bec-2d10-492d-9c37-361fe0b79427	51fb88d6-133f-4afa-95b9-4f0680cc6d96
790	790	0	GBIF France	da44cd31-5901-4687-a106-6d1c7734ee3a	55a13551-f65c-4f5d-ad36-e0d6cc2cd059
6	6	0	Participant Node Managers Committee	7f48e0c8-5c96-49ec-b972-30748e339115	5898d0f2-2a87-4a26-bfc2-ff977f139f84
29	29	0	Plazi	ffb07bec-2d10-492d-9c37-361fe0b79427	59709b45-9e8f-4922-bd5f-90fbe521eb75
0	406	406	Ocean Biodiversity Information System	ba0670b9-4186-41e6-8e70-f9cb3065551a	5a03dcad-49e8-447c-b2b2-42e38d9f3a82
245	245	0	GBIF Brazil	cdc9736d-5ff7-4ece-9959-3c744360cdb3	5b9e8042-dde3-49bf-9170-03abb0f4bf44
19364	19364	0	GBIF Finland	dd514216-5c7c-45f3-910d-797424cb5be6	5c590b76-5874-4bc1-95f3-07d0f0c8b55c
3	3	0	Plazi	ffb07bec-2d10-492d-9c37-361fe0b79427	5ce06218-5f10-4f06-bb4b-882e13d24898
1	1	0	Plazi	ffb07bec-2d10-492d-9c37-361fe0b79427	5ea1c177-5b00-4c9d-8489-af5066b837bc
1094	1369	275	Symbiota Support Hub	612b5a0b-908b-4b4e-b9bf-ca15dfdc94fa	5f9cac91-3b5d-41df-8200-883a68aa2a17
725	725	0	Ocean Biodiversity Information System	ba0670b9-4186-41e6-8e70-f9cb3065551a	607256a0-9943-4e2b-9eda-68098ad3d16a
0	13	13	Plazi	ffb07bec-2d10-492d-9c37-361fe0b79427	60736e24-69a2-4243-a420-19c77c0d57b4
57	57	0	GBIF Germany	4f6826f2-4ff6-443d-b966-e6913bd24013	619918a0-f762-11e1-a439-00145eb45e9a
96	96	0	GBIF Germany	4f6826f2-4ff6-443d-b966-e6913bd24013	61a7b838-f762-11e1-a439-00145eb45e9a
56699	56699	0	Canada Biodiversity Information Facility	8f83fc96-c966-4126-83f7-bf044dc49efa	628abbe5-dc8d-41e9-a0c7-f05efe282649
29	29	0	GBIF Germany	4f6826f2-4ff6-443d-b966-e6913bd24013	6295f7e6-f762-11e1-a439-00145eb45e9a
64	64	0	GBIF Germany	4f6826f2-4ff6-443d-b966-e6913bd24013	62b2cf10-f762-11e1-a439-00145eb45e9a
102	102	0	GBIF Germany	4f6826f2-4ff6-443d-b966-e6913bd24013	62c6c79a-f762-11e1-a439-00145eb45e9a
92	92	0	GBIF Germany	4f6826f2-4ff6-443d-b966-e6913bd24013	66c762f0-f762-11e1-a439-00145eb45e9a
206	206	0	GBIF Germany	4f6826f2-4ff6-443d-b966-e6913bd24013	67f8c498-f762-11e1-a439-00145eb45e9a
187	187	0	GBIF France	da44cd31-5901-4687-a106-6d1c7734ee3a	68949ffc-8f3f-4353-a8b0-441d7abbcbf5
41	41	0	GBIF Germany	4f6826f2-4ff6-443d-b966-e6913bd24013	69198402-f762-11e1-a439-00145eb45e9a
18	18	0	GBIF Germany	4f6826f2-4ff6-443d-b966-e6913bd24013	6b3197e8-f762-11e1-a439-00145eb45e9a
141	141	0	GBIF Uganda	71b40829-6a12-4c3d-8fee-5746f5e9cf8c	6b7eced3-d4a2-49ac-9c81-1eaabb2d6369
32	32	0	GBIF Germany	4f6826f2-4ff6-443d-b966-e6913bd24013	6c9afbf6-f762-11e1-a439-00145eb45e9a
584	584	0	GBIF Germany	4f6826f2-4ff6-443d-b966-e6913bd24013	6ca6b5cc-f762-11e1-a439-00145eb45e9a
0	45	45	Plazi	ffb07bec-2d10-492d-9c37-361fe0b79427	6d9aa047-4f78-49dd-8838-0872b731a6ca
666	666	0	Colombian Biodiversity Information System	7e865cba-7c46-417b-ade5-97f2cf5b7be0	6e82ee3d-f5c2-43c7-8962-cfa36ca6b179
9	9	0	GBIF Germany	4f6826f2-4ff6-443d-b966-e6913bd24013	6fe48ac0-f762-11e1-a439-00145eb45e9a
2	2	0	GBIF Germany	4f6826f2-4ff6-443d-b966-e6913bd24013	71894636-f762-11e1-a439-00145eb45e9a
141	141	0	GBIF Germany	4f6826f2-4ff6-443d-b966-e6913bd24013	71b9a826-f762-11e1-a439-00145eb45e9a
349178	349178	0	U.S. Geological Survey	8618c64a-93e0-4300-b546-7249e5148ed2	71d0dff0-f762-11e1-a439-00145eb45e9a
1	1	0	GBIF Germany	4f6826f2-4ff6-443d-b966-e6913bd24013	71ef190c-f762-11e1-a439-00145eb45e9a
638057	638057	0	GBIF France	da44cd31-5901-4687-a106-6d1c7734ee3a	72b6bac4-3a93-491b-a931-cbd07bff5b39
15	15	0	Plazi	ffb07bec-2d10-492d-9c37-361fe0b79427	7465dd93-f69d-4018-9128-673b51925f67
348	348	0	GBIF Germany	4f6826f2-4ff6-443d-b966-e6913bd24013	74f46e2c-f762-11e1-a439-00145eb45e9a
81	81	0	Colombian Biodiversity Information System	7e865cba-7c46-417b-ade5-97f2cf5b7be0	770f1cdc-0441-42bb-8dfa-18a0a295486e
31	32	1	GBIF Germany	4f6826f2-4ff6-443d-b966-e6913bd24013	77503016-f762-11e1-a439-00145eb45e9a
0	13	13	Plazi	ffb07bec-2d10-492d-9c37-361fe0b79427	78a35ad4-2094-41f8-ad5c-17611449b46e
11	11	0	GBIF Germany	4f6826f2-4ff6-443d-b966-e6913bd24013	78f7eda0-f762-11e1-a439-00145eb45e9a
0	1144	1144	Ocean Biodiversity Information System	ba0670b9-4186-41e6-8e70-f9cb3065551a	79193302-bfe6-410d-91ab-94734bf5f7f8
44	34	-10	GBIF Germany	4f6826f2-4ff6-443d-b966-e6913bd24013	795477c8-f762-11e1-a439-00145eb45e9a
1013	817	-196	GBIF Germany	4f6826f2-4ff6-443d-b966-e6913bd24013	797cbdb4-f762-11e1-a439-00145eb45e9a
4924	4924	0	National Biodiversity Network	d897a5b9-35ee-4232-94bd-b0bcaac003c2	7a49358e-7c27-4636-8061-90ba51bcf985
151	151	0	GBIF Germany	4f6826f2-4ff6-443d-b966-e6913bd24013	7a7991a6-f762-11e1-a439-00145eb45e9a
283	283	0	Ocean Biodiversity Information System	ba0670b9-4186-41e6-8e70-f9cb3065551a	7b9545bc-f762-11e1-a439-00145eb45e9a
5115	5115	0	GBIF Germany	4f6826f2-4ff6-443d-b966-e6913bd24013	7b9d7214-f762-11e1-a439-00145eb45e9a
528	528	0	GBIF France	da44cd31-5901-4687-a106-6d1c7734ee3a	7bc1af58-b271-410a-b377-65ed1a773a34
24	24	0	Plazi	ffb07bec-2d10-492d-9c37-361fe0b79427	7c601adf-555e-4c3c-9257-ce47e832cd6c
0	2	2	Plazi	ffb07bec-2d10-492d-9c37-361fe0b79427	7c8dad8c-3c2f-48bf-9ca1-f888a0eef5f4
54	54	0	Plazi	ffb07bec-2d10-492d-9c37-361fe0b79427	7c9ed37d-ebab-4970-bf62-771925ea97a9
1522	1522	0	National Biodiversity Network	d897a5b9-35ee-4232-94bd-b0bcaac003c2	7cc1c6f7-b99c-4132-91e7-2b311ab88872
1	1	0	GBIF Japan	db5705aa-6a6e-42f1-8942-d77b9f4896ea	80e1db20-f762-11e1-a439-00145eb45e9a
0	8	8	Plazi	ffb07bec-2d10-492d-9c37-361fe0b79427	80fafa9d-0129-451e-8277-c93022893c5f
874	899	25	GBIF Germany	4f6826f2-4ff6-443d-b966-e6913bd24013	81ad9968-f762-11e1-a439-00145eb45e9a
11805	8189	-3616	GBIF Germany	4f6826f2-4ff6-443d-b966-e6913bd24013	81b1cdfc-f940-4eff-bb27-002c297e2914
1040	1014	-26	GBIF Germany	4f6826f2-4ff6-443d-b966-e6913bd24013	82a620f3-d1d2-4f6c-b230-7c1da7e6ca82
30178	314240	284062	U.S. Geological Survey	8618c64a-93e0-4300-b546-7249e5148ed2	836204c6-f8ca-49f3-be9a-afbae64ae72c
241	241	0	Biodiversity Information System of Mexico	b324e8e9-9a4c-44fa-8f1a-7f39ea7ab576	850f0510-f762-11e1-a439-00145eb45e9a
0	23	23	Plazi	ffb07bec-2d10-492d-9c37-361fe0b79427	86cd3ea8-3f45-444c-90d3-1ebc090eeca7
0	10	10	Plazi	ffb07bec-2d10-492d-9c37-361fe0b79427	87f7897f-0f4a-468a-9626-ce4ab12fc4d7
0	6	6	Plazi	ffb07bec-2d10-492d-9c37-361fe0b79427	892a21aa-d6b8-42e9-bcef-7a95b0dfe0e5
67840	67840	0	U.S. Geological Survey	8618c64a-93e0-4300-b546-7249e5148ed2	8935e64a-f762-11e1-a439-00145eb45e9a
1	1	0	Plazi	ffb07bec-2d10-492d-9c37-361fe0b79427	8b8357bc-5a0f-44af-bb96-a54448ec8547
35	35	0	Plazi	ffb07bec-2d10-492d-9c37-361fe0b79427	8bfab3eb-72b6-4d56-a072-ec4ecaf53820
37	37	0	GBIF Germany	4f6826f2-4ff6-443d-b966-e6913bd24013	8cd13c77-d038-44b0-87e0-1d36bbf249b8
0	8	8	Plazi	ffb07bec-2d10-492d-9c37-361fe0b79427	8d785073-d286-4462-a915-771d1be0e591
3070	3070	0	GBIF Germany	4f6826f2-4ff6-443d-b966-e6913bd24013	8ed51a94-f762-11e1-a439-00145eb45e9a
0	4159	4159	Colombian Biodiversity Information System	7e865cba-7c46-417b-ade5-97f2cf5b7be0	8f4e257a-f55b-45a7-9b45-a6241cae907d
143	143	0	GBIF Germany	4f6826f2-4ff6-443d-b966-e6913bd24013	8f810458-f762-11e1-a439-00145eb45e9a
209691	209691	0	GBIF Sweden	a0b3be64-6525-4387-ac67-a499950f92e1	9070a460-0c6e-11dd-84d2-b8a03c50a862
30	30	0	GBIF Spain	1f94b3ca-9345-4d65-afe2-4bace93aa0fe	90fa011c-9f9c-476b-b50c-c1ce75a9d5bf
231	215	-16	GBIF Germany	4f6826f2-4ff6-443d-b966-e6913bd24013	9155d7c2-f762-11e1-a439-00145eb45e9a
5	5	0	Plazi	ffb07bec-2d10-492d-9c37-361fe0b79427	91fa4568-747a-4854-92d0-3159264955a5
391758	391758	0	GBIF France	da44cd31-5901-4687-a106-6d1c7734ee3a	92204c07-5011-47ac-82b7-4050858a9cd0
277	277	0	GBIF Germany	4f6826f2-4ff6-443d-b966-e6913bd24013	927319b2-f762-11e1-a439-00145eb45e9a
198	198	0	GBIF Germany	4f6826f2-4ff6-443d-b966-e6913bd24013	92c489d2-f762-11e1-a439-00145eb45e9a
0	1122886	1122886	Ocean Biodiversity Information System	ba0670b9-4186-41e6-8e70-f9cb3065551a	93c8cc03-30cf-474e-8173-dbe5a22a5d28
0	1	1	Ocean Biodiversity Information System	ba0670b9-4186-41e6-8e70-f9cb3065551a	9519edba-ea94-4455-9b9f-971dde02e794
11840	11840	0	U.S. Geological Survey	8618c64a-93e0-4300-b546-7249e5148ed2	96406e90-953c-4b6d-b950-c079a04fd424
844	844	0	Plazi	ffb07bec-2d10-492d-9c37-361fe0b79427	96c8a18a-e887-4345-b266-d76076e8416b
0	102	102	Ocean Biodiversity Information System	ba0670b9-4186-41e6-8e70-f9cb3065551a	96ed8c12-d67b-4dc4-80a9-984f44524869
15	15	0	GBIF Germany	4f6826f2-4ff6-443d-b966-e6913bd24013	97768746-f762-11e1-a439-00145eb45e9a
38	38	0	GBIF France	da44cd31-5901-4687-a106-6d1c7734ee3a	98bb992c-72ca-4ebf-a727-b95958d8c3ab
0	1	1	Plazi	ffb07bec-2d10-492d-9c37-361fe0b79427	98bc9fa2-0e19-46c7-9341-d0fcc00ca105
27	27	0	Plazi	ffb07bec-2d10-492d-9c37-361fe0b79427	9f3e7a0e-4d40-44e9-9637-76ca79ef314a
0	14	14	Plazi	ffb07bec-2d10-492d-9c37-361fe0b79427	a1aa54a8-fca0-43b7-af9c-3137ad2a6449
0	18	18	Plazi	ffb07bec-2d10-492d-9c37-361fe0b79427	a20a47f9-c72c-4a66-9cc0-c2cda9b2b4f8
364	364	0	GBIF Germany	4f6826f2-4ff6-443d-b966-e6913bd24013	a9c59c6a-7f93-4d9b-bc05-817360bb8477
2751	2751	0	GBIF Germany	4f6826f2-4ff6-443d-b966-e6913bd24013	adf18f03-5def-4d54-931b-c3b00b518ed2
3	3	0	Plazi	ffb07bec-2d10-492d-9c37-361fe0b79427	b26dd2a7-e1dd-409f-bac9-a79a3f09f9d1
31	31	0	GBIF France	da44cd31-5901-4687-a106-6d1c7734ee3a	b276a72a-ccf7-43e9-88e1-cd91f7239e5a
92	92	0	GBIF Finland	dd514216-5c7c-45f3-910d-797424cb5be6	b351644a-f000-4e4f-a8d7-f5275ce02721
311347	311347	0	U.S. Geological Survey	8618c64a-93e0-4300-b546-7249e5148ed2	b3614f42-8f96-49b5-9659-4c421a983f02
0	484	484	GBIF Norway	4f829580-180d-46a9-9c87-ed8ec959b545	b4804f19-8a8a-49e7-8dc2-79b528635696
3	3	0	Plazi	ffb07bec-2d10-492d-9c37-361fe0b79427	b6afadd2-de15-4e04-a984-8d182f117845
21	21	0	Plazi	ffb07bec-2d10-492d-9c37-361fe0b79427	b9fb54f7-1883-4a6d-99b4-76f855a4d1cd
0	6	6	Participant Node Managers Committee	7f48e0c8-5c96-49ec-b972-30748e339115	bda9471f-e6fe-4f66-b836-df6e15e6a259
28	28	0	Plazi	ffb07bec-2d10-492d-9c37-361fe0b79427	c37b315a-5fff-4ed2-8505-cee48fce3f6c
221	221	0	GBIF France	da44cd31-5901-4687-a106-6d1c7734ee3a	c5edef3d-3747-4fb4-8d8f-a3457bc96b20
9244	9244	0	GBIF Portugal	673f7038-4262-4149-b753-5658a4e912f6	c690c2b5-8002-4d12-831c-9258dd618f78
15	15	0	Plazi	ffb07bec-2d10-492d-9c37-361fe0b79427	c7880314-66e6-4f8e-8ffe-ff13cbb6a9a3
32822	33150	328	Canada Biodiversity Information Facility	8f83fc96-c966-4126-83f7-bf044dc49efa	ca1bcd7e-7387-42f9-81ba-1470db55e3e8
0	2	2	Plazi	ffb07bec-2d10-492d-9c37-361fe0b79427	d240c9d5-88c8-4b3f-a9b6-bd60bbab588f
1709819	1709819	0	GBIF Spain	1f94b3ca-9345-4d65-afe2-4bace93aa0fe	d4aa2255-f927-4220-af22-2958298733b7
33	33	0	GBIF France	da44cd31-5901-4687-a106-6d1c7734ee3a	d5404c8e-8f97-4e20-9522-09fbf661d748
917	917	0	Colombian Biodiversity Information System	7e865cba-7c46-417b-ade5-97f2cf5b7be0	ddbfb01d-0c39-4aa6-a343-37929a157fa7
413	413	0	GBIF France	da44cd31-5901-4687-a106-6d1c7734ee3a	de80f896-9f9f-4556-876e-568b1f3c92ce
240	240	0	GBIF Germany	4f6826f2-4ff6-443d-b966-e6913bd24013	e11c020b-0cff-4f94-b763-e0f8329bb5c5
7	7	0	Plazi	ffb07bec-2d10-492d-9c37-361fe0b79427	e1558636-62be-42e0-a5ec-c285e6f8fcc4
13	13	0	Plazi	ffb07bec-2d10-492d-9c37-361fe0b79427	e352bb73-0c07-4e6d-af55-f369bdab1aab
0	9299	9299	Biodiversity Information System of Mexico	b324e8e9-9a4c-44fa-8f1a-7f39ea7ab576	e472509e-3117-410e-94ed-d2fbf605ab88
123	123	0	Plazi	ffb07bec-2d10-492d-9c37-361fe0b79427	e597b10d-8e4e-4ffa-8d36-87454b4b35b9
0	1000	1000	GBIF Japan	db5705aa-6a6e-42f1-8942-d77b9f4896ea	e59b4f4a-1449-41d5-adaf-fcae9dc3f819
14	14	0	Plazi	ffb07bec-2d10-492d-9c37-361fe0b79427	e6ed2164-d69d-41e9-b0c1-814b1b6b967e
6	6	0	Plazi	ffb07bec-2d10-492d-9c37-361fe0b79427	e907a366-2077-42be-9497-33071f17a051
1101	1101	0	Colombian Biodiversity Information System	7e865cba-7c46-417b-ade5-97f2cf5b7be0	e92a7b4a-55ed-4b0b-8033-9bf38643d019
46	46	0	Plazi	ffb07bec-2d10-492d-9c37-361fe0b79427	e9ffcfc7-9f7c-4212-ae6e-b842b31de6e9
0	1	1	Plazi	ffb07bec-2d10-492d-9c37-361fe0b79427	ec95a0c6-adc6-4c16-ac54-1a4fb16a0102
0	450	450	Korean Biodiversity Information Facility	e0a1e772-0177-4800-94b4-2d023fe6cdf4	f30e5cd0-2077-4bb0-8143-5aafee8e055f
465	465	0	Belgian Biodiversity Platform	fb11cfe1-ebc3-45af-9159-17d9fddbcdac	f3102dce-38a7-4dc5-bd54-3b3e3e76cb1f
6	6	0	Participant Node Managers Committee	7f48e0c8-5c96-49ec-b972-30748e339115	f3a1e772-2b73-4375-9dd6-2ec4805856f2
2	2	0	Plazi	ffb07bec-2d10-492d-9c37-361fe0b79427	f4997f4d-551d-4860-81ba-ec43bfd7c029
1	1	0	Plazi	ffb07bec-2d10-492d-9c37-361fe0b79427	f4c7a675-84b1-4418-9c19-698dd00e0ba5
1430	1430	0	GBIF Spain	1f94b3ca-9345-4d65-afe2-4bace93aa0fe	f5aa5a9f-30b8-4dc5-a5b5-b6ff106354f8
82	82	0	Biodiversity Information System of Mexico	b324e8e9-9a4c-44fa-8f1a-7f39ea7ab576	f5edd628-9c86-4c93-920c-6daac027500d
17	17	0	Plazi	ffb07bec-2d10-492d-9c37-361fe0b79427	f75630df-ea6c-447b-b750-d9330786d736
0	2548	2548	Participant Node Managers Committee	7f48e0c8-5c96-49ec-b972-30748e339115	f81b9b6c-ae10-4281-8b20-5db481ce8cc8
780	780	0	GBIF Argentina	2426a871-9feb-40a1-96c6-0c593a76b835	f9aa8260-9417-4c02-b171-e5550126c7bd
0	2	2	Plazi	ffb07bec-2d10-492d-9c37-361fe0b79427	f9c3e725-4781-463e-9045-9b357bdd3174
230	230	0	Colombian Biodiversity Information System	7e865cba-7c46-417b-ade5-97f2cf5b7be0	fcae44c7-8aa9-4e8b-ae7e-d85a98566f2c
54	54	0	Plazi	ffb07bec-2d10-492d-9c37-361fe0b79427	fdec1255-5294-442c-ba54-c528020d548a
197	197	0	GBIF Malawi	2a42e4d7-ad4a-41b3-84c4-de4aa7b74d35	fdf17dd6-44fa-409c-be7f-8a6a86c3cb76
2	2	0	Plazi	ffb07bec-2d10-492d-9c37-361fe0b79427	fec47ea9-eafd-4355-8406-3cc1568af7d5
387	387	0	GBIF France	da44cd31-5901-4687-a106-6d1c7734ee3a	ffc67d3c-b2f4-43b8-81a8-ae31521c4a22
0	3940	3940	Participant Node Managers Committee	7f48e0c8-5c96-49ec-b972-30748e339115	04021582-641b-4c2b-9247-ea126280b526
354	354	0	GBIF Germany	4f6826f2-4ff6-443d-b966-e6913bd24013	04280626-04d1-4127-939d-931ceed3a9c0
5	5	0	Plazi	ffb07bec-2d10-492d-9c37-361fe0b79427	0481ea4c-a303-4d86-93d5-e715a3e5909c
1352	1352	0	Plazi	ffb07bec-2d10-492d-9c37-361fe0b79427	0518c6ff-6418-460d-9bfb-cd606990e5bc
59	59	0	Plazi	ffb07bec-2d10-492d-9c37-361fe0b79427	05d2a4ba-f50f-4645-bbb3-05cd83dcbd7e
0	18	18	Plazi	ffb07bec-2d10-492d-9c37-361fe0b79427	0ae84f70-ab17-45b0-a3f9-081a41046b0e
1478	1478	0	National Biodiversity Network	d897a5b9-35ee-4232-94bd-b0bcaac003c2	0ba1bf20-e8a7-4226-99b8-bf6a812dbfb9
0	3	3	Ocean Biodiversity Information System	ba0670b9-4186-41e6-8e70-f9cb3065551a	0d2421e1-8987-4961-809e-2daabef05ecf
70222	70222	0	National Biodiversity Network	d897a5b9-35ee-4232-94bd-b0bcaac003c2	0de20c27-792a-461b-ae59-3ab8221a1113
0	2	2	Plazi	ffb07bec-2d10-492d-9c37-361fe0b79427	0dffb7c8-328d-426a-bbc2-9fb28c92b396
2	2	0	Plazi	ffb07bec-2d10-492d-9c37-361fe0b79427	11cfb0cb-b1d8-4410-8d95-f66c4a6a8e9a
0	6	6	Plazi	ffb07bec-2d10-492d-9c37-361fe0b79427	11f0cf97-3cbb-40c4-82e4-094d21031faa
6	6	0	Plazi	ffb07bec-2d10-492d-9c37-361fe0b79427	181f12d1-3c7c-4f39-bc5c-eb42a9bb4913
257	90	-167	GBIF Germany	4f6826f2-4ff6-443d-b966-e6913bd24013	18259558-43c1-4cee-a153-85c2f783c89d
0	2	2	Ocean Biodiversity Information System	ba0670b9-4186-41e6-8e70-f9cb3065551a	18e4b9a1-4fc3-4676-a7d0-3eb8bc369b6d
0	35	35	Ocean Biodiversity Information System	ba0670b9-4186-41e6-8e70-f9cb3065551a	193bf498-fcb4-40ad-ae74-8835eb9d3d65
0	10	10	Plazi	ffb07bec-2d10-492d-9c37-361fe0b79427	1e4a8c76-2524-4afa-8e06-ba3a97697e42
6	6	0	Plazi	ffb07bec-2d10-492d-9c37-361fe0b79427	1e92152f-3ecc-46c9-a3ae-173854b56ff6
0	4	4	Plazi	ffb07bec-2d10-492d-9c37-361fe0b79427	1f822ad9-a8f0-48d9-8679-f551d2107d4b
11	11	0	Plazi	ffb07bec-2d10-492d-9c37-361fe0b79427	247b6cb3-245a-4fb9-b065-5b0548b5b7ce
0	188	188	Plazi	ffb07bec-2d10-492d-9c37-361fe0b79427	250bb9d8-a388-4795-9d57-cf58791d768a
5	5	0	Plazi	ffb07bec-2d10-492d-9c37-361fe0b79427	266ff2b3-8358-436f-ad80-e07c70f2203f
2	2	0	Plazi	ffb07bec-2d10-492d-9c37-361fe0b79427	29f56b1c-400f-4fa7-a4aa-69846dbaf509
0	40	40	Colombian Biodiversity Information System	7e865cba-7c46-417b-ade5-97f2cf5b7be0	2caf9aa0-a6d5-4805-b703-17e7d6b75b99
1	1	0	Plazi	ffb07bec-2d10-492d-9c37-361fe0b79427	2cd85cea-3428-4301-bc21-0b747239ea43
1	1	0	Plazi	ffb07bec-2d10-492d-9c37-361fe0b79427	2f3b75d6-6bf8-41f8-8543-1a46cd5ca052
25	25	0	Plazi	ffb07bec-2d10-492d-9c37-361fe0b79427	343a6a67-e8bf-467c-9818-de9621bbe955
32275	32275	0	Participant Node Managers Committee	7f48e0c8-5c96-49ec-b972-30748e339115	34e5d258-a1bc-49c6-8c25-56609a300015
49	49	0	Plazi	ffb07bec-2d10-492d-9c37-361fe0b79427	38e6ea4e-2d88-4e41-9f25-38872ac5723e
13325	13325	0	GBIF Benin	efb9c00e-f802-45dd-8826-a52ec45b89ff	3914b779-bc43-4e83-9cc8-1ffbcde89db3
0	1191496	1191496	National Biodiversity Network	d897a5b9-35ee-4232-94bd-b0bcaac003c2	393b8c26-e4e0-4dd0-a218-93fc074ebf4e
402	402	0	GBIF Germany	4f6826f2-4ff6-443d-b966-e6913bd24013	39db5fbc-223a-4b45-a7dd-bf606b408a62
69	69	0	GBIF France	da44cd31-5901-4687-a106-6d1c7734ee3a	3a41254b-8ac3-4115-9970-d939025e9745
26	26	0	Plazi	ffb07bec-2d10-492d-9c37-361fe0b79427	3aa2d2ee-d0bd-48dc-adcc-ae5765651ac1
0	1	1	Plazi	ffb07bec-2d10-492d-9c37-361fe0b79427	3cd7dccc-81aa-4a0d-8831-e0b272afdbf9
241	241	0	Colombian Biodiversity Information System	7e865cba-7c46-417b-ade5-97f2cf5b7be0	3f5c177c-de90-4802-9f7b-53dbd97fbda3
2297	2297	0	National Biodiversity Network	d897a5b9-35ee-4232-94bd-b0bcaac003c2	3fa8e2b7-43c0-490e-b30e-b1902caa9bf0
0	115	115	Ocean Biodiversity Information System	ba0670b9-4186-41e6-8e70-f9cb3065551a	412a0be2-8f44-4975-a147-b0d7e8778971
0	87	87	Ocean Biodiversity Information System	ba0670b9-4186-41e6-8e70-f9cb3065551a	424d81c1-d67a-4791-8a89-f445b9569abe
199817	244118	44301	GBIF Sweden	a0b3be64-6525-4387-ac67-a499950f92e1	427a6290-0c65-11dd-84d2-b8a03c50a862
333	333	0	Society for the Management of Electronic Biodiversity Data	97818ee4-1461-4180-bf1d-b3201050124f	42ac1433-d581-4480-8336-0078141a3ca3
104	104	0	GBIF Germany	4f6826f2-4ff6-443d-b966-e6913bd24013	440be348-3a0c-11e2-b0ce-00145eb45e9a
101	104	3	National Biodiversity Network	d897a5b9-35ee-4232-94bd-b0bcaac003c2	441ea9dc-0388-42b0-aad0-3950067ad183
3842	3844	2	GBIF Norway	4f829580-180d-46a9-9c87-ed8ec959b545	44ff990f-945e-4b37-9060-fc7de856b1ea
20	20	0	U.S. Geological Survey	8618c64a-93e0-4300-b546-7249e5148ed2	47c4dad5-aff2-4f62-b3e9-ac16eb166dc3
0	1	1	Plazi	ffb07bec-2d10-492d-9c37-361fe0b79427	4e956cd3-472d-4923-8fab-908e519cd093
65	199	134	Plazi	ffb07bec-2d10-492d-9c37-361fe0b79427	4f27700d-9990-4b2a-b6e9-a5a4d699ea8d
717	717	0	GBIF Norway	4f829580-180d-46a9-9c87-ed8ec959b545	4f659137-54b4-4243-8bcb-5b2f534481c8
30255	30255	0	Atlas of Living Australia	4a6f1b71-969e-4fc5-a693-282b05e1220c	52d51b66-5ed6-4afe-a7b5-d272ca11c3c8
9094	9094	0	Biodiversity Information System of Mexico	b324e8e9-9a4c-44fa-8f1a-7f39ea7ab576	5381c29f-b090-488a-8693-0038708c904f
0	4	4	Plazi	ffb07bec-2d10-492d-9c37-361fe0b79427	556a22a2-fc8c-4750-850a-b6a131a8948d
0	462	462	GBIF Portugal	673f7038-4262-4149-b753-5658a4e912f6	55bb758c-148a-4a7a-9914-e95e2c240d9d
141	141	0	Colombian Biodiversity Information System	7e865cba-7c46-417b-ade5-97f2cf5b7be0	5629da1f-f55d-4f5e-be32-07983096fe88
286	286	0	Plazi	ffb07bec-2d10-492d-9c37-361fe0b79427	5846b72f-37ca-4033-af93-c20fb297add9
3	3	0	Plazi	ffb07bec-2d10-492d-9c37-361fe0b79427	5a675543-7b51-4621-b76f-518d8ed15c8c
3	3	0	Plazi	ffb07bec-2d10-492d-9c37-361fe0b79427	5b969e11-336f-49e4-a134-ba402d653c6f
0	78	78	GBIF Spain	1f94b3ca-9345-4d65-afe2-4bace93aa0fe	5ecc61f9-5ea0-4200-9ca7-377a452a0323
33693	33693	0	U.S. Geological Survey	8618c64a-93e0-4300-b546-7249e5148ed2	5f1568db-5d5b-4597-9c66-dfbd0d7ddd7b
35	35	0	GBIF Germany	4f6826f2-4ff6-443d-b966-e6913bd24013	61eb198e-f762-11e1-a439-00145eb45e9a
41	41	0	GBIF Germany	4f6826f2-4ff6-443d-b966-e6913bd24013	61f04620-f762-11e1-a439-00145eb45e9a
50	50	0	GBIF Germany	4f6826f2-4ff6-443d-b966-e6913bd24013	6202499c-f762-11e1-a439-00145eb45e9a
98	98	0	GBIF Germany	4f6826f2-4ff6-443d-b966-e6913bd24013	6237c1e4-f762-11e1-a439-00145eb45e9a
63	63	0	GBIF Germany	4f6826f2-4ff6-443d-b966-e6913bd24013	628d410a-f762-11e1-a439-00145eb45e9a
0	516	516	Ocean Biodiversity Information System	ba0670b9-4186-41e6-8e70-f9cb3065551a	62a9d441-8257-4a96-875e-926004fff0f0
35	35	0	GBIF Germany	4f6826f2-4ff6-443d-b966-e6913bd24013	62ba4998-f762-11e1-a439-00145eb45e9a
248	248	0	GBIF Germany	4f6826f2-4ff6-443d-b966-e6913bd24013	642083a6-f762-11e1-a439-00145eb45e9a
124	117	-7	GBIF Germany	4f6826f2-4ff6-443d-b966-e6913bd24013	6501fea8-f762-11e1-a439-00145eb45e9a
0	5	5	Ocean Biodiversity Information System	ba0670b9-4186-41e6-8e70-f9cb3065551a	651ee376-fa3a-4b7f-90fd-718385b7d4c2
691	681	-10	GBIF Germany	4f6826f2-4ff6-443d-b966-e6913bd24013	6572e9c4-f762-11e1-a439-00145eb45e9a
201	201	0	GBIF Germany	4f6826f2-4ff6-443d-b966-e6913bd24013	678f5dfa-f762-11e1-a439-00145eb45e9a
83	83	0	GBIF Germany	4f6826f2-4ff6-443d-b966-e6913bd24013	680d4b34-f762-11e1-a439-00145eb45e9a
56	56	0	GBIF Germany	4f6826f2-4ff6-443d-b966-e6913bd24013	68b80632-f762-11e1-a439-00145eb45e9a
57	57	0	GBIF Germany	4f6826f2-4ff6-443d-b966-e6913bd24013	68ee80fe-f762-11e1-a439-00145eb45e9a
49	49	0	GBIF Germany	4f6826f2-4ff6-443d-b966-e6913bd24013	690b7b78-f762-11e1-a439-00145eb45e9a
16	16	0	GBIF Germany	4f6826f2-4ff6-443d-b966-e6913bd24013	6a0d28a0-f762-11e1-a439-00145eb45e9a
8	8	0	GBIF Germany	4f6826f2-4ff6-443d-b966-e6913bd24013	6aec3d38-f762-11e1-a439-00145eb45e9a
26	26	0	Plazi	ffb07bec-2d10-492d-9c37-361fe0b79427	6b2301e0-2fff-4d76-ac54-beb75b6fa93d
0	15	15	Plazi	ffb07bec-2d10-492d-9c37-361fe0b79427	6c93d97d-8c62-4fbb-b328-e78ec1c6a081
1387	1387	0	GBIF Germany	4f6826f2-4ff6-443d-b966-e6913bd24013	6db74864-f762-11e1-a439-00145eb45e9a
426	426	0	GBIF Germany	4f6826f2-4ff6-443d-b966-e6913bd24013	6f666db0-7b94-483a-a1c1-0c2c7e1e578a
0	4	4	Plazi	ffb07bec-2d10-492d-9c37-361fe0b79427	6f8235dd-d3f7-44d9-a2a6-c5836eda3138
32	32	0	National Biodiversity Network	d897a5b9-35ee-4232-94bd-b0bcaac003c2	6fa048ce-0d12-49a4-81b9-7537214bdc78
56	56	0	Biodiversity Information System of Mexico	b324e8e9-9a4c-44fa-8f1a-7f39ea7ab576	6fb8928b-9fa0-4481-be81-35413c7e4840
92	92	0	GBIF Germany	4f6826f2-4ff6-443d-b966-e6913bd24013	71c38d3c-f762-11e1-a439-00145eb45e9a
6871	10871	4000	GBIF Japan	db5705aa-6a6e-42f1-8942-d77b9f4896ea	71efa00f-97b8-4dcd-a4b1-712b812d6c7d
18	18	0	GBIF Germany	4f6826f2-4ff6-443d-b966-e6913bd24013	7291ad66-f762-11e1-a439-00145eb45e9a
0	24	24	Plazi	ffb07bec-2d10-492d-9c37-361fe0b79427	738a527f-3aab-47cb-b0cb-b622fd40a7b8
18	18	0	GBIF Germany	4f6826f2-4ff6-443d-b966-e6913bd24013	740af274-f762-11e1-a439-00145eb45e9a
0	12	12	Plazi	ffb07bec-2d10-492d-9c37-361fe0b79427	79a59003-4567-44b2-af12-2a7ac58ad444
50	50	0	GBIF Germany	4f6826f2-4ff6-443d-b966-e6913bd24013	79e7a732-f762-11e1-a439-00145eb45e9a
748	132	-616	GBIF Germany	4f6826f2-4ff6-443d-b966-e6913bd24013	79f5922a-f762-11e1-a439-00145eb45e9a
1	1	0	GBIF Germany	4f6826f2-4ff6-443d-b966-e6913bd24013	7aaf7a6e-f762-11e1-a439-00145eb45e9a
3794	3794	0	Colombian Biodiversity Information System	7e865cba-7c46-417b-ade5-97f2cf5b7be0	7ae20239-e677-4943-9699-28939a796e24
0	435	435	Ocean Biodiversity Information System	ba0670b9-4186-41e6-8e70-f9cb3065551a	7b3b8c69-23a5-43c1-bca0-2e719ba7dc6f
10928	10928	0	Canada Biodiversity Information Facility	8f83fc96-c966-4126-83f7-bf044dc49efa	7b4543e2-437d-4635-ac11-6a38007f6287
406	406	0	Atlas of Living Australia	4a6f1b71-969e-4fc5-a693-282b05e1220c	7b582e40-5480-4da6-95b3-7d2386f5cac2
3030	3047	17	GBIF Germany	4f6826f2-4ff6-443d-b966-e6913bd24013	7b9e97de-f762-11e1-a439-00145eb45e9a
745	745	0	GBIF Germany	4f6826f2-4ff6-443d-b966-e6913bd24013	7c24798a-f762-11e1-a439-00145eb45e9a
170	170	0	GBIF Germany	4f6826f2-4ff6-443d-b966-e6913bd24013	7c3fa69c-f762-11e1-a439-00145eb45e9a
933	933	0	GBIF Germany	4f6826f2-4ff6-443d-b966-e6913bd24013	7d18715c-f762-11e1-a439-00145eb45e9a
1265	920	-345	GBIF Germany	4f6826f2-4ff6-443d-b966-e6913bd24013	7d5f8b6e-f762-11e1-a439-00145eb45e9a
0	16	16	Plazi	ffb07bec-2d10-492d-9c37-361fe0b79427	7dfe533a-40f2-435c-8b08-e9ea9cb1a070
245	245	0	GBIF Germany	4f6826f2-4ff6-443d-b966-e6913bd24013	7eca2d56-f762-11e1-a439-00145eb45e9a
18	18	0	GBIF Germany	4f6826f2-4ff6-443d-b966-e6913bd24013	7f379d96-f762-11e1-a439-00145eb45e9a
85	85	0	Plazi	ffb07bec-2d10-492d-9c37-361fe0b79427	7f45fc71-fc58-4ca9-a320-5052c4aeba9d
562	562	0	GBIF Germany	4f6826f2-4ff6-443d-b966-e6913bd24013	7f4b25be-f762-11e1-a439-00145eb45e9a
816	816	0	Biodiversity Information System of Mexico	b324e8e9-9a4c-44fa-8f1a-7f39ea7ab576	8005e570-f762-11e1-a439-00145eb45e9a
2	2	0	GBIF Japan	db5705aa-6a6e-42f1-8942-d77b9f4896ea	80ef0caa-f762-11e1-a439-00145eb45e9a
362	362	0	GBIF Spain	1f94b3ca-9345-4d65-afe2-4bace93aa0fe	810f3e62-f762-11e1-a439-00145eb45e9a
180	180	0	GBIF Germany	4f6826f2-4ff6-443d-b966-e6913bd24013	822d13d2-f762-11e1-a439-00145eb45e9a
1321	1321	0	National Biodiversity Network	d897a5b9-35ee-4232-94bd-b0bcaac003c2	8279463f-09ae-46e1-bc20-4efe84e35e7d
846	282	-564	GBIF Germany	4f6826f2-4ff6-443d-b966-e6913bd24013	82c88aa3-a905-4e97-a002-f2968ed3155b
153815	153815	0	Atlas of Living Australia	4a6f1b71-969e-4fc5-a693-282b05e1220c	82dd797a-f762-11e1-a439-00145eb45e9a
4697245	4697245	0	GBIF France	da44cd31-5901-4687-a106-6d1c7734ee3a	857aa892-f762-11e1-a439-00145eb45e9a
477	414	-63	GBIF Germany	4f6826f2-4ff6-443d-b966-e6913bd24013	86e21f94-f762-11e1-a439-00145eb45e9a
1482	1411	-71	GBIF Germany	4f6826f2-4ff6-443d-b966-e6913bd24013	872f2fe6-f762-11e1-a439-00145eb45e9a
296	147	-149	GBIF Germany	4f6826f2-4ff6-443d-b966-e6913bd24013	8790a6ea-f762-11e1-a439-00145eb45e9a
15	15	0	Plazi	ffb07bec-2d10-492d-9c37-361fe0b79427	87bc8f85-1dad-4a65-91ce-ada2307ff676
497	353	-144	GBIF Germany	4f6826f2-4ff6-443d-b966-e6913bd24013	87e2da82-f762-11e1-a439-00145eb45e9a
733	533	-200	GBIF Germany	4f6826f2-4ff6-443d-b966-e6913bd24013	87f760f6-f762-11e1-a439-00145eb45e9a
0	18	18	Plazi	ffb07bec-2d10-492d-9c37-361fe0b79427	8932da60-1a36-4101-a0c2-a126de745429
29	29	0	Plazi	ffb07bec-2d10-492d-9c37-361fe0b79427	8b277405-a91c-4d0c-b77e-8b1d4820c7cd
0	29	29	Plazi	ffb07bec-2d10-492d-9c37-361fe0b79427	8c168eb0-5d72-4b5c-aa9b-0b25ce1c0416
27	23	-4	GBIF Germany	4f6826f2-4ff6-443d-b966-e6913bd24013	8cc0656a-f762-11e1-a439-00145eb45e9a
0	36	36	Plazi	ffb07bec-2d10-492d-9c37-361fe0b79427	8cd8a768-c115-4b2e-8167-f9ae52eb4f80
525	525	0	GBIF France	da44cd31-5901-4687-a106-6d1c7734ee3a	8e9d17b5-b45f-4f54-ae3e-2f1c1ef9615a
154	154	0	GBIF Germany	4f6826f2-4ff6-443d-b966-e6913bd24013	8f1d4ba2-f762-11e1-a439-00145eb45e9a
1989	1853	-136	GBIF Germany	4f6826f2-4ff6-443d-b966-e6913bd24013	8f758632-f762-11e1-a439-00145eb45e9a
613	212	-401	GBIF Germany	4f6826f2-4ff6-443d-b966-e6913bd24013	90f346a2-f762-11e1-a439-00145eb45e9a
12562	12562	0	GBIF France	da44cd31-5901-4687-a106-6d1c7734ee3a	90f9376e-3e89-4b09-95f9-2c5f6f990185
46	37	-9	GBIF Germany	4f6826f2-4ff6-443d-b966-e6913bd24013	92939994-f762-11e1-a439-00145eb45e9a
474	456	-18	GBIF Germany	4f6826f2-4ff6-443d-b966-e6913bd24013	9358d8e4-f762-11e1-a439-00145eb45e9a
0	3	3	Plazi	ffb07bec-2d10-492d-9c37-361fe0b79427	93a4c88d-4349-455f-bcbe-be671226ed0a
340	342	2	GBIF Germany	4f6826f2-4ff6-443d-b966-e6913bd24013	94eedd2a-f762-11e1-a439-00145eb45e9a
55	56	1	GBIF Germany	4f6826f2-4ff6-443d-b966-e6913bd24013	94f45282-f762-11e1-a439-00145eb45e9a
1144	1144	0	National Biodiversity Network	d897a5b9-35ee-4232-94bd-b0bcaac003c2	9eadfdd8-fce4-4983-9ef2-4ddf4ed06a48
13	13	0	Plazi	ffb07bec-2d10-492d-9c37-361fe0b79427	a0474a9e-7489-4896-b5a5-f95f926e5dee
17974	17974	0	National Biodiversity Network	d897a5b9-35ee-4232-94bd-b0bcaac003c2	a0494a31-ad77-4c86-8067-a14abf095b01
5413	5413	0	GBIF Kenya	2a44d626-9f7a-4120-8a7a-4ab5ac15ff2a	a1857da2-d5b1-48e3-ac40-6a8622f0167d
5150	5150	0	GBIF France	da44cd31-5901-4687-a106-6d1c7734ee3a	a2f64499-520f-49bd-bc5e-225657a505a0
2	2	0	Plazi	ffb07bec-2d10-492d-9c37-361fe0b79427	a4b0f734-1cf2-41e7-88fd-a94ceb8d1505
5	5	0	Plazi	ffb07bec-2d10-492d-9c37-361fe0b79427	a78cffa6-1614-452e-a90c-28fa3b0cec56
0	3	3	Plazi	ffb07bec-2d10-492d-9c37-361fe0b79427	a85e8f06-95fa-467d-8d09-c49f593271a3
117	117	0	South African Biodiversity Information Facility	7190b835-4e86-4b6e-85c1-19cc6677c250	a868444f-329e-47f7-b3e6-1297a0dfbcb7
25867	26917	1050	GBIF Brazil	cdc9736d-5ff7-4ece-9959-3c744360cdb3	a8e78a51-12b2-4ca1-8945-6d909022ef6a
5	5	0	Plazi	ffb07bec-2d10-492d-9c37-361fe0b79427	a99a719d-a39e-4471-b1b9-ee93435ce5bf
24	24	0	Plazi	ffb07bec-2d10-492d-9c37-361fe0b79427	ad746972-3837-4f1d-bf97-c09e5d7f1bd5
367	367	0	GBIF Germany	4f6826f2-4ff6-443d-b966-e6913bd24013	ae0f374b-19f3-4bd9-9f96-3eb8512f2fd2
24	24	0	Canada Biodiversity Information Facility	8f83fc96-c966-4126-83f7-bf044dc49efa	b065a152-9f83-4944-9ea0-545ac0703c35
2041	2041	0	National Biodiversity Network	d897a5b9-35ee-4232-94bd-b0bcaac003c2	b111fc04-69ba-48e0-a6f4-9c4fc7b26809
0	36	36	Plazi	ffb07bec-2d10-492d-9c37-361fe0b79427	b2e22338-e62a-4b58-8251-fe53214da8f3
0	14	14	Plazi	ffb07bec-2d10-492d-9c37-361fe0b79427	b46f8fa7-0a31-431c-9fcf-fd09c54e0564
3832	3832	0	National Biodiversity Network	d897a5b9-35ee-4232-94bd-b0bcaac003c2	b5150343-1c3e-4a8a-bc0b-fbfb06ebe077
1	1	0	Plazi	ffb07bec-2d10-492d-9c37-361fe0b79427	b6818bab-fbba-4eff-80a3-c9f43735e427
38	38	0	GBIF Argentina	2426a871-9feb-40a1-96c6-0c593a76b835	b695fa2a-c2dd-4ab2-a623-159a33cf9c92
2	2	0	Plazi	ffb07bec-2d10-492d-9c37-361fe0b79427	b702fa97-f8dc-4e53-93ef-b1049d2890bb
6	6	0	Plazi	ffb07bec-2d10-492d-9c37-361fe0b79427	b829c9bf-1291-46fb-90ae-f5fc7e4af81d
37	37	0	U.S. Geological Survey	8618c64a-93e0-4300-b546-7249e5148ed2	b87a59e8-12bd-490b-a6b0-e7db3bff2958
1493	1493	0	GBIF France	da44cd31-5901-4687-a106-6d1c7734ee3a	b9214eb9-51fd-41ca-9f14-a682349be69b
13180	13180	0	Participant Node Managers Committee	7f48e0c8-5c96-49ec-b972-30748e339115	bd09b03d-6bb7-4ab5-a2a8-799a0d132e16
478	478	0	Colombian Biodiversity Information System	7e865cba-7c46-417b-ade5-97f2cf5b7be0	bd5e52fe-b688-4a01-a791-3458f43c1475
6724	6724	0	Participant Node Managers Committee	7f48e0c8-5c96-49ec-b972-30748e339115	c3b0e0ff-def0-40dd-b72d-cbe5e79c1213
0	4679	4679	Korean Biodiversity Information Facility	e0a1e772-0177-4800-94b4-2d023fe6cdf4	c4d41fc6-0e76-409f-894a-8f669930743c
40	40	0	Plazi	ffb07bec-2d10-492d-9c37-361fe0b79427	c4fb2d83-3196-432f-85d3-19681e94ed9a
0	14	14	Plazi	ffb07bec-2d10-492d-9c37-361fe0b79427	c5d56758-ab92-4965-9c0c-852961456f18
388	388	0	Colombian Biodiversity Information System	7e865cba-7c46-417b-ade5-97f2cf5b7be0	c96b4c4a-903b-4f01-8f05-4d37acdefdb8
287870	287870	0	U.S. Geological Survey	8618c64a-93e0-4300-b546-7249e5148ed2	ccddb599-33cb-4206-bbb9-d8dc641c70cd
363582	363582	0	U.S. Geological Survey	8618c64a-93e0-4300-b546-7249e5148ed2	cf7d6c01-309b-4545-8319-3d53b1e8bfd0
0	39	39	Plazi	ffb07bec-2d10-492d-9c37-361fe0b79427	d1902871-8128-49e0-ad62-f613a1418bec
24676	24676	0	Participant Node Managers Committee	7f48e0c8-5c96-49ec-b972-30748e339115	d1f724bf-8d68-49c8-a87f-5c9e7a7b9deb
2	2	0	Plazi	ffb07bec-2d10-492d-9c37-361fe0b79427	d26aae50-4574-4737-b769-ae966a8b4e50
1	1	0	Plazi	ffb07bec-2d10-492d-9c37-361fe0b79427	d2bfb427-4b03-42e8-b836-ed48811d8013
26	26	0	Participant Node Managers Committee	7f48e0c8-5c96-49ec-b972-30748e339115	d314a5d4-ef46-465b-a008-00337afcd1f0
0	8889	8889	GBIF Finland	dd514216-5c7c-45f3-910d-797424cb5be6	d34156ac-83af-4c33-9686-cc71a1045826
2	2	0	Plazi	ffb07bec-2d10-492d-9c37-361fe0b79427	d3c680b5-3861-49f4-b42c-e2c9261b608b
0	46	46	Plazi	ffb07bec-2d10-492d-9c37-361fe0b79427	d6326c1a-0e7e-4953-99a0-fbdc425fd0e3
0	439	439	Indonesian Biodiversity Information Facility	2ebd91f6-f14f-4375-b525-c011a3774f03	d7c0b774-b885-4aaf-9f0f-b9666bff6041
0	1	1	Plazi	ffb07bec-2d10-492d-9c37-361fe0b79427	db0408ae-59dc-4341-9f1b-cd701efe666d
429	429	0	GBIF France	da44cd31-5901-4687-a106-6d1c7734ee3a	dcb4276b-4fa5-445a-ac8f-6d9937971a0a
21663	21663	0	Society for the Management of Electronic Biodiversity Data	97818ee4-1461-4180-bf1d-b3201050124f	deae7cbd-0c20-422f-a7f9-4e8acfb57c4a
8	8	0	GBIF Germany	4f6826f2-4ff6-443d-b966-e6913bd24013	df42f5ff-36b0-43a6-a19b-389616ba6e28
0	14	14	Ocean Biodiversity Information System	ba0670b9-4186-41e6-8e70-f9cb3065551a	e1d9e966-8203-42dc-aec0-8d150bd1c26a
16252	16252	0	National Biodiversity Network	d897a5b9-35ee-4232-94bd-b0bcaac003c2	e3004062-f320-4d91-8192-3ec889e468dc
60	60	0	GBIF France	da44cd31-5901-4687-a106-6d1c7734ee3a	e35a9528-9025-42f5-b12c-981468b2ddaf
0	25	25	Plazi	ffb07bec-2d10-492d-9c37-361fe0b79427	e3dca285-34d8-4962-bfda-994d705a4a53
3	3	0	Plazi	ffb07bec-2d10-492d-9c37-361fe0b79427	e86137f5-0717-47ec-9020-c67fb9c1c375
23648	23648	0	National Biodiversity Network	d897a5b9-35ee-4232-94bd-b0bcaac003c2	e87e14f1-76e9-48a1-8378-98cc909eb301
0	78	78	Plazi	ffb07bec-2d10-492d-9c37-361fe0b79427	e92d07ad-4aac-4bf8-8364-f384530f3a4d
1	1	0	Plazi	ffb07bec-2d10-492d-9c37-361fe0b79427	e9bfa59c-7aac-46af-a3a3-df50b444c2d4
2163	2163	0	National Biodiversity Network	d897a5b9-35ee-4232-94bd-b0bcaac003c2	f198188d-e4cb-4a1f-bfaa-8e45ff7edc85
154	154	0	Biodiversity Information System of Mexico	b324e8e9-9a4c-44fa-8f1a-7f39ea7ab576	f3731814-d8c3-4ab3-8a1f-90ac27e98d4f
254	391	137	Colombian Biodiversity Information System	7e865cba-7c46-417b-ade5-97f2cf5b7be0	f37bf1a6-2944-4964-862f-4a4e50888d41
3	3	0	Plazi	ffb07bec-2d10-492d-9c37-361fe0b79427	fa2a8829-46bb-450e-afc5-5f64cd3371f1
3113	3113	0	GBIF Norway	4f829580-180d-46a9-9c87-ed8ec959b545	fcb19622-6d6d-470f-9371-86e1210f9ee3
2077	2918	841	National Biodiversity Network	d897a5b9-35ee-4232-94bd-b0bcaac003c2	febe3d7b-59a7-45c1-abbd-bd610e85823b
0	12	12	Plazi	ffb07bec-2d10-492d-9c37-361fe0b79427	febe7015-6a1e-4b70-9a8e-badc3810cf50
12583	12583	0	Biodiversity Information System of Mexico	b324e8e9-9a4c-44fa-8f1a-7f39ea7ab576	0159cf6b-6a46-4365-96f1-d7ca2511f082
0	2	2	Plazi	ffb07bec-2d10-492d-9c37-361fe0b79427	01c06a0e-b076-4faa-8e71-fb8cd4f923b1
899	899	0	GBIF France	da44cd31-5901-4687-a106-6d1c7734ee3a	02743f84-b52a-433f-8482-f54bc86014b7
7	7	0	Plazi	ffb07bec-2d10-492d-9c37-361fe0b79427	04799c8c-e8fc-4f8c-b619-c5aa5289a797
2	2	0	Plazi	ffb07bec-2d10-492d-9c37-361fe0b79427	06222f59-9be8-453f-a930-560644d4f716
696	696	0	U.S. Geological Survey	8618c64a-93e0-4300-b546-7249e5148ed2	07be324e-bcf5-4e83-b9cc-dc2a962fba30
2	2	0	Plazi	ffb07bec-2d10-492d-9c37-361fe0b79427	09feb5cb-d61b-4d34-89cc-9cd790095da4
327	327	0	Colombian Biodiversity Information System	7e865cba-7c46-417b-ade5-97f2cf5b7be0	0c293704-8a60-4da4-b64d-2f6679794753
24	24	0	Plazi	ffb07bec-2d10-492d-9c37-361fe0b79427	0e59b981-a2a3-4369-80d9-76bffa753d8b
8195	8195	0	Colombian Biodiversity Information System	7e865cba-7c46-417b-ade5-97f2cf5b7be0	0e7f5125-0e37-4a93-9a2e-939e770c7bfd
588	588	0	GBIF Benin	efb9c00e-f802-45dd-8826-a52ec45b89ff	107c4e84-79a1-4e3f-b96b-77d87d723628
0	11656	11656	National Biodiversity Network	d897a5b9-35ee-4232-94bd-b0bcaac003c2	11ddb6e5-7bc8-4478-9e80-5c85c1a08ae2
61976	61976	0	National Biodiversity Network	d897a5b9-35ee-4232-94bd-b0bcaac003c2	17dd59b2-0266-418d-bdb7-db458cb91796
3191	3705	514	U.S. Geological Survey	8618c64a-93e0-4300-b546-7249e5148ed2	187a7e8e-bee1-4933-9783-454103386c26
0	43164	43164	Taiwan Biodiversity Information Facility	e1b85abc-61f9-430f-ba79-6813dec53a0f	19c3400b-b7bb-425f-b8c5-f222648b86b2
6541	6541	0	Belgian Biodiversity Platform	fb11cfe1-ebc3-45af-9159-17d9fddbcdac	1a1d6a39-8651-49a1-a75c-e379a45429bf
0	101	101	Plazi	ffb07bec-2d10-492d-9c37-361fe0b79427	1abcb62d-e2d8-4daf-9d33-7acb0cbd9580
7	7	0	Plazi	ffb07bec-2d10-492d-9c37-361fe0b79427	1cbb2068-bb21-47e4-bfab-451de197614c
698	698	0	GBIF France	da44cd31-5901-4687-a106-6d1c7734ee3a	1e7f2660-7d54-41a2-993c-e5ee7030af8c
23	23	0	Plazi	ffb07bec-2d10-492d-9c37-361fe0b79427	20e8e8c5-edcc-4a16-a5e1-78745d5b9b19
47499	47499	0	GBIF Germany	4f6826f2-4ff6-443d-b966-e6913bd24013	21448e32-117a-11e3-a753-00145eb45e9a
0	5	5	Plazi	ffb07bec-2d10-492d-9c37-361fe0b79427	254ea831-1224-438d-862b-116ad75bf1b5
258	258	0	GBIF Malawi	2a42e4d7-ad4a-41b3-84c4-de4aa7b74d35	25cf9b9b-4bf8-46c4-b85c-7a08933b1577
0	1201	1201	Colombian Biodiversity Information System	7e865cba-7c46-417b-ade5-97f2cf5b7be0	260e6088-86f8-4f56-a2ff-87dc75ae59c7
0	7291	7291	Korean Biodiversity Information Facility	e0a1e772-0177-4800-94b4-2d023fe6cdf4	2b59bcd1-e175-4652-9883-5e50d5238e49
3070	3070	0	Colombian Biodiversity Information System	7e865cba-7c46-417b-ade5-97f2cf5b7be0	2de2f65e-7031-4844-a461-687b8c197689
5	5	0	Plazi	ffb07bec-2d10-492d-9c37-361fe0b79427	30702932-451e-47b8-9f34-b42593328f29
0	17	17	Participant Node Managers Committee	7f48e0c8-5c96-49ec-b972-30748e339115	31171934-aad4-48ac-888e-e56d9feec596
59	59	0	GBIF France	da44cd31-5901-4687-a106-6d1c7734ee3a	31e2d744-70d1-4636-a859-cdaac6217567
462	462	0	GBIF France	da44cd31-5901-4687-a106-6d1c7734ee3a	349a84b7-07b3-464c-a221-bd0763bcf44f
0	2	2	Plazi	ffb07bec-2d10-492d-9c37-361fe0b79427	357ed589-53bf-4c0f-89af-bdbf9cfe94ac
56847	78779	21932	GBIF Spain	1f94b3ca-9345-4d65-afe2-4bace93aa0fe	35e0cdd1-d493-4a73-bca8-2850c61ef79f
61	61	0	Participant Node Managers Committee	7f48e0c8-5c96-49ec-b972-30748e339115	37fd6348-6c0f-4916-9db9-579e5defa72a
23562	23562	0	Participant Node Managers Committee	7f48e0c8-5c96-49ec-b972-30748e339115	403fabe5-b960-4dc3-9e13-32f479a0b798
0	13	13	Plazi	ffb07bec-2d10-492d-9c37-361fe0b79427	419f5c3a-2e7c-4302-921b-c4e42dde7b5a
0	1	1	Plazi	ffb07bec-2d10-492d-9c37-361fe0b79427	41c24aa8-401c-4cd2-8fb5-7259304ba71b
3	3	0	Plazi	ffb07bec-2d10-492d-9c37-361fe0b79427	435c2851-0ddb-484b-8cd0-32567cb7f22f
1	1	0	Plazi	ffb07bec-2d10-492d-9c37-361fe0b79427	44b432cb-4965-47ea-8ca8-ff039e214ae8
4	4	0	Plazi	ffb07bec-2d10-492d-9c37-361fe0b79427	44c193ae-b881-4936-a1b9-cc2729805047
0	7	7	Plazi	ffb07bec-2d10-492d-9c37-361fe0b79427	45f1bda5-b5c4-4c57-9f4c-b3a397d2bb83
477	477	0	GBIF France	da44cd31-5901-4687-a106-6d1c7734ee3a	47f5955a-0543-4fd6-bf29-b359bed9ab54
1416	1416	0	GBIF Germany	4f6826f2-4ff6-443d-b966-e6913bd24013	48d986ec-a2df-41c8-93c0-335404634967
0	13	13	Plazi	ffb07bec-2d10-492d-9c37-361fe0b79427	4d54c85b-7149-43ec-9c1d-8dfb1a575b4a
0	87	87	Plazi	ffb07bec-2d10-492d-9c37-361fe0b79427	504278d0-5689-4adb-9350-3e97392bfbf0
6	6	0	Plazi	ffb07bec-2d10-492d-9c37-361fe0b79427	529338ac-ef1b-4c01-93da-857bc2a346dc
102717	102717	0	National Biodiversity Network	d897a5b9-35ee-4232-94bd-b0bcaac003c2	53b2eff2-5b6f-494d-a23f-383ddfd265f0
0	7	7	Plazi	ffb07bec-2d10-492d-9c37-361fe0b79427	54b60ce2-158f-4ce8-a9b0-f42b60242162
0	4	4	Plazi	ffb07bec-2d10-492d-9c37-361fe0b79427	5572f2ca-47f3-49a3-9e11-6ba404d5cb3e
4	4	0	Plazi	ffb07bec-2d10-492d-9c37-361fe0b79427	58e1ba03-dbc7-499b-8899-2d71dcd79f97
8374	8605	231	GBIF Brazil	cdc9736d-5ff7-4ece-9959-3c744360cdb3	5bad80c7-8b9e-448a-84fe-df70288f16ac
50	50	0	Plazi	ffb07bec-2d10-492d-9c37-361fe0b79427	5bcd4e84-f122-4429-ac40-4ec95fe2de29
26014	26014	0	Colombian Biodiversity Information System	7e865cba-7c46-417b-ade5-97f2cf5b7be0	5f78d639-26ec-473b-90c9-4efe59a0632d
2	2	0	Plazi	ffb07bec-2d10-492d-9c37-361fe0b79427	5fb59523-3c5c-47eb-adeb-1640f98dfb75
20	20	0	Plazi	ffb07bec-2d10-492d-9c37-361fe0b79427	61eb0831-d3a2-4010-b809-3c4376e6d89c
168	168	0	GBIF France	da44cd31-5901-4687-a106-6d1c7734ee3a	61fb5bd6-acf4-4fe5-87e0-14af93e4cb32
81	81	0	GBIF Germany	4f6826f2-4ff6-443d-b966-e6913bd24013	6290fa70-f762-11e1-a439-00145eb45e9a
2730	2730	0	Participant Node Managers Committee	7f48e0c8-5c96-49ec-b972-30748e339115	638165c0-21d4-4d8e-9c35-b9dbb2a97095
1	1	0	Plazi	ffb07bec-2d10-492d-9c37-361fe0b79427	63b342d8-66ca-44fb-a650-f072fbdf6890
107	107	0	GBIF Germany	4f6826f2-4ff6-443d-b966-e6913bd24013	63fa29a4-f762-11e1-a439-00145eb45e9a
102	102	0	GBIF Germany	4f6826f2-4ff6-443d-b966-e6913bd24013	6450ab9e-f762-11e1-a439-00145eb45e9a
129	129	0	GBIF Germany	4f6826f2-4ff6-443d-b966-e6913bd24013	645bafe4-f762-11e1-a439-00145eb45e9a
19	19	0	GBIF Germany	4f6826f2-4ff6-443d-b966-e6913bd24013	64e6d40c-f762-11e1-a439-00145eb45e9a
143	141	-2	GBIF Germany	4f6826f2-4ff6-443d-b966-e6913bd24013	659abf08-f762-11e1-a439-00145eb45e9a
13981	13981	0	Korean Biodiversity Information Facility	e0a1e772-0177-4800-94b4-2d023fe6cdf4	65bdd8e3-a27b-4b88-998d-dfb27d528206
26	20	-6	GBIF Germany	4f6826f2-4ff6-443d-b966-e6913bd24013	65c2a586-f762-11e1-a439-00145eb45e9a
96	96	0	Colombian Biodiversity Information System	7e865cba-7c46-417b-ade5-97f2cf5b7be0	663bce18-2448-4666-9760-ee07bbded2fa
99	99	0	GBIF Germany	4f6826f2-4ff6-443d-b966-e6913bd24013	675fbe55-7723-4f09-b4a0-bcd5122bc546
543	543	0	GBIF Germany	4f6826f2-4ff6-443d-b966-e6913bd24013	68add807-2fb7-4b1a-afb3-40368f5fab24
42	42	0	GBIF Germany	4f6826f2-4ff6-443d-b966-e6913bd24013	68b4314c-f762-11e1-a439-00145eb45e9a
4035	4035	0	Participant Node Managers Committee	7f48e0c8-5c96-49ec-b972-30748e339115	69a84027-2b96-49ea-8011-d8030c94bfa9
16	16	0	GBIF Germany	4f6826f2-4ff6-443d-b966-e6913bd24013	6afadda2-f762-11e1-a439-00145eb45e9a
24	24	0	GBIF Germany	4f6826f2-4ff6-443d-b966-e6913bd24013	6b3c4954-f762-11e1-a439-00145eb45e9a
51	51	0	GBIF Germany	4f6826f2-4ff6-443d-b966-e6913bd24013	6c7a572a-f762-11e1-a439-00145eb45e9a
0	2	2	Plazi	ffb07bec-2d10-492d-9c37-361fe0b79427	6ccfe17d-9a3b-47ab-af22-06c967dd89f2
1	1	0	Plazi	ffb07bec-2d10-492d-9c37-361fe0b79427	6ed39f35-d841-4ee0-866e-6e2b2417913d
118	118	0	GBIF Germany	4f6826f2-4ff6-443d-b966-e6913bd24013	702e1776-f762-11e1-a439-00145eb45e9a
122	122	0	GBIF Germany	4f6826f2-4ff6-443d-b966-e6913bd24013	70fee748-f762-11e1-a439-00145eb45e9a
0	8	8	Plazi	ffb07bec-2d10-492d-9c37-361fe0b79427	72fbd015-d727-4e48-b8e1-54496db6c932
9	9	0	Plazi	ffb07bec-2d10-492d-9c37-361fe0b79427	7390d4e0-93bd-4412-828b-4a2c5452feff
158	158	0	GBIF Germany	4f6826f2-4ff6-443d-b966-e6913bd24013	74a3dc32-f762-11e1-a439-00145eb45e9a
68	68	0	Colombian Biodiversity Information System	7e865cba-7c46-417b-ade5-97f2cf5b7be0	761e94b6-e172-433f-a9c7-12efff6b217d
42	42	0	GBIF Germany	4f6826f2-4ff6-443d-b966-e6913bd24013	787701cc-f762-11e1-a439-00145eb45e9a
241	241	0	Participant Node Managers Committee	7f48e0c8-5c96-49ec-b972-30748e339115	78fb84f9-b5e1-4067-a1b1-730aca8c1bdc
222	219	-3	GBIF Germany	4f6826f2-4ff6-443d-b966-e6913bd24013	796ba3bc-f762-11e1-a439-00145eb45e9a
3462	3299	-163	GBIF Germany	4f6826f2-4ff6-443d-b966-e6913bd24013	79eb2e98-f762-11e1-a439-00145eb45e9a
919	919	0	GBIF France	da44cd31-5901-4687-a106-6d1c7734ee3a	79f4fa93-c0b7-41f8-80bf-51de540041d6
754	593	-161	GBIF Germany	4f6826f2-4ff6-443d-b966-e6913bd24013	7a108aee-f762-11e1-a439-00145eb45e9a
27	27	0	GBIF Germany	4f6826f2-4ff6-443d-b966-e6913bd24013	7a813078-f762-11e1-a439-00145eb45e9a
51	51	0	Colombian Biodiversity Information System	7e865cba-7c46-417b-ade5-97f2cf5b7be0	7ab3ce4f-0cc8-4819-851e-c46a5c185773
2020	2020	0	Korean Biodiversity Information Facility	e0a1e772-0177-4800-94b4-2d023fe6cdf4	7b00428c-f762-11e1-a439-00145eb45e9a
1000	1000	0	Korean Biodiversity Information Facility	e0a1e772-0177-4800-94b4-2d023fe6cdf4	7b2a1008-f762-11e1-a439-00145eb45e9a
936	936	0	Atlas of Living Australia	4a6f1b71-969e-4fc5-a693-282b05e1220c	7b6f0500-f762-11e1-a439-00145eb45e9a
5948	4981	-967	GBIF Germany	4f6826f2-4ff6-443d-b966-e6913bd24013	7c09ea0c-f762-11e1-a439-00145eb45e9a
13	13	0	National Biodiversity Network	d897a5b9-35ee-4232-94bd-b0bcaac003c2	7c570136-9eb9-4bb3-ba2b-65b51f4c0ef1
13573	13573	0	National Biodiversity Network	d897a5b9-35ee-4232-94bd-b0bcaac003c2	7c6b6f36-ecab-4ac7-b72c-30e8f501d06f
1	1	0	Plazi	ffb07bec-2d10-492d-9c37-361fe0b79427	7d7649b6-c602-48cc-aa98-9a5832aff65c
189839	194285	4446	U.S. Geological Survey	8618c64a-93e0-4300-b546-7249e5148ed2	7dd6e9f8-f252-42c9-bd34-221716095973
4664	4664	0	GBIF Kenya	2a44d626-9f7a-4120-8a7a-4ab5ac15ff2a	7f66928f-2995-44d1-9a13-5cd263d5708c
6326	1817	-4509	Biodiversity Information System of Mexico	b324e8e9-9a4c-44fa-8f1a-7f39ea7ab576	7f6dc132-f762-11e1-a439-00145eb45e9a
39	39	0	Plazi	ffb07bec-2d10-492d-9c37-361fe0b79427	80ac1017-65a3-434c-8436-e8701f7761df
1881	1881	0	GBIF Germany	4f6826f2-4ff6-443d-b966-e6913bd24013	8148cc22-f762-11e1-a439-00145eb45e9a
1916	1916	0	GBIF France	da44cd31-5901-4687-a106-6d1c7734ee3a	81a93d4b-cfd7-44e0-9a95-f9250d07b60e
53	53	0	GBIF Germany	4f6826f2-4ff6-443d-b966-e6913bd24013	82571bbe-f762-11e1-a439-00145eb45e9a
88302	88302	0	GBIF Spain	1f94b3ca-9345-4d65-afe2-4bace93aa0fe	838a6ba8-f762-11e1-a439-00145eb45e9a
0	2	2	Plazi	ffb07bec-2d10-492d-9c37-361fe0b79427	85728f6c-b858-42db-ad52-9195cb420166
66	66	0	GBIF Germany	4f6826f2-4ff6-443d-b966-e6913bd24013	85de82d6-f762-11e1-a439-00145eb45e9a
131719	140719	9000	GBIF Japan	db5705aa-6a6e-42f1-8942-d77b9f4896ea	8682e420-f762-11e1-a439-00145eb45e9a
1150	1150	0	Ocean Biodiversity Information System	ba0670b9-4186-41e6-8e70-f9cb3065551a	8928e328-f762-11e1-a439-00145eb45e9a
108	108	0	Plazi	ffb07bec-2d10-492d-9c37-361fe0b79427	8945f8b0-4be3-4e60-8338-3916fdece1a5
546	546	0	GBIF Germany	4f6826f2-4ff6-443d-b966-e6913bd24013	8a00478c-f762-11e1-a439-00145eb45e9a
92464	92464	0	National Biodiversity Network	d897a5b9-35ee-4232-94bd-b0bcaac003c2	8a6ca920-216c-4731-a892-f5132570d9ad
0	22	22	Plazi	ffb07bec-2d10-492d-9c37-361fe0b79427	8bd911c4-a027-4a72-a69b-f37bc46b24b9
1	1	0	Plazi	ffb07bec-2d10-492d-9c37-361fe0b79427	8c8cd4d9-29f7-49f5-b3b0-47e91329814f
396	396	0	GBIF Germany	4f6826f2-4ff6-443d-b966-e6913bd24013	8d72917c-f762-11e1-a439-00145eb45e9a
1910	1910	0	Participant Node Managers Committee	7f48e0c8-5c96-49ec-b972-30748e339115	8ec254cc-7da8-4055-b3f0-ded781a43522
103	106	3	GBIF Germany	4f6826f2-4ff6-443d-b966-e6913bd24013	93244534-f762-11e1-a439-00145eb45e9a
2276	2276	0	GBIF Germany	4f6826f2-4ff6-443d-b966-e6913bd24013	94478322-f762-11e1-a439-00145eb45e9a
0	16	16	Plazi	ffb07bec-2d10-492d-9c37-361fe0b79427	95d08f9b-ef98-40eb-ad56-3082493e73f7
3524	3581	57	GBIF Germany	4f6826f2-4ff6-443d-b966-e6913bd24013	9676072c-f762-11e1-a439-00145eb45e9a
114	114	0	Plazi	ffb07bec-2d10-492d-9c37-361fe0b79427	96acc02b-31e6-4fe4-ac2b-548b1c99c944
2329	2329	0	Biodiversity Information System of Mexico	b324e8e9-9a4c-44fa-8f1a-7f39ea7ab576	96ca9ace-7fa2-461c-a1f9-8a80fa99c666
3	3	0	Plazi	ffb07bec-2d10-492d-9c37-361fe0b79427	9bec8eaa-f1d8-4ea7-a2e9-170eb3df05ea
17	17	0	Plazi	ffb07bec-2d10-492d-9c37-361fe0b79427	9cc452e0-2aea-4919-9cda-a26a52964eeb
782	782	0	Colombian Biodiversity Information System	7e865cba-7c46-417b-ade5-97f2cf5b7be0	9f99a46b-d812-45a2-b51a-3f48f65357b5
4	4	0	Plazi	ffb07bec-2d10-492d-9c37-361fe0b79427	a01d68ef-1be6-4d20-9e3f-80c0d73e94db
0	33	33	Plazi	ffb07bec-2d10-492d-9c37-361fe0b79427	a0ab8b43-0686-487e-9c83-21e465e60816
361	361	0	Colombian Biodiversity Information System	7e865cba-7c46-417b-ade5-97f2cf5b7be0	a21eb3c4-c89a-4099-bb61-7b5501c2c044
1378422	1401148	22726	GBIF Finland	dd514216-5c7c-45f3-910d-797424cb5be6	a4d53b24-d61b-4ee5-addd-8b42d54a913f
84	84	0	GBIF Guinea	b1cd2e84-c4ba-47bd-b72a-dfd1f92dce0a	a69a11f1-4f45-49d5-8a98-4c44bf314e94
0	463	463	Colombian Biodiversity Information System	7e865cba-7c46-417b-ade5-97f2cf5b7be0	a6bb9a7a-6167-492e-9a4f-096bc07891c7
10	10	0	Plazi	ffb07bec-2d10-492d-9c37-361fe0b79427	a824d5c5-efb3-4c73-a942-5819474e2f99
4792	4792	0	GBIF France	da44cd31-5901-4687-a106-6d1c7734ee3a	a9010eb7-062a-4999-a566-d0b91714ba09
0	17	17	Plazi	ffb07bec-2d10-492d-9c37-361fe0b79427	a9c6b4d4-0539-4a79-af8c-c780a69a769d
8	8	0	Plazi	ffb07bec-2d10-492d-9c37-361fe0b79427	aa185dd6-7178-4f5b-9c0a-46ca56094d89
0	2	2	Plazi	ffb07bec-2d10-492d-9c37-361fe0b79427	abb8d5a4-2f50-48a2-881e-3f0cab7b5adb
16270	16255	-15	Biodiversity Information System of Mexico	b324e8e9-9a4c-44fa-8f1a-7f39ea7ab576	b349f235-926d-43ff-b6f7-fc3c1928f581
25	25	0	Plazi	ffb07bec-2d10-492d-9c37-361fe0b79427	b431de6a-4720-4e86-aea0-61ef0dcd2569
0	2	2	Plazi	ffb07bec-2d10-492d-9c37-361fe0b79427	b63b1fed-2eaf-4e55-a905-5e8bafd196ab
32	32	0	Plazi	ffb07bec-2d10-492d-9c37-361fe0b79427	ba498adf-4dec-4fa3-8213-9d4d8c3b9dd3
19303	19303	0	National Biodiversity Data Centre	422b00b2-6c94-4bb6-976b-c359916efdb8	baa1e422-b68b-42ee-abf5-5d02cac70d68
20	20	0	GBIF Norway	4f829580-180d-46a9-9c87-ed8ec959b545	bed5a9b5-38c5-47f5-a060-51f25b32a1d8
36173	36173	0	National Biodiversity Network	d897a5b9-35ee-4232-94bd-b0bcaac003c2	c1df184e-1340-4ab1-a045-b6e4752f7fa2
0	1	1	Plazi	ffb07bec-2d10-492d-9c37-361fe0b79427	c2a41bd8-2af6-47bb-b117-5c409e3c5ee8
43076	44876	1800	GBIF Brazil	cdc9736d-5ff7-4ece-9959-3c744360cdb3	c525b217-2f59-4b71-a173-68d13da5e8a7
47168	47168	0	GBIF Brazil	cdc9736d-5ff7-4ece-9959-3c744360cdb3	c755bc4d-35da-4bf5-8026-53324410b17e
0	20	20	Korean Biodiversity Information Facility	e0a1e772-0177-4800-94b4-2d023fe6cdf4	c8b0f8c1-d733-411e-8b35-79f78a6102eb
151	151	0	Plazi	ffb07bec-2d10-492d-9c37-361fe0b79427	c9b51a7c-da61-42bf-b5df-7abaea536e05
0	10	10	Plazi	ffb07bec-2d10-492d-9c37-361fe0b79427	d1467dc5-42ac-4656-b728-69cbbe44f692
760	760	0	Participant Node Managers Committee	7f48e0c8-5c96-49ec-b972-30748e339115	d29c7c1b-b9f5-4969-8e50-55019e2916e5
15	15	0	GBIF Germany	4f6826f2-4ff6-443d-b966-e6913bd24013	d3aef3f8-c3cd-4a60-95ab-8ba1b3666a3e
217	217	0	GBIF France	da44cd31-5901-4687-a106-6d1c7734ee3a	d3c8ba0b-4500-48a4-9335-cecdb02b14e4
795	795	0	GBIF Spain	1f94b3ca-9345-4d65-afe2-4bace93aa0fe	d4ee3335-fad4-47f7-a575-bba0873de8a7
2639	2639	0	Belgian Biodiversity Platform	fb11cfe1-ebc3-45af-9159-17d9fddbcdac	daf29de6-6cdf-4f53-9a7f-82c40f9936b6
1	1	0	Plazi	ffb07bec-2d10-492d-9c37-361fe0b79427	dbf7ccbb-f48d-4b99-a06c-9ef9a83964bb
13661	13661	0	GBIF Brazil	cdc9736d-5ff7-4ece-9959-3c744360cdb3	e153bbae-f9cd-46a6-a4dd-db74983c7075
0	4	4	Ocean Biodiversity Information System	ba0670b9-4186-41e6-8e70-f9cb3065551a	e2046038-dc6c-412c-b238-25cf1b86fee3
861	861	0	Ocean Biodiversity Information System	ba0670b9-4186-41e6-8e70-f9cb3065551a	e4a66ab8-356e-4894-89d4-5972555726bc
0	4	4	Plazi	ffb07bec-2d10-492d-9c37-361fe0b79427	e9ae9776-d979-4681-b841-c6828de63728
14590	14567	-23	Biodiversity Information System of Mexico	b324e8e9-9a4c-44fa-8f1a-7f39ea7ab576	ec79bfca-83fc-4f89-baad-9a76d320953b
0	147032	147032	U.S. Geological Survey	8618c64a-93e0-4300-b546-7249e5148ed2	ed3d96f2-db7b-48cd-9960-f871e7df7286
3	3	0	Plazi	ffb07bec-2d10-492d-9c37-361fe0b79427	ee9cf1c6-ff5a-4860-8889-dd96ce1767a0
0	16	16	Plazi	ffb07bec-2d10-492d-9c37-361fe0b79427	f1401986-3530-4d05-83a4-ab17f1703bba
0	5	5	Plazi	ffb07bec-2d10-492d-9c37-361fe0b79427	f4020445-4086-414b-b934-3608490ecf53
0	2	2	Plazi	ffb07bec-2d10-492d-9c37-361fe0b79427	f64d6ad0-9fef-4955-a4f6-765426429bf6
95	95	0	Colombian Biodiversity Information System	7e865cba-7c46-417b-ade5-97f2cf5b7be0	f689e53c-3e30-4dc0-a1dd-0799902d2f11
3419	3425	6	GBIF Brazil	cdc9736d-5ff7-4ece-9959-3c744360cdb3	f6aedfca-dced-488e-aa07-1490ac520169
3	3	0	Plazi	ffb07bec-2d10-492d-9c37-361fe0b79427	f6dce443-13cb-4153-8ff4-748c42a76518
5	5	0	Plazi	ffb07bec-2d10-492d-9c37-361fe0b79427	fa716b6d-7451-45b9-8a97-b4a1d524c645
1506	1506	0	Biodiversity Information System of Mexico	b324e8e9-9a4c-44fa-8f1a-7f39ea7ab576	fcc0062f-ff30-4929-b623-ec04be6c6443
0	3	3	Plazi	ffb07bec-2d10-492d-9c37-361fe0b79427	ff77f600-4cf8-4437-ab29-fe9f679bbe4c
49	49	0	Plazi	ffb07bec-2d10-492d-9c37-361fe0b79427	00fa23ba-e0e6-4a1a-959c-7192b134caf2
0	1412	1412	Colombian Biodiversity Information System	7e865cba-7c46-417b-ade5-97f2cf5b7be0	014fd607-a5f7-4f3b-9015-c6194a1097d4
3122	3122	0	GBIF Brazil	cdc9736d-5ff7-4ece-9959-3c744360cdb3	01d28467-87a1-4d64-ba40-4e3e1cc9091b
16449	16449	0	Colombian Biodiversity Information System	7e865cba-7c46-417b-ade5-97f2cf5b7be0	03381bbc-ae81-4a9f-b317-09e1716d8849
0	235	235	Plazi	ffb07bec-2d10-492d-9c37-361fe0b79427	06c4d529-b187-453f-8534-3739700e0328
3403810	3403810	0	Colombian Biodiversity Information System	7e865cba-7c46-417b-ade5-97f2cf5b7be0	07044577-bd82-4089-9f3a-f4a9d2170b2e
0	6	6	Plazi	ffb07bec-2d10-492d-9c37-361fe0b79427	09842c0c-d502-4a59-8f54-015fa09185b4
293	293	0	U.S. Geological Survey	8618c64a-93e0-4300-b546-7249e5148ed2	09d82596-f4a1-45ce-8684-580b57b7b60e
121014	85488	-35526	GBIF Austria	1e789bc9-79fc-4e60-a49e-89dfc45a7188	0afba960-be3b-4202-a7de-736ae05aec9e
8	8	0	Plazi	ffb07bec-2d10-492d-9c37-361fe0b79427	0d9ed23d-01cf-42f8-bf86-f03b5f6f5059
889	525	-364	GBIF Germany	4f6826f2-4ff6-443d-b966-e6913bd24013	0ea53df8-a240-439c-99bb-9577e0f23f19
259	259	0	GBIF France	da44cd31-5901-4687-a106-6d1c7734ee3a	12390b9a-b506-4a76-a7b7-6585a576275a
0	4	4	Plazi	ffb07bec-2d10-492d-9c37-361fe0b79427	124cf9a2-a8f8-4578-85a4-fab471a9aa4b
27	27	0	GBIF France	da44cd31-5901-4687-a106-6d1c7734ee3a	15b0ec25-c7bd-41d3-86ba-d64ecc9bdc3c
701	701	0	Biodiversity Information System of Mexico	b324e8e9-9a4c-44fa-8f1a-7f39ea7ab576	16328523-bf92-448b-83fc-fbe3eff278e3
0	187	187	Ocean Biodiversity Information System	ba0670b9-4186-41e6-8e70-f9cb3065551a	1660e5d0-49e7-45f2-901d-74955cf48a72
0	23	23	Plazi	ffb07bec-2d10-492d-9c37-361fe0b79427	16ed0447-fd09-4b88-ae9a-ac84067a94a3
104	104	0	Plazi	ffb07bec-2d10-492d-9c37-361fe0b79427	1ec8d779-5834-4ac9-b03a-f4017b425d13
14	14	0	Plazi	ffb07bec-2d10-492d-9c37-361fe0b79427	2254e402-c6b6-4b90-95d8-587e979af76f
0	7	7	Plazi	ffb07bec-2d10-492d-9c37-361fe0b79427	2648114a-e9fa-4f8a-b543-19b382e95fe3
1	1	0	Plazi	ffb07bec-2d10-492d-9c37-361fe0b79427	2ca3faf3-3edd-4eb2-a2e7-825faf90dfeb
8	8	0	Plazi	ffb07bec-2d10-492d-9c37-361fe0b79427	2d0c820c-8cb2-4212-8e0a-634e74489712
0	9	9	Ocean Biodiversity Information System	ba0670b9-4186-41e6-8e70-f9cb3065551a	2e68a4e9-0910-4c4a-8f24-04f358b652a9
4	4	0	Plazi	ffb07bec-2d10-492d-9c37-361fe0b79427	2fe22fcf-67b2-405a-809d-4ca5dbe1d2e3
166	166	0	National Biodiversity Network	d897a5b9-35ee-4232-94bd-b0bcaac003c2	30d18e81-2b7a-40ed-828a-72a1c7f585c4
3	3	0	Plazi	ffb07bec-2d10-492d-9c37-361fe0b79427	32e43479-c921-4ae9-a1bd-f31e99cb09f4
1322	1322	0	GBIF Sweden	a0b3be64-6525-4387-ac67-a499950f92e1	3694a677-fd84-4e8f-bc96-7fdacbf0020a
0	9960	9960	Ocean Biodiversity Information System	ba0670b9-4186-41e6-8e70-f9cb3065551a	381bf3e9-df40-46b9-a3ee-b55542a3bd64
2329	2329	0	GBIF Portugal	673f7038-4262-4149-b753-5658a4e912f6	38c70a82-c6e3-4ef4-89f4-a37455c6f73a
11	11	0	Plazi	ffb07bec-2d10-492d-9c37-361fe0b79427	3eda082e-b4da-4390-a0ed-bbbac9407588
0	8	8	Plazi	ffb07bec-2d10-492d-9c37-361fe0b79427	3f7cd05b-a293-48c9-878a-620f2034700e
562	562	0	GBIF France	da44cd31-5901-4687-a106-6d1c7734ee3a	406388bc-c55c-4566-a5b8-ffbfd3916d28
322	322	0	Colombian Biodiversity Information System	7e865cba-7c46-417b-ade5-97f2cf5b7be0	42f293d6-1b3e-4ca0-9d70-a7d1dcc9a209
0	4	4	Plazi	ffb07bec-2d10-492d-9c37-361fe0b79427	43c350ae-3f64-4038-b75f-01440faf6d47
0	1	1	Plazi	ffb07bec-2d10-492d-9c37-361fe0b79427	45a13474-027a-45dc-8a1f-c9799b6212a9
1127	1127	0	GBIF Benin	efb9c00e-f802-45dd-8826-a52ec45b89ff	47ad77fd-6717-4215-b62c-8a300e5a89e4
1614	1614	0	GBIF Germany	4f6826f2-4ff6-443d-b966-e6913bd24013	482b6e73-5135-4bba-8be7-9c12460130c0
19525	19525	0	South African Biodiversity Information Facility	7190b835-4e86-4b6e-85c1-19cc6677c250	4887f81b-b7b1-4979-9096-1b3a89ba71b2
0	2	2	Plazi	ffb07bec-2d10-492d-9c37-361fe0b79427	4b1d7c88-398b-401e-8ec9-8fd7c48e4101
4	4	0	Plazi	ffb07bec-2d10-492d-9c37-361fe0b79427	4b780f64-5797-4415-a794-9d5893d15cff
319	319	0	GBIF Germany	4f6826f2-4ff6-443d-b966-e6913bd24013	4dbc7562-1516-4bf0-9bb2-b4303fff93e7
0	5098	5098	Ocean Biodiversity Information System	ba0670b9-4186-41e6-8e70-f9cb3065551a	4fcbc818-d122-4a4a-ad51-a87fff1686e3
23	23	0	Participant Node Managers Committee	7f48e0c8-5c96-49ec-b972-30748e339115	54bcd51c-1807-4ea9-9d73-4c04019a8282
6	6	0	Plazi	ffb07bec-2d10-492d-9c37-361fe0b79427	5523cf76-15b9-481e-9e0b-75b212360c15
20136	20136	0	Canada Biodiversity Information Facility	8f83fc96-c966-4126-83f7-bf044dc49efa	55a29b7c-9cb3-4721-b1e3-40561c955e21
2	2	0	Participant Node Managers Committee	7f48e0c8-5c96-49ec-b972-30748e339115	5750f6b5-ffbe-4bb2-a943-86c5a7870f0d
9605	9605	0	GBIF France	da44cd31-5901-4687-a106-6d1c7734ee3a	5a058b59-dc30-4b4b-9677-0cea5cdd2704
1935	1935	0	National Biodiversity Network	d897a5b9-35ee-4232-94bd-b0bcaac003c2	5e8df783-07ab-4d0e-b854-297396ad0615
3	3	0	Plazi	ffb07bec-2d10-492d-9c37-361fe0b79427	5f288109-3f1d-4c3e-9e80-c39c9d971b64
0	8	8	Ocean Biodiversity Information System	ba0670b9-4186-41e6-8e70-f9cb3065551a	606363ae-4a70-4ce3-aa10-bf12aeb519dc
128	128	0	GBIF Germany	4f6826f2-4ff6-443d-b966-e6913bd24013	61078480-f762-11e1-a439-00145eb45e9a
1	1	0	National Biodiversity Network	d897a5b9-35ee-4232-94bd-b0bcaac003c2	61a18fea-e3df-4b00-90c6-02cac280cb75
100	100	0	GBIF Germany	4f6826f2-4ff6-443d-b966-e6913bd24013	6264b014-f762-11e1-a439-00145eb45e9a
36	36	0	GBIF Germany	4f6826f2-4ff6-443d-b966-e6913bd24013	627bd474-f762-11e1-a439-00145eb45e9a
101	101	0	GBIF Germany	4f6826f2-4ff6-443d-b966-e6913bd24013	62bde850-f762-11e1-a439-00145eb45e9a
4544	4544	0	GBIF France	da44cd31-5901-4687-a106-6d1c7734ee3a	635a901e-b2ff-4583-9e22-7f0dd3d930d5
402	402	0	GBIF Germany	4f6826f2-4ff6-443d-b966-e6913bd24013	63fe5024-f762-11e1-a439-00145eb45e9a
21	21	0	GBIF Germany	4f6826f2-4ff6-443d-b966-e6913bd24013	646c4f98-f762-11e1-a439-00145eb45e9a
0	826	826	Participant Node Managers Committee	7f48e0c8-5c96-49ec-b972-30748e339115	666648f4-b169-4b97-9b6f-f662aaf6592c
0	412	412	GBIF Portugal	673f7038-4262-4149-b753-5658a4e912f6	66a5be5f-2471-4c38-b966-c3f9a8794832
98	98	0	GBIF Germany	4f6826f2-4ff6-443d-b966-e6913bd24013	674630d0-f762-11e1-a439-00145eb45e9a
94	94	0	GBIF Germany	4f6826f2-4ff6-443d-b966-e6913bd24013	67b3afac-f762-11e1-a439-00145eb45e9a
144	120	-24	GBIF Germany	4f6826f2-4ff6-443d-b966-e6913bd24013	68836cce-e702-4c42-ade9-e1f4b13bd284
16276	16276	0	GBIF Finland	dd514216-5c7c-45f3-910d-797424cb5be6	68a8dad9-2229-4775-90d3-b90b6927e406
109	73	-36	GBIF Germany	4f6826f2-4ff6-443d-b966-e6913bd24013	69e95416-f762-11e1-a439-00145eb45e9a
21	21	0	GBIF Germany	4f6826f2-4ff6-443d-b966-e6913bd24013	6b254b1e-f762-11e1-a439-00145eb45e9a
18	18	0	GBIF Germany	4f6826f2-4ff6-443d-b966-e6913bd24013	6b296294-f762-11e1-a439-00145eb45e9a
42	42	0	GBIF Germany	4f6826f2-4ff6-443d-b966-e6913bd24013	6b6e04da-f762-11e1-a439-00145eb45e9a
75	75	0	GBIF Germany	4f6826f2-4ff6-443d-b966-e6913bd24013	6c3e2250-f762-11e1-a439-00145eb45e9a
73	73	0	GBIF Germany	4f6826f2-4ff6-443d-b966-e6913bd24013	6c73d490-f762-11e1-a439-00145eb45e9a
35	35	0	GBIF Germany	4f6826f2-4ff6-443d-b966-e6913bd24013	6c7673f8-f762-11e1-a439-00145eb45e9a
28	28	0	GBIF Germany	4f6826f2-4ff6-443d-b966-e6913bd24013	6c89db32-f762-11e1-a439-00145eb45e9a
67	67	0	Plazi	ffb07bec-2d10-492d-9c37-361fe0b79427	6ca7492b-a52e-4200-ba83-d92dfbeb2ea5
83	83	0	GBIF France	da44cd31-5901-4687-a106-6d1c7734ee3a	6dfd5302-ac97-4b3c-906f-cdb2916e94eb
89	89	0	GBIF France	da44cd31-5901-4687-a106-6d1c7734ee3a	6f9ba273-ed0d-4f4c-8c29-30abe0ce7398
97	97	0	GBIF Germany	4f6826f2-4ff6-443d-b966-e6913bd24013	6fefef82-f762-11e1-a439-00145eb45e9a
92	92	0	GBIF Germany	4f6826f2-4ff6-443d-b966-e6913bd24013	702fb0ea-f762-11e1-a439-00145eb45e9a
26	22	-4	GBIF Germany	4f6826f2-4ff6-443d-b966-e6913bd24013	707ae88a-f762-11e1-a439-00145eb45e9a
0	2	2	Plazi	ffb07bec-2d10-492d-9c37-361fe0b79427	709ed2ff-5069-49c4-9490-5378ce7ce01b
17	16	-1	GBIF Germany	4f6826f2-4ff6-443d-b966-e6913bd24013	70da4a96-f762-11e1-a439-00145eb45e9a
1	1	0	GBIF Germany	4f6826f2-4ff6-443d-b966-e6913bd24013	718a7df8-f762-11e1-a439-00145eb45e9a
144337	144337	0	GBIF France	da44cd31-5901-4687-a106-6d1c7734ee3a	724ec4af-c9a3-490b-b718-a1b202437c0f
15	15	0	GBIF Germany	4f6826f2-4ff6-443d-b966-e6913bd24013	73407b48-f762-11e1-a439-00145eb45e9a
1	1	0	Plazi	ffb07bec-2d10-492d-9c37-361fe0b79427	755631af-be3e-4cb0-9126-0728ab9936ad
3	3	0	Plazi	ffb07bec-2d10-492d-9c37-361fe0b79427	75a6029e-1083-4fe7-8209-8415e4e8c369
15	15	0	Plazi	ffb07bec-2d10-492d-9c37-361fe0b79427	773f8611-8563-48f0-820c-f275a6e7636f
12	12	0	Colombian Biodiversity Information System	7e865cba-7c46-417b-ade5-97f2cf5b7be0	782f30da-3041-4f70-9d6c-886b3991961a
198	165	-33	GBIF Germany	4f6826f2-4ff6-443d-b966-e6913bd24013	7bc3c02c-f762-11e1-a439-00145eb45e9a
2162	1730	-432	GBIF Germany	4f6826f2-4ff6-443d-b966-e6913bd24013	7c05fa8c-f762-11e1-a439-00145eb45e9a
174	174	0	GBIF France	da44cd31-5901-4687-a106-6d1c7734ee3a	7c11bdec-5c4f-4f3f-9c62-2ce2b7285ac7
1120	1056	-64	GBIF Germany	4f6826f2-4ff6-443d-b966-e6913bd24013	7d04f5e6-f762-11e1-a439-00145eb45e9a
153	153	0	Participant Node Managers Committee	7f48e0c8-5c96-49ec-b972-30748e339115	7e91aacb-c994-41ee-a7b7-bd23c02cd5bf
3142	3142	0	Biodiversity Information System of Mexico	b324e8e9-9a4c-44fa-8f1a-7f39ea7ab576	7f9c2694-f762-11e1-a439-00145eb45e9a
81049	81035	-14	Biodiversity Information System of Mexico	b324e8e9-9a4c-44fa-8f1a-7f39ea7ab576	805bbcde-f762-11e1-a439-00145eb45e9a
77	77	0	GBIF Germany	4f6826f2-4ff6-443d-b966-e6913bd24013	81d1b9d8-f762-11e1-a439-00145eb45e9a
2030	2030	0	GBIF Germany	4f6826f2-4ff6-443d-b966-e6913bd24013	826010b6-f762-11e1-a439-00145eb45e9a
811	811	0	U.S. Geological Survey	8618c64a-93e0-4300-b546-7249e5148ed2	82c3a0ae-f762-11e1-a439-00145eb45e9a
2382	2381	-1	Ocean Biodiversity Information System	ba0670b9-4186-41e6-8e70-f9cb3065551a	83ac301c-f762-11e1-a439-00145eb45e9a
10	10	0	Plazi	ffb07bec-2d10-492d-9c37-361fe0b79427	83e54f98-3c98-47fc-81bd-0996bcfbc974
2397	2397	0	World Federation for Culture Collections	a6bdc523-5368-4e0f-9d2e-de1c262ac092	85616d0a-f762-11e1-a439-00145eb45e9a
23	23	0	GBIF Germany	4f6826f2-4ff6-443d-b966-e6913bd24013	856734ce-f762-11e1-a439-00145eb45e9a
51	51	0	Korean Biodiversity Information Facility	e0a1e772-0177-4800-94b4-2d023fe6cdf4	85969598-f762-11e1-a439-00145eb45e9a
0	8	8	Plazi	ffb07bec-2d10-492d-9c37-361fe0b79427	87a35bf2-bb5e-45a6-afab-cb3a13b00d4f
464	390	-74	GBIF Germany	4f6826f2-4ff6-443d-b966-e6913bd24013	8845c160-f762-11e1-a439-00145eb45e9a
10598	10598	0	Canada Biodiversity Information Facility	8f83fc96-c966-4126-83f7-bf044dc49efa	88d5d94e-f762-11e1-a439-00145eb45e9a
1925	1676	-249	Biodiversity Information System of Mexico	b324e8e9-9a4c-44fa-8f1a-7f39ea7ab576	88e450ba-2076-4947-9529-9d0cfbb06f2a
234	234	0	Ocean Biodiversity Information System	ba0670b9-4186-41e6-8e70-f9cb3065551a	891d0314-f762-11e1-a439-00145eb45e9a
0	1	1	Plazi	ffb07bec-2d10-492d-9c37-361fe0b79427	8939ee63-cab8-41ff-aa31-b58d49e66f4a
7223	7223	0	GBIF Argentina	2426a871-9feb-40a1-96c6-0c593a76b835	89dd4156-7b1b-4f4f-aefe-ad1a712a3149
0	94	94	Plazi	ffb07bec-2d10-492d-9c37-361fe0b79427	89de8b03-b1c0-4580-b988-561f7e381264
80	80	0	GBIF Germany	4f6826f2-4ff6-443d-b966-e6913bd24013	8a01a8de-f762-11e1-a439-00145eb45e9a
1338	1338	0	GBIF Germany	4f6826f2-4ff6-443d-b966-e6913bd24013	8c471930-f762-11e1-a439-00145eb45e9a
1927	1927	0	GBIF Argentina	2426a871-9feb-40a1-96c6-0c593a76b835	8e298408-6cd0-42cf-b259-7c05d2d43038
1004	661	-343	GBIF Germany	4f6826f2-4ff6-443d-b966-e6913bd24013	8ea5c758-f762-11e1-a439-00145eb45e9a
715	294	-421	GBIF Germany	4f6826f2-4ff6-443d-b966-e6913bd24013	8fa448a0-f762-11e1-a439-00145eb45e9a
391	298	-93	GBIF Germany	4f6826f2-4ff6-443d-b966-e6913bd24013	8fc6328a-f762-11e1-a439-00145eb45e9a
4371	3255	-1116	GBIF Germany	4f6826f2-4ff6-443d-b966-e6913bd24013	909cc408-f762-11e1-a439-00145eb45e9a
48	21	-27	GBIF Germany	4f6826f2-4ff6-443d-b966-e6913bd24013	91e74900-f762-11e1-a439-00145eb45e9a
9	8	-1	GBIF Germany	4f6826f2-4ff6-443d-b966-e6913bd24013	91f5c6b0-f762-11e1-a439-00145eb45e9a
80	80	0	GBIF Germany	4f6826f2-4ff6-443d-b966-e6913bd24013	92979b66-f762-11e1-a439-00145eb45e9a
121	121	0	GBIF Germany	4f6826f2-4ff6-443d-b966-e6913bd24013	92bf1ea2-f762-11e1-a439-00145eb45e9a
612	612	0	GBIF Germany	4f6826f2-4ff6-443d-b966-e6913bd24013	931b5c76-f762-11e1-a439-00145eb45e9a
278148	298148	20000	GBIF Japan	db5705aa-6a6e-42f1-8942-d77b9f4896ea	95eebc5e-f762-11e1-a439-00145eb45e9a
90996	90996	0	Participant Node Managers Committee	7f48e0c8-5c96-49ec-b972-30748e339115	95f572da-a3a9-4706-bccb-03521079a520
306	306	0	Atlas of Living Australia	4a6f1b71-969e-4fc5-a693-282b05e1220c	96a90488-f762-11e1-a439-00145eb45e9a
43	43	0	Plazi	ffb07bec-2d10-492d-9c37-361fe0b79427	99a3b113-9858-49be-be97-b1877966af34
967	967	0	National Biodiversity Network	d897a5b9-35ee-4232-94bd-b0bcaac003c2	99bcf021-ed3e-411e-8cb3-a8c145e3a2d2
399	5094	4695	GBIF Norway	4f829580-180d-46a9-9c87-ed8ec959b545	9b6f01f1-9b00-4c39-ae14-6ee552988ce9
0	1555	1555	Ocean Biodiversity Information System	ba0670b9-4186-41e6-8e70-f9cb3065551a	a057e413-3d26-4f2a-9235-e071a0116bca
0	7	7	Plazi	ffb07bec-2d10-492d-9c37-361fe0b79427	a18cb04d-1682-4a00-b261-32b692ddcaf1
781	781	0	Colombian Biodiversity Information System	7e865cba-7c46-417b-ade5-97f2cf5b7be0	a1a94e37-171d-41b0-a65d-b75664d4f9c0
0	27	27	Plazi	ffb07bec-2d10-492d-9c37-361fe0b79427	a2545208-1888-44e9-82d3-b429219cd070
1	1	0	Plazi	ffb07bec-2d10-492d-9c37-361fe0b79427	a4039dda-9e9f-4988-a6de-c045d93716e7
0	2	2	Plazi	ffb07bec-2d10-492d-9c37-361fe0b79427	a47376ec-9516-470a-9af8-9f819651c2bf
34118	37897	3779	U.S. Geological Survey	8618c64a-93e0-4300-b546-7249e5148ed2	a92f4b3c-ae5c-45af-8dac-4a6a88d35ddd
26	26	0	Plazi	ffb07bec-2d10-492d-9c37-361fe0b79427	a9d4b1f4-fa63-42bb-881e-53514379d22c
2808	2808	0	GBIF France	da44cd31-5901-4687-a106-6d1c7734ee3a	ac256d63-dd79-44a6-ac31-1c56aee93b41
103069	103069	0	GBIF Japan	db5705aa-6a6e-42f1-8942-d77b9f4896ea	ad005057-c4b5-4eb1-8b3f-8cdc7aaf994f
273	273	0	Participant Node Managers Committee	7f48e0c8-5c96-49ec-b972-30748e339115	ad831fd0-4047-41ce-a7b0-568259f6a247
13443	13443	0	U.S. Geological Survey	8618c64a-93e0-4300-b546-7249e5148ed2	af49d8bc-959c-418c-b39e-2b9ebb3830d9
4	4	0	Plazi	ffb07bec-2d10-492d-9c37-361fe0b79427	b3a5be9b-c6f9-46c2-9393-fa3b7be6e896
1976	1976	0	GBIF Brazil	cdc9736d-5ff7-4ece-9959-3c744360cdb3	b40b69e3-dc62-48c9-9d36-1da21b544395
36763	46408	9645	National Biodiversity Network	d897a5b9-35ee-4232-94bd-b0bcaac003c2	b45a151e-734c-40f4-94c9-001458a2972b
1616778	1616778	0	GBIF Finland	dd514216-5c7c-45f3-910d-797424cb5be6	b84a3711-b4ca-4e4f-adac-80dfaea98d1c
147	147	0	GBIF France	da44cd31-5901-4687-a106-6d1c7734ee3a	b8cccb73-b040-4ad6-bf3f-f6190a89d45b
153	153	0	Plazi	ffb07bec-2d10-492d-9c37-361fe0b79427	bb5c58a5-3a4a-4c8b-8025-7e71e77c2782
684	684	0	GBIF France	da44cd31-5901-4687-a106-6d1c7734ee3a	bb77aefa-d4de-47b2-8455-562c1c11cfd7
239	239	0	Participant Node Managers Committee	7f48e0c8-5c96-49ec-b972-30748e339115	be90e2b4-9c55-478d-983b-47c206ac9faa
16	16	0	Plazi	ffb07bec-2d10-492d-9c37-361fe0b79427	bf02ed78-3128-468e-b8ef-381ad8783201
121	125	4	Atlas of Living Australia	4a6f1b71-969e-4fc5-a693-282b05e1220c	c03fe10c-2f92-49c8-9eb5-e81ca25a839c
5902	5902	0	South African Biodiversity Information Facility	7190b835-4e86-4b6e-85c1-19cc6677c250	c13eb182-a0e0-4e54-985b-598de74dd949
0	4	4	Plazi	ffb07bec-2d10-492d-9c37-361fe0b79427	c3268c84-33ed-4d8f-9fb6-cb50dbbde93e
0	5	5	Plazi	ffb07bec-2d10-492d-9c37-361fe0b79427	c5201064-aafd-407b-a02d-62dde2f64c1f
37	37	0	Plazi	ffb07bec-2d10-492d-9c37-361fe0b79427	c7626091-8808-4d4f-b081-d01dc246483a
193	193	0	Plazi	ffb07bec-2d10-492d-9c37-361fe0b79427	cabc0475-d35f-407e-a33f-40b59ad802b9
0	63	63	Plazi	ffb07bec-2d10-492d-9c37-361fe0b79427	cc1a9ad1-ceb2-4ce8-87eb-570b2b96ed03
1	1	0	Plazi	ffb07bec-2d10-492d-9c37-361fe0b79427	ced62082-1000-41dc-b05d-333107d93c55
433	433	0	GBIF France	da44cd31-5901-4687-a106-6d1c7734ee3a	cf744e11-d3c9-4f68-8fe5-206d368fd5e4
0	89	89	Colombian Biodiversity Information System	7e865cba-7c46-417b-ade5-97f2cf5b7be0	cf8ba399-e93a-455e-9ed4-6fbb849e549d
210	217	7	GBIF Germany	4f6826f2-4ff6-443d-b966-e6913bd24013	d4370343-3b41-494d-aa7c-2ca7fc2ad29f
747913	746024	-1889	National Biodiversity Network	d897a5b9-35ee-4232-94bd-b0bcaac003c2	d596fccb-2319-42eb-b13b-986c932780ad
2809	2809	0	National Biodiversity Network	d897a5b9-35ee-4232-94bd-b0bcaac003c2	d79f5335-c0ee-4d74-b313-53aa51bcb36d
435	435	0	GBIF France	da44cd31-5901-4687-a106-6d1c7734ee3a	dc834143-357c-46af-a77b-e762aea7126e
2409	2409	0	Atlas of Living Australia	4a6f1b71-969e-4fc5-a693-282b05e1220c	dcce70f7-06be-4de3-aed1-d811343566ea
0	42	42	Ocean Biodiversity Information System	ba0670b9-4186-41e6-8e70-f9cb3065551a	dcedf335-812c-4df2-8e02-7d3c47599272
30	30	0	Participant Node Managers Committee	7f48e0c8-5c96-49ec-b972-30748e339115	de7fe7a1-1ceb-4302-adb6-f7b64686a86f
1	1	0	Plazi	ffb07bec-2d10-492d-9c37-361fe0b79427	deb91877-508a-4c6c-9ba8-bdfce7e38797
3071	3071	0	GBIF France	da44cd31-5901-4687-a106-6d1c7734ee3a	e3424867-3326-402c-b365-961a035fbe28
213	213	0	Biodiversity Information System of Mexico	b324e8e9-9a4c-44fa-8f1a-7f39ea7ab576	e684dd09-da00-4e7d-9c5e-33bd67f187ac
0	27	27	Plazi	ffb07bec-2d10-492d-9c37-361fe0b79427	eaf8b12d-b281-44b8-abc8-a5ea2bdaf22b
1193	1193	0	GBIF Malawi	2a42e4d7-ad4a-41b3-84c4-de4aa7b74d35	ec4038fb-cb53-4ddb-96a3-f1c395f97584
366	366	0	Colombian Biodiversity Information System	7e865cba-7c46-417b-ade5-97f2cf5b7be0	f16eb97d-c15d-4f3c-a71b-64ab38ceb38b
233	233	0	GBIF Portugal	673f7038-4262-4149-b753-5658a4e912f6	f1e0c699-a29e-4484-9070-373d283ac245
883	883	0	Ocean Biodiversity Information System	ba0670b9-4186-41e6-8e70-f9cb3065551a	f4620c32-cada-461f-9f33-73db78fdb712
9	9	0	Plazi	ffb07bec-2d10-492d-9c37-361fe0b79427	f4ca459b-ff7e-4517-86fa-75402b6d2d7d
5	6	1	Plazi	ffb07bec-2d10-492d-9c37-361fe0b79427	f5adc190-982e-4678-bfa8-5f53b66457aa
126	126	0	Participant Node Managers Committee	7f48e0c8-5c96-49ec-b972-30748e339115	f659f688-0eeb-4e33-9e86-856733977b42
12	12	0	Plazi	ffb07bec-2d10-492d-9c37-361fe0b79427	f734d92e-4696-4653-bd8d-2af35653c4b5
0	10	10	Plazi	ffb07bec-2d10-492d-9c37-361fe0b79427	f983c124-e735-49aa-86ef-14e9862bbd57
0	1	1	Plazi	ffb07bec-2d10-492d-9c37-361fe0b79427	facf5c05-5366-4f6b-851b-6293966247e8
10	10	0	Plazi	ffb07bec-2d10-492d-9c37-361fe0b79427	fc4a1f3e-6a1d-45c8-9701-d050d2c334c7
0	25	25	Plazi	ffb07bec-2d10-492d-9c37-361fe0b79427	fce50f60-b834-424f-9a19-cf4601ffd2a3
0	331	331	Plazi	ffb07bec-2d10-492d-9c37-361fe0b79427	fd8f5cb9-13e9-4c90-ac15-502fa7ee8d38
0	2	2	Participant Node Managers Committee	7f48e0c8-5c96-49ec-b972-30748e339115	0239959d-33ff-489c-b34f-b26d2d9aef13
0	410	410	GBIF Chile	a8b16421-d80b-4ef3-8f22-098b01a89255	036cfba0-91a8-4e09-8b21-e6d949af388b
268	268	0	GBIF France	da44cd31-5901-4687-a106-6d1c7734ee3a	042f54ba-58de-454d-a9f0-ee548e2fe438
0	4	4	Plazi	ffb07bec-2d10-492d-9c37-361fe0b79427	043afea6-f8cc-40f7-986a-fe898b9514df
161	161	0	Participant Node Managers Committee	7f48e0c8-5c96-49ec-b972-30748e339115	0574c39e-da5f-4ec9-8987-13841737eb44
344	344	0	U.S. Geological Survey	8618c64a-93e0-4300-b546-7249e5148ed2	07a6710f-0b81-4b80-b5bf-a9e59c007a97
0	2	2	Plazi	ffb07bec-2d10-492d-9c37-361fe0b79427	0812359b-ebf3-4ffc-bbec-a9765d58c135
5	5	0	Plazi	ffb07bec-2d10-492d-9c37-361fe0b79427	08364813-bac8-40e5-99dd-97617184a58b
1	1	0	Plazi	ffb07bec-2d10-492d-9c37-361fe0b79427	0e0efc07-474c-402e-92af-feaf3445e4f7
0	2370	2370	GBIF Japan	db5705aa-6a6e-42f1-8942-d77b9f4896ea	0e148948-ad3b-4416-a738-bcded92afdb2
1	1	0	Plazi	ffb07bec-2d10-492d-9c37-361fe0b79427	0ea7df0b-59a7-4c1d-8f3b-b1b06811206f
184364	370266	185902	U.S. Geological Survey	8618c64a-93e0-4300-b546-7249e5148ed2	0ec927cf-325a-4d63-9499-d721c734463a
4	4	0	Plazi	ffb07bec-2d10-492d-9c37-361fe0b79427	102134f1-27aa-45ec-8cd9-9bdaa9c19e9f
0	3	3	Plazi	ffb07bec-2d10-492d-9c37-361fe0b79427	11bf5b45-a9bb-40a7-af36-a806daafd1c9
0	2	2	Ocean Biodiversity Information System	ba0670b9-4186-41e6-8e70-f9cb3065551a	13e3b8b4-10dc-42f4-9498-880289864913
160	160	0	Plazi	ffb07bec-2d10-492d-9c37-361fe0b79427	145c534d-f4eb-4099-9779-02ff529be895
8	8	0	Plazi	ffb07bec-2d10-492d-9c37-361fe0b79427	1758af10-9070-4772-a2b5-40ca85612db3
3	3	0	Plazi	ffb07bec-2d10-492d-9c37-361fe0b79427	19e53c4e-0f3c-44bc-bae0-fe57eae79b12
2614	2614	0	GBIF Germany	4f6826f2-4ff6-443d-b966-e6913bd24013	1ff01e59-940e-4064-830d-b897c1785080
1747	1747	0	Biodiversity Information System of Mexico	b324e8e9-9a4c-44fa-8f1a-7f39ea7ab576	2105b68c-120d-4cfb-9459-5eb8895cf42e
9515	9483	-32	National Biodiversity Network	d897a5b9-35ee-4232-94bd-b0bcaac003c2	219285f8-b3c9-4c34-963e-bdd3c14692fd
0	224	224	Ocean Biodiversity Information System	ba0670b9-4186-41e6-8e70-f9cb3065551a	283a45c3-4f82-4a3f-8af5-c6c0a327cdb1
0	102	102	GBIF Japan	db5705aa-6a6e-42f1-8942-d77b9f4896ea	29dc594e-e3c9-4b5f-b658-acfce74b8d5c
22	22	0	Plazi	ffb07bec-2d10-492d-9c37-361fe0b79427	2b1d4578-1d2a-45fa-883b-851f61ffbf7f
3	3	0	GBIF Portugal	673f7038-4262-4149-b753-5658a4e912f6	2c5df391-3d22-4c92-b039-bed10c1f62c0
187	187	0	GBIF Norway	4f829580-180d-46a9-9c87-ed8ec959b545	2ce085b1-f05e-4bb9-8a3b-0ae583f3a58d
841	841	0	National Biodiversity Network	d897a5b9-35ee-4232-94bd-b0bcaac003c2	2d519945-a6de-49ee-96e3-de80099cc339
112	112	0	GBIF Germany	4f6826f2-4ff6-443d-b966-e6913bd24013	2f260519-acf1-420a-a4f0-f52b8b7e27d8
766	766	0	GBIF Spain	1f94b3ca-9345-4d65-afe2-4bace93aa0fe	2f58500b-b776-4fe6-b2b9-cbb32e8cd615
2	2	0	Plazi	ffb07bec-2d10-492d-9c37-361fe0b79427	3274ce54-6a40-43fc-9b1e-8121fa3c8025
14	14	0	Plazi	ffb07bec-2d10-492d-9c37-361fe0b79427	33936883-b37d-484f-9737-401c08469a18
6	6	0	Plazi	ffb07bec-2d10-492d-9c37-361fe0b79427	34a85246-e13a-4bb0-a276-ddb5c2b6e940
0	146	146	Ocean Biodiversity Information System	ba0670b9-4186-41e6-8e70-f9cb3065551a	37e632a2-dcea-483d-94e1-52fafd26412a
1000	1000	0	Korean Biodiversity Information Facility	e0a1e772-0177-4800-94b4-2d023fe6cdf4	38797432-f93d-447e-b83f-d8adb910dd6c
19	19	0	Plazi	ffb07bec-2d10-492d-9c37-361fe0b79427	39e08df9-a9a6-423a-8af7-58e91e84dcf1
3118	3118	0	National Biodiversity Network	d897a5b9-35ee-4232-94bd-b0bcaac003c2	3b91df32-521d-4351-a45a-d4a45debbc81
0	6	6	Plazi	ffb07bec-2d10-492d-9c37-361fe0b79427	3dd4ba74-e97d-43ff-a0c2-4dced784fecb
2902	2902	0	Biodiversity Information System of Mexico	b324e8e9-9a4c-44fa-8f1a-7f39ea7ab576	3f58545e-75c1-4463-844d-fd5fe2e0d9a7
0	958	958	Participant Node Managers Committee	7f48e0c8-5c96-49ec-b972-30748e339115	448bcaee-882e-4b11-a276-4c6b8b2b8636
10	10	0	Plazi	ffb07bec-2d10-492d-9c37-361fe0b79427	453e6549-3523-4118-9df6-faac263eb2c4
0	2	2	Plazi	ffb07bec-2d10-492d-9c37-361fe0b79427	4550562c-958d-4ded-a04e-a87109a8fd3a
0	50	50	Ocean Biodiversity Information System	ba0670b9-4186-41e6-8e70-f9cb3065551a	48432ac2-ecfe-464d-b2d4-f0ebb8da1775
67	67	0	Atlas of Living Australia	4a6f1b71-969e-4fc5-a693-282b05e1220c	492d70bb-fe52-4575-9b35-ce4282f41d7d
26389	26389	0	National Biodiversity Network	d897a5b9-35ee-4232-94bd-b0bcaac003c2	4b027a69-f3f0-42ba-9051-c939d859fc17
0	10	10	Plazi	ffb07bec-2d10-492d-9c37-361fe0b79427	4b6d3b98-b1e6-4add-90b2-63f9f537d8f7
0	2	2	Plazi	ffb07bec-2d10-492d-9c37-361fe0b79427	53e128d9-0bb2-48b4-9959-3ef2f40fc6aa
0	19	19	Participant Node Managers Committee	7f48e0c8-5c96-49ec-b972-30748e339115	53ebfd98-2b56-43e9-bd83-20fff78842a1
0	3	3	Plazi	ffb07bec-2d10-492d-9c37-361fe0b79427	58290d73-cba4-45c8-9f22-2c88a5d147cd
0	25	25	Korean Biodiversity Information Facility	e0a1e772-0177-4800-94b4-2d023fe6cdf4	5a81fa18-04e2-43aa-9485-73792f4aadd1
231	231	0	National Biodiversity Network	d897a5b9-35ee-4232-94bd-b0bcaac003c2	5b1580f7-c386-4a3e-9901-79d46c0439d4
11384	11384	0	Atlas of Living Australia	4a6f1b71-969e-4fc5-a693-282b05e1220c	5d11316c-4237-41cc-aba0-1288b532d5c2
0	7	7	Plazi	ffb07bec-2d10-492d-9c37-361fe0b79427	5d930c71-c1f5-42b5-b3b9-f414d7237ad1
3	3	0	Plazi	ffb07bec-2d10-492d-9c37-361fe0b79427	5ea6f61c-10c6-4e2d-b714-ee777bd26d08
5	5	0	Plazi	ffb07bec-2d10-492d-9c37-361fe0b79427	61a0916c-6214-4222-807c-f776a7ab49c1
219	219	0	GBIF Germany	4f6826f2-4ff6-443d-b966-e6913bd24013	61a4f6b6-f762-11e1-a439-00145eb45e9a
30	30	0	Plazi	ffb07bec-2d10-492d-9c37-361fe0b79427	62931799-dbc5-475d-9028-b99ac00d1edb
36	36	0	GBIF Germany	4f6826f2-4ff6-443d-b966-e6913bd24013	62a7764c-f762-11e1-a439-00145eb45e9a
80	80	0	GBIF Germany	4f6826f2-4ff6-443d-b966-e6913bd24013	636a901e-f762-11e1-a439-00145eb45e9a
69	69	0	GBIF Germany	4f6826f2-4ff6-443d-b966-e6913bd24013	6466aa52-f762-11e1-a439-00145eb45e9a
7950	7950	0	Society for the Management of Electronic Biodiversity Data	97818ee4-1461-4180-bf1d-b3201050124f	648cbc07-5157-4dbd-add9-5db92d6e8011
31	31	0	GBIF Germany	4f6826f2-4ff6-443d-b966-e6913bd24013	64ac45bc-f762-11e1-a439-00145eb45e9a
1637	1637	0	GBIF Germany	4f6826f2-4ff6-443d-b966-e6913bd24013	655de2a4-f762-11e1-a439-00145eb45e9a
213	213	0	GBIF Germany	4f6826f2-4ff6-443d-b966-e6913bd24013	66414346-f762-11e1-a439-00145eb45e9a
141	141	0	GBIF Germany	4f6826f2-4ff6-443d-b966-e6913bd24013	6647380a-f762-11e1-a439-00145eb45e9a
30	30	0	Plazi	ffb07bec-2d10-492d-9c37-361fe0b79427	66993826-063a-476f-a821-bfff44e916aa
62	62	0	GBIF Germany	4f6826f2-4ff6-443d-b966-e6913bd24013	66a2fa78-f762-11e1-a439-00145eb45e9a
219	219	0	GBIF France	da44cd31-5901-4687-a106-6d1c7734ee3a	67acf85b-ffb8-4f30-9f4a-ec2ece96d77f
61	61	0	GBIF Germany	4f6826f2-4ff6-443d-b966-e6913bd24013	68025fd0-f762-11e1-a439-00145eb45e9a
271	271	0	GBIF Germany	4f6826f2-4ff6-443d-b966-e6913bd24013	682c7fd6-f762-11e1-a439-00145eb45e9a
303	303	0	GBIF Germany	4f6826f2-4ff6-443d-b966-e6913bd24013	68340788-f762-11e1-a439-00145eb45e9a
146	146	0	GBIF Germany	4f6826f2-4ff6-443d-b966-e6913bd24013	683d474e-f762-11e1-a439-00145eb45e9a
11	11	0	GBIF Germany	4f6826f2-4ff6-443d-b966-e6913bd24013	68f621ce-f762-11e1-a439-00145eb45e9a
20	20	0	GBIF Germany	4f6826f2-4ff6-443d-b966-e6913bd24013	68fb23fe-f762-11e1-a439-00145eb45e9a
2021	2021	0	National Biodiversity Network	d897a5b9-35ee-4232-94bd-b0bcaac003c2	6aeb76df-5354-40ad-9a94-f903ee04638e
6	6	0	Plazi	ffb07bec-2d10-492d-9c37-361fe0b79427	6b2ac420-3c8e-429e-9497-562945198c5a
15	15	0	GBIF Germany	4f6826f2-4ff6-443d-b966-e6913bd24013	6bec6d3e-f762-11e1-a439-00145eb45e9a
373	373	0	GBIF France	da44cd31-5901-4687-a106-6d1c7734ee3a	6c59a31a-9014-4749-9683-446d5c4eb833
28	28	0	GBIF Germany	4f6826f2-4ff6-443d-b966-e6913bd24013	6cd585fa-f762-11e1-a439-00145eb45e9a
40	40	0	GBIF France	da44cd31-5901-4687-a106-6d1c7734ee3a	6dedb5b6-260c-4677-b5d2-7a0ec9b86b70
1	1	0	Plazi	ffb07bec-2d10-492d-9c37-361fe0b79427	6df9af50-96be-4880-a87f-de6867dc94b2
24334	24853	519	National Biodiversity Network	d897a5b9-35ee-4232-94bd-b0bcaac003c2	6e09f9dc-0bf2-4c20-8ff6-bd898bbc4831
32	32	0	Plazi	ffb07bec-2d10-492d-9c37-361fe0b79427	6f6af3d0-601d-47dc-849d-8ad21170e570
1459	1038	-421	GBIF Germany	4f6826f2-4ff6-443d-b966-e6913bd24013	704a59ea-f762-11e1-a439-00145eb45e9a
173	173	0	GBIF Germany	4f6826f2-4ff6-443d-b966-e6913bd24013	713ef310-f762-11e1-a439-00145eb45e9a
57286	57286	0	U.S. Geological Survey	8618c64a-93e0-4300-b546-7249e5148ed2	71e6db8e-f762-11e1-a439-00145eb45e9a
51	51	0	GBIF Germany	4f6826f2-4ff6-443d-b966-e6913bd24013	72d5ef76-f762-11e1-a439-00145eb45e9a
31	31	0	Plazi	ffb07bec-2d10-492d-9c37-361fe0b79427	743a03e6-c13d-416f-b2fe-77434c2ab1c8
115	115	0	GBIF Germany	4f6826f2-4ff6-443d-b966-e6913bd24013	754d830e-f762-11e1-a439-00145eb45e9a
3	3	0	Plazi	ffb07bec-2d10-492d-9c37-361fe0b79427	759fb5c6-ac31-4e4b-87b1-bd72c4f74545
147	147	0	GBIF Germany	4f6826f2-4ff6-443d-b966-e6913bd24013	75bd4838-f762-11e1-a439-00145eb45e9a
73	73	0	GBIF Argentina	2426a871-9feb-40a1-96c6-0c593a76b835	7789605b-31c9-4750-a5ea-c2349581c3d2
103	103	0	GBIF Germany	4f6826f2-4ff6-443d-b966-e6913bd24013	78c0a444-f762-11e1-a439-00145eb45e9a
3195	3195	0	GBIF Germany	4f6826f2-4ff6-443d-b966-e6913bd24013	79f6d96e-f762-11e1-a439-00145eb45e9a
260	260	0	GBIF Germany	4f6826f2-4ff6-443d-b966-e6913bd24013	79fbdef0-f762-11e1-a439-00145eb45e9a
3772	3772	0	Korean Biodiversity Information Facility	e0a1e772-0177-4800-94b4-2d023fe6cdf4	7b106ef0-f762-11e1-a439-00145eb45e9a
2336	2087	-249	GBIF Germany	4f6826f2-4ff6-443d-b966-e6913bd24013	7c59e6ce-f762-11e1-a439-00145eb45e9a
713	360	-353	GBIF Germany	4f6826f2-4ff6-443d-b966-e6913bd24013	7c7f09f4-f762-11e1-a439-00145eb45e9a
459	459	0	GBIF Germany	4f6826f2-4ff6-443d-b966-e6913bd24013	7db0aa1c-f762-11e1-a439-00145eb45e9a
3043	3043	0	Participant Node Managers Committee	7f48e0c8-5c96-49ec-b972-30748e339115	7eef086c-8e58-4b31-830e-2696d3158301
357	357	0	Biodiversity Information System of Mexico	b324e8e9-9a4c-44fa-8f1a-7f39ea7ab576	7f902f1a-f762-11e1-a439-00145eb45e9a
0	570	570	Ocean Biodiversity Information System	ba0670b9-4186-41e6-8e70-f9cb3065551a	805ccb9b-3cf6-46eb-8de2-0ae0a18af393
4940	4940	0	Biodiversity Information System of Mexico	b324e8e9-9a4c-44fa-8f1a-7f39ea7ab576	8088b072-f762-11e1-a439-00145eb45e9a
187	187	0	GBIF Benin	efb9c00e-f802-45dd-8826-a52ec45b89ff	80a00e21-1d93-490f-b94e-a6bd87997f33
1694	1694	0	GBIF Germany	4f6826f2-4ff6-443d-b966-e6913bd24013	81eb1b76-f762-11e1-a439-00145eb45e9a
42	42	0	Plazi	ffb07bec-2d10-492d-9c37-361fe0b79427	82128789-e580-46d1-8b30-8a3562705b6f
0	4	4	Ocean Biodiversity Information System	ba0670b9-4186-41e6-8e70-f9cb3065551a	83db1ea1-a4df-4f28-8ba0-3386cf94e96a
395	269	-126	GBIF Germany	4f6826f2-4ff6-443d-b966-e6913bd24013	84829322-1240-4adc-a908-cc1d7e92317a
3562	3562	0	GBIF Japan	db5705aa-6a6e-42f1-8942-d77b9f4896ea	868fcb5e-f762-11e1-a439-00145eb45e9a
116	98	-18	GBIF Germany	4f6826f2-4ff6-443d-b966-e6913bd24013	877a16a0-f762-11e1-a439-00145eb45e9a
210	147	-63	GBIF Germany	4f6826f2-4ff6-443d-b966-e6913bd24013	881d46a4-f762-11e1-a439-00145eb45e9a
1003	1003	0	GBIF Germany	4f6826f2-4ff6-443d-b966-e6913bd24013	89754f1a-f762-11e1-a439-00145eb45e9a
95	95	0	Biodiversity Information System of Mexico	b324e8e9-9a4c-44fa-8f1a-7f39ea7ab576	89c339fa-f424-410b-bad2-a0331139b152
1036	1036	0	GBIF Germany	4f6826f2-4ff6-443d-b966-e6913bd24013	89e33052-f762-11e1-a439-00145eb45e9a
2	2	0	Plazi	ffb07bec-2d10-492d-9c37-361fe0b79427	8a8a87b6-7e06-4004-b74e-4bb7b0eca921
30	30	0	Plazi	ffb07bec-2d10-492d-9c37-361fe0b79427	8ca4d6b5-953c-443f-b6e5-fa12798918b0
52	52	0	GBIF Germany	4f6826f2-4ff6-443d-b966-e6913bd24013	8d4bb17e-f762-11e1-a439-00145eb45e9a
253	180	-73	GBIF Germany	4f6826f2-4ff6-443d-b966-e6913bd24013	8dd9a7f4-f762-11e1-a439-00145eb45e9a
12	12	0	Plazi	ffb07bec-2d10-492d-9c37-361fe0b79427	8e2d27e3-dec0-4ebb-bcd3-dd16e56c8092
72	55	-17	GBIF Germany	4f6826f2-4ff6-443d-b966-e6913bd24013	8eab3f76-f762-11e1-a439-00145eb45e9a
42620	42622	2	U.S. Geological Survey	8618c64a-93e0-4300-b546-7249e5148ed2	8f79c802-a58c-447f-99aa-1d6a0790825a
127	127	0	Plazi	ffb07bec-2d10-492d-9c37-361fe0b79427	8fa896d4-6b42-485c-a053-9f4d04aed213
273	147	-126	GBIF Germany	4f6826f2-4ff6-443d-b966-e6913bd24013	90798538-f762-11e1-a439-00145eb45e9a
13	13	0	Plazi	ffb07bec-2d10-492d-9c37-361fe0b79427	91d1d6e8-ffef-4ee8-a7a1-50ecf20cf25d
1746	1746	0	GBIF France	da44cd31-5901-4687-a106-6d1c7734ee3a	9243e1f0-19a4-4fe6-99fc-5f7da7eb95d9
600	255	-345	GBIF Germany	4f6826f2-4ff6-443d-b966-e6913bd24013	9343b496-f762-11e1-a439-00145eb45e9a
89	89	0	GBIF Germany	4f6826f2-4ff6-443d-b966-e6913bd24013	93a8db5a-f762-11e1-a439-00145eb45e9a
3	3	0	GBIF Germany	4f6826f2-4ff6-443d-b966-e6913bd24013	957b566a-f762-11e1-a439-00145eb45e9a
87	87	0	GBIF France	da44cd31-5901-4687-a106-6d1c7734ee3a	95dca5f9-1195-4ba0-ac59-913793489c5b
73574	73574	0	GBIF Spain	1f94b3ca-9345-4d65-afe2-4bace93aa0fe	95ed1fa5-2923-4459-836b-11ad8cc4bf42
153	153	0	GBIF Germany	4f6826f2-4ff6-443d-b966-e6913bd24013	96125ee8-f762-11e1-a439-00145eb45e9a
691	691	0	Biodiversity Information System of Mexico	b324e8e9-9a4c-44fa-8f1a-7f39ea7ab576	9812f014-d8f0-47ec-908d-1380377eece3
101480	101480	0	National Biodiversity Network	d897a5b9-35ee-4232-94bd-b0bcaac003c2	98af357b-541e-4f16-b35c-8ca68767be99
0	3	3	National Biodiversity Network	d897a5b9-35ee-4232-94bd-b0bcaac003c2	994e75fa-b187-4b07-a30e-665f4acbe394
43	43	0	GBIF France	da44cd31-5901-4687-a106-6d1c7734ee3a	99e7db5d-76fd-4460-bf12-2ead6bfddbe9
728736	869422	140686	Belgian Biodiversity Platform	fb11cfe1-ebc3-45af-9159-17d9fddbcdac	9a0b66df-7535-4f28-9f4e-5bc11b8b096c
366514	366514	0	U.S. Geological Survey	8618c64a-93e0-4300-b546-7249e5148ed2	9a71aa12-7636-4381-9986-d8f03240b277
4	4	0	Plazi	ffb07bec-2d10-492d-9c37-361fe0b79427	9c2b8f06-804c-483e-aa7d-e3e1f05ba318
1	1	0	Plazi	ffb07bec-2d10-492d-9c37-361fe0b79427	9cdbf4b8-5a10-4e26-bbcc-c8dcdba8a722
0	6	6	Plazi	ffb07bec-2d10-492d-9c37-361fe0b79427	9d1bef06-2a83-41f9-82b0-d377d375d29b
8	8	0	Plazi	ffb07bec-2d10-492d-9c37-361fe0b79427	9f4826b1-23a0-4446-8890-e063c759004b
172	172	0	GBIF France	da44cd31-5901-4687-a106-6d1c7734ee3a	9fe029d4-2905-40fe-9e2f-1e414db9e959
0	1	1	Plazi	ffb07bec-2d10-492d-9c37-361fe0b79427	a07b30c2-01ec-4961-a237-4b02cd71d756
0	4	4	Plazi	ffb07bec-2d10-492d-9c37-361fe0b79427	a0b8bc7c-8df3-45b1-a85f-072ad5a08434
99053	98994	-59	Netherlands Biodiversity Information Facility	0909d601-bda2-42df-9e63-a6d51847ebce	a57e6526-54c6-465a-baa9-904979bbc93f
5410	5410	0	GBIF France	da44cd31-5901-4687-a106-6d1c7734ee3a	a6f91225-b3bc-4ded-8374-c6c8c205baae
710	710	0	GBIF Finland	dd514216-5c7c-45f3-910d-797424cb5be6	abde2d9d-94ad-49cb-8186-ec49defb045e
63872	63872	0	GBIF Argentina	2426a871-9feb-40a1-96c6-0c593a76b835	ad9599c0-16f7-11df-b5b3-b8a03c50a862
2	2	0	GBIF France	da44cd31-5901-4687-a106-6d1c7734ee3a	aeb788c0-b2de-4bc2-beff-d75c19f4ee4a
0	3	3	Plazi	ffb07bec-2d10-492d-9c37-361fe0b79427	b174490e-9eec-4ae6-b521-de17bb76cc24
8	8	0	Plazi	ffb07bec-2d10-492d-9c37-361fe0b79427	b373394d-f4da-4c07-a55b-9f702cfb0f0f
2896	2896	0	GBIF Spain	1f94b3ca-9345-4d65-afe2-4bace93aa0fe	b654c4ea-db58-40ae-bd24-32bd65f4779b
2	2	0	Plazi	ffb07bec-2d10-492d-9c37-361fe0b79427	b7b5b805-3e1e-4f9f-ab6c-01de0d797fed
0	19	19	Plazi	ffb07bec-2d10-492d-9c37-361fe0b79427	bac2ce3a-2d0b-4bb8-9919-abbdd295518f
1200	1200	0	Belgian Biodiversity Platform	fb11cfe1-ebc3-45af-9159-17d9fddbcdac	bcac3656-d9c1-4b91-a2a1-7320a84df798
2	2	0	Plazi	ffb07bec-2d10-492d-9c37-361fe0b79427	bd01ca6e-7bb1-4c27-94da-ddaf9888bc27
120	120	0	Atlas of Living Australia	4a6f1b71-969e-4fc5-a693-282b05e1220c	bdb7dba3-b0e6-4490-8fb5-4be67cda2488
6	6	0	Plazi	ffb07bec-2d10-492d-9c37-361fe0b79427	bdf81ab0-b6c0-4c3a-a57f-7bdae697fb21
6641	6641	0	GBIF France	da44cd31-5901-4687-a106-6d1c7734ee3a	be00c56f-ab20-4418-9d3e-b55793638d09
4253	16426	12173	GBIF Brazil	cdc9736d-5ff7-4ece-9959-3c744360cdb3	bf0dd71d-364c-4f16-8612-2661f07f40a2
1073	1073	0	GBIF Japan	db5705aa-6a6e-42f1-8942-d77b9f4896ea	c2c60700-6c31-42e5-8c9a-6bbd28768af4
120	120	0	GBIF Japan	db5705aa-6a6e-42f1-8942-d77b9f4896ea	c40f7d17-a840-447e-97c9-c7edd7109cc9
1822	1822	0	Participant Node Managers Committee	7f48e0c8-5c96-49ec-b972-30748e339115	c8bdeeef-3c89-41b5-aa2e-2778976cc3cd
3	3	0	Plazi	ffb07bec-2d10-492d-9c37-361fe0b79427	cad2585a-731d-4319-9d3d-b8b29ffb09a8
13845	13845	0	National Biodiversity Network	d897a5b9-35ee-4232-94bd-b0bcaac003c2	cb4c3a5c-3b28-41a3-ace9-9fa7c60e0b31
1560	292449	290889	National Biodiversity Network	d897a5b9-35ee-4232-94bd-b0bcaac003c2	cba037aa-5d20-4d0c-9bcb-04e2e9453c7e
24	24	0	GBIF France	da44cd31-5901-4687-a106-6d1c7734ee3a	cd41ee33-8935-4eea-8ad3-8cf9346d7349
43	43	0	Plazi	ffb07bec-2d10-492d-9c37-361fe0b79427	cef5076b-424b-4cdc-8d13-6e472d861e09
1208	1208	0	Colombian Biodiversity Information System	7e865cba-7c46-417b-ade5-97f2cf5b7be0	d002c155-3025-4a2e-8843-fcefa96e2802
3	3	0	Plazi	ffb07bec-2d10-492d-9c37-361fe0b79427	d07bb500-5b81-49ba-bce3-53dff7b6d337
59	59	0	Participant Node Managers Committee	7f48e0c8-5c96-49ec-b972-30748e339115	d1dac821-aacb-4e46-926e-5750139f053f
1	1	0	Plazi	ffb07bec-2d10-492d-9c37-361fe0b79427	d3b0c3a8-bcb5-4017-bd61-542301b42857
0	25	25	Participant Node Managers Committee	7f48e0c8-5c96-49ec-b972-30748e339115	d4007c80-fe8e-4f91-aef6-97c2793cd910
43014	53343	10329	U.S. Geological Survey	8618c64a-93e0-4300-b546-7249e5148ed2	d4aea86c-bd2c-4526-ab57-c6a98dc057e5
0	3102	3102	Participant Node Managers Committee	7f48e0c8-5c96-49ec-b972-30748e339115	d6a5db54-ffb5-4399-bdfd-876d888d7184
0	21	21	Plazi	ffb07bec-2d10-492d-9c37-361fe0b79427	d7c23423-af16-4c2d-bd68-3526fb8bb654
8	8	0	Plazi	ffb07bec-2d10-492d-9c37-361fe0b79427	d8a05a87-6d76-4ca1-aec7-b198c357a060
5673	5856	183	GBIF Germany	4f6826f2-4ff6-443d-b966-e6913bd24013	dc144d63-5ac4-4d2b-a2a3-a1d554850b41
0	376	376	Plazi	ffb07bec-2d10-492d-9c37-361fe0b79427	e0112ec9-2b66-4726-88b6-5db0df9e8b43
1042	1042	0	Biodiversity Information System of Mexico	b324e8e9-9a4c-44fa-8f1a-7f39ea7ab576	e36f3c64-f9b8-4811-8bc7-b0452841f1fc
0	3	3	Plazi	ffb07bec-2d10-492d-9c37-361fe0b79427	e404734d-4396-4746-a307-5db5ffb2a780
1	1	0	Plazi	ffb07bec-2d10-492d-9c37-361fe0b79427	e4838e1b-d759-41de-b841-11e1e58e7805
176	176	0	U.S. Geological Survey	8618c64a-93e0-4300-b546-7249e5148ed2	e9ce0cbd-2e8e-4d78-804a-239abd591fcb
51000	479745	428745	U.S. Geological Survey	8618c64a-93e0-4300-b546-7249e5148ed2	ea09e0f4-36c4-4383-b04d-48da83a32c5c
452759	464027	11268	Taiwan Biodiversity Information Facility	e1b85abc-61f9-430f-ba79-6813dec53a0f	eb7681c5-5c9c-4e28-954f-f328991c7004
1	1	0	Plazi	ffb07bec-2d10-492d-9c37-361fe0b79427	ee200a72-86bd-47cf-ac62-a234d97c394a
607	607	0	Colombian Biodiversity Information System	7e865cba-7c46-417b-ade5-97f2cf5b7be0	f1586f46-712b-4d28-a89b-36a302166d4b
0	23	23	Plazi	ffb07bec-2d10-492d-9c37-361fe0b79427	f277d05f-a500-46f3-b159-563c2affd186
0	1	1	Plazi	ffb07bec-2d10-492d-9c37-361fe0b79427	f358bf78-e14c-4a91-8354-b744efc40163
209	209	0	U.S. Geological Survey	8618c64a-93e0-4300-b546-7249e5148ed2	f4013571-ec17-4e0b-95e9-10606ab51d4f
0	8	8	Plazi	ffb07bec-2d10-492d-9c37-361fe0b79427	f62caa9b-9794-41d0-8551-a6ccb1d2e092
0	1259	1259	Ocean Biodiversity Information System	ba0670b9-4186-41e6-8e70-f9cb3065551a	fe769795-5c11-4e20-8996-10124078fadd
179	179	0	Plazi	ffb07bec-2d10-492d-9c37-361fe0b79427	ff300143-3581-4909-ae95-8dec768fe27a
0	201	201	Plazi	ffb07bec-2d10-492d-9c37-361fe0b79427	013391dd-030e-46f9-8d78-3a11cc7aa959
2419	2419	0	Colombian Biodiversity Information System	7e865cba-7c46-417b-ade5-97f2cf5b7be0	01cba035-6a1a-410b-bff9-03413cf6f6dd
107	107	0	Participant Node Managers Committee	7f48e0c8-5c96-49ec-b972-30748e339115	030340f4-caa1-4337-a18b-a8d52a3fddfc
3621	3621	0	Ocean Biodiversity Information System	ba0670b9-4186-41e6-8e70-f9cb3065551a	075d0752-d817-498f-8be8-3c7797844fde
6	6	0	Plazi	ffb07bec-2d10-492d-9c37-361fe0b79427	09bd5c7f-53cc-40ef-895b-6dc1ae69747a
6	6	0	Plazi	ffb07bec-2d10-492d-9c37-361fe0b79427	09fe62a6-62e4-4c5e-b446-30e5141199f7
3	3	0	Plazi	ffb07bec-2d10-492d-9c37-361fe0b79427	0a9d76db-4663-4e2b-9e0a-f51c3f2cbe9a
1	1	0	GBIF France	da44cd31-5901-4687-a106-6d1c7734ee3a	0d02b613-283a-4ed3-af76-0fd9753c4ac0
734	734	0	Colombian Biodiversity Information System	7e865cba-7c46-417b-ade5-97f2cf5b7be0	0decf394-24f6-43da-9152-3af692cbf618
0	50	50	Colombian Biodiversity Information System	7e865cba-7c46-417b-ade5-97f2cf5b7be0	19762b92-45c3-4547-8960-17694bc279d5
5579	5385	-194	Biodiversity Information System of Mexico	b324e8e9-9a4c-44fa-8f1a-7f39ea7ab576	1a523735-7023-4457-8075-55ed885a5163
2765	2765	0	GBIF France	da44cd31-5901-4687-a106-6d1c7734ee3a	1c8ee49a-f4a1-4710-a6b6-c704156eedf8
145	145	0	Plazi	ffb07bec-2d10-492d-9c37-361fe0b79427	1ccec85a-ccd1-4151-b51a-411ba91ef406
13493	15198	1705	National Biodiversity Network	d897a5b9-35ee-4232-94bd-b0bcaac003c2	1e0353fa-78d9-4799-998a-74685255e04e
0	3	3	Plazi	ffb07bec-2d10-492d-9c37-361fe0b79427	25c8aaaa-846b-4b52-a81c-5fbbef7ee32b
30	30	0	Belgian Biodiversity Platform	fb11cfe1-ebc3-45af-9159-17d9fddbcdac	26129f66-fb74-4a89-bed7-812f2533b68c
0	60	60	Plazi	ffb07bec-2d10-492d-9c37-361fe0b79427	265a237e-3c48-4d63-adbd-33d6682aaf81
642	641	-1	Canada Biodiversity Information Facility	8f83fc96-c966-4126-83f7-bf044dc49efa	289f7f33-8ac4-4779-9883-e713f2aa5250
12	12	0	Plazi	ffb07bec-2d10-492d-9c37-361fe0b79427	31e9dec8-ac91-43e6-aef3-c43fb0ed82ad
4019	4019	0	GBIF Brazil	cdc9736d-5ff7-4ece-9959-3c744360cdb3	32ba1b9a-b06d-417e-98ea-eb0cfb67466a
12	12	0	Plazi	ffb07bec-2d10-492d-9c37-361fe0b79427	3508070f-0750-4b1d-84f0-0b5611ea6c3c
1	1	0	Plazi	ffb07bec-2d10-492d-9c37-361fe0b79427	356aa319-b5dd-426f-abc9-a7b53054e1d7
2	2	0	Plazi	ffb07bec-2d10-492d-9c37-361fe0b79427	36b1c2a7-be1b-4532-b25f-dcc48b7f9d35
158	158	0	Plazi	ffb07bec-2d10-492d-9c37-361fe0b79427	381202fb-343a-4c47-b17f-e3ad6df1b0fd
22441	22442	1	U.S. Geological Survey	8618c64a-93e0-4300-b546-7249e5148ed2	3ca53690-d42a-4b49-9f7d-e247d8eee7a5
1087	1087	0	GBIF Germany	4f6826f2-4ff6-443d-b966-e6913bd24013	3d57c2f0-4bc7-4a78-ae45-c29d081b2f60
13	13	0	Plazi	ffb07bec-2d10-492d-9c37-361fe0b79427	4154ae19-0a0b-4fde-974c-454ca69e6964
90	66	-24	GBIF Germany	4f6826f2-4ff6-443d-b966-e6913bd24013	42c1f470-e2ab-41e1-875e-98731bf10bd7
67	67	0	Participant Node Managers Committee	7f48e0c8-5c96-49ec-b972-30748e339115	444a8483-2205-46d6-917f-b27a3ec94729
6	6	0	Plazi	ffb07bec-2d10-492d-9c37-361fe0b79427	4532e6c7-62f0-4889-a145-ce6197f18511
3	3	0	Plazi	ffb07bec-2d10-492d-9c37-361fe0b79427	45b5a7e8-c2b0-491c-93e9-e62ab286ba6d
8853	12115	3262	U.S. Geological Survey	8618c64a-93e0-4300-b546-7249e5148ed2	4655f1f3-60a5-4346-a343-84f5836a4585
0	2	2	Colombian Biodiversity Information System	7e865cba-7c46-417b-ade5-97f2cf5b7be0	4b498fc9-bdfd-4bfb-805f-d9ee1f3ae44b
0	5	5	Plazi	ffb07bec-2d10-492d-9c37-361fe0b79427	4f2d5446-9799-4427-a9b3-1a281ba944b3
0	1349	1349	Ocean Biodiversity Information System	ba0670b9-4186-41e6-8e70-f9cb3065551a	50e6b980-2404-492d-acb1-2fc161fb3705
367	367	0	GBIF France	da44cd31-5901-4687-a106-6d1c7734ee3a	531c20a7-cd40-4a32-9d54-880a1769862f
0	5	5	Ocean Biodiversity Information System	ba0670b9-4186-41e6-8e70-f9cb3065551a	58519d90-4a7a-4a78-bb60-d5132e728e6d
4	4	0	Plazi	ffb07bec-2d10-492d-9c37-361fe0b79427	592615d7-2405-46ef-bb06-9a309565e4e1
761	682	-79	Biodiversity Information System of Mexico	b324e8e9-9a4c-44fa-8f1a-7f39ea7ab576	5a0cf651-a5d2-4645-b022-77f241218857
14	14	0	Plazi	ffb07bec-2d10-492d-9c37-361fe0b79427	5b0e7e0f-ea7c-4958-bab8-b781b0a17f08
0	6	6	Plazi	ffb07bec-2d10-492d-9c37-361fe0b79427	5b9a5515-8fe1-4bad-9889-dedfef5b3032
9	9	0	Plazi	ffb07bec-2d10-492d-9c37-361fe0b79427	5c4392c3-3b82-435e-aa25-b3458f39af89
45	45	0	Belgian Biodiversity Platform	fb11cfe1-ebc3-45af-9159-17d9fddbcdac	5d56b7b0-61d0-4522-ab84-eb75b3afc568
0	3	3	Plazi	ffb07bec-2d10-492d-9c37-361fe0b79427	5f152e23-7bb3-4aa9-8cc9-cbda847073bf
102	102	0	GBIF Germany	4f6826f2-4ff6-443d-b966-e6913bd24013	61371c7c-f762-11e1-a439-00145eb45e9a
0	66	66	Ocean Biodiversity Information System	ba0670b9-4186-41e6-8e70-f9cb3065551a	61a8d488-6a8c-4bb9-83be-c80e74ce6c06
0	121	121	Plazi	ffb07bec-2d10-492d-9c37-361fe0b79427	6206d142-3b21-4c39-afca-75b602420619
36	36	0	Plazi	ffb07bec-2d10-492d-9c37-361fe0b79427	623ad777-a27c-4c95-a742-6fefa2c9c785
126	126	0	GBIF Germany	4f6826f2-4ff6-443d-b966-e6913bd24013	638cedc6-f762-11e1-a439-00145eb45e9a
106	106	0	GBIF Germany	4f6826f2-4ff6-443d-b966-e6913bd24013	63dd7412-f762-11e1-a439-00145eb45e9a
504	504	0	GBIF Germany	4f6826f2-4ff6-443d-b966-e6913bd24013	640802ae-f762-11e1-a439-00145eb45e9a
234	234	0	GBIF Germany	4f6826f2-4ff6-443d-b966-e6913bd24013	64116286-f762-11e1-a439-00145eb45e9a
0	254	254	Indonesian Biodiversity Information Facility	2ebd91f6-f14f-4375-b525-c011a3774f03	646fdab4-6cb0-4d54-b569-d6d306ce7580
901	901	0	GBIF Germany	4f6826f2-4ff6-443d-b966-e6913bd24013	64d089ce-378c-4334-a060-f724dffa62fc
0	44	44	Plazi	ffb07bec-2d10-492d-9c37-361fe0b79427	65ad5988-5a09-4c75-bcc5-0461cec8646c
1023	1015	-8	GBIF Germany	4f6826f2-4ff6-443d-b966-e6913bd24013	66109458-f762-11e1-a439-00145eb45e9a
41	41	0	GBIF Germany	4f6826f2-4ff6-443d-b966-e6913bd24013	66806832-f762-11e1-a439-00145eb45e9a
92	92	0	GBIF Germany	4f6826f2-4ff6-443d-b966-e6913bd24013	67e888f8-f762-11e1-a439-00145eb45e9a
80	80	0	GBIF France	da44cd31-5901-4687-a106-6d1c7734ee3a	691709fb-cfb4-4d44-a090-6523e8ef7a99
237	237	0	GBIF Germany	4f6826f2-4ff6-443d-b966-e6913bd24013	6981d5ca-f762-11e1-a439-00145eb45e9a
79	79	0	GBIF Germany	4f6826f2-4ff6-443d-b966-e6913bd24013	699e01be-f762-11e1-a439-00145eb45e9a
223	223	0	GBIF Germany	4f6826f2-4ff6-443d-b966-e6913bd24013	6a7726f6-f762-11e1-a439-00145eb45e9a
0	17	17	Colombian Biodiversity Information System	7e865cba-7c46-417b-ade5-97f2cf5b7be0	6bf4bc3e-2646-4f0c-bf08-970795089bd7
229	229	0	National Biodiversity Network	d897a5b9-35ee-4232-94bd-b0bcaac003c2	6d224a09-ba03-4b4f-babb-a1fa3bb3820b
48351	48351	0	National Biodiversity Network	d897a5b9-35ee-4232-94bd-b0bcaac003c2	6f721754-b685-4ed4-a097-dcd29d27b523
9	9	0	GBIF Germany	4f6826f2-4ff6-443d-b966-e6913bd24013	6fa47516-f762-11e1-a439-00145eb45e9a
0	2	2	Plazi	ffb07bec-2d10-492d-9c37-361fe0b79427	70167c7e-d03c-4a53-aa20-a07520a3d766
495	474	-21	GBIF Germany	4f6826f2-4ff6-443d-b966-e6913bd24013	70b2bff8-f762-11e1-a439-00145eb45e9a
194	194	0	GBIF Germany	4f6826f2-4ff6-443d-b966-e6913bd24013	72208bfe-f762-11e1-a439-00145eb45e9a
1	1	0	Plazi	ffb07bec-2d10-492d-9c37-361fe0b79427	72d3c4d5-ff65-4f6d-820f-d04b5c93a7ed
312	312	0	GBIF Germany	4f6826f2-4ff6-443d-b966-e6913bd24013	732b589e-f762-11e1-a439-00145eb45e9a
1	1	0	GBIF Germany	4f6826f2-4ff6-443d-b966-e6913bd24013	733f35c6-f762-11e1-a439-00145eb45e9a
58	58	0	GBIF Germany	4f6826f2-4ff6-443d-b966-e6913bd24013	7346db32-f762-11e1-a439-00145eb45e9a
170	170	0	GBIF Germany	4f6826f2-4ff6-443d-b966-e6913bd24013	73536942-f762-11e1-a439-00145eb45e9a
3	3	0	GBIF Germany	4f6826f2-4ff6-443d-b966-e6913bd24013	741000e8-f762-11e1-a439-00145eb45e9a
0	36	36	Plazi	ffb07bec-2d10-492d-9c37-361fe0b79427	77c4fabe-4556-4efa-a2b4-e9ddfe86a6c5
1	1	0	GBIF Germany	4f6826f2-4ff6-443d-b966-e6913bd24013	78799306-f762-11e1-a439-00145eb45e9a
1	1	0	GBIF Germany	4f6826f2-4ff6-443d-b966-e6913bd24013	7896e762-f762-11e1-a439-00145eb45e9a
0	5	5	Plazi	ffb07bec-2d10-492d-9c37-361fe0b79427	78e853f4-59a8-4716-ae9a-662cc2ada33b
9	9	0	GBIF Germany	4f6826f2-4ff6-443d-b966-e6913bd24013	78faa982-f762-11e1-a439-00145eb45e9a
6	6	0	Plazi	ffb07bec-2d10-492d-9c37-361fe0b79427	79331c17-cf32-4763-9cd4-87b408b929f3
62	48	-14	GBIF Germany	4f6826f2-4ff6-443d-b966-e6913bd24013	7970727a-f762-11e1-a439-00145eb45e9a
266	242	-24	GBIF Germany	4f6826f2-4ff6-443d-b966-e6913bd24013	79bfa80e-f762-11e1-a439-00145eb45e9a
765	765	0	GBIF Germany	4f6826f2-4ff6-443d-b966-e6913bd24013	79e8d774-f762-11e1-a439-00145eb45e9a
7	7	0	National Biodiversity Network	d897a5b9-35ee-4232-94bd-b0bcaac003c2	79e9bfdb-f422-4161-a14f-7366a507cfd9
65	65	0	GBIF Germany	4f6826f2-4ff6-443d-b966-e6913bd24013	7a6f4e94-f762-11e1-a439-00145eb45e9a
3102	3102	0	Korean Biodiversity Information Facility	e0a1e772-0177-4800-94b4-2d023fe6cdf4	7aeba48a-f762-11e1-a439-00145eb45e9a
2371	1870	-501	GBIF Germany	4f6826f2-4ff6-443d-b966-e6913bd24013	7bdbc212-f762-11e1-a439-00145eb45e9a
53062	53062	0	National Biodiversity Network	d897a5b9-35ee-4232-94bd-b0bcaac003c2	7c12e4d6-f762-11e1-a439-00145eb45e9a
1437	1437	0	GBIF Germany	4f6826f2-4ff6-443d-b966-e6913bd24013	7dd269d6-f762-11e1-a439-00145eb45e9a
1569	1569	0	GBIF Germany	4f6826f2-4ff6-443d-b966-e6913bd24013	7e56cb18-f762-11e1-a439-00145eb45e9a
2387	2387	0	Biodiversity Information System of Mexico	b324e8e9-9a4c-44fa-8f1a-7f39ea7ab576	7f6025cc-f762-11e1-a439-00145eb45e9a
179	179	0	Biodiversity Information System of Mexico	b324e8e9-9a4c-44fa-8f1a-7f39ea7ab576	80959102-f762-11e1-a439-00145eb45e9a
42	42	0	GBIF Germany	4f6826f2-4ff6-443d-b966-e6913bd24013	81576af2-f762-11e1-a439-00145eb45e9a
7	7	0	Plazi	ffb07bec-2d10-492d-9c37-361fe0b79427	81db55ed-b19e-42e9-930e-f9697834cc1b
338	338	0	Atlas of Living Australia	4a6f1b71-969e-4fc5-a693-282b05e1220c	8226ec75-9bba-4351-a101-79306a7dcd55
15	15	0	GBIF Germany	4f6826f2-4ff6-443d-b966-e6913bd24013	82690248-f762-11e1-a439-00145eb45e9a
205599	205599	0	CABI Bioscience	ed988a18-81f8-4d5f-a88d-f93ef592b2f2	8323a4b8-f762-11e1-a439-00145eb45e9a
226498	226498	0	GBIF Spain	1f94b3ca-9345-4d65-afe2-4bace93aa0fe	8375dada-f762-11e1-a439-00145eb45e9a
85	85	0	GBIF France	da44cd31-5901-4687-a106-6d1c7734ee3a	8402eb5f-eae1-4718-9437-e6d69b03bf5b
1513	1513	0	Canada Biodiversity Information Facility	8f83fc96-c966-4126-83f7-bf044dc49efa	844e3b00-f762-11e1-a439-00145eb45e9a
20584	20584	0	GBIF Portugal	673f7038-4262-4149-b753-5658a4e912f6	875efb2d-7527-4f91-8583-04e3d2e47176
0	398	398	Participant Node Managers Committee	7f48e0c8-5c96-49ec-b972-30748e339115	88cf2487-51a5-4f9a-a6a2-82ad28398dc9
245157	245157	0	U.S. Geological Survey	8618c64a-93e0-4300-b546-7249e5148ed2	89a2cd92-b5e0-44da-862b-968e12e1036f
6	6	0	Plazi	ffb07bec-2d10-492d-9c37-361fe0b79427	8bb99db7-6ec1-4e9a-8217-7058f1436600
131	131	0	GBIF Japan	db5705aa-6a6e-42f1-8942-d77b9f4896ea	8c3b1fa0-5120-4e8f-8fc2-93af3ecab69f
1822	1822	0	GBIF France	da44cd31-5901-4687-a106-6d1c7734ee3a	8cae7718-efd5-425d-b49f-4dfd1f6c947d
14	12	-2	GBIF Germany	4f6826f2-4ff6-443d-b966-e6913bd24013	8cfb4d1a-f762-11e1-a439-00145eb45e9a
0	15	15	Plazi	ffb07bec-2d10-492d-9c37-361fe0b79427	8e613818-120e-411b-8dfb-f18be609622d
24	24	0	Plazi	ffb07bec-2d10-492d-9c37-361fe0b79427	8e8e2c68-f230-43fb-b1a4-5678728ce547
310	244	-66	GBIF Germany	4f6826f2-4ff6-443d-b966-e6913bd24013	8ec8962a-f762-11e1-a439-00145eb45e9a
314	314	0	GBIF Germany	4f6826f2-4ff6-443d-b966-e6913bd24013	8f1eb136-f762-11e1-a439-00145eb45e9a
555	424	-131	GBIF Germany	4f6826f2-4ff6-443d-b966-e6913bd24013	8f511bc6-f762-11e1-a439-00145eb45e9a
128	103	-25	GBIF Germany	4f6826f2-4ff6-443d-b966-e6913bd24013	90bcf46c-f762-11e1-a439-00145eb45e9a
1	1	0	Plazi	ffb07bec-2d10-492d-9c37-361fe0b79427	915aa501-4951-4575-9f57-11051ba377e6
273	273	0	GBIF France	da44cd31-5901-4687-a106-6d1c7734ee3a	91625548-93dd-43f7-b29f-1d0c1d361d73
100	100	0	GBIF Germany	4f6826f2-4ff6-443d-b966-e6913bd24013	92ef7b2e-f762-11e1-a439-00145eb45e9a
492	492	0	GBIF Germany	4f6826f2-4ff6-443d-b966-e6913bd24013	9419502e-f762-11e1-a439-00145eb45e9a
560	560	0	Albertine Rift Conservation Society	90a939d3-e99c-4f6d-915f-2616423b3735	9437b6e6-43b5-4514-bd6d-ef129ee7f716
92566	92566	0	Taiwan Biodiversity Information Facility	e1b85abc-61f9-430f-ba79-6813dec53a0f	96c33790-a2b5-11de-9f79-b8a03c50a862
944	944	0	GBIF Germany	4f6826f2-4ff6-443d-b966-e6913bd24013	972f95ca-f762-11e1-a439-00145eb45e9a
15323	15323	0	Biodiversity Information System of Mexico	b324e8e9-9a4c-44fa-8f1a-7f39ea7ab576	987fc6a5-1a11-452b-be14-b89e027fa3e4
10	10	0	Plazi	ffb07bec-2d10-492d-9c37-361fe0b79427	9a6fe80f-4530-4a35-b95e-8f64180c5ce4
53	53	0	Plazi	ffb07bec-2d10-492d-9c37-361fe0b79427	9c7f14b6-7cfb-4305-88b1-8ce90d4b21e7
2512	2512	0	GBIF France	da44cd31-5901-4687-a106-6d1c7734ee3a	9d0377f3-3a56-430c-9e81-e9e2e93be009
239	239	0	GBIF Japan	db5705aa-6a6e-42f1-8942-d77b9f4896ea	9ed0fa79-fe38-4754-aa5b-599d35192ab9
38120	38120	0	National Biodiversity Network	d897a5b9-35ee-4232-94bd-b0bcaac003c2	9f31bff8-417e-4b3f-8cae-6ee4aa9bc0ee
5933	5933	0	National Biodiversity Network	d897a5b9-35ee-4232-94bd-b0bcaac003c2	9fe6317a-f97e-4174-8c80-7d4f530f25ba
60	60	0	Plazi	ffb07bec-2d10-492d-9c37-361fe0b79427	a068f737-c024-4d3d-b88b-665915062ec6
3	3	0	Plazi	ffb07bec-2d10-492d-9c37-361fe0b79427	a1d56c0b-d41f-42c1-91d2-417ab340969f
0	10	10	Plazi	ffb07bec-2d10-492d-9c37-361fe0b79427	a2120d24-68fa-4774-acda-400fbcb0e9e8
0	2	2	Plazi	ffb07bec-2d10-492d-9c37-361fe0b79427	a2ed8bfa-e56f-4dc6-bc01-382e9b8cb3da
0	111	111	Plazi	ffb07bec-2d10-492d-9c37-361fe0b79427	a680b0d1-c6c7-4352-bc7c-3e86a6553f20
4315	4315	0	GBIF France	da44cd31-5901-4687-a106-6d1c7734ee3a	a73d9e11-def6-4644-88fd-8cc40d9b8ffe
61	61	0	Plazi	ffb07bec-2d10-492d-9c37-361fe0b79427	aa3da0bc-3736-490e-ad9c-3e5f8f4524e1
1	1	0	Plazi	ffb07bec-2d10-492d-9c37-361fe0b79427	ab599439-e927-4110-8cc4-d6defe64afde
3	3	0	Plazi	ffb07bec-2d10-492d-9c37-361fe0b79427	afbdcf03-9533-47c5-9e13-607c5a98e3f0
0	22	22	Plazi	ffb07bec-2d10-492d-9c37-361fe0b79427	b20b7b3d-7fa7-4de7-87dd-9e00d48a6fa3
16	16	0	Plazi	ffb07bec-2d10-492d-9c37-361fe0b79427	b234abf6-4127-4bbe-a4da-07eb7316d36b
126	4123	3997	Participant Node Managers Committee	7f48e0c8-5c96-49ec-b972-30748e339115	b73e7171-f1de-47a6-8331-843ed8b541bb
22	22	0	GBIF France	da44cd31-5901-4687-a106-6d1c7734ee3a	b8526f0b-c7f9-4e66-9ddb-bc8f4ff4ec7e
91	91	0	GBIF France	da44cd31-5901-4687-a106-6d1c7734ee3a	b9f72571-9a88-4bdb-a844-d0e3c7526e93
0	128	128	Plazi	ffb07bec-2d10-492d-9c37-361fe0b79427	bc1808d3-bc32-492c-9751-b620076221dd
22	22	0	Biodiversity Information System of Mexico	b324e8e9-9a4c-44fa-8f1a-7f39ea7ab576	c0d0888f-ca9b-449d-8c50-782ba41e192a
13	13	0	Plazi	ffb07bec-2d10-492d-9c37-361fe0b79427	c6aa05ac-8e39-4b3f-bfe1-b0e6b1a7ecf9
0	5	5	Plazi	ffb07bec-2d10-492d-9c37-361fe0b79427	c893553d-672b-49a0-8e34-5d997485db18
0	3	3	Plazi	ffb07bec-2d10-492d-9c37-361fe0b79427	cd36da9c-a180-4a09-853e-5f954cebb346
1716	1716	0	GBIF Portugal	673f7038-4262-4149-b753-5658a4e912f6	ce8761c1-155e-4618-beea-6fcc8138bb37
121	121	0	Plazi	ffb07bec-2d10-492d-9c37-361fe0b79427	d2dda052-5654-4b34-bf72-b6d557300f7e
0	8	8	Plazi	ffb07bec-2d10-492d-9c37-361fe0b79427	d6c49314-7a28-4229-b6fc-deb6d4ebaa23
2	2	0	Plazi	ffb07bec-2d10-492d-9c37-361fe0b79427	d6df271c-3f52-4f1a-9610-5e3e35ac50bd
0	122	122	Colombian Biodiversity Information System	7e865cba-7c46-417b-ade5-97f2cf5b7be0	d70f9777-03da-40f6-8d56-07685bb8275d
0	5	5	Plazi	ffb07bec-2d10-492d-9c37-361fe0b79427	d7e35f99-5731-4e46-9cc1-0b051cbe6d26
0	22	22	Plazi	ffb07bec-2d10-492d-9c37-361fe0b79427	d801e893-f8da-4a4c-9f8f-3aeef7d6899d
153	153	0	U.S. Geological Survey	8618c64a-93e0-4300-b546-7249e5148ed2	d92c8859-ffcd-4c12-a45e-64b46238a521
139	139	0	Colombian Biodiversity Information System	7e865cba-7c46-417b-ade5-97f2cf5b7be0	da879b37-30d3-4481-af57-b9c247b0fe28
30	30	0	Plazi	ffb07bec-2d10-492d-9c37-361fe0b79427	daf6e39c-3494-4db6-aec3-cc924e4a0970
0	227	227	Plazi	ffb07bec-2d10-492d-9c37-361fe0b79427	dbdc2661-176d-437b-bfde-d4e19a4966c0
67450	67450	0	GBIF France	da44cd31-5901-4687-a106-6d1c7734ee3a	dceb7843-b7e7-4dc7-b50e-b978e52e27dc
62	62	0	Plazi	ffb07bec-2d10-492d-9c37-361fe0b79427	dedaf07a-3b6f-43b8-8544-4aea7dc74956
1000	4000	3000	GBIF Japan	db5705aa-6a6e-42f1-8942-d77b9f4896ea	e19c9d1c-f8f6-4c71-a30a-ae435bdd108d
7	7	0	GBIF Brazil	cdc9736d-5ff7-4ece-9959-3c744360cdb3	e3a69702-0626-4e3f-90c2-f0635acea053
3	3	0	Plazi	ffb07bec-2d10-492d-9c37-361fe0b79427	e5152ce0-a14b-4e7a-a676-26b4765bc49c
10	10	0	Plazi	ffb07bec-2d10-492d-9c37-361fe0b79427	e6037c5d-a96f-41e5-8e70-71f2659659e2
599	599	0	GBIF France	da44cd31-5901-4687-a106-6d1c7734ee3a	e7f4b20b-7ffc-4f0b-917f-0d110905d278
91745	91745	0	Canada Biodiversity Information Facility	8f83fc96-c966-4126-83f7-bf044dc49efa	e8a25a42-f125-476c-8554-3ec21cd51a84
0	59	59	Ocean Biodiversity Information System	ba0670b9-4186-41e6-8e70-f9cb3065551a	ebb3afba-d52f-4b4e-96ca-787091e0da09
235	235	0	Participant Node Managers Committee	7f48e0c8-5c96-49ec-b972-30748e339115	ee7253d4-2752-464a-9f50-7b5825362d70
606	606	0	GBIF Germany	4f6826f2-4ff6-443d-b966-e6913bd24013	efb9d197-c0c7-41c2-af6d-4ca97090467e
39	39	0	Plazi	ffb07bec-2d10-492d-9c37-361fe0b79427	f01c9bd1-7635-40c7-b5ee-5fc57320b880
21	21	0	Plazi	ffb07bec-2d10-492d-9c37-361fe0b79427	f1889f03-d51c-4de1-a1b5-339de952df0a
0	1	1	Plazi	ffb07bec-2d10-492d-9c37-361fe0b79427	f3ce9aa4-31b7-4052-b3fb-3fc23a82e65b
0	5	5	Colombian Biodiversity Information System	7e865cba-7c46-417b-ade5-97f2cf5b7be0	f3dbba47-85b7-48bf-bff8-29a56f65370a
0	6	6	Plazi	ffb07bec-2d10-492d-9c37-361fe0b79427	f3fad915-19f3-4cbf-9965-b9728f71415a
0	64	64	Plazi	ffb07bec-2d10-492d-9c37-361fe0b79427	f57429c6-ed18-4852-b5e9-e2f2f68864e2
0	7	7	Plazi	ffb07bec-2d10-492d-9c37-361fe0b79427	f694a4aa-15f4-4b42-82f1-d98ef73bf1d9
0	4439	4439	Participant Node Managers Committee	7f48e0c8-5c96-49ec-b972-30748e339115	f77b1a07-3442-41e9-b0c6-a04483ab7229
2	2	0	Plazi	ffb07bec-2d10-492d-9c37-361fe0b79427	fa48fb42-9802-436b-913a-b397f64a9cdb
385	385	0	GBIF France	da44cd31-5901-4687-a106-6d1c7734ee3a	fc447e7d-d0f1-4b00-9691-77ffcd11345a
35	35	0	GBIF Argentina	2426a871-9feb-40a1-96c6-0c593a76b835	fed71ed2-bdd2-4df0-8d21-d86c4ab6c7a5
0	8	8	Plazi	ffb07bec-2d10-492d-9c37-361fe0b79427	ff85e076-2c6e-4cc1-8e8b-44289b1e822d
3	3	0	Plazi	ffb07bec-2d10-492d-9c37-361fe0b79427	008dafd5-32fd-45e7-8593-ed53b2df0b41
8185	1286	-6899	Biodiversity Information System of Mexico	b324e8e9-9a4c-44fa-8f1a-7f39ea7ab576	012473a9-1c60-42d9-be83-53ab144b271b
0	11	11	Plazi	ffb07bec-2d10-492d-9c37-361fe0b79427	0296b9bb-3646-4732-a305-a37fead2e0f3
0	2	2	Plazi	ffb07bec-2d10-492d-9c37-361fe0b79427	05cfa689-7e1a-4a32-88e1-4c9240c69f1f
4314	4314	0	GBIF France	da44cd31-5901-4687-a106-6d1c7734ee3a	05d2d309-cebb-46eb-8863-0df342c006cd
0	101	101	Plazi	ffb07bec-2d10-492d-9c37-361fe0b79427	06992002-8592-45f5-ab21-cf1ec5fd61fa
37	37	0	Plazi	ffb07bec-2d10-492d-9c37-361fe0b79427	075e6c8b-fcc2-45f0-bc70-d005f3284db1
2	2	0	Plazi	ffb07bec-2d10-492d-9c37-361fe0b79427	07934676-c030-4ea1-be00-18250a89a2a6
0	4	4	Plazi	ffb07bec-2d10-492d-9c37-361fe0b79427	09db3a4a-d243-439a-b091-1543d3a60e89
0	105	105	Ocean Biodiversity Information System	ba0670b9-4186-41e6-8e70-f9cb3065551a	0a048742-3be2-4a43-bb89-cdbd48c302d0
67	67	0	National Biodiversity Network	d897a5b9-35ee-4232-94bd-b0bcaac003c2	0a40b4f4-9fc1-49d0-b4c5-d2b6d1ffb3f3
74	74	0	Participant Node Managers Committee	7f48e0c8-5c96-49ec-b972-30748e339115	0aee2de1-e151-42ff-91ee-4bc66b4e3cbb
10	10	0	Plazi	ffb07bec-2d10-492d-9c37-361fe0b79427	0c70e133-0761-4802-aa47-01182984a070
1068	1068	0	Belgian Biodiversity Platform	fb11cfe1-ebc3-45af-9159-17d9fddbcdac	0ce14307-45a5-4b4f-af50-8e63311ea9ab
957	957	0	Biodiversity Information System of Mexico	b324e8e9-9a4c-44fa-8f1a-7f39ea7ab576	0df70865-6344-453d-91be-fcef53f4554c
0	28	28	Plazi	ffb07bec-2d10-492d-9c37-361fe0b79427	0fb7e2ce-ee80-43ef-83b4-b92d0f64ca33
424	331	-93	GBIF Germany	4f6826f2-4ff6-443d-b966-e6913bd24013	105187ce-4916-486d-a2ee-8a8f699aa7fb
78	78	0	GBIF Argentina	2426a871-9feb-40a1-96c6-0c593a76b835	11133505-336e-4b8f-b797-1d153cf880bd
24	24	0	Plazi	ffb07bec-2d10-492d-9c37-361fe0b79427	126bf126-8ec3-4b6b-960f-85304455aeba
125	125	0	GBIF France	da44cd31-5901-4687-a106-6d1c7734ee3a	16f8fcde-0026-4b65-9a1f-d0f5bfe34859
24380	15410	-8970	GBIF Germany	4f6826f2-4ff6-443d-b966-e6913bd24013	18c1d733-6cea-4061-8450-8d68d9efbee6
54415	54415	0	GBIF New Zealand	4f9fd726-20dd-445e-89a1-8ed93792276f	18d0270e-899b-4a16-82f2-aa87d93bb1df
0	37	37	Plazi	ffb07bec-2d10-492d-9c37-361fe0b79427	1aa43d9b-a9da-41f9-b4a3-70b84c3cc978
0	7	7	Plazi	ffb07bec-2d10-492d-9c37-361fe0b79427	1ba38405-82cf-4640-9e7b-9d6954a2bbbe
0	291	291	Plazi	ffb07bec-2d10-492d-9c37-361fe0b79427	1f4f2c28-d4fa-487a-bf83-988cc35518ea
89	89	0	South African Biodiversity Information Facility	7190b835-4e86-4b6e-85c1-19cc6677c250	25be374b-8318-4a8c-ae3c-7ae592233afb
0	9	9	Plazi	ffb07bec-2d10-492d-9c37-361fe0b79427	27e8615f-ba3f-4d59-99a1-ecb8493d10f2
2	2	0	Participant Node Managers Committee	7f48e0c8-5c96-49ec-b972-30748e339115	29015374-e407-40d8-9779-78871fc5cd11
52	52	0	Biodiversity Information System of Mexico	b324e8e9-9a4c-44fa-8f1a-7f39ea7ab576	29a2453d-3dfc-4c40-82c9-d870f0e4a94e
3	3	0	Plazi	ffb07bec-2d10-492d-9c37-361fe0b79427	2aa0632f-4390-44b9-9632-af6d53c5a74f
5	5	0	Plazi	ffb07bec-2d10-492d-9c37-361fe0b79427	2b390cb8-dc44-4bd6-a86d-296cabf3af02
55521	56545	1024	U.S. Geological Survey	8618c64a-93e0-4300-b546-7249e5148ed2	2f54cb88-4167-499a-81fb-0a2d02465212
58	58	0	Secretariat of the Pacific Regional Environment Programme	29c6a139-ea7f-41f5-8d9b-c55af8736182	329c9f4f-13eb-4a69-9c56-09923e394dcf
0	34	34	Plazi	ffb07bec-2d10-492d-9c37-361fe0b79427	37ab0d60-c931-4718-b85a-00d5087fca50
0	310	310	Colombian Biodiversity Information System	7e865cba-7c46-417b-ade5-97f2cf5b7be0	38544679-2638-4b4f-a9b9-7e70e29a18d0
9	9	0	National Biodiversity Network	d897a5b9-35ee-4232-94bd-b0bcaac003c2	38a07e76-9038-4618-822a-b5b9ac1a26eb
3904	3904	0	GBIF France	da44cd31-5901-4687-a106-6d1c7734ee3a	3995de8f-297d-4e5a-ac3a-0aacf521b24c
0	5	5	Plazi	ffb07bec-2d10-492d-9c37-361fe0b79427	3a6868dd-e0c2-4db2-9060-37c85a02f821
0	51	51	Plazi	ffb07bec-2d10-492d-9c37-361fe0b79427	3aeceeaa-e311-4389-b8eb-99dee5dbfbc6
51	51	0	Plazi	ffb07bec-2d10-492d-9c37-361fe0b79427	3b6f03c1-2954-473a-af9e-05e6ed66f807
0	24244	24244	Korean Biodiversity Information Facility	e0a1e772-0177-4800-94b4-2d023fe6cdf4	3bd7e9fb-2e43-480d-a7de-681dfd3449f4
0	3	3	Plazi	ffb07bec-2d10-492d-9c37-361fe0b79427	3f848bfb-4405-46de-a7fd-b85eff5d1d8c
105	105	0	Plazi	ffb07bec-2d10-492d-9c37-361fe0b79427	417a8abe-82fc-4168-9301-d8adf334b764
42	42	0	Plazi	ffb07bec-2d10-492d-9c37-361fe0b79427	455a3682-4614-4606-b4af-b648f3b661e3
12528	12528	0	GBIF Portugal	673f7038-4262-4149-b753-5658a4e912f6	458df1aa-00d4-477a-8bc9-faaa21e08ce1
8	8	0	GBIF France	da44cd31-5901-4687-a106-6d1c7734ee3a	4900d034-1566-4d1d-83db-51c13f39dfd6
869	869	0	GBIF France	da44cd31-5901-4687-a106-6d1c7734ee3a	4c357b4d-74a4-4a77-b89d-1e84d450f5da
11	11	0	Plazi	ffb07bec-2d10-492d-9c37-361fe0b79427	4c53e97d-685a-445a-b6c9-c8db8c264d5d
2457	2471	14	Colombian Biodiversity Information System	7e865cba-7c46-417b-ade5-97f2cf5b7be0	4cb6c022-7654-4901-bb3d-e7028a26b1ac
0	9	9	Plazi	ffb07bec-2d10-492d-9c37-361fe0b79427	4e0fd1af-982f-4163-8dc8-3ef3ca423398
1395	1395	0	GBIF France	da44cd31-5901-4687-a106-6d1c7734ee3a	4f075d7d-5e73-4349-95ff-5f1416144a0d
29691	29691	0	Netherlands Biodiversity Information Facility	0909d601-bda2-42df-9e63-a6d51847ebce	50361be0-d9cd-11de-b793-b8a03c50a862
0	310	310	Participant Node Managers Committee	7f48e0c8-5c96-49ec-b972-30748e339115	504f1f75-355f-417d-9f99-60409230b264
0	6	6	Plazi	ffb07bec-2d10-492d-9c37-361fe0b79427	51ebf2e6-2f47-40ce-9c2c-e4a5f0770af4
0	6	6	Plazi	ffb07bec-2d10-492d-9c37-361fe0b79427	5323143f-4530-4bd7-a643-9b34fc48c2d7
10079	10079	0	Atlas of Living Australia	4a6f1b71-969e-4fc5-a693-282b05e1220c	533f6552-5f60-42b0-a616-af66650d3d91
0	5	5	Plazi	ffb07bec-2d10-492d-9c37-361fe0b79427	54afaad7-d45d-44b5-996b-64ea0f19bd46
82	82	0	Plazi	ffb07bec-2d10-492d-9c37-361fe0b79427	563cde0f-0524-46fc-9b9a-dcdb3ca5eb98
6	6	0	Plazi	ffb07bec-2d10-492d-9c37-361fe0b79427	57df72fe-c428-4955-b947-d26de55bd547
272	272	0	Biodiversity Information System of Mexico	b324e8e9-9a4c-44fa-8f1a-7f39ea7ab576	5868a20d-f038-4a48-8c20-dc22c2246196
3436	3436	0	GBIF France	da44cd31-5901-4687-a106-6d1c7734ee3a	586fa366-648c-48d3-a590-88a3ce00dfa0
0	43	43	Plazi	ffb07bec-2d10-492d-9c37-361fe0b79427	58b56ac0-2210-4fe2-83aa-014d62375696
113	113	0	Participant Node Managers Committee	7f48e0c8-5c96-49ec-b972-30748e339115	5dd0169f-3b69-41e6-bc1c-278d44c4f2fe
4	4	0	Plazi	ffb07bec-2d10-492d-9c37-361fe0b79427	5fa08e75-1d09-4ec4-84e5-d3d97cac1459
0	5786	5786	Participant Node Managers Committee	7f48e0c8-5c96-49ec-b972-30748e339115	61384edd-2d0a-437b-8cf0-ff4d2dfcc0da
6	6	0	Plazi	ffb07bec-2d10-492d-9c37-361fe0b79427	621e183b-789b-4d5e-bc43-64000219e1a8
3350	3350	0	Taiwan Biodiversity Information Facility	e1b85abc-61f9-430f-ba79-6813dec53a0f	63a81a32-3381-442a-9f79-11945c7e296f
0	324	324	GBIF Japan	db5705aa-6a6e-42f1-8942-d77b9f4896ea	63b42483-48e8-4dd8-acca-a8ad35e72f45
198	198	0	GBIF Germany	4f6826f2-4ff6-443d-b966-e6913bd24013	647a6182-f762-11e1-a439-00145eb45e9a
93	93	0	GBIF France	da44cd31-5901-4687-a106-6d1c7734ee3a	6488725f-3123-46d8-ba89-8c8bc7e1d861
205	205	0	GBIF Germany	4f6826f2-4ff6-443d-b966-e6913bd24013	64a7c406-f762-11e1-a439-00145eb45e9a
0	188	188	Plazi	ffb07bec-2d10-492d-9c37-361fe0b79427	64eab05b-4539-4be2-bb06-7af4369949e0
16	12	-4	GBIF Germany	4f6826f2-4ff6-443d-b966-e6913bd24013	65c0360c-f762-11e1-a439-00145eb45e9a
60	60	0	GBIF Germany	4f6826f2-4ff6-443d-b966-e6913bd24013	66a85874-f762-11e1-a439-00145eb45e9a
96	96	0	GBIF Germany	4f6826f2-4ff6-443d-b966-e6913bd24013	67af7a36-f762-11e1-a439-00145eb45e9a
1	1	0	Plazi	ffb07bec-2d10-492d-9c37-361fe0b79427	67c03d05-6c1c-4f88-862d-b061d05e9bf9
53	53	0	GBIF Germany	4f6826f2-4ff6-443d-b966-e6913bd24013	67cff0fe-f762-11e1-a439-00145eb45e9a
87	87	0	GBIF Germany	4f6826f2-4ff6-443d-b966-e6913bd24013	68093cc4-f762-11e1-a439-00145eb45e9a
825	592	-233	GBIF Germany	4f6826f2-4ff6-443d-b966-e6913bd24013	69f201f6-f762-11e1-a439-00145eb45e9a
66	66	0	GBIF Germany	4f6826f2-4ff6-443d-b966-e6913bd24013	6a67c2ec-f762-11e1-a439-00145eb45e9a
18	18	0	GBIF Germany	4f6826f2-4ff6-443d-b966-e6913bd24013	6b06cdc4-f762-11e1-a439-00145eb45e9a
18	18	0	GBIF Germany	4f6826f2-4ff6-443d-b966-e6913bd24013	6b9a1368-f762-11e1-a439-00145eb45e9a
0	47	47	Plazi	ffb07bec-2d10-492d-9c37-361fe0b79427	6bfd846c-0304-4330-8941-95c406630230
33785	34579	794	U.S. Geological Survey	8618c64a-93e0-4300-b546-7249e5148ed2	6ce7290f-47f6-4046-8356-371f5b6749df
2	2	0	Plazi	ffb07bec-2d10-492d-9c37-361fe0b79427	6f0aff81-a0bf-4eba-b15f-ca0bb7cfe2d4
0	3	3	Plazi	ffb07bec-2d10-492d-9c37-361fe0b79427	6f5f5060-256a-4be0-b8d7-37e078fd2fe7
2231	2231	0	National Biodiversity Network	d897a5b9-35ee-4232-94bd-b0bcaac003c2	6fcf50a3-7cd5-486b-9854-255e803a264a
0	376	376	Netherlands Biodiversity Information Facility	0909d601-bda2-42df-9e63-a6d51847ebce	6fe2c62e-449b-437d-ba71-ee0dc70e8ced
0	9	9	Plazi	ffb07bec-2d10-492d-9c37-361fe0b79427	70f5941e-cb45-46da-8038-81064d9595e8
52881	52881	0	National Biodiversity Network	d897a5b9-35ee-4232-94bd-b0bcaac003c2	710ad05a-25cf-4129-80ce-c2702cdfa33f
135	87	-48	GBIF Germany	4f6826f2-4ff6-443d-b966-e6913bd24013	710ad224-f762-11e1-a439-00145eb45e9a
1	1	0	Plazi	ffb07bec-2d10-492d-9c37-361fe0b79427	7236fc85-4203-46da-bb11-304a5945b583
112	112	0	GBIF Germany	4f6826f2-4ff6-443d-b966-e6913bd24013	74fdd6c4-f762-11e1-a439-00145eb45e9a
300	141	-159	Biodiversity Information System of Mexico	b324e8e9-9a4c-44fa-8f1a-7f39ea7ab576	772b065f-0b77-4557-934b-81efba7f4610
73	73	0	Biodiversity Information System of Mexico	b324e8e9-9a4c-44fa-8f1a-7f39ea7ab576	77db804c-5a86-42e0-8f4c-65a76d1aca4b
117	117	0	GBIF Germany	4f6826f2-4ff6-443d-b966-e6913bd24013	7838f68e-f762-11e1-a439-00145eb45e9a
825	825	0	GBIF Benin	efb9c00e-f802-45dd-8826-a52ec45b89ff	788fbea1-8f16-49fa-8daa-6ebd9c9b6ff9
3	3	0	GBIF Germany	4f6826f2-4ff6-443d-b966-e6913bd24013	789c1ab6-f762-11e1-a439-00145eb45e9a
2996	2996	0	GBIF France	da44cd31-5901-4687-a106-6d1c7734ee3a	7989688f-25dc-4ad5-b7e2-34f0d680c03a
486	486	0	GBIF France	da44cd31-5901-4687-a106-6d1c7734ee3a	79fc1860-6a73-41d9-8ed4-4e6baaf23d75
3578	3578	0	National Biodiversity Network	d897a5b9-35ee-4232-94bd-b0bcaac003c2	7aa24e43-257b-44b6-ab4d-695372f2e3f3
11906	11906	0	GBIF Brazil	cdc9736d-5ff7-4ece-9959-3c744360cdb3	7aeb3ded-7443-4512-95f7-2ec7ab0f308c
1001	1001	0	Korean Biodiversity Information Facility	e0a1e772-0177-4800-94b4-2d023fe6cdf4	7b0bc332-f762-11e1-a439-00145eb45e9a
12	12	0	Plazi	ffb07bec-2d10-492d-9c37-361fe0b79427	7b405761-b22d-48bd-9d78-afe3e77e47a5
152	152	0	Ocean Biodiversity Information System	ba0670b9-4186-41e6-8e70-f9cb3065551a	7d122ae7-ef18-42a7-a0d4-bf4540826dbc
1128	392	-736	GBIF Germany	4f6826f2-4ff6-443d-b966-e6913bd24013	7f4014f8-f762-11e1-a439-00145eb45e9a
4489	1592	-2897	Biodiversity Information System of Mexico	b324e8e9-9a4c-44fa-8f1a-7f39ea7ab576	80307a38-f762-11e1-a439-00145eb45e9a
822	822	0	Biodiversity Information System of Mexico	b324e8e9-9a4c-44fa-8f1a-7f39ea7ab576	805e193e-f762-11e1-a439-00145eb45e9a
5779	5780	1	Biodiversity Information System of Mexico	b324e8e9-9a4c-44fa-8f1a-7f39ea7ab576	80b2b8cc-f762-11e1-a439-00145eb45e9a
6723	3735	-2988	GBIF Germany	4f6826f2-4ff6-443d-b966-e6913bd24013	81da4224-f762-11e1-a439-00145eb45e9a
2427	2427	0	Atlas of Living Australia	4a6f1b71-969e-4fc5-a693-282b05e1220c	82b2e911-9636-47e1-ba1b-e8ab3fb93f9e
16600	16600	0	GBIF Japan	db5705aa-6a6e-42f1-8942-d77b9f4896ea	8495457c-f762-11e1-a439-00145eb45e9a
9654	9654	0	GBIF Germany	4f6826f2-4ff6-443d-b966-e6913bd24013	8589cc8c-f762-11e1-a439-00145eb45e9a
775	614	-161	GBIF Germany	4f6826f2-4ff6-443d-b966-e6913bd24013	86c49a6e-f762-11e1-a439-00145eb45e9a
283	283	0	GBIF Germany	4f6826f2-4ff6-443d-b966-e6913bd24013	87543296-f762-11e1-a439-00145eb45e9a
235	160	-75	GBIF Germany	4f6826f2-4ff6-443d-b966-e6913bd24013	877f4e90-f762-11e1-a439-00145eb45e9a
289	217	-72	GBIF Germany	4f6826f2-4ff6-443d-b966-e6913bd24013	87ebefaa-f762-11e1-a439-00145eb45e9a
13	13	0	GBIF Germany	4f6826f2-4ff6-443d-b966-e6913bd24013	88a316e4-f762-11e1-a439-00145eb45e9a
592	592	0	Ocean Biodiversity Information System	ba0670b9-4186-41e6-8e70-f9cb3065551a	891f5b96-f762-11e1-a439-00145eb45e9a
38787	38787	0	U.S. Geological Survey	8618c64a-93e0-4300-b546-7249e5148ed2	89d78af0-ad71-4136-9812-fb1d415ec933
1651	1651	0	Atlas of Living Australia	4a6f1b71-969e-4fc5-a693-282b05e1220c	8a0e70b1-dd09-4c74-85f1-68554108ba7b
23	23	0	GBIF Germany	4f6826f2-4ff6-443d-b966-e6913bd24013	8bd66172-f762-11e1-a439-00145eb45e9a
7	7	0	Plazi	ffb07bec-2d10-492d-9c37-361fe0b79427	8cc3a74b-6739-461a-92ab-fa05a585a405
153	153	0	GBIF Guinea	b1cd2e84-c4ba-47bd-b72a-dfd1f92dce0a	8e892727-ec1b-473f-bb8e-967dd02bb9b8
201	201	0	GBIF Germany	4f6826f2-4ff6-443d-b966-e6913bd24013	8ec05a32-f762-11e1-a439-00145eb45e9a
1071	514	-557	GBIF Germany	4f6826f2-4ff6-443d-b966-e6913bd24013	90591578-f762-11e1-a439-00145eb45e9a
57	45	-12	GBIF Germany	4f6826f2-4ff6-443d-b966-e6913bd24013	9188a81e-f762-11e1-a439-00145eb45e9a
288	288	0	GBIF Germany	4f6826f2-4ff6-443d-b966-e6913bd24013	93c8903a-f762-11e1-a439-00145eb45e9a
360	360	0	GBIF Germany	4f6826f2-4ff6-443d-b966-e6913bd24013	93f39d7a-f762-11e1-a439-00145eb45e9a
2105	2105	0	U.S. Geological Survey	8618c64a-93e0-4300-b546-7249e5148ed2	9475db2f-b714-4bb5-9797-cd6daae6d595
0	6	6	Plazi	ffb07bec-2d10-492d-9c37-361fe0b79427	94929838-19fb-4b23-b6eb-f4e0bab41ae6
61	61	0	Plazi	ffb07bec-2d10-492d-9c37-361fe0b79427	95c8b580-1685-41d2-9853-1a0b5b83c327
399	399	0	Belgian Biodiversity Platform	fb11cfe1-ebc3-45af-9159-17d9fddbcdac	9758adf3-77f1-464b-b6ab-79e6d605e297
8693	8693	0	Society for the Management of Electronic Biodiversity Data	97818ee4-1461-4180-bf1d-b3201050124f	98333cb6-6c15-4add-aa0e-b322bf1500ba
1	1	0	Plazi	ffb07bec-2d10-492d-9c37-361fe0b79427	984e9b18-d26e-4a46-8dce-d8aea73d88a2
5	5	0	Plazi	ffb07bec-2d10-492d-9c37-361fe0b79427	995463ca-392f-4f86-b595-c630f24db8ac
135	135	0	U.S. Geological Survey	8618c64a-93e0-4300-b546-7249e5148ed2	9a65aa81-8dc1-47b0-889d-fb34dd6826a7
203	203	0	GBIF Kenya	2a44d626-9f7a-4120-8a7a-4ab5ac15ff2a	9efc2821-3026-48be-8018-5a0f75f25706
0	3	3	Plazi	ffb07bec-2d10-492d-9c37-361fe0b79427	a0393459-6d9d-4caa-b163-cb7194b0626c
9577	9577	0	National Biodiversity Network	d897a5b9-35ee-4232-94bd-b0bcaac003c2	a1cd73e2-10d4-4ebf-8cb2-99268ac44377
0	1088	1088	Korean Biodiversity Information Facility	e0a1e772-0177-4800-94b4-2d023fe6cdf4	a52ea7b9-6787-4467-82f8-3500d31960bf
28	28	0	Plazi	ffb07bec-2d10-492d-9c37-361fe0b79427	a54c5633-aca4-4be8-afde-692622b72f0b
261	261	0	Colombian Biodiversity Information System	7e865cba-7c46-417b-ade5-97f2cf5b7be0	a797f77c-cd90-401c-827c-92662081cd1d
2110	2110	0	National Biodiversity Network	d897a5b9-35ee-4232-94bd-b0bcaac003c2	aa764da1-8d58-4381-b926-f6a88163f2a3
20457	20462	5	Biodiversity Information System of Mexico	b324e8e9-9a4c-44fa-8f1a-7f39ea7ab576	abb07908-f443-45ab-acfe-2e61cb10db0c
2	2	0	Plazi	ffb07bec-2d10-492d-9c37-361fe0b79427	abc9d14f-a108-40d4-82e7-205bfc0e2879
0	587	587	GBIF France	da44cd31-5901-4687-a106-6d1c7734ee3a	ade77a46-8cb4-4950-909c-88475ef7c2ea
0	13	13	Plazi	ffb07bec-2d10-492d-9c37-361fe0b79427	b12f2270-6665-4332-8f6f-ac5804efdf9b
64	64	0	Colombian Biodiversity Information System	7e865cba-7c46-417b-ade5-97f2cf5b7be0	b1f95dc2-f39f-4438-807f-56303e8c2de8
4	4	0	Plazi	ffb07bec-2d10-492d-9c37-361fe0b79427	b3b7b336-c0c1-4b68-862d-010752abb7de
0	449	449	Colombian Biodiversity Information System	7e865cba-7c46-417b-ade5-97f2cf5b7be0	b7a3d274-a137-4695-8e16-37e374160118
0	4235	4235	Ocean Biodiversity Information System	ba0670b9-4186-41e6-8e70-f9cb3065551a	b7ad7c16-0642-4ce9-bef5-a5f5bb909eb5
328	163	-165	GBIF Germany	4f6826f2-4ff6-443d-b966-e6913bd24013	b950b070-447d-423e-8ca9-d5cc3ce563a7
0	176	176	Plazi	ffb07bec-2d10-492d-9c37-361fe0b79427	b96aa772-0701-4b75-a308-f3ff755bb749
18252	18252	0	Colombian Biodiversity Information System	7e865cba-7c46-417b-ade5-97f2cf5b7be0	bdd4a614-fb1f-4f0a-a559-478f022baafb
2	2	0	Plazi	ffb07bec-2d10-492d-9c37-361fe0b79427	bed5228f-a57c-4187-b528-962ea52748e6
7	7	0	GBIF France	da44cd31-5901-4687-a106-6d1c7734ee3a	bf8e22b3-bbf0-49a2-add9-c568383ff504
306	306	0	Plazi	ffb07bec-2d10-492d-9c37-361fe0b79427	c20562dc-39c3-4dab-8714-442cef6dc495
17	17	0	Plazi	ffb07bec-2d10-492d-9c37-361fe0b79427	c251acfe-3ff1-4bd1-92fb-7df521e7ff79
67	67	0	Plazi	ffb07bec-2d10-492d-9c37-361fe0b79427	c38b0fde-57c4-46ba-b8cb-2022a08f397f
30	30	0	Participant Node Managers Committee	7f48e0c8-5c96-49ec-b972-30748e339115	c3959e0b-ccfe-4357-a648-dcc66c58bf65
5043	5043	0	National Biodiversity Network	d897a5b9-35ee-4232-94bd-b0bcaac003c2	c4e54359-1ee7-4fe4-a768-e17da314784e
0	2	2	Plazi	ffb07bec-2d10-492d-9c37-361fe0b79427	c5d13ada-5cce-49f0-8054-684b4999a617
3	3	0	Plazi	ffb07bec-2d10-492d-9c37-361fe0b79427	c7b56485-9c2f-4f83-92e7-dbc7a3ca81ba
141	141	0	GBIF France	da44cd31-5901-4687-a106-6d1c7734ee3a	c8378949-f3f6-48b8-99ec-b646807deb59
83	83	0	Plazi	ffb07bec-2d10-492d-9c37-361fe0b79427	cae2635f-bcc3-44bb-b001-3df486fa2104
55	55	0	Plazi	ffb07bec-2d10-492d-9c37-361fe0b79427	cc93dddd-d6df-4a93-9a5e-182123b0c4ee
3	3	0	Plazi	ffb07bec-2d10-492d-9c37-361fe0b79427	ce97f038-2604-4adc-b4fd-a14ac6537523
0	100	100	Plazi	ffb07bec-2d10-492d-9c37-361fe0b79427	d56e60ac-9956-4908-a6a4-21e344ee0f41
1153	1153	0	National Biodiversity Network	d897a5b9-35ee-4232-94bd-b0bcaac003c2	dc2d5aa2-70da-429c-bbcd-940e37dcfa9a
5515	5515	0	GBIF Argentina	2426a871-9feb-40a1-96c6-0c593a76b835	dc9294e3-3d6d-4a96-baa6-5225140c183b
2365	2365	0	GBIF Brazil	cdc9736d-5ff7-4ece-9959-3c744360cdb3	dcda25fc-e43b-455c-bc1a-a4e1d0941d32
871	871	0	Participant Node Managers Committee	7f48e0c8-5c96-49ec-b972-30748e339115	df007302-0f3f-44cc-b474-1ce4bf563e08
398	398	0	GBIF Finland	dd514216-5c7c-45f3-910d-797424cb5be6	dffe30bd-5871-4044-b5fe-d20fee674573
0	12	12	Plazi	ffb07bec-2d10-492d-9c37-361fe0b79427	e17326ea-9ad5-4f11-b8d0-3e865248d420
0	18	18	Colombian Biodiversity Information System	7e865cba-7c46-417b-ade5-97f2cf5b7be0	e33249b5-12c9-4b1b-9d87-0a1419570d81
245	245	0	GBIF Portugal	673f7038-4262-4149-b753-5658a4e912f6	e379ab9d-66fb-4bbd-b2d3-c77c60a361be
249	249	0	GBIF France	da44cd31-5901-4687-a106-6d1c7734ee3a	e557cf75-a880-4da9-abff-6683edd015c5
11	11	0	GBIF France	da44cd31-5901-4687-a106-6d1c7734ee3a	e82dc591-2bec-4506-b84a-56ea75f45d66
0	6	6	Plazi	ffb07bec-2d10-492d-9c37-361fe0b79427	e9245a31-8059-40b5-8b95-18ba02bc1d91
151	151	0	Plazi	ffb07bec-2d10-492d-9c37-361fe0b79427	ea720c19-6c5b-4a21-9d01-569dbbb22da1
0	434	434	Ocean Biodiversity Information System	ba0670b9-4186-41e6-8e70-f9cb3065551a	eac15223-1582-464c-908a-5a80bb6c2577
55	55	0	GBIF France	da44cd31-5901-4687-a106-6d1c7734ee3a	eb262b18-0962-4ec4-9b10-7b0d6322e08c
2336	2336	0	Participant Node Managers Committee	7f48e0c8-5c96-49ec-b972-30748e339115	ed467fbb-664b-49b7-8d5f-911b9eb5c55a
0	25	25	Plazi	ffb07bec-2d10-492d-9c37-361fe0b79427	f3e3972a-fedd-4acd-bdb6-6fcfbe4bbc62
7414	7414	0	National Biodiversity Network	d897a5b9-35ee-4232-94bd-b0bcaac003c2	f825a67b-23cc-4f17-a479-91f46ffe0902
0	63	63	Ocean Biodiversity Information System	ba0670b9-4186-41e6-8e70-f9cb3065551a	fc5855cc-cd27-41ee-a30e-f1eb4fe9e4ae
7	7	0	Plazi	ffb07bec-2d10-492d-9c37-361fe0b79427	fd210da0-0299-4588-a573-57c97700750f
9	9	0	Plazi	ffb07bec-2d10-492d-9c37-361fe0b79427	fd229573-d281-4c7a-a9cc-86e8cf041c60
0	2	2	Ocean Biodiversity Information System	ba0670b9-4186-41e6-8e70-f9cb3065551a	fd24c228-220f-4a69-b3ad-9a5524c6f943
20	20	0	GBIF Uganda	71b40829-6a12-4c3d-8fee-5746f5e9cf8c	fe3265d6-8723-4753-800b-ca1850d66d3c
257400	259557	2157	U.S. Geological Survey	8618c64a-93e0-4300-b546-7249e5148ed2	005eb8d8-ed94-41be-89cf-e3115a9058e4
481	481	0	Colombian Biodiversity Information System	7e865cba-7c46-417b-ade5-97f2cf5b7be0	0086f7d6-07a1-40b4-a20c-bca803162788
0	12	12	Plazi	ffb07bec-2d10-492d-9c37-361fe0b79427	048cd90b-381f-4cce-94a1-846e33bb263e
492	492	0	Colombian Biodiversity Information System	7e865cba-7c46-417b-ade5-97f2cf5b7be0	0501a03c-cfe4-4f42-8427-ac94460bc510
5886	5886	0	DanBIF - Danish Biodiversity Information Facility	4ddd294f-02b7-4359-ac33-0806a9ca9c6b	0528c11e-4074-43bb-829f-13b161bd0a56
299	299	0	GBIF Germany	4f6826f2-4ff6-443d-b966-e6913bd24013	05a23926-3756-46b7-a1a0-f483a992090e
0	5	5	Plazi	ffb07bec-2d10-492d-9c37-361fe0b79427	0875c273-045c-4c5d-ac0e-af52229b1a87
4065	4065	0	National Biodiversity Network	d897a5b9-35ee-4232-94bd-b0bcaac003c2	0ab3e5ca-6d4f-4072-a285-6ec377cc8c77
0	3505	3505	Ocean Biodiversity Information System	ba0670b9-4186-41e6-8e70-f9cb3065551a	10431811-6113-4771-8ebb-711d6f62a203
42	42	0	GBIF France	da44cd31-5901-4687-a106-6d1c7734ee3a	10dfffa4-8bbb-4f34-8f86-1f443e7baf53
2	2	0	Plazi	ffb07bec-2d10-492d-9c37-361fe0b79427	11eafe26-5cb6-40a4-8f5c-c92eb07df370
1798	1798	0	National Biodiversity Network	d897a5b9-35ee-4232-94bd-b0bcaac003c2	12f9b2e6-7b63-4bc9-81df-48808a45d568
0	68	68	Plazi	ffb07bec-2d10-492d-9c37-361fe0b79427	1420a882-3007-4d6f-afbc-f486390b2215
0	12	12	Plazi	ffb07bec-2d10-492d-9c37-361fe0b79427	16852ecc-89f5-49e5-8854-618556eb0441
204	204	0	Plazi	ffb07bec-2d10-492d-9c37-361fe0b79427	195ebc3d-5307-49d5-abae-33e2dc70fb93
140	140	0	Participant Node Managers Committee	7f48e0c8-5c96-49ec-b972-30748e339115	1b41df21-d6a7-49fe-bdf2-2ec7b6344f88
0	30	30	Plazi	ffb07bec-2d10-492d-9c37-361fe0b79427	1df399c6-c920-4862-81a3-dd51f0a28471
96	96	0	Plazi	ffb07bec-2d10-492d-9c37-361fe0b79427	2018eded-d5b1-4f60-b954-35abbd40d2d7
839	839	0	GBIF France	da44cd31-5901-4687-a106-6d1c7734ee3a	203c7594-1960-4294-abf9-ef5d024ea9dd
12	12	0	Plazi	ffb07bec-2d10-492d-9c37-361fe0b79427	212d9199-2ef7-4e35-a222-b3333ba0af61
0	141	141	GBIF Spain	1f94b3ca-9345-4d65-afe2-4bace93aa0fe	216b4600-ca41-4d28-9218-183f75f5ed13
10	10	0	Colombian Biodiversity Information System	7e865cba-7c46-417b-ade5-97f2cf5b7be0	2170737f-b704-448a-a6fd-5f358ffc32fd
165	165	0	Participant Node Managers Committee	7f48e0c8-5c96-49ec-b972-30748e339115	22c3be28-e74f-40b9-aeb5-c427fdee496e
0	9	9	Plazi	ffb07bec-2d10-492d-9c37-361fe0b79427	23fccc1a-01d7-48be-a545-418f1a8271fc
0	32	32	Ocean Biodiversity Information System	ba0670b9-4186-41e6-8e70-f9cb3065551a	2a11ed09-f574-4bc2-8571-1f72171ad8e3
77	77	0	GBIF Japan	db5705aa-6a6e-42f1-8942-d77b9f4896ea	2a6eaed1-cc05-49aa-9c43-12c491747cbb
11	11	0	GBIF France	da44cd31-5901-4687-a106-6d1c7734ee3a	2be5892a-a382-4c05-b70b-128ab5cf47f2
82	82	0	GBIF Finland	dd514216-5c7c-45f3-910d-797424cb5be6	2c42a5da-a059-452f-be89-dc76ec296fed
0	2	2	Plazi	ffb07bec-2d10-492d-9c37-361fe0b79427	2df99f58-befa-4a0e-89dc-aaa540b5b35c
0	11	11	Plazi	ffb07bec-2d10-492d-9c37-361fe0b79427	2f072fc4-3dab-43d2-9cb7-f551c4d9c390
293608	293608	0	Belgian Biodiversity Platform	fb11cfe1-ebc3-45af-9159-17d9fddbcdac	2fc1d8b5-9c99-4e03-8c3c-11a6e51a298f
352692	352692	0	Costa Rica Biodiversity Facility	3379bb09-1a58-41e7-9c57-e3b66c3eb5a0	3717f916-d983-4a81-bb13-5f91200871a6
300	300	0	GBIF Japan	db5705aa-6a6e-42f1-8942-d77b9f4896ea	39ca3bfa-2888-49ba-b4f7-f128701ddf38
7	7	0	Plazi	ffb07bec-2d10-492d-9c37-361fe0b79427	3c34e15d-f799-4524-b74b-9a11c1756d39
363	363	0	GBIF Germany	4f6826f2-4ff6-443d-b966-e6913bd24013	3e72d7ea-09bf-4f0c-91c0-8ef306a5b9a1
913	913	0	GBIF France	da44cd31-5901-4687-a106-6d1c7734ee3a	3f428d43-aa63-4973-a747-e458d25575c4
5316	2763	-2553	GBIF Germany	4f6826f2-4ff6-443d-b966-e6913bd24013	41f5aee4-79cf-48a6-a016-35f195bd227d
147	147	0	GBIF Sweden	a0b3be64-6525-4387-ac67-a499950f92e1	432ad05a-a1e4-4f20-b4bc-9c79fc0c603a
291	291	0	GBIF Germany	4f6826f2-4ff6-443d-b966-e6913bd24013	44d2e241-06c4-4538-abe6-4bf800d837c3
3594	3594	0	Belgian Biodiversity Platform	fb11cfe1-ebc3-45af-9159-17d9fddbcdac	45157d5f-7eb9-42b8-8d70-66482fdd912f
0	37	37	Plazi	ffb07bec-2d10-492d-9c37-361fe0b79427	478d6acd-ac70-4bd0-ad03-ed1422a3e919
2502	2502	0	U.S. Geological Survey	8618c64a-93e0-4300-b546-7249e5148ed2	4b17f1c6-93a3-4e22-9822-1c7d829bb666
2	2	0	Plazi	ffb07bec-2d10-492d-9c37-361fe0b79427	4c89cb3f-235d-4e7d-b3b0-4315a7092898
2	2	0	Plazi	ffb07bec-2d10-492d-9c37-361fe0b79427	4ee61488-f35b-44d4-baf7-a4f0eecf0335
7891989	8254900	362911	GBIF Sweden	a0b3be64-6525-4387-ac67-a499950f92e1	4f70108a-dda7-4e8b-8298-babaee5182c3
761	761	0	National Biodiversity Network	d897a5b9-35ee-4232-94bd-b0bcaac003c2	52e04458-0c25-4b2b-b661-d2f95670e200
0	258	258	National Biodiversity Network	d897a5b9-35ee-4232-94bd-b0bcaac003c2	54cb3a6b-a32f-460c-a1ee-e40666f1cb95
62	62	0	GBIF Spain	1f94b3ca-9345-4d65-afe2-4bace93aa0fe	55347db9-46a3-449d-8e55-ba6ed02e4820
0	17	17	Plazi	ffb07bec-2d10-492d-9c37-361fe0b79427	56e22b1b-6708-4761-9a11-873c77c3b453
0	2	2	Plazi	ffb07bec-2d10-492d-9c37-361fe0b79427	57a67f85-87a0-4069-804a-a1f6ad1e370b
50	50	0	Inter American Biodiversity Information Network	69f8ea9e-b2a6-4e5a-896f-3bf8fc23cc8d	59ab76d8-6664-4589-b1e2-791753d79eb3
26487	26487	0	GBIF Portugal	673f7038-4262-4149-b753-5658a4e912f6	5b345642-64b5-4115-86b7-ba64d8e2c15b
1	1	0	GBIF Germany	4f6826f2-4ff6-443d-b966-e6913bd24013	5c20b234-d120-455a-85c1-c59c59d4d25d
760	760	0	GBIF France	da44cd31-5901-4687-a106-6d1c7734ee3a	5c85ff42-2109-4b81-87da-6d41ab68e369
151	151	0	GBIF Germany	4f6826f2-4ff6-443d-b966-e6913bd24013	61546322-f762-11e1-a439-00145eb45e9a
675	675	0	Plazi	ffb07bec-2d10-492d-9c37-361fe0b79427	620a3c9d-4a3a-49a1-afd6-57f4b1d405bd
123	123	0	GBIF Germany	4f6826f2-4ff6-443d-b966-e6913bd24013	62439f70-31d3-47c8-bda8-8cdf9e1f3710
122	122	0	GBIF Germany	4f6826f2-4ff6-443d-b966-e6913bd24013	62624c7a-f762-11e1-a439-00145eb45e9a
649	649	0	GBIF Norway	4f829580-180d-46a9-9c87-ed8ec959b545	629ca734-096a-45c8-bca1-3a5dcefd2f15
279	279	0	GBIF Germany	4f6826f2-4ff6-443d-b966-e6913bd24013	639bb432-f762-11e1-a439-00145eb45e9a
19	19	0	GBIF Germany	4f6826f2-4ff6-443d-b966-e6913bd24013	64d00c72-f762-11e1-a439-00145eb45e9a
2	2	0	Plazi	ffb07bec-2d10-492d-9c37-361fe0b79427	65bb59f4-d3e7-43aa-9116-23ba8f97ecc1
197	195	-2	GBIF Germany	4f6826f2-4ff6-443d-b966-e6913bd24013	65e67e3e-f762-11e1-a439-00145eb45e9a
157	157	0	GBIF Germany	4f6826f2-4ff6-443d-b966-e6913bd24013	6637c136-f762-11e1-a439-00145eb45e9a
0	2	2	Plazi	ffb07bec-2d10-492d-9c37-361fe0b79427	66a7b946-77dd-4b4f-90de-572bb0083527
152	152	0	GBIF Germany	4f6826f2-4ff6-443d-b966-e6913bd24013	66cf72ce-f762-11e1-a439-00145eb45e9a
25375	30490	5115	National Biodiversity Network	d897a5b9-35ee-4232-94bd-b0bcaac003c2	686c1b9b-5f29-4e1f-8c28-f9779d264579
32	32	0	GBIF Germany	4f6826f2-4ff6-443d-b966-e6913bd24013	690171fa-f762-11e1-a439-00145eb45e9a
122	122	0	GBIF Germany	4f6826f2-4ff6-443d-b966-e6913bd24013	690e1c7a-f762-11e1-a439-00145eb45e9a
279	279	0	GBIF Germany	4f6826f2-4ff6-443d-b966-e6913bd24013	697f52aa-f762-11e1-a439-00145eb45e9a
98	98	0	GBIF Germany	4f6826f2-4ff6-443d-b966-e6913bd24013	699cbc0a-f762-11e1-a439-00145eb45e9a
0	1721	1721	National Biodiversity Network	d897a5b9-35ee-4232-94bd-b0bcaac003c2	69bc8993-33e4-4a34-985b-d73d70a88c6d
16730	22761	6031	National Biodiversity Network	d897a5b9-35ee-4232-94bd-b0bcaac003c2	6a9b060b-d419-4569-ad6f-5ebf4afbbcf3
8	8	0	GBIF Germany	4f6826f2-4ff6-443d-b966-e6913bd24013	6ad48aee-f762-11e1-a439-00145eb45e9a
12	12	0	GBIF Germany	4f6826f2-4ff6-443d-b966-e6913bd24013	6b0d5edc-f762-11e1-a439-00145eb45e9a
0	3	3	Plazi	ffb07bec-2d10-492d-9c37-361fe0b79427	6c2a442e-2e76-4728-b65b-16a13d1e12a7
4	4	0	Plazi	ffb07bec-2d10-492d-9c37-361fe0b79427	6c2fc877-37de-434f-a818-e84fd805003a
260	260	0	GBIF Norway	4f829580-180d-46a9-9c87-ed8ec959b545	6db17e9d-47d8-459e-8173-2d32ffa99470
0	20	20	Plazi	ffb07bec-2d10-492d-9c37-361fe0b79427	6f26ed85-363e-4b31-b0c9-17eace429ce9
0	3	3	Plazi	ffb07bec-2d10-492d-9c37-361fe0b79427	73791ba9-41e9-4de3-85db-0d857bfc9c3e
18	18	0	GBIF Germany	4f6826f2-4ff6-443d-b966-e6913bd24013	739f5960-f762-11e1-a439-00145eb45e9a
13	13	0	Plazi	ffb07bec-2d10-492d-9c37-361fe0b79427	73bb1259-a607-4359-ac8c-ebeea4e1ea6e
10	10	0	Plazi	ffb07bec-2d10-492d-9c37-361fe0b79427	776234fd-f2e3-4cf5-b9ab-12f5420cdd87
6	6	0	GBIF Germany	4f6826f2-4ff6-443d-b966-e6913bd24013	78cb56fa-f762-11e1-a439-00145eb45e9a
236	193	-43	GBIF Germany	4f6826f2-4ff6-443d-b966-e6913bd24013	7966d6ca-f762-11e1-a439-00145eb45e9a
502	372	-130	GBIF Germany	4f6826f2-4ff6-443d-b966-e6913bd24013	79a0a436-f762-11e1-a439-00145eb45e9a
918	298	-620	GBIF Germany	4f6826f2-4ff6-443d-b966-e6913bd24013	7a0cd494-f762-11e1-a439-00145eb45e9a
2	2	0	Plazi	ffb07bec-2d10-492d-9c37-361fe0b79427	7a68e13d-3c05-49d5-86a3-7bdb5c4af1ce
89	89	0	GBIF Brazil	cdc9736d-5ff7-4ece-9959-3c744360cdb3	7a849e27-f775-4e09-906f-b2912057b02c
1418	1418	0	Korean Biodiversity Information Facility	e0a1e772-0177-4800-94b4-2d023fe6cdf4	7b1e8012-f762-11e1-a439-00145eb45e9a
15325	15325	0	National Biodiversity Network	d897a5b9-35ee-4232-94bd-b0bcaac003c2	7c08705c-b86f-4e6a-93a2-577fcfa6b6c2
279	148	-131	GBIF Germany	4f6826f2-4ff6-443d-b966-e6913bd24013	7d2c1bd0-f762-11e1-a439-00145eb45e9a
808	2031	1223	GBIF Argentina	2426a871-9feb-40a1-96c6-0c593a76b835	7d5cc0fd-1a00-4109-baf3-de2cb38caa59
10	10	0	GBIF Germany	4f6826f2-4ff6-443d-b966-e6913bd24013	7e5275e0-f762-11e1-a439-00145eb45e9a
0	1	1	Plazi	ffb07bec-2d10-492d-9c37-361fe0b79427	80fb3ed1-03d8-4294-8a2a-755927f26150
1485	1485	0	GBIF Germany	4f6826f2-4ff6-443d-b966-e6913bd24013	815c3a6e-f762-11e1-a439-00145eb45e9a
168	133	-35	GBIF Germany	4f6826f2-4ff6-443d-b966-e6913bd24013	8174b53a-f762-11e1-a439-00145eb45e9a
9728	9728	0	National Biodiversity Data Centre	422b00b2-6c94-4bb6-976b-c359916efdb8	81b551f9-3e4f-47b4-952e-56e870c1b363
2964	1884	-1080	GBIF Germany	4f6826f2-4ff6-443d-b966-e6913bd24013	8239c1b8-f762-11e1-a439-00145eb45e9a
950	950	0	GBIF Germany	4f6826f2-4ff6-443d-b966-e6913bd24013	828dc178-f762-11e1-a439-00145eb45e9a
9266	9266	0	GBIF Germany	4f6826f2-4ff6-443d-b966-e6913bd24013	82b5869a-f762-11e1-a439-00145eb45e9a
135628	135628	0	GBIF Spain	1f94b3ca-9345-4d65-afe2-4bace93aa0fe	834b7330-f762-11e1-a439-00145eb45e9a
1	1	0	Plazi	ffb07bec-2d10-492d-9c37-361fe0b79427	84173e4f-fbfc-43a8-bf19-1124b12af112
3	3	0	Plazi	ffb07bec-2d10-492d-9c37-361fe0b79427	847a0727-774e-42e3-98bb-a2d26ad71f05
5	5	0	Colombian Biodiversity Information System	7e865cba-7c46-417b-ade5-97f2cf5b7be0	8692b378-00af-4c3e-a68a-e28f3fae5501
1901	1901	0	Atlas of Living Australia	4a6f1b71-969e-4fc5-a693-282b05e1220c	86b7940e-f762-11e1-a439-00145eb45e9a
169	83	-86	GBIF Germany	4f6826f2-4ff6-443d-b966-e6913bd24013	87372142-f762-11e1-a439-00145eb45e9a
0	132081	132081	Ocean Biodiversity Information System	ba0670b9-4186-41e6-8e70-f9cb3065551a	874ff2f9-f515-435b-afb1-bc282ef3fa67
29915	29915	0	GBIF Brazil	cdc9736d-5ff7-4ece-9959-3c744360cdb3	8766db9d-86a9-4db5-81ff-d3632826d5b9
0	34	34	GBIF Spain	1f94b3ca-9345-4d65-afe2-4bace93aa0fe	88748591-17d3-4ec7-8e13-7ef2541176e6
48	48	0	GBIF Germany	4f6826f2-4ff6-443d-b966-e6913bd24013	898d17d0-f762-11e1-a439-00145eb45e9a
330	330	0	Colombian Biodiversity Information System	7e865cba-7c46-417b-ade5-97f2cf5b7be0	8aad9e02-2337-4836-83d6-bb505b2b2d11
3	3	0	Plazi	ffb07bec-2d10-492d-9c37-361fe0b79427	8abe11f7-a3a2-44b8-b066-70a5904a36cd
16	12	-4	GBIF Germany	4f6826f2-4ff6-443d-b966-e6913bd24013	8e3b7ab0-f762-11e1-a439-00145eb45e9a
207	207	0	Participant Node Managers Committee	7f48e0c8-5c96-49ec-b972-30748e339115	8ea4d86b-7030-4b11-a558-2b0e0ef3c49a
352	280	-72	GBIF Germany	4f6826f2-4ff6-443d-b966-e6913bd24013	8f5ee288-f762-11e1-a439-00145eb45e9a
18	16	-2	GBIF Germany	4f6826f2-4ff6-443d-b966-e6913bd24013	90b00f86-f762-11e1-a439-00145eb45e9a
126	107	-19	GBIF Germany	4f6826f2-4ff6-443d-b966-e6913bd24013	90c20ed4-f762-11e1-a439-00145eb45e9a
26285	26285	0	U.S. Geological Survey	8618c64a-93e0-4300-b546-7249e5148ed2	91aa5e23-9cad-4751-86e0-241da77d7407
2	1	-1	GBIF Germany	4f6826f2-4ff6-443d-b966-e6913bd24013	9243dc06-f762-11e1-a439-00145eb45e9a
91	91	0	GBIF Germany	4f6826f2-4ff6-443d-b966-e6913bd24013	9294f258-f762-11e1-a439-00145eb45e9a
372	180	-192	GBIF Germany	4f6826f2-4ff6-443d-b966-e6913bd24013	935f107e-f762-11e1-a439-00145eb45e9a
26	26	0	GBIF Germany	4f6826f2-4ff6-443d-b966-e6913bd24013	93e1949a-f762-11e1-a439-00145eb45e9a
511	511	0	Participant Node Managers Committee	7f48e0c8-5c96-49ec-b972-30748e339115	93f335ef-bb92-42f3-80ac-ec7e418c273a
2	2	0	Plazi	ffb07bec-2d10-492d-9c37-361fe0b79427	94d55437-8797-4ead-8ae5-175696163d09
35	35	0	GBIF Germany	4f6826f2-4ff6-443d-b966-e6913bd24013	94e99f40-f762-11e1-a439-00145eb45e9a
2825	2825	0	GBIF Germany	4f6826f2-4ff6-443d-b966-e6913bd24013	9513015a-f762-11e1-a439-00145eb45e9a
11	11	0	GBIF Germany	4f6826f2-4ff6-443d-b966-e6913bd24013	957cb06e-f762-11e1-a439-00145eb45e9a
56685	56685	0	U.S. Geological Survey	8618c64a-93e0-4300-b546-7249e5148ed2	95b2d7ca-f762-11e1-a439-00145eb45e9a
4301	4301	0	Belgian Biodiversity Platform	fb11cfe1-ebc3-45af-9159-17d9fddbcdac	95fd34fe-0099-4361-b32d-318916333171
16	16	0	Plazi	ffb07bec-2d10-492d-9c37-361fe0b79427	96194af2-44f3-4ed0-9f9e-29f64b97cb93
0	3	3	Plazi	ffb07bec-2d10-492d-9c37-361fe0b79427	9647087a-d9c6-40af-817d-1ee235973ebd
86225	87874	1649	GBIF Germany	4f6826f2-4ff6-443d-b966-e6913bd24013	96678e90-f762-11e1-a439-00145eb45e9a
873	873	0	GBIF France	da44cd31-5901-4687-a106-6d1c7734ee3a	9894e987-6f00-495e-b512-1a5198fe9be5
0	5	5	Plazi	ffb07bec-2d10-492d-9c37-361fe0b79427	994e6d01-f0b6-4adb-821e-bf9100435c4c
482	482	0	GBIF France	da44cd31-5901-4687-a106-6d1c7734ee3a	9a24b263-0263-40b9-ba1a-395e0781a9d2
153201	170732	17531	National Biodiversity Network	d897a5b9-35ee-4232-94bd-b0bcaac003c2	9a6bdcc9-e017-44ea-9cf9-ff6a87fdb8c2
381	381	0	Participant Node Managers Committee	7f48e0c8-5c96-49ec-b972-30748e339115	9fb65b3a-164c-41b0-a2df-5a1e08780296
1	1	0	Plazi	ffb07bec-2d10-492d-9c37-361fe0b79427	a048a3ff-5659-41e0-952c-8977626b8e6d
338405	357267	18862	Netherlands Biodiversity Information Facility	0909d601-bda2-42df-9e63-a6d51847ebce	a307e4d7-1de2-4adc-95d5-a0a8d5f57236
13	13	0	Plazi	ffb07bec-2d10-492d-9c37-361fe0b79427	a4d84e4e-e772-4a01-8d20-c2e52c82dbbc
178	178	0	Plazi	ffb07bec-2d10-492d-9c37-361fe0b79427	a61c3d84-bf86-420e-b8f3-18fc805c901a
0	10	10	Plazi	ffb07bec-2d10-492d-9c37-361fe0b79427	a69800a0-bc3f-49fe-a5e0-441d0b142e53
812	812	0	GBIF France	da44cd31-5901-4687-a106-6d1c7734ee3a	a6f31705-bf0b-4b36-8448-d274813f9760
0	3	3	Plazi	ffb07bec-2d10-492d-9c37-361fe0b79427	a8e26a33-8461-460c-b7d4-4b4add6534b2
830	830	0	GBIF France	da44cd31-5901-4687-a106-6d1c7734ee3a	aeac93c3-1433-470f-ada9-704c11b7f8ed
1	1	0	Plazi	ffb07bec-2d10-492d-9c37-361fe0b79427	aeccb546-e1b8-4d4f-a1cb-e996e61c4c57
380	380	0	Plazi	ffb07bec-2d10-492d-9c37-361fe0b79427	b14b0d0d-cf67-4895-965c-12792c622b21
43	43	0	GBIF France	da44cd31-5901-4687-a106-6d1c7734ee3a	b5cfc7f3-bb6a-40a5-98e3-8ce11753331e
21	21	0	Plazi	ffb07bec-2d10-492d-9c37-361fe0b79427	b63099b5-619a-4cff-8f64-50385132af12
154774	154774	0	U.S. Geological Survey	8618c64a-93e0-4300-b546-7249e5148ed2	ba5b0f3a-73dd-459f-a7f1-9abc327aed00
0	572	572	Tanzania Biodiversity Information Facility	abd95ca6-3959-4db9-aaa6-2de1aeecf514	ba7f30c4-3d5b-46c1-8036-37ebb62fe65c
0	221	221	Ocean Biodiversity Information System	ba0670b9-4186-41e6-8e70-f9cb3065551a	bbe07432-d0d4-43b7-b60c-9ef4fb812881
0	24	24	Plazi	ffb07bec-2d10-492d-9c37-361fe0b79427	bd4313a1-f17a-4745-ba2d-655124108edc
1	1	0	Plazi	ffb07bec-2d10-492d-9c37-361fe0b79427	c026a088-0830-473c-9110-84467aae2bd4
994	994	0	GBIF France	da44cd31-5901-4687-a106-6d1c7734ee3a	c0f82861-1977-4947-a11b-acbfb7c81d5c
0	86	86	GBIF Spain	1f94b3ca-9345-4d65-afe2-4bace93aa0fe	c737e40d-7e30-48f9-9319-9d6335fd2c97
1	1	0	Plazi	ffb07bec-2d10-492d-9c37-361fe0b79427	c7e7b46f-ec6b-42d4-8bba-1aa7aa3031d9
208	208	0	Participant Node Managers Committee	7f48e0c8-5c96-49ec-b972-30748e339115	caa4bc26-f3d6-4b03-95e2-643609b00500
24	24	0	Plazi	ffb07bec-2d10-492d-9c37-361fe0b79427	ccbb854c-979b-40ea-bd51-64cf20307fb0
13	13	0	Plazi	ffb07bec-2d10-492d-9c37-361fe0b79427	da73951d-68f4-4e16-86d2-fc7806285534
367	367	0	Plazi	ffb07bec-2d10-492d-9c37-361fe0b79427	dd972471-fb89-4202-b474-8e88a7f8f1c4
353	353	0	Belgian Biodiversity Platform	fb11cfe1-ebc3-45af-9159-17d9fddbcdac	df2a965e-48b6-4309-9c6d-8cb50237001c
3	3	0	GBIF Germany	4f6826f2-4ff6-443d-b966-e6913bd24013	e12656e4-1548-4fb5-b739-45e069eb80c1
127	127	0	GBIF France	da44cd31-5901-4687-a106-6d1c7734ee3a	e14574b1-c01d-4741-84c4-4e71145b9d63
0	86	86	Participant Node Managers Committee	7f48e0c8-5c96-49ec-b972-30748e339115	e1fed3c3-97eb-4c4b-8472-a7928e45a52f
3	3	0	Plazi	ffb07bec-2d10-492d-9c37-361fe0b79427	e3add788-8653-4f45-8658-f017da50b0b2
2	2	0	Plazi	ffb07bec-2d10-492d-9c37-361fe0b79427	e41b0b15-f717-40a8-9c71-29dd51f23604
1090	1090	0	Biodiversity Information System of Mexico	b324e8e9-9a4c-44fa-8f1a-7f39ea7ab576	e44008d2-6310-4a5a-9d96-9843bd0e5698
6	7	1	Plazi	ffb07bec-2d10-492d-9c37-361fe0b79427	e5d8103a-3589-4d3f-a11b-a2f6366135cf
0	26	26	Plazi	ffb07bec-2d10-492d-9c37-361fe0b79427	e62bfab1-1fa9-47d3-9759-d161cb15f3e8
50	50	0	Ocean Biodiversity Information System	ba0670b9-4186-41e6-8e70-f9cb3065551a	e8e2a3e6-0225-4d37-8c66-5f00cc75c181
0	3	3	Plazi	ffb07bec-2d10-492d-9c37-361fe0b79427	e9015b27-749a-4026-95b2-34d46deb3fec
7	7	0	Plazi	ffb07bec-2d10-492d-9c37-361fe0b79427	ea96b06d-bfc2-45d7-8e60-68e24c23ccf8
4	4	0	Plazi	ffb07bec-2d10-492d-9c37-361fe0b79427	ea9d7878-7f24-4aa4-aad2-2155047490b0
0	286	286	Colombian Biodiversity Information System	7e865cba-7c46-417b-ade5-97f2cf5b7be0	eeadb643-2fed-49d9-959e-efdab9c47455
12	12	0	Plazi	ffb07bec-2d10-492d-9c37-361fe0b79427	eeb518cb-7144-432b-bbb2-a9d9e36a8d00
0	3	3	Plazi	ffb07bec-2d10-492d-9c37-361fe0b79427	ef574f24-f91f-4aa2-a5f0-d770afb2fc20
13	13	0	Plazi	ffb07bec-2d10-492d-9c37-361fe0b79427	f3bfaa48-90c4-4589-acf3-091174257dc4
0	21	21	Colombian Biodiversity Information System	7e865cba-7c46-417b-ade5-97f2cf5b7be0	f7e1f925-36e1-4b99-970b-56540425cf8d
22	22	0	Plazi	ffb07bec-2d10-492d-9c37-361fe0b79427	fcb90f8f-1c93-4d87-a223-599264ed5642
4	4	0	Plazi	ffb07bec-2d10-492d-9c37-361fe0b79427	fd5aea8b-dedd-4b0f-97df-149b760bf6fc
2	2	0	Plazi	ffb07bec-2d10-492d-9c37-361fe0b79427	01e93929-77fa-4e38-a22a-4d43549bad21
68	68	0	Plazi	ffb07bec-2d10-492d-9c37-361fe0b79427	058a8983-7310-4a2a-ade4-66ed90de8a06
8637	8637	0	Polish Biodiversity Information Network	2618bfdf-e194-4911-a241-80db3107bc51	05db3ca4-e534-4a91-abcd-f6bfdd2989ad
3	3	0	Plazi	ffb07bec-2d10-492d-9c37-361fe0b79427	08ce9a1c-7aa7-448f-b24a-e09583d26266
33	33	0	GBIF Madagascar	2dbfc5c5-51b5-4494-9dfc-4d3f013a3b64	0942490a-f0b8-4111-ae73-379a04da4186
25056	25056	0	U.S. Geological Survey	8618c64a-93e0-4300-b546-7249e5148ed2	09831f10-8457-40b0-a3b1-3fd80c8d1279
3584	3584	0	GBIF France	da44cd31-5901-4687-a106-6d1c7734ee3a	0a7c41ce-596e-408f-ab86-0614aba3f750
14	14	0	Plazi	ffb07bec-2d10-492d-9c37-361fe0b79427	0b58bb9a-327b-4bf6-8fe9-affa3144d64e
1300	1300	0	Colombian Biodiversity Information System	7e865cba-7c46-417b-ade5-97f2cf5b7be0	0b8c0f5b-e970-44fd-8823-7f4bf7a6a370
4	4	0	Plazi	ffb07bec-2d10-492d-9c37-361fe0b79427	12479fa5-02c6-428f-8090-dec54fd70422
352	352	0	National Biodiversity Network	d897a5b9-35ee-4232-94bd-b0bcaac003c2	14c06f91-8937-472a-b59e-10cf7f8942d4
12	12	0	Plazi	ffb07bec-2d10-492d-9c37-361fe0b79427	177c225c-e7db-4fc0-a099-f88eead488de
15	15	0	Plazi	ffb07bec-2d10-492d-9c37-361fe0b79427	1aa0d238-b577-46f3-a4fb-0338c3f42ad1
0	6	6	Plazi	ffb07bec-2d10-492d-9c37-361fe0b79427	1e70290e-8c8d-45aa-b9fa-d0623117f07a
110558	110558	0	Colombian Biodiversity Information System	7e865cba-7c46-417b-ade5-97f2cf5b7be0	1fe5d5cd-0336-4664-b768-d38acf349c0a
20594	20594	0	National Biodiversity Network	d897a5b9-35ee-4232-94bd-b0bcaac003c2	213ab505-03d8-497e-a2d1-074079116a8b
0	3	3	Plazi	ffb07bec-2d10-492d-9c37-361fe0b79427	26075f25-43ca-4629-b9b1-45f5120b9252
255	255	0	Colombian Biodiversity Information System	7e865cba-7c46-417b-ade5-97f2cf5b7be0	272e40d5-88a0-4f90-badc-b9941316d48f
8985	8985	0	U.S. Geological Survey	8618c64a-93e0-4300-b546-7249e5148ed2	29b43457-5ebc-465c-b275-21a03cb9f148
26	26	0	Plazi	ffb07bec-2d10-492d-9c37-361fe0b79427	2e754b68-5172-4cdc-8106-6b27d7bec3ca
1782	1782	0	National Biodiversity Network	d897a5b9-35ee-4232-94bd-b0bcaac003c2	2ea0c121-6695-4ca8-8956-147517488767
0	319	319	National Biodiversity Network	d897a5b9-35ee-4232-94bd-b0bcaac003c2	2f3420f9-8258-4fe3-85e9-bdc30c7a3bf0
5	5	0	Plazi	ffb07bec-2d10-492d-9c37-361fe0b79427	335201e1-32a7-4851-9e87-0196a75e4eac
1385	1385	0	Biodiversity Information System of Mexico	b324e8e9-9a4c-44fa-8f1a-7f39ea7ab576	36a4dcd7-d142-4760-8d67-4dd1333a64ce
23710	23710	0	GBIF Finland	dd514216-5c7c-45f3-910d-797424cb5be6	39131221-61c0-417e-a0c6-dc00745917a7
302857	315277	12420	GBIF Brazil	cdc9736d-5ff7-4ece-9959-3c744360cdb3	3b8e9d83-b2d4-4a97-973c-31d98b67b1e9
4	4	0	Plazi	ffb07bec-2d10-492d-9c37-361fe0b79427	3f8b24c5-d739-4edb-a404-435f846ff559
120	120	0	GBIF Germany	4f6826f2-4ff6-443d-b966-e6913bd24013	40574ab0-f607-42c5-99cb-af1a5d9cb79b
167	167	0	GBIF Brazil	cdc9736d-5ff7-4ece-9959-3c744360cdb3	411ecc3d-7827-4ef6-918c-bc47fe80d1d3
438	438	0	National Biodiversity Network	d897a5b9-35ee-4232-94bd-b0bcaac003c2	468580a0-57dc-4581-bb78-03407ce5ab55
3387	3387	0	GBIF France	da44cd31-5901-4687-a106-6d1c7734ee3a	47b3bc8c-6676-451d-9f24-c14423b4f2ae
19	19	0	Colombian Biodiversity Information System	7e865cba-7c46-417b-ade5-97f2cf5b7be0	4a35d0e3-fa25-4c58-967a-ffe7355df432
0	2	2	Plazi	ffb07bec-2d10-492d-9c37-361fe0b79427	4ce1d7b9-4509-4ff2-aef9-25bb3bb66c19
55	55	0	GBIF Germany	4f6826f2-4ff6-443d-b966-e6913bd24013	4d67df77-b152-4544-bf60-e0349c08fb36
7918	7918	0	GBIF France	da44cd31-5901-4687-a106-6d1c7734ee3a	511fbf0b-2c05-43f0-a510-ab417fa97ffe
2146	2146	0	National Biodiversity Network	d897a5b9-35ee-4232-94bd-b0bcaac003c2	57542b65-98a8-4897-9ab2-2534b7b02b03
509574	516528	6954	U.S. Geological Survey	8618c64a-93e0-4300-b546-7249e5148ed2	58d0f326-2e85-4d0a-a744-571461220f00
3	3	0	Plazi	ffb07bec-2d10-492d-9c37-361fe0b79427	5c7ae3fd-369e-4daf-bcee-dd21d1cee17e
1307	1307	0	Biodiversity Information System of Mexico	b324e8e9-9a4c-44fa-8f1a-7f39ea7ab576	5caa6b61-4cdf-4716-9f9d-d9886aa7dbb2
0	31	31	Plazi	ffb07bec-2d10-492d-9c37-361fe0b79427	5e5b80da-83a0-4747-a7dc-3b5c67e58b58
47	47	0	Plazi	ffb07bec-2d10-492d-9c37-361fe0b79427	5e87f718-703c-4280-8ca9-f8b6d0f3b402
2	2	0	Plazi	ffb07bec-2d10-492d-9c37-361fe0b79427	5fa5efe4-3aa1-4b14-a794-e3faed206a48
15	15	0	Plazi	ffb07bec-2d10-492d-9c37-361fe0b79427	60115c37-317c-4201-a3c9-86f1cfe078f6
0	11	11	Plazi	ffb07bec-2d10-492d-9c37-361fe0b79427	60950549-402f-4d66-9f88-46d51e00c4f1
82	82	0	GBIF Germany	4f6826f2-4ff6-443d-b966-e6913bd24013	6226ea22-f762-11e1-a439-00145eb45e9a
42	42	0	GBIF Germany	4f6826f2-4ff6-443d-b966-e6913bd24013	631d0cb8-f762-11e1-a439-00145eb45e9a
140	140	0	GBIF Germany	4f6826f2-4ff6-443d-b966-e6913bd24013	637136e4-f762-11e1-a439-00145eb45e9a
36	36	0	Plazi	ffb07bec-2d10-492d-9c37-361fe0b79427	6384c0b8-822b-46fa-9de7-1d1752536fd8
440	440	0	GBIF Germany	4f6826f2-4ff6-443d-b966-e6913bd24013	64a58d6c-f762-11e1-a439-00145eb45e9a
134	134	0	GBIF Germany	4f6826f2-4ff6-443d-b966-e6913bd24013	64c22530-f762-11e1-a439-00145eb45e9a
2	2	0	Plazi	ffb07bec-2d10-492d-9c37-361fe0b79427	65a60366-7910-4855-9bd2-a6aa5a5338e2
3781	3781	0	U.S. Geological Survey	8618c64a-93e0-4300-b546-7249e5148ed2	66ca5555-102d-4d50-baaa-a949a2846666
1	1	0	Plazi	ffb07bec-2d10-492d-9c37-361fe0b79427	6705f380-8cf0-4c29-839a-75eea82ac069
57	57	0	GBIF Germany	4f6826f2-4ff6-443d-b966-e6913bd24013	6803ed14-f762-11e1-a439-00145eb45e9a
111	111	0	GBIF Germany	4f6826f2-4ff6-443d-b966-e6913bd24013	6840002e-f762-11e1-a439-00145eb45e9a
111	111	0	GBIF Germany	4f6826f2-4ff6-443d-b966-e6913bd24013	689cc606-f762-11e1-a439-00145eb45e9a
83	83	0	GBIF Germany	4f6826f2-4ff6-443d-b966-e6913bd24013	689e0e9e-f762-11e1-a439-00145eb45e9a
43	43	0	GBIF Germany	4f6826f2-4ff6-443d-b966-e6913bd24013	6c902dd4-f762-11e1-a439-00145eb45e9a
45	45	0	GBIF Germany	4f6826f2-4ff6-443d-b966-e6913bd24013	6cd3017c-f762-11e1-a439-00145eb45e9a
136	136	0	GBIF Kenya	2a44d626-9f7a-4120-8a7a-4ab5ac15ff2a	6d2b478b-5670-4889-a567-8ae95f9b282e
13750	13750	0	Colombian Biodiversity Information System	7e865cba-7c46-417b-ade5-97f2cf5b7be0	6d4b3e65-5922-46bd-a9b5-9c80b19a28d0
1716	1716	0	GBIF Portugal	673f7038-4262-4149-b753-5658a4e912f6	6dc27fb5-1449-4482-bb50-21eacb17e570
0	3	3	Participant Node Managers Committee	7f48e0c8-5c96-49ec-b972-30748e339115	6ff11bad-2687-4d34-add9-e9ea7d067d64
1476	1476	0	GBIF Germany	4f6826f2-4ff6-443d-b966-e6913bd24013	70ae0210-f762-11e1-a439-00145eb45e9a
10	10	0	GBIF Germany	4f6826f2-4ff6-443d-b966-e6913bd24013	736b93aa-f762-11e1-a439-00145eb45e9a
9	9	0	Plazi	ffb07bec-2d10-492d-9c37-361fe0b79427	74c6f5e4-4eff-4085-ad80-c98984ce7c95
1000	3000	2000	GBIF Japan	db5705aa-6a6e-42f1-8942-d77b9f4896ea	75eec09c-7206-40e5-a84a-36954b64a876
0	3468	3468	Ocean Biodiversity Information System	ba0670b9-4186-41e6-8e70-f9cb3065551a	767f57dd-bdb8-44cb-bf20-f9aafafa4137
15	15	0	Plazi	ffb07bec-2d10-492d-9c37-361fe0b79427	7689563f-7ea3-428a-8df2-072944add9b7
50	50	0	Plazi	ffb07bec-2d10-492d-9c37-361fe0b79427	7838bb10-6ff5-4333-823c-cb5debdb973c
16	16	0	GBIF Germany	4f6826f2-4ff6-443d-b966-e6913bd24013	78410964-f762-11e1-a439-00145eb45e9a
2413	2413	0	Colombian Biodiversity Information System	7e865cba-7c46-417b-ade5-97f2cf5b7be0	79a4574f-a80a-4bd7-9f61-a17c16ef606e
32	32	0	GBIF Germany	4f6826f2-4ff6-443d-b966-e6913bd24013	7a95a300-f762-11e1-a439-00145eb45e9a
2777	2777	0	Korean Biodiversity Information Facility	e0a1e772-0177-4800-94b4-2d023fe6cdf4	7af70730-f762-11e1-a439-00145eb45e9a
8	8	0	Ocean Biodiversity Information System	ba0670b9-4186-41e6-8e70-f9cb3065551a	7b4d10e4-f762-11e1-a439-00145eb45e9a
82	82	0	GBIF France	da44cd31-5901-4687-a106-6d1c7734ee3a	7b8b200f-e0a9-4881-a3c1-657e902fb34f
306	306	0	GBIF Germany	4f6826f2-4ff6-443d-b966-e6913bd24013	7bc26218-f762-11e1-a439-00145eb45e9a
17348	17348	0	Colombian Biodiversity Information System	7e865cba-7c46-417b-ade5-97f2cf5b7be0	7d692461-9c66-4ec5-a57c-96d78fc9132f
489	295	-194	GBIF Germany	4f6826f2-4ff6-443d-b966-e6913bd24013	7d75ae1c-f762-11e1-a439-00145eb45e9a
282	282	0	GBIF Germany	4f6826f2-4ff6-443d-b966-e6913bd24013	7d8e5214-f762-11e1-a439-00145eb45e9a
316	285	-31	GBIF Germany	4f6826f2-4ff6-443d-b966-e6913bd24013	7e878780-f762-11e1-a439-00145eb45e9a
0	97	97	Ocean Biodiversity Information System	ba0670b9-4186-41e6-8e70-f9cb3065551a	81253722-b084-4380-9b6f-d24cdcb074a3
907	907	0	GBIF Germany	4f6826f2-4ff6-443d-b966-e6913bd24013	81aed7c4-f762-11e1-a439-00145eb45e9a
952	952	0	GBIF Germany	4f6826f2-4ff6-443d-b966-e6913bd24013	82074562-f762-11e1-a439-00145eb45e9a
28	28	0	GBIF Germany	4f6826f2-4ff6-443d-b966-e6913bd24013	826b7e92-f762-11e1-a439-00145eb45e9a
563	563	0	Atlas of Living Australia	4a6f1b71-969e-4fc5-a693-282b05e1220c	82e57c42-f762-11e1-a439-00145eb45e9a
32	32	0	Plazi	ffb07bec-2d10-492d-9c37-361fe0b79427	8470bad9-6c97-468c-9687-5653fd52d89f
21333	21333	0	Biodiversity Information System of Mexico	b324e8e9-9a4c-44fa-8f1a-7f39ea7ab576	847f5564-f762-11e1-a439-00145eb45e9a
34	34	0	Plazi	ffb07bec-2d10-492d-9c37-361fe0b79427	84b5feba-a458-4f03-a5b5-35b9c1cc02e1
4	4	0	Plazi	ffb07bec-2d10-492d-9c37-361fe0b79427	8726a871-d9af-4404-ba77-213c73f892a6
1	1	0	Plazi	ffb07bec-2d10-492d-9c37-361fe0b79427	87f348a2-e3a5-444c-a416-fc4b5c991ffa
13	13	0	GBIF Germany	4f6826f2-4ff6-443d-b966-e6913bd24013	888cc8d0-f762-11e1-a439-00145eb45e9a
968	968	0	GBIF Germany	4f6826f2-4ff6-443d-b966-e6913bd24013	89acc3b4-f762-11e1-a439-00145eb45e9a
0	4	4	Ocean Biodiversity Information System	ba0670b9-4186-41e6-8e70-f9cb3065551a	89ee7f27-b999-4bc6-a989-e4c4f65f57f3
160	160	0	GBIF Germany	4f6826f2-4ff6-443d-b966-e6913bd24013	8a3b0296-f762-11e1-a439-00145eb45e9a
88	88	0	GBIF Germany	4f6826f2-4ff6-443d-b966-e6913bd24013	8aadb4e4-f762-11e1-a439-00145eb45e9a
92	92	0	GBIF Germany	4f6826f2-4ff6-443d-b966-e6913bd24013	8ac5910e-f762-11e1-a439-00145eb45e9a
10	10	0	GBIF Germany	4f6826f2-4ff6-443d-b966-e6913bd24013	8c217c8e-f762-11e1-a439-00145eb45e9a
0	35	35	Ocean Biodiversity Information System	ba0670b9-4186-41e6-8e70-f9cb3065551a	8c7fc320-c6df-4136-b414-6778d682f905
18	14	-4	GBIF Germany	4f6826f2-4ff6-443d-b966-e6913bd24013	8ca29968-f762-11e1-a439-00145eb45e9a
927	521	-406	GBIF Germany	4f6826f2-4ff6-443d-b966-e6913bd24013	8d87509e-f762-11e1-a439-00145eb45e9a
19	19	0	Plazi	ffb07bec-2d10-492d-9c37-361fe0b79427	8eaddec8-ce52-4222-a97c-a77d380cb09e
2	2	0	GBIF Argentina	2426a871-9feb-40a1-96c6-0c593a76b835	8f264c36-1f41-47d3-baf5-85f13cdd96ef
0	4463	4463	U.S. Geological Survey	8618c64a-93e0-4300-b546-7249e5148ed2	8f93bab2-36b8-4a87-8a0c-2614e762fe90
0	1263	1263	GBIF Chile	a8b16421-d80b-4ef3-8f22-098b01a89255	8fbf6bab-3c5f-4397-8eac-362a4d582b3c
11	11	0	GBIF Portugal	673f7038-4262-4149-b753-5658a4e912f6	900a387b-cf8b-479b-b983-69fa973f3bcd
2	2	0	Plazi	ffb07bec-2d10-492d-9c37-361fe0b79427	906a7ed5-7271-4df4-b5f6-01bf517cec07
10	10	0	GBIF Germany	4f6826f2-4ff6-443d-b966-e6913bd24013	90d44a7c-f762-11e1-a439-00145eb45e9a
34	18	-16	GBIF Germany	4f6826f2-4ff6-443d-b966-e6913bd24013	90e3c3f8-f762-11e1-a439-00145eb45e9a
6	3	-3	GBIF Germany	4f6826f2-4ff6-443d-b966-e6913bd24013	9185fd58-f762-11e1-a439-00145eb45e9a
1566	1566	0	GBIF Germany	4f6826f2-4ff6-443d-b966-e6913bd24013	91f46a54-f762-11e1-a439-00145eb45e9a
825	825	0	GBIF Germany	4f6826f2-4ff6-443d-b966-e6913bd24013	920ec426-f762-11e1-a439-00145eb45e9a
12	12	0	Plazi	ffb07bec-2d10-492d-9c37-361fe0b79427	9223d6a4-2e57-4bb6-91fe-09fcfb1b78a5
2	2	0	Plazi	ffb07bec-2d10-492d-9c37-361fe0b79427	92402f3e-075a-440f-87df-a545fd221c0c
2143	2143	0	GBIF Germany	4f6826f2-4ff6-443d-b966-e6913bd24013	930c27ba-f762-11e1-a439-00145eb45e9a
162	162	0	GBIF Germany	4f6826f2-4ff6-443d-b966-e6913bd24013	94fc5432-f762-11e1-a439-00145eb45e9a
45	45	0	GBIF Germany	4f6826f2-4ff6-443d-b966-e6913bd24013	953164ce-f762-11e1-a439-00145eb45e9a
59990	64263	4273	GBIF Japan	db5705aa-6a6e-42f1-8942-d77b9f4896ea	95f4f542-f762-11e1-a439-00145eb45e9a
1	1	0	Plazi	ffb07bec-2d10-492d-9c37-361fe0b79427	967c4c38-33a4-4f5e-bd46-4ec1a62e68a9
1236	1236	0	GBIF Spain	1f94b3ca-9345-4d65-afe2-4bace93aa0fe	96b66524-f762-11e1-a439-00145eb45e9a
4080	3920	-160	GBIF Germany	4f6826f2-4ff6-443d-b966-e6913bd24013	98879ffc-1a80-4b5b-9431-beb55bf8d751
0	19	19	Plazi	ffb07bec-2d10-492d-9c37-361fe0b79427	99259204-6b1f-4164-8063-c2de18458596
0	11	11	Plazi	ffb07bec-2d10-492d-9c37-361fe0b79427	9971f3b4-03c0-4426-9ccc-a581ec305ec9
1	1	0	GBIF Germany	4f6826f2-4ff6-443d-b966-e6913bd24013	99f8e99c-f281-4123-9243-3e908fe52cd2
0	1575	1575	U.S. Geological Survey	8618c64a-93e0-4300-b546-7249e5148ed2	9af34855-acaf-4d5e-8953-fb5912d09fd9
0	1	1	Plazi	ffb07bec-2d10-492d-9c37-361fe0b79427	9cf87cc9-79ad-4a31-83ca-b635d495a0b9
29	29	0	Plazi	ffb07bec-2d10-492d-9c37-361fe0b79427	9f6752d6-7c9a-4756-acfe-badb2a0301d0
9	9	0	Plazi	ffb07bec-2d10-492d-9c37-361fe0b79427	a0f62e9a-3360-4076-92aa-b7c85ca34ce5
29	29	0	Colombian Biodiversity Information System	7e865cba-7c46-417b-ade5-97f2cf5b7be0	a18d5ab7-894a-4649-a4dd-7335086fe910
1081	1081	0	GBIF Spain	1f94b3ca-9345-4d65-afe2-4bace93aa0fe	a33055a3-5e03-4ad9-8447-bc92c967a27b
4	4	0	Plazi	ffb07bec-2d10-492d-9c37-361fe0b79427	a6c7319b-70ee-4a4f-ae39-7cf8b26ca335
6	6	0	Plazi	ffb07bec-2d10-492d-9c37-361fe0b79427	a8801729-fde2-4ea9-a2f5-c6bf633a81b5
724	724	0	National Biodiversity Data Centre	422b00b2-6c94-4bb6-976b-c359916efdb8	a8accd76-fead-4fd8-8689-6011fdb93afb
60	36	-24	GBIF Germany	4f6826f2-4ff6-443d-b966-e6913bd24013	aa117b38-3186-4182-86ee-d82f8d8adcb9
923	4220	3297	Colombian Biodiversity Information System	7e865cba-7c46-417b-ade5-97f2cf5b7be0	acfbea93-6b09-4455-a0e2-e4b1042a3b58
109	109	0	ASEAN Centre for Biodiversity	af2a0fa1-4c8e-4bdc-8954-b1a55e32b0f1	af32ab2e-7be6-42ca-a570-ad79fe0e32bb
364	252	-112	GBIF Germany	4f6826f2-4ff6-443d-b966-e6913bd24013	afd10439-f49f-4105-b5e9-9fc1df532d71
10	10	0	Plazi	ffb07bec-2d10-492d-9c37-361fe0b79427	b069f23e-2600-499e-b8d0-5ef3fd4d0c16
0	13	13	Plazi	ffb07bec-2d10-492d-9c37-361fe0b79427	b21fc215-0cec-4baa-b4e9-ad216f17972a
212	212	0	GBIF France	da44cd31-5901-4687-a106-6d1c7734ee3a	b3ff4efa-cb9c-48bf-be3b-73b1c2c9f7b1
0	2	2	Plazi	ffb07bec-2d10-492d-9c37-361fe0b79427	b5167639-dcd0-4edc-b502-e8863632d628
175	175	0	ASEAN Centre for Biodiversity	af2a0fa1-4c8e-4bdc-8954-b1a55e32b0f1	b8fb7fcc-75cd-46d3-8ea6-5a43b2ed7e04
2360	2360	0	GBIF Benin	efb9c00e-f802-45dd-8826-a52ec45b89ff	b927307a-913b-46f8-8b27-fd616d374692
2	3	1	Plazi	ffb07bec-2d10-492d-9c37-361fe0b79427	b99b3fcb-e3fd-4c6e-83d1-e9b5851387c2
278	278	0	Colombian Biodiversity Information System	7e865cba-7c46-417b-ade5-97f2cf5b7be0	bbf73261-50ad-43fd-a9f2-536e41046e02
6	6	0	GBIF Germany	4f6826f2-4ff6-443d-b966-e6913bd24013	bd93af91-60f8-43bf-9f35-3ee623ca11c8
70447	70447	0	U.S. Geological Survey	8618c64a-93e0-4300-b546-7249e5148ed2	bea2b388-fb91-4b1a-8ee5-c5ae7837268b
0	50	50	Plazi	ffb07bec-2d10-492d-9c37-361fe0b79427	c95b424f-11b6-4d97-a30f-b6b36dd1b8ed
28	28	0	Plazi	ffb07bec-2d10-492d-9c37-361fe0b79427	ca47b044-1360-409b-a885-c0da85fa904b
182	182	0	Plazi	ffb07bec-2d10-492d-9c37-361fe0b79427	cb288575-93a8-4e59-86fd-ee6bae784b6a
18	18	0	Plazi	ffb07bec-2d10-492d-9c37-361fe0b79427	d49f6d28-68b5-4c6c-b9e5-c842e9b198ad
101	101	0	Plazi	ffb07bec-2d10-492d-9c37-361fe0b79427	d5fa185b-9572-41ac-90b9-7c0349dc2300
187	187	0	Plazi	ffb07bec-2d10-492d-9c37-361fe0b79427	d946ff4d-5c3d-420a-b43a-f43242b52daa
0	108	108	Plazi	ffb07bec-2d10-492d-9c37-361fe0b79427	ddc9965c-360a-4b2f-bc3e-3a8720e277a3
7	7	0	Plazi	ffb07bec-2d10-492d-9c37-361fe0b79427	de4f2e41-d1c5-47c8-98af-548b7f9842bb
51	51	0	Plazi	ffb07bec-2d10-492d-9c37-361fe0b79427	de5a8887-9c15-4847-ab00-041fac2e1d9e
385	385	0	GBIF France	da44cd31-5901-4687-a106-6d1c7734ee3a	dea05a0f-6245-4adc-9e76-c1335033b6f8
0	1	1	Plazi	ffb07bec-2d10-492d-9c37-361fe0b79427	dea5368a-ea89-41d0-a4d6-ea5191f1bc79
6	6	0	Participant Node Managers Committee	7f48e0c8-5c96-49ec-b972-30748e339115	e246c57f-4f47-40ff-917d-573a42f8bc26
0	11	11	Plazi	ffb07bec-2d10-492d-9c37-361fe0b79427	e2f37531-aab6-45c4-8285-0d786c9002d6
0	2	2	Plazi	ffb07bec-2d10-492d-9c37-361fe0b79427	e38aa9f2-b73f-429b-85c4-18db464c6dd1
7	7	0	Plazi	ffb07bec-2d10-492d-9c37-361fe0b79427	e3921d2b-6f98-46a8-b33f-d81be08e74ea
0	18	18	Ocean Biodiversity Information System	ba0670b9-4186-41e6-8e70-f9cb3065551a	e81762b0-8cec-4b0e-b74e-11613e5c4115
442	442	0	Plazi	ffb07bec-2d10-492d-9c37-361fe0b79427	e85115a0-ecc8-4c1f-9908-821d5a18f80b
23	23	0	Colombian Biodiversity Information System	7e865cba-7c46-417b-ade5-97f2cf5b7be0	ec4bec36-444f-4b46-be20-acbef77c4566
154	154	0	Plazi	ffb07bec-2d10-492d-9c37-361fe0b79427	ee7b1d15-b0aa-4960-92f5-e2b8ccd5409e
26	26	0	Plazi	ffb07bec-2d10-492d-9c37-361fe0b79427	efce95d8-c0d8-4b4c-8093-edc8c83ddbcd
0	67	67	Plazi	ffb07bec-2d10-492d-9c37-361fe0b79427	f22dc570-6219-40e7-8b08-b8d22012e567
0	43	43	Plazi	ffb07bec-2d10-492d-9c37-361fe0b79427	f2cd2a2b-9ae1-41fe-9a0e-b625a8b07be4
2998	2998	0	Biodiversity Information System of Mexico	b324e8e9-9a4c-44fa-8f1a-7f39ea7ab576	f30836e6-fffa-44fb-9fa7-2b4c536e8bb9
171	171	0	Plazi	ffb07bec-2d10-492d-9c37-361fe0b79427	f3cb952d-98ae-4de8-9482-4f7a876ddf77
14	14	0	Plazi	ffb07bec-2d10-492d-9c37-361fe0b79427	f3d4b488-bf0e-4bc1-86f4-88db1263f169
0	4	4	Plazi	ffb07bec-2d10-492d-9c37-361fe0b79427	f730e4bb-d756-4ac5-92ba-6c117ca7bfff
0	3	3	Plazi	ffb07bec-2d10-492d-9c37-361fe0b79427	fb153f91-8f8c-491c-a140-01b65308aef4
0	121	121	Plazi	ffb07bec-2d10-492d-9c37-361fe0b79427	003a15e3-4b3f-423c-b40b-7f08fa1b1a75
108	108	0	Plazi	ffb07bec-2d10-492d-9c37-361fe0b79427	034ebcd9-efa7-416a-822c-b6aee0e57a1c
146	146	0	Plazi	ffb07bec-2d10-492d-9c37-361fe0b79427	05d55bff-4ac2-43f1-9818-9665b0bf1198
712	712	0	GBIF France	da44cd31-5901-4687-a106-6d1c7734ee3a	0a7b424e-70e6-4bb9-a87d-080b89b3fdec
550	609	59	Atlas of Living Australia	4a6f1b71-969e-4fc5-a693-282b05e1220c	0d031c51-08fa-4c31-aced-2250d458acd6
455	455	0	Plazi	ffb07bec-2d10-492d-9c37-361fe0b79427	10b6b053-2ccf-4ca0-8922-486ad098fc56
1295	1295	0	Biodiversity Information System of Mexico	b324e8e9-9a4c-44fa-8f1a-7f39ea7ab576	11813364-c20b-4a1e-8eb1-0febd8ddef5d
20	20	0	GBIF Sweden	a0b3be64-6525-4387-ac67-a499950f92e1	152c3363-4786-487b-9c0f-518e1d07eb82
0	1	1	Ocean Biodiversity Information System	ba0670b9-4186-41e6-8e70-f9cb3065551a	1556a7ad-423c-4a47-9727-9fd3cc655ee4
43610	43610	0	U.S. Geological Survey	8618c64a-93e0-4300-b546-7249e5148ed2	1683e434-321c-4b55-a5b0-6e05eb6d931f
0	5	5	Plazi	ffb07bec-2d10-492d-9c37-361fe0b79427	16e811c9-ff54-4518-86ab-9a241d3a783a
36	36	0	GBIF France	da44cd31-5901-4687-a106-6d1c7734ee3a	191cae5b-6dbd-4057-a094-89bf517cbc67
3	3	0	Plazi	ffb07bec-2d10-492d-9c37-361fe0b79427	1b5a8f1a-37b0-40fd-acd4-2476f1f4d189
0	4	4	Plazi	ffb07bec-2d10-492d-9c37-361fe0b79427	1d93b583-d19b-4889-a904-7cb366aca615
1540	1540	0	GBIF Germany	4f6826f2-4ff6-443d-b966-e6913bd24013	1ec9f790-5490-4656-8dac-396b49c7cd41
129	129	0	National Biodiversity Network	d897a5b9-35ee-4232-94bd-b0bcaac003c2	1ee2f194-4c11-4212-a77a-28a4cfcd5c50
88	88	0	Plazi	ffb07bec-2d10-492d-9c37-361fe0b79427	2090f066-c5ef-4aca-90c2-6b267c3ef848
13483	13483	0	GBIF Japan	db5705aa-6a6e-42f1-8942-d77b9f4896ea	22767367-9a4d-4eaf-90d2-baaa2d9befab
235	235	0	GBIF France	da44cd31-5901-4687-a106-6d1c7734ee3a	245a4d83-b1a6-4b34-8d19-858dccba0f33
48	48	0	GBIF Sweden	a0b3be64-6525-4387-ac67-a499950f92e1	24d3ced7-8ac1-41d9-b9b1-f813c7bdc81e
660	660	0	GBIF France	da44cd31-5901-4687-a106-6d1c7734ee3a	25c4b4e8-edc5-4137-b204-775590c8edbb
1401	1401	0	GBIF France	da44cd31-5901-4687-a106-6d1c7734ee3a	2ceb7556-fbaf-4a3e-97b2-34696a48a0c3
3	3	0	Plazi	ffb07bec-2d10-492d-9c37-361fe0b79427	2d048e59-b20d-4f30-9b4b-1f18303f318b
297	297	0	Biodiversity Information System of Mexico	b324e8e9-9a4c-44fa-8f1a-7f39ea7ab576	30763955-029e-4008-86b9-c2d9c12f11ed
1014	1014	0	GBIF France	da44cd31-5901-4687-a106-6d1c7734ee3a	315ad955-fe8a-4c78-88b6-6b0ff033a50d
59	59	0	GBIF Germany	4f6826f2-4ff6-443d-b966-e6913bd24013	327b65d7-c3d6-45f9-8bc9-5ed6e6a2717a
4	4	0	Plazi	ffb07bec-2d10-492d-9c37-361fe0b79427	32c5384a-c581-41e3-ab05-83f88b0ebbf2
11	11	0	Plazi	ffb07bec-2d10-492d-9c37-361fe0b79427	34bb70ed-5193-4153-9a16-0f12395fb82f
90	90	0	GBIF Germany	4f6826f2-4ff6-443d-b966-e6913bd24013	34c0bc41-cb59-4927-9e41-53fb0a5ce44b
812	812	0	GBIF Germany	4f6826f2-4ff6-443d-b966-e6913bd24013	359ff51a-8128-4a30-8cc5-c5bd2b0e0e88
0	4	4	Plazi	ffb07bec-2d10-492d-9c37-361fe0b79427	38bacee8-bbb7-473e-8d6a-a5c928530e34
17	17	0	Plazi	ffb07bec-2d10-492d-9c37-361fe0b79427	39f522cb-ee17-49d1-b967-d9fd3ad393fe
618	618	0	National Biodiversity Network	d897a5b9-35ee-4232-94bd-b0bcaac003c2	3a47d44d-de57-4332-adb2-999e70e28960
0	49	49	Plazi	ffb07bec-2d10-492d-9c37-361fe0b79427	3a661272-251f-4ad1-9912-ed55f59750c9
1	1	0	Plazi	ffb07bec-2d10-492d-9c37-361fe0b79427	3b7a3c90-f109-4d2c-96dd-cbc79d68ccc0
544	544	0	GBIF Norway	4f829580-180d-46a9-9c87-ed8ec959b545	3b9a6c7a-98cb-4e1e-bc33-7fecb2599a87
91	91	0	Colombian Biodiversity Information System	7e865cba-7c46-417b-ade5-97f2cf5b7be0	3bc4190d-da62-464f-8279-500bb8a2db6e
127	127	0	Biodiversity Information System of Mexico	b324e8e9-9a4c-44fa-8f1a-7f39ea7ab576	3ffd0a52-3599-4f6c-8fce-180cea28b708
723	723	0	GBIF Germany	4f6826f2-4ff6-443d-b966-e6913bd24013	4085aaae-d914-4cfd-8bfa-fbadcf3a0b04
0	4	4	Plazi	ffb07bec-2d10-492d-9c37-361fe0b79427	4117e1ba-9327-48b7-95c2-fd29059f011b
19689	19689	0	National Biodiversity Network	d897a5b9-35ee-4232-94bd-b0bcaac003c2	41fd07f2-5fde-4050-b58c-45aa58f25afb
117427	117427	0	Ocean Biodiversity Information System	ba0670b9-4186-41e6-8e70-f9cb3065551a	421890f7-e909-40ed-a573-b1c9529a55fa
81	63	-18	GBIF Germany	4f6826f2-4ff6-443d-b966-e6913bd24013	425616ac-75e2-45fc-8966-8b77bb44ace8
0	1	1	Plazi	ffb07bec-2d10-492d-9c37-361fe0b79427	4597f8e7-649f-4c70-bb57-a7e5fd48ada4
2	2	0	Plazi	ffb07bec-2d10-492d-9c37-361fe0b79427	460a9434-2c3d-4e00-a96d-7ce0b7fbb378
3	3	0	Belgian Biodiversity Platform	fb11cfe1-ebc3-45af-9159-17d9fddbcdac	47ffa1e7-fff8-486b-9446-2473c371c275
0	9	9	Plazi	ffb07bec-2d10-492d-9c37-361fe0b79427	4b8ded0c-2d13-4692-88bc-11c60ca8c8dd
183	183	0	Participant Node Managers Committee	7f48e0c8-5c96-49ec-b972-30748e339115	4bb5aebe-ec3b-4cf4-b0bb-ac2078dd3a19
157292	157292	0	National Biodiversity Network	d897a5b9-35ee-4232-94bd-b0bcaac003c2	4ec3868e-b460-48f0-bd64-8e5daf392827
71	71	0	Plazi	ffb07bec-2d10-492d-9c37-361fe0b79427	508869f7-cee9-4626-976a-7b4aa7f96504
2	2	0	Plazi	ffb07bec-2d10-492d-9c37-361fe0b79427	50efd98b-e1f4-447d-8cc5-917eaf6f435a
7125	7125	0	GBIF France	da44cd31-5901-4687-a106-6d1c7734ee3a	5161123f-d807-409a-9d09-a9464cfa4876
18202	18201	-1	Biodiversity Information System of Mexico	b324e8e9-9a4c-44fa-8f1a-7f39ea7ab576	55593034-e52a-4b4a-8b2f-e2d3d24b6aa1
0	12	12	Colombian Biodiversity Information System	7e865cba-7c46-417b-ade5-97f2cf5b7be0	560bdffb-b03f-4212-933e-6acc7e593891
0	15	15	Plazi	ffb07bec-2d10-492d-9c37-361fe0b79427	57db4b25-71e8-41ed-892a-869edf423d76
50	50	0	Plazi	ffb07bec-2d10-492d-9c37-361fe0b79427	5b3ebcd7-2751-4acf-94b5-82a3fc2ceace
0	5	5	Plazi	ffb07bec-2d10-492d-9c37-361fe0b79427	5f46dee8-35ab-404d-90df-f26ef03da2b6
0	1748	1748	U.S. Geological Survey	8618c64a-93e0-4300-b546-7249e5148ed2	602e1bdf-385d-447c-818a-58266b7c7fc6
104	104	0	GBIF Germany	4f6826f2-4ff6-443d-b966-e6913bd24013	611f1398-f762-11e1-a439-00145eb45e9a
86	86	0	GBIF Germany	4f6826f2-4ff6-443d-b966-e6913bd24013	61b102b2-f762-11e1-a439-00145eb45e9a
0	6	6	Plazi	ffb07bec-2d10-492d-9c37-361fe0b79427	64f95b5a-8a54-4119-b887-f3d0fe6bd23c
275	274	-1	GBIF Germany	4f6826f2-4ff6-443d-b966-e6913bd24013	659e442a-f762-11e1-a439-00145eb45e9a
598	598	0	GBIF France	da44cd31-5901-4687-a106-6d1c7734ee3a	65a1dc68-3a0d-4813-a193-a0045cf1d4c9
126	84	-42	GBIF Germany	4f6826f2-4ff6-443d-b966-e6913bd24013	65fe52c0-f762-11e1-a439-00145eb45e9a
50	50	0	GBIF Germany	4f6826f2-4ff6-443d-b966-e6913bd24013	66a07410-f762-11e1-a439-00145eb45e9a
76	76	0	GBIF Germany	4f6826f2-4ff6-443d-b966-e6913bd24013	6749ec2a-f762-11e1-a439-00145eb45e9a
48	48	0	GBIF Germany	4f6826f2-4ff6-443d-b966-e6913bd24013	67f28402-f762-11e1-a439-00145eb45e9a
57421	57421	0	DanBIF - Danish Biodiversity Information Facility	4ddd294f-02b7-4359-ac33-0806a9ca9c6b	6867ae37-74b8-43e7-805d-5dac0a6d447e
255	255	0	Plazi	ffb07bec-2d10-492d-9c37-361fe0b79427	6b7e3a53-0658-4628-bfb6-9f39f0b34c99
10005	10005	0	National Biodiversity Network	d897a5b9-35ee-4232-94bd-b0bcaac003c2	6df4cdef-c55d-4a03-9055-3cbadcdd05aa
192	192	0	Netherlands Biodiversity Information Facility	0909d601-bda2-42df-9e63-a6d51847ebce	6e1af587-c4f3-4526-bedf-9ee5130755ee
0	4	4	Plazi	ffb07bec-2d10-492d-9c37-361fe0b79427	6e52255f-7523-463b-874e-d2503609c7a4
0	34	34	Colombian Biodiversity Information System	7e865cba-7c46-417b-ade5-97f2cf5b7be0	70b916f3-bf6d-4270-9d69-56ff7381161f
109	109	0	GBIF Germany	4f6826f2-4ff6-443d-b966-e6913bd24013	70eaf422-f762-11e1-a439-00145eb45e9a
55	55	0	GBIF Germany	4f6826f2-4ff6-443d-b966-e6913bd24013	71be8990-f762-11e1-a439-00145eb45e9a
23347	23347	0	GBIF Germany	4f6826f2-4ff6-443d-b966-e6913bd24013	71eba376-f762-11e1-a439-00145eb45e9a
0	19	19	Plazi	ffb07bec-2d10-492d-9c37-361fe0b79427	72416fcb-b45f-44bc-9aba-75c1fcdcbd67
15	15	0	GBIF Germany	4f6826f2-4ff6-443d-b966-e6913bd24013	728f0e94-f762-11e1-a439-00145eb45e9a
56	56	0	GBIF Germany	4f6826f2-4ff6-443d-b966-e6913bd24013	73226a7c-f762-11e1-a439-00145eb45e9a
23	23	0	GBIF Germany	4f6826f2-4ff6-443d-b966-e6913bd24013	752a72e2-f762-11e1-a439-00145eb45e9a
30	30	0	GBIF Germany	4f6826f2-4ff6-443d-b966-e6913bd24013	757ddefa-f762-11e1-a439-00145eb45e9a
26	26	0	GBIF Germany	4f6826f2-4ff6-443d-b966-e6913bd24013	7590210a-f762-11e1-a439-00145eb45e9a
222	222	0	GBIF Germany	4f6826f2-4ff6-443d-b966-e6913bd24013	75d4f776-f762-11e1-a439-00145eb45e9a
0	7758	7758	Participant Node Managers Committee	7f48e0c8-5c96-49ec-b972-30748e339115	77973bd8-e146-463e-9452-05debd36c12a
1247	1257	10	GBIF Norway	4f829580-180d-46a9-9c87-ed8ec959b545	78822c79-7646-448d-aac2-35700498c147
11	11	0	GBIF Germany	4f6826f2-4ff6-443d-b966-e6913bd24013	78eed760-f762-11e1-a439-00145eb45e9a
11633	11633	0	GBIF France	da44cd31-5901-4687-a106-6d1c7734ee3a	794710a4-7fb2-4908-8bdf-f1d5dcdb2a4a
2	2	0	Plazi	ffb07bec-2d10-492d-9c37-361fe0b79427	7999f93c-88f6-49b2-96a2-cc7e6e774f40
103	89	-14	GBIF Germany	4f6826f2-4ff6-443d-b966-e6913bd24013	799a7c5a-f762-11e1-a439-00145eb45e9a
0	29	29	Ocean Biodiversity Information System	ba0670b9-4186-41e6-8e70-f9cb3065551a	79cf45a1-5e18-46c3-b83b-8dc5e6d3355e
890	890	0	Atlas of Living Australia	4a6f1b71-969e-4fc5-a693-282b05e1220c	7a2530fc-f762-11e1-a439-00145eb45e9a
23	23	0	GBIF Germany	4f6826f2-4ff6-443d-b966-e6913bd24013	7ab8ca42-f762-11e1-a439-00145eb45e9a
1017	1017	0	Korean Biodiversity Information Facility	e0a1e772-0177-4800-94b4-2d023fe6cdf4	7b1793a6-f762-11e1-a439-00145eb45e9a
106100	106100	0	Korean Biodiversity Information Facility	e0a1e772-0177-4800-94b4-2d023fe6cdf4	7b20cfac-f762-11e1-a439-00145eb45e9a
267	267	0	GBIF Germany	4f6826f2-4ff6-443d-b966-e6913bd24013	7bdb6b84-93e3-4834-84a6-5147cc69b5c6
66	66	0	GBIF Japan	db5705aa-6a6e-42f1-8942-d77b9f4896ea	7c509321-47c2-4ded-a6eb-621cbf03c389
183	183	0	GBIF Germany	4f6826f2-4ff6-443d-b966-e6913bd24013	7d2ad072-f762-11e1-a439-00145eb45e9a
2177	2177	0	GBIF Germany	4f6826f2-4ff6-443d-b966-e6913bd24013	7d8180f2-f762-11e1-a439-00145eb45e9a
265	264	-1	GBIF Norway	4f829580-180d-46a9-9c87-ed8ec959b545	7da9dbec-e66b-4665-86bb-3a977d91f1d6
4	4	0	Plazi	ffb07bec-2d10-492d-9c37-361fe0b79427	7df83c81-d1cc-453f-8c17-0ccd5dda5b76
995	996	1	GBIF Germany	4f6826f2-4ff6-443d-b966-e6913bd24013	7e554270-f762-11e1-a439-00145eb45e9a
24	24	0	GBIF Portugal	673f7038-4262-4149-b753-5658a4e912f6	7f7c02d8-178e-4673-9107-d811f894c883
3406	3406	0	Biodiversity Information System of Mexico	b324e8e9-9a4c-44fa-8f1a-7f39ea7ab576	7ffbedb8-f762-11e1-a439-00145eb45e9a
1000	1000	0	Biodiversity Information System of Mexico	b324e8e9-9a4c-44fa-8f1a-7f39ea7ab576	80b6b274-f762-11e1-a439-00145eb45e9a
1936	2136	200	GBIF Japan	db5705aa-6a6e-42f1-8942-d77b9f4896ea	811f7d86-f762-11e1-a439-00145eb45e9a
508197	636115	127918	Belgian Biodiversity Platform	fb11cfe1-ebc3-45af-9159-17d9fddbcdac	8138eb72-f762-11e1-a439-00145eb45e9a
341	341	0	GBIF Germany	4f6826f2-4ff6-443d-b966-e6913bd24013	825d7da6-f762-11e1-a439-00145eb45e9a
4387	5313	926	National Biodiversity Network	d897a5b9-35ee-4232-94bd-b0bcaac003c2	82c4ec26-36a1-42d0-b9af-cf0da4ac55de
3345	3345	0	Participant Node Managers Committee	7f48e0c8-5c96-49ec-b972-30748e339115	82cf41bc-5aa5-4c9c-b86f-845bf591d002
3166	3166	0	Polish Biodiversity Information Network	2618bfdf-e194-4911-a241-80db3107bc51	82d79276-f762-11e1-a439-00145eb45e9a
97	97	0	Biodiversity Information System of Mexico	b324e8e9-9a4c-44fa-8f1a-7f39ea7ab576	850c8236-f762-11e1-a439-00145eb45e9a
21	21	0	Plazi	ffb07bec-2d10-492d-9c37-361fe0b79427	8534fa33-a047-490a-8e78-2a3e481a1420
29324	37676	8352	GBIF Japan	db5705aa-6a6e-42f1-8942-d77b9f4896ea	861392fa-f762-11e1-a439-00145eb45e9a
0	9	9	Plazi	ffb07bec-2d10-492d-9c37-361fe0b79427	86199f41-39a7-42a8-a201-ac728ed2e76f
5284	5123	-161	GBIF Germany	4f6826f2-4ff6-443d-b966-e6913bd24013	8731d5fc-f762-11e1-a439-00145eb45e9a
463	463	0	GBIF Germany	4f6826f2-4ff6-443d-b966-e6913bd24013	8838b6fa-f762-11e1-a439-00145eb45e9a
2869	2869	0	Colombian Biodiversity Information System	7e865cba-7c46-417b-ade5-97f2cf5b7be0	887677ec-c307-4398-8fe5-0676c40b57ca
530	530	0	Ocean Biodiversity Information System	ba0670b9-4186-41e6-8e70-f9cb3065551a	8922dd20-f762-11e1-a439-00145eb45e9a
204	204	0	GBIF Germany	4f6826f2-4ff6-443d-b966-e6913bd24013	89f7e498-f762-11e1-a439-00145eb45e9a
3027	3027	0	Colombian Biodiversity Information System	7e865cba-7c46-417b-ade5-97f2cf5b7be0	8bc4f5d2-8e7a-430d-b219-6776c38f401a
73	73	0	GBIF Germany	4f6826f2-4ff6-443d-b966-e6913bd24013	8bcdc9ea-f762-11e1-a439-00145eb45e9a
195	126	-69	GBIF Germany	4f6826f2-4ff6-443d-b966-e6913bd24013	8c515d8c-f762-11e1-a439-00145eb45e9a
135	135	0	GBIF Germany	4f6826f2-4ff6-443d-b966-e6913bd24013	8d6c033e-f762-11e1-a439-00145eb45e9a
4	2	-2	GBIF Germany	4f6826f2-4ff6-443d-b966-e6913bd24013	8e44b29c-f762-11e1-a439-00145eb45e9a
1728	1152	-576	GBIF Germany	4f6826f2-4ff6-443d-b966-e6913bd24013	8e954bb2-f762-11e1-a439-00145eb45e9a
337	204	-133	GBIF Germany	4f6826f2-4ff6-443d-b966-e6913bd24013	8f837cb0-f762-11e1-a439-00145eb45e9a
65	38	-27	GBIF Germany	4f6826f2-4ff6-443d-b966-e6913bd24013	90409692-f762-11e1-a439-00145eb45e9a
0	108	108	Plazi	ffb07bec-2d10-492d-9c37-361fe0b79427	90855d8d-93eb-4a4f-a4cf-3c36fdf9c2a5
7	3	-4	GBIF Germany	4f6826f2-4ff6-443d-b966-e6913bd24013	90e91aec-f762-11e1-a439-00145eb45e9a
141	141	0	GBIF France	da44cd31-5901-4687-a106-6d1c7734ee3a	91b9b21c-5cbe-4d3c-9830-7c8d4affb019
70	70	0	Plazi	ffb07bec-2d10-492d-9c37-361fe0b79427	91bf65af-e156-47c5-83e8-5b508a0fd280
81	48	-33	GBIF Germany	4f6826f2-4ff6-443d-b966-e6913bd24013	9349e4b0-f762-11e1-a439-00145eb45e9a
158	158	0	GBIF Germany	4f6826f2-4ff6-443d-b966-e6913bd24013	93d57a52-f762-11e1-a439-00145eb45e9a
2134	2134	0	National Biodiversity Network	d897a5b9-35ee-4232-94bd-b0bcaac003c2	9497be44-9171-4191-9ba9-17742cbb8fb4
161	161	0	Plazi	ffb07bec-2d10-492d-9c37-361fe0b79427	9602fa47-6df3-4388-81f3-1bba8ceea5de
115	115	0	GBIF France	da44cd31-5901-4687-a106-6d1c7734ee3a	97836fc9-111f-4530-9d57-2e2c066c8aad
162150	162150	0	South African Biodiversity Information Facility	7190b835-4e86-4b6e-85c1-19cc6677c250	9a9dcc47-fdca-4881-998a-9596dcedff6a
5146	5146	0	GBIF Madagascar	2dbfc5c5-51b5-4494-9dfc-4d3f013a3b64	9d68dae3-0851-4277-a7d5-ab997758a10d
38	38	0	Plazi	ffb07bec-2d10-492d-9c37-361fe0b79427	9d896584-022d-4f21-a211-c23b533953ce
404	404	0	GBIF Brazil	cdc9736d-5ff7-4ece-9959-3c744360cdb3	9e0936f9-8902-4a4b-8f32-a3e3b038993d
1569	1569	0	GBIF Germany	4f6826f2-4ff6-443d-b966-e6913bd24013	9e516a11-2dfa-49de-8ec4-364c3087b6e1
0	4	4	Plazi	ffb07bec-2d10-492d-9c37-361fe0b79427	a0723a89-d4df-4e36-9da9-cc6fd438c7c3
39	39	0	Plazi	ffb07bec-2d10-492d-9c37-361fe0b79427	a169fa80-80f0-4792-8a01-69b3bac059db
26551	26840	289	Participant Node Managers Committee	7f48e0c8-5c96-49ec-b972-30748e339115	a5f69bb0-d405-451b-a249-178482c01fa6
794	794	0	National Biodiversity Network	d897a5b9-35ee-4232-94bd-b0bcaac003c2	a82a4dec-5dd1-4615-b582-3d923805c0bd
0	33	33	Plazi	ffb07bec-2d10-492d-9c37-361fe0b79427	a8d78d49-efac-4c4a-b81f-bec54827995d
0	12419	12419	GBIF Norway	4f829580-180d-46a9-9c87-ed8ec959b545	ac2573cc-6fdb-4f2f-b670-928ab3864c91
5	5	0	Plazi	ffb07bec-2d10-492d-9c37-361fe0b79427	af2ba010-3b23-4b91-8e35-dfeadcb442cf
29	29	0	GBIF France	da44cd31-5901-4687-a106-6d1c7734ee3a	b0d2e757-553c-47f8-af56-1496e97938ba
23	23	0	Secretariat of the Pacific Regional Environment Programme	29c6a139-ea7f-41f5-8d9b-c55af8736182	b31968fe-1f9a-4da5-ac09-8a892fd0a6c1
1	1	0	GBIF Argentina	2426a871-9feb-40a1-96c6-0c593a76b835	b4b346fb-73bb-42c3-aaa7-f9ef878d98b2
1474	1474	0	Colombian Biodiversity Information System	7e865cba-7c46-417b-ade5-97f2cf5b7be0	b4df93fb-b9b2-49f0-bffb-515e7e0150f9
0	838	838	Ocean Biodiversity Information System	ba0670b9-4186-41e6-8e70-f9cb3065551a	b5f929d7-02d8-4de7-8a23-b9917c0e3e63
498	498	0	GBIF France	da44cd31-5901-4687-a106-6d1c7734ee3a	b6f360a8-e74e-49ac-a862-46d8d78b7d10
16	16	0	GBIF Nigeria	6529bcb5-a542-4fda-be87-54a624515335	b74dbf66-15bf-456c-a288-21aa269200e2
0	13	13	Plazi	ffb07bec-2d10-492d-9c37-361fe0b79427	b8d825ca-bd8d-4329-8ab9-cf1026cb9ccd
39678	39678	0	Participant Node Managers Committee	7f48e0c8-5c96-49ec-b972-30748e339115	b941d3d1-964e-47dc-a3e7-f8edb144e051
4	4	0	Plazi	ffb07bec-2d10-492d-9c37-361fe0b79427	baa14d01-12ec-4972-bf68-6acc6e608776
31	31	0	GBIF France	da44cd31-5901-4687-a106-6d1c7734ee3a	bcce78df-3a24-4807-bf8b-9fe1513e7859
19	19	0	GBIF Argentina	2426a871-9feb-40a1-96c6-0c593a76b835	c3232f5f-cde3-4347-b5cc-b59f36c9d558
3074	3074	0	GBIF France	da44cd31-5901-4687-a106-6d1c7734ee3a	c4f4f71a-568f-49c6-bd3f-c96902772bf3
220	220	0	GBIF France	da44cd31-5901-4687-a106-6d1c7734ee3a	c7655328-32d1-42db-b427-0e706646c6c3
0	14476	14476	GBIF Finland	dd514216-5c7c-45f3-910d-797424cb5be6	c8916e4d-cfa0-41e1-81d1-fa35f49d5b1e
1238	1238	0	GBIF France	da44cd31-5901-4687-a106-6d1c7734ee3a	cc1d5013-b936-4995-8827-bc52e016c82d
16	16	0	Atlas of Living Australia	4a6f1b71-969e-4fc5-a693-282b05e1220c	ccf7853b-477b-47cf-ab2a-cb5cc2ac92c2
2502	2533	31	U.S. Geological Survey	8618c64a-93e0-4300-b546-7249e5148ed2	d30a4b74-968b-492c-aee8-7b79141a2b67
0	8	8	Plazi	ffb07bec-2d10-492d-9c37-361fe0b79427	d44cea23-cf29-4e99-b971-7b36ea9ce911
27476	27476	0	GBIF Spain	1f94b3ca-9345-4d65-afe2-4bace93aa0fe	d7c78847-d662-44c4-a550-5a812dbcc71b
460	460	0	Plazi	ffb07bec-2d10-492d-9c37-361fe0b79427	d8cc2cd8-8410-49aa-a75d-7a41d9f52b26
0	18	18	Ocean Biodiversity Information System	ba0670b9-4186-41e6-8e70-f9cb3065551a	d9c73d92-b06b-4d64-9ae9-986d6b3b9136
35	35	0	U.S. Geological Survey	8618c64a-93e0-4300-b546-7249e5148ed2	db89acb0-b372-4f3d-9ba6-3ab8124a3214
14	14	0	Plazi	ffb07bec-2d10-492d-9c37-361fe0b79427	dc89386b-3791-4ac2-948a-73f69552b3a9
2653	2653	0	Plazi	ffb07bec-2d10-492d-9c37-361fe0b79427	dc899af5-61be-4478-805d-c4b1a04fbb06
31066	32141	1075	GBIF Brazil	cdc9736d-5ff7-4ece-9959-3c744360cdb3	dd31ac22-63d4-4bb4-a987-5eece5ffadb8
54	54	0	Plazi	ffb07bec-2d10-492d-9c37-361fe0b79427	de1023ad-4a41-469d-b170-b8438039936d
77	77	0	Plazi	ffb07bec-2d10-492d-9c37-361fe0b79427	dfca4816-9e5a-4629-a619-fe33b2324079
1098	1098	0	GBIF France	da44cd31-5901-4687-a106-6d1c7734ee3a	e30b2ef2-8923-4682-8f1c-1cf41a459f68
30687	30687	0	National Biodiversity Network	d897a5b9-35ee-4232-94bd-b0bcaac003c2	e3c6d758-9ace-4a08-954f-1aee6c7d2812
0	27	27	Plazi	ffb07bec-2d10-492d-9c37-361fe0b79427	e42658a2-0e15-4e90-9bc5-0d00cbcbd781
398	398	0	Biodiversity Information System of Mexico	b324e8e9-9a4c-44fa-8f1a-7f39ea7ab576	e481c1a2-9182-4e45-a960-7acea13796df
57	57	0	Participant Node Managers Committee	7f48e0c8-5c96-49ec-b972-30748e339115	e9ea0fc7-1924-4bda-a9ea-b3a5a6930ecf
26042	26042	0	GBIF Sweden	a0b3be64-6525-4387-ac67-a499950f92e1	ea05dcbd-0d05-4785-9313-0ec68cb90426
17	17	0	Plazi	ffb07bec-2d10-492d-9c37-361fe0b79427	eaf719d1-9816-489b-90d9-ee4927fec2c6
0	421	421	Colombian Biodiversity Information System	7e865cba-7c46-417b-ade5-97f2cf5b7be0	ec5e03d4-154c-4785-b916-00d7e3f23d98
288	288	0	National Biodiversity Network	d897a5b9-35ee-4232-94bd-b0bcaac003c2	ecefdd0d-2ea6-4d51-a811-a8cb1da4db35
84076	87487	3411	U.S. Geological Survey	8618c64a-93e0-4300-b546-7249e5148ed2	ee4d0706-38af-4bc4-8539-e17c0ca8512e
3	3	0	Plazi	ffb07bec-2d10-492d-9c37-361fe0b79427	f1ce836a-8a7a-4c9d-8983-c8685228313e
0	3896	3896	GBIF Japan	db5705aa-6a6e-42f1-8942-d77b9f4896ea	f3bfae2e-ae07-4e06-86e2-3fcb7dea8c4f
1143	1143	0	GBIF Sweden	a0b3be64-6525-4387-ac67-a499950f92e1	f548a0b0-4473-41aa-b651-0e639f52a4d4
0	7	7	Plazi	ffb07bec-2d10-492d-9c37-361fe0b79427	f803b392-deaa-4f64-a46d-0ad5ada9ee5d
42	42	0	Plazi	ffb07bec-2d10-492d-9c37-361fe0b79427	f87e626f-9755-419d-b75e-d5275fb50872
0	1	1	Plazi	ffb07bec-2d10-492d-9c37-361fe0b79427	f9570c52-f8b6-41ec-8921-8bdd75c71ba8
6762	6762	0	GBIF Benin	efb9c00e-f802-45dd-8826-a52ec45b89ff	f9eb2f96-4962-4b05-b56c-accf68160734
3184	3184	0	GBIF France	da44cd31-5901-4687-a106-6d1c7734ee3a	fc976aa9-e137-446a-bad6-0999331fcd58
10	10	0	Plazi	ffb07bec-2d10-492d-9c37-361fe0b79427	fd6cd3a0-d4bb-482b-bdde-c41fb1836faf
11	11	0	Plazi	ffb07bec-2d10-492d-9c37-361fe0b79427	fe76f860-39b1-4520-a13c-d01a47dfc130
24	24	0	Participant Node Managers Committee	7f48e0c8-5c96-49ec-b972-30748e339115	fea6b5c8-64bc-4fb9-8c36-bb4088f99e37
11	11	0	Plazi	ffb07bec-2d10-492d-9c37-361fe0b79427	00788319-7617-4668-abae-f5359ea67afc
0	368	368	National Biodiversity Network	d897a5b9-35ee-4232-94bd-b0bcaac003c2	00b0fd1b-bfa7-4b77-8e3c-c6f599d426e8
37	37	0	Plazi	ffb07bec-2d10-492d-9c37-361fe0b79427	046b564d-0d89-43ea-83c7-9544dcf05225
216	231	15	GBIF Japan	db5705aa-6a6e-42f1-8942-d77b9f4896ea	05841fe7-d8f6-418f-ba1b-3091128d8ab6
108	108	0	GBIF France	da44cd31-5901-4687-a106-6d1c7734ee3a	07591054-7866-4601-96cb-672c19007c03
24054	24054	0	GBIF France	da44cd31-5901-4687-a106-6d1c7734ee3a	094d437c-6453-488c-803d-7fc243d9d730
12371	12371	0	GBIF Finland	dd514216-5c7c-45f3-910d-797424cb5be6	0c7bd9e3-ded7-4de4-99ec-d5145361ff48
37	37	0	Plazi	ffb07bec-2d10-492d-9c37-361fe0b79427	0e835bd9-b158-4858-a55a-fc5a32cdfe68
30	30	0	Participant Node Managers Committee	7f48e0c8-5c96-49ec-b972-30748e339115	0fb60850-97c7-403c-8293-4efd6ac981c4
0	10	10	Plazi	ffb07bec-2d10-492d-9c37-361fe0b79427	10b7a318-909b-404a-ab8a-d20f5de41fc4
0	6	6	Plazi	ffb07bec-2d10-492d-9c37-361fe0b79427	14130de3-73f2-4b0e-bf78-ad3f951eb67b
0	39	39	Plazi	ffb07bec-2d10-492d-9c37-361fe0b79427	14311353-903e-43c6-9626-e97a0d9952de
7	7	0	Plazi	ffb07bec-2d10-492d-9c37-361fe0b79427	14c8d39a-8380-441f-a1ca-55bce9a09205
69	69	0	GBIF France	da44cd31-5901-4687-a106-6d1c7734ee3a	15dc2440-b972-4dba-a308-8c3d8bc03536
0	12	12	Plazi	ffb07bec-2d10-492d-9c37-361fe0b79427	1895a345-ec36-4ee6-b6cf-8fc099079c7b
731045	731045	0	Ocean Biodiversity Information System	ba0670b9-4186-41e6-8e70-f9cb3065551a	197908d0-5565-11d8-b290-b8a03c50a862
0	1490	1490	GBIF Japan	db5705aa-6a6e-42f1-8942-d77b9f4896ea	1b85fb99-3130-4ebb-8b08-2da79bceaebf
135	135	0	GBIF France	da44cd31-5901-4687-a106-6d1c7734ee3a	1ce35dd2-8a22-4232-b421-8e22741b42a2
0	6	6	Plazi	ffb07bec-2d10-492d-9c37-361fe0b79427	1fa85303-0aed-47b8-87f4-d5d10170ce3e
77075	77075	0	CABI Bioscience	ed988a18-81f8-4d5f-a88d-f93ef592b2f2	23ec2d04-c0eb-4ca4-afb8-a8710e38f641
21	21	0	GBIF Finland	dd514216-5c7c-45f3-910d-797424cb5be6	29a14f49-991f-4b56-861d-2c2129d305b6
1930	1930	0	U.S. Geological Survey	8618c64a-93e0-4300-b546-7249e5148ed2	2b169d34-2946-40e4-8af1-13adce9c745b
0	74	74	Plazi	ffb07bec-2d10-492d-9c37-361fe0b79427	2d86f0e3-df0c-46a8-9c7e-4a1b11b109a5
3	3	0	Plazi	ffb07bec-2d10-492d-9c37-361fe0b79427	2e1231d8-05e3-4ad7-857b-043a83450b52
21	21	0	GBIF Argentina	2426a871-9feb-40a1-96c6-0c593a76b835	2e4d8d24-a663-4b08-98d2-571db12b50ef
16685	16685	0	Colombian Biodiversity Information System	7e865cba-7c46-417b-ade5-97f2cf5b7be0	3021152d-571e-477e-8b22-e11f9b2e1ca4
0	3	3	Plazi	ffb07bec-2d10-492d-9c37-361fe0b79427	30f218dd-fbc5-44d6-869f-a1ce96cfcc3a
30881	31137	256	GBIF Brazil	cdc9736d-5ff7-4ece-9959-3c744360cdb3	3345dcbc-a43d-4307-9cd8-084cb293d6bb
0	1467	1467	Colombian Biodiversity Information System	7e865cba-7c46-417b-ade5-97f2cf5b7be0	33aa7801-e09f-4dd0-8684-0e98fe53b74d
6098	6098	0	National Biodiversity Network	d897a5b9-35ee-4232-94bd-b0bcaac003c2	3549b36a-c17a-41dc-bdcb-fe348bf0ce5d
30	30	0	Plazi	ffb07bec-2d10-492d-9c37-361fe0b79427	36219e98-ffc6-46c4-86b1-41e0ff4c2215
5153	5153	0	GBIF France	da44cd31-5901-4687-a106-6d1c7734ee3a	38b496a8-65cf-4278-b4f1-3be314bba3af
134	134	0	Canada Biodiversity Information Facility	8f83fc96-c966-4126-83f7-bf044dc49efa	39bd4817-9530-4341-a918-4f16b8db1419
61	61	0	Plazi	ffb07bec-2d10-492d-9c37-361fe0b79427	3e4f6863-677b-478f-89ed-0b7c80ad5006
0	1	1	Plazi	ffb07bec-2d10-492d-9c37-361fe0b79427	3eaf0ab4-3a75-49e7-bf12-693503dac26f
37	37	0	Plazi	ffb07bec-2d10-492d-9c37-361fe0b79427	40eb70db-1cfd-47ea-acc7-f981dfacc4e9
1410	1410	0	National Biodiversity Network	d897a5b9-35ee-4232-94bd-b0bcaac003c2	41d9a07d-e6d5-4128-94ae-1987e802b00d
1	1	0	Plazi	ffb07bec-2d10-492d-9c37-361fe0b79427	433c8642-c66c-4bdd-b5c8-d0174d063ce4
0	41	41	Plazi	ffb07bec-2d10-492d-9c37-361fe0b79427	438fdd44-350b-43e3-8af5-304dfe6ddf09
7	7	0	Plazi	ffb07bec-2d10-492d-9c37-361fe0b79427	4482b4cb-e1f0-48a8-a6e5-b5fda6e93bc9
5740	5740	0	Participant Node Managers Committee	7f48e0c8-5c96-49ec-b972-30748e339115	45ff6ac5-ee78-48dd-997f-3602025bc562
10	10	0	Plazi	ffb07bec-2d10-492d-9c37-361fe0b79427	46e22b3e-eec8-449e-8955-08b79a7eda84
0	3	3	Plazi	ffb07bec-2d10-492d-9c37-361fe0b79427	48775238-9811-457d-aa74-e432bebc8b71
16	16	0	Plazi	ffb07bec-2d10-492d-9c37-361fe0b79427	4c159766-bd49-4b1d-ad9b-6df2bc938403
3	3	0	Colombian Biodiversity Information System	7e865cba-7c46-417b-ade5-97f2cf5b7be0	4c9be7ad-5e3c-47af-a69e-fae1513530ea
14	14	0	Plazi	ffb07bec-2d10-492d-9c37-361fe0b79427	53275514-8714-4764-bb63-7787b41e0526
0	510	510	National Biodiversity Network	d897a5b9-35ee-4232-94bd-b0bcaac003c2	55496782-b8ea-4b4e-9215-abf93ac67f3a
104	104	0	Plazi	ffb07bec-2d10-492d-9c37-361fe0b79427	55f509e1-126e-4287-9d18-15a58208e041
0	382	382	Plazi	ffb07bec-2d10-492d-9c37-361fe0b79427	57505acd-5459-4749-925c-cf6cbaefda51
5	5	0	Participant Node Managers Committee	7f48e0c8-5c96-49ec-b972-30748e339115	580f0e0f-f68f-40a5-969c-d4881f9d7105
10	10	0	Plazi	ffb07bec-2d10-492d-9c37-361fe0b79427	5916de8a-06db-4553-8a2e-9bace15543c4
0	68	68	Colombian Biodiversity Information System	7e865cba-7c46-417b-ade5-97f2cf5b7be0	59514b30-b5f5-4a5a-b066-84d11041a24a
0	4	4	Ocean Biodiversity Information System	ba0670b9-4186-41e6-8e70-f9cb3065551a	59f88c20-3741-4ffd-a105-360bd04a454c
0	3	3	Ocean Biodiversity Information System	ba0670b9-4186-41e6-8e70-f9cb3065551a	5f4585a5-adcc-477b-b01e-70c25f2a0159
108	108	0	GBIF Germany	4f6826f2-4ff6-443d-b966-e6913bd24013	611b8b9c-f762-11e1-a439-00145eb45e9a
20	20	0	GBIF Germany	4f6826f2-4ff6-443d-b966-e6913bd24013	624abb64-f762-11e1-a439-00145eb45e9a
24	24	0	GBIF Germany	4f6826f2-4ff6-443d-b966-e6913bd24013	62d1111e-f762-11e1-a439-00145eb45e9a
2	2	0	Plazi	ffb07bec-2d10-492d-9c37-361fe0b79427	62dbc20f-9d4a-49c5-9269-3c9a4e2cea87
6	6	0	GBIF Germany	4f6826f2-4ff6-443d-b966-e6913bd24013	63553156-f762-11e1-a439-00145eb45e9a
89	89	0	GBIF Germany	4f6826f2-4ff6-443d-b966-e6913bd24013	6449a18c-f762-11e1-a439-00145eb45e9a
1670	1670	0	GBIF Germany	4f6826f2-4ff6-443d-b966-e6913bd24013	64533d00-24e3-4bc2-bfb2-f52f21e568fe
7	7	0	Plazi	ffb07bec-2d10-492d-9c37-361fe0b79427	6477b295-7e5f-4aac-9fac-fd04ebb26e71
0	229	229	Participant Node Managers Committee	7f48e0c8-5c96-49ec-b972-30748e339115	64981a03-1056-4add-b78c-84dda4f8efa9
51	51	0	GBIF Germany	4f6826f2-4ff6-443d-b966-e6913bd24013	6498eb48-f762-11e1-a439-00145eb45e9a
735	861	126	Belgian Biodiversity Platform	fb11cfe1-ebc3-45af-9159-17d9fddbcdac	64d7725a-4743-461a-ac17-956bffef577b
0	669	669	Ocean Biodiversity Information System	ba0670b9-4186-41e6-8e70-f9cb3065551a	659de609-48a7-4d14-b65b-5940f261553c
138	138	0	GBIF Germany	4f6826f2-4ff6-443d-b966-e6913bd24013	665980a0-f762-11e1-a439-00145eb45e9a
44	44	0	GBIF Germany	4f6826f2-4ff6-443d-b966-e6913bd24013	667f25f8-f762-11e1-a439-00145eb45e9a
111	111	0	GBIF Germany	4f6826f2-4ff6-443d-b966-e6913bd24013	68a627c8-f762-11e1-a439-00145eb45e9a
257	257	0	GBIF Germany	4f6826f2-4ff6-443d-b966-e6913bd24013	68c0e8b0-f762-11e1-a439-00145eb45e9a
1	1	0	Plazi	ffb07bec-2d10-492d-9c37-361fe0b79427	6b27f85c-8d1b-4a8e-9715-abe8d9ddfc47
62149	62149	0	GBIF France	da44cd31-5901-4687-a106-6d1c7734ee3a	6cbf7d4d-13cb-4604-8668-db68fe753349
94	94	0	GBIF Germany	4f6826f2-4ff6-443d-b966-e6913bd24013	6d624896-f762-11e1-a439-00145eb45e9a
2176	1943	-233	GBIF Germany	4f6826f2-4ff6-443d-b966-e6913bd24013	6f7796cc-f762-11e1-a439-00145eb45e9a
9	9	0	GBIF Germany	4f6826f2-4ff6-443d-b966-e6913bd24013	6fd75bde-f762-11e1-a439-00145eb45e9a
21	21	0	GBIF Germany	4f6826f2-4ff6-443d-b966-e6913bd24013	6fe99e66-f762-11e1-a439-00145eb45e9a
263	263	0	GBIF Germany	4f6826f2-4ff6-443d-b966-e6913bd24013	711c0a62-f762-11e1-a439-00145eb45e9a
8	8	0	GBIF Germany	4f6826f2-4ff6-443d-b966-e6913bd24013	715bdf8e-f762-11e1-a439-00145eb45e9a
35	35	0	GBIF Germany	4f6826f2-4ff6-443d-b966-e6913bd24013	72a47e3c-f762-11e1-a439-00145eb45e9a
998	998	0	GBIF France	da44cd31-5901-4687-a106-6d1c7734ee3a	72e4c986-88c9-4ce2-a805-c4fcfda92675
6	6	0	GBIF Germany	4f6826f2-4ff6-443d-b966-e6913bd24013	7363f67f-c7b3-4b66-9b8e-5bec53aa01be
15	15	0	GBIF Germany	4f6826f2-4ff6-443d-b966-e6913bd24013	73867526-f762-11e1-a439-00145eb45e9a
19821	19821	0	GBIF Brazil	cdc9736d-5ff7-4ece-9959-3c744360cdb3	73f644a4-9079-45f4-bb61-512692a09035
105	105	0	GBIF Germany	4f6826f2-4ff6-443d-b966-e6913bd24013	7416a556-f762-11e1-a439-00145eb45e9a
407	407	0	GBIF Germany	4f6826f2-4ff6-443d-b966-e6913bd24013	7488331a-f762-11e1-a439-00145eb45e9a
371	371	0	GBIF Germany	4f6826f2-4ff6-443d-b966-e6913bd24013	7593f24e-f762-11e1-a439-00145eb45e9a
395	395	0	GBIF Germany	4f6826f2-4ff6-443d-b966-e6913bd24013	75a260ae-f762-11e1-a439-00145eb45e9a
2	2	0	Plazi	ffb07bec-2d10-492d-9c37-361fe0b79427	75ae9ac4-d938-4b28-beef-4f81b9352b7f
3209	3093	-116	Participant Node Managers Committee	7f48e0c8-5c96-49ec-b972-30748e339115	769dbaf7-8238-43fa-9717-90973e41706d
284	284	0	GBIF Germany	4f6826f2-4ff6-443d-b966-e6913bd24013	774f348e-0fe7-4c00-aba2-1182e5f17341
0	13	13	Plazi	ffb07bec-2d10-492d-9c37-361fe0b79427	77f3d696-515b-4dc0-a87a-597a68cf4df8
436	436	0	GBIF Germany	4f6826f2-4ff6-443d-b966-e6913bd24013	79fd32aa-f762-11e1-a439-00145eb45e9a
1862	882	-980	GBIF Germany	4f6826f2-4ff6-443d-b966-e6913bd24013	7a0e11ec-f762-11e1-a439-00145eb45e9a
0	31	31	Plazi	ffb07bec-2d10-492d-9c37-361fe0b79427	7a142b15-7034-45cc-a16e-8738702de386
0	20	20	Plazi	ffb07bec-2d10-492d-9c37-361fe0b79427	7b87d5eb-e754-418f-8673-363bc07712b3
0	4088	4088	GBIF Japan	db5705aa-6a6e-42f1-8942-d77b9f4896ea	7c37ad72-58d0-464f-a774-b72ece86af8f
1248	1152	-96	GBIF Germany	4f6826f2-4ff6-443d-b966-e6913bd24013	7c5c7ed4-f762-11e1-a439-00145eb45e9a
1280	1280	0	GBIF Germany	4f6826f2-4ff6-443d-b966-e6913bd24013	7c7345f6-f762-11e1-a439-00145eb45e9a
122	122	0	GBIF Germany	4f6826f2-4ff6-443d-b966-e6913bd24013	7d2e8b36-f762-11e1-a439-00145eb45e9a
744	744	0	GBIF Germany	4f6826f2-4ff6-443d-b966-e6913bd24013	7d786544-f762-11e1-a439-00145eb45e9a
826	826	0	GBIF Germany	4f6826f2-4ff6-443d-b966-e6913bd24013	7d94a8c6-f762-11e1-a439-00145eb45e9a
3	3	0	Plazi	ffb07bec-2d10-492d-9c37-361fe0b79427	7e02f4d6-73bc-458f-8066-8d2c08e2d8d4
483	238	-245	GBIF Germany	4f6826f2-4ff6-443d-b966-e6913bd24013	7e17d4da-f762-11e1-a439-00145eb45e9a
1	1	0	Plazi	ffb07bec-2d10-492d-9c37-361fe0b79427	7f981c83-5319-4b96-aba1-78188cb05e09
11	11	0	Plazi	ffb07bec-2d10-492d-9c37-361fe0b79427	809d331f-3909-4989-858e-4071180345f3
3490	3490	0	Biodiversity Information System of Mexico	b324e8e9-9a4c-44fa-8f1a-7f39ea7ab576	80a24726-f762-11e1-a439-00145eb45e9a
2990	1794	-1196	GBIF Germany	4f6826f2-4ff6-443d-b966-e6913bd24013	81e1b400-f762-11e1-a439-00145eb45e9a
10850	10850	0	GBIF Germany	4f6826f2-4ff6-443d-b966-e6913bd24013	8278e7bc-f762-11e1-a439-00145eb45e9a
803	803	0	GBIF France	da44cd31-5901-4687-a106-6d1c7734ee3a	83306167-fce2-4b6d-97a6-93c3ad83fb38
2867	2867	0	GBIF Germany	4f6826f2-4ff6-443d-b966-e6913bd24013	857e1bda-f762-11e1-a439-00145eb45e9a
73	73	0	GBIF Germany	4f6826f2-4ff6-443d-b966-e6913bd24013	85d4fb26-f762-11e1-a439-00145eb45e9a
435	337	-98	GBIF Germany	4f6826f2-4ff6-443d-b966-e6913bd24013	86ca5120-f762-11e1-a439-00145eb45e9a
0	4	4	Plazi	ffb07bec-2d10-492d-9c37-361fe0b79427	86ed8044-eb08-4ea8-9938-4e634508ed15
73	73	0	GBIF Germany	4f6826f2-4ff6-443d-b966-e6913bd24013	8a31845a-f762-11e1-a439-00145eb45e9a
153	153	0	GBIF Germany	4f6826f2-4ff6-443d-b966-e6913bd24013	8f3fabd4-f762-11e1-a439-00145eb45e9a
121	98	-23	GBIF Germany	4f6826f2-4ff6-443d-b966-e6913bd24013	8fe0857c-f762-11e1-a439-00145eb45e9a
38	34	-4	GBIF Germany	4f6826f2-4ff6-443d-b966-e6913bd24013	900a0348-f762-11e1-a439-00145eb45e9a
1	1	0	GBIF Germany	4f6826f2-4ff6-443d-b966-e6913bd24013	900f3e4e-f762-11e1-a439-00145eb45e9a
35	35	0	GBIF Germany	4f6826f2-4ff6-443d-b966-e6913bd24013	923bcf2a-f762-11e1-a439-00145eb45e9a
471	471	0	GBIF Germany	4f6826f2-4ff6-443d-b966-e6913bd24013	924fd786-f762-11e1-a439-00145eb45e9a
16	16	0	GBIF Germany	4f6826f2-4ff6-443d-b966-e6913bd24013	927a7aae-f762-11e1-a439-00145eb45e9a
1492	1492	0	GBIF Germany	4f6826f2-4ff6-443d-b966-e6913bd24013	929a5770-f762-11e1-a439-00145eb45e9a
11	11	0	GBIF Germany	4f6826f2-4ff6-443d-b966-e6913bd24013	9681f186-f762-11e1-a439-00145eb45e9a
29	29	0	GBIF Germany	4f6826f2-4ff6-443d-b966-e6913bd24013	977e9daa-f762-11e1-a439-00145eb45e9a
0	31	31	Plazi	ffb07bec-2d10-492d-9c37-361fe0b79427	98c822f2-5db7-486c-94fe-931b3026215f
0	11	11	Plazi	ffb07bec-2d10-492d-9c37-361fe0b79427	9939831f-0d89-4ac3-bfac-969f077d3f33
999976	999976	0	Korean Biodiversity Information Facility	e0a1e772-0177-4800-94b4-2d023fe6cdf4	9aa00786-772a-46d4-8fe1-ac6d8926a040
125	125	0	Plazi	ffb07bec-2d10-492d-9c37-361fe0b79427	a1540ced-2e09-452a-bd37-aee70242bf23
12	12	0	GBIF France	da44cd31-5901-4687-a106-6d1c7734ee3a	a3ce8676-0ae0-42e5-8588-ab90fb34cf05
8	8	0	Plazi	ffb07bec-2d10-492d-9c37-361fe0b79427	a48873e8-584d-425c-8da0-bccbefc6388f
3780	3780	0	Biodiversity Information System of Mexico	b324e8e9-9a4c-44fa-8f1a-7f39ea7ab576	a4edfc8b-ab0e-4427-aecd-897d2a0b9925
0	1	1	Plazi	ffb07bec-2d10-492d-9c37-361fe0b79427	a7e11d82-798f-44ac-b548-dd4abba61b61
48	48	0	Plazi	ffb07bec-2d10-492d-9c37-361fe0b79427	a9edfada-4b67-44f9-8b4f-4ea85407ce13
131248	131248	0	GBIF France	da44cd31-5901-4687-a106-6d1c7734ee3a	a9f7dd79-e368-46be-a774-a9eabf2d191a
8	8	0	Plazi	ffb07bec-2d10-492d-9c37-361fe0b79427	ac6c5561-2f3e-44da-95a5-78de88071a59
18	18	0	Plazi	ffb07bec-2d10-492d-9c37-361fe0b79427	acda171b-0c57-48c9-bdca-267401896058
293	293	0	Colombian Biodiversity Information System	7e865cba-7c46-417b-ade5-97f2cf5b7be0	b019c833-0b1a-4658-a27e-80b46bf4aa06
0	2	2	Plazi	ffb07bec-2d10-492d-9c37-361fe0b79427	b04dfc27-81c7-4ace-a568-4c8eebdc1e9a
4617	4617	0	GBIF France	da44cd31-5901-4687-a106-6d1c7734ee3a	b3d38408-1b69-48e3-8bff-de7929e0e5e7
400	400	0	GBIF Germany	4f6826f2-4ff6-443d-b966-e6913bd24013	b516bc56-ff41-418e-9a19-3e4b00418651
696	696	0	Atlas of Living Australia	4a6f1b71-969e-4fc5-a693-282b05e1220c	b5e6a82a-7781-497b-b2aa-118b8890c3fa
9	9	0	Plazi	ffb07bec-2d10-492d-9c37-361fe0b79427	b655a33e-8944-4d0b-bc72-87d62f5c2c78
151	151	0	U.S. Geological Survey	8618c64a-93e0-4300-b546-7249e5148ed2	b69797e5-bb99-41fe-8462-00b92d68e2fb
1776041	1796902	20861	Belgian Biodiversity Platform	fb11cfe1-ebc3-45af-9159-17d9fddbcdac	b740eaa0-0679-41dc-acb7-990d562dfa37
131	131	0	GBIF France	da44cd31-5901-4687-a106-6d1c7734ee3a	b7a75ad6-288d-47aa-8580-9705ce034229
44	44	0	Plazi	ffb07bec-2d10-492d-9c37-361fe0b79427	b7db7bbf-f5d4-4fc8-b013-8c35b57a0e21
526	526	0	GBIF Germany	4f6826f2-4ff6-443d-b966-e6913bd24013	b8372c89-eedb-466c-80eb-7276a966a1fb
7	7	0	Plazi	ffb07bec-2d10-492d-9c37-361fe0b79427	b8b27a8e-4e3a-4861-b208-5fdf59ecde37
7	7	0	Plazi	ffb07bec-2d10-492d-9c37-361fe0b79427	b959fa5d-ad5b-4f35-b98f-95761b3e2794
6	6	0	Plazi	ffb07bec-2d10-492d-9c37-361fe0b79427	b9e09984-ea64-4dcf-aa00-0a42ea8b6e90
141	141	0	Colombian Biodiversity Information System	7e865cba-7c46-417b-ade5-97f2cf5b7be0	bbed2cf3-bc30-41a8-9a39-3a0494f5c25a
3131	3131	0	GBIF France	da44cd31-5901-4687-a106-6d1c7734ee3a	bdfcaacc-c50a-4d6b-a87f-912460721816
0	1855892	1855892	GBIF Austria	1e789bc9-79fc-4e60-a49e-89dfc45a7188	c1492854-5d15-40e9-9ee7-24a18ac05112
0	1	1	Ocean Biodiversity Information System	ba0670b9-4186-41e6-8e70-f9cb3065551a	c3066561-736b-4473-b85a-91cf5d29165e
7474	7474	0	Canada Biodiversity Information Facility	8f83fc96-c966-4126-83f7-bf044dc49efa	cd4cd181-ae56-4595-8c80-d4311654ad03
12757	12757	0	GBIF Brazil	cdc9736d-5ff7-4ece-9959-3c744360cdb3	cd78a5fd-fa3b-41a4-b298-77ad3a6a821f
0	6435	6435	National Biodiversity Network	d897a5b9-35ee-4232-94bd-b0bcaac003c2	cf8107e1-68be-4c76-a71d-05d96aeea4cb
0	66	66	Plazi	ffb07bec-2d10-492d-9c37-361fe0b79427	d009621e-c55f-446b-a518-2cf32929b517
2097	2097	0	GBIF Norway	4f829580-180d-46a9-9c87-ed8ec959b545	d062e651-c3e6-4e6c-9544-8d573df5af30
0	985	985	U.S. Geological Survey	8618c64a-93e0-4300-b546-7249e5148ed2	d156cb49-ba5d-45fc-898e-3de6002d2efd
51	51	0	Plazi	ffb07bec-2d10-492d-9c37-361fe0b79427	d37f4c45-3df2-4c16-82f2-28cc595d38dc
2	2	0	Participant Node Managers Committee	7f48e0c8-5c96-49ec-b972-30748e339115	d40582a1-29fb-4628-acb8-95f5e6d309a9
1	1	0	Plazi	ffb07bec-2d10-492d-9c37-361fe0b79427	d8fa24c0-15e3-44e4-bf5f-0ca23a5eb9d1
0	99	99	Colombian Biodiversity Information System	7e865cba-7c46-417b-ade5-97f2cf5b7be0	d991d84a-c5b9-4810-a72a-d39ff4306094
997	997	0	Ocean Biodiversity Information System	ba0670b9-4186-41e6-8e70-f9cb3065551a	da2f316a-7329-4115-89d9-825f8125963b
0	20	20	Plazi	ffb07bec-2d10-492d-9c37-361fe0b79427	dbf16487-bba8-47bb-8fd9-faa1d49876a3
2227	2227	0	National Biodiversity Network	d897a5b9-35ee-4232-94bd-b0bcaac003c2	debc1994-2b92-4b92-8183-a2664f0f5c30
1	1	0	Plazi	ffb07bec-2d10-492d-9c37-361fe0b79427	dfd78f7c-45a8-4ece-afab-f35927d22d6d
16599	16651	52	Canada Biodiversity Information Facility	8f83fc96-c966-4126-83f7-bf044dc49efa	e0fa07ae-74d9-44b1-8e05-5785482ccad2
0	5	5	Participant Node Managers Committee	7f48e0c8-5c96-49ec-b972-30748e339115	e2c85b10-5d84-4417-971a-07912f07ac30
94	94	0	Plazi	ffb07bec-2d10-492d-9c37-361fe0b79427	e30650b4-4b5d-4031-8f07-e57668e07101
5042	5042	0	GBIF Japan	db5705aa-6a6e-42f1-8942-d77b9f4896ea	e33a016a-1f64-11e2-9d9f-00145eb45e9a
0	36	36	Plazi	ffb07bec-2d10-492d-9c37-361fe0b79427	e3694a73-fa16-4efe-8135-7bbae6899758
3	3	0	Plazi	ffb07bec-2d10-492d-9c37-361fe0b79427	e38df9e9-36a9-4eb9-b5ec-38f513cd65af
83	83	0	Plazi	ffb07bec-2d10-492d-9c37-361fe0b79427	e6b25548-6721-4e1e-a68e-663c949b3306
274	274	0	GBIF France	da44cd31-5901-4687-a106-6d1c7734ee3a	e71a269d-929b-4bd2-a437-39f1d4fe8068
8	8	0	GBIF France	da44cd31-5901-4687-a106-6d1c7734ee3a	e76fcd2a-6939-4552-abb8-db2b784f002e
0	1671	1671	Colombian Biodiversity Information System	7e865cba-7c46-417b-ade5-97f2cf5b7be0	e961d627-db44-4fbd-b9d4-dc150c20dcec
0	560714	560714	GBIF Portugal	673f7038-4262-4149-b753-5658a4e912f6	eb97768a-339d-4c1b-bff8-a87e7e016a6d
0	13	13	Plazi	ffb07bec-2d10-492d-9c37-361fe0b79427	ec3cc3fc-768c-465c-a837-5845683f3514
2123	2123	0	Biodiversity Information System of Mexico	b324e8e9-9a4c-44fa-8f1a-7f39ea7ab576	f17d68da-83d0-4306-b555-cc7e6589d718
0	5	5	Plazi	ffb07bec-2d10-492d-9c37-361fe0b79427	f4503f82-7db6-4643-9ce1-d9887ad359ca
4693	4693	0	GBIF Brazil	cdc9736d-5ff7-4ece-9959-3c744360cdb3	f4abda55-c342-491f-8898-23876751deef
0	226771	226771	Canada Biodiversity Information Facility	8f83fc96-c966-4126-83f7-bf044dc49efa	f61e70a4-7172-4d9e-acfc-8034cd651b9c
58	58	0	GBIF Sweden	a0b3be64-6525-4387-ac67-a499950f92e1	f669bf13-3f4c-44d1-83c7-74e3ce35d6c3
0	46	46	Plazi	ffb07bec-2d10-492d-9c37-361fe0b79427	f76e17a3-3bc3-43a8-ae33-6655aba3fa57
2	2	0	Plazi	ffb07bec-2d10-492d-9c37-361fe0b79427	f7e1e710-872d-443b-9322-dc2b2be76cbe
1	1	0	Plazi	ffb07bec-2d10-492d-9c37-361fe0b79427	fa265e39-63ed-499c-b7d4-c6f60585abb3
2	2	0	Plazi	ffb07bec-2d10-492d-9c37-361fe0b79427	fb6afd52-f718-42ab-9d0c-4042968d0471
0	45110	45110	Ocean Biodiversity Information System	ba0670b9-4186-41e6-8e70-f9cb3065551a	fcd286f9-7e0f-4584-81dd-b50e932fecc7
36	36	0	Plazi	ffb07bec-2d10-492d-9c37-361fe0b79427	00657993-6208-44fe-bc00-f6c6350c8c11
2	2	0	Plazi	ffb07bec-2d10-492d-9c37-361fe0b79427	04415c8a-194f-4aba-b3f7-eec0161010bb
2	2	0	Plazi	ffb07bec-2d10-492d-9c37-361fe0b79427	048ec6c6-7d27-40ed-bf59-c32ca24c9700
0	105	105	Plazi	ffb07bec-2d10-492d-9c37-361fe0b79427	065cd936-3e5f-45f8-ac7f-2d530aab8b4e
0	1	1	Plazi	ffb07bec-2d10-492d-9c37-361fe0b79427	0679bb20-5192-433f-b780-45d5c35ab853
99300	99300	0	GBIF Austria	1e789bc9-79fc-4e60-a49e-89dfc45a7188	06d3504c-a3bb-11e2-95b8-00145eb45e9a
0	383	383	Atlas of Living Australia	4a6f1b71-969e-4fc5-a693-282b05e1220c	08345d2c-9536-439e-811a-75bb1c547a90
2115	2148	33	Taiwan Biodiversity Information Facility	e1b85abc-61f9-430f-ba79-6813dec53a0f	0b1c69fb-96de-438b-afe7-24a7a19a7b85
0	1	1	Plazi	ffb07bec-2d10-492d-9c37-361fe0b79427	0c2aa01d-58eb-498b-a278-8b6b4367c1a2
502	502	0	National Biodiversity Network	d897a5b9-35ee-4232-94bd-b0bcaac003c2	0c8b120e-994c-4e31-90c9-7c49444d957d
0	11	11	Plazi	ffb07bec-2d10-492d-9c37-361fe0b79427	0cc8ece0-e085-419a-8d59-278ff7e8571f
0	7	7	Ocean Biodiversity Information System	ba0670b9-4186-41e6-8e70-f9cb3065551a	10895094-5c4e-4402-a5ea-ae4e62bdf69e
191	191	0	Biodiversity Information System of Mexico	b324e8e9-9a4c-44fa-8f1a-7f39ea7ab576	111c1cc2-b10a-456a-835c-1555c784b2c6
39	39	0	Plazi	ffb07bec-2d10-492d-9c37-361fe0b79427	114a9cd5-ae28-4133-a31e-e847c3e4f316
4	4	0	Korean Biodiversity Information Facility	e0a1e772-0177-4800-94b4-2d023fe6cdf4	114f9ce7-981b-4f40-b5a8-c4d3871c2bd1
1154	1154	0	Biodiversity Information System of Mexico	b324e8e9-9a4c-44fa-8f1a-7f39ea7ab576	12c99f46-685a-4e09-8917-e43e0c1fd63a
35278	35278	0	GBIF Finland	dd514216-5c7c-45f3-910d-797424cb5be6	135fe78c-6fbb-4586-8d43-214b503dc593
5722	7487	1765	National Biodiversity Network	d897a5b9-35ee-4232-94bd-b0bcaac003c2	14652c82-e5d1-4c3e-bd3b-0f28e0315e08
0	87	87	Plazi	ffb07bec-2d10-492d-9c37-361fe0b79427	1478a1d3-fcb4-43b3-9418-010043c5c154
0	1520	1520	Ocean Biodiversity Information System	ba0670b9-4186-41e6-8e70-f9cb3065551a	14a3f146-3a3a-42ee-8d70-2cb65cbeae0d
38	38	0	Plazi	ffb07bec-2d10-492d-9c37-361fe0b79427	14cdab6f-399c-4e87-b45f-ab80753a2563
2	2	0	Plazi	ffb07bec-2d10-492d-9c37-361fe0b79427	16f36858-a02e-4fab-9d8b-3cd4f533c713
0	562	562	GBIF Japan	db5705aa-6a6e-42f1-8942-d77b9f4896ea	18b95acb-4ffc-422b-b786-56b6b72e3bf5
2	2	0	Plazi	ffb07bec-2d10-492d-9c37-361fe0b79427	18d1060a-bb56-4396-87d0-c66979d5059f
9	9	0	GBIF France	da44cd31-5901-4687-a106-6d1c7734ee3a	1995be77-aeaf-4622-b2af-ed4839fb2df2
29	29	0	Colombian Biodiversity Information System	7e865cba-7c46-417b-ade5-97f2cf5b7be0	1dd5aff4-0be7-437b-be86-c8fd9ba59b74
0	2	2	Plazi	ffb07bec-2d10-492d-9c37-361fe0b79427	21392a44-7afe-48f7-8b3b-cc394f239ac1
0	2	2	Plazi	ffb07bec-2d10-492d-9c37-361fe0b79427	28435aae-df4f-4343-99c9-4e884124a740
0	11	11	Plazi	ffb07bec-2d10-492d-9c37-361fe0b79427	2aed84ef-e93d-4346-9f1c-1553faba3328
1	1	0	Plazi	ffb07bec-2d10-492d-9c37-361fe0b79427	2d874abb-081f-40a2-a358-3686c451b9b2
217	217	0	Plazi	ffb07bec-2d10-492d-9c37-361fe0b79427	2ddc655a-4aa6-4c08-a093-143dfde6c4f7
35	35	0	Plazi	ffb07bec-2d10-492d-9c37-361fe0b79427	2e0c16cb-bcc4-4c05-bb52-68f336914b43
0	55	55	Colombian Biodiversity Information System	7e865cba-7c46-417b-ade5-97f2cf5b7be0	2ee84c7f-e671-4d6b-81a5-c661dc14bcfb
123	123	0	U.S. Geological Survey	8618c64a-93e0-4300-b546-7249e5148ed2	34059df6-d97a-421e-9ced-24c22875edd8
0	3	3	Plazi	ffb07bec-2d10-492d-9c37-361fe0b79427	37b99e65-4321-4005-bcac-3af6aad0d75a
4129	4129	0	GBIF France	da44cd31-5901-4687-a106-6d1c7734ee3a	3bb78aab-ab42-4841-ac01-3104f8456909
13	13	0	Plazi	ffb07bec-2d10-492d-9c37-361fe0b79427	3ced59f3-6094-4b2c-8f07-6632892a3b74
10895	10895	0	GBIF Norway	4f829580-180d-46a9-9c87-ed8ec959b545	3cf0df27-6416-46a2-ad5e-7d970e5d1a19
1419	1419	0	Colombian Biodiversity Information System	7e865cba-7c46-417b-ade5-97f2cf5b7be0	3dc8c286-9e33-4665-8641-9858af6ba75b
72	72	0	GBIF France	da44cd31-5901-4687-a106-6d1c7734ee3a	3dfdc6aa-a518-40d7-9056-96adc031f793
22	22	0	Plazi	ffb07bec-2d10-492d-9c37-361fe0b79427	47079bb4-a272-483f-98b7-52d33399f3ed
0	2	2	Plazi	ffb07bec-2d10-492d-9c37-361fe0b79427	47ddcc54-06e5-4e2d-8c1e-068f5b521230
0	4	4	Plazi	ffb07bec-2d10-492d-9c37-361fe0b79427	47ede772-a15f-4e97-86dd-d18f91605e7b
9	9	0	Plazi	ffb07bec-2d10-492d-9c37-361fe0b79427	488ad3fa-255d-47be-a255-c56a0f1b7bfc
9982	9982	0	GBIF Portugal	673f7038-4262-4149-b753-5658a4e912f6	4ad65517-2860-4fb2-8a73-82e7df5df45e
9	9	0	Plazi	ffb07bec-2d10-492d-9c37-361fe0b79427	4ebe05f4-f39b-4770-85c2-8de0fcda0cb3
3	3	0	Plazi	ffb07bec-2d10-492d-9c37-361fe0b79427	53232463-edc9-496f-b9bf-12e4bc93871a
6	6	0	Plazi	ffb07bec-2d10-492d-9c37-361fe0b79427	542a4e4b-bb75-4922-a0c1-5aa93fbdaf4d
2355	2355	0	Biodiversity Information System of Mexico	b324e8e9-9a4c-44fa-8f1a-7f39ea7ab576	58a59413-583d-4738-82e0-f26ed12afed3
23	23	0	Plazi	ffb07bec-2d10-492d-9c37-361fe0b79427	5a46a93a-33c7-4ffe-a96b-c6dc309f2e54
2	2	0	Plazi	ffb07bec-2d10-492d-9c37-361fe0b79427	5d9ff5c2-a9c8-4271-8756-e09e3ed9d955
631	631	0	GBIF New Zealand	4f9fd726-20dd-445e-89a1-8ed93792276f	5f02ffba-6104-44a9-9ef0-d4cae2c585f6
220	220	0	GBIF Viet Nam	7f4b5eab-2edf-4b46-9360-d9574ab0f1d7	624da23f-6b49-4201-ab43-e6513cf41c71
352	1451	1099	Participant Node Managers Committee	7f48e0c8-5c96-49ec-b972-30748e339115	624ffcb0-3723-4b6f-9039-eea2e1ef82e2
31	31	0	GBIF Germany	4f6826f2-4ff6-443d-b966-e6913bd24013	62ac7372-f762-11e1-a439-00145eb45e9a
1	1	0	Plazi	ffb07bec-2d10-492d-9c37-361fe0b79427	6311c789-c8f8-4060-b005-b3aa84e407af
41	41	0	GBIF Germany	4f6826f2-4ff6-443d-b966-e6913bd24013	64b65106-f762-11e1-a439-00145eb45e9a
14	14	0	GBIF Germany	4f6826f2-4ff6-443d-b966-e6913bd24013	64d1319c-f762-11e1-a439-00145eb45e9a
187	187	0	GBIF Germany	4f6826f2-4ff6-443d-b966-e6913bd24013	64e284c4-f762-11e1-a439-00145eb45e9a
1357	1357	0	GBIF Germany	4f6826f2-4ff6-443d-b966-e6913bd24013	657533aa-f762-11e1-a439-00145eb45e9a
18	18	0	GBIF Germany	4f6826f2-4ff6-443d-b966-e6913bd24013	6669459e-f762-11e1-a439-00145eb45e9a
71	71	0	GBIF Germany	4f6826f2-4ff6-443d-b966-e6913bd24013	668c0552-f762-11e1-a439-00145eb45e9a
2	2	0	Plazi	ffb07bec-2d10-492d-9c37-361fe0b79427	66a47dea-fe25-4231-9782-2d6a557d3592
36	36	0	GBIF Germany	4f6826f2-4ff6-443d-b966-e6913bd24013	66a708f2-f762-11e1-a439-00145eb45e9a
48	48	0	GBIF Germany	4f6826f2-4ff6-443d-b966-e6913bd24013	67d13cb6-f762-11e1-a439-00145eb45e9a
54	54	0	GBIF Germany	4f6826f2-4ff6-443d-b966-e6913bd24013	685696e0-f762-11e1-a439-00145eb45e9a
282	282	0	Scientific Committee on Antarctic Research	51e4e8ff-bff0-4996-8b27-9107d61b3478	6899818d-a6f5-4a18-81d2-047d84ee28b8
61	61	0	Plazi	ffb07bec-2d10-492d-9c37-361fe0b79427	690469f3-469d-4993-bbe6-f717bff2b1b5
197	197	0	GBIF Germany	4f6826f2-4ff6-443d-b966-e6913bd24013	69655e7c-f762-11e1-a439-00145eb45e9a
98	98	0	GBIF Germany	4f6826f2-4ff6-443d-b966-e6913bd24013	6998750a-f762-11e1-a439-00145eb45e9a
26	26	0	GBIF Germany	4f6826f2-4ff6-443d-b966-e6913bd24013	6a391726-f762-11e1-a439-00145eb45e9a
6	6	0	Plazi	ffb07bec-2d10-492d-9c37-361fe0b79427	6b07f781-3a69-42d8-90b9-3e2f09307f95
14352	14352	0	Atlas of Living Australia	4a6f1b71-969e-4fc5-a693-282b05e1220c	6bfeecf3-bdb0-4deb-83d9-8f07029f2bbc
446	446	0	GBIF Germany	4f6826f2-4ff6-443d-b966-e6913bd24013	6bff1c15-43a6-4074-8b9c-3994cc8fe028
182	182	0	GBIF Germany	4f6826f2-4ff6-443d-b966-e6913bd24013	6d21f8ae-f762-11e1-a439-00145eb45e9a
5	5	0	Plazi	ffb07bec-2d10-492d-9c37-361fe0b79427	6db260ab-3d8c-4152-8a7e-ad0fef402f89
64	64	0	GBIF Germany	4f6826f2-4ff6-443d-b966-e6913bd24013	6f9cf32c-f762-11e1-a439-00145eb45e9a
96	96	0	GBIF Finland	dd514216-5c7c-45f3-910d-797424cb5be6	6fc68a6b-2c50-4b07-9d3f-f4c06fac3d9a
0	13	13	Ocean Biodiversity Information System	ba0670b9-4186-41e6-8e70-f9cb3065551a	709d1a64-7f71-49bc-be24-5be4975a8995
2813	2813	0	U.S. Geological Survey	8618c64a-93e0-4300-b546-7249e5148ed2	70fc5154-6019-4d96-b9a7-fdce469d0260
1408	1408	0	GBIF Germany	4f6826f2-4ff6-443d-b966-e6913bd24013	7137f448-f762-11e1-a439-00145eb45e9a
6	6	0	GBIF Germany	4f6826f2-4ff6-443d-b966-e6913bd24013	717776ae-f762-11e1-a439-00145eb45e9a
47	47	0	GBIF Germany	4f6826f2-4ff6-443d-b966-e6913bd24013	732a1d9e-f762-11e1-a439-00145eb45e9a
16	16	0	GBIF Germany	4f6826f2-4ff6-443d-b966-e6913bd24013	750cef6a-f762-11e1-a439-00145eb45e9a
6	4	-2	GBIF Germany	4f6826f2-4ff6-443d-b966-e6913bd24013	7525249a-f762-11e1-a439-00145eb45e9a
17	17	0	Participant Node Managers Committee	7f48e0c8-5c96-49ec-b972-30748e339115	77bca2e3-70a6-46ac-b30f-031550a06087
0	5	5	Plazi	ffb07bec-2d10-492d-9c37-361fe0b79427	781476ce-a8de-4c31-8072-94b8daf13b9d
0	6	6	Plazi	ffb07bec-2d10-492d-9c37-361fe0b79427	79707515-6744-427a-8ed5-00c1e1de8091
132	132	0	Colombian Biodiversity Information System	7e865cba-7c46-417b-ade5-97f2cf5b7be0	7b263b6e-b156-4199-ab97-f84f33cdf575
362	362	0	Ocean Biodiversity Information System	ba0670b9-4186-41e6-8e70-f9cb3065551a	7b554a7a-f762-11e1-a439-00145eb45e9a
230	230	0	GBIF Germany	4f6826f2-4ff6-443d-b966-e6913bd24013	7bceba86-f762-11e1-a439-00145eb45e9a
3	3	0	Plazi	ffb07bec-2d10-492d-9c37-361fe0b79427	7d707e31-1104-4ed3-8493-ef9302b98796
103	103	0	GBIF Germany	4f6826f2-4ff6-443d-b966-e6913bd24013	7ec0ba8c-f762-11e1-a439-00145eb45e9a
414252	582423	168171	Belgian Biodiversity Platform	fb11cfe1-ebc3-45af-9159-17d9fddbcdac	7f5e4129-0717-428e-876a-464fbd5d9a47
18805	18805	0	Biodiversity Information System of Mexico	b324e8e9-9a4c-44fa-8f1a-7f39ea7ab576	7f740f60-f762-11e1-a439-00145eb45e9a
1850	1646	-204	Biodiversity Information System of Mexico	b324e8e9-9a4c-44fa-8f1a-7f39ea7ab576	7fbbb7a2-f762-11e1-a439-00145eb45e9a
500	489	-11	Biodiversity Information System of Mexico	b324e8e9-9a4c-44fa-8f1a-7f39ea7ab576	800aefe8-f762-11e1-a439-00145eb45e9a
6779	6779	0	GBIF France	da44cd31-5901-4687-a106-6d1c7734ee3a	804c7b10-41a1-4422-b573-41aedb612a5d
1871	1871	0	Colombian Biodiversity Information System	7e865cba-7c46-417b-ade5-97f2cf5b7be0	80b04889-7270-41bd-a17c-58f313e04212
1593	1131	-462	GBIF Germany	4f6826f2-4ff6-443d-b966-e6913bd24013	8159c23e-f762-11e1-a439-00145eb45e9a
18	18	0	Plazi	ffb07bec-2d10-492d-9c37-361fe0b79427	84565611-15ec-4ae5-ac6f-6489ca9ddd28
243	243	0	Canada Biodiversity Information Facility	8f83fc96-c966-4126-83f7-bf044dc49efa	845972b8-f762-11e1-a439-00145eb45e9a
667946	679233	11287	U.S. Geological Survey	8618c64a-93e0-4300-b546-7249e5148ed2	85b1cfb6-f762-11e1-a439-00145eb45e9a
0	103	103	Belgian Biodiversity Platform	fb11cfe1-ebc3-45af-9159-17d9fddbcdac	8704a765-ec45-45fa-a133-36fec7dd4346
4942	4986	44	GBIF Norway	4f829580-180d-46a9-9c87-ed8ec959b545	88d6237c-fbce-4135-b509-0aeed1e4222e
11	11	0	Plazi	ffb07bec-2d10-492d-9c37-361fe0b79427	89245c82-3a4f-4361-b1ba-04fcd0fbb9ad
102	102	0	GBIF Germany	4f6826f2-4ff6-443d-b966-e6913bd24013	8981097c-f762-11e1-a439-00145eb45e9a
118	118	0	GBIF Germany	4f6826f2-4ff6-443d-b966-e6913bd24013	8a39ba3a-f762-11e1-a439-00145eb45e9a
269	269	0	GBIF Germany	4f6826f2-4ff6-443d-b966-e6913bd24013	8a850076-f762-11e1-a439-00145eb45e9a
136	136	0	GBIF Germany	4f6826f2-4ff6-443d-b966-e6913bd24013	8ad0b23c-f762-11e1-a439-00145eb45e9a
17	17	0	Plazi	ffb07bec-2d10-492d-9c37-361fe0b79427	8afd20a4-f494-45f9-a263-7abee3ac3eb2
15	10	-5	GBIF Germany	4f6826f2-4ff6-443d-b966-e6913bd24013	8c60650c-f762-11e1-a439-00145eb45e9a
40	34	-6	GBIF Germany	4f6826f2-4ff6-443d-b966-e6913bd24013	8c71e6ec-f762-11e1-a439-00145eb45e9a
0	56	56	Plazi	ffb07bec-2d10-492d-9c37-361fe0b79427	8cc68765-58a7-4604-bc87-03da388815d4
4	4	0	Plazi	ffb07bec-2d10-492d-9c37-361fe0b79427	8df95524-da84-4847-a8f8-cf658ff57307
1033	734	-299	GBIF Germany	4f6826f2-4ff6-443d-b966-e6913bd24013	8eb672d8-f762-11e1-a439-00145eb45e9a
10	10	0	Plazi	ffb07bec-2d10-492d-9c37-361fe0b79427	8f1615fb-8ba7-4fe9-9e10-013a9d175180
57	26	-31	GBIF Germany	4f6826f2-4ff6-443d-b966-e6913bd24013	902c4750-f762-11e1-a439-00145eb45e9a
14541771	17847718	3305947	South African Biodiversity Information Facility	7190b835-4e86-4b6e-85c1-19cc6677c250	906e6978-e292-4a8b-9c39-adf6bb0f3323
765	765	0	GBIF France	da44cd31-5901-4687-a106-6d1c7734ee3a	90eb9168-3742-4769-8e0f-749e0df5bcf2
54	54	0	Participant Node Managers Committee	7f48e0c8-5c96-49ec-b972-30748e339115	916e0274-a1ef-4047-aaef-a56430c27b6f
35	25	-10	GBIF Germany	4f6826f2-4ff6-443d-b966-e6913bd24013	918751ee-f762-11e1-a439-00145eb45e9a
224	224	0	GBIF Germany	4f6826f2-4ff6-443d-b966-e6913bd24013	91af6288-f762-11e1-a439-00145eb45e9a
2	2	0	GBIF Germany	4f6826f2-4ff6-443d-b966-e6913bd24013	93d991e6-f762-11e1-a439-00145eb45e9a
792	792	0	GBIF Germany	4f6826f2-4ff6-443d-b966-e6913bd24013	9410f820-f762-11e1-a439-00145eb45e9a
2058	2038	-20	GBIF Germany	4f6826f2-4ff6-443d-b966-e6913bd24013	944ca050-f762-11e1-a439-00145eb45e9a
0	9	9	Plazi	ffb07bec-2d10-492d-9c37-361fe0b79427	950d0ca1-62a2-4f36-898d-6dca2c5b90cf
6	6	0	GBIF Germany	4f6826f2-4ff6-443d-b966-e6913bd24013	953d3486-7811-4e05-b03a-c26f8a9bf4cb
1574	1574	0	U.S. Geological Survey	8618c64a-93e0-4300-b546-7249e5148ed2	95c6d414-f762-11e1-a439-00145eb45e9a
22	22	0	GBIF Germany	4f6826f2-4ff6-443d-b966-e6913bd24013	96820473-a2c5-420c-a02d-a5da58e73e25
367	367	0	Plazi	ffb07bec-2d10-492d-9c37-361fe0b79427	96befb78-0a83-49f3-aa2c-50621311f7c7
0	160	160	Ocean Biodiversity Information System	ba0670b9-4186-41e6-8e70-f9cb3065551a	997e26db-f6f7-4270-8477-35655eba3c53
0	12	12	Plazi	ffb07bec-2d10-492d-9c37-361fe0b79427	99b2432e-c149-4b82-a584-4b33d116d198
0	1133	1133	GBIF Spain	1f94b3ca-9345-4d65-afe2-4bace93aa0fe	a181b0f0-3447-40d5-b8e3-063be17b5f5f
15	15	0	Plazi	ffb07bec-2d10-492d-9c37-361fe0b79427	a1e3abab-933f-4af9-be69-632ea60348f6
1193	1193	0	GBIF Germany	4f6826f2-4ff6-443d-b966-e6913bd24013	a27d281f-ff65-4231-b14b-d16d2173c939
0	10	10	Plazi	ffb07bec-2d10-492d-9c37-361fe0b79427	ab396ed7-042f-4d18-9fb6-926587094adf
0	21	21	Plazi	ffb07bec-2d10-492d-9c37-361fe0b79427	b3604013-c2a3-4a72-858c-da2097975327
4764	4764	0	U.S. Geological Survey	8618c64a-93e0-4300-b546-7249e5148ed2	b48ad0d1-2fa0-49ba-b1ff-7ae594738658
2904	2904	0	Atlas of Living Australia	4a6f1b71-969e-4fc5-a693-282b05e1220c	b5267bb3-217b-49a1-b9c9-9024cdad2666
0	2149	2149	U.S. Geological Survey	8618c64a-93e0-4300-b546-7249e5148ed2	b6ba36a7-362b-4c13-9e28-f71d4770a193
0	1320	1320	GBIF Portugal	673f7038-4262-4149-b753-5658a4e912f6	b71cfcb7-8146-4683-9683-3e6a510fa3a4
34	34	0	Plazi	ffb07bec-2d10-492d-9c37-361fe0b79427	b86231f7-4481-4f70-83e5-711c89b09480
2559	2067	-492	GBIF Germany	4f6826f2-4ff6-443d-b966-e6913bd24013	b8979aa5-b6a1-4d55-8605-cca49a9652c1
9	9	0	Plazi	ffb07bec-2d10-492d-9c37-361fe0b79427	ba8836af-4f9b-496f-a154-493f18950c11
9	9	0	Plazi	ffb07bec-2d10-492d-9c37-361fe0b79427	be019669-b825-4ebe-a332-091d32be1093
0	4	4	Plazi	ffb07bec-2d10-492d-9c37-361fe0b79427	be2730a8-26d1-4894-b45e-05e55a51cee6
1872	1872	0	GBIF Brazil	cdc9736d-5ff7-4ece-9959-3c744360cdb3	be48de13-adc7-458d-9e3d-447fc55dda4a
8015	8015	0	National Biodiversity Network	d897a5b9-35ee-4232-94bd-b0bcaac003c2	bec035ce-c22d-48f3-bf8c-6a42888e42e9
2264	2264	0	South African Biodiversity Information Facility	7190b835-4e86-4b6e-85c1-19cc6677c250	bfb9c2d2-4f05-43f3-b7fd-16b497467178
11840	11840	0	U.S. Geological Survey	8618c64a-93e0-4300-b546-7249e5148ed2	c24949d7-9a97-422b-aed9-c083894e49a2
0	10	10	Plazi	ffb07bec-2d10-492d-9c37-361fe0b79427	c2500323-6124-46e0-a008-06aedef14ad1
70	70	0	Plazi	ffb07bec-2d10-492d-9c37-361fe0b79427	c6d3d19c-627e-425f-8824-193a7213994a
19	19	0	Tanzania Biodiversity Information Facility	abd95ca6-3959-4db9-aaa6-2de1aeecf514	c791b255-a184-4600-b828-ef9d4092a212
0	141	141	Ocean Biodiversity Information System	ba0670b9-4186-41e6-8e70-f9cb3065551a	cc48f7b9-cabb-49c6-bb54-4c03dec0724d
160	160	0	GBIF France	da44cd31-5901-4687-a106-6d1c7734ee3a	cccae1ac-d62b-43e5-8044-ba97b4ee0f79
2880	2880	0	National Biodiversity Network	d897a5b9-35ee-4232-94bd-b0bcaac003c2	ccd5a6be-8958-4017-90c6-91c61de7f0c1
0	184	184	Ocean Biodiversity Information System	ba0670b9-4186-41e6-8e70-f9cb3065551a	cd799005-b27e-4548-9c57-0edc5e2ba196
0	3	3	Participant Node Managers Committee	7f48e0c8-5c96-49ec-b972-30748e339115	ce60be44-08f9-42c0-b423-c8e748d43c60
617	617	0	GBIF Benin	efb9c00e-f802-45dd-8826-a52ec45b89ff	cf134deb-8678-424c-9f87-f9cbc24253cc
5162	5162	0	Colombian Biodiversity Information System	7e865cba-7c46-417b-ade5-97f2cf5b7be0	d2278c93-6510-46a8-9792-d794765b4167
7007	8323	1316	Participant Node Managers Committee	7f48e0c8-5c96-49ec-b972-30748e339115	d922b606-6c94-4d51-9277-36c9b03872a7
0	46	46	Plazi	ffb07bec-2d10-492d-9c37-361fe0b79427	d9ca8942-545a-47a2-ab7b-ff599c44434b
9139	9139	0	Participant Node Managers Committee	7f48e0c8-5c96-49ec-b972-30748e339115	dad9eb2e-7749-4c99-b6cd-2b161d6419b0
2916	2916	0	National Biodiversity Network	d897a5b9-35ee-4232-94bd-b0bcaac003c2	dbab08b6-f98a-4ce4-9951-2c38202fa98f
190	190	0	Belgian Biodiversity Platform	fb11cfe1-ebc3-45af-9159-17d9fddbcdac	dc22a2f5-2c51-455b-b121-cef418b23a49
0	41	41	Plazi	ffb07bec-2d10-492d-9c37-361fe0b79427	df79feb7-c7e6-4267-b324-91597bc182fd
57	57	0	Colombian Biodiversity Information System	7e865cba-7c46-417b-ade5-97f2cf5b7be0	df8e6b62-d24c-403d-860b-81ceaf588fb7
36	36	0	Plazi	ffb07bec-2d10-492d-9c37-361fe0b79427	e1497134-9399-4967-b427-20906054f3f5
13527	13527	0	Ocean Biodiversity Information System	ba0670b9-4186-41e6-8e70-f9cb3065551a	e17bfff0-4cf4-4130-98ea-f9f053eaef4f
1552	1552	0	National Biodiversity Network	d897a5b9-35ee-4232-94bd-b0bcaac003c2	e33ac3eb-bd50-4e18-bb88-fe5d3e57d243
0	9	9	Plazi	ffb07bec-2d10-492d-9c37-361fe0b79427	e3a4e21d-e4fd-4d82-a596-de175e91f976
1	1	0	Plazi	ffb07bec-2d10-492d-9c37-361fe0b79427	e45c62a0-c7a0-452c-b33e-c2879edc71b2
0	22	22	Plazi	ffb07bec-2d10-492d-9c37-361fe0b79427	e4f875c6-1187-4f75-9e8f-d828f93979f2
949	949	0	National Biodiversity Network	d897a5b9-35ee-4232-94bd-b0bcaac003c2	e818bbb2-286c-4008-9b53-1bb98d361a04
352	352	0	GBIF France	da44cd31-5901-4687-a106-6d1c7734ee3a	f23fa3bd-482e-4aa5-974b-6517d464e782
57	57	0	Colombian Biodiversity Information System	7e865cba-7c46-417b-ade5-97f2cf5b7be0	f47a39b7-84de-40b4-ae45-2cb4b33ade63
66826	66826	0	GBIF France	da44cd31-5901-4687-a106-6d1c7734ee3a	f6b72f89-09c9-4805-be09-96198ab19050
0	10	10	Plazi	ffb07bec-2d10-492d-9c37-361fe0b79427	fbab4b35-da14-44d9-8ed9-984f7de5f7f4
0	15	15	Plazi	ffb07bec-2d10-492d-9c37-361fe0b79427	fc211a04-7e7f-4249-94ac-b592f8c01e6f
209	209	0	Plazi	ffb07bec-2d10-492d-9c37-361fe0b79427	fc81d7e8-5862-451f-8c90-b91b4493f1fa
291402	291402	0	Belgian Biodiversity Platform	fb11cfe1-ebc3-45af-9159-17d9fddbcdac	fc992520-9e66-11dc-8738-b8a03c50a862
0	23	23	Participant Node Managers Committee	7f48e0c8-5c96-49ec-b972-30748e339115	feb1f3f1-d153-4445-a2d1-03a0b10969e6
3283	3283	0	Biodiversity Information System of Mexico	b324e8e9-9a4c-44fa-8f1a-7f39ea7ab576	ff470f29-2838-43fe-9c92-64ac1f9373ea
10616	10616	0	Biodiversity Information System of Mexico	b324e8e9-9a4c-44fa-8f1a-7f39ea7ab576	017c7c7e-9c1b-4fe8-b849-277848eebfde
36	36	0	Plazi	ffb07bec-2d10-492d-9c37-361fe0b79427	01dcaaeb-b60b-45ca-a001-92dc695b5973
4791	8317	3526	GBIF Japan	db5705aa-6a6e-42f1-8942-d77b9f4896ea	030cc3ac-4032-4097-b06c-538c5dc24b98
2024	2024	0	Colombian Biodiversity Information System	7e865cba-7c46-417b-ade5-97f2cf5b7be0	057f132f-d5d3-4b92-b094-f46adab4c29e
0	3	3	Plazi	ffb07bec-2d10-492d-9c37-361fe0b79427	07e82def-b92a-48ce-a950-fb21fb687959
121	121	0	GBIF France	da44cd31-5901-4687-a106-6d1c7734ee3a	09139f19-6dc3-4e26-9f73-295999345f47
361	361	0	Colombian Biodiversity Information System	7e865cba-7c46-417b-ade5-97f2cf5b7be0	0cc70367-90e9-4450-8d03-caa8060e952c
690	690	0	GBIF France	da44cd31-5901-4687-a106-6d1c7734ee3a	0d7fd46c-25ca-46bb-a229-78ce526997e5
47	47	0	Atlas of Living Australia	4a6f1b71-969e-4fc5-a693-282b05e1220c	1173740d-43d0-4469-95ec-4a8a52895d6a
5	5	0	Plazi	ffb07bec-2d10-492d-9c37-361fe0b79427	12e5159f-29a5-44d7-a11d-e8a408e21884
21	21	0	Plazi	ffb07bec-2d10-492d-9c37-361fe0b79427	14d27c19-b536-4618-9e3b-2195e1c10c37
8	8	0	Plazi	ffb07bec-2d10-492d-9c37-361fe0b79427	156703d5-7ed5-446a-b499-0b87f1141e98
33361	33563	202	GBIF Spain	1f94b3ca-9345-4d65-afe2-4bace93aa0fe	17a729a0-7ed1-11df-8c4a-0800200c9a66
0	262	262	Participant Node Managers Committee	7f48e0c8-5c96-49ec-b972-30748e339115	1a7dfcf2-234a-4d7a-9d5f-de7c8925d274
0	10	10	Ocean Biodiversity Information System	ba0670b9-4186-41e6-8e70-f9cb3065551a	1f291e00-0571-4980-96d5-f9c9370a67ca
663	663	0	Colombian Biodiversity Information System	7e865cba-7c46-417b-ade5-97f2cf5b7be0	27465742-2f96-4cb5-83eb-c8bbb9f850ee
5758	5758	0	GBIF France	da44cd31-5901-4687-a106-6d1c7734ee3a	2aa2a8a0-db9d-4309-93c2-62d380ebbe3b
15455	15455	0	GBIF France	da44cd31-5901-4687-a106-6d1c7734ee3a	2c13b330-d6c5-4d4f-a726-129ca8c855cf
36	36	0	Plazi	ffb07bec-2d10-492d-9c37-361fe0b79427	30d7eb1c-d9b1-42af-a499-5b3de8d41be3
4	4	0	Plazi	ffb07bec-2d10-492d-9c37-361fe0b79427	30fd60e6-d200-43a4-8d62-b906ae26a77c
175	175	0	Colombian Biodiversity Information System	7e865cba-7c46-417b-ade5-97f2cf5b7be0	32acd21c-e784-4b54-96c1-8c0b315bf3d5
212	212	0	Plazi	ffb07bec-2d10-492d-9c37-361fe0b79427	32b41697-bcad-4325-b0b9-e50ea0eef03c
387	387	0	GBIF Germany	4f6826f2-4ff6-443d-b966-e6913bd24013	35fc6cf0-d46d-40de-9d73-624944d5bfd6
0	5703	5703	Belgian Biodiversity Platform	fb11cfe1-ebc3-45af-9159-17d9fddbcdac	3634aee3-41d5-4aa2-8cb5-875859f62a3a
96249	96249	0	Belgian Biodiversity Platform	fb11cfe1-ebc3-45af-9159-17d9fddbcdac	37e094f3-dcf2-469f-93a2-c4b9b5fa7275
418	418	0	Participant Node Managers Committee	7f48e0c8-5c96-49ec-b972-30748e339115	396f6ea3-e250-40b9-9810-cdf2ab2f0f79
3	3	0	Plazi	ffb07bec-2d10-492d-9c37-361fe0b79427	3996d4b6-345e-4db4-a214-4729d5844552
0	3	3	Plazi	ffb07bec-2d10-492d-9c37-361fe0b79427	3c53535f-d5c5-44af-8421-a9c7750b8cf5
20	20	0	Plazi	ffb07bec-2d10-492d-9c37-361fe0b79427	3c8948ac-ca2e-436d-9f5c-8e0f1d3f1a19
32	32	0	Participant Node Managers Committee	7f48e0c8-5c96-49ec-b972-30748e339115	3c8a5d19-69a7-46e3-980b-59abc1dc29ab
107	107	0	Plazi	ffb07bec-2d10-492d-9c37-361fe0b79427	3eeb8ad3-f39e-48d6-8b27-0e66d006d322
536	536	0	National Biodiversity Network	d897a5b9-35ee-4232-94bd-b0bcaac003c2	3f11e7df-89d6-4a28-a4ed-bd400c1976a9
25066	25066	0	GBIF Brazil	cdc9736d-5ff7-4ece-9959-3c744360cdb3	3f26f7da-27ff-4a74-aa8f-7357234a790f
0	21	21	Ocean Biodiversity Information System	ba0670b9-4186-41e6-8e70-f9cb3065551a	3f6821de-f811-4130-84f5-6705a52f3270
146	148	2	U.S. Geological Survey	8618c64a-93e0-4300-b546-7249e5148ed2	40275fc6-3e71-4d76-aafe-276bdeefcd86
59	59	0	GBIF France	da44cd31-5901-4687-a106-6d1c7734ee3a	41a3fa07-e1d0-4f8c-b1f7-7e653fcd3708
22	22	0	Plazi	ffb07bec-2d10-492d-9c37-361fe0b79427	44cfdd68-dcee-4af6-a5d1-12ce27d7f061
0	2	2	Plazi	ffb07bec-2d10-492d-9c37-361fe0b79427	4542f05d-992b-48a2-8b6e-c8128357d5e0
243	243	0	GBIF Uganda	71b40829-6a12-4c3d-8fee-5746f5e9cf8c	46090fec-fafb-44c1-aa10-2de851fcff41
0	375	375	Plazi	ffb07bec-2d10-492d-9c37-361fe0b79427	479d8c3b-8194-4f81-bed5-d157d5aa021e
0	190566	190566	GBIF Japan	db5705aa-6a6e-42f1-8942-d77b9f4896ea	4b4f3625-7e31-4b34-be76-999ccfecbff1
1186	1186	0	Participant Node Managers Committee	7f48e0c8-5c96-49ec-b972-30748e339115	4bb083e8-53b9-418e-b83d-105e75a1798d
3804	3733	-71	Biodiversity Information System of Mexico	b324e8e9-9a4c-44fa-8f1a-7f39ea7ab576	4bdc2839-5869-4d2b-8fee-1a507ebc232d
28	28	0	Colombian Biodiversity Information System	7e865cba-7c46-417b-ade5-97f2cf5b7be0	4e941005-b5b4-4f79-b8cc-acc1318b6fc4
3	3	0	Plazi	ffb07bec-2d10-492d-9c37-361fe0b79427	4eb89ac4-d631-44e5-ae5c-6f2f29a6ebb6
1	1	0	Plazi	ffb07bec-2d10-492d-9c37-361fe0b79427	4fe35c0c-ecc1-4e78-b269-569cbb1ace45
98	98	0	Biodiversity Information System of Mexico	b324e8e9-9a4c-44fa-8f1a-7f39ea7ab576	51397421-4f33-43bc-a32b-6ffdecd9ce0a
0	1559	1559	Atlas of Living Australia	4a6f1b71-969e-4fc5-a693-282b05e1220c	54b4549c-9ba0-4517-8614-0d0eccb75b07
1008	1008	0	GBIF France	da44cd31-5901-4687-a106-6d1c7734ee3a	57886648-0811-497a-8df3-1a140a388fc3
419514	419514	0	GBIF Sweden	a0b3be64-6525-4387-ac67-a499950f92e1	59bc8df0-0c71-11dd-84d4-b8a03c50a862
6652	6652	0	GBIF Benin	efb9c00e-f802-45dd-8826-a52ec45b89ff	5d3bd3a3-b4b6-41f5-968d-8b8f99340800
68748	68748	0	GBIF Japan	db5705aa-6a6e-42f1-8942-d77b9f4896ea	5e610094-df1e-4073-85cb-260091509e1e
0	36	36	Ocean Biodiversity Information System	ba0670b9-4186-41e6-8e70-f9cb3065551a	5e7c9759-1892-41bb-b1cc-4279c41befb6
0	2	2	Plazi	ffb07bec-2d10-492d-9c37-361fe0b79427	5fec31bc-8f6f-49f1-bb5e-7bdc1daaf4fb
1143	1143	0	Atlas of Living Australia	4a6f1b71-969e-4fc5-a693-282b05e1220c	6026ed0c-3113-4d31-9c85-a6468f09f699
19451	19451	0	Polish Biodiversity Information Network	2618bfdf-e194-4911-a241-80db3107bc51	610f5cf0-13c7-11de-b2e0-b8a03c50a862
41	41	0	GBIF Germany	4f6826f2-4ff6-443d-b966-e6913bd24013	619f5490-f762-11e1-a439-00145eb45e9a
99	99	0	GBIF Germany	4f6826f2-4ff6-443d-b966-e6913bd24013	61d9d71e-f762-11e1-a439-00145eb45e9a
2	2	0	Plazi	ffb07bec-2d10-492d-9c37-361fe0b79427	623b2e8f-9e17-495f-8c00-73fff45fa485
45	45	0	GBIF Germany	4f6826f2-4ff6-443d-b966-e6913bd24013	62b9042a-f762-11e1-a439-00145eb45e9a
27	27	0	GBIF Germany	4f6826f2-4ff6-443d-b966-e6913bd24013	6328b2a2-f762-11e1-a439-00145eb45e9a
157	157	0	GBIF Germany	4f6826f2-4ff6-443d-b966-e6913bd24013	63acd2c6-f762-11e1-a439-00145eb45e9a
1288	1288	0	Participant Node Managers Committee	7f48e0c8-5c96-49ec-b972-30748e339115	641196ce-d154-456a-8af1-a306b0f81895
571	571	0	GBIF France	da44cd31-5901-4687-a106-6d1c7734ee3a	6445e1ef-2579-407f-9d2c-803a3de4b3da
5	5	0	Plazi	ffb07bec-2d10-492d-9c37-361fe0b79427	6446fee7-99f6-43cd-b37a-bb6ce3fade53
15964	15964	0	GBIF France	da44cd31-5901-4687-a106-6d1c7734ee3a	644f3a9f-1bbc-4e9d-8fd6-6989eac05371
28	28	0	GBIF Germany	4f6826f2-4ff6-443d-b966-e6913bd24013	64d9c7b2-f762-11e1-a439-00145eb45e9a
12	12	0	Plazi	ffb07bec-2d10-492d-9c37-361fe0b79427	6592cf39-be44-44f4-842d-e0126d8640ad
589	589	0	GBIF France	da44cd31-5901-4687-a106-6d1c7734ee3a	65d82ae1-ca60-46c1-acea-acec0f1837e8
103	103	0	GBIF Germany	4f6826f2-4ff6-443d-b966-e6913bd24013	662d6d26-f762-11e1-a439-00145eb45e9a
10	10	0	GBIF Germany	4f6826f2-4ff6-443d-b966-e6913bd24013	666bb338-f762-11e1-a439-00145eb45e9a
33	33	0	GBIF Germany	4f6826f2-4ff6-443d-b966-e6913bd24013	6731463e-f762-11e1-a439-00145eb45e9a
48	48	0	GBIF Germany	4f6826f2-4ff6-443d-b966-e6913bd24013	67b81178-f762-11e1-a439-00145eb45e9a
0	71	71	Ocean Biodiversity Information System	ba0670b9-4186-41e6-8e70-f9cb3065551a	68c69639-4240-413f-8e0a-73be5a775773
324	182	-142	GBIF Germany	4f6826f2-4ff6-443d-b966-e6913bd24013	68d125ae-f762-11e1-a439-00145eb45e9a
30	30	0	GBIF Germany	4f6826f2-4ff6-443d-b966-e6913bd24013	69223ea8-f762-11e1-a439-00145eb45e9a
36	36	0	GBIF Germany	4f6826f2-4ff6-443d-b966-e6913bd24013	6927394e-f762-11e1-a439-00145eb45e9a
178	178	0	GBIF Germany	4f6826f2-4ff6-443d-b966-e6913bd24013	695888b4-f762-11e1-a439-00145eb45e9a
191	191	0	GBIF Germany	4f6826f2-4ff6-443d-b966-e6913bd24013	69feb57c-f762-11e1-a439-00145eb45e9a
248	248	0	GBIF Germany	4f6826f2-4ff6-443d-b966-e6913bd24013	6a0bc1ea-f762-11e1-a439-00145eb45e9a
450	420	-30	GBIF Germany	4f6826f2-4ff6-443d-b966-e6913bd24013	6a821444-f762-11e1-a439-00145eb45e9a
27	27	0	GBIF Germany	4f6826f2-4ff6-443d-b966-e6913bd24013	6bdcb8c6-f762-11e1-a439-00145eb45e9a
391	391	0	GBIF Germany	4f6826f2-4ff6-443d-b966-e6913bd24013	6e824096-f762-11e1-a439-00145eb45e9a
1	1	0	Plazi	ffb07bec-2d10-492d-9c37-361fe0b79427	6f45db94-402f-4497-be13-05abb806c962
208	206	-2	GBIF Germany	4f6826f2-4ff6-443d-b966-e6913bd24013	6f8531ce-f762-11e1-a439-00145eb45e9a
1881	1273	-608	GBIF Germany	4f6826f2-4ff6-443d-b966-e6913bd24013	704f00f8-f762-11e1-a439-00145eb45e9a
625	625	0	GBIF Germany	4f6826f2-4ff6-443d-b966-e6913bd24013	70aae184-f762-11e1-a439-00145eb45e9a
64	53	-11	GBIF Germany	4f6826f2-4ff6-443d-b966-e6913bd24013	70e9c624-f762-11e1-a439-00145eb45e9a
827	827	0	GBIF Germany	4f6826f2-4ff6-443d-b966-e6913bd24013	715e8a40-f762-11e1-a439-00145eb45e9a
409	409	0	GBIF Germany	4f6826f2-4ff6-443d-b966-e6913bd24013	7210ce80-f762-11e1-a439-00145eb45e9a
125	125	0	GBIF Germany	4f6826f2-4ff6-443d-b966-e6913bd24013	72e65352-f762-11e1-a439-00145eb45e9a
79	79	0	Participant Node Managers Committee	7f48e0c8-5c96-49ec-b972-30748e339115	73686819-c664-4ae6-9bc2-5e5f120cbd3d
0	2	2	Plazi	ffb07bec-2d10-492d-9c37-361fe0b79427	73ea1b52-5964-4c13-a1ef-70bac196195b
40	40	0	GBIF Germany	4f6826f2-4ff6-443d-b966-e6913bd24013	740ebc42-f762-11e1-a439-00145eb45e9a
235	235	0	GBIF Germany	4f6826f2-4ff6-443d-b966-e6913bd24013	75c874e2-f762-11e1-a439-00145eb45e9a
0	3	3	Plazi	ffb07bec-2d10-492d-9c37-361fe0b79427	76863c3f-5f75-4aec-88f8-298e34ef4557
11	11	0	Plazi	ffb07bec-2d10-492d-9c37-361fe0b79427	7752c97e-c9bc-49c3-b1dd-0db7992b3e6c
818	793	-25	GBIF Germany	4f6826f2-4ff6-443d-b966-e6913bd24013	79742316-f762-11e1-a439-00145eb45e9a
0	2	2	Plazi	ffb07bec-2d10-492d-9c37-361fe0b79427	7a0dc42d-4aa7-4e5c-9c67-1952337d620a
4	4	0	Plazi	ffb07bec-2d10-492d-9c37-361fe0b79427	7a8f700f-f5a5-4055-8fd6-ed95699105ce
21	21	0	GBIF Germany	4f6826f2-4ff6-443d-b966-e6913bd24013	7ac724b6-f762-11e1-a439-00145eb45e9a
1547	1547	0	Biodiversity Information System of Mexico	b324e8e9-9a4c-44fa-8f1a-7f39ea7ab576	7b3173d3-2e58-458e-baac-bdca2d5b3af8
36	36	0	GBIF Germany	4f6826f2-4ff6-443d-b966-e6913bd24013	7b803320-f762-11e1-a439-00145eb45e9a
18	18	0	Plazi	ffb07bec-2d10-492d-9c37-361fe0b79427	7ba66947-0a65-40f6-9058-a0a57cd1d584
129403	182923	53520	National Biodiversity Network	d897a5b9-35ee-4232-94bd-b0bcaac003c2	7bf578b3-5753-4c11-bde0-4370fddf2ce9
578	578	0	GBIF Germany	4f6826f2-4ff6-443d-b966-e6913bd24013	7db8695a-f762-11e1-a439-00145eb45e9a
1393	1393	0	GBIF Finland	dd514216-5c7c-45f3-910d-797424cb5be6	7f23b626-ed2f-4c46-b522-60eed712bf0d
106550	106550	0	DanBIF - Danish Biodiversity Information Facility	4ddd294f-02b7-4359-ac33-0806a9ca9c6b	7f4ed916-f762-11e1-a439-00145eb45e9a
100391	100391	0	GBIF France	da44cd31-5901-4687-a106-6d1c7734ee3a	80ec681f-e53c-4b7e-9e9c-3f50a0f3e269
179	150	-29	GBIF Germany	4f6826f2-4ff6-443d-b966-e6913bd24013	8188c106-f762-11e1-a439-00145eb45e9a
97	97	0	Ghana Biodiversity Information Facility	b5633b75-6a86-4fdf-9cfc-506047fb9dc7	81a51504-4aa6-41b7-8686-ae34fae95276
11	11	0	Plazi	ffb07bec-2d10-492d-9c37-361fe0b79427	81b3873f-f2a1-47b9-9dbb-02777021ddbe
33	33	0	Plazi	ffb07bec-2d10-492d-9c37-361fe0b79427	81dc4962-b7c7-4d34-a928-50009e4f465b
0	1	1	Plazi	ffb07bec-2d10-492d-9c37-361fe0b79427	84325d59-852a-47e2-83de-08b5193e7450
2	2	0	Plazi	ffb07bec-2d10-492d-9c37-361fe0b79427	84c008d2-a6b7-411e-932a-74e847fc4b7d
9545	9545	0	GBIF Germany	4f6826f2-4ff6-443d-b966-e6913bd24013	856bc8c2-f762-11e1-a439-00145eb45e9a
2940	2940	0	GBIF Germany	4f6826f2-4ff6-443d-b966-e6913bd24013	858e7462-f762-11e1-a439-00145eb45e9a
10203	13330	3127	GBIF Japan	db5705aa-6a6e-42f1-8942-d77b9f4896ea	868e97a2-f762-11e1-a439-00145eb45e9a
3967	3967	0	National Biodiversity Network	d897a5b9-35ee-4232-94bd-b0bcaac003c2	86e04540-4f45-43b4-b878-ade541608280
4	4	0	Plazi	ffb07bec-2d10-492d-9c37-361fe0b79427	87001a8f-7955-47b6-89c2-94ce5aad7c50
351	351	0	GBIF Germany	4f6826f2-4ff6-443d-b966-e6913bd24013	87a8a6aa-f762-11e1-a439-00145eb45e9a
580	580	0	Ocean Biodiversity Information System	ba0670b9-4186-41e6-8e70-f9cb3065551a	8925498e-f762-11e1-a439-00145eb45e9a
148	148	0	GBIF Germany	4f6826f2-4ff6-443d-b966-e6913bd24013	897aa474-f762-11e1-a439-00145eb45e9a
161	161	0	GBIF Germany	4f6826f2-4ff6-443d-b966-e6913bd24013	8a79d84a-f762-11e1-a439-00145eb45e9a
168	168	0	GBIF Germany	4f6826f2-4ff6-443d-b966-e6913bd24013	8a80de10-f762-11e1-a439-00145eb45e9a
135	135	0	GBIF Germany	4f6826f2-4ff6-443d-b966-e6913bd24013	8b8fe562-f762-11e1-a439-00145eb45e9a
120	120	0	Plazi	ffb07bec-2d10-492d-9c37-361fe0b79427	8c28e10d-e12c-4399-9bd1-bac99bac1fb4
181	126	-55	GBIF Germany	4f6826f2-4ff6-443d-b966-e6913bd24013	8c4ecaa4-f762-11e1-a439-00145eb45e9a
139	139	0	GBIF Germany	4f6826f2-4ff6-443d-b966-e6913bd24013	8c7ef6d4-f762-11e1-a439-00145eb45e9a
1	1	0	GBIF Germany	4f6826f2-4ff6-443d-b966-e6913bd24013	8ca78aea-f762-11e1-a439-00145eb45e9a
96	96	0	Plazi	ffb07bec-2d10-492d-9c37-361fe0b79427	8e7650ed-66fc-4b2a-b55f-11603d3d2166
650	451	-199	GBIF Germany	4f6826f2-4ff6-443d-b966-e6913bd24013	8f68c654-f762-11e1-a439-00145eb45e9a
51	33	-18	GBIF Germany	4f6826f2-4ff6-443d-b966-e6913bd24013	8f84ba6c-f762-11e1-a439-00145eb45e9a
330	296	-34	GBIF Germany	4f6826f2-4ff6-443d-b966-e6913bd24013	8facfa54-f762-11e1-a439-00145eb45e9a
299	106	-193	GBIF Germany	4f6826f2-4ff6-443d-b966-e6913bd24013	90ef8364-f762-11e1-a439-00145eb45e9a
24	24	0	National Biodiversity Network	d897a5b9-35ee-4232-94bd-b0bcaac003c2	919fbd54-6fa6-4a6f-a616-4a87962a0a37
4	4	0	Plazi	ffb07bec-2d10-492d-9c37-361fe0b79427	92f25115-f0a9-440a-948e-80327772c861
6	6	0	Plazi	ffb07bec-2d10-492d-9c37-361fe0b79427	9322a9db-0fb9-4136-a366-3bde45d1220e
10	10	0	GBIF Germany	4f6826f2-4ff6-443d-b966-e6913bd24013	933ebd10-f762-11e1-a439-00145eb45e9a
1275	625	-650	GBIF Germany	4f6826f2-4ff6-443d-b966-e6913bd24013	9363faee-f762-11e1-a439-00145eb45e9a
0	48992	48992	Atlas of Living Australia	4a6f1b71-969e-4fc5-a693-282b05e1220c	93e4d24c-92f0-40b7-84e3-ba054886b1c3
84	84	0	GBIF Germany	4f6826f2-4ff6-443d-b966-e6913bd24013	9756a098-f762-11e1-a439-00145eb45e9a
0	2	2	Plazi	ffb07bec-2d10-492d-9c37-361fe0b79427	98bf3743-af1e-49af-97d4-46f4402cc700
0	41	41	Plazi	ffb07bec-2d10-492d-9c37-361fe0b79427	98ed7183-9006-4016-bb0b-4148527cfc28
0	2	2	Plazi	ffb07bec-2d10-492d-9c37-361fe0b79427	9a5434dd-ceb6-4e3b-9952-7b9d22184472
1172	1172	0	GBIF Finland	dd514216-5c7c-45f3-910d-797424cb5be6	9d8ff248-3f6d-4180-a7f5-3570c489cf72
19	19	0	Plazi	ffb07bec-2d10-492d-9c37-361fe0b79427	9fa4fe9c-574a-48e0-a659-390bb7216997
2	2	0	Plazi	ffb07bec-2d10-492d-9c37-361fe0b79427	a1609808-20a4-443b-88c4-f08fae39849d
32537	39029	6492	GBIF Spain	1f94b3ca-9345-4d65-afe2-4bace93aa0fe	a48c2e76-4984-4540-9bf6-f4d579ed7d99
36	36	0	GBIF Spain	1f94b3ca-9345-4d65-afe2-4bace93aa0fe	a7f7e3f4-4557-4ffe-8bde-25e719d4b85c
0	448	448	Colombian Biodiversity Information System	7e865cba-7c46-417b-ade5-97f2cf5b7be0	a9dc39cb-501e-43a4-b7cf-a9afee337b44
50	50	0	Plazi	ffb07bec-2d10-492d-9c37-361fe0b79427	ad56828c-aee3-4b22-a912-048c722e4410
242	242	0	Atlas of Living Australia	4a6f1b71-969e-4fc5-a693-282b05e1220c	aeaef0c7-f842-4bca-a287-fa8e22f0086b
7750	7750	0	GBIF Brazil	cdc9736d-5ff7-4ece-9959-3c744360cdb3	afae313d-2283-49fc-97fd-6825da4cb49b
1164	297	-867	GBIF Germany	4f6826f2-4ff6-443d-b966-e6913bd24013	b295989d-430b-4b58-9e6e-6ab13ad862c5
1	1	0	GBIF France	da44cd31-5901-4687-a106-6d1c7734ee3a	b5490e05-da56-4945-a472-41738b30e792
0	3	3	Plazi	ffb07bec-2d10-492d-9c37-361fe0b79427	bd9f453c-5163-43dd-a357-2b75e63f88e2
0	19	19	Plazi	ffb07bec-2d10-492d-9c37-361fe0b79427	c1e73049-2d3f-4296-ba8e-5e8645e62bce
283	283	0	Belgian Biodiversity Platform	fb11cfe1-ebc3-45af-9159-17d9fddbcdac	c4bd0284-6f76-4af1-a638-e5f6c4594201
3	3	0	Plazi	ffb07bec-2d10-492d-9c37-361fe0b79427	c66f0344-e944-4c87-9083-079f0a7dbd77
1	1	0	Plazi	ffb07bec-2d10-492d-9c37-361fe0b79427	c7b0209d-c2d7-4e16-bc08-8cc352634836
0	1908	1908	Colombian Biodiversity Information System	7e865cba-7c46-417b-ade5-97f2cf5b7be0	c9dabf4e-1118-450f-ba9b-8f8e86c135ea
0	6	6	Plazi	ffb07bec-2d10-492d-9c37-361fe0b79427	cd541dad-c385-42c7-848c-4303c55a10d7
0	9	9	Ocean Biodiversity Information System	ba0670b9-4186-41e6-8e70-f9cb3065551a	d2008378-84c9-4809-95ed-84cbf1bd0849
1950	1950	0	GBIF France	da44cd31-5901-4687-a106-6d1c7734ee3a	d481ac84-37d2-418a-8b59-d82269a188a9
716	716	0	Biodiversity Information System of Mexico	b324e8e9-9a4c-44fa-8f1a-7f39ea7ab576	d881b95c-dd14-4555-86db-d91ff5283c59
5187	5187	0	Atlas of Living Australia	4a6f1b71-969e-4fc5-a693-282b05e1220c	dab5a4c8-2dd8-48cc-8960-4be487d8995a
0	888	888	GBIF Benin	efb9c00e-f802-45dd-8826-a52ec45b89ff	dabfb4a1-ed02-447b-b150-a9d8daf82e36
0	5	5	Plazi	ffb07bec-2d10-492d-9c37-361fe0b79427	dd598c34-9798-48d1-8cd8-200b329ca86c
0	7775	7775	National Biodiversity Network	d897a5b9-35ee-4232-94bd-b0bcaac003c2	ddcc85ee-cb47-47a6-8789-711d6852145a
3	3	0	Plazi	ffb07bec-2d10-492d-9c37-361fe0b79427	de7813b6-9067-4f9c-a02e-c45f1d5ac379
0	1	1	Plazi	ffb07bec-2d10-492d-9c37-361fe0b79427	dfc7a855-b314-412f-83ed-9105497bdca8
1898	1898	0	Colombian Biodiversity Information System	7e865cba-7c46-417b-ade5-97f2cf5b7be0	e0214551-c230-490e-aa9a-51913b74d60c
7486	7486	0	GBIF Brazil	cdc9736d-5ff7-4ece-9959-3c744360cdb3	e1278068-7d2d-44e0-8274-a46ae6ebf957
148651	148651	0	National Biodiversity Network	d897a5b9-35ee-4232-94bd-b0bcaac003c2	e5a6c31a-a253-4f87-a2a7-f2d18cd82be0
49	49	0	Participant Node Managers Committee	7f48e0c8-5c96-49ec-b972-30748e339115	e756296a-275f-4c05-af4c-3f244b78cfd1
31	31	0	Indonesian Biodiversity Information Facility	2ebd91f6-f14f-4375-b525-c011a3774f03	ea2c11dc-7e7d-41db-b556-ea6b72bec370
0	1	1	Plazi	ffb07bec-2d10-492d-9c37-361fe0b79427	ea671b7b-5821-4ce1-91ab-18f02d33380c
376	376	0	GBIF Brazil	cdc9736d-5ff7-4ece-9959-3c744360cdb3	ef0ff88d-96e2-4716-886d-8e821e33125e
153	153	0	Plazi	ffb07bec-2d10-492d-9c37-361fe0b79427	eff59168-ceb3-489f-8fa5-e1f83aff2473
5920	5920	0	Netherlands Biodiversity Information Facility	0909d601-bda2-42df-9e63-a6d51847ebce	f02240a8-f206-467b-a379-fdce36beb808
73	73	0	GBIF France	da44cd31-5901-4687-a106-6d1c7734ee3a	f0292c75-bc1a-4e82-9c90-0e74f8430ad2
488	488	0	GBIF France	da44cd31-5901-4687-a106-6d1c7734ee3a	f367501d-f153-4a34-83ac-727a902c6c80
602	602	0	Netherlands Biodiversity Information Facility	0909d601-bda2-42df-9e63-a6d51847ebce	f3df8fbc-435b-42c3-a4d6-81fff868eaf4
28180	28340	160	GBIF Germany	4f6826f2-4ff6-443d-b966-e6913bd24013	f6a07b42-1d2c-11e2-8fd4-00145eb45e9a
2215	2215	0	Ocean Biodiversity Information System	ba0670b9-4186-41e6-8e70-f9cb3065551a	f97f5c65-9a82-436b-a751-fcd0e9be09cc
38	38	0	Plazi	ffb07bec-2d10-492d-9c37-361fe0b79427	fb6fbaa8-c279-408d-bbf5-d1dbe71f5827
4559	4559	0	GBIF France	da44cd31-5901-4687-a106-6d1c7734ee3a	fcf04204-5787-44d9-a987-d2fc2132b141
308	308	0	Belgian Biodiversity Platform	fb11cfe1-ebc3-45af-9159-17d9fddbcdac	fd5f9044-c95c-4e47-b3d1-8dbc34cc941a
276	276	0	National Biodiversity Network	d897a5b9-35ee-4232-94bd-b0bcaac003c2	00152458-37ab-4698-b3fc-1b0cfb5c15d8
452	452	0	GBIF Germany	4f6826f2-4ff6-443d-b966-e6913bd24013	00601f06-1ebf-442a-a966-59955b060fb9
375	375	0	GBIF Germany	4f6826f2-4ff6-443d-b966-e6913bd24013	01fdde0a-a371-45b6-a6a2-5656d57e3280
472	472	0	GBIF France	da44cd31-5901-4687-a106-6d1c7734ee3a	038b53c5-cd89-4fb0-8de5-ffeef39852e1
3	3	0	Plazi	ffb07bec-2d10-492d-9c37-361fe0b79427	04de1a71-1492-4258-af1b-3220d16bfc6f
588	588	0	Ocean Biodiversity Information System	ba0670b9-4186-41e6-8e70-f9cb3065551a	0628cc70-37e0-4353-949d-e3990bc2a341
39	39	0	Plazi	ffb07bec-2d10-492d-9c37-361fe0b79427	0986a097-6033-4eb5-b807-5aad00c01867
0	1	1	Plazi	ffb07bec-2d10-492d-9c37-361fe0b79427	0a5bb021-1807-408b-962c-d5c72bbc9bd6
22	22	0	GBIF France	da44cd31-5901-4687-a106-6d1c7734ee3a	0fae86e4-daf4-454f-bb65-1e914db90a0c
120	120	0	Biodiversity Information System of Mexico	b324e8e9-9a4c-44fa-8f1a-7f39ea7ab576	1255d042-51b9-421d-b9c7-1eb4b1fd7399
1	1	0	Plazi	ffb07bec-2d10-492d-9c37-361fe0b79427	1383594d-075a-4470-aa09-14ad83583269
476	476	0	Colombian Biodiversity Information System	7e865cba-7c46-417b-ade5-97f2cf5b7be0	138c2def-70c0-416c-b341-5004318f6c66
122	122	0	Biodiversity Information System of Mexico	b324e8e9-9a4c-44fa-8f1a-7f39ea7ab576	14dca6a9-d413-451f-9fa5-352637bfde83
2	2	0	Plazi	ffb07bec-2d10-492d-9c37-361fe0b79427	15befca6-8842-4946-be45-d91935bb2001
1040	1040	0	GBIF France	da44cd31-5901-4687-a106-6d1c7734ee3a	16734bd8-00cb-48ea-81fd-bdc2b0dcee38
0	2	2	Plazi	ffb07bec-2d10-492d-9c37-361fe0b79427	172b5270-7bf0-4b19-9398-19d50282cd2c
10	10	0	Plazi	ffb07bec-2d10-492d-9c37-361fe0b79427	19cc94c0-2dfc-4e0c-a23c-095317820a66
1	1	0	Plazi	ffb07bec-2d10-492d-9c37-361fe0b79427	1f5e680e-79e1-4508-bf9d-a6aeeb015caa
0	2	2	Plazi	ffb07bec-2d10-492d-9c37-361fe0b79427	1f87b260-4342-48d6-a790-bd973d48db7f
0	2	2	Plazi	ffb07bec-2d10-492d-9c37-361fe0b79427	205204db-d331-480c-abeb-2dad27e18d50
0	2	2	Plazi	ffb07bec-2d10-492d-9c37-361fe0b79427	2054ca31-b068-4436-8d5f-6ff7ff48329b
0	14	14	Ocean Biodiversity Information System	ba0670b9-4186-41e6-8e70-f9cb3065551a	244c7d56-924d-4537-9a2f-706520656edf
0	4	4	Plazi	ffb07bec-2d10-492d-9c37-361fe0b79427	25ba72ac-dca5-4fdc-8ba0-00988ff70ba9
0	3782	3782	GBIF France	da44cd31-5901-4687-a106-6d1c7734ee3a	2c5cd152-a902-415a-916f-4e65b32343c5
455	538	83	Participant Node Managers Committee	7f48e0c8-5c96-49ec-b972-30748e339115	2cb096d9-0171-4790-ae5b-32a0524a3669
0	27506	27506	Ocean Biodiversity Information System	ba0670b9-4186-41e6-8e70-f9cb3065551a	2de18034-dda6-48c4-9365-b45a478b8a7e
0	5622	5622	Colombian Biodiversity Information System	7e865cba-7c46-417b-ade5-97f2cf5b7be0	2fda04c8-2a22-4d16-8c1c-48bde4e1f118
46	46	0	Plazi	ffb07bec-2d10-492d-9c37-361fe0b79427	30230f9f-1184-4b24-a83f-d1fab4d71eea
15615	15615	0	Participant Node Managers Committee	7f48e0c8-5c96-49ec-b972-30748e339115	3bcdf4d1-4416-431b-8c33-4f28222533b1
196	196	0	Participant Node Managers Committee	7f48e0c8-5c96-49ec-b972-30748e339115	3cd7753a-8724-4633-a147-ef4d50d35880
5	5	0	Plazi	ffb07bec-2d10-492d-9c37-361fe0b79427	3ff7ed27-415e-426c-8ea9-64c90a590530
0	5	5	Ocean Biodiversity Information System	ba0670b9-4186-41e6-8e70-f9cb3065551a	40d727d8-ec9c-4d3c-a8a7-51941c16c637
90	90	0	Plazi	ffb07bec-2d10-492d-9c37-361fe0b79427	4460932c-a39b-4b53-9346-2c0cfa8cd6d7
126	126	0	GBIF France	da44cd31-5901-4687-a106-6d1c7734ee3a	44fcb36c-4999-4d81-906d-12435b59229e
5429	5429	0	Colombian Biodiversity Information System	7e865cba-7c46-417b-ade5-97f2cf5b7be0	48249f10-4b89-4b56-a1d8-83a6297bd0c7
312	312	0	GBIF Germany	4f6826f2-4ff6-443d-b966-e6913bd24013	4975ef02-e7cf-47b1-b659-8eec5e79ac30
377	377	0	GBIF Spain	1f94b3ca-9345-4d65-afe2-4bace93aa0fe	497d9260-46fc-402c-84fd-e16f78268cd4
2056	1938	-118	Biodiversity Information System of Mexico	b324e8e9-9a4c-44fa-8f1a-7f39ea7ab576	4a76f6d6-5d77-4754-8aa9-adfd1e846eda
9	9	0	Plazi	ffb07bec-2d10-492d-9c37-361fe0b79427	4a7b7bb1-7033-4bc6-817c-08a91ccc79f6
0	2	2	Ocean Biodiversity Information System	ba0670b9-4186-41e6-8e70-f9cb3065551a	4b59d3f4-ae05-4072-bee3-71ce47295586
3115	3115	0	GBIF France	da44cd31-5901-4687-a106-6d1c7734ee3a	4d39e987-1e6a-4e78-ad5f-39a8c8846ebf
0	10692	10692	Ocean Biodiversity Information System	ba0670b9-4186-41e6-8e70-f9cb3065551a	50914b57-6c66-4432-91c7-edbc7a296a9f
5	5	0	GBIF Germany	4f6826f2-4ff6-443d-b966-e6913bd24013	52c460e5-c322-4bc7-9eea-b4beee2b8920
0	6	6	Plazi	ffb07bec-2d10-492d-9c37-361fe0b79427	565d09b1-8934-4ecd-8e46-aebdbf3c801f
1	1	0	Plazi	ffb07bec-2d10-492d-9c37-361fe0b79427	577b9b02-aced-4d2a-86f5-c0daaebf564d
850	850	0	Korean Biodiversity Information Facility	e0a1e772-0177-4800-94b4-2d023fe6cdf4	58bc85a4-0dea-465f-b2e8-b3e81ad201b4
14	14	0	Atlas of Living Australia	4a6f1b71-969e-4fc5-a693-282b05e1220c	59997fb4-d940-4305-90b4-6dee190260bd
40	40	0	Participant Node Managers Committee	7f48e0c8-5c96-49ec-b972-30748e339115	5b6ada34-3ea6-4555-b45b-f698ccd1b15e
0	1073	1073	Colombian Biodiversity Information System	7e865cba-7c46-417b-ade5-97f2cf5b7be0	5d5f990b-18da-452b-9481-cee96709285a
1862	1862	0	GBIF Brazil	cdc9736d-5ff7-4ece-9959-3c744360cdb3	5ddd59c2-c291-4a74-8a25-933bf873d4a4
837	837	0	GBIF Finland	dd514216-5c7c-45f3-910d-797424cb5be6	5f4ee9ad-6c14-4077-8ddc-62e25c09b3df
0	2	2	Plazi	ffb07bec-2d10-492d-9c37-361fe0b79427	601437bd-40a5-40dc-8fda-72b0aa119041
66	66	0	Participant Node Managers Committee	7f48e0c8-5c96-49ec-b972-30748e339115	605b7dae-8645-482b-b9ed-19e6e0edd5f1
96	96	0	GBIF Germany	4f6826f2-4ff6-443d-b966-e6913bd24013	612772fe-f762-11e1-a439-00145eb45e9a
0	115	115	Atlas of Living Australia	4a6f1b71-969e-4fc5-a693-282b05e1220c	6295aeaf-a5f3-4832-8d8e-b2e1c9e3a015
3	3	0	Plazi	ffb07bec-2d10-492d-9c37-361fe0b79427	62a26005-245c-4298-ae96-2de02d77897b
0	52	52	Plazi	ffb07bec-2d10-492d-9c37-361fe0b79427	6375cc5c-ff07-40a5-bc53-68d06da2fc9f
108	108	0	GBIF Germany	4f6826f2-4ff6-443d-b966-e6913bd24013	63f8d4d2-f762-11e1-a439-00145eb45e9a
56	56	0	Plazi	ffb07bec-2d10-492d-9c37-361fe0b79427	6477a7bb-a261-443a-a462-137a6db3c7f5
0	89	89	Biodiversity Information System of Mexico	b324e8e9-9a4c-44fa-8f1a-7f39ea7ab576	64cbd0c5-4e22-4051-980e-89bec687f18c
229	218	-11	GBIF Germany	4f6826f2-4ff6-443d-b966-e6913bd24013	65f3bdec-f762-11e1-a439-00145eb45e9a
258	258	0	GBIF France	da44cd31-5901-4687-a106-6d1c7734ee3a	664c2f54-0bfc-4b19-ad58-e1d57f8ff27b
34	34	0	GBIF Germany	4f6826f2-4ff6-443d-b966-e6913bd24013	6788c2d8-f762-11e1-a439-00145eb45e9a
88	88	0	GBIF Germany	4f6826f2-4ff6-443d-b966-e6913bd24013	6853f48a-f762-11e1-a439-00145eb45e9a
6	6	0	GBIF Germany	4f6826f2-4ff6-443d-b966-e6913bd24013	693f42fa-f762-11e1-a439-00145eb45e9a
173	173	0	GBIF Germany	4f6826f2-4ff6-443d-b966-e6913bd24013	6a34d094-f762-11e1-a439-00145eb45e9a
12	12	0	GBIF Germany	4f6826f2-4ff6-443d-b966-e6913bd24013	6bc5b0cc-f762-11e1-a439-00145eb45e9a
53	53	0	GBIF France	da44cd31-5901-4687-a106-6d1c7734ee3a	6e6cb943-df9b-4f24-860b-623861589960
80889	80889	0	National Biodiversity Network	d897a5b9-35ee-4232-94bd-b0bcaac003c2	6f86b84a-4a96-4c56-905c-3bfdd6ca9023
12	12	0	GBIF Germany	4f6826f2-4ff6-443d-b966-e6913bd24013	6fd4b726-f762-11e1-a439-00145eb45e9a
301	301	0	GBIF Germany	4f6826f2-4ff6-443d-b966-e6913bd24013	7124b64e-f762-11e1-a439-00145eb45e9a
446	446	0	GBIF Germany	4f6826f2-4ff6-443d-b966-e6913bd24013	718f7ede-f762-11e1-a439-00145eb45e9a
90	90	0	National Biodiversity Network	d897a5b9-35ee-4232-94bd-b0bcaac003c2	747283a7-1f37-4f2b-b2b6-807bd749378b
640	640	0	GBIF Germany	4f6826f2-4ff6-443d-b966-e6913bd24013	74a80820-f762-11e1-a439-00145eb45e9a
141	141	0	GBIF France	da44cd31-5901-4687-a106-6d1c7734ee3a	74effae0-6793-4715-8e01-f49511497018
22	22	0	GBIF Germany	4f6826f2-4ff6-443d-b966-e6913bd24013	74fb2848-f762-11e1-a439-00145eb45e9a
413	413	0	GBIF Germany	4f6826f2-4ff6-443d-b966-e6913bd24013	75968cb6-f762-11e1-a439-00145eb45e9a
1716	1716	0	National Biodiversity Network	d897a5b9-35ee-4232-94bd-b0bcaac003c2	76c0015e-c6e5-4039-acd8-b411ca0a67ff
2293	2293	0	Belgian Biodiversity Platform	fb11cfe1-ebc3-45af-9159-17d9fddbcdac	781747f1-ebab-4eb0-beaf-1f88b3cfd65d
428	428	0	Biodiversity Information System of Mexico	b324e8e9-9a4c-44fa-8f1a-7f39ea7ab576	78879d0f-486e-4bf8-bfc8-e2c66bf63446
825	499	-326	GBIF Germany	4f6826f2-4ff6-443d-b966-e6913bd24013	792f74fa-f762-11e1-a439-00145eb45e9a
1603	1603	0	Korean Biodiversity Information Facility	e0a1e772-0177-4800-94b4-2d023fe6cdf4	7b27be70-f762-11e1-a439-00145eb45e9a
56	56	0	GBIF Portugal	673f7038-4262-4149-b753-5658a4e912f6	7bee867f-9d6a-4fb9-ac74-0072a285c216
1	1	0	Plazi	ffb07bec-2d10-492d-9c37-361fe0b79427	7c04b724-55fb-4bff-9382-0391f362c22c
109	109	0	GBIF Germany	4f6826f2-4ff6-443d-b966-e6913bd24013	7d13231e-f762-11e1-a439-00145eb45e9a
2016	2016	0	GBIF Germany	4f6826f2-4ff6-443d-b966-e6913bd24013	7d2422fe-f762-11e1-a439-00145eb45e9a
0	2	2	Ocean Biodiversity Information System	ba0670b9-4186-41e6-8e70-f9cb3065551a	7d4b4fc8-ad38-4745-a876-b8e4b5001a17
77	77	0	Plazi	ffb07bec-2d10-492d-9c37-361fe0b79427	7f19f81d-eed1-4d91-a8bd-081b805056ff
2698	2698	0	Biodiversity Information System of Mexico	b324e8e9-9a4c-44fa-8f1a-7f39ea7ab576	80d6e8c8-f762-11e1-a439-00145eb45e9a
6	6	0	Plazi	ffb07bec-2d10-492d-9c37-361fe0b79427	80ff4e7a-98fa-4e34-a3fd-63afdc4ee6c1
15	15	0	GBIF Germany	4f6826f2-4ff6-443d-b966-e6913bd24013	815898fa-f762-11e1-a439-00145eb45e9a
6251	6152	-99	GBIF Germany	4f6826f2-4ff6-443d-b966-e6913bd24013	81b2a96c-f762-11e1-a439-00145eb45e9a
570	570	0	GBIF Germany	4f6826f2-4ff6-443d-b966-e6913bd24013	81f943e0-f762-11e1-a439-00145eb45e9a
180	180	0	GBIF Germany	4f6826f2-4ff6-443d-b966-e6913bd24013	822bd0c6-f762-11e1-a439-00145eb45e9a
48437	48437	0	National Biodiversity Network	d897a5b9-35ee-4232-94bd-b0bcaac003c2	82d9ff5c-f762-11e1-a439-00145eb45e9a
8	8	0	Plazi	ffb07bec-2d10-492d-9c37-361fe0b79427	8310713c-38e5-4c1e-9f6d-9c54e62bce52
1599	1599	0	GBIF Spain	1f94b3ca-9345-4d65-afe2-4bace93aa0fe	83880886-f762-11e1-a439-00145eb45e9a
8603	8603	0	GBIF Germany	4f6826f2-4ff6-443d-b966-e6913bd24013	85ad6c96-f762-11e1-a439-00145eb45e9a
42	42	0	Plazi	ffb07bec-2d10-492d-9c37-361fe0b79427	85b3a8bb-92c0-4d89-b6fe-3dfee3303b0b
0	142363	142363	U.S. Geological Survey	8618c64a-93e0-4300-b546-7249e5148ed2	8674480c-ebdc-42cf-8d42-c3762fe137d8
41646	41646	0	GBIF Brazil	cdc9736d-5ff7-4ece-9959-3c744360cdb3	86aba78e-f762-11e1-a439-00145eb45e9a
14	14	0	GBIF Germany	4f6826f2-4ff6-443d-b966-e6913bd24013	88935a1a-f762-11e1-a439-00145eb45e9a
1000	1000	0	GBIF Japan	db5705aa-6a6e-42f1-8942-d77b9f4896ea	89949a00-17da-4c33-98ab-ef23a0ff6424
376	376	0	Plazi	ffb07bec-2d10-492d-9c37-361fe0b79427	8cd88652-1627-4fbe-891d-062b3e02e511
17	17	0	Plazi	ffb07bec-2d10-492d-9c37-361fe0b79427	8d3ebbcd-55af-48a3-a7e5-525abb06c324
13	10	-3	GBIF Germany	4f6826f2-4ff6-443d-b966-e6913bd24013	8d65701e-f762-11e1-a439-00145eb45e9a
5304	15828	10524	GBIF Japan	db5705aa-6a6e-42f1-8942-d77b9f4896ea	8db2b2ef-78d4-4f48-93e0-1a960594b44b
60	7	-53	GBIF Germany	4f6826f2-4ff6-443d-b966-e6913bd24013	8dcee404-f762-11e1-a439-00145eb45e9a
418	418	0	GBIF Germany	4f6826f2-4ff6-443d-b966-e6913bd24013	8fc0f216-f762-11e1-a439-00145eb45e9a
424	333	-91	GBIF Germany	4f6826f2-4ff6-443d-b966-e6913bd24013	8fd51f8e-f762-11e1-a439-00145eb45e9a
18	15	-3	GBIF Germany	4f6826f2-4ff6-443d-b966-e6913bd24013	9144504c-f762-11e1-a439-00145eb45e9a
137	166	29	GBIF Germany	4f6826f2-4ff6-443d-b966-e6913bd24013	9225770c-f762-11e1-a439-00145eb45e9a
209	209	0	GBIF Germany	4f6826f2-4ff6-443d-b966-e6913bd24013	92b1adb2-f762-11e1-a439-00145eb45e9a
300	300	0	GBIF Portugal	673f7038-4262-4149-b753-5658a4e912f6	932927e7-ef5b-42ca-add3-bd07e0c3b871
1803	1803	0	GBIF Finland	dd514216-5c7c-45f3-910d-797424cb5be6	95ec4bf4-f762-11e1-a439-00145eb45e9a
236	236	0	GBIF France	da44cd31-5901-4687-a106-6d1c7734ee3a	96bcb08a-e06a-4a67-b278-738651928bb9
0	346	346	Colombian Biodiversity Information System	7e865cba-7c46-417b-ade5-97f2cf5b7be0	97589bce-2a45-41e3-98fd-5a801850b33a
153	153	0	GBIF Germany	4f6826f2-4ff6-443d-b966-e6913bd24013	978e88c8-f762-11e1-a439-00145eb45e9a
74	74	0	Plazi	ffb07bec-2d10-492d-9c37-361fe0b79427	98d46a53-c342-4e19-b613-8300c3ad56d1
2834	2834	0	National Biodiversity Network	d897a5b9-35ee-4232-94bd-b0bcaac003c2	990affce-eda0-41e7-b831-efabab174106
0	502	502	Ocean Biodiversity Information System	ba0670b9-4186-41e6-8e70-f9cb3065551a	9c4924f0-a22a-4c5b-8c38-0a9f7b3a73e7
316	316	0	GBIF Norway	4f829580-180d-46a9-9c87-ed8ec959b545	9cc95cb1-d97a-4c35-9d0e-5de8a6e2f134
1824	1824	0	GBIF Norway	4f829580-180d-46a9-9c87-ed8ec959b545	9d1faf2a-1383-43a3-9862-2d5028eca053
1	1	0	Plazi	ffb07bec-2d10-492d-9c37-361fe0b79427	9eb6bf82-e980-487b-ae49-6a2ca3ad772a
21	21	0	Plazi	ffb07bec-2d10-492d-9c37-361fe0b79427	9f636bad-4eab-4929-83b8-4f1b550c5b33
2128	2128	0	GBIF Germany	4f6826f2-4ff6-443d-b966-e6913bd24013	a11b6d8f-56da-4c5c-9349-83413807847f
0	15	15	Plazi	ffb07bec-2d10-492d-9c37-361fe0b79427	a1374f4d-af28-4778-9689-c2105e16660c
2645	2645	0	Polish Biodiversity Information Network	2618bfdf-e194-4911-a241-80db3107bc51	a4718800-1495-11de-bab0-b8a03c50a862
3	3	0	Plazi	ffb07bec-2d10-492d-9c37-361fe0b79427	a9c1db8a-7089-400a-bf62-cfc671e3b70c
235	235	0	GBIF Germany	4f6826f2-4ff6-443d-b966-e6913bd24013	ab32d886-00fa-4b74-92a4-fef2e9e209ac
0	1	1	Plazi	ffb07bec-2d10-492d-9c37-361fe0b79427	ac2def2f-7a9a-4585-baed-c50ffe8cddaf
222	222	0	Colombian Biodiversity Information System	7e865cba-7c46-417b-ade5-97f2cf5b7be0	ad5a856f-8767-46f0-9201-045e0945ca22
5	5	0	Plazi	ffb07bec-2d10-492d-9c37-361fe0b79427	af84b96d-720b-47e6-9fe5-804ccd865659
0	4	4	Plazi	ffb07bec-2d10-492d-9c37-361fe0b79427	af9fa8a9-6374-4b14-b037-fe6d44505dc1
17	17	0	Colombian Biodiversity Information System	7e865cba-7c46-417b-ade5-97f2cf5b7be0	b4a909e7-f5f1-46b7-8ca7-2687742ae63c
47	47	0	Plazi	ffb07bec-2d10-492d-9c37-361fe0b79427	b56cc193-14a7-4acb-8d32-c777f8af24ec
5	5	0	Plazi	ffb07bec-2d10-492d-9c37-361fe0b79427	b8aa2bb3-ff16-477c-a804-5cb4b1344330
12187	12187	0	National Biodiversity Network	d897a5b9-35ee-4232-94bd-b0bcaac003c2	b98eeda7-aea1-469b-9044-9bd6f251e6e3
0	56	56	Plazi	ffb07bec-2d10-492d-9c37-361fe0b79427	ba3917da-96c6-4438-8365-b445ce0dbb2a
0	8505	8505	GBIF Finland	dd514216-5c7c-45f3-910d-797424cb5be6	bc6d4ac6-a710-456e-b75f-8dbaf540eab3
2	2	0	Plazi	ffb07bec-2d10-492d-9c37-361fe0b79427	bd02e3c5-6920-4592-968d-2ffdb424dace
0	145	145	Plazi	ffb07bec-2d10-492d-9c37-361fe0b79427	be62f361-5e14-4ce2-8990-484865f899c7
21	21	0	Plazi	ffb07bec-2d10-492d-9c37-361fe0b79427	bea08b82-f1da-4fca-987f-820360af0e8f
2948	2948	0	GBIF Germany	4f6826f2-4ff6-443d-b966-e6913bd24013	c2eb8c10-be34-433f-b0e4-bae5d327bcdf
17008	17529	521	GBIF Norway	4f829580-180d-46a9-9c87-ed8ec959b545	c6a2ecf7-f9d2-4443-91b6-199f00aa01a2
245	245	0	GBIF France	da44cd31-5901-4687-a106-6d1c7734ee3a	c74c6e0f-39fc-456f-bcec-b1966ac66b49
0	36	36	Plazi	ffb07bec-2d10-492d-9c37-361fe0b79427	c9232a85-5a09-440a-9ede-102073e7b6f0
0	4	4	Plazi	ffb07bec-2d10-492d-9c37-361fe0b79427	cb3beef6-f52f-4318-a88e-6fb8cc9760b6
0	16	16	Plazi	ffb07bec-2d10-492d-9c37-361fe0b79427	cbe4d0ea-84dc-4beb-b22a-d48c626fe3dc
144	144	0	GBIF France	da44cd31-5901-4687-a106-6d1c7734ee3a	cce6c531-12fa-4809-9560-6652a735d4fc
5587	5587	0	Canada Biodiversity Information Facility	8f83fc96-c966-4126-83f7-bf044dc49efa	cd309a69-421b-4317-a61e-483333be3cb9
1046	1046	0	Polish Biodiversity Information Network	2618bfdf-e194-4911-a241-80db3107bc51	cdbc4740-2fe8-11de-816f-b8a03c50a862
0	35	35	Plazi	ffb07bec-2d10-492d-9c37-361fe0b79427	d0912529-3de7-4704-92b2-7714623d8222
42493	42493	0	GBIF Norway	4f829580-180d-46a9-9c87-ed8ec959b545	d30a617e-cac3-470c-a070-601376f45d6b
0	2	2	Plazi	ffb07bec-2d10-492d-9c37-361fe0b79427	d5999896-a781-4d3b-8b3e-6399cfd072fb
509226	526475	17249	U.S. Geological Survey	8618c64a-93e0-4300-b546-7249e5148ed2	d6cc311c-c5ab-4f23-9a20-10514f9eb9c4
40	40	0	Plazi	ffb07bec-2d10-492d-9c37-361fe0b79427	d8036fa9-32eb-4c5f-bdb2-428d22250ea8
0	3	3	Plazi	ffb07bec-2d10-492d-9c37-361fe0b79427	da2d1ef8-052d-44fc-8abf-8042b986816c
18151	18151	0	GBIF France	da44cd31-5901-4687-a106-6d1c7734ee3a	db1ab877-1ab2-4890-921a-fcad741c37fc
627	627	0	Biodiversity Information System of Mexico	b324e8e9-9a4c-44fa-8f1a-7f39ea7ab576	db88753b-744c-460d-891a-e0b88eea13bb
0	10	10	Plazi	ffb07bec-2d10-492d-9c37-361fe0b79427	e01c61af-391c-4de0-beab-ca7c2393c236
0	1667	1667	Ocean Biodiversity Information System	ba0670b9-4186-41e6-8e70-f9cb3065551a	e1f3ca58-eadf-40cb-956d-d8d93f40e1e4
131	131	0	GBIF France	da44cd31-5901-4687-a106-6d1c7734ee3a	e3096c7e-f927-4f54-a582-4acd0566ea83
0	1	1	Plazi	ffb07bec-2d10-492d-9c37-361fe0b79427	e703b565-88be-4127-9b2d-2eee283af26a
25	25	0	Plazi	ffb07bec-2d10-492d-9c37-361fe0b79427	e775079e-1eed-446a-b696-2ed7664f4b22
23	23	0	Plazi	ffb07bec-2d10-492d-9c37-361fe0b79427	e81a7542-2603-4280-8fd9-a2c9c211b333
7823	8291	468	GBIF Brazil	cdc9736d-5ff7-4ece-9959-3c744360cdb3	eb63cc46-126f-43b2-9c3e-0f03a97e0638
2173	2173	0	GBIF Brazil	cdc9736d-5ff7-4ece-9959-3c744360cdb3	ebef3538-550e-4169-b9ac-bfa0d14ec25a
0	10217	10217	GBIF Japan	db5705aa-6a6e-42f1-8942-d77b9f4896ea	ed656115-9283-4be9-a91a-eb7ff39b0f99
901	901	0	GBIF France	da44cd31-5901-4687-a106-6d1c7734ee3a	ef9c2624-7de8-44e2-9b0c-662cff407450
3142	4016	874	GBIF Japan	db5705aa-6a6e-42f1-8942-d77b9f4896ea	f307cee9-2f0b-4b3d-8774-f86cc17e60c8
100	100	0	GBIF France	da44cd31-5901-4687-a106-6d1c7734ee3a	f43a73b1-24b9-4e1a-a7e7-4b9996150046
0	3	3	Plazi	ffb07bec-2d10-492d-9c37-361fe0b79427	f4b7e77a-07f1-4369-8c6a-73456c97a772
7351	7351	0	GBIF France	da44cd31-5901-4687-a106-6d1c7734ee3a	f6e737bf-349b-4731-81d1-330d8fe025e7
0	36	36	Plazi	ffb07bec-2d10-492d-9c37-361fe0b79427	f7036c44-0459-4d22-be5b-00925904f820
1197	1197	0	South African Biodiversity Information Facility	7190b835-4e86-4b6e-85c1-19cc6677c250	f703b08e-008e-438c-ad2d-58d544825692
29	29	0	GBIF France	da44cd31-5901-4687-a106-6d1c7734ee3a	f922a7d1-6fda-4fc7-9a42-14d6b8c3e100
4307	4307	0	Biodiversity Information System of Mexico	b324e8e9-9a4c-44fa-8f1a-7f39ea7ab576	f9232cc7-b88c-468d-bb94-b42595c73c42
61	61	0	U.S. Geological Survey	8618c64a-93e0-4300-b546-7249e5148ed2	fa0deeff-743c-411f-9934-b17d9f4512f8
0	1125	1125	Ocean Biodiversity Information System	ba0670b9-4186-41e6-8e70-f9cb3065551a	fb390f93-aacc-48be-b2fc-8f2b1d9c72b9
15	15	0	Plazi	ffb07bec-2d10-492d-9c37-361fe0b79427	0010c4e6-f37b-40c6-a2fc-f03234cd0a1e
34309	34309	0	National Biodiversity Network	d897a5b9-35ee-4232-94bd-b0bcaac003c2	00539f2f-63f5-4f87-8df7-75b62293cb1d
802	802	0	Korean Biodiversity Information Facility	e0a1e772-0177-4800-94b4-2d023fe6cdf4	018e5443-c958-4483-8af8-a596925b075c
3142	3142	0	GBIF France	da44cd31-5901-4687-a106-6d1c7734ee3a	0470423b-e558-4f9d-9767-0e94b711076d
7	7	0	Plazi	ffb07bec-2d10-492d-9c37-361fe0b79427	072e0cbe-fa5d-49ab-829a-b1c45f0862da
74	74	0	Colombian Biodiversity Information System	7e865cba-7c46-417b-ade5-97f2cf5b7be0	080685f0-0df9-43dd-8bd7-eb82ca54b654
38	38	0	Plazi	ffb07bec-2d10-492d-9c37-361fe0b79427	09f65810-9fd6-4660-bec7-564a0f79ef5c
244	244	0	National Biodiversity Network	d897a5b9-35ee-4232-94bd-b0bcaac003c2	0a2b1b5e-eaae-4bd5-847a-26b3e27116a5
1	1	0	Plazi	ffb07bec-2d10-492d-9c37-361fe0b79427	0a786ea6-9688-471a-b33e-20d7d5f89681
3806	3806	0	U.S. Geological Survey	8618c64a-93e0-4300-b546-7249e5148ed2	0b7656f7-4b0c-4133-abe4-5ba95492d33c
6	6	0	Plazi	ffb07bec-2d10-492d-9c37-361fe0b79427	0fe8dc15-68ce-4ff6-a62a-897ea2349506
101	101	0	GBIF France	da44cd31-5901-4687-a106-6d1c7734ee3a	11e975aa-413b-4078-9a37-4aa0ad4c83b7
4	4	0	Plazi	ffb07bec-2d10-492d-9c37-361fe0b79427	12109b72-c85b-446a-9831-5908f93ca4db
8	8	0	Plazi	ffb07bec-2d10-492d-9c37-361fe0b79427	124cf12f-4c32-469e-a991-da5f43482c99
6	6	0	Plazi	ffb07bec-2d10-492d-9c37-361fe0b79427	13560dec-1452-4411-a000-d9d6348313e6
0	6	6	Participant Node Managers Committee	7f48e0c8-5c96-49ec-b972-30748e339115	13fe7298-dc03-416b-a643-2f617c7dd73d
2407	2407	0	GBIF Madagascar	2dbfc5c5-51b5-4494-9dfc-4d3f013a3b64	15d76f87-6d16-4948-b4d5-f7d50a168aa6
46	46	0	Plazi	ffb07bec-2d10-492d-9c37-361fe0b79427	16b30051-6c33-4c03-9287-f99750d988cf
0	47	47	Plazi	ffb07bec-2d10-492d-9c37-361fe0b79427	173cf168-6357-4b76-955f-7b523590ff1d
675	675	0	GBIF France	da44cd31-5901-4687-a106-6d1c7734ee3a	185c3fae-7b47-4711-bec3-912ca9b2685d
4713	4713	0	National Biodiversity Network	d897a5b9-35ee-4232-94bd-b0bcaac003c2	1b851d7f-fc92-4e95-87a2-9fe577069e19
5	5	0	Plazi	ffb07bec-2d10-492d-9c37-361fe0b79427	1bbd6a6e-ab4c-493d-8996-30f5fad15d0f
531	531	0	GBIF Brazil	cdc9736d-5ff7-4ece-9959-3c744360cdb3	1edcfe6d-da55-4d59-b30e-468cd21f8b0b
79	79	0	GBIF Guinea	b1cd2e84-c4ba-47bd-b72a-dfd1f92dce0a	20057106-9922-486c-bf7b-e58461626172
0	25	25	Plazi	ffb07bec-2d10-492d-9c37-361fe0b79427	238dd2d3-f38f-4e11-a2be-87c16ff21dd8
314	447	133	GBIF Japan	db5705aa-6a6e-42f1-8942-d77b9f4896ea	24168265-33c2-4342-a6d5-fad89ecf877b
10	10	0	Plazi	ffb07bec-2d10-492d-9c37-361fe0b79427	2673e55b-aad9-48a6-9862-6c93abea7d3c
295	295	0	GBIF France	da44cd31-5901-4687-a106-6d1c7734ee3a	26dcbd44-cb80-457a-926a-e41052110d93
0	436	436	U.S. Geological Survey	8618c64a-93e0-4300-b546-7249e5148ed2	289ccc30-41c1-477b-b398-897561bb077e
6	6	0	Plazi	ffb07bec-2d10-492d-9c37-361fe0b79427	2a6f2f2b-d4ff-4d07-8516-0859bfecb027
0	2	2	Plazi	ffb07bec-2d10-492d-9c37-361fe0b79427	2f0b9ca5-7b10-4bbe-af2b-dc649e0f65ea
4	4	0	Plazi	ffb07bec-2d10-492d-9c37-361fe0b79427	30f96cf9-2d23-4242-9139-74162f72ac48
0	7550	7550	Participant Node Managers Committee	7f48e0c8-5c96-49ec-b972-30748e339115	321e6294-7e96-44c2-ac5d-6b009ef17618
640	640	0	Colombian Biodiversity Information System	7e865cba-7c46-417b-ade5-97f2cf5b7be0	34e29f87-28f2-45a0-8acb-2d27aa589a97
0	2031	2031	Indonesian Biodiversity Information Facility	2ebd91f6-f14f-4375-b525-c011a3774f03	38af1774-d162-49d1-8c17-ea50e952b1bf
2090	2090	0	GBIF Spain	1f94b3ca-9345-4d65-afe2-4bace93aa0fe	39a06c30-dcfd-4a4e-bde8-a0be882fb33f
0	147	147	Plazi	ffb07bec-2d10-492d-9c37-361fe0b79427	3a7cdaa4-c2f2-4370-9301-c2ab339b2e0d
12128	53442	41314	Biodiversity Information System of Mexico	b324e8e9-9a4c-44fa-8f1a-7f39ea7ab576	3beabb49-17c6-44eb-b13b-a107515bb653
135656	135656	0	National Biodiversity Network	d897a5b9-35ee-4232-94bd-b0bcaac003c2	3d6c8883-c29b-48f6-9fbf-9a5ad6ecbee4
308	308	0	GBIF France	da44cd31-5901-4687-a106-6d1c7734ee3a	3e33b85d-0a2c-4735-8a18-c4d93f8c3d4b
5	5	0	Plazi	ffb07bec-2d10-492d-9c37-361fe0b79427	3ed97781-eead-4ba9-9330-a4efac1a5255
0	1	1	Plazi	ffb07bec-2d10-492d-9c37-361fe0b79427	3ee58a70-115e-4250-b366-76de3e9b113c
1	1	0	Plazi	ffb07bec-2d10-492d-9c37-361fe0b79427	42070ad7-c2d0-418a-8742-bafd806a0b35
1210	1210	0	GBIF Germany	4f6826f2-4ff6-443d-b966-e6913bd24013	425afa24-e385-4076-94af-a9f173da7610
0	98720	98720	U.S. Geological Survey	8618c64a-93e0-4300-b546-7249e5148ed2	491177c8-d074-46c0-9da3-0e9d1794936f
60	60	0	GBIF Germany	4f6826f2-4ff6-443d-b966-e6913bd24013	4b3890b4-d5d1-48ae-bfdc-02e97e7eddf2
8	8	0	Plazi	ffb07bec-2d10-492d-9c37-361fe0b79427	4e7bcd4d-1cdb-45cf-b2c3-54da2466f171
1672	1672	0	National Biodiversity Network	d897a5b9-35ee-4232-94bd-b0bcaac003c2	503e8cd3-2aa6-4218-8ac7-f08c08c0fae6
9368	9368	0	National Biodiversity Network	d897a5b9-35ee-4232-94bd-b0bcaac003c2	50eb37b8-9dc8-4145-9406-e4b8b47fb843
21	21	0	Plazi	ffb07bec-2d10-492d-9c37-361fe0b79427	5513b97d-9796-43fd-94b3-557aada1afe4
30	30	0	Plazi	ffb07bec-2d10-492d-9c37-361fe0b79427	57a241fd-5993-4064-b152-b00ee0a46e2a
0	28	28	Plazi	ffb07bec-2d10-492d-9c37-361fe0b79427	607dcc60-66ea-494e-b613-ee258734404c
360	360	0	GBIF Germany	4f6826f2-4ff6-443d-b966-e6913bd24013	61459586-f762-11e1-a439-00145eb45e9a
4	4	0	GBIF Germany	4f6826f2-4ff6-443d-b966-e6913bd24013	6332da98-f762-11e1-a439-00145eb45e9a
62	62	0	GBIF Germany	4f6826f2-4ff6-443d-b966-e6913bd24013	64c5549e-f762-11e1-a439-00145eb45e9a
4548	4548	0	National Biodiversity Network	d897a5b9-35ee-4232-94bd-b0bcaac003c2	65c17ad0-67bd-412c-9e37-0cdf7db63e34
2	2	0	Plazi	ffb07bec-2d10-492d-9c37-361fe0b79427	662d0307-3c14-4301-bbc4-e05bf61ceebf
189	189	0	GBIF Germany	4f6826f2-4ff6-443d-b966-e6913bd24013	695dadee-f762-11e1-a439-00145eb45e9a
24	24	0	GBIF Germany	4f6826f2-4ff6-443d-b966-e6913bd24013	6b3db83e-f762-11e1-a439-00145eb45e9a
212	212	0	GBIF France	da44cd31-5901-4687-a106-6d1c7734ee3a	6e0c591b-8be6-4946-9e56-090037a1d9d0
823	823	0	GBIF Germany	4f6826f2-4ff6-443d-b966-e6913bd24013	6ed3d21c-f762-11e1-a439-00145eb45e9a
2	2	0	Plazi	ffb07bec-2d10-492d-9c37-361fe0b79427	6ef64f69-6a70-4898-9fbc-2b2b2b77c9e7
53	43	-10	GBIF Germany	4f6826f2-4ff6-443d-b966-e6913bd24013	70c88072-f762-11e1-a439-00145eb45e9a
69	9	-60	GBIF Germany	4f6826f2-4ff6-443d-b966-e6913bd24013	70e6cc80-f762-11e1-a439-00145eb45e9a
407096	407096	0	GBIF Estonia	2c11b821-d22b-4c64-8cd3-c1578173b129	712dba38-74cc-4704-87c0-63d1bf8484bc
8	8	0	Plazi	ffb07bec-2d10-492d-9c37-361fe0b79427	717385a9-d033-46da-a3cf-ced1a57a3547
1099	1099	0	National Biodiversity Network	d897a5b9-35ee-4232-94bd-b0bcaac003c2	725e8ac0-cadd-44e8-ac89-16b5b5c9deeb
224	224	0	GBIF Kenya	2a44d626-9f7a-4120-8a7a-4ab5ac15ff2a	7294f96c-7c04-483e-b19c-71e66253ca0f
3	3	0	Plazi	ffb07bec-2d10-492d-9c37-361fe0b79427	72b0899a-dd15-44d3-9910-b4be50231386
7	7	0	Plazi	ffb07bec-2d10-492d-9c37-361fe0b79427	730140ef-5dc1-4ec8-832b-67ec459ff30d
360	360	0	National Biodiversity Network	d897a5b9-35ee-4232-94bd-b0bcaac003c2	731161f8-0fae-4c7f-8c64-ce9c9c233fd9
60	60	0	Participant Node Managers Committee	7f48e0c8-5c96-49ec-b972-30748e339115	743988be-524a-4095-986c-824da5a8e5f4
9640	9640	0	GBIF Portugal	673f7038-4262-4149-b753-5658a4e912f6	75a0a75e-94c4-4c0f-a60d-fb424a9080d5
1381	1381	0	GBIF Germany	4f6826f2-4ff6-443d-b966-e6913bd24013	776ce3aa-f762-11e1-a439-00145eb45e9a
2	2	0	Plazi	ffb07bec-2d10-492d-9c37-361fe0b79427	7884788a-d554-497d-8dba-e6522168c7b5
153	153	0	GBIF Germany	4f6826f2-4ff6-443d-b966-e6913bd24013	7916423c-f762-11e1-a439-00145eb45e9a
741	741	0	GBIF Germany	4f6826f2-4ff6-443d-b966-e6913bd24013	79fab098-f762-11e1-a439-00145eb45e9a
263	263	0	GBIF Germany	4f6826f2-4ff6-443d-b966-e6913bd24013	7beabc7c-f762-11e1-a439-00145eb45e9a
525	510	-15	GBIF Germany	4f6826f2-4ff6-443d-b966-e6913bd24013	7bfbe8b2-f762-11e1-a439-00145eb45e9a
33	33	0	GBIF Spain	1f94b3ca-9345-4d65-afe2-4bace93aa0fe	7c1702eb-8bb7-4eb9-9a63-27b1b188fb43
0	7	7	Ocean Biodiversity Information System	ba0670b9-4186-41e6-8e70-f9cb3065551a	7c8fc64c-a2ed-483f-9814-542a4d1465a2
48	48	0	GBIF Germany	4f6826f2-4ff6-443d-b966-e6913bd24013	7d22bd4c-f762-11e1-a439-00145eb45e9a
117	117	0	GBIF Germany	4f6826f2-4ff6-443d-b966-e6913bd24013	7d6ca4fc-f762-11e1-a439-00145eb45e9a
1201	1201	0	GBIF Japan	db5705aa-6a6e-42f1-8942-d77b9f4896ea	7dd1dc3b-d3db-4a8f-8252-5f93c1b64231
66	66	0	GBIF Germany	4f6826f2-4ff6-443d-b966-e6913bd24013	7e167982-f762-11e1-a439-00145eb45e9a
128	111	-17	GBIF Germany	4f6826f2-4ff6-443d-b966-e6913bd24013	7e3c0404-f762-11e1-a439-00145eb45e9a
11232	3780	-7452	GBIF Germany	4f6826f2-4ff6-443d-b966-e6913bd24013	7e7beba0-f762-11e1-a439-00145eb45e9a
74	74	0	Plazi	ffb07bec-2d10-492d-9c37-361fe0b79427	7f5b691a-88a8-471f-a777-d19bb03ba162
326	326	0	GBIF Germany	4f6826f2-4ff6-443d-b966-e6913bd24013	7f7d4983-7024-4ca2-bf47-632f39b4d96e
2093	2093	0	Biodiversity Information System of Mexico	b324e8e9-9a4c-44fa-8f1a-7f39ea7ab576	805952e6-f762-11e1-a439-00145eb45e9a
462	462	0	GBIF France	da44cd31-5901-4687-a106-6d1c7734ee3a	8081d24f-3434-4338-83b0-8619030e468b
0	41	41	Plazi	ffb07bec-2d10-492d-9c37-361fe0b79427	818d0bc4-31a6-4319-86a3-6e6b16ab72df
2	2	0	GBIF Germany	4f6826f2-4ff6-443d-b966-e6913bd24013	81d2f1f4-f762-11e1-a439-00145eb45e9a
2867	1159	-1708	GBIF Germany	4f6826f2-4ff6-443d-b966-e6913bd24013	81e42f3c-f762-11e1-a439-00145eb45e9a
1154	1154	0	GBIF Germany	4f6826f2-4ff6-443d-b966-e6913bd24013	827c66e4-f762-11e1-a439-00145eb45e9a
14	14	0	Canada Biodiversity Information Facility	8f83fc96-c966-4126-83f7-bf044dc49efa	846f6a46-f762-11e1-a439-00145eb45e9a
1221	1221	0	Canada Biodiversity Information Facility	8f83fc96-c966-4126-83f7-bf044dc49efa	84a6d076-f762-11e1-a439-00145eb45e9a
61798	61798	0	GBIF Brazil	cdc9736d-5ff7-4ece-9959-3c744360cdb3	850b5c8c-3f36-4403-a7c6-a9f156ef0c29
1534	1534	0	GBIF Germany	4f6826f2-4ff6-443d-b966-e6913bd24013	8575f23e-f762-11e1-a439-00145eb45e9a
0	1	1	Ocean Biodiversity Information System	ba0670b9-4186-41e6-8e70-f9cb3065551a	8678f510-f195-4efd-ba25-fab510bc5c40
4120	4120	0	GBIF Japan	db5705aa-6a6e-42f1-8942-d77b9f4896ea	8691143c-f762-11e1-a439-00145eb45e9a
218	218	0	National Biodiversity Network	d897a5b9-35ee-4232-94bd-b0bcaac003c2	86d0b5c1-804c-4b98-8104-adeb1bff43c4
2	2	0	GBIF Germany	4f6826f2-4ff6-443d-b966-e6913bd24013	87a1edd8-f762-11e1-a439-00145eb45e9a
18	18	0	GBIF Germany	4f6826f2-4ff6-443d-b966-e6913bd24013	88a11e8e-f762-11e1-a439-00145eb45e9a
233	233	0	GBIF Germany	4f6826f2-4ff6-443d-b966-e6913bd24013	89b6427c-f762-11e1-a439-00145eb45e9a
412	412	0	GBIF Germany	4f6826f2-4ff6-443d-b966-e6913bd24013	8a07352e-f762-11e1-a439-00145eb45e9a
27	27	0	GBIF Germany	4f6826f2-4ff6-443d-b966-e6913bd24013	8bc2ab8c-f762-11e1-a439-00145eb45e9a
336	336	0	GBIF Malawi	2a42e4d7-ad4a-41b3-84c4-de4aa7b74d35	8c160e1d-09f7-4377-8b7e-1e4f3cc5898e
15	10	-5	GBIF Germany	4f6826f2-4ff6-443d-b966-e6913bd24013	8c70ac3c-f762-11e1-a439-00145eb45e9a
13	8	-5	GBIF Germany	4f6826f2-4ff6-443d-b966-e6913bd24013	8c746584-f762-11e1-a439-00145eb45e9a
11	4	-7	GBIF Germany	4f6826f2-4ff6-443d-b966-e6913bd24013	8e10f196-f762-11e1-a439-00145eb45e9a
6	6	0	Plazi	ffb07bec-2d10-492d-9c37-361fe0b79427	8e9b3b02-144c-46e7-8a91-e5b8a7530894
847	839	-8	Biodiversity Information System of Mexico	b324e8e9-9a4c-44fa-8f1a-7f39ea7ab576	9069691f-cdc9-4caf-b05f-5f46d41c4c57
121	103	-18	GBIF Germany	4f6826f2-4ff6-443d-b966-e6913bd24013	908e33f2-f762-11e1-a439-00145eb45e9a
0	81	81	Ocean Biodiversity Information System	ba0670b9-4186-41e6-8e70-f9cb3065551a	91215db8-5e16-4ed5-acd5-3e23c8a4ed14
3280	3280	0	GBIF Cameroon	cfe0cad9-2bf4-4d16-ae33-c3dfb0da1ed9	912de54b-1fbe-4ef1-a283-9f7329238022
30	20	-10	GBIF Germany	4f6826f2-4ff6-443d-b966-e6913bd24013	91330f4e-f762-11e1-a439-00145eb45e9a
56	50	-6	GBIF Germany	4f6826f2-4ff6-443d-b966-e6913bd24013	9159c45e-f762-11e1-a439-00145eb45e9a
4819	3318	-1501	GBIF Germany	4f6826f2-4ff6-443d-b966-e6913bd24013	91b74f52-f762-11e1-a439-00145eb45e9a
1	1	0	Plazi	ffb07bec-2d10-492d-9c37-361fe0b79427	92277408-bc82-4c24-8bd2-472a3e6a62bf
577	577	0	GBIF Germany	4f6826f2-4ff6-443d-b966-e6913bd24013	927495d0-f762-11e1-a439-00145eb45e9a
53	31	-22	GBIF Germany	4f6826f2-4ff6-443d-b966-e6913bd24013	92e3687a-f762-11e1-a439-00145eb45e9a
1176	1176	0	GBIF Germany	4f6826f2-4ff6-443d-b966-e6913bd24013	94214720-f762-11e1-a439-00145eb45e9a
567	494	-73	GBIF Germany	4f6826f2-4ff6-443d-b966-e6913bd24013	95340ca6-f762-11e1-a439-00145eb45e9a
361	361	0	GBIF Germany	4f6826f2-4ff6-443d-b966-e6913bd24013	9551a004-f762-11e1-a439-00145eb45e9a
27	27	0	Plazi	ffb07bec-2d10-492d-9c37-361fe0b79427	96fdb764-fda6-4184-9a74-0e3456fea565
56	56	0	Plazi	ffb07bec-2d10-492d-9c37-361fe0b79427	97664e4b-836b-45ed-b43a-394f42ab1baa
628	628	0	Participant Node Managers Committee	7f48e0c8-5c96-49ec-b972-30748e339115	98442b0b-9f7b-4924-9289-5b793946ca01
2	2	0	Plazi	ffb07bec-2d10-492d-9c37-361fe0b79427	99739ca8-be58-4843-aa6f-27a35bafe27a
8	8	0	Plazi	ffb07bec-2d10-492d-9c37-361fe0b79427	99b3b009-f006-4146-b335-cbfdc2fcd60b
1	1	0	Plazi	ffb07bec-2d10-492d-9c37-361fe0b79427	9a7df9f8-5216-4b29-bee9-30623c580c6c
6688	6688	0	GBIF Brazil	cdc9736d-5ff7-4ece-9959-3c744360cdb3	9b511323-32c7-4d5e-8042-5356a08aa32b
3	3	0	Plazi	ffb07bec-2d10-492d-9c37-361fe0b79427	9c148623-3bb1-462f-aa68-4389bfa32e67
11	11	0	Plazi	ffb07bec-2d10-492d-9c37-361fe0b79427	9dd11965-9958-4665-aef8-d4b9d8d458f0
0	497	497	Colombian Biodiversity Information System	7e865cba-7c46-417b-ade5-97f2cf5b7be0	a4a19183-6c3f-438d-b566-48b465c88970
0	6	6	Plazi	ffb07bec-2d10-492d-9c37-361fe0b79427	a63757d3-e2c9-4477-83d7-6b69a08a7592
175	175	0	Plazi	ffb07bec-2d10-492d-9c37-361fe0b79427	a6c229ee-b814-4e3f-b836-a9209628f6b6
865	683	-182	GBIF Germany	4f6826f2-4ff6-443d-b966-e6913bd24013	aa8f8eaf-292e-423c-80b9-296579d32747
0	1	1	Plazi	ffb07bec-2d10-492d-9c37-361fe0b79427	aafa06e1-3443-4ee9-bacb-e7cc8f0a5eb9
30	30	0	Plazi	ffb07bec-2d10-492d-9c37-361fe0b79427	ac565270-3576-4125-b47f-13e57c3b17fa
0	3	3	Plazi	ffb07bec-2d10-492d-9c37-361fe0b79427	acc97ddf-a140-4a6d-a244-f57c9a2d195d
241	241	0	GBIF Germany	4f6826f2-4ff6-443d-b966-e6913bd24013	ae1c60bb-2a99-444a-a0f2-ed03c7baaebe
228501	233409	4908	U.S. Geological Survey	8618c64a-93e0-4300-b546-7249e5148ed2	af1b4db0-c8ce-4a95-b700-8a6a02bed9d6
17544	17544	0	GBIF France	da44cd31-5901-4687-a106-6d1c7734ee3a	b0dd9739-9cfa-4ee4-8e17-358c9e6a46f8
0	3	3	Plazi	ffb07bec-2d10-492d-9c37-361fe0b79427	b2387b09-fc42-4e25-95e3-825f20be6c4e
440779	440779	0	National Biodiversity Network	d897a5b9-35ee-4232-94bd-b0bcaac003c2	b3747af5-c715-457c-84f8-31b7629afeca
72	72	0	Plazi	ffb07bec-2d10-492d-9c37-361fe0b79427	b3e847ad-dad9-4fb9-822f-ef8adee0ed2d
0	3	3	Participant Node Managers Committee	7f48e0c8-5c96-49ec-b972-30748e339115	b4df886e-51a3-456b-a236-051ff0e455c2
3638	3638	0	U.S. Geological Survey	8618c64a-93e0-4300-b546-7249e5148ed2	b7e52722-ee9a-4a9c-9c01-455044e855c2
216	72	-144	GBIF Germany	4f6826f2-4ff6-443d-b966-e6913bd24013	b86f1acf-78ab-4580-8c2a-e13f8e5e96c3
2	2	0	Plazi	ffb07bec-2d10-492d-9c37-361fe0b79427	b9a9d10f-e4f0-4498-9696-046dee1fc19c
45925	49712	3787	GBIF France	da44cd31-5901-4687-a106-6d1c7734ee3a	ba0c03ab-fa61-4a3c-8db7-35c8c3454168
5940	5940	0	GBIF Benin	efb9c00e-f802-45dd-8826-a52ec45b89ff	bd4fda33-c9e5-4d40-8f48-7acd6b7ea6d1
332	332	0	Colombian Biodiversity Information System	7e865cba-7c46-417b-ade5-97f2cf5b7be0	bed0b1b9-0dfa-4467-9148-fe8365ecb853
31820	31820	0	GBIF Brazil	cdc9736d-5ff7-4ece-9959-3c744360cdb3	c001a28f-6f37-40e9-8e34-e0ada1772e4d
0	1	1	Plazi	ffb07bec-2d10-492d-9c37-361fe0b79427	c0e49540-13fd-430b-b26e-0bf8d08ad5d7
156	156	0	National Biodiversity Network	d897a5b9-35ee-4232-94bd-b0bcaac003c2	c497c84a-ba5e-439d-8932-b23df520e529
581	581	0	Participant Node Managers Committee	7f48e0c8-5c96-49ec-b972-30748e339115	c761f6ee-936f-40df-bc2a-d9084267bb7a
0	3	3	Plazi	ffb07bec-2d10-492d-9c37-361fe0b79427	c7b35919-a8bf-4baa-aae3-f029e93332f6
150	150	0	Plazi	ffb07bec-2d10-492d-9c37-361fe0b79427	c807f833-9fe4-45ec-b5d6-62c6b88979b3
1391	1391	0	GBIF Norway	4f829580-180d-46a9-9c87-ed8ec959b545	c89f43c2-98cf-4c60-ad53-ddf7127bb9d5
396	396	0	GBIF Germany	4f6826f2-4ff6-443d-b966-e6913bd24013	ca8980f9-171e-4daa-b9f6-a0e646d6b4e8
544	544	0	GBIF France	da44cd31-5901-4687-a106-6d1c7734ee3a	cbd6e93e-3da6-4bad-9db6-33e0d1a820a0
220	220	0	Colombian Biodiversity Information System	7e865cba-7c46-417b-ade5-97f2cf5b7be0	cbe99b01-7fa8-4827-bc14-dc1e7fed2073
0	1	1	Plazi	ffb07bec-2d10-492d-9c37-361fe0b79427	cc3d3f75-8bb5-4c1f-9255-6f373a070559
0	2	2	Plazi	ffb07bec-2d10-492d-9c37-361fe0b79427	cccd251f-0aff-456c-aecc-5eccc5824fe8
15	15	0	Plazi	ffb07bec-2d10-492d-9c37-361fe0b79427	cf456406-b79b-4bfe-8d13-861cd328d5b3
3	3	0	Plazi	ffb07bec-2d10-492d-9c37-361fe0b79427	d3cc7203-2472-47b5-9f2d-ca8b7fcdbaa6
7	7	0	Plazi	ffb07bec-2d10-492d-9c37-361fe0b79427	d44bcfee-aa05-4eee-88cd-25fa5504b30e
8549	8549	0	Inter American Biodiversity Information Network	69f8ea9e-b2a6-4e5a-896f-3bf8fc23cc8d	d82eaca8-005a-4002-817c-70c1d2d4b5db
0	14	14	Plazi	ffb07bec-2d10-492d-9c37-361fe0b79427	da59bea2-040b-4052-b33c-1df67739a29d
58	58	0	National Biodiversity Network	d897a5b9-35ee-4232-94bd-b0bcaac003c2	dd838ad8-1e2d-4415-8c40-1bf5f102a506
2	2	0	Plazi	ffb07bec-2d10-492d-9c37-361fe0b79427	e0e53aad-9b6f-4cfa-9a01-d83adc65d7db
613	613	0	Colombian Biodiversity Information System	7e865cba-7c46-417b-ade5-97f2cf5b7be0	e21fcd92-b7a4-42fb-9541-af2e85d490dc
0	1	1	Plazi	ffb07bec-2d10-492d-9c37-361fe0b79427	e25aca4f-f4b8-430f-aa23-27c6a3b7e1c4
6	6	0	Plazi	ffb07bec-2d10-492d-9c37-361fe0b79427	e3253ac7-afea-44f5-a6b9-a2b2d6984de8
0	8	8	Plazi	ffb07bec-2d10-492d-9c37-361fe0b79427	e43128ba-0694-45ac-b551-b555f13c7cec
485	485	0	ASEAN Centre for Biodiversity	af2a0fa1-4c8e-4bdc-8954-b1a55e32b0f1	e4c5d8b1-6134-4654-be05-9162c098337b
264806	266316	1510	U.S. Geological Survey	8618c64a-93e0-4300-b546-7249e5148ed2	e523cf2d-4fc2-48d8-aa75-80ecbc90b3f5
1	1	0	Plazi	ffb07bec-2d10-492d-9c37-361fe0b79427	e5c82b8b-6e62-4a2d-bf0b-d20515539ad7
1747	1747	0	GBIF Portugal	673f7038-4262-4149-b753-5658a4e912f6	e5dd4343-8bd9-449a-bef5-47c655968225
0	2	2	Plazi	ffb07bec-2d10-492d-9c37-361fe0b79427	e6d5813c-ed46-47dd-8929-402744e64ddf
7	7	0	Plazi	ffb07bec-2d10-492d-9c37-361fe0b79427	e754b6f8-72d5-4ca2-ae4a-eb4b6c581651
571	571	0	GBIF France	da44cd31-5901-4687-a106-6d1c7734ee3a	e893aca8-306a-40ad-a577-b1610f6bcc9b
5452	5452	0	National Biodiversity Data Centre	422b00b2-6c94-4bb6-976b-c359916efdb8	eaaabe3b-e64a-4819-a007-2c3529eb4bf7
38876	38876	0	GBIF France	da44cd31-5901-4687-a106-6d1c7734ee3a	ead74478-edb2-46d5-bea6-7c5f6060cd4a
53	53	0	GBIF Germany	4f6826f2-4ff6-443d-b966-e6913bd24013	eba6f65e-6df3-4179-9ecb-aea4d2c8d9d9
15	15	0	Plazi	ffb07bec-2d10-492d-9c37-361fe0b79427	ec5c2223-79ee-460e-a836-5956e7104c19
0	93	93	Ocean Biodiversity Information System	ba0670b9-4186-41e6-8e70-f9cb3065551a	f0f2cff8-1a03-4215-af23-c63a9cf71fbe
407	407	0	Plazi	ffb07bec-2d10-492d-9c37-361fe0b79427	f31ec6ba-4ed8-4245-9ed0-c068cda2c03a
29	29	0	Colombian Biodiversity Information System	7e865cba-7c46-417b-ade5-97f2cf5b7be0	f71b5ba7-7e16-40a0-9e44-3320ec1eee7a
0	233	233	Plazi	ffb07bec-2d10-492d-9c37-361fe0b79427	f7537331-0a6b-46e4-9999-d6ffd161e0ba
0	349	349	Atlas of Living Australia	4a6f1b71-969e-4fc5-a693-282b05e1220c	f88124f5-95d5-4da5-984e-0ba2698e2c93
1705	1705	0	National Biodiversity Network	d897a5b9-35ee-4232-94bd-b0bcaac003c2	fa15947b-542f-4f5a-8d26-44834ce41b6d
15600	15600	0	GBIF France	da44cd31-5901-4687-a106-6d1c7734ee3a	fa186af6-703e-43a5-9c8e-bb2726e13807
23	23	0	Plazi	ffb07bec-2d10-492d-9c37-361fe0b79427	fb9da37a-8219-4b3c-b604-82eb0b85c91f
0	5	5	Plazi	ffb07bec-2d10-492d-9c37-361fe0b79427	fbb67a27-5239-4242-a601-a423b80ec7fc
102	102	0	Plazi	ffb07bec-2d10-492d-9c37-361fe0b79427	fbbecb4d-bda5-4215-9147-a47944250471
0	4	4	Plazi	ffb07bec-2d10-492d-9c37-361fe0b79427	0078ba23-9839-4219-b866-152151514da2
5	5	0	Plazi	ffb07bec-2d10-492d-9c37-361fe0b79427	03240bc9-1784-4c98-9e22-448c9ea078ec
15530	15551	21	U.S. Geological Survey	8618c64a-93e0-4300-b546-7249e5148ed2	038b6cf8-4c53-4bf3-961e-9fe6c57b813e
0	14	14	Plazi	ffb07bec-2d10-492d-9c37-361fe0b79427	0554a6a5-0123-4746-8d53-4481c52c06d3
1	1	0	Plazi	ffb07bec-2d10-492d-9c37-361fe0b79427	05e45ff4-b918-44d7-a800-4cdb335b5c3c
5796	5796	0	GBIF Spain	1f94b3ca-9345-4d65-afe2-4bace93aa0fe	07506960-9703-11de-893c-b8a03c50a862
2	2	0	Plazi	ffb07bec-2d10-492d-9c37-361fe0b79427	0ad6ecdc-c381-4bf4-bc75-164c6c9622cb
6	6	0	Participant Node Managers Committee	7f48e0c8-5c96-49ec-b972-30748e339115	0cda423c-7e01-45ee-927b-565794631cbe
2	2	0	Plazi	ffb07bec-2d10-492d-9c37-361fe0b79427	11e247e3-ae54-41c9-bcf2-a09604644999
26180	26180	0	GBIF Brazil	cdc9736d-5ff7-4ece-9959-3c744360cdb3	143fd714-b939-4cf7-a078-acdde353a914
28383	28383	0	GBIF Norway	4f829580-180d-46a9-9c87-ed8ec959b545	1939e560-d089-44b5-99fb-3ff15e4d34be
3	3	0	Plazi	ffb07bec-2d10-492d-9c37-361fe0b79427	1980a3df-0542-48ec-a594-e6bc4dc8f3aa
4	4	0	Plazi	ffb07bec-2d10-492d-9c37-361fe0b79427	1c5bce12-4b99-4480-a230-9fe3cd5e0fee
0	1	1	Plazi	ffb07bec-2d10-492d-9c37-361fe0b79427	1ea0b356-4168-44b3-97ca-2817af54ab92
0	2	2	Plazi	ffb07bec-2d10-492d-9c37-361fe0b79427	20fea8b5-772e-4201-a123-5174859a8dbb
24	24	0	Plazi	ffb07bec-2d10-492d-9c37-361fe0b79427	264c93c1-bb73-4f0c-8115-cbc901544be0
0	1	1	Ocean Biodiversity Information System	ba0670b9-4186-41e6-8e70-f9cb3065551a	26a07867-2d6a-41bb-a52b-6d14ea93cf5e
0	1	1	Ocean Biodiversity Information System	ba0670b9-4186-41e6-8e70-f9cb3065551a	280ef5f0-b538-422e-a20b-35fba1ef24c8
1863	1863	0	U.S. Geological Survey	8618c64a-93e0-4300-b546-7249e5148ed2	2de5feab-2e50-4b85-8bd4-90dd3dee995e
1661	1661	0	GBIF Benin	efb9c00e-f802-45dd-8826-a52ec45b89ff	2dfafe29-f0ae-4668-9e03-d0aa7e80dd8d
850	850	0	National Biodiversity Network	d897a5b9-35ee-4232-94bd-b0bcaac003c2	2fd8c8c0-6c13-4653-afe9-151a23665667
2	2	0	Plazi	ffb07bec-2d10-492d-9c37-361fe0b79427	301eb878-be22-48d8-9d29-ccd16892433a
19	19	0	Plazi	ffb07bec-2d10-492d-9c37-361fe0b79427	32061d78-2ba5-4885-ab58-7c873ceb45b6
2014	2014	0	Colombian Biodiversity Information System	7e865cba-7c46-417b-ade5-97f2cf5b7be0	3316aeea-f5a5-45de-880f-055b4f91cbec
1	1	0	Plazi	ffb07bec-2d10-492d-9c37-361fe0b79427	35552e1d-02fd-417a-9f99-ef299bea49ee
509	509	0	GBIF Japan	db5705aa-6a6e-42f1-8942-d77b9f4896ea	35c20b41-bed5-4147-9e98-98c210b14efe
159	159	0	Plazi	ffb07bec-2d10-492d-9c37-361fe0b79427	375480cc-1f64-4e37-ba9d-a087e7cb34ef
10	10	0	Plazi	ffb07bec-2d10-492d-9c37-361fe0b79427	3a05b9e6-8a07-4822-91e5-11d16eeb934f
1205	1205	0	GBIF Germany	4f6826f2-4ff6-443d-b966-e6913bd24013	3a754d92-6a8a-4ff4-86d1-1e3fd773afd2
15276	15276	0	GBIF Benin	efb9c00e-f802-45dd-8826-a52ec45b89ff	3ffac87d-3d44-48de-b541-7bdd31573780
698	698	0	GBIF Germany	4f6826f2-4ff6-443d-b966-e6913bd24013	4209e539-52bc-448a-a38a-f80a8611847e
0	4	4	Plazi	ffb07bec-2d10-492d-9c37-361fe0b79427	458656e6-2ee9-4c6f-94ab-93e315f6d7f5
0	2046	2046	Participant Node Managers Committee	7f48e0c8-5c96-49ec-b972-30748e339115	465ee0d2-fa52-407b-839e-43227e75ef5e
77	80	3	GBIF Japan	db5705aa-6a6e-42f1-8942-d77b9f4896ea	46e201a1-33b2-4921-a6c4-8609ec4fbbb7
4	4	0	Plazi	ffb07bec-2d10-492d-9c37-361fe0b79427	46f14143-5170-4760-b3f2-9452ed80bdaf
605	605	0	GBIF Portugal	673f7038-4262-4149-b753-5658a4e912f6	48466ce1-9bb4-4b8c-bb9b-b5bae1a3a010
12644	12645	1	U.S. Geological Survey	8618c64a-93e0-4300-b546-7249e5148ed2	48fa6173-8db2-40a3-9ef3-90a1651a506d
3	3	0	Plazi	ffb07bec-2d10-492d-9c37-361fe0b79427	4935cee9-8c79-4df4-b007-98cbf46b964e
454	454	0	National Biodiversity Network	d897a5b9-35ee-4232-94bd-b0bcaac003c2	4d30e8fd-de38-48d4-a977-25a43d607ed8
202207	203628	1421	GBIF Norway	4f829580-180d-46a9-9c87-ed8ec959b545	4db619a6-9429-4bef-90c9-06cc90c39552
6004	6004	0	Colombian Biodiversity Information System	7e865cba-7c46-417b-ade5-97f2cf5b7be0	4f28afd9-f50e-42aa-b49f-60d9f637ab2c
114	114	0	National Biodiversity Network	d897a5b9-35ee-4232-94bd-b0bcaac003c2	523e6359-b378-49a2-af18-360775d5884b
3	3	0	Plazi	ffb07bec-2d10-492d-9c37-361fe0b79427	5458f1f0-63cd-4a12-9741-a83afbca0482
1468	1468	0	Ocean Biodiversity Information System	ba0670b9-4186-41e6-8e70-f9cb3065551a	55a6d292-5141-40d3-89b1-d13959a1c998
19879	16959	-2920	National Biodiversity Network	d897a5b9-35ee-4232-94bd-b0bcaac003c2	56a946bf-bd42-4a54-8543-4380d92f9762
21660	25149	3489	National Biodiversity Network	d897a5b9-35ee-4232-94bd-b0bcaac003c2	58a18d87-e572-4191-96a7-9b960a8df7e0
300	300	0	GBIF France	da44cd31-5901-4687-a106-6d1c7734ee3a	5905a16b-fdf9-47fc-8dab-2509a222ff52
0	6	6	Plazi	ffb07bec-2d10-492d-9c37-361fe0b79427	59dc47c8-01b5-4f14-baa6-95b57158ca96
1	1	0	Plazi	ffb07bec-2d10-492d-9c37-361fe0b79427	5ae498c8-8199-4227-a5df-09ae40face89
142	142	0	Plazi	ffb07bec-2d10-492d-9c37-361fe0b79427	5c4e752c-bc86-4b72-94b0-c854a5d4ef23
3464	3464	0	Canada Biodiversity Information Facility	8f83fc96-c966-4126-83f7-bf044dc49efa	5ca5f0b6-d221-4f69-b7ac-8579180942b5
50	50	0	National Biodiversity Network	d897a5b9-35ee-4232-94bd-b0bcaac003c2	5fd439c7-9645-4970-aa16-eb2578a2f5e7
8	8	0	Plazi	ffb07bec-2d10-492d-9c37-361fe0b79427	60b5a286-c831-49ba-b499-ad61183e7f36
13671	13671	0	GBIF France	da44cd31-5901-4687-a106-6d1c7734ee3a	60d02b69-1dca-496b-a24c-35b702b3e7a9
88	88	0	GBIF Germany	4f6826f2-4ff6-443d-b966-e6913bd24013	6132b3b2-f762-11e1-a439-00145eb45e9a
174	174	0	GBIF Germany	4f6826f2-4ff6-443d-b966-e6913bd24013	615c6c34-f762-11e1-a439-00145eb45e9a
84	84	0	GBIF Germany	4f6826f2-4ff6-443d-b966-e6913bd24013	616c5d60-f762-11e1-a439-00145eb45e9a
167	167	0	GBIF Germany	4f6826f2-4ff6-443d-b966-e6913bd24013	617fbd06-f762-11e1-a439-00145eb45e9a
1298	1298	0	Biodiversity Information System of Mexico	b324e8e9-9a4c-44fa-8f1a-7f39ea7ab576	61ef7393-21fd-4e95-b57b-33266ffde540
42	42	0	GBIF Germany	4f6826f2-4ff6-443d-b966-e6913bd24013	62dc5be6-f762-11e1-a439-00145eb45e9a
0	10	10	Plazi	ffb07bec-2d10-492d-9c37-361fe0b79427	636cb7ef-a6bf-4799-ad77-8e0693277d8a
80	80	0	GBIF Germany	4f6826f2-4ff6-443d-b966-e6913bd24013	64232cbe-f762-11e1-a439-00145eb45e9a
84	84	0	GBIF Germany	4f6826f2-4ff6-443d-b966-e6913bd24013	64697c8c-f762-11e1-a439-00145eb45e9a
129	119	-10	GBIF Germany	4f6826f2-4ff6-443d-b966-e6913bd24013	64faecb2-f762-11e1-a439-00145eb45e9a
152	145	-7	GBIF Germany	4f6826f2-4ff6-443d-b966-e6913bd24013	65034088-f762-11e1-a439-00145eb45e9a
5	5	0	GBIF Germany	4f6826f2-4ff6-443d-b966-e6913bd24013	65b38d3a-f762-11e1-a439-00145eb45e9a
58	58	0	GBIF Germany	4f6826f2-4ff6-443d-b966-e6913bd24013	667422ac-f762-11e1-a439-00145eb45e9a
0	7	7	Plazi	ffb07bec-2d10-492d-9c37-361fe0b79427	67806fea-282d-4140-8fda-abb99eb1008f
226	226	0	GBIF Germany	4f6826f2-4ff6-443d-b966-e6913bd24013	67947024-f762-11e1-a439-00145eb45e9a
198	198	0	GBIF Germany	4f6826f2-4ff6-443d-b966-e6913bd24013	68304efe-f762-11e1-a439-00145eb45e9a
1	1	0	Plazi	ffb07bec-2d10-492d-9c37-361fe0b79427	687146d5-e65d-424d-858a-830894f1a038
85	85	0	GBIF Germany	4f6826f2-4ff6-443d-b966-e6913bd24013	69288042-f762-11e1-a439-00145eb45e9a
34	34	0	GBIF Germany	4f6826f2-4ff6-443d-b966-e6913bd24013	6ab66280-f762-11e1-a439-00145eb45e9a
1426	1426	0	Participant Node Managers Committee	7f48e0c8-5c96-49ec-b972-30748e339115	6b03c5e7-05fe-497b-8156-6d564ecdbdaf
158	158	0	Participant Node Managers Committee	7f48e0c8-5c96-49ec-b972-30748e339115	6bccbb3f-e095-4f54-b1f2-a1be8837e69c
0	2	2	Plazi	ffb07bec-2d10-492d-9c37-361fe0b79427	6c0c57e2-a02a-436a-ad33-2c38a9ed07c5
70	70	0	GBIF Germany	4f6826f2-4ff6-443d-b966-e6913bd24013	6cdb9bb6-f762-11e1-a439-00145eb45e9a
8	8	0	Plazi	ffb07bec-2d10-492d-9c37-361fe0b79427	6e071d1a-5d82-4005-9d93-55a205e59f95
8	8	0	Plazi	ffb07bec-2d10-492d-9c37-361fe0b79427	6e5e23cb-2c41-48aa-ad2d-3a5ac235da97
191	191	0	GBIF France	da44cd31-5901-4687-a106-6d1c7734ee3a	6ebbf42d-fe33-4cbd-9a1a-c6045689e455
0	27	27	Plazi	ffb07bec-2d10-492d-9c37-361fe0b79427	6f1ccb6f-3988-489d-a595-f3f944e85eeb
54	54	0	Plazi	ffb07bec-2d10-492d-9c37-361fe0b79427	6fdc6a27-0f98-454c-8f0a-4be3f202b312
860	860	0	GBIF Chile	a8b16421-d80b-4ef3-8f22-098b01a89255	703f7531-fd90-4b02-9303-c80c472f4a0a
2	2	0	Plazi	ffb07bec-2d10-492d-9c37-361fe0b79427	70696273-b5ef-4883-8e3a-d742b3f30930
22852	22852	0	Netherlands Biodiversity Information Facility	0909d601-bda2-42df-9e63-a6d51847ebce	733854db-11e2-472f-914f-461c06943090
0	3	3	Plazi	ffb07bec-2d10-492d-9c37-361fe0b79427	74821661-51a7-4588-8628-dbbd94e63099
17	17	0	Plazi	ffb07bec-2d10-492d-9c37-361fe0b79427	74ac3747-b373-47bc-81d1-e188aa0a8814
0	313	313	Plazi	ffb07bec-2d10-492d-9c37-361fe0b79427	74b7bfe4-e37c-4095-9f3e-78e0f9cbef6a
282	282	0	GBIF Finland	dd514216-5c7c-45f3-910d-797424cb5be6	74ca3dcc-32f9-4981-a3b5-dab8c6a6457f
137	136	-1	GBIF Germany	4f6826f2-4ff6-443d-b966-e6913bd24013	757a2c56-f762-11e1-a439-00145eb45e9a
13	13	0	Plazi	ffb07bec-2d10-492d-9c37-361fe0b79427	7603c4db-a658-4941-88b2-75bdc2d2b402
4610	4610	0	GBIF New Zealand	4f9fd726-20dd-445e-89a1-8ed93792276f	765ff590-b785-4797-adfe-3132689ce917
566	566	0	Participant Node Managers Committee	7f48e0c8-5c96-49ec-b972-30748e339115	771ca2ae-f336-495f-8a11-b700c0118454
0	20	20	Ocean Biodiversity Information System	ba0670b9-4186-41e6-8e70-f9cb3065551a	77f808b1-1692-464f-a9fd-080ac3b8b570
59	59	0	GBIF Germany	4f6826f2-4ff6-443d-b966-e6913bd24013	78c6453e-f762-11e1-a439-00145eb45e9a
11	11	0	GBIF Germany	4f6826f2-4ff6-443d-b966-e6913bd24013	78e2e4a0-f762-11e1-a439-00145eb45e9a
9	9	0	GBIF Germany	4f6826f2-4ff6-443d-b966-e6913bd24013	78f1cf88-f762-11e1-a439-00145eb45e9a
72	72	0	GBIF France	da44cd31-5901-4687-a106-6d1c7734ee3a	79417bc9-ff79-4a81-b12d-b5e9dd028640
2050	2050	0	Korean Biodiversity Information Facility	e0a1e772-0177-4800-94b4-2d023fe6cdf4	7b11a5e0-f762-11e1-a439-00145eb45e9a
1808	1808	0	Ocean Biodiversity Information System	ba0670b9-4186-41e6-8e70-f9cb3065551a	7b92bd24-f762-11e1-a439-00145eb45e9a
375	375	0	GBIF Germany	4f6826f2-4ff6-443d-b966-e6913bd24013	7caabbda-f762-11e1-a439-00145eb45e9a
13	13	0	Plazi	ffb07bec-2d10-492d-9c37-361fe0b79427	7e11cb7b-ab7c-4a1d-9e86-e00521d205b9
0	1243	1243	Ocean Biodiversity Information System	ba0670b9-4186-41e6-8e70-f9cb3065551a	7e639463-8e22-40e0-a347-967012d61f5b
2958	2958	0	National Biodiversity Network	d897a5b9-35ee-4232-94bd-b0bcaac003c2	81484c70-bb2d-4c3b-b007-5fca82b69a23
4603	4603	0	Atlas of Living Australia	4a6f1b71-969e-4fc5-a693-282b05e1220c	82dea548-f762-11e1-a439-00145eb45e9a
344	344	0	National Biodiversity Network	d897a5b9-35ee-4232-94bd-b0bcaac003c2	83072c26-af4e-44a7-b373-0567f623081d
109176	109176	0	U.S. Geological Survey	8618c64a-93e0-4300-b546-7249e5148ed2	83713818-f762-11e1-a439-00145eb45e9a
50	50	0	Plazi	ffb07bec-2d10-492d-9c37-361fe0b79427	83eecd69-03b2-4cc5-beaf-e3682312ffb4
292	292	0	Canada Biodiversity Information Facility	8f83fc96-c966-4126-83f7-bf044dc49efa	844d1b44-f762-11e1-a439-00145eb45e9a
11001	11005	4	Canada Biodiversity Information Facility	8f83fc96-c966-4126-83f7-bf044dc49efa	84f3b06c-f762-11e1-a439-00145eb45e9a
319	319	0	GBIF Chile	a8b16421-d80b-4ef3-8f22-098b01a89255	853ddf57-13fb-4bb4-b41a-3160066a9415
13083	13083	0	National Biodiversity Network	d897a5b9-35ee-4232-94bd-b0bcaac003c2	8543440c-0c50-4865-8d12-bd6070150adc
23167	23244	77	Netherlands Biodiversity Information Facility	0909d601-bda2-42df-9e63-a6d51847ebce	85796928-f762-11e1-a439-00145eb45e9a
9	9	0	GBIF Germany	4f6826f2-4ff6-443d-b966-e6913bd24013	880d5c76-f762-11e1-a439-00145eb45e9a
614	307	-307	GBIF Germany	4f6826f2-4ff6-443d-b966-e6913bd24013	88ab3f2c-f762-11e1-a439-00145eb45e9a
606	606	0	GBIF Germany	4f6826f2-4ff6-443d-b966-e6913bd24013	8976ab08-f762-11e1-a439-00145eb45e9a
966	966	0	GBIF Germany	4f6826f2-4ff6-443d-b966-e6913bd24013	8b210a16-f762-11e1-a439-00145eb45e9a
62	62	0	GBIF Germany	4f6826f2-4ff6-443d-b966-e6913bd24013	8d3cd55a-f762-11e1-a439-00145eb45e9a
20	20	0	Plazi	ffb07bec-2d10-492d-9c37-361fe0b79427	8d6c3233-4503-416a-8525-9901206c6557
0	4	4	Plazi	ffb07bec-2d10-492d-9c37-361fe0b79427	8d83c9d2-2610-4216-9264-8b39c933d6db
0	6	6	GBIF Uganda	71b40829-6a12-4c3d-8fee-5746f5e9cf8c	8db190dd-983d-4219-a7e8-770f0f9869d1
3	3	0	Plazi	ffb07bec-2d10-492d-9c37-361fe0b79427	8db6c8d5-11d0-4841-900d-6d87b880468c
9	1	-8	GBIF Germany	4f6826f2-4ff6-443d-b966-e6913bd24013	8dcc223c-f762-11e1-a439-00145eb45e9a
626	210	-416	GBIF Germany	4f6826f2-4ff6-443d-b966-e6913bd24013	8dd025d0-f762-11e1-a439-00145eb45e9a
66	66	0	Plazi	ffb07bec-2d10-492d-9c37-361fe0b79427	8e7d21e6-7131-4805-aeb8-5400408b435b
0	10	10	Plazi	ffb07bec-2d10-492d-9c37-361fe0b79427	8f239084-30f3-4a6c-ba97-3eb65356beb5
8	4	-4	GBIF Germany	4f6826f2-4ff6-443d-b966-e6913bd24013	90e7cc32-f762-11e1-a439-00145eb45e9a
10	9	-1	GBIF Germany	4f6826f2-4ff6-443d-b966-e6913bd24013	917933b6-f762-11e1-a439-00145eb45e9a
5020	5020	0	Colombian Biodiversity Information System	7e865cba-7c46-417b-ade5-97f2cf5b7be0	917f5583-f6ce-4f66-bdfd-e5150dbc5200
0	1	1	Plazi	ffb07bec-2d10-492d-9c37-361fe0b79427	91aaaf8c-b873-4eb9-a3c6-c17adede6c7d
240	240	0	Colombian Biodiversity Information System	7e865cba-7c46-417b-ade5-97f2cf5b7be0	93160e89-1501-481b-8d87-983fd8b1d5e5
0	79	79	Plazi	ffb07bec-2d10-492d-9c37-361fe0b79427	93710577-83f6-4922-a580-07295afb6b62
876	876	0	GBIF Germany	4f6826f2-4ff6-443d-b966-e6913bd24013	93f8c48a-f762-11e1-a439-00145eb45e9a
785	785	0	GBIF Argentina	2426a871-9feb-40a1-96c6-0c593a76b835	945b5e0e-b0a0-4d9c-9d41-9c4e3d8f5532
236	236	0	GBIF Germany	4f6826f2-4ff6-443d-b966-e6913bd24013	9564bb58-f762-11e1-a439-00145eb45e9a
318	318	0	GBIF Japan	db5705aa-6a6e-42f1-8942-d77b9f4896ea	95faf636-f762-11e1-a439-00145eb45e9a
14411	14411	0	GBIF Spain	1f94b3ca-9345-4d65-afe2-4bace93aa0fe	9621f47a-f762-11e1-a439-00145eb45e9a
6232	6232	0	GBIF France	da44cd31-5901-4687-a106-6d1c7734ee3a	9631e56a-f762-11e1-a439-00145eb45e9a
140	140	0	Atlas of Living Australia	4a6f1b71-969e-4fc5-a693-282b05e1220c	964cb534-f762-11e1-a439-00145eb45e9a
1050	1050	0	GBIF Germany	4f6826f2-4ff6-443d-b966-e6913bd24013	96830f08-f762-11e1-a439-00145eb45e9a
0	102	102	Plazi	ffb07bec-2d10-492d-9c37-361fe0b79427	988005ac-68a5-443a-937e-7f4622d8bec8
46	46	0	GBIF Finland	dd514216-5c7c-45f3-910d-797424cb5be6	994fb34c-ba13-4768-a238-b1d3eb35c90d
162321	162318	-3	Biodiversity Information System of Mexico	b324e8e9-9a4c-44fa-8f1a-7f39ea7ab576	99ab3167-a2d5-411a-8176-34dc02edee4a
376028	376028	0	U.S. Geological Survey	8618c64a-93e0-4300-b546-7249e5148ed2	a56671b7-f619-4f49-9250-dfa7c0b298dc
0	14	14	Plazi	ffb07bec-2d10-492d-9c37-361fe0b79427	a57d7bd0-ee60-4db8-bda6-7db21e3e46fb
30	30	0	Plazi	ffb07bec-2d10-492d-9c37-361fe0b79427	a7c3cd9d-d4be-4686-a198-3255c948beb8
9	9	0	Plazi	ffb07bec-2d10-492d-9c37-361fe0b79427	abb4a6c8-d4a2-4153-9372-3196b43899ef
0	2	2	Plazi	ffb07bec-2d10-492d-9c37-361fe0b79427	abbdcf6d-8873-4149-bc80-3cdc934263f2
13	13	0	Plazi	ffb07bec-2d10-492d-9c37-361fe0b79427	ac2f791f-223e-431e-baa1-9d8ff6cecabd
0	3	3	Plazi	ffb07bec-2d10-492d-9c37-361fe0b79427	ac49843e-1032-41df-8004-de65c890903d
0	12	12	Plazi	ffb07bec-2d10-492d-9c37-361fe0b79427	ad828c7b-b7ba-4a0f-81a1-dcc4002bc989
2778	2778	0	GBIF France	da44cd31-5901-4687-a106-6d1c7734ee3a	ae217adc-afb9-4833-80ee-e7e2e3e2a2ac
2	2	0	Participant Node Managers Committee	7f48e0c8-5c96-49ec-b972-30748e339115	af26be01-b563-49a2-b71e-8adac2b83560
55	55	0	Plazi	ffb07bec-2d10-492d-9c37-361fe0b79427	af5d4a4a-518f-482e-9b0d-a718e0007131
1	1	0	Plazi	ffb07bec-2d10-492d-9c37-361fe0b79427	b0425de5-3b4d-43aa-aacd-cf78c879de6f
0	109	109	Ocean Biodiversity Information System	ba0670b9-4186-41e6-8e70-f9cb3065551a	b4b66bdd-f0c2-43ad-b642-1f0c2cb44654
0	19406	19406	Belgian Biodiversity Platform	fb11cfe1-ebc3-45af-9159-17d9fddbcdac	b6412a28-329c-4a24-b605-bc9d1b43b5b2
2586	2586	0	National Biodiversity Network	d897a5b9-35ee-4232-94bd-b0bcaac003c2	b6918a0c-c735-4d1d-9a49-4b75002af1f0
4	4	0	Plazi	ffb07bec-2d10-492d-9c37-361fe0b79427	b9c98b66-a61f-49a7-b9cf-69ea2c95aa64
0	3	3	Plazi	ffb07bec-2d10-492d-9c37-361fe0b79427	bbe8c7a4-ed5b-4d36-bbc6-f179c88a5aa5
4972	4972	0	Biodiversity Information System of Mexico	b324e8e9-9a4c-44fa-8f1a-7f39ea7ab576	bbee2ef2-1389-43e6-bde8-ac8e38c6cc6e
18586	18586	0	National Biodiversity Network	d897a5b9-35ee-4232-94bd-b0bcaac003c2	bbf97678-fe2a-4d74-9cf8-ed48ddeaf64f
4	4	0	Plazi	ffb07bec-2d10-492d-9c37-361fe0b79427	bc19d052-353e-4e68-ab95-41e4eaaeac02
2257	2307	50	GBIF Japan	db5705aa-6a6e-42f1-8942-d77b9f4896ea	bd13138d-0173-4994-9893-2acbaa4683e7
0	7	7	Plazi	ffb07bec-2d10-492d-9c37-361fe0b79427	bd8fd73e-8051-4a27-8350-1ccefcce0a93
11	11	0	GBIF Portugal	673f7038-4262-4149-b753-5658a4e912f6	bed9ac78-1f04-4f63-ace8-ae61870bf223
4905	4905	0	GBIF Nigeria	6529bcb5-a542-4fda-be87-54a624515335	beefc0e5-520f-446c-8d7a-2e1c35394144
87908	90014	2106	Atlas of Living Australia	4a6f1b71-969e-4fc5-a693-282b05e1220c	c19a8f6e-c368-494d-942e-10108d8867a7
1	1	0	Plazi	ffb07bec-2d10-492d-9c37-361fe0b79427	c1da0e35-063c-48c5-8e21-e18a7424fa47
279	279	0	GBIF France	da44cd31-5901-4687-a106-6d1c7734ee3a	c2cfdfbb-4360-4158-8d7b-b08dc1920636
461	461	0	Plazi	ffb07bec-2d10-492d-9c37-361fe0b79427	c87fedef-eea4-42c6-998a-2a01b2c5839d
0	5	5	Plazi	ffb07bec-2d10-492d-9c37-361fe0b79427	cad8ef97-029d-4e58-8189-27a0615f501e
5505	5505	0	GBIF France	da44cd31-5901-4687-a106-6d1c7734ee3a	cc23908f-0a4f-4811-b1e2-f603f4168d09
2	2	0	Plazi	ffb07bec-2d10-492d-9c37-361fe0b79427	ce7b8632-fefa-44f6-a59f-402c2bbb34c3
1110	1110	0	GBIF Germany	4f6826f2-4ff6-443d-b966-e6913bd24013	d053e6ef-234c-443d-969d-ae133b1aae9f
3	3	0	Plazi	ffb07bec-2d10-492d-9c37-361fe0b79427	d444d56e-9031-4ffa-85f8-687c745b761e
8	8	0	Plazi	ffb07bec-2d10-492d-9c37-361fe0b79427	d5171484-4828-43f4-bb55-146b24015668
2214	2214	0	GBIF New Zealand	4f9fd726-20dd-445e-89a1-8ed93792276f	d55a864e-6259-4981-83f8-7941c0c3c118
25	25	0	Plazi	ffb07bec-2d10-492d-9c37-361fe0b79427	ddb62273-2007-405c-968b-ebd41b334d22
87	87	0	Belgian Biodiversity Platform	fb11cfe1-ebc3-45af-9159-17d9fddbcdac	df662766-0716-4bea-bad0-158e985071c6
24	24	0	Participant Node Managers Committee	7f48e0c8-5c96-49ec-b972-30748e339115	e0971ffe-6108-4a29-9007-d68a8eaa5b26
33	33	0	Atlas of Living Australia	4a6f1b71-969e-4fc5-a693-282b05e1220c	e11af578-d507-42a6-a34e-aaec39ee55bc
0	14	14	Plazi	ffb07bec-2d10-492d-9c37-361fe0b79427	e3bbc3f8-2bd7-42e4-9356-438a4080eb85
1166	1166	0	National Biodiversity Network	d897a5b9-35ee-4232-94bd-b0bcaac003c2	e4ae858c-039d-4a7b-bf6e-c42c18f0fbd9
0	394	394	Ocean Biodiversity Information System	ba0670b9-4186-41e6-8e70-f9cb3065551a	e4fbb871-4d1b-47e5-b931-0ca9e1f84bf5
82	82	0	Plazi	ffb07bec-2d10-492d-9c37-361fe0b79427	eab2b696-915d-4d62-b5a7-b5188c1e4cbb
9	9	0	Plazi	ffb07bec-2d10-492d-9c37-361fe0b79427	eb04d275-3eca-4339-b822-866f5e265066
0	10	10	Plazi	ffb07bec-2d10-492d-9c37-361fe0b79427	ec7839a0-bda1-46f4-bfbe-f065b13f9682
8005	8005	0	GBIF Germany	4f6826f2-4ff6-443d-b966-e6913bd24013	ece4ea69-9ec5-4773-a5dc-7a99b245e415
15	15	0	Participant Node Managers Committee	7f48e0c8-5c96-49ec-b972-30748e339115	ed927893-2736-49d5-8662-642d40f9f952
0	3	3	Plazi	ffb07bec-2d10-492d-9c37-361fe0b79427	ee5f89eb-2e99-4836-8a78-18f77656bc17
0	615	615	Atlas of Living Australia	4a6f1b71-969e-4fc5-a693-282b05e1220c	ef1284ee-fa76-4c2a-8547-99d130d76804
0	1154	1154	GBIF France	da44cd31-5901-4687-a106-6d1c7734ee3a	f10407e8-e66a-4c11-aa3c-44607b4e7c49
2184	2184	0	National Biodiversity Network	d897a5b9-35ee-4232-94bd-b0bcaac003c2	f44faab9-1031-4e11-8cb7-66fea12414bb
3738	3738	0	GBIF Norway	4f829580-180d-46a9-9c87-ed8ec959b545	f60aa56f-cbb7-4f55-8a6d-67288d5ba9b1
0	2	2	Plazi	ffb07bec-2d10-492d-9c37-361fe0b79427	f73e8ddd-000f-4471-b4fd-164a87fb6aa8
3062	3062	0	Biodiversity Information System of Mexico	b324e8e9-9a4c-44fa-8f1a-7f39ea7ab576	f75482a0-f244-4bd2-aff9-92130e99bbe2
0	248	248	Colombian Biodiversity Information System	7e865cba-7c46-417b-ade5-97f2cf5b7be0	fbb27d70-6864-416a-8d39-b99d6c257210
37	37	0	Plazi	ffb07bec-2d10-492d-9c37-361fe0b79427	fdbc45bb-a0df-4472-8cb7-ca718f01b8d6
3472	3472	0	GBIF Germany	4f6826f2-4ff6-443d-b966-e6913bd24013	feae2649-360e-431d-b49c-debcbeb01ad6
5	5	0	Plazi	ffb07bec-2d10-492d-9c37-361fe0b79427	00b558f7-f916-4658-b770-9590e0836283
58475	58475	0	U.S. Geological Survey	8618c64a-93e0-4300-b546-7249e5148ed2	02242d2f-b43f-44d1-8e53-4c51af461f5b
373	373	0	National Biodiversity Data Centre	422b00b2-6c94-4bb6-976b-c359916efdb8	028da6e9-b2c7-4a66-90ee-3fc1670f6e8f
2707	2707	0	GBIF Spain	1f94b3ca-9345-4d65-afe2-4bace93aa0fe	04c42f78-51bd-4d70-8cbf-ef16964d2f34
16334	17239	905	GBIF Brazil	cdc9736d-5ff7-4ece-9959-3c744360cdb3	05776b2b-eda0-4a70-ba81-986e3f100e1a
38	38	0	Plazi	ffb07bec-2d10-492d-9c37-361fe0b79427	088bbc78-ee77-4fc8-b487-1e061da8009a
5012	5012	0	Biodiversity Information System of Mexico	b324e8e9-9a4c-44fa-8f1a-7f39ea7ab576	0abad0df-c5b2-44e9-9cef-5d2c5c04ea69
3	3	0	Plazi	ffb07bec-2d10-492d-9c37-361fe0b79427	0accf87d-7caf-45ef-9d8f-fa2e868a88a9
7	7	0	Plazi	ffb07bec-2d10-492d-9c37-361fe0b79427	0dbfd769-022a-4f18-9a99-447e5e865f89
169854	169854	0	Participant Node Managers Committee	7f48e0c8-5c96-49ec-b972-30748e339115	0eacbbfa-45b9-41dc-b7e3-1f0773ce1477
34	34	0	Participant Node Managers Committee	7f48e0c8-5c96-49ec-b972-30748e339115	0f7e074d-c7da-40c9-89a3-b9eef2007698
8	8	0	Plazi	ffb07bec-2d10-492d-9c37-361fe0b79427	1232073f-c7d7-48ad-b5ce-ef7d585a4de5
1024	1024	0	National Biodiversity Network	d897a5b9-35ee-4232-94bd-b0bcaac003c2	139ad531-70de-40c2-8525-0db6fa27b0dc
2390	2390	0	Secretariat of the Pacific Regional Environment Programme	29c6a139-ea7f-41f5-8d9b-c55af8736182	14f889f3-6ab2-4431-bbed-58cbd1afbc6f
77	77	0	Plazi	ffb07bec-2d10-492d-9c37-361fe0b79427	18b8b529-9043-414e-b7f0-2a975e51c7ce
0	3	3	Plazi	ffb07bec-2d10-492d-9c37-361fe0b79427	193525f9-e9b4-4c47-a842-d66e83775ecc
662	662	0	Netherlands Biodiversity Information Facility	0909d601-bda2-42df-9e63-a6d51847ebce	19bc01d7-8a5f-4048-9699-8bf7385d8804
49	49	0	National Biodiversity Network	d897a5b9-35ee-4232-94bd-b0bcaac003c2	1ab44d22-13ab-47fa-b49a-681343c8b90b
0	10	10	Plazi	ffb07bec-2d10-492d-9c37-361fe0b79427	1d13c388-548f-4758-afb4-f6a2f85e0e7e
1	1	0	Plazi	ffb07bec-2d10-492d-9c37-361fe0b79427	1e6a80cf-c6c2-405d-aea7-40c06b58bf93
61	61	0	Colombian Biodiversity Information System	7e865cba-7c46-417b-ade5-97f2cf5b7be0	1edd9aea-2fc9-4789-abc6-7826e88af037
0	22	22	Chinese Academy of Sciences	e760dc6f-dd68-474d-ab41-bd3588571793	1fd51272-3b89-4a1f-8ad8-b66c43e3f1ad
0	37	37	Ocean Biodiversity Information System	ba0670b9-4186-41e6-8e70-f9cb3065551a	20603f30-3255-4904-8085-ee7806c739cb
6051	6051	0	National Biodiversity Network	d897a5b9-35ee-4232-94bd-b0bcaac003c2	206ce4fc-3527-43b2-ab77-f51ea9f6f6c9
21	21	0	Plazi	ffb07bec-2d10-492d-9c37-361fe0b79427	23dc5851-357d-4fa0-984b-2e81aca308a5
6	6	0	Plazi	ffb07bec-2d10-492d-9c37-361fe0b79427	255e83c2-d4a3-41dd-a72e-2a92fe17daa4
264	264	0	GBIF France	da44cd31-5901-4687-a106-6d1c7734ee3a	26098d07-6d8c-4079-891a-5e8d674c710f
803	803	0	National Biodiversity Network	d897a5b9-35ee-4232-94bd-b0bcaac003c2	284c8617-59ac-4579-a4bf-01bc84721be1
4033	4033	0	National Biodiversity Network	d897a5b9-35ee-4232-94bd-b0bcaac003c2	2a3619d8-6dc9-4f8e-8e39-a1a42641a862
852	852	0	Participant Node Managers Committee	7f48e0c8-5c96-49ec-b972-30748e339115	2a69b0d9-546d-4953-917e-7e6e30731a44
25	25	0	Plazi	ffb07bec-2d10-492d-9c37-361fe0b79427	2a7f7990-456d-40ea-9a68-64c28fa53d9a
0	458	458	U.S. Geological Survey	8618c64a-93e0-4300-b546-7249e5148ed2	2e457886-b046-4ed2-8ffe-72def411b8c9
5	5	0	Plazi	ffb07bec-2d10-492d-9c37-361fe0b79427	30bb0609-0304-4ded-8c6d-fd05c534537d
217307	217307	0	Society for the Management of Electronic Biodiversity Data	97818ee4-1461-4180-bf1d-b3201050124f	312bb844-4980-4b1a-a64b-e79f9ac083a4
36184	36184	0	GBIF France	da44cd31-5901-4687-a106-6d1c7734ee3a	34ca4f5c-f7bd-46d0-95a0-fe954a5074b3
8165	8165	0	GBIF France	da44cd31-5901-4687-a106-6d1c7734ee3a	353cabdf-17f8-4e47-9656-47f333d7704c
0	35	35	Plazi	ffb07bec-2d10-492d-9c37-361fe0b79427	3678bdb3-f334-4b57-8f9a-b4d5bff857c6
125	125	0	Plazi	ffb07bec-2d10-492d-9c37-361fe0b79427	378ebf94-4b5c-4451-90f4-4109f9b27ea9
86	86	0	Plazi	ffb07bec-2d10-492d-9c37-361fe0b79427	3a7a0350-3c58-40e6-8648-fe6e019bbe54
925	925	0	GBIF France	da44cd31-5901-4687-a106-6d1c7734ee3a	3b1325b0-7fbc-4997-bb59-e21f09717730
192	192	0	Colombian Biodiversity Information System	7e865cba-7c46-417b-ade5-97f2cf5b7be0	3c18c500-1dd3-4e7c-a2c8-88e5567235d3
24	24	0	Plazi	ffb07bec-2d10-492d-9c37-361fe0b79427	3ec8c336-8b17-43e4-a989-b0dcf0f823cc
4722	4722	0	GBIF Argentina	2426a871-9feb-40a1-96c6-0c593a76b835	3fcc20af-1051-4773-8ef2-f7284a4d53b4
0	1	1	Participant Node Managers Committee	7f48e0c8-5c96-49ec-b972-30748e339115	411f7087-6569-41e0-b793-175a64e17407
200	200	0	Plazi	ffb07bec-2d10-492d-9c37-361fe0b79427	414a9fa5-0e04-4b8f-88e6-0b0888a0edef
2	2	0	GBIF Germany	4f6826f2-4ff6-443d-b966-e6913bd24013	43c03dee-3a0c-11e2-b0ce-00145eb45e9a
2	2	0	Plazi	ffb07bec-2d10-492d-9c37-361fe0b79427	43dd072d-56b0-4454-80a7-591d5efcc4d3
21	21	0	Plazi	ffb07bec-2d10-492d-9c37-361fe0b79427	462d8d84-7413-49a3-9611-65c6961240a8
1025	1025	0	GBIF Germany	4f6826f2-4ff6-443d-b966-e6913bd24013	48092b8a-a73f-4546-bd9e-b58f3c591352
190	190	0	Colombian Biodiversity Information System	7e865cba-7c46-417b-ade5-97f2cf5b7be0	4a96dc96-1bab-4d3d-867b-c7e612fd30a5
0	7	7	Ocean Biodiversity Information System	ba0670b9-4186-41e6-8e70-f9cb3065551a	4b1c895e-edef-482f-8f41-d6ad3c9335b9
1	1	0	Plazi	ffb07bec-2d10-492d-9c37-361fe0b79427	4f7bdb82-291d-4f67-9c8d-05d993203cf5
3	3	0	Plazi	ffb07bec-2d10-492d-9c37-361fe0b79427	51a627cb-5754-4bba-8468-270101f7702d
2	2	0	Plazi	ffb07bec-2d10-492d-9c37-361fe0b79427	54e89cab-17a1-4a1f-a6eb-e7e4e78527ec
3	3	0	Plazi	ffb07bec-2d10-492d-9c37-361fe0b79427	566eaab2-9ce6-442d-b85f-eb11b344fbd4
4	4	0	Plazi	ffb07bec-2d10-492d-9c37-361fe0b79427	5716c1a2-e443-46c2-a015-be5c83db2803
1	1	0	Plazi	ffb07bec-2d10-492d-9c37-361fe0b79427	58855bc0-8cdd-4c52-81c6-84586895221c
0	6	6	Plazi	ffb07bec-2d10-492d-9c37-361fe0b79427	59174531-fe6f-4215-a12f-e89774871d14
444	444	0	GBIF Finland	dd514216-5c7c-45f3-910d-797424cb5be6	5c1f02e2-234b-4d0c-8246-2cd5c76db26a
57	57	0	Plazi	ffb07bec-2d10-492d-9c37-361fe0b79427	5dc6e760-5dcb-4928-a58e-c88c8524b8f9
3629	3629	0	National Biodiversity Network	d897a5b9-35ee-4232-94bd-b0bcaac003c2	61a40045-7ef2-4293-85f8-2ff39b2d67ae
110	110	0	GBIF Germany	4f6826f2-4ff6-443d-b966-e6913bd24013	61fd8646-f762-11e1-a439-00145eb45e9a
12	12	0	Plazi	ffb07bec-2d10-492d-9c37-361fe0b79427	62be3a8c-ea5d-4503-aaa7-128d32879cfa
59	59	0	GBIF Germany	4f6826f2-4ff6-443d-b966-e6913bd24013	63395fda-f762-11e1-a439-00145eb45e9a
3	3	0	Plazi	ffb07bec-2d10-492d-9c37-361fe0b79427	633f557a-8355-4a7d-ae96-f027096e3ec7
26	26	0	Plazi	ffb07bec-2d10-492d-9c37-361fe0b79427	63db7ca1-2866-4510-9ce8-b9ad97f41703
145	145	0	GBIF Germany	4f6826f2-4ff6-443d-b966-e6913bd24013	6403d346-f762-11e1-a439-00145eb45e9a
30	30	0	GBIF Germany	4f6826f2-4ff6-443d-b966-e6913bd24013	64979716-f762-11e1-a439-00145eb45e9a
384	384	0	GBIF Germany	4f6826f2-4ff6-443d-b966-e6913bd24013	649e5f4c-f762-11e1-a439-00145eb45e9a
0	1	1	Plazi	ffb07bec-2d10-492d-9c37-361fe0b79427	64fed6a7-107a-424d-a7b9-5e2173e2e308
453	453	0	GBIF Germany	4f6826f2-4ff6-443d-b966-e6913bd24013	65535a6e-f762-11e1-a439-00145eb45e9a
2083	2083	0	GBIF Portugal	673f7038-4262-4149-b753-5658a4e912f6	65f32597-48a7-4877-ae13-e4256b51fb6b
3	3	0	Plazi	ffb07bec-2d10-492d-9c37-361fe0b79427	675a4327-9125-4bb1-99a1-e6e930ce6eae
2736	2736	0	GBIF France	da44cd31-5901-4687-a106-6d1c7734ee3a	6767f28d-5a21-48c1-9dc9-9681da1ea217
95	95	0	GBIF Germany	4f6826f2-4ff6-443d-b966-e6913bd24013	68528000-f762-11e1-a439-00145eb45e9a
625	625	0	GBIF Germany	4f6826f2-4ff6-443d-b966-e6913bd24013	6a248388-f762-11e1-a439-00145eb45e9a
2549	2549	0	GBIF Germany	4f6826f2-4ff6-443d-b966-e6913bd24013	6a85efce-f762-11e1-a439-00145eb45e9a
4	4	0	GBIF Germany	4f6826f2-4ff6-443d-b966-e6913bd24013	6b4c9c5a-f762-11e1-a439-00145eb45e9a
211	211	0	GBIF Germany	4f6826f2-4ff6-443d-b966-e6913bd24013	6c1147bc-f762-11e1-a439-00145eb45e9a
19	19	0	GBIF Germany	4f6826f2-4ff6-443d-b966-e6913bd24013	6c9504e4-f762-11e1-a439-00145eb45e9a
198	198	0	GBIF Germany	4f6826f2-4ff6-443d-b966-e6913bd24013	6d25b7dc-f762-11e1-a439-00145eb45e9a
1179	1179	0	GBIF Germany	4f6826f2-4ff6-443d-b966-e6913bd24013	6dd92d44-f762-11e1-a439-00145eb45e9a
7	7	0	GBIF Germany	4f6826f2-4ff6-443d-b966-e6913bd24013	6fe08326-f762-11e1-a439-00145eb45e9a
642	642	0	GBIF Germany	4f6826f2-4ff6-443d-b966-e6913bd24013	708e6e1e-f762-11e1-a439-00145eb45e9a
8864	8864	0	Biodiversity Information System of Mexico	b324e8e9-9a4c-44fa-8f1a-7f39ea7ab576	727b83c1-e8a7-4dd9-a9a2-4c4a9ea9636c
168	168	0	GBIF Germany	4f6826f2-4ff6-443d-b966-e6913bd24013	75392d5a-f762-11e1-a439-00145eb45e9a
9	9	0	GBIF Germany	4f6826f2-4ff6-443d-b966-e6913bd24013	78d595b6-f762-11e1-a439-00145eb45e9a
37	37	0	Participant Node Managers Committee	7f48e0c8-5c96-49ec-b972-30748e339115	7ac0e08b-8881-4c06-9d1c-1c3f023e6a7b
3923	3923	0	Ocean Biodiversity Information System	ba0670b9-4186-41e6-8e70-f9cb3065551a	7b542942-f762-11e1-a439-00145eb45e9a
519	519	0	GBIF Germany	4f6826f2-4ff6-443d-b966-e6913bd24013	7bf51082-f762-11e1-a439-00145eb45e9a
8775	6500	-2275	GBIF Germany	4f6826f2-4ff6-443d-b966-e6913bd24013	7c841656-f762-11e1-a439-00145eb45e9a
1	1	0	Plazi	ffb07bec-2d10-492d-9c37-361fe0b79427	7ca3a729-11e2-4c6c-9f55-9ecd6b13a262
48	32	-16	GBIF Germany	4f6826f2-4ff6-443d-b966-e6913bd24013	7ca4f6dc-f762-11e1-a439-00145eb45e9a
176	176	0	GBIF Germany	4f6826f2-4ff6-443d-b966-e6913bd24013	7ccc7f2c-f762-11e1-a439-00145eb45e9a
14	14	0	GBIF Germany	4f6826f2-4ff6-443d-b966-e6913bd24013	7cf9045c-f762-11e1-a439-00145eb45e9a
2336	2310	-26	GBIF Germany	4f6826f2-4ff6-443d-b966-e6913bd24013	7daa46b8-f762-11e1-a439-00145eb45e9a
358	358	0	GBIF Germany	4f6826f2-4ff6-443d-b966-e6913bd24013	7e9eeb78-f762-11e1-a439-00145eb45e9a
39541	39541	0	National Biodiversity Network	d897a5b9-35ee-4232-94bd-b0bcaac003c2	7ea4a04e-4610-4bca-8450-9f654c87ef22
0	40	40	Plazi	ffb07bec-2d10-492d-9c37-361fe0b79427	7ec5a262-b30b-4489-87ec-c3b197ed2088
2118	2118	0	Colombian Biodiversity Information System	7e865cba-7c46-417b-ade5-97f2cf5b7be0	8054f634-a3d9-49b8-b2b2-3dfae0e82a54
3	3	0	GBIF Japan	db5705aa-6a6e-42f1-8942-d77b9f4896ea	80fd810e-f762-11e1-a439-00145eb45e9a
110	110	0	Plazi	ffb07bec-2d10-492d-9c37-361fe0b79427	810b55e4-b8ba-4368-bf9c-8517ee33e7d0
8	8	0	GBIF Portugal	673f7038-4262-4149-b753-5658a4e912f6	8129bd30-6a5e-4d72-b602-75355ac73182
206646	206646	0	National Biodiversity Network	d897a5b9-35ee-4232-94bd-b0bcaac003c2	84fc98d0-972c-42c1-817f-038bf5e35c0f
12	12	0	GBIF Germany	4f6826f2-4ff6-443d-b966-e6913bd24013	871a45ae-f762-11e1-a439-00145eb45e9a
8	8	0	Plazi	ffb07bec-2d10-492d-9c37-361fe0b79427	88098ad9-67d6-4e6b-8362-66e674352258
103	103	0	Belgian Biodiversity Platform	fb11cfe1-ebc3-45af-9159-17d9fddbcdac	88261147-1a23-4a4d-be95-4eb5173c9b20
11941	11941	0	GBIF Spain	1f94b3ca-9345-4d65-afe2-4bace93aa0fe	890afcd2-f762-11e1-a439-00145eb45e9a
9	9	0	Plazi	ffb07bec-2d10-492d-9c37-361fe0b79427	8af65b58-68e9-4355-bcb7-e230aa607da0
7	7	0	Plazi	ffb07bec-2d10-492d-9c37-361fe0b79427	8c20ec52-8244-420c-8053-bd68d8fd4bc0
139	139	0	GBIF Germany	4f6826f2-4ff6-443d-b966-e6913bd24013	8c2f47f6-f762-11e1-a439-00145eb45e9a
15	12	-3	GBIF Germany	4f6826f2-4ff6-443d-b966-e6913bd24013	8d1848d4-f762-11e1-a439-00145eb45e9a
4	4	0	Plazi	ffb07bec-2d10-492d-9c37-361fe0b79427	8dee825b-a087-4811-9e3f-4a72c9c8af24
1140	900	-240	GBIF Germany	4f6826f2-4ff6-443d-b966-e6913bd24013	8e7b4794-f762-11e1-a439-00145eb45e9a
5168	3572	-1596	GBIF Germany	4f6826f2-4ff6-443d-b966-e6913bd24013	8e91237a-f762-11e1-a439-00145eb45e9a
41	41	0	Plazi	ffb07bec-2d10-492d-9c37-361fe0b79427	8eed2b3e-bd58-4bed-9222-c5e507664631
39	31	-8	GBIF Germany	4f6826f2-4ff6-443d-b966-e6913bd24013	8fdb6a74-f762-11e1-a439-00145eb45e9a
14	12	-2	GBIF Germany	4f6826f2-4ff6-443d-b966-e6913bd24013	918214cc-f762-11e1-a439-00145eb45e9a
4	4	0	Plazi	ffb07bec-2d10-492d-9c37-361fe0b79427	92af672e-1964-472f-a21e-069db853403b
2	2	0	GBIF Germany	4f6826f2-4ff6-443d-b966-e6913bd24013	93d18adc-f762-11e1-a439-00145eb45e9a
884	776	-108	GBIF Germany	4f6826f2-4ff6-443d-b966-e6913bd24013	9457cf3e-f762-11e1-a439-00145eb45e9a
1	47	46	GBIF Japan	db5705aa-6a6e-42f1-8942-d77b9f4896ea	952fec22-9dfb-4c4f-b5f0-7152595408be
128	128	0	GBIF France	da44cd31-5901-4687-a106-6d1c7734ee3a	95fce101-ceec-4320-bde8-a43b697e1bb5
18	18	0	Plazi	ffb07bec-2d10-492d-9c37-361fe0b79427	970b91ef-477c-47a6-bdb0-a1b6c09de383
197	197	0	GBIF Portugal	673f7038-4262-4149-b753-5658a4e912f6	982c3131-582a-4cd5-9571-9f49fcdb3c5a
0	5	5	Plazi	ffb07bec-2d10-492d-9c37-361fe0b79427	9aceebbe-79da-43cb-847b-b6cf638b6801
12	12	0	GBIF France	da44cd31-5901-4687-a106-6d1c7734ee3a	9c5d9068-f4be-474c-9aa4-138f4315ebad
9	9	0	Plazi	ffb07bec-2d10-492d-9c37-361fe0b79427	9e24e45f-643b-4aca-b8d0-61b40de7459a
0	5	5	Plazi	ffb07bec-2d10-492d-9c37-361fe0b79427	a15b3af7-16c7-492b-bf7b-d08a36b7f6a2
3965	3965	0	Participant Node Managers Committee	7f48e0c8-5c96-49ec-b972-30748e339115	a5882866-47c2-4af9-9151-c630c550e111
16866	16866	0	Canada Biodiversity Information Facility	8f83fc96-c966-4126-83f7-bf044dc49efa	a646b5c3-237e-4057-84d5-266ea0185e34
0	12	12	Plazi	ffb07bec-2d10-492d-9c37-361fe0b79427	a6a595b4-bb5d-4e95-b970-aa3d6e6d0f3a
7	7	0	Plazi	ffb07bec-2d10-492d-9c37-361fe0b79427	a879ea9e-d9c9-4726-932f-a39458823a1c
55	55	0	Plazi	ffb07bec-2d10-492d-9c37-361fe0b79427	a929eda2-1d3b-423d-904e-b41ba1e48894
5890	5890	0	U.S. Geological Survey	8618c64a-93e0-4300-b546-7249e5148ed2	a958cf24-75e9-48f2-a70d-d14de797a48d
5	5	0	Plazi	ffb07bec-2d10-492d-9c37-361fe0b79427	a9e0336c-85fe-4d7c-8998-fadb8b1e4a29
0	166	166	Plazi	ffb07bec-2d10-492d-9c37-361fe0b79427	ab929ee4-4987-4dd0-a525-2e97236bd6d3
2	2	0	Plazi	ffb07bec-2d10-492d-9c37-361fe0b79427	abbfab53-8217-465b-abb2-6c4520d0a383
0	185	185	Plazi	ffb07bec-2d10-492d-9c37-361fe0b79427	add91096-4341-4cad-8dbb-4f2fa3dbd773
277	277	0	GBIF France	da44cd31-5901-4687-a106-6d1c7734ee3a	ae333705-c491-4b52-a7fc-b141f0ada85e
8	8	0	Participant Node Managers Committee	7f48e0c8-5c96-49ec-b972-30748e339115	b0b2f281-7575-42de-b730-6dd364754062
3004	3004	0	Netherlands Biodiversity Information Facility	0909d601-bda2-42df-9e63-a6d51847ebce	b6ca95b0-c066-11dd-a312-b8a03c50a862
3984	3984	0	South African Biodiversity Information Facility	7190b835-4e86-4b6e-85c1-19cc6677c250	b9aab537-db65-4b7c-ab35-0a4877703dde
16	16	0	Plazi	ffb07bec-2d10-492d-9c37-361fe0b79427	b9f09593-6aa2-4481-8e98-51b5626af5ac
96	96	0	GBIF Germany	4f6826f2-4ff6-443d-b966-e6913bd24013	babe3979-25b1-4641-a5bf-64545e406df8
27847	27847	0	GBIF Spain	1f94b3ca-9345-4d65-afe2-4bace93aa0fe	bb1c7420-fbb5-46e2-87ad-658081360694
1	1	0	Plazi	ffb07bec-2d10-492d-9c37-361fe0b79427	bbc149f3-3578-4ae7-a13c-5d22f00a8768
32	32	0	Plazi	ffb07bec-2d10-492d-9c37-361fe0b79427	bc689683-8dd5-442e-90a6-adbb7221aad6
8851	8851	0	National Biodiversity Network	d897a5b9-35ee-4232-94bd-b0bcaac003c2	bcba1531-fb72-4a70-ade4-3845f58005a6
54	54	0	GBIF France	da44cd31-5901-4687-a106-6d1c7734ee3a	c2110d4a-0883-48b6-9f03-37d458b46240
7148	7148	0	U.S. Geological Survey	8618c64a-93e0-4300-b546-7249e5148ed2	c50340a3-54f9-46fa-aecb-6197bcfa1b54
156265	156265	0	GBIF Germany	4f6826f2-4ff6-443d-b966-e6913bd24013	c5c2542c-408f-442f-97d0-3a97562fe5ec
106820	106820	0	U.S. Geological Survey	8618c64a-93e0-4300-b546-7249e5148ed2	c67df85a-9a3d-4b93-9625-d1f4b1e2d6f2
3312	3312	0	GBIF Viet Nam	7f4b5eab-2edf-4b46-9360-d9574ab0f1d7	c7c676f9-b87d-474b-af48-b021a5094ff1
6	6	0	Plazi	ffb07bec-2d10-492d-9c37-361fe0b79427	c972bdea-ffd6-46e9-9d7e-2543609076fd
9	9	0	Plazi	ffb07bec-2d10-492d-9c37-361fe0b79427	c9cca315-0a78-4e20-8293-3e6022b66b7c
8523	8616	93	U.S. Geological Survey	8618c64a-93e0-4300-b546-7249e5148ed2	cb0eb5bf-4759-4aa1-92b5-4143b0a64e15
0	67	67	Plazi	ffb07bec-2d10-492d-9c37-361fe0b79427	cd567429-9cd9-45f1-ae33-d40736478046
107	107	0	GBIF France	da44cd31-5901-4687-a106-6d1c7734ee3a	cd6e383d-33a0-4c8c-b91c-ede5a41b61e8
113	113	0	Plazi	ffb07bec-2d10-492d-9c37-361fe0b79427	ce27a957-859f-4f3b-976b-86716dd118a5
6440	6440	0	National Biodiversity Network	d897a5b9-35ee-4232-94bd-b0bcaac003c2	d0dcc6de-f7de-42f5-8a70-917b82ace4a5
1	1	0	Plazi	ffb07bec-2d10-492d-9c37-361fe0b79427	d19118bb-90aa-4c54-97a5-d455f484436c
0	1016	1016	GBIF Norway	4f829580-180d-46a9-9c87-ed8ec959b545	d391c193-0fc0-4a96-bdac-6043dd9516d1
14	14	0	Plazi	ffb07bec-2d10-492d-9c37-361fe0b79427	d3ab996a-3124-4733-93fd-7eadcacdc179
15164	15164	0	National Biodiversity Network	d897a5b9-35ee-4232-94bd-b0bcaac003c2	d3ed14a0-da64-4179-9643-4927deeb5126
2564	2564	0	GBIF France	da44cd31-5901-4687-a106-6d1c7734ee3a	d6bef7ce-2340-401d-9151-fd258a2dd5db
259	259	0	GBIF France	da44cd31-5901-4687-a106-6d1c7734ee3a	d7053f5b-2078-4a21-9d8d-a6d81a177df5
76124	76124	0	GBIF Norway	4f829580-180d-46a9-9c87-ed8ec959b545	d74d5b23-922d-40ff-9120-eb742d1d66f6
585	585	0	Participant Node Managers Committee	7f48e0c8-5c96-49ec-b972-30748e339115	d8f221d7-a4e6-4d45-9296-b3836893bee1
61	61	0	Plazi	ffb07bec-2d10-492d-9c37-361fe0b79427	da18d6cf-db48-4fc6-b74d-2e763b6bf888
992	992	0	Biodiversity Information System of Mexico	b324e8e9-9a4c-44fa-8f1a-7f39ea7ab576	da1c5803-9ceb-4b4b-96ae-5818471d4a5f
557	557	0	GBIF France	da44cd31-5901-4687-a106-6d1c7734ee3a	db5f7e43-1198-4712-b209-e594c923eb7b
0	5986	5986	Participant Node Managers Committee	7f48e0c8-5c96-49ec-b972-30748e339115	db908fac-ed42-407e-817c-3f10ce74a28e
0	3	3	Plazi	ffb07bec-2d10-492d-9c37-361fe0b79427	db9f8d1a-9096-4b0c-84c7-cd4c33f9a86d
941	941	0	GBIF Germany	4f6826f2-4ff6-443d-b966-e6913bd24013	dca02654-ee91-408c-a0e8-d864df2eca07
1597	1597	0	GBIF France	da44cd31-5901-4687-a106-6d1c7734ee3a	ddd4dad9-273c-4f8e-b68f-5b4c03525301
53	53	0	Plazi	ffb07bec-2d10-492d-9c37-361fe0b79427	dddb8e0b-7020-4669-9b18-e2c660c9dcc0
0	166	166	Ocean Biodiversity Information System	ba0670b9-4186-41e6-8e70-f9cb3065551a	de5adc1a-144c-4bc4-99f3-2e137932ae16
2648	2648	0	South African Biodiversity Information Facility	7190b835-4e86-4b6e-85c1-19cc6677c250	e0bde7d0-36fb-4036-81fe-4c3429dfa67f
0	366	366	Ocean Biodiversity Information System	ba0670b9-4186-41e6-8e70-f9cb3065551a	e2adead7-52f8-4c13-a60e-4e9969cee817
0	1	1	Plazi	ffb07bec-2d10-492d-9c37-361fe0b79427	e4383849-346d-4c1a-ab4a-d4f8bfd06d76
1741	1741	0	Korean Biodiversity Information Facility	e0a1e772-0177-4800-94b4-2d023fe6cdf4	e664d5b6-626d-4977-aa95-0bc20af5b168
3	3	0	Plazi	ffb07bec-2d10-492d-9c37-361fe0b79427	e7a395e6-38d8-4cbc-8365-6e883cd0d060
321	59	-262	GBIF Germany	4f6826f2-4ff6-443d-b966-e6913bd24013	eb1e7397-b1df-4c31-a491-f9bc29c5bfb9
6291	6287	-4	GBIF Japan	db5705aa-6a6e-42f1-8942-d77b9f4896ea	ec3800df-fdcf-4925-a350-d7de3f1f9597
1584	1584	0	Colombian Biodiversity Information System	7e865cba-7c46-417b-ade5-97f2cf5b7be0	f192489c-ee4a-4f49-a0df-47b598fe3caa
0	3	3	Plazi	ffb07bec-2d10-492d-9c37-361fe0b79427	f29e243d-c83d-4900-a356-48bf5aac92fd
38694	38694	0	Atlas of Living Australia	4a6f1b71-969e-4fc5-a693-282b05e1220c	f338c61f-4861-4dea-9379-96d98d8ede85
0	15	15	Plazi	ffb07bec-2d10-492d-9c37-361fe0b79427	f3d9ce1e-187d-425e-a094-c547ff358175
10	10	0	National Biodiversity Network	d897a5b9-35ee-4232-94bd-b0bcaac003c2	f68a06a3-5d58-4782-a913-b255f0b177c9
0	3	3	Plazi	ffb07bec-2d10-492d-9c37-361fe0b79427	f702f2bf-e817-4863-96f7-f20015f61de3
132	132	0	Colombian Biodiversity Information System	7e865cba-7c46-417b-ade5-97f2cf5b7be0	f90841fd-719a-443c-b6f5-efd11e294e06
58	58	0	GBIF Spain	1f94b3ca-9345-4d65-afe2-4bace93aa0fe	f9367d11-65f0-4206-82b4-5ff986afaa68
0	85	85	Plazi	ffb07bec-2d10-492d-9c37-361fe0b79427	fb046e10-a720-45bc-8684-5935587d267f
97	97	0	Colombian Biodiversity Information System	7e865cba-7c46-417b-ade5-97f2cf5b7be0	fc467aa6-0fc4-41d1-908b-fbe7d27c72fc
0	5	5	Plazi	ffb07bec-2d10-492d-9c37-361fe0b79427	fdb0c1c4-b987-4ed4-b2b6-32ed2bf087d0
10966	10966	0	National Biodiversity Network	d897a5b9-35ee-4232-94bd-b0bcaac003c2	ff1a668d-9b6d-4134-836f-0f3f509bd67a
150	150	0	GBIF Germany	4f6826f2-4ff6-443d-b966-e6913bd24013	040b1fab-9f7d-4b1d-91e5-2d15261e9b6a
20	20	0	National Biodiversity Network	d897a5b9-35ee-4232-94bd-b0bcaac003c2	0966611e-308d-488d-af87-9d7a47c7bd08
17	17	0	Plazi	ffb07bec-2d10-492d-9c37-361fe0b79427	0c1daa9f-2423-497b-84e6-91f72029d512
3062	3584	522	National Biodiversity Network	d897a5b9-35ee-4232-94bd-b0bcaac003c2	10288b46-163b-4789-a95e-0a7cd0c504d4
40	40	0	GBIF France	da44cd31-5901-4687-a106-6d1c7734ee3a	11f7acb1-88ff-42f8-877b-a55c922f57a9
9	9	0	Plazi	ffb07bec-2d10-492d-9c37-361fe0b79427	123704a0-4300-46d9-a355-c5003999e9e8
1	1	0	Plazi	ffb07bec-2d10-492d-9c37-361fe0b79427	1287b0f5-6d6f-40a5-8241-cee5448ce2d2
0	30	30	Plazi	ffb07bec-2d10-492d-9c37-361fe0b79427	1317663d-d980-43c5-8c13-ea7da6f9684f
544	544	0	U.S. Geological Survey	8618c64a-93e0-4300-b546-7249e5148ed2	144e0a35-3fc3-408b-84c9-2ea2959b0a5b
0	2	2	Plazi	ffb07bec-2d10-492d-9c37-361fe0b79427	166df880-568d-4949-8ddf-dd5739e03150
13	13	0	Plazi	ffb07bec-2d10-492d-9c37-361fe0b79427	1a74934b-71d8-462d-a017-cf1f2d9ec1ea
1095	1095	0	GBIF Spain	1f94b3ca-9345-4d65-afe2-4bace93aa0fe	1ed27efd-2a72-4d9b-a2c3-311ce3da5937
148	148	0	GBIF France	da44cd31-5901-4687-a106-6d1c7734ee3a	20c99e6f-e90f-460f-acae-83d48243a8b9
205	205	0	Participant Node Managers Committee	7f48e0c8-5c96-49ec-b972-30748e339115	22b805bb-5b5a-4db8-8ddd-4f7bff767993
79	74	-5	GBIF Germany	4f6826f2-4ff6-443d-b966-e6913bd24013	252d72b3-6ab2-40d4-aed1-38aadce49dd2
21	21	0	GBIF Sweden	a0b3be64-6525-4387-ac67-a499950f92e1	25b774ab-600b-4fa7-9ff3-0fdf6cd0c09a
20559	20559	0	GBIF France	da44cd31-5901-4687-a106-6d1c7734ee3a	26e9823f-0545-4b67-9e6d-30b16d657835
1362	1362	0	GBIF France	da44cd31-5901-4687-a106-6d1c7734ee3a	288b792a-840c-4712-9903-39c717410731
17	17	0	National Biodiversity Network	d897a5b9-35ee-4232-94bd-b0bcaac003c2	29b9bcc6-b4f8-4d8e-9e4b-a2e322102272
863	863	0	Atlas of Living Australia	4a6f1b71-969e-4fc5-a693-282b05e1220c	2ab285bd-1e2c-4e93-b321-ef1c5160730f
56	56	0	GBIF Argentina	2426a871-9feb-40a1-96c6-0c593a76b835	2d203ffe-c106-430b-b027-109917027d2c
691	691	0	Participant Node Managers Committee	7f48e0c8-5c96-49ec-b972-30748e339115	2e8e59ba-4132-47ab-9923-dfc0c046683b
7	7	0	GBIF France	da44cd31-5901-4687-a106-6d1c7734ee3a	30da3775-27a3-420d-8db6-0263689bd175
8	8	0	GBIF Germany	4f6826f2-4ff6-443d-b966-e6913bd24013	31330278-9af4-46c7-b297-7b981cb7a15d
0	2	2	Plazi	ffb07bec-2d10-492d-9c37-361fe0b79427	31a1f5f3-e9af-4bb5-a22a-c1f002c33c70
0	1	1	Plazi	ffb07bec-2d10-492d-9c37-361fe0b79427	33f0ee9e-15aa-46ea-86b6-8e00e5c0c78f
696	696	0	National Biodiversity Network	d897a5b9-35ee-4232-94bd-b0bcaac003c2	353621e4-72dc-4890-be87-bc52903645a9
7410	7410	0	GBIF Norway	4f829580-180d-46a9-9c87-ed8ec959b545	3538370e-448f-4214-a1d4-49687d4cae17
449	449	0	GBIF Norway	4f829580-180d-46a9-9c87-ed8ec959b545	377b0deb-3dba-472b-97ca-965f7231ee38
47	47	0	Plazi	ffb07bec-2d10-492d-9c37-361fe0b79427	38a1367e-58f4-43be-8f3f-87d083291a00
19	19	0	Plazi	ffb07bec-2d10-492d-9c37-361fe0b79427	42d7a17e-6244-4e0f-a340-e49558f5acaa
12731	12731	0	Atlas of Living Australia	4a6f1b71-969e-4fc5-a693-282b05e1220c	438e6744-b15a-4dad-8028-2d08485dff17
400	400	0	National Biodiversity Network	d897a5b9-35ee-4232-94bd-b0bcaac003c2	4473fc4b-333e-41e7-9ed6-301e7461583e
3497	3497	0	Colombian Biodiversity Information System	7e865cba-7c46-417b-ade5-97f2cf5b7be0	4669cfa4-6379-4e7d-8b22-1d977d7d2197
10	10	0	Plazi	ffb07bec-2d10-492d-9c37-361fe0b79427	46ce5872-0a04-4739-ac46-9bb641fd75df
0	125	125	Plazi	ffb07bec-2d10-492d-9c37-361fe0b79427	492b2757-6d0c-489b-a611-2644760307c7
689	689	0	Colombian Biodiversity Information System	7e865cba-7c46-417b-ade5-97f2cf5b7be0	49b3c2bb-2437-474f-996c-7a018b945151
3	3	0	Plazi	ffb07bec-2d10-492d-9c37-361fe0b79427	4a86c8da-7d45-439f-8e46-f4cebc069144
48	48	0	GBIF Japan	db5705aa-6a6e-42f1-8942-d77b9f4896ea	4c41cd76-942e-481f-9999-42744ea7b7c8
15	15	0	Plazi	ffb07bec-2d10-492d-9c37-361fe0b79427	4d2bfb35-52a9-4f82-8dc5-497d463c781d
4059	4059	0	GBIF Portugal	673f7038-4262-4149-b753-5658a4e912f6	4db1f3ca-02e6-4b42-880c-981d7cc76a82
1012	1012	0	GBIF France	da44cd31-5901-4687-a106-6d1c7734ee3a	4f83f880-4fe1-48ce-84a5-32c30948e111
9	9	0	Participant Node Managers Committee	7f48e0c8-5c96-49ec-b972-30748e339115	530feb0e-61cd-4058-bb50-328e2230ea82
0	15	15	Plazi	ffb07bec-2d10-492d-9c37-361fe0b79427	53a10958-53d5-4d0c-aa0e-de63c2b6f37a
0	8	8	Plazi	ffb07bec-2d10-492d-9c37-361fe0b79427	5aa0b8cf-ebe0-4f4b-8797-dd342d5720f6
0	4	4	Plazi	ffb07bec-2d10-492d-9c37-361fe0b79427	5e5b56e6-a1ba-43cd-b618-8bde4cbd9ffe
0	18	18	Plazi	ffb07bec-2d10-492d-9c37-361fe0b79427	5f10376b-c1d4-42b7-8ee4-d6c4a3472e1e
2203	2203	0	Biodiversity Information System of Mexico	b324e8e9-9a4c-44fa-8f1a-7f39ea7ab576	5ff00d49-e775-4545-b641-12eb24251201
97	97	0	GBIF Germany	4f6826f2-4ff6-443d-b966-e6913bd24013	61263bbe-f762-11e1-a439-00145eb45e9a
97	97	0	GBIF Germany	4f6826f2-4ff6-443d-b966-e6913bd24013	620b61d0-f762-11e1-a439-00145eb45e9a
2032	2032	0	Biodiversity Information System of Mexico	b324e8e9-9a4c-44fa-8f1a-7f39ea7ab576	63866322-6218-4ae9-8e7b-da129dd2fdc8
996	996	0	Biodiversity Information System of Mexico	b324e8e9-9a4c-44fa-8f1a-7f39ea7ab576	6438540e-ba7f-4e91-81bf-c3654f2a6071
12	12	0	GBIF Germany	4f6826f2-4ff6-443d-b966-e6913bd24013	64885832-f762-11e1-a439-00145eb45e9a
173	173	0	GBIF Germany	4f6826f2-4ff6-443d-b966-e6913bd24013	64c33574-f762-11e1-a439-00145eb45e9a
424	240	-184	GBIF Germany	4f6826f2-4ff6-443d-b966-e6913bd24013	654352ae-f762-11e1-a439-00145eb45e9a
112	112	0	GBIF Germany	4f6826f2-4ff6-443d-b966-e6913bd24013	6685202a-f762-11e1-a439-00145eb45e9a
82	82	0	National Biodiversity Data Centre	422b00b2-6c94-4bb6-976b-c359916efdb8	66a51aea-8662-4685-9fd0-9d4b596617d5
6	6	0	Plazi	ffb07bec-2d10-492d-9c37-361fe0b79427	6758c39f-119f-401b-bf6e-c458ea4f4dca
50	50	0	GBIF Germany	4f6826f2-4ff6-443d-b966-e6913bd24013	67c242ec-f762-11e1-a439-00145eb45e9a
8	8	0	GBIF Germany	4f6826f2-4ff6-443d-b966-e6913bd24013	693b6f0e-f762-11e1-a439-00145eb45e9a
85	85	0	GBIF Germany	4f6826f2-4ff6-443d-b966-e6913bd24013	6988542c-f762-11e1-a439-00145eb45e9a
119	119	0	National Biodiversity Network	d897a5b9-35ee-4232-94bd-b0bcaac003c2	69bfc884-d7fa-4d05-a4b5-5271dc43fa83
16119	16119	0	National Biodiversity Network	d897a5b9-35ee-4232-94bd-b0bcaac003c2	69fd3e33-fc2b-450c-9970-fdf632ac54bb
698	698	0	GBIF Germany	4f6826f2-4ff6-443d-b966-e6913bd24013	6ba6fcf4-f762-11e1-a439-00145eb45e9a
7	7	0	Plazi	ffb07bec-2d10-492d-9c37-361fe0b79427	6c71c062-4867-4d9d-a267-871140b8dd35
1343	1343	0	GBIF France	da44cd31-5901-4687-a106-6d1c7734ee3a	6f581c8e-62f0-42aa-9eab-7281b7405b97
37	37	0	GBIF Germany	4f6826f2-4ff6-443d-b966-e6913bd24013	6f9f78e0-f762-11e1-a439-00145eb45e9a
21	21	0	GBIF Germany	4f6826f2-4ff6-443d-b966-e6913bd24013	72983d2a-f762-11e1-a439-00145eb45e9a
70366	70366	0	GBIF France	da44cd31-5901-4687-a106-6d1c7734ee3a	72a17f09-ceaa-4420-aff3-3bb99564774e
14	14	0	GBIF Germany	4f6826f2-4ff6-443d-b966-e6913bd24013	73735838-f762-11e1-a439-00145eb45e9a
0	3	3	Plazi	ffb07bec-2d10-492d-9c37-361fe0b79427	739ea5b6-6c4b-4c0b-85c2-80554bdfc2db
15	15	0	GBIF Germany	4f6826f2-4ff6-443d-b966-e6913bd24013	73b41f80-f762-11e1-a439-00145eb45e9a
26	26	0	GBIF Germany	4f6826f2-4ff6-443d-b966-e6913bd24013	73b57114-f762-11e1-a439-00145eb45e9a
23	23	0	GBIF Germany	4f6826f2-4ff6-443d-b966-e6913bd24013	75456ade-f762-11e1-a439-00145eb45e9a
140	140	0	GBIF Germany	4f6826f2-4ff6-443d-b966-e6913bd24013	75c0e97a-f762-11e1-a439-00145eb45e9a
7	7	0	GBIF Germany	4f6826f2-4ff6-443d-b966-e6913bd24013	78e181be-f762-11e1-a439-00145eb45e9a
36	36	0	GBIF Germany	4f6826f2-4ff6-443d-b966-e6913bd24013	7926528a-f762-11e1-a439-00145eb45e9a
839	660	-179	GBIF Germany	4f6826f2-4ff6-443d-b966-e6913bd24013	7985186a-f762-11e1-a439-00145eb45e9a
206	206	0	Atlas of Living Australia	4a6f1b71-969e-4fc5-a693-282b05e1220c	7a01619e-0e49-49fa-afcf-5a95428f0458
1	1	0	GBIF Germany	4f6826f2-4ff6-443d-b966-e6913bd24013	7a83ae5c-f762-11e1-a439-00145eb45e9a
42	42	0	GBIF Germany	4f6826f2-4ff6-443d-b966-e6913bd24013	7acb1062-f762-11e1-a439-00145eb45e9a
1914	1650	-264	GBIF Germany	4f6826f2-4ff6-443d-b966-e6913bd24013	7c818710-f762-11e1-a439-00145eb45e9a
1410	1410	0	GBIF Germany	4f6826f2-4ff6-443d-b966-e6913bd24013	7e23f440-f762-11e1-a439-00145eb45e9a
13	13	0	Plazi	ffb07bec-2d10-492d-9c37-361fe0b79427	7e43bf72-1c01-4166-8a56-681856eb46db
59	59	0	GBIF Germany	4f6826f2-4ff6-443d-b966-e6913bd24013	7ef69e72-f762-11e1-a439-00145eb45e9a
923	923	0	National Biodiversity Network	d897a5b9-35ee-4232-94bd-b0bcaac003c2	80a18648-0d97-40b6-831c-71ca612bd154
26111	26111	0	U.S. Geological Survey	8618c64a-93e0-4300-b546-7249e5148ed2	8117733e-f762-11e1-a439-00145eb45e9a
665	665	0	GBIF Germany	4f6826f2-4ff6-443d-b966-e6913bd24013	813d9e24-f762-11e1-a439-00145eb45e9a
29	29	0	GBIF Germany	4f6826f2-4ff6-443d-b966-e6913bd24013	818f125e-f762-11e1-a439-00145eb45e9a
0	313	313	Ocean Biodiversity Information System	ba0670b9-4186-41e6-8e70-f9cb3065551a	81977522-691d-4bdc-9528-d6d10e92994b
390	390	0	GBIF Benin	efb9c00e-f802-45dd-8826-a52ec45b89ff	81f053a5-2505-48e4-bba6-8c3b3e2a5258
491	349	-142	GBIF Germany	4f6826f2-4ff6-443d-b966-e6913bd24013	824bac02-f762-11e1-a439-00145eb45e9a
119279	119279	0	GBIF France	da44cd31-5901-4687-a106-6d1c7734ee3a	8256af7b-37fc-4fe7-99bc-d4454c379374
7865	7865	0	Atlas of Living Australia	4a6f1b71-969e-4fc5-a693-282b05e1220c	834442e7-c3ba-4ff9-bd1f-3288989f7725
6628	6628	0	GBIF Finland	dd514216-5c7c-45f3-910d-797424cb5be6	83b06552-5fb7-46b5-9b9c-aaa724e3ae71
106	106	0	GBIF Germany	4f6826f2-4ff6-443d-b966-e6913bd24013	85d06214-f762-11e1-a439-00145eb45e9a
4	4	0	Plazi	ffb07bec-2d10-492d-9c37-361fe0b79427	870cb481-2691-4f0c-b259-089af77bf753
1037	908	-129	GBIF Germany	4f6826f2-4ff6-443d-b966-e6913bd24013	87289686-f762-11e1-a439-00145eb45e9a
322	247	-75	GBIF Germany	4f6826f2-4ff6-443d-b966-e6913bd24013	880fff4e-f762-11e1-a439-00145eb45e9a
212	128	-84	GBIF Germany	4f6826f2-4ff6-443d-b966-e6913bd24013	88c9d3ce-f762-11e1-a439-00145eb45e9a
234	234	0	GBIF Germany	4f6826f2-4ff6-443d-b966-e6913bd24013	89d6c448-f762-11e1-a439-00145eb45e9a
0	4	4	Plazi	ffb07bec-2d10-492d-9c37-361fe0b79427	8b1c9847-ebd6-4cf7-aaa6-109188534cfc
5	5	0	Plazi	ffb07bec-2d10-492d-9c37-361fe0b79427	8b7e3a10-8d56-4d68-9516-80e08d0565ef
199	199	0	GBIF France	da44cd31-5901-4687-a106-6d1c7734ee3a	8bb346ab-25a8-4992-8d56-901a43f42d1e
0	3	3	Plazi	ffb07bec-2d10-492d-9c37-361fe0b79427	8be6fd07-6dce-4c6c-9c4e-f2c72006aa86
941	941	0	National Biodiversity Network	d897a5b9-35ee-4232-94bd-b0bcaac003c2	8cb641af-f33b-447c-a364-9da8132a2698
81	42	-39	GBIF Germany	4f6826f2-4ff6-443d-b966-e6913bd24013	8da85a00-f762-11e1-a439-00145eb45e9a
4932	4932	0	GBIF Benin	efb9c00e-f802-45dd-8826-a52ec45b89ff	8e912d78-6259-44e3-8f58-debb3081a15f
692	431	-261	GBIF Germany	4f6826f2-4ff6-443d-b966-e6913bd24013	8ed7dae0-f762-11e1-a439-00145eb45e9a
2	2	0	Plazi	ffb07bec-2d10-492d-9c37-361fe0b79427	8fa4af52-5a18-43b0-9cd7-f9887f71a1f9
2814	2814	0	GBIF Finland	dd514216-5c7c-45f3-910d-797424cb5be6	8fb86698-1f25-4518-b534-aa391af25924
374	374	0	GBIF Germany	4f6826f2-4ff6-443d-b966-e6913bd24013	8fe6d8dc-f762-11e1-a439-00145eb45e9a
108	108	0	Participant Node Managers Committee	7f48e0c8-5c96-49ec-b972-30748e339115	91b4c3da-613a-4811-9096-089643e12e29
321	326	5	GBIF Germany	4f6826f2-4ff6-443d-b966-e6913bd24013	91df8102-f762-11e1-a439-00145eb45e9a
116	124	8	GBIF Germany	4f6826f2-4ff6-443d-b966-e6913bd24013	9226c22e-f762-11e1-a439-00145eb45e9a
670	670	0	GBIF Germany	4f6826f2-4ff6-443d-b966-e6913bd24013	941230dc-f762-11e1-a439-00145eb45e9a
17	17	0	Plazi	ffb07bec-2d10-492d-9c37-361fe0b79427	9434dfd7-7234-456a-b3d8-0bf7effeedf8
76426	95143	18717	GBIF Japan	db5705aa-6a6e-42f1-8942-d77b9f4896ea	96029706-f762-11e1-a439-00145eb45e9a
207	207	0	Participant Node Managers Committee	7f48e0c8-5c96-49ec-b972-30748e339115	968dbe0f-a8a0-498f-816a-cb5b4b5c041b
19	19	0	Colombian Biodiversity Information System	7e865cba-7c46-417b-ade5-97f2cf5b7be0	9743f7ec-1c63-4647-b465-48dd27c4d4b6
13	13	0	GBIF Germany	4f6826f2-4ff6-443d-b966-e6913bd24013	978670de-f762-11e1-a439-00145eb45e9a
0	4276	4276	GBIF Japan	db5705aa-6a6e-42f1-8942-d77b9f4896ea	97db1fb8-a629-4bbd-a9e4-e24acfc71214
311044	317502	6458	U.S. Geological Survey	8618c64a-93e0-4300-b546-7249e5148ed2	989f6285-841c-47a4-991b-3d3396427f02
1	1	0	Plazi	ffb07bec-2d10-492d-9c37-361fe0b79427	9b814d4f-378b-4e95-8144-1e6b183711d5
2341	2341	0	U.S. Geological Survey	8618c64a-93e0-4300-b546-7249e5148ed2	9f9cf852-babb-4c52-b17f-f81dbe96c527
0	50034	50034	Ocean Biodiversity Information System	ba0670b9-4186-41e6-8e70-f9cb3065551a	a5bfbdb3-d391-4177-864a-2d36cbcaff92
0	628	628	Colombian Biodiversity Information System	7e865cba-7c46-417b-ade5-97f2cf5b7be0	a7799cdd-93c9-433c-bc95-a83ec417ef33
1983	1983	0	National Biodiversity Network	d897a5b9-35ee-4232-94bd-b0bcaac003c2	abbab93b-ab81-47f4-b825-85bbbc210e94
0	56	56	Plazi	ffb07bec-2d10-492d-9c37-361fe0b79427	accc158b-4f19-427e-8b8b-6f0cd70e7b6e
358	358	0	GBIF Germany	4f6826f2-4ff6-443d-b966-e6913bd24013	ad0565e8-33ba-4cd1-809b-bcd7d84df9cd
0	3	3	Plazi	ffb07bec-2d10-492d-9c37-361fe0b79427	ae249662-d6f6-4acf-ae69-420220f5034b
95	95	0	GBIF France	da44cd31-5901-4687-a106-6d1c7734ee3a	afdefdf5-84da-4bf5-98b2-9b1698788f5a
22771	22771	0	National Biodiversity Network	d897a5b9-35ee-4232-94bd-b0bcaac003c2	b459d0bb-82ec-4cb8-bf03-f0030bdbb1f5
3	3	0	Plazi	ffb07bec-2d10-492d-9c37-361fe0b79427	b710c958-4fdc-40c8-babb-8576eecdc1ea
43443	43443	0	Belgian Biodiversity Platform	fb11cfe1-ebc3-45af-9159-17d9fddbcdac	b76c1a65-b912-4ca6-be7e-50eb365f4a32
146	146	0	GBIF Argentina	2426a871-9feb-40a1-96c6-0c593a76b835	b78dc638-1dde-43b4-a4cb-1e7e8ba2f185
3034	3034	0	Colombian Biodiversity Information System	7e865cba-7c46-417b-ade5-97f2cf5b7be0	b90cadd7-9ef5-4640-b1fe-94d4803e7129
0	9174	9174	Participant Node Managers Committee	7f48e0c8-5c96-49ec-b972-30748e339115	bb6249ca-2e0b-449e-bd68-8d88bab4ed2b
4	4	0	Plazi	ffb07bec-2d10-492d-9c37-361fe0b79427	bc2aa0d4-dfeb-49bc-8a0b-8f4e98996cb0
259	259	0	GBIF France	da44cd31-5901-4687-a106-6d1c7734ee3a	be962b8e-dcd8-465f-8bec-b29822e1f167
320	320	0	Belgian Biodiversity Platform	fb11cfe1-ebc3-45af-9159-17d9fddbcdac	bec95074-2220-4c3c-92ed-5ce729bd4307
8	8	0	Plazi	ffb07bec-2d10-492d-9c37-361fe0b79427	c1bb363a-ba07-43a7-a9b2-f484ca391ea6
24	24	0	Plazi	ffb07bec-2d10-492d-9c37-361fe0b79427	c2a8b62f-1530-4705-a8bf-0245b0856001
0	2	2	Plazi	ffb07bec-2d10-492d-9c37-361fe0b79427	c6e730b5-1172-4d9e-9fd3-7c2d1f3016db
0	253344	253344	GBIF Portugal	673f7038-4262-4149-b753-5658a4e912f6	c877cc39-da89-483b-a5b8-a438229222fa
27	27	0	Plazi	ffb07bec-2d10-492d-9c37-361fe0b79427	c99d1340-b651-49fd-a462-54655ec3d468
436	436	0	GBIF France	da44cd31-5901-4687-a106-6d1c7734ee3a	ccc46358-1aaf-434a-a5ad-af8ee55f9259
2970	2970	0	GBIF Germany	4f6826f2-4ff6-443d-b966-e6913bd24013	cdaf4a2c-ada2-11e2-8fbc-00145eb45e9a
87	87	0	GBIF France	da44cd31-5901-4687-a106-6d1c7734ee3a	ce6c8d6e-f929-4afc-b860-57f8e3ceb7d1
0	246	246	Plazi	ffb07bec-2d10-492d-9c37-361fe0b79427	d0a83fae-9f06-4fc0-94b0-ad13a9e9bf34
9633	9633	0	GBIF Brazil	cdc9736d-5ff7-4ece-9959-3c744360cdb3	d12a61f0-230b-4e5b-81ea-7393aeea85db
0	10	10	Plazi	ffb07bec-2d10-492d-9c37-361fe0b79427	d1a9539b-2df1-42f0-8151-ecf8e6678bc5
41	41	0	Participant Node Managers Committee	7f48e0c8-5c96-49ec-b972-30748e339115	d40326b8-a1d5-463d-b060-6bd1dc7d70b0
6	6	0	Plazi	ffb07bec-2d10-492d-9c37-361fe0b79427	d464c9a4-f8ae-439f-8929-781a6420adaa
1054	1054	0	GBIF Norway	4f829580-180d-46a9-9c87-ed8ec959b545	d5a8d3f2-9bad-4724-b793-daf78f8bca29
16	16	0	Plazi	ffb07bec-2d10-492d-9c37-361fe0b79427	d6db56eb-3ad0-47bb-8e1c-583f7d5b648e
14	14	0	Plazi	ffb07bec-2d10-492d-9c37-361fe0b79427	d9aaf71d-e347-4fc3-b5fd-cae0989cac05
0	2	2	Plazi	ffb07bec-2d10-492d-9c37-361fe0b79427	dc853953-1449-4ef0-903e-583c3664bafe
2	2	0	Plazi	ffb07bec-2d10-492d-9c37-361fe0b79427	df49d6da-ad36-4b37-a437-c69a6edf61d7
11	11	0	Plazi	ffb07bec-2d10-492d-9c37-361fe0b79427	e143db18-f7fe-4f11-9457-edbf383c0e5f
0	20	20	Plazi	ffb07bec-2d10-492d-9c37-361fe0b79427	e4224b52-b058-4bc5-89d4-53db72efd546
0	9	9	Plazi	ffb07bec-2d10-492d-9c37-361fe0b79427	e4a5a574-cfa4-4824-bf4f-b8b563ac0e7d
0	37	37	Plazi	ffb07bec-2d10-492d-9c37-361fe0b79427	e63f7e67-71da-4d34-8b2f-970b5ccb812f
148	148	0	Colombian Biodiversity Information System	7e865cba-7c46-417b-ade5-97f2cf5b7be0	e6d89684-dc2b-47f6-9ed8-1596b46f3025
54	54	0	GBIF France	da44cd31-5901-4687-a106-6d1c7734ee3a	e795aa6f-3d22-43d3-a1c3-499e35a8c914
0	8	8	Plazi	ffb07bec-2d10-492d-9c37-361fe0b79427	e83b4672-2a59-4159-834a-9d040730f42b
121	78	-43	GBIF Germany	4f6826f2-4ff6-443d-b966-e6913bd24013	eb53b6d8-c9e6-4682-9b51-0b0beb64e7d5
0	2	2	Plazi	ffb07bec-2d10-492d-9c37-361fe0b79427	ee030190-51b5-4e94-9979-90a488a64da1
0	4568	4568	U.S. Geological Survey	8618c64a-93e0-4300-b546-7249e5148ed2	ee21cfcd-9f34-47f0-ab46-9b21e9db5c5a
40	40	0	Biodiversity Information System of Mexico	b324e8e9-9a4c-44fa-8f1a-7f39ea7ab576	efeadef6-3488-4d9f-936d-61a81b0195ef
1300	1300	0	GBIF Peru	46e3639a-27f8-45af-bfbe-d19b77efb040	f240723c-5a62-415b-b6e2-cc6dbdd206a6
0	3171	3171	Ocean Biodiversity Information System	ba0670b9-4186-41e6-8e70-f9cb3065551a	f353d213-008e-4ee1-835b-f30c17e261d6
3	3	0	Plazi	ffb07bec-2d10-492d-9c37-361fe0b79427	fa090a44-a1c7-4cef-a40b-d841a2eb1d77
0	6	6	Plazi	ffb07bec-2d10-492d-9c37-361fe0b79427	fce2f651-c25e-4fc0-8d27-396e7047d510
4709	4709	0	Participant Node Managers Committee	7f48e0c8-5c96-49ec-b972-30748e339115	fe509a1b-3f0f-445b-8332-1d6d9ee9e2cd
6	6	0	Plazi	ffb07bec-2d10-492d-9c37-361fe0b79427	0534b00e-640e-42d1-8706-80911b943bba
46	46	0	Plazi	ffb07bec-2d10-492d-9c37-361fe0b79427	0914b474-100a-4226-b171-d68f021cfcc4
1710	1710	0	GBIF Spain	1f94b3ca-9345-4d65-afe2-4bace93aa0fe	0a5f2598-e2c2-424c-8236-69a227b4b16f
0	59	59	National Biodiversity Network	d897a5b9-35ee-4232-94bd-b0bcaac003c2	0e5ec19e-aadf-4c69-871c-43c0e4273a77
1971	1971	0	Participant Node Managers Committee	7f48e0c8-5c96-49ec-b972-30748e339115	1160e07d-3285-403e-8770-8426ef450bbf
3	3	0	Plazi	ffb07bec-2d10-492d-9c37-361fe0b79427	126edf81-04ff-46f9-97d7-cfc04942d409
25	25	0	Plazi	ffb07bec-2d10-492d-9c37-361fe0b79427	13876228-70b2-4310-86d1-2e049ce1f414
2	2	0	Plazi	ffb07bec-2d10-492d-9c37-361fe0b79427	14d186c9-e041-443d-8a40-5edb9b100f9a
0	6	6	Plazi	ffb07bec-2d10-492d-9c37-361fe0b79427	1a912893-6f4e-4800-af2a-8972614eb929
25	53	28	GBIF Germany	4f6826f2-4ff6-443d-b966-e6913bd24013	1b531d5f-ace5-4bd7-83de-189270223166
1401185	1401185	0	GBIF France	da44cd31-5901-4687-a106-6d1c7734ee3a	1fec2829-4ac0-4329-b448-6f768b8d3427
630	630	0	GBIF Guinea	b1cd2e84-c4ba-47bd-b72a-dfd1f92dce0a	1feca755-e026-4dd1-822e-aa95eebc607a
12157313	12227428	70115	GBIF Finland	dd514216-5c7c-45f3-910d-797424cb5be6	292a71df-588b-48fa-9ab5-29ae868ba88c
53	53	0	GBIF France	da44cd31-5901-4687-a106-6d1c7734ee3a	2ce8d7c2-3852-4f58-a25e-1fc9e35fe293
1	1	0	Plazi	ffb07bec-2d10-492d-9c37-361fe0b79427	2d5355b0-1c17-47df-b8e6-d0ff5dc474b3
0	31	31	Plazi	ffb07bec-2d10-492d-9c37-361fe0b79427	2f0d497f-606a-40f7-9811-eeb2865b125f
97	97	0	GBIF France	da44cd31-5901-4687-a106-6d1c7734ee3a	30abf5c0-146f-4635-b7ec-7afc3c69feee
17825	17825	0	U.S. Geological Survey	8618c64a-93e0-4300-b546-7249e5148ed2	31b346f9-1a91-4688-af40-5a50a261c572
0	10	10	Plazi	ffb07bec-2d10-492d-9c37-361fe0b79427	3228103c-9c27-4ab0-9823-c31bbe817d96
176	176	0	Plazi	ffb07bec-2d10-492d-9c37-361fe0b79427	32bd22ce-7d3f-4eac-8203-e9f61a19c7f0
0	1207	1207	Participant Node Managers Committee	7f48e0c8-5c96-49ec-b972-30748e339115	37742167-d38a-4a4e-8b7d-76f75c2baed8
1826	1826	0	GBIF France	da44cd31-5901-4687-a106-6d1c7734ee3a	38c2fc7a-b025-4dec-aba3-8b049c821ef2
16	16	0	Plazi	ffb07bec-2d10-492d-9c37-361fe0b79427	39973e9c-d91e-4bbf-989a-336b4f2b5560
2312	2312	0	Biodiversity Information System of Mexico	b324e8e9-9a4c-44fa-8f1a-7f39ea7ab576	3cbee9c6-bd69-4fef-aedd-5cda2d2d7781
1809	1809	0	Participant Node Managers Committee	7f48e0c8-5c96-49ec-b972-30748e339115	40ee219d-ab5f-4917-9c7a-6137dba77b05
0	3	3	Plazi	ffb07bec-2d10-492d-9c37-361fe0b79427	41009441-8ad0-4e4e-9e81-583816039aea
1	1	0	Plazi	ffb07bec-2d10-492d-9c37-361fe0b79427	44716114-53ae-40fb-9b68-5e03745b9bfd
0	94	94	Ocean Biodiversity Information System	ba0670b9-4186-41e6-8e70-f9cb3065551a	449d4082-1c11-4599-815d-b8bd6923a6c6
22	22	0	Participant Node Managers Committee	7f48e0c8-5c96-49ec-b972-30748e339115	47d4d065-3486-441e-a70b-707eef444998
13	13	0	Plazi	ffb07bec-2d10-492d-9c37-361fe0b79427	4819771b-1204-45ae-8cc1-2ea1c1bd7c69
1362	1701	339	National Biodiversity Network	d897a5b9-35ee-4232-94bd-b0bcaac003c2	48d5602a-fbea-417a-b5d3-46073a08efda
0	3	3	Plazi	ffb07bec-2d10-492d-9c37-361fe0b79427	4b58ca8a-170c-4a58-b185-5a3c83ca161d
0	42	42	Participant Node Managers Committee	7f48e0c8-5c96-49ec-b972-30748e339115	537eb9e2-e35d-4f63-b4d1-3501d2d8c59a
3	3	0	Plazi	ffb07bec-2d10-492d-9c37-361fe0b79427	5727b209-20b0-4e6a-906c-0eeff346ea92
33	33	0	Participant Node Managers Committee	7f48e0c8-5c96-49ec-b972-30748e339115	5785ecbf-0d8a-4304-bd6b-c93aedabc3d1
0	287732	287732	National Biodiversity Network	d897a5b9-35ee-4232-94bd-b0bcaac003c2	583d91fe-bbc0-4b4a-afe1-801f88263016
1	1	0	Plazi	ffb07bec-2d10-492d-9c37-361fe0b79427	5b5ef4ab-6c45-40d0-8676-2a3082d22850
0	276	276	Ocean Biodiversity Information System	ba0670b9-4186-41e6-8e70-f9cb3065551a	5bb15d7a-f5df-48a2-8287-c8070738af92
0	47	47	Plazi	ffb07bec-2d10-492d-9c37-361fe0b79427	5c7f98ad-35be-4069-964f-79808e8960b6
809	3206	2397	National Biodiversity Network	d897a5b9-35ee-4232-94bd-b0bcaac003c2	5e096c60-f909-4213-9cf3-05b1f2ad5a5e
31	31	0	Colombian Biodiversity Information System	7e865cba-7c46-417b-ade5-97f2cf5b7be0	5eac7163-db81-4133-a36e-db9fcae77978
105	105	0	GBIF Germany	4f6826f2-4ff6-443d-b966-e6913bd24013	611cc1f6-f762-11e1-a439-00145eb45e9a
57	57	0	GBIF Germany	4f6826f2-4ff6-443d-b966-e6913bd24013	616d8320-f762-11e1-a439-00145eb45e9a
0	13	13	Plazi	ffb07bec-2d10-492d-9c37-361fe0b79427	616f791f-ae6b-4335-9d5c-1f094a4dfd3f
80	80	0	GBIF Germany	4f6826f2-4ff6-443d-b966-e6913bd24013	62e673a6-f762-11e1-a439-00145eb45e9a
5	5	0	GBIF Germany	4f6826f2-4ff6-443d-b966-e6913bd24013	6313ed72-f762-11e1-a439-00145eb45e9a
32	32	0	Plazi	ffb07bec-2d10-492d-9c37-361fe0b79427	63a66d44-a2f0-478a-9e74-9c439bf873d6
102	102	0	GBIF Germany	4f6826f2-4ff6-443d-b966-e6913bd24013	63ca9c3e-f762-11e1-a439-00145eb45e9a
809	731	-78	GBIF Germany	4f6826f2-4ff6-443d-b966-e6913bd24013	65674146-f762-11e1-a439-00145eb45e9a
123	123	0	GBIF Germany	4f6826f2-4ff6-443d-b966-e6913bd24013	6579dafe-f762-11e1-a439-00145eb45e9a
11	11	0	Plazi	ffb07bec-2d10-492d-9c37-361fe0b79427	660f1f7d-2a80-4f3b-aa03-861c81fffb6c
10879	7075	-3804	GBIF Germany	4f6826f2-4ff6-443d-b966-e6913bd24013	662510f4-f762-11e1-a439-00145eb45e9a
2239	6016	3777	U.S. Geological Survey	8618c64a-93e0-4300-b546-7249e5148ed2	66da3373-5cca-4d00-a477-af751b5ed052
0	7	7	Plazi	ffb07bec-2d10-492d-9c37-361fe0b79427	69cf944a-43de-4eeb-bdd7-3dee10cde70c
337	53	-284	GBIF Germany	4f6826f2-4ff6-443d-b966-e6913bd24013	6a37bd68-f762-11e1-a439-00145eb45e9a
116	116	0	GBIF Norway	4f829580-180d-46a9-9c87-ed8ec959b545	6c0af44b-7c13-472e-9daa-5a735ea39efb
63	63	0	GBIF Germany	4f6826f2-4ff6-443d-b966-e6913bd24013	6f88f0e8-f762-11e1-a439-00145eb45e9a
12	12	0	GBIF Germany	4f6826f2-4ff6-443d-b966-e6913bd24013	6fb7b95a-f762-11e1-a439-00145eb45e9a
1355	882	-473	GBIF Germany	4f6826f2-4ff6-443d-b966-e6913bd24013	7045f6b6-f762-11e1-a439-00145eb45e9a
20	20	0	GBIF Germany	4f6826f2-4ff6-443d-b966-e6913bd24013	708ff5ea-f762-11e1-a439-00145eb45e9a
41	38	-3	GBIF Germany	4f6826f2-4ff6-443d-b966-e6913bd24013	70d773ac-f762-11e1-a439-00145eb45e9a
29	29	0	Plazi	ffb07bec-2d10-492d-9c37-361fe0b79427	711ece55-bd2f-4d5f-940a-2cd36cfe8061
8	8	0	GBIF Germany	4f6826f2-4ff6-443d-b966-e6913bd24013	7145ce2e-f762-11e1-a439-00145eb45e9a
360	360	0	GBIF Germany	4f6826f2-4ff6-443d-b966-e6913bd24013	71819d5a-f762-11e1-a439-00145eb45e9a
1811	1811	0	Participant Node Managers Committee	7f48e0c8-5c96-49ec-b972-30748e339115	7182d6f0-9a7d-42e4-824f-cdce194bbff9
1	1	0	Plazi	ffb07bec-2d10-492d-9c37-361fe0b79427	73943cc7-c490-46fe-95ad-e2ce8ea8923b
8	8	0	GBIF Germany	4f6826f2-4ff6-443d-b966-e6913bd24013	74749008-f762-11e1-a439-00145eb45e9a
1054	1054	0	GBIF Germany	4f6826f2-4ff6-443d-b966-e6913bd24013	7481b62a-f762-11e1-a439-00145eb45e9a
6	6	0	Plazi	ffb07bec-2d10-492d-9c37-361fe0b79427	769a30e2-392e-4102-a382-f5f606a4c05a
208	208	0	Colombian Biodiversity Information System	7e865cba-7c46-417b-ade5-97f2cf5b7be0	7818abe0-5c49-4c0e-b76d-7ac2d9af0eab
303	303	0	GBIF Brazil	cdc9736d-5ff7-4ece-9959-3c744360cdb3	7b4d8842-03d4-40e6-b9b1-02274ed48548
414	414	0	GBIF Germany	4f6826f2-4ff6-443d-b966-e6913bd24013	7bed6c74-f762-11e1-a439-00145eb45e9a
816	352	-464	GBIF Germany	4f6826f2-4ff6-443d-b966-e6913bd24013	7ce28862-f762-11e1-a439-00145eb45e9a
1919	1438	-481	GBIF Germany	4f6826f2-4ff6-443d-b966-e6913bd24013	7cf26de0-f762-11e1-a439-00145eb45e9a
645	645	0	GBIF Germany	4f6826f2-4ff6-443d-b966-e6913bd24013	7dbafd00-f762-11e1-a439-00145eb45e9a
60	60	0	GBIF Germany	4f6826f2-4ff6-443d-b966-e6913bd24013	7dd3b192-f762-11e1-a439-00145eb45e9a
7323	7323	0	U.S. Geological Survey	8618c64a-93e0-4300-b546-7249e5148ed2	7e36d9b6-f762-11e1-a439-00145eb45e9a
21	15	-6	GBIF Germany	4f6826f2-4ff6-443d-b966-e6913bd24013	7f429ec6-f762-11e1-a439-00145eb45e9a
673	673	0	Biodiversity Information System of Mexico	b324e8e9-9a4c-44fa-8f1a-7f39ea7ab576	7f962910-f762-11e1-a439-00145eb45e9a
15826	15826	0	GBIF Germany	4f6826f2-4ff6-443d-b966-e6913bd24013	81332e30-f762-11e1-a439-00145eb45e9a
912	570	-342	GBIF Germany	4f6826f2-4ff6-443d-b966-e6913bd24013	823c64e0-f762-11e1-a439-00145eb45e9a
2520	2520	0	GBIF Brazil	cdc9736d-5ff7-4ece-9959-3c744360cdb3	824e923d-531a-411d-9a2a-94409c5df105
0	7	7	Plazi	ffb07bec-2d10-492d-9c37-361fe0b79427	8276d17c-25a8-43fa-98dd-2157c3c8f3ca
7	7	0	GBIF Germany	4f6826f2-4ff6-443d-b966-e6913bd24013	82891ac4-f762-11e1-a439-00145eb45e9a
64554	64554	0	GBIF Germany	4f6826f2-4ff6-443d-b966-e6913bd24013	82b7d2ec-f762-11e1-a439-00145eb45e9a
21172	21172	0	Atlas of Living Australia	4a6f1b71-969e-4fc5-a693-282b05e1220c	82dfda58-f762-11e1-a439-00145eb45e9a
113941	113941	0	Ocean Biodiversity Information System	ba0670b9-4186-41e6-8e70-f9cb3065551a	83b45ca6-f762-11e1-a439-00145eb45e9a
4749	4749	0	Biodiversity Information System of Mexico	b324e8e9-9a4c-44fa-8f1a-7f39ea7ab576	8500982c-f762-11e1-a439-00145eb45e9a
40472	40472	0	Biodiversity Information System of Mexico	b324e8e9-9a4c-44fa-8f1a-7f39ea7ab576	85042096-f762-11e1-a439-00145eb45e9a
37649	39623	1974	Nordic Genetic Resource Centre	fa6bdac4-51e2-4334-940c-ba6cdf6e1257	85a347c0-f762-11e1-a439-00145eb45e9a
22817	22817	0	GBIF Austria	1e789bc9-79fc-4e60-a49e-89dfc45a7188	85ab1bf8-f762-11e1-a439-00145eb45e9a
1183	1183	0	Participant Node Managers Committee	7f48e0c8-5c96-49ec-b972-30748e339115	85b7970e-4368-401a-84da-413117fb284b
286	286	0	GBIF Germany	4f6826f2-4ff6-443d-b966-e6913bd24013	8624044f-443f-4208-8d53-2f406687a857
94	94	0	U.S. Geological Survey	8618c64a-93e0-4300-b546-7249e5148ed2	863e06be-f610-4303-8e56-5511a266821d
1495	1495	0	Colombian Biodiversity Information System	7e865cba-7c46-417b-ade5-97f2cf5b7be0	86c04058-871f-4c2d-a60e-2b3a6ebedf0d
361	324	-37	GBIF Germany	4f6826f2-4ff6-443d-b966-e6913bd24013	881fe454-f762-11e1-a439-00145eb45e9a
183	183	0	GBIF Germany	4f6826f2-4ff6-443d-b966-e6913bd24013	8852c6b2-f762-11e1-a439-00145eb45e9a
441	441	0	Plazi	ffb07bec-2d10-492d-9c37-361fe0b79427	897dc544-e3e9-46db-b36e-4aa995caabc4
210	210	0	GBIF Germany	4f6826f2-4ff6-443d-b966-e6913bd24013	898a53c4-f762-11e1-a439-00145eb45e9a
2160	2160	0	GBIF Germany	4f6826f2-4ff6-443d-b966-e6913bd24013	8afce30c-f762-11e1-a439-00145eb45e9a
168	106	-62	GBIF Germany	4f6826f2-4ff6-443d-b966-e6913bd24013	8c79b4da-f762-11e1-a439-00145eb45e9a
22	6	-16	GBIF Germany	4f6826f2-4ff6-443d-b966-e6913bd24013	8cf3e7e6-f762-11e1-a439-00145eb45e9a
201	67	-134	GBIF Germany	4f6826f2-4ff6-443d-b966-e6913bd24013	8f4b08d0-f762-11e1-a439-00145eb45e9a
369	192	-177	GBIF Germany	4f6826f2-4ff6-443d-b966-e6913bd24013	9045be92-f762-11e1-a439-00145eb45e9a
13	12	-1	GBIF Germany	4f6826f2-4ff6-443d-b966-e6913bd24013	9228272c-f762-11e1-a439-00145eb45e9a
3	3	0	Plazi	ffb07bec-2d10-492d-9c37-361fe0b79427	93262da3-e835-42c7-b673-1c9bad69f900
168	168	0	GBIF Germany	4f6826f2-4ff6-443d-b966-e6913bd24013	93cdaa5c-f762-11e1-a439-00145eb45e9a
0	124	124	Plazi	ffb07bec-2d10-492d-9c37-361fe0b79427	9452c756-88bb-4955-ac26-1910d6ec0bd6
8219	14414	6195	U.S. Geological Survey	8618c64a-93e0-4300-b546-7249e5148ed2	973879fb-3e36-49ca-ab09-01b87bea0deb
232	232	0	GBIF Germany	4f6826f2-4ff6-443d-b966-e6913bd24013	979a5dce-f762-11e1-a439-00145eb45e9a
1740	1740	0	Society for the Management of Electronic Biodiversity Data	97818ee4-1461-4180-bf1d-b3201050124f	9a73f108-5ee8-4e9b-a1f7-8f2c5f0dc0d6
0	6	6	Plazi	ffb07bec-2d10-492d-9c37-361fe0b79427	9a8832b9-a96c-47ca-aa19-74c6b9775f3e
3774	3774	0	GBIF France	da44cd31-5901-4687-a106-6d1c7734ee3a	9d826523-76cd-452b-8a02-41b6073722dd
5	5	0	Participant Node Managers Committee	7f48e0c8-5c96-49ec-b972-30748e339115	9fdb7f3f-f307-4e0c-ad70-4a7fa9015388
170	170	0	GBIF Portugal	673f7038-4262-4149-b753-5658a4e912f6	a3533a61-6f88-443e-89ae-37611ea88267
8196	8196	0	GBIF Spain	1f94b3ca-9345-4d65-afe2-4bace93aa0fe	a387171f-c9c2-47ba-a02a-bcb99b2a0fa0
18	18	0	Plazi	ffb07bec-2d10-492d-9c37-361fe0b79427	a829ccd3-ea80-4a26-b612-d66cee0174a1
9	9	0	Plazi	ffb07bec-2d10-492d-9c37-361fe0b79427	a9853313-1073-4c91-824a-2c235c298d13
1022	1022	0	DanBIF - Danish Biodiversity Information Facility	4ddd294f-02b7-4359-ac33-0806a9ca9c6b	a98ca341-87f7-4366-a9ef-42ab91652e17
0	3	3	Plazi	ffb07bec-2d10-492d-9c37-361fe0b79427	ab9213ee-f066-482e-83d3-fcf2f75fa908
11	11	0	Plazi	ffb07bec-2d10-492d-9c37-361fe0b79427	ad1c1df7-6de8-4205-bdf5-7e041011bf08
2	2	0	Plazi	ffb07bec-2d10-492d-9c37-361fe0b79427	ad358c64-e408-4739-98b5-d767485a66fc
0	23	23	Plazi	ffb07bec-2d10-492d-9c37-361fe0b79427	aed68073-9741-4a8b-9b72-c15376ad5e0b
4	4	0	Plazi	ffb07bec-2d10-492d-9c37-361fe0b79427	b0230e05-0a3b-4337-850c-384db063f5d6
9115	9115	0	GBIF France	da44cd31-5901-4687-a106-6d1c7734ee3a	b259f2b4-e3d5-48ff-98e2-e5a7540f9d90
5	5	0	Plazi	ffb07bec-2d10-492d-9c37-361fe0b79427	b3ab1acc-5ff9-4152-9dcc-3b4d127b599b
0	1	1	Plazi	ffb07bec-2d10-492d-9c37-361fe0b79427	b3aeebb0-e3ac-4d28-b818-2078770d69b3
210	210	0	GBIF France	da44cd31-5901-4687-a106-6d1c7734ee3a	b4443d83-635f-4dd8-a311-46992c0f17cf
1059	1059	0	Ocean Biodiversity Information System	ba0670b9-4186-41e6-8e70-f9cb3065551a	b7b11220-1331-43d4-9884-2540e5acd7db
1	1	0	Plazi	ffb07bec-2d10-492d-9c37-361fe0b79427	b87d843d-1458-487b-ac2e-4071e7e66f62
75	75	0	Plazi	ffb07bec-2d10-492d-9c37-361fe0b79427	b8b1c620-3356-480c-80e9-7fb113ea80d6
1640	1640	0	Biodiversity Information System of Mexico	b324e8e9-9a4c-44fa-8f1a-7f39ea7ab576	b95d2f66-ff24-41f2-bd64-700476a735cc
8546	8546	0	National Biodiversity Network	d897a5b9-35ee-4232-94bd-b0bcaac003c2	baeb0d4f-4d1d-4fc3-b68d-aac7e01723c5
146	146	0	National Biodiversity Data Centre	422b00b2-6c94-4bb6-976b-c359916efdb8	bcd789f6-3b57-4a0b-9eaa-43938025b586
173	173	0	Plazi	ffb07bec-2d10-492d-9c37-361fe0b79427	bdc12bce-f24c-4713-8026-a1aee4193ef5
1	1	0	Plazi	ffb07bec-2d10-492d-9c37-361fe0b79427	bdd99689-bd38-46f8-9e54-1f1afc3cb1d6
47	47	0	GBIF France	da44cd31-5901-4687-a106-6d1c7734ee3a	c15a9e49-5f4e-4c37-a60c-be749043c723
22	22	0	Plazi	ffb07bec-2d10-492d-9c37-361fe0b79427	c65e2d4a-1a47-4945-88e7-d33a9fe3d772
5	5	0	Plazi	ffb07bec-2d10-492d-9c37-361fe0b79427	cb8a3930-eb30-4697-a9f6-fc21d04f681e
0	19	19	Plazi	ffb07bec-2d10-492d-9c37-361fe0b79427	cbd6479d-ac43-4609-ab60-e69de966ed9c
0	10	10	Plazi	ffb07bec-2d10-492d-9c37-361fe0b79427	cdc7d13c-1741-4970-9b3e-0d2e25ed4ec8
59	59	0	GBIF Malawi	2a42e4d7-ad4a-41b3-84c4-de4aa7b74d35	ce2ccf63-7ac2-4a0a-8624-4faa61beb0d0
413	413	0	U.S. Geological Survey	8618c64a-93e0-4300-b546-7249e5148ed2	ce4fe924-1ddf-4546-856f-b3319aded91b
177	177	0	GBIF Argentina	2426a871-9feb-40a1-96c6-0c593a76b835	cfa5b8ff-22e8-41e4-abb7-5bb8c9cadf84
459	459	0	GBIF France	da44cd31-5901-4687-a106-6d1c7734ee3a	cfdf21e1-935d-464d-895e-424264486402
67	67	0	GBIF Germany	4f6826f2-4ff6-443d-b966-e6913bd24013	d0f0acb2-ac2d-4115-8223-974a58b50e23
0	28	28	Participant Node Managers Committee	7f48e0c8-5c96-49ec-b972-30748e339115	d2a2e1b8-e8a4-4e9e-aa9d-3d494d663e06
197	197	0	Plazi	ffb07bec-2d10-492d-9c37-361fe0b79427	d312e146-9347-4644-b2fe-8829d8221d21
6	6	0	Plazi	ffb07bec-2d10-492d-9c37-361fe0b79427	d88d2e27-e493-4918-aa5c-a15399962b3c
0	3614	3614	Participant Node Managers Committee	7f48e0c8-5c96-49ec-b972-30748e339115	db9cc886-10fe-4873-9853-bfd53b6c7123
9871	9871	0	National Biodiversity Network	d897a5b9-35ee-4232-94bd-b0bcaac003c2	dc2f90f9-02d2-4f47-b473-e7bf104530c9
22	22	0	Colombian Biodiversity Information System	7e865cba-7c46-417b-ade5-97f2cf5b7be0	e158f18a-50b3-498b-8885-39a4d8193705
500808	500808	0	GBIF Germany	4f6826f2-4ff6-443d-b966-e6913bd24013	e1e16cf0-ada2-11e2-8fbc-00145eb45e9a
2	2	0	Plazi	ffb07bec-2d10-492d-9c37-361fe0b79427	e41f8cdb-b772-41d6-b890-5b1b35aec51c
0	1	1	Plazi	ffb07bec-2d10-492d-9c37-361fe0b79427	e4849f64-2671-4c07-b97b-3b2077d91b5b
0	239	239	Ocean Biodiversity Information System	ba0670b9-4186-41e6-8e70-f9cb3065551a	e4ff0882-4dc5-4305-aca6-f16ebcfde307
18224	18224	0	U.S. Geological Survey	8618c64a-93e0-4300-b546-7249e5148ed2	e6137ccd-15b7-47ca-bb81-91dc3003a9b0
44	44	0	Plazi	ffb07bec-2d10-492d-9c37-361fe0b79427	e7eb57ba-824d-4103-87fd-9a69777bae62
4	5	1	Plazi	ffb07bec-2d10-492d-9c37-361fe0b79427	eb8ff662-a842-47b8-8dba-a69cec07e6f7
0	1666	1666	National Biodiversity Network	d897a5b9-35ee-4232-94bd-b0bcaac003c2	ecd18a44-b841-4bfa-8b9d-b7e118640616
2955	2955	0	Taiwan Biodiversity Information Facility	e1b85abc-61f9-430f-ba79-6813dec53a0f	ee894f1d-22fb-42fc-a681-27e449880366
0	15	15	Plazi	ffb07bec-2d10-492d-9c37-361fe0b79427	eeae93f1-66d5-4ca0-a1d9-946ad810fb99
81	81	0	Colombian Biodiversity Information System	7e865cba-7c46-417b-ade5-97f2cf5b7be0	eed1e6a2-7fb3-4519-bcf1-47b9fb9fa223
0	30	30	U.S. Geological Survey	8618c64a-93e0-4300-b546-7249e5148ed2	effbfd44-2aef-44db-8d13-8428dce1604b
270	270	0	Colombian Biodiversity Information System	7e865cba-7c46-417b-ade5-97f2cf5b7be0	f0d35874-0237-489f-a58d-518036c0f3c7
48794	48794	0	U.S. Geological Survey	8618c64a-93e0-4300-b546-7249e5148ed2	f11db245-3f9f-4fc6-a0cc-12b4124d081b
271	271	0	GBIF Argentina	2426a871-9feb-40a1-96c6-0c593a76b835	f2c7dd7a-9199-498f-a0c1-7fb711598b51
177	177	0	National Biodiversity Network	d897a5b9-35ee-4232-94bd-b0bcaac003c2	f61ac482-69bb-43f8-b777-6ff5b302e577
6	6	0	Plazi	ffb07bec-2d10-492d-9c37-361fe0b79427	f63c21ad-5be6-4268-89b0-96df5032ed90
108856	108856	0	Canada Biodiversity Information Facility	8f83fc96-c966-4126-83f7-bf044dc49efa	f6e21753-5129-498f-92bd-73710b0087e3
13	13	0	Plazi	ffb07bec-2d10-492d-9c37-361fe0b79427	fbc66cd8-6a7b-4cf3-ac3f-850b17b3abe4
10007	10007	0	Society for the Management of Electronic Biodiversity Data	97818ee4-1461-4180-bf1d-b3201050124f	fc77b814-5596-4959-a779-30027a6507de
3125	3125	0	U.S. Geological Survey	8618c64a-93e0-4300-b546-7249e5148ed2	fda9a8f8-6342-4f73-8c3b-8b79e62afc9d
267	267	0	Plazi	ffb07bec-2d10-492d-9c37-361fe0b79427	ffcbe161-01d4-43e5-9ea8-4b4b5a70551e
0	116	116	GBIF France	da44cd31-5901-4687-a106-6d1c7734ee3a	00456d9f-634c-4366-a3f0-791f9676563a
2	2	0	Plazi	ffb07bec-2d10-492d-9c37-361fe0b79427	01ae3f18-f954-4779-9a38-9c46b46c1bcc
101	101	0	GBIF France	da44cd31-5901-4687-a106-6d1c7734ee3a	022f3fa9-3868-412a-807f-c0d324002a68
1	1	0	Plazi	ffb07bec-2d10-492d-9c37-361fe0b79427	03170277-cfc5-406d-b379-83e06a82e57c
175	175	0	GBIF France	da44cd31-5901-4687-a106-6d1c7734ee3a	03b12834-7467-4a7d-bf70-2821d068539c
0	48	48	Participant Node Managers Committee	7f48e0c8-5c96-49ec-b972-30748e339115	05250d0a-f0c5-4b64-bae4-ea7245db6fd6
5285	5285	0	National Biodiversity Network	d897a5b9-35ee-4232-94bd-b0bcaac003c2	065afbf9-ba90-4fa9-8386-3da752022d44
3	3	0	Plazi	ffb07bec-2d10-492d-9c37-361fe0b79427	09827415-df1c-4129-9bc1-39321f933d5d
80	80	0	Ocean Biodiversity Information System	ba0670b9-4186-41e6-8e70-f9cb3065551a	0a80c025-3f11-4b59-be35-13f1969761e6
0	1	1	Plazi	ffb07bec-2d10-492d-9c37-361fe0b79427	0b6de8e9-0ced-4af6-a7b9-c112454d05cd
0	800	800	Korean Biodiversity Information Facility	e0a1e772-0177-4800-94b4-2d023fe6cdf4	0c4674eb-80d5-4d4d-a00f-b8c69eb7e5e9
1096	1096	0	GBIF France	da44cd31-5901-4687-a106-6d1c7734ee3a	0cd5354f-75ef-4cfd-a66b-f224f09d7f64
32060	32060	0	GBIF Brazil	cdc9736d-5ff7-4ece-9959-3c744360cdb3	0ead7539-70d6-4486-9a37-2c273413ec51
22205	22205	0	Atlas of Living Australia	4a6f1b71-969e-4fc5-a693-282b05e1220c	10710e0f-205f-46d4-b1f3-1a92bd21a4f3
3	3	0	Plazi	ffb07bec-2d10-492d-9c37-361fe0b79427	11ecfd1b-0332-44a6-a120-8f7006629717
1284	1284	0	Polish Biodiversity Information Network	2618bfdf-e194-4911-a241-80db3107bc51	128548c0-9169-11db-9f6c-b8a03c50a862
2	2	0	Plazi	ffb07bec-2d10-492d-9c37-361fe0b79427	139e31ca-ce45-4e2d-9ddb-b9f12732700a
1146	1146	0	GBIF Germany	4f6826f2-4ff6-443d-b966-e6913bd24013	13b1f66f-93c7-4415-8d07-4c05ec6ef644
0	1759	1759	National Biodiversity Data Centre	422b00b2-6c94-4bb6-976b-c359916efdb8	154e5cea-9a47-48e1-b7c5-fdf7c81000c4
68602	22469	-46133	National Biodiversity Network	d897a5b9-35ee-4232-94bd-b0bcaac003c2	1cffb119-4c27-43cd-b62d-fe8fabbaa628
2569	2569	0	GBIF Brazil	cdc9736d-5ff7-4ece-9959-3c744360cdb3	1f27dd0d-789b-4e23-b46a-53eddef341ad
0	460	460	GBIF Norway	4f829580-180d-46a9-9c87-ed8ec959b545	212e4844-e458-4f2a-a645-c3231364b202
170	170	0	Plazi	ffb07bec-2d10-492d-9c37-361fe0b79427	26e12e1b-2175-4007-871b-d0b73122e5e9
29666	30654	988	National Biodiversity Network	d897a5b9-35ee-4232-94bd-b0bcaac003c2	2790adc5-c709-427c-8d04-804590d98272
22	22	0	Biodiversity Information System of Mexico	b324e8e9-9a4c-44fa-8f1a-7f39ea7ab576	29b4b2d3-04be-4234-b74f-b9eea4ae7461
0	7	7	Plazi	ffb07bec-2d10-492d-9c37-361fe0b79427	29cfe23b-c8eb-46a2-bded-a6f9037982fd
175970	175970	0	U.S. Geological Survey	8618c64a-93e0-4300-b546-7249e5148ed2	2a97ee62-de89-4c4e-8151-0cb2ec98ae3c
102	102	0	GBIF France	da44cd31-5901-4687-a106-6d1c7734ee3a	2b3981f4-da8c-4693-a9b9-383cd7aae28b
0	5	5	Plazi	ffb07bec-2d10-492d-9c37-361fe0b79427	2f3fb2f9-a5a8-4ca1-b481-13c0c2e949da
0	26	26	Participant Node Managers Committee	7f48e0c8-5c96-49ec-b972-30748e339115	3143c70a-5afe-4564-bc1d-4ae1f53b7875
4	4	0	Plazi	ffb07bec-2d10-492d-9c37-361fe0b79427	36db578a-8a93-4211-aa73-aa517bc57ad8
395	395	0	GBIF France	da44cd31-5901-4687-a106-6d1c7734ee3a	383287ee-19c5-46e2-8b58-f9320a7aa091
558	558	0	Participant Node Managers Committee	7f48e0c8-5c96-49ec-b972-30748e339115	38b7571b-5011-49ed-a157-d07330a84836
655	655	0	Colombian Biodiversity Information System	7e865cba-7c46-417b-ade5-97f2cf5b7be0	39a96bb1-2fbd-4994-92f3-c1fc79b1bba3
8593	8127	-466	Belgian Biodiversity Platform	fb11cfe1-ebc3-45af-9159-17d9fddbcdac	3d1231e8-2554-45e6-b354-e590c56ce9a8
153	153	0	GBIF France	da44cd31-5901-4687-a106-6d1c7734ee3a	3d52644a-bd9b-4ee7-8bc6-c694064d4f8f
5	5	0	Plazi	ffb07bec-2d10-492d-9c37-361fe0b79427	3e1c4420-b287-4848-8b81-c9524d3fb5d9
1173	1173	0	GBIF France	da44cd31-5901-4687-a106-6d1c7734ee3a	3f9d801e-fafe-4157-8dd0-82d1f21d5e3d
9	9	0	Plazi	ffb07bec-2d10-492d-9c37-361fe0b79427	4552f0f4-563f-4a8e-bfef-ed4fadb0d786
1771	1771	0	Colombian Biodiversity Information System	7e865cba-7c46-417b-ade5-97f2cf5b7be0	477188a9-ebc9-45d1-92c0-711de17d3146
16097	16097	0	GBIF France	da44cd31-5901-4687-a106-6d1c7734ee3a	4939f5ba-e740-4f16-87fc-e2eac9b26cab
10	10	0	Plazi	ffb07bec-2d10-492d-9c37-361fe0b79427	4c0a9d8b-60b2-436e-8a83-2d5a95bd8e54
1	1	0	Plazi	ffb07bec-2d10-492d-9c37-361fe0b79427	4d26ca6c-b694-4ba7-b291-57b4fd00ccb8
258	258	0	Colombian Biodiversity Information System	7e865cba-7c46-417b-ade5-97f2cf5b7be0	4fb910b6-9fde-4b10-b41e-f78c02256dd9
159	159	0	Participant Node Managers Committee	7f48e0c8-5c96-49ec-b972-30748e339115	4fe926f2-6910-44af-aa0d-1a9e384a528c
20833	20833	0	U.S. Geological Survey	8618c64a-93e0-4300-b546-7249e5148ed2	52da118d-e74e-420a-9b6b-1a6d7bc3028d
0	61	61	Plazi	ffb07bec-2d10-492d-9c37-361fe0b79427	53754ae5-8913-4e45-b546-b9edae8f726b
660	660	0	National Biodiversity Network	d897a5b9-35ee-4232-94bd-b0bcaac003c2	53877953-d63b-4644-863b-d3028bc5a356
836	836	0	Participant Node Managers Committee	7f48e0c8-5c96-49ec-b972-30748e339115	542725b9-982a-43f3-a70a-abe91af3c4ea
3	3	0	Plazi	ffb07bec-2d10-492d-9c37-361fe0b79427	578da766-4538-4421-a77a-a9639850eac1
5795	5599	-196	Biodiversity Information System of Mexico	b324e8e9-9a4c-44fa-8f1a-7f39ea7ab576	5ab71997-6cb4-4796-8ba9-4b9b49a703ab
10179	10179	0	National Biodiversity Network	d897a5b9-35ee-4232-94bd-b0bcaac003c2	5b580625-29f0-4911-be29-cf5b6496e538
190	190	0	GBIF France	da44cd31-5901-4687-a106-6d1c7734ee3a	5b8c1e5b-c00b-41e6-8fbe-a2b2458f0788
6	6	0	Plazi	ffb07bec-2d10-492d-9c37-361fe0b79427	5bd0d5fb-f0d7-41cc-96af-c48ac8ecd35d
36	36	0	GBIF Spain	1f94b3ca-9345-4d65-afe2-4bace93aa0fe	5be2657e-0d54-489f-9aa3-e7145b367f3d
95	95	0	Participant Node Managers Committee	7f48e0c8-5c96-49ec-b972-30748e339115	5bf10f28-f0b1-40de-9df6-ac9d8ba22480
2	2	0	Plazi	ffb07bec-2d10-492d-9c37-361fe0b79427	5da9e520-9f14-4518-b3ab-e752466c28d8
3	3	0	Plazi	ffb07bec-2d10-492d-9c37-361fe0b79427	5e7426db-618e-4be0-818a-0f1b4e11539b
33	33	0	Plazi	ffb07bec-2d10-492d-9c37-361fe0b79427	602ab4c1-7ee2-43e4-93db-c3a4af273271
3	3	0	Plazi	ffb07bec-2d10-492d-9c37-361fe0b79427	607634de-02c5-497f-829f-e925c5178694
109	109	0	GBIF Germany	4f6826f2-4ff6-443d-b966-e6913bd24013	611a6c26-f762-11e1-a439-00145eb45e9a
103	103	0	GBIF Germany	4f6826f2-4ff6-443d-b966-e6913bd24013	61308344-f762-11e1-a439-00145eb45e9a
55	55	0	Colombian Biodiversity Information System	7e865cba-7c46-417b-ade5-97f2cf5b7be0	6172cd3e-54bf-486e-a64c-dc99c12aa05b
8313	8313	0	Taiwan Biodiversity Information Facility	e1b85abc-61f9-430f-ba79-6813dec53a0f	617e5387-3122-47b7-b639-c9fafc35bf13
17	17	0	Plazi	ffb07bec-2d10-492d-9c37-361fe0b79427	61d31327-ff5a-43e7-a3d8-864e4e114707
106	106	0	GBIF Germany	4f6826f2-4ff6-443d-b966-e6913bd24013	638a47f6-f762-11e1-a439-00145eb45e9a
47242	47242	0	GBIF France	da44cd31-5901-4687-a106-6d1c7734ee3a	646858f7-8620-4124-9405-279539aec76c
19	19	0	Plazi	ffb07bec-2d10-492d-9c37-361fe0b79427	64b0d4b0-479e-484a-aaf5-d5237292d4a5
0	173	173	Ocean Biodiversity Information System	ba0670b9-4186-41e6-8e70-f9cb3065551a	66002429-1bf0-4f15-acdf-739ed7f65644
36	36	0	GBIF Germany	4f6826f2-4ff6-443d-b966-e6913bd24013	66c49b56-f762-11e1-a439-00145eb45e9a
120	120	0	GBIF Germany	4f6826f2-4ff6-443d-b966-e6913bd24013	66d4578a-f762-11e1-a439-00145eb45e9a
378	378	0	GBIF Germany	4f6826f2-4ff6-443d-b966-e6913bd24013	680c12e3-6440-4559-8add-b263cb48f31a
98	98	0	GBIF Germany	4f6826f2-4ff6-443d-b966-e6913bd24013	68462b4e-bd70-4e05-9019-409ab013e440
148	148	0	GBIF Germany	4f6826f2-4ff6-443d-b966-e6913bd24013	69d49f26-f762-11e1-a439-00145eb45e9a
1803	1803	0	GBIF Germany	4f6826f2-4ff6-443d-b966-e6913bd24013	6a320de6-f762-11e1-a439-00145eb45e9a
2	2	0	Plazi	ffb07bec-2d10-492d-9c37-361fe0b79427	6a9a8192-2fc3-44fc-a5f4-e5aced04ab85
4340	4340	0	GBIF Brazil	cdc9736d-5ff7-4ece-9959-3c744360cdb3	6ba8e2df-519e-4fb2-84c5-d964a746f7e1
0	202	202	Plazi	ffb07bec-2d10-492d-9c37-361fe0b79427	6be6579d-cb12-4a89-82c8-a3a5419a7fff
111	111	0	GBIF Germany	4f6826f2-4ff6-443d-b966-e6913bd24013	6d55a4ba-f762-11e1-a439-00145eb45e9a
4	4	0	Plazi	ffb07bec-2d10-492d-9c37-361fe0b79427	6e9a1134-1c81-4217-95f9-e5fdcde176cd
6420	6420	0	Biodiversity Information System of Mexico	b324e8e9-9a4c-44fa-8f1a-7f39ea7ab576	700a6f1d-8bfb-4b7e-b88c-f8d4882600e9
120	120	0	GBIF Germany	4f6826f2-4ff6-443d-b966-e6913bd24013	7103a990-f762-11e1-a439-00145eb45e9a
63	63	0	GBIF Germany	4f6826f2-4ff6-443d-b966-e6913bd24013	710e76ea-f762-11e1-a439-00145eb45e9a
1	1	0	GBIF Germany	4f6826f2-4ff6-443d-b966-e6913bd24013	71a29618-f762-11e1-a439-00145eb45e9a
182	182	0	GBIF Germany	4f6826f2-4ff6-443d-b966-e6913bd24013	71ac5248-f762-11e1-a439-00145eb45e9a
121	121	0	GBIF Germany	4f6826f2-4ff6-443d-b966-e6913bd24013	71cb1778-f762-11e1-a439-00145eb45e9a
0	19	19	Ocean Biodiversity Information System	ba0670b9-4186-41e6-8e70-f9cb3065551a	7221015e-1631-49b3-b787-60e39c6bda02
168	168	0	National Biodiversity Network	d897a5b9-35ee-4232-94bd-b0bcaac003c2	72350416-6619-4920-b7dd-2e4f39f0bb2d
1953	1953	0	GBIF Germany	4f6826f2-4ff6-443d-b966-e6913bd24013	72bcf39a-f762-11e1-a439-00145eb45e9a
103	103	0	GBIF Germany	4f6826f2-4ff6-443d-b966-e6913bd24013	7371f54c-f762-11e1-a439-00145eb45e9a
0	10	10	GBIF Japan	db5705aa-6a6e-42f1-8942-d77b9f4896ea	738854b6-d0ac-4bb1-b39d-87cd61b2a072
153	153	0	GBIF Germany	4f6826f2-4ff6-443d-b966-e6913bd24013	742269c2-f762-11e1-a439-00145eb45e9a
33	33	0	GBIF Germany	4f6826f2-4ff6-443d-b966-e6913bd24013	74470836-f762-11e1-a439-00145eb45e9a
35	32	-3	GBIF Germany	4f6826f2-4ff6-443d-b966-e6913bd24013	757f2634-f762-11e1-a439-00145eb45e9a
253	236	-17	GBIF Germany	4f6826f2-4ff6-443d-b966-e6913bd24013	7606a974-f762-11e1-a439-00145eb45e9a
159	159	0	Ocean Biodiversity Information System	ba0670b9-4186-41e6-8e70-f9cb3065551a	7636857e-72d3-4c1a-9a31-d19be9d122cf
346	346	0	Canada Biodiversity Information Facility	8f83fc96-c966-4126-83f7-bf044dc49efa	776e8e76-65b5-4cb0-ba08-509feb8c8808
1659	966	-693	GBIF Germany	4f6826f2-4ff6-443d-b966-e6913bd24013	79e429ae-f762-11e1-a439-00145eb45e9a
31	31	0	GBIF Germany	4f6826f2-4ff6-443d-b966-e6913bd24013	7a862cae-f762-11e1-a439-00145eb45e9a
104	104	0	GBIF Germany	4f6826f2-4ff6-443d-b966-e6913bd24013	7ab37d94-f762-11e1-a439-00145eb45e9a
1	1	0	GBIF Germany	4f6826f2-4ff6-443d-b966-e6913bd24013	7ab7807e-f762-11e1-a439-00145eb45e9a
0	1	1	Plazi	ffb07bec-2d10-492d-9c37-361fe0b79427	7afb9205-9b81-473e-80be-999e99774435
440	440	0	Ocean Biodiversity Information System	ba0670b9-4186-41e6-8e70-f9cb3065551a	7b506316-f762-11e1-a439-00145eb45e9a
15918	15918	0	GBIF Spain	1f94b3ca-9345-4d65-afe2-4bace93aa0fe	7b8f1304-f762-11e1-a439-00145eb45e9a
1325	1325	0	Ocean Biodiversity Information System	ba0670b9-4186-41e6-8e70-f9cb3065551a	7b97a28a-f762-11e1-a439-00145eb45e9a
410	410	0	GBIF Germany	4f6826f2-4ff6-443d-b966-e6913bd24013	7c3d11de-f762-11e1-a439-00145eb45e9a
422	422	0	National Biodiversity Network	d897a5b9-35ee-4232-94bd-b0bcaac003c2	7c7756f3-6a25-45e8-a0a6-425ee43ea7ad
336	232	-104	GBIF Germany	4f6826f2-4ff6-443d-b966-e6913bd24013	7cf7b890-f762-11e1-a439-00145eb45e9a
31	31	0	GBIF Germany	4f6826f2-4ff6-443d-b966-e6913bd24013	7d3d0652-f762-11e1-a439-00145eb45e9a
93	93	0	GBIF France	da44cd31-5901-4687-a106-6d1c7734ee3a	7ee1918d-1fd4-47ae-bd22-10752f6ba797
89	89	0	GBIF Germany	4f6826f2-4ff6-443d-b966-e6913bd24013	8147910e-f762-11e1-a439-00145eb45e9a
21794	21794	0	GBIF Japan	db5705aa-6a6e-42f1-8942-d77b9f4896ea	849dabae-f762-11e1-a439-00145eb45e9a
0	648	648	GBIF Norway	4f829580-180d-46a9-9c87-ed8ec959b545	84f0fec1-b254-4d5b-8c7c-3666166fc4e3
8980	8980	0	Biodiversity Information System of Mexico	b324e8e9-9a4c-44fa-8f1a-7f39ea7ab576	8501be96-f762-11e1-a439-00145eb45e9a
604	604	0	GBIF France	da44cd31-5901-4687-a106-6d1c7734ee3a	85cecc78-f491-4443-bc13-10be7a5dcd32
0	2	2	Plazi	ffb07bec-2d10-492d-9c37-361fe0b79427	86c31b05-92b3-4b02-870f-ecbd662ecc60
23	15	-8	GBIF Germany	4f6826f2-4ff6-443d-b966-e6913bd24013	875aee92-f762-11e1-a439-00145eb45e9a
102	75	-27	GBIF Germany	4f6826f2-4ff6-443d-b966-e6913bd24013	87694848-f762-11e1-a439-00145eb45e9a
1860	1612	-248	GBIF Germany	4f6826f2-4ff6-443d-b966-e6913bd24013	878f4278-f762-11e1-a439-00145eb45e9a
10	10	0	GBIF Germany	4f6826f2-4ff6-443d-b966-e6913bd24013	879df958-f762-11e1-a439-00145eb45e9a
31	16	-15	GBIF Germany	4f6826f2-4ff6-443d-b966-e6913bd24013	87a60206-f762-11e1-a439-00145eb45e9a
0	1	1	Plazi	ffb07bec-2d10-492d-9c37-361fe0b79427	87d616fa-c4e1-474e-b191-f6b24af44520
4	4	0	Plazi	ffb07bec-2d10-492d-9c37-361fe0b79427	887ab7bf-0711-420c-9ce9-6fc6fd0f6d0a
16	16	0	GBIF Germany	4f6826f2-4ff6-443d-b966-e6913bd24013	889a804c-f762-11e1-a439-00145eb45e9a
7	7	0	GBIF Germany	4f6826f2-4ff6-443d-b966-e6913bd24013	8949d6be-f762-11e1-a439-00145eb45e9a
238	238	0	GBIF Germany	4f6826f2-4ff6-443d-b966-e6913bd24013	8a3455fe-f762-11e1-a439-00145eb45e9a
0	2	2	Plazi	ffb07bec-2d10-492d-9c37-361fe0b79427	8c25c4ca-1cb8-41e9-b73a-f7cd0e61f0ff
45	45	0	Plazi	ffb07bec-2d10-492d-9c37-361fe0b79427	8d311d5f-01bd-4a08-bb54-3bcac98ea7c2
5	4	-1	GBIF Germany	4f6826f2-4ff6-443d-b966-e6913bd24013	8ee82666-f762-11e1-a439-00145eb45e9a
211	211	0	GBIF Germany	4f6826f2-4ff6-443d-b966-e6913bd24013	8f191cb2-f762-11e1-a439-00145eb45e9a
135	41	-94	GBIF Germany	4f6826f2-4ff6-443d-b966-e6913bd24013	8f952302-f762-11e1-a439-00145eb45e9a
975	735	-240	GBIF Germany	4f6826f2-4ff6-443d-b966-e6913bd24013	907d7d5e-50cb-484f-bad4-a8eb547bb982
202057	202057	0	GBIF Spain	1f94b3ca-9345-4d65-afe2-4bace93aa0fe	90ae13f0-288f-4108-b741-ac8a0f9e0878
7	7	0	Plazi	ffb07bec-2d10-492d-9c37-361fe0b79427	924c834c-245c-4db3-a504-352b1d98d5b7
45	45	0	Plazi	ffb07bec-2d10-492d-9c37-361fe0b79427	9316f2ae-941e-4f30-9163-2d8d1309701e
1	1	0	GBIF Germany	4f6826f2-4ff6-443d-b966-e6913bd24013	9385e302-f762-11e1-a439-00145eb45e9a
220	220	0	GBIF Spain	1f94b3ca-9345-4d65-afe2-4bace93aa0fe	95ff948b-2f19-4c17-8057-a21bd58df93c
0	77	77	Belgian Biodiversity Platform	fb11cfe1-ebc3-45af-9159-17d9fddbcdac	97456782-8d2f-4b2b-b14b-704f2ca61165
0	44	44	Plazi	ffb07bec-2d10-492d-9c37-361fe0b79427	9d936674-3dce-4fd9-8f2b-7cd216b19b75
232	232	0	GBIF France	da44cd31-5901-4687-a106-6d1c7734ee3a	9e2f8841-097e-4eba-b015-dddaf1708c7e
5	5	0	Plazi	ffb07bec-2d10-492d-9c37-361fe0b79427	a2776578-f968-442b-8317-9599e5884e3f
142	142	0	Plazi	ffb07bec-2d10-492d-9c37-361fe0b79427	a3c9f2fa-30d7-48b9-9a2e-3f81cc0a3e3e
0	2	2	Plazi	ffb07bec-2d10-492d-9c37-361fe0b79427	a5362c50-6123-4b02-b93a-2d7e47d0a8d1
0	13	13	Plazi	ffb07bec-2d10-492d-9c37-361fe0b79427	a8c04358-3585-456d-ab16-294c4235b740
7738	7738	0	National Biodiversity Network	d897a5b9-35ee-4232-94bd-b0bcaac003c2	ada1f63e-4128-4ea1-a9dd-b8dbf68971d9
1	1	0	Plazi	ffb07bec-2d10-492d-9c37-361fe0b79427	b001f995-9e4f-45cf-bb6f-a67eeb29045b
14845	28150	13305	GBIF Japan	db5705aa-6a6e-42f1-8942-d77b9f4896ea	b08b5ce4-b157-4fa5-b904-afa1ac982e1a
0	14	14	Plazi	ffb07bec-2d10-492d-9c37-361fe0b79427	b3748d17-c3e5-4e9d-9ec5-cb5e6a51f2f8
3782	3782	0	Colombian Biodiversity Information System	7e865cba-7c46-417b-ade5-97f2cf5b7be0	b403c612-8402-4bdd-ad60-0fc6eb465cae
119	119	0	GBIF Norway	4f829580-180d-46a9-9c87-ed8ec959b545	b4fc23e2-df21-4756-8029-e8ace96e6589
2418	2418	0	GBIF Germany	4f6826f2-4ff6-443d-b966-e6913bd24013	b6cb79e9-63cc-44a4-88c8-b0630039cc86
1332	1332	0	GBIF Brazil	cdc9736d-5ff7-4ece-9959-3c744360cdb3	b8911be5-a01a-41d4-a160-aadd08b844d0
0	2590	2590	National Biodiversity Network	d897a5b9-35ee-4232-94bd-b0bcaac003c2	bc3f2018-2924-4fe8-86d4-261c9b9fa71f
466	466	0	GBIF France	da44cd31-5901-4687-a106-6d1c7734ee3a	bef72d46-99f0-469a-8ea1-a3eb943d3670
32	1181	1149	GBIF Germany	4f6826f2-4ff6-443d-b966-e6913bd24013	c0878e31-bada-421d-b1c1-96075996e3ac
11	11	0	Plazi	ffb07bec-2d10-492d-9c37-361fe0b79427	c3d12699-338e-45eb-a376-c0298240b67c
3381819	3381819	0	Atlas of Living Australia	4a6f1b71-969e-4fc5-a693-282b05e1220c	c3f5731f-4ebc-48a2-83ba-3fb5c895f6c1
0	82	82	Ocean Biodiversity Information System	ba0670b9-4186-41e6-8e70-f9cb3065551a	c432fba3-c490-435e-87ce-27fa5593192c
2439	2439	0	Participant Node Managers Committee	7f48e0c8-5c96-49ec-b972-30748e339115	c4d742af-8f18-4f71-90ea-91f1645b9b28
3	3	0	Plazi	ffb07bec-2d10-492d-9c37-361fe0b79427	c9972b11-cc8e-48e6-be47-fdc80ca7b7fe
91	91	0	GBIF France	da44cd31-5901-4687-a106-6d1c7734ee3a	ca415041-8434-45ce-b6d3-c6b0683a40b5
105002	94279	-10723	GBIF Estonia	2c11b821-d22b-4c64-8cd3-c1578173b129	ca9b1ee0-1302-43a7-b75c-fa46e1f7ab7c
9990	9990	0	GBIF France	da44cd31-5901-4687-a106-6d1c7734ee3a	cc29d42b-fcfa-4874-88aa-9c349d1d5178
7	7	0	Plazi	ffb07bec-2d10-492d-9c37-361fe0b79427	cc8ceff7-fe59-4090-9bde-3eaf28e8dd82
201	176	-25	GBIF Germany	4f6826f2-4ff6-443d-b966-e6913bd24013	ccb8f313-1b41-436b-bd99-0bcc40a5c55a
321	321	0	GBIF Germany	4f6826f2-4ff6-443d-b966-e6913bd24013	cd957e3d-2f34-4731-a3cc-c44b95534806
0	1	1	Participant Node Managers Committee	7f48e0c8-5c96-49ec-b972-30748e339115	ce449d38-c351-4e31-b3b1-b46bcce05e3b
3	3	0	Plazi	ffb07bec-2d10-492d-9c37-361fe0b79427	cea0c53a-f4c2-4d77-8819-0deeae00791d
0	10	10	Plazi	ffb07bec-2d10-492d-9c37-361fe0b79427	ceca425f-e47a-4fe0-8c4c-f0abaae680e4
0	550282	550282	GBIF Portugal	673f7038-4262-4149-b753-5658a4e912f6	cfac873c-696e-4a6a-8ee1-c3e0f18fc323
14	14	0	Plazi	ffb07bec-2d10-492d-9c37-361fe0b79427	d00b602c-b408-4a79-acaf-bcd9fe0a7948
127	127	0	Participant Node Managers Committee	7f48e0c8-5c96-49ec-b972-30748e339115	d01a97f1-47a6-4627-8127-19148d698f4e
74	74	0	Plazi	ffb07bec-2d10-492d-9c37-361fe0b79427	d13c2f0d-7f44-4b5f-aa68-6b4d69c05d2e
338	338	0	GBIF France	da44cd31-5901-4687-a106-6d1c7734ee3a	d3c75a98-09d5-42ce-86f1-762f1cc817f8
12	12	0	Plazi	ffb07bec-2d10-492d-9c37-361fe0b79427	d6c1c011-5858-4339-b444-f99176fbcde5
11298	11298	0	GBIF France	da44cd31-5901-4687-a106-6d1c7734ee3a	d71b721d-6eb0-45d2-8794-7e6b5296ccbd
0	2	2	Plazi	ffb07bec-2d10-492d-9c37-361fe0b79427	d74cb174-4e73-4b24-8240-071f098aa4d1
54	54	0	Plazi	ffb07bec-2d10-492d-9c37-361fe0b79427	d8261df6-dba5-4c69-afca-83b9b4db13c8
0	2	2	Plazi	ffb07bec-2d10-492d-9c37-361fe0b79427	d9472c9c-ed8f-407a-89d9-167d4c49f29f
0	23	23	Plazi	ffb07bec-2d10-492d-9c37-361fe0b79427	d9ee6109-a271-4440-8a93-dd53f043be8e
99	99	0	Plazi	ffb07bec-2d10-492d-9c37-361fe0b79427	dca608e8-fccf-4c1c-b8df-ef0c28e1d518
0	50	50	Plazi	ffb07bec-2d10-492d-9c37-361fe0b79427	dd19ed08-632a-443b-8c7e-0a8bde3d3035
1250	1250	0	GBIF Japan	db5705aa-6a6e-42f1-8942-d77b9f4896ea	de9ffc5b-26ed-42ea-b8b6-76a55c47c619
2668	2680	12	U.S. Geological Survey	8618c64a-93e0-4300-b546-7249e5148ed2	df51b5c8-ed35-4a9c-8cda-cb5005ea3192
18768	18768	0	GBIF Brazil	cdc9736d-5ff7-4ece-9959-3c744360cdb3	e00f784b-e406-4cb0-8117-559b924ab3f4
2	2	0	Plazi	ffb07bec-2d10-492d-9c37-361fe0b79427	e42a0566-4e05-409f-9a50-e9d1756b1683
0	315	315	Ocean Biodiversity Information System	ba0670b9-4186-41e6-8e70-f9cb3065551a	e6c39fbc-2583-43a9-8e44-11a32b0a213b
665	284	-381	GBIF Germany	4f6826f2-4ff6-443d-b966-e6913bd24013	e808761e-e8a5-4948-a4bf-d26d91c29a6f
3018	3018	0	Participant Node Managers Committee	7f48e0c8-5c96-49ec-b972-30748e339115	e86233df-a477-4776-8e30-6c541fb41e5f
0	225	225	Ocean Biodiversity Information System	ba0670b9-4186-41e6-8e70-f9cb3065551a	ea90df74-d62b-43b7-ac17-24f5889fde30
126	126	0	Biodiversity Information System of Mexico	b324e8e9-9a4c-44fa-8f1a-7f39ea7ab576	ea9ad89e-4452-4ba2-86fe-d7b5b4f777e9
6	6	0	Plazi	ffb07bec-2d10-492d-9c37-361fe0b79427	ebfafafe-ed6f-4fc7-a34e-770cdde8ede6
15	15	0	Plazi	ffb07bec-2d10-492d-9c37-361fe0b79427	f29477d8-21e5-4db0-b41d-c726d86ce3ca
50	50	0	Plazi	ffb07bec-2d10-492d-9c37-361fe0b79427	f2dbeef9-77cf-47d6-a109-a81357210e48
0	8	8	Plazi	ffb07bec-2d10-492d-9c37-361fe0b79427	f3d698f2-f653-4be9-8d49-9ac6502912c0
0	8	8	Plazi	ffb07bec-2d10-492d-9c37-361fe0b79427	f49d9820-b433-4760-b056-1e0c3dc3bab6
2	2	0	Plazi	ffb07bec-2d10-492d-9c37-361fe0b79427	f6c42da5-145e-4ebc-b55b-c5931c2a7b8d
0	58	58	Ocean Biodiversity Information System	ba0670b9-4186-41e6-8e70-f9cb3065551a	f7392b14-71c6-4bbb-9d8a-06335618259a
116	116	0	Atlas of Living Australia	4a6f1b71-969e-4fc5-a693-282b05e1220c	fba07657-9a38-4cae-9797-d0febebfca24
10	10	0	Plazi	ffb07bec-2d10-492d-9c37-361fe0b79427	fd0f8df3-632e-4e51-adab-24311d5d9027
54	54	0	GBIF France	da44cd31-5901-4687-a106-6d1c7734ee3a	04a9755b-5eba-410a-ae6f-f0597f249348
0	24775	24775	U.S. Geological Survey	8618c64a-93e0-4300-b546-7249e5148ed2	08fa9dda-6ad2-49c5-8e49-c20058214268
0	27	27	GBIF Spain	1f94b3ca-9345-4d65-afe2-4bace93aa0fe	0a1c317b-8bb9-4a44-8c48-f9b59d566baf
0	12	12	Plazi	ffb07bec-2d10-492d-9c37-361fe0b79427	0a76fff6-61ee-4477-8f55-b7abce7ca771
21	21	0	GBIF France	da44cd31-5901-4687-a106-6d1c7734ee3a	0ab6b759-8002-44dd-8dc7-85f3c48f9b25
0	49942	49942	Korean Biodiversity Information Facility	e0a1e772-0177-4800-94b4-2d023fe6cdf4	0c4dc4f2-c11e-4e8b-8169-cabac6384735
48	48	0	Plazi	ffb07bec-2d10-492d-9c37-361fe0b79427	0d5b0561-a16b-4ed8-a9e8-2b7160630339
2	2	0	Plazi	ffb07bec-2d10-492d-9c37-361fe0b79427	0d7e46f1-4153-4ce2-86c0-abeef2166047
119365	119365	0	National Biodiversity Network	d897a5b9-35ee-4232-94bd-b0bcaac003c2	0d9accc4-309d-44ad-901e-f221e1d0ec80
10	10	0	Plazi	ffb07bec-2d10-492d-9c37-361fe0b79427	0e1cc894-7613-41e5-bc48-b5224cce0670
3	3	0	Plazi	ffb07bec-2d10-492d-9c37-361fe0b79427	1381c73a-20e6-449d-848f-f8f75cc88bb1
25	25	0	GBIF Germany	4f6826f2-4ff6-443d-b966-e6913bd24013	1391f7a7-4348-4b00-9e54-1eb24c31cfc4
3	3	0	Plazi	ffb07bec-2d10-492d-9c37-361fe0b79427	1a357b4d-dcde-4be0-ac99-fd9de8b39306
7474	7474	0	U.S. Geological Survey	8618c64a-93e0-4300-b546-7249e5148ed2	1ba73ad6-f210-4a11-be3c-578709d036cf
15	15	0	Plazi	ffb07bec-2d10-492d-9c37-361fe0b79427	20d0000a-3d51-4b9e-a7b8-db42a2378763
28	28	0	Plazi	ffb07bec-2d10-492d-9c37-361fe0b79427	21741f30-812d-45b7-a766-cdc7e81c32b3
0	48	48	Plazi	ffb07bec-2d10-492d-9c37-361fe0b79427	225571d6-a475-4d3e-9f2a-a2e93c50a984
0	12	12	Plazi	ffb07bec-2d10-492d-9c37-361fe0b79427	239ef927-f13d-4898-b3a2-1cbb63c98215
181	181	0	GBIF Argentina	2426a871-9feb-40a1-96c6-0c593a76b835	265fb13a-515a-47f6-84da-88b294e88798
70	70	0	GBIF Germany	4f6826f2-4ff6-443d-b966-e6913bd24013	2821b001-4609-4eac-ba6a-85ecc39731b3
6	6	0	Plazi	ffb07bec-2d10-492d-9c37-361fe0b79427	2a0a0531-766d-4054-8638-1134f95fe1bb
1359	1359	0	Ocean Biodiversity Information System	ba0670b9-4186-41e6-8e70-f9cb3065551a	2aa6f6ad-515b-4aac-87cb-d3a60321b9f4
0	330897	330897	GBIF Estonia	2c11b821-d22b-4c64-8cd3-c1578173b129	2b044aa9-1a9a-413e-8b18-ed09da575d3f
0	1079	1079	Ocean Biodiversity Information System	ba0670b9-4186-41e6-8e70-f9cb3065551a	2b7ba688-b90c-49b3-b3db-20d781389927
50	50	0	GBIF Germany	4f6826f2-4ff6-443d-b966-e6913bd24013	2eef9773-169d-4a12-93d1-1742a3a3b31e
3	3	0	Plazi	ffb07bec-2d10-492d-9c37-361fe0b79427	2f0b36c9-f69e-435d-8dcd-c6ad6717de50
108	108	0	Participant Node Managers Committee	7f48e0c8-5c96-49ec-b972-30748e339115	2fad476b-71d3-4743-9ab5-b782693974f8
240	240	0	Participant Node Managers Committee	7f48e0c8-5c96-49ec-b972-30748e339115	314ffb47-7e25-4f72-bf98-5f8cc7195f76
9997	9997	0	GBIF France	da44cd31-5901-4687-a106-6d1c7734ee3a	3287044c-8c48-4ad6-81d4-4908071bc8db
4	4	0	Plazi	ffb07bec-2d10-492d-9c37-361fe0b79427	368ee07f-340b-47b1-a0d0-de421fe309d1
0	2	2	Plazi	ffb07bec-2d10-492d-9c37-361fe0b79427	3796a761-c30d-4f80-ac57-d174f274e5f3
13	13	0	Plazi	ffb07bec-2d10-492d-9c37-361fe0b79427	3ab9cb01-3768-4d15-916c-0398183fa75e
0	3	3	Plazi	ffb07bec-2d10-492d-9c37-361fe0b79427	3cf79a3b-8708-4fa8-9f06-0126933c1c02
3372	3372	0	GBIF Argentina	2426a871-9feb-40a1-96c6-0c593a76b835	3e360f32-57df-4186-a9da-f62620505a14
57	57	0	GBIF France	da44cd31-5901-4687-a106-6d1c7734ee3a	456023bd-9740-4abc-9c66-6387d1ba4cb8
55	55	0	Colombian Biodiversity Information System	7e865cba-7c46-417b-ade5-97f2cf5b7be0	460077c3-1808-4342-8f09-e08db871f6b7
0	5	5	Plazi	ffb07bec-2d10-492d-9c37-361fe0b79427	470bea87-bad5-4352-aeac-fe448f94792e
504	504	0	Atlas of Living Australia	4a6f1b71-969e-4fc5-a693-282b05e1220c	48f54e74-d525-4fad-b482-a32316d79ccb
1	1	0	Plazi	ffb07bec-2d10-492d-9c37-361fe0b79427	49d1e950-2a1f-46b7-917a-ce89a4bd164e
1	1	0	Plazi	ffb07bec-2d10-492d-9c37-361fe0b79427	4a61b76a-24d2-4796-8bea-6a25105253fc
79	79	0	Colombian Biodiversity Information System	7e865cba-7c46-417b-ade5-97f2cf5b7be0	4b99d5d8-5d62-4f17-89cc-b1bd3bc242ec
0	175	175	Plazi	ffb07bec-2d10-492d-9c37-361fe0b79427	4c24f7f2-67be-4bac-b343-ca377a8dd82f
0	1	1	Plazi	ffb07bec-2d10-492d-9c37-361fe0b79427	4de59e50-6aa3-41e9-bb60-c6ca122bc6d5
8	8	0	Plazi	ffb07bec-2d10-492d-9c37-361fe0b79427	4f3ec33b-a217-4df5-9e6b-c084ef1dc089
2789	2789	0	Colombian Biodiversity Information System	7e865cba-7c46-417b-ade5-97f2cf5b7be0	5152f65f-ec13-4847-a02e-3cb454ae6dd5
474	474	0	GBIF France	da44cd31-5901-4687-a106-6d1c7734ee3a	522ff15f-4f77-4402-862a-a4618d2ff415
152	152	0	National Biodiversity Network	d897a5b9-35ee-4232-94bd-b0bcaac003c2	52707cd4-ea49-4578-a7a7-175272d1542f
39	39	0	Plazi	ffb07bec-2d10-492d-9c37-361fe0b79427	53a70190-7745-41c3-8cc5-ae7a8c2f35cf
1260	1260	0	GBIF Germany	4f6826f2-4ff6-443d-b966-e6913bd24013	54e39d50-133e-4841-b6df-99e4bcea4010
0	3529	3529	Belgian Biodiversity Platform	fb11cfe1-ebc3-45af-9159-17d9fddbcdac	55bb3aa5-e13d-41e1-8667-1afaa0b17786
0	2	2	Plazi	ffb07bec-2d10-492d-9c37-361fe0b79427	562ff8c1-89ef-4be6-a025-4dd7bc728b73
0	20	20	Ocean Biodiversity Information System	ba0670b9-4186-41e6-8e70-f9cb3065551a	5708ecde-ffc2-4ce3-9e02-45f64f7dbd9a
0	227	227	Plazi	ffb07bec-2d10-492d-9c37-361fe0b79427	5b3a67b8-7bec-48f8-ac95-4588cdadf76b
0	5	5	Plazi	ffb07bec-2d10-492d-9c37-361fe0b79427	5c7d2759-155e-48a7-a440-96d8b608fbc8
461	461	0	GBIF France	da44cd31-5901-4687-a106-6d1c7734ee3a	5c7e315e-7e2f-4715-bfc1-ba0ec6880cc7
0	11	11	Plazi	ffb07bec-2d10-492d-9c37-361fe0b79427	5d03d026-6f4b-4ec9-a01f-14b0c30e4ac8
0	100	100	Ocean Biodiversity Information System	ba0670b9-4186-41e6-8e70-f9cb3065551a	5dee5531-f702-4b70-880e-ff5bddc0c8e0
11	11	0	Colombian Biodiversity Information System	7e865cba-7c46-417b-ade5-97f2cf5b7be0	61f9400e-2fa4-47c9-a8d3-07cb65be0681
102	102	0	GBIF Germany	4f6826f2-4ff6-443d-b966-e6913bd24013	6274802a-f762-11e1-a439-00145eb45e9a
636	636	0	GBIF Germany	4f6826f2-4ff6-443d-b966-e6913bd24013	631ea088-8dc7-496f-bb48-8396f3801616
136	39	-97	Ocean Biodiversity Information System	ba0670b9-4186-41e6-8e70-f9cb3065551a	644b5e09-595f-4e0d-b464-ba734e04ab61
0	4	4	Plazi	ffb07bec-2d10-492d-9c37-361fe0b79427	66218df8-73a3-40d6-b5f4-7cf10002016a
2	2	0	Plazi	ffb07bec-2d10-492d-9c37-361fe0b79427	66883e42-86d2-4053-9ef6-3eb65f5dc75e
1750	1750	0	GBIF Japan	db5705aa-6a6e-42f1-8942-d77b9f4896ea	675442df-956e-4714-8e78-903a1060f15b
94	94	0	GBIF Germany	4f6826f2-4ff6-443d-b966-e6913bd24013	67552a04-f762-11e1-a439-00145eb45e9a
83	83	0	GBIF Germany	4f6826f2-4ff6-443d-b966-e6913bd24013	67b0d138-f762-11e1-a439-00145eb45e9a
185	185	0	GBIF Germany	4f6826f2-4ff6-443d-b966-e6913bd24013	67d7e30e-f762-11e1-a439-00145eb45e9a
65	65	0	GBIF Germany	4f6826f2-4ff6-443d-b966-e6913bd24013	681ea492-f762-11e1-a439-00145eb45e9a
2300	2300	0	Atlas of Living Australia	4a6f1b71-969e-4fc5-a693-282b05e1220c	685cff6d-e439-4552-980c-5c73d647d1bf
2	2	0	Plazi	ffb07bec-2d10-492d-9c37-361fe0b79427	68c6779b-de86-4ce4-98cf-b83601baa0d1
764	567	-197	GBIF Germany	4f6826f2-4ff6-443d-b966-e6913bd24013	69f6cf9c-f762-11e1-a439-00145eb45e9a
218	218	0	GBIF Germany	4f6826f2-4ff6-443d-b966-e6913bd24013	6a79ba56-f762-11e1-a439-00145eb45e9a
5462	5462	0	Colombian Biodiversity Information System	7e865cba-7c46-417b-ade5-97f2cf5b7be0	6b0b234d-8cc2-4129-84c7-f10803ffc1c6
18	18	0	GBIF Germany	4f6826f2-4ff6-443d-b966-e6913bd24013	6b35964a-f762-11e1-a439-00145eb45e9a
4823	4823	0	GBIF France	da44cd31-5901-4687-a106-6d1c7734ee3a	6bcfbc19-4a2a-496f-ae62-5dcb36e335fb
33	33	0	GBIF Germany	4f6826f2-4ff6-443d-b966-e6913bd24013	6c863716-f762-11e1-a439-00145eb45e9a
31	31	0	GBIF Germany	4f6826f2-4ff6-443d-b966-e6913bd24013	6cde106c-f762-11e1-a439-00145eb45e9a
528	528	0	GBIF Germany	4f6826f2-4ff6-443d-b966-e6913bd24013	6d4e6e70-f762-11e1-a439-00145eb45e9a
94	94	0	GBIF Germany	4f6826f2-4ff6-443d-b966-e6913bd24013	6d597dc4-f762-11e1-a439-00145eb45e9a
25743	25743	0	National Biodiversity Network	d897a5b9-35ee-4232-94bd-b0bcaac003c2	7139041c-bc5b-49fe-bda2-601dc00c9d19
0	1	1	Plazi	ffb07bec-2d10-492d-9c37-361fe0b79427	7174846b-0859-4f21-a1f5-1272c21ed963
2	2	0	GBIF Germany	4f6826f2-4ff6-443d-b966-e6913bd24013	717f1422-f762-11e1-a439-00145eb45e9a
18	18	0	GBIF Germany	4f6826f2-4ff6-443d-b966-e6913bd24013	72932966-f762-11e1-a439-00145eb45e9a
1	1	0	Plazi	ffb07bec-2d10-492d-9c37-361fe0b79427	72af943f-ac2e-4a7a-961f-aaf7b4c42d40
11	11	0	GBIF Germany	4f6826f2-4ff6-443d-b966-e6913bd24013	737ae576-f762-11e1-a439-00145eb45e9a
5353	5353	0	National Biodiversity Network	d897a5b9-35ee-4232-94bd-b0bcaac003c2	73c5759a-586a-4474-8fb6-a0fe27a70590
1	1	0	Plazi	ffb07bec-2d10-492d-9c37-361fe0b79427	73ca798a-39ed-41a7-9e55-0af516188ca0
312	312	0	GBIF Germany	4f6826f2-4ff6-443d-b966-e6913bd24013	749ab38c-f762-11e1-a439-00145eb45e9a
587	587	0	GBIF Germany	4f6826f2-4ff6-443d-b966-e6913bd24013	74a29110-f762-11e1-a439-00145eb45e9a
407	407	0	GBIF Germany	4f6826f2-4ff6-443d-b966-e6913bd24013	75f615fa-f762-11e1-a439-00145eb45e9a
0	5	5	Plazi	ffb07bec-2d10-492d-9c37-361fe0b79427	76a37585-2ba6-4cb4-be95-99f4451bd4ee
587	587	0	Colombian Biodiversity Information System	7e865cba-7c46-417b-ade5-97f2cf5b7be0	77b2bda4-aec2-4bbc-8643-496b7a019ea7
9	9	0	Plazi	ffb07bec-2d10-492d-9c37-361fe0b79427	77b839e2-6894-409b-93f0-e80afc9e8e19
0	18	18	Ocean Biodiversity Information System	ba0670b9-4186-41e6-8e70-f9cb3065551a	782e42e0-179b-4ab3-964c-7a383c710823
0	11	11	Plazi	ffb07bec-2d10-492d-9c37-361fe0b79427	7b8feec1-b85e-4a4c-9d55-f3298078bf0f
183	183	0	GBIF Germany	4f6826f2-4ff6-443d-b966-e6913bd24013	7bde8ce0-f762-11e1-a439-00145eb45e9a
471	471	0	GBIF Germany	4f6826f2-4ff6-443d-b966-e6913bd24013	7cc784a1-52a5-48da-8367-2e3c276a3e7b
684	684	0	GBIF Germany	4f6826f2-4ff6-443d-b966-e6913bd24013	7dab8c1c-f762-11e1-a439-00145eb45e9a
5272	5272	0	GBIF Germany	4f6826f2-4ff6-443d-b966-e6913bd24013	7e440c80-f762-11e1-a439-00145eb45e9a
41	38	-3	GBIF Germany	4f6826f2-4ff6-443d-b966-e6913bd24013	7e8628a4-f762-11e1-a439-00145eb45e9a
2000	2000	0	Biodiversity Information System of Mexico	b324e8e9-9a4c-44fa-8f1a-7f39ea7ab576	8050237e-f762-11e1-a439-00145eb45e9a
1	1	0	Plazi	ffb07bec-2d10-492d-9c37-361fe0b79427	80d29977-724b-431e-9a98-5eaf7a8c3651
868	868	0	GBIF Germany	4f6826f2-4ff6-443d-b966-e6913bd24013	818504f8-f762-11e1-a439-00145eb45e9a
74	74	0	GBIF Germany	4f6826f2-4ff6-443d-b966-e6913bd24013	8250db46-f762-11e1-a439-00145eb45e9a
1733	1733	0	GBIF France	da44cd31-5901-4687-a106-6d1c7734ee3a	85c5d5a9-e0d6-46a9-a726-15b590a83e62
536	393	-143	GBIF Germany	4f6826f2-4ff6-443d-b966-e6913bd24013	87db2260-f762-11e1-a439-00145eb45e9a
462	462	0	GBIF Germany	4f6826f2-4ff6-443d-b966-e6913bd24013	88be8960-f762-11e1-a439-00145eb45e9a
640	640	0	GBIF Chile	a8b16421-d80b-4ef3-8f22-098b01a89255	891ac910-0096-4c25-ab16-c69cfaf956fe
63	63	0	GBIF Germany	4f6826f2-4ff6-443d-b966-e6913bd24013	89f3d9b6-f762-11e1-a439-00145eb45e9a
145	145	0	GBIF Germany	4f6826f2-4ff6-443d-b966-e6913bd24013	8a0f4dea-f762-11e1-a439-00145eb45e9a
0	1	1	Ocean Biodiversity Information System	ba0670b9-4186-41e6-8e70-f9cb3065551a	8bf23d60-afdf-47d7-b1be-d21d6ba1a3d9
80	68	-12	GBIF Germany	4f6826f2-4ff6-443d-b966-e6913bd24013	8cb7a9de-f762-11e1-a439-00145eb45e9a
272	272	0	Colombian Biodiversity Information System	7e865cba-7c46-417b-ade5-97f2cf5b7be0	8dc1f1ac-8d4f-4d5b-bbde-a5028143f37f
2934	2934	0	GBIF France	da44cd31-5901-4687-a106-6d1c7734ee3a	8e90b50e-3493-44a1-94c3-03fa8332f0e9
1647	1107	-540	GBIF Germany	4f6826f2-4ff6-443d-b966-e6913bd24013	8e9ab39a-f762-11e1-a439-00145eb45e9a
0	11	11	Plazi	ffb07bec-2d10-492d-9c37-361fe0b79427	8eb7fd40-5f23-4c11-9a20-3cb6c55260a8
6641	6641	0	National Biodiversity Network	d897a5b9-35ee-4232-94bd-b0bcaac003c2	8fe5e653-388a-4214-a224-4a4534c94b0a
0	2	2	Plazi	ffb07bec-2d10-492d-9c37-361fe0b79427	90f8cfa4-8adf-42e7-b8ca-4acf39b7fc81
1003	354	-649	GBIF Germany	4f6826f2-4ff6-443d-b966-e6913bd24013	91a629fc-f762-11e1-a439-00145eb45e9a
62	62	0	GBIF France	da44cd31-5901-4687-a106-6d1c7734ee3a	92722913-cb30-4229-85c5-598e0dc9de2c
12	12	0	GBIF Germany	4f6826f2-4ff6-443d-b966-e6913bd24013	9377fe22-f762-11e1-a439-00145eb45e9a
3673	3673	0	GBIF Benin	efb9c00e-f802-45dd-8826-a52ec45b89ff	94386f28-e94a-4e67-8012-b656c6007f2b
42428	42428	0	GBIF Finland	dd514216-5c7c-45f3-910d-797424cb5be6	95ed873a-f762-11e1-a439-00145eb45e9a
300	300	0	GBIF Japan	db5705aa-6a6e-42f1-8942-d77b9f4896ea	95f9b1b8-f762-11e1-a439-00145eb45e9a
6732	6733	1	GBIF Germany	4f6826f2-4ff6-443d-b966-e6913bd24013	9671680c-f762-11e1-a439-00145eb45e9a
50	50	0	GBIF Germany	4f6826f2-4ff6-443d-b966-e6913bd24013	97a6af02-f762-11e1-a439-00145eb45e9a
0	76	76	U.S. Geological Survey	8618c64a-93e0-4300-b546-7249e5148ed2	993875dd-5915-4107-8707-835d5a8d1022
0	3	3	Plazi	ffb07bec-2d10-492d-9c37-361fe0b79427	9d689439-3462-428f-b950-b0884e4189dd
846	264	-582	GBIF Germany	4f6826f2-4ff6-443d-b966-e6913bd24013	9f4d4817-79b9-4473-9d23-6241ff547e82
17	17	0	Plazi	ffb07bec-2d10-492d-9c37-361fe0b79427	a3ed5325-e71d-42d0-836b-738264a3fedc
2	2	0	Plazi	ffb07bec-2d10-492d-9c37-361fe0b79427	a501cc62-619a-4c9b-b350-58a3aada4240
8	8	0	Plazi	ffb07bec-2d10-492d-9c37-361fe0b79427	a5d17497-8053-43bb-ab87-15c78466231c
0	54258	54258	GBIF Switzerland	169eb292-376b-4cc6-8e31-9c2c432de0ad	a646efc3-8d52-421c-8253-e34f6e1bc8f5
1	1	0	Plazi	ffb07bec-2d10-492d-9c37-361fe0b79427	a768c0bd-a310-4391-95e2-e04acf5d25cc
3	3	0	Plazi	ffb07bec-2d10-492d-9c37-361fe0b79427	aade9a88-65f1-48d3-985f-43d4d4ace1a8
346	346	0	GBIF France	da44cd31-5901-4687-a106-6d1c7734ee3a	ad17a67b-059c-4985-994a-90bd03f42c02
786	786	0	U.S. Geological Survey	8618c64a-93e0-4300-b546-7249e5148ed2	b31d76f9-c6ff-4324-9984-c6bd8a1938c9
1	1	0	Plazi	ffb07bec-2d10-492d-9c37-361fe0b79427	b50dc923-c656-4a46-b935-7262e6006da4
2693	2693	0	GBIF France	da44cd31-5901-4687-a106-6d1c7734ee3a	bafd2234-f691-4259-9a5f-6679e7eb77be
0	2	2	Plazi	ffb07bec-2d10-492d-9c37-361fe0b79427	bb8e464b-ac20-4fd1-82e2-6d7ab69efa8e
0	21	21	Plazi	ffb07bec-2d10-492d-9c37-361fe0b79427	bd89417b-161a-4502-aa6b-17ac7e9ea2d1
2451	2451	0	Participant Node Managers Committee	7f48e0c8-5c96-49ec-b972-30748e339115	bffa8458-36d3-4580-b446-7ac281a4785f
0	639	639	Colombian Biodiversity Information System	7e865cba-7c46-417b-ade5-97f2cf5b7be0	c0b331e5-bed8-45eb-83ce-b2277ae4ee53
164	164	0	GBIF Argentina	2426a871-9feb-40a1-96c6-0c593a76b835	c137195c-6d34-4c1f-b2b4-a063833878b4
258	258	0	GBIF France	da44cd31-5901-4687-a106-6d1c7734ee3a	c3395502-78cb-49c7-b97a-d1f0f79458e7
207	207	0	GBIF Japan	db5705aa-6a6e-42f1-8942-d77b9f4896ea	c3f2d009-a95b-40dd-8f9b-bad1bc54e8e7
0	821	821	Ocean Biodiversity Information System	ba0670b9-4186-41e6-8e70-f9cb3065551a	c6c36ac0-9c3f-45c3-bc40-e60a594c66e3
841	841	0	Atlas of Living Australia	4a6f1b71-969e-4fc5-a693-282b05e1220c	cee9cad3-172b-475d-ab04-871c7617bbe8
0	3	3	Plazi	ffb07bec-2d10-492d-9c37-361fe0b79427	d02558bd-d286-4df3-afe4-dddb80e2d3cb
0	74	74	Plazi	ffb07bec-2d10-492d-9c37-361fe0b79427	d0309e8b-3179-4162-946c-08cef1c82013
17	17	0	Participant Node Managers Committee	7f48e0c8-5c96-49ec-b972-30748e339115	d284cc7f-32fd-4c5c-bee7-91fb8c44933c
75680	75680	0	National Biodiversity Network	d897a5b9-35ee-4232-94bd-b0bcaac003c2	d2a0dd22-9d39-4de2-99fb-5dde3ee3f49e
0	37	37	Ocean Biodiversity Information System	ba0670b9-4186-41e6-8e70-f9cb3065551a	d48234f0-5b23-4718-a462-f22a81f40b7c
0	113	113	Participant Node Managers Committee	7f48e0c8-5c96-49ec-b972-30748e339115	d94fe0c4-adb2-4ccd-afca-ede8a3ad99fd
0	5	5	Plazi	ffb07bec-2d10-492d-9c37-361fe0b79427	d9642ee7-5e4f-419d-b292-dca06da2a86e
708	708	0	GBIF France	da44cd31-5901-4687-a106-6d1c7734ee3a	d9adcc59-5362-43ec-ab95-8d8e1b4fdfa2
8363	8363	0	GBIF Argentina	2426a871-9feb-40a1-96c6-0c593a76b835	dba33190-d892-4d2f-8508-36f0fc72dc94
10	10	0	Plazi	ffb07bec-2d10-492d-9c37-361fe0b79427	dda6f3e2-723b-40b6-a098-75ac90b036c1
5	5	0	Plazi	ffb07bec-2d10-492d-9c37-361fe0b79427	dde4db22-fb4f-4e91-b752-106ccadf9f90
1465	1465	0	GBIF France	da44cd31-5901-4687-a106-6d1c7734ee3a	e083da34-ce15-4a7d-b716-1d98249c3463
0	77	77	GBIF Spain	1f94b3ca-9345-4d65-afe2-4bace93aa0fe	e0eddaac-2457-47aa-8529-abee3ffe80b2
1	1	0	Plazi	ffb07bec-2d10-492d-9c37-361fe0b79427	e1d69bec-cc4a-49aa-815e-e1e74f34f6b6
147	147	0	GBIF France	da44cd31-5901-4687-a106-6d1c7734ee3a	e715ce7a-9704-43fb-a1f1-e23b261e6681
1304	1565	261	GBIF Japan	db5705aa-6a6e-42f1-8942-d77b9f4896ea	e94feb1d-b4de-4c30-8625-81d6595b8adc
110383	112934	2551	GBIF Norway	4f829580-180d-46a9-9c87-ed8ec959b545	ead6339f-39f8-46be-b059-d1c48d88ab29
290	290	0	Participant Node Managers Committee	7f48e0c8-5c96-49ec-b972-30748e339115	ebd6b143-c5fb-4fbf-982a-64ce7dcf776b
100	100	0	National Biodiversity Network	d897a5b9-35ee-4232-94bd-b0bcaac003c2	ed3c599b-50c5-4d63-9efb-7fa528d46509
0	7	7	Plazi	ffb07bec-2d10-492d-9c37-361fe0b79427	f1ee9487-d843-4519-852d-e0d622e3d08a
13	13	0	Plazi	ffb07bec-2d10-492d-9c37-361fe0b79427	f453f8ca-4217-4d9a-8b80-55f14cda45f2
11	11	0	Plazi	ffb07bec-2d10-492d-9c37-361fe0b79427	f93577a4-5107-47fa-b8e6-48faca25769c
622	622	0	GBIF Germany	4f6826f2-4ff6-443d-b966-e6913bd24013	fc580dbc-72f6-4f33-854a-753dd7bff693
335974	335974	0	GBIF France	da44cd31-5901-4687-a106-6d1c7734ee3a	fe99edff-54d8-43b9-a25d-57964403efa6
0	33	33	Plazi	ffb07bec-2d10-492d-9c37-361fe0b79427	00a305af-5ea8-458d-9883-bd6a9d2a31e9
0	4	4	Plazi	ffb07bec-2d10-492d-9c37-361fe0b79427	017cf81c-0036-41a7-9a7f-e09bbfca2b87
0	8	8	Plazi	ffb07bec-2d10-492d-9c37-361fe0b79427	01fb3891-c404-481c-a247-fbc4863b0fbc
0	43	43	Plazi	ffb07bec-2d10-492d-9c37-361fe0b79427	031a30dc-d7b5-46e5-b578-dc35a57e0b92
644	644	0	National Biodiversity Network	d897a5b9-35ee-4232-94bd-b0bcaac003c2	03b1ca38-6225-406a-b2d6-ed47605802d1
1	1	0	Plazi	ffb07bec-2d10-492d-9c37-361fe0b79427	071dff7e-440b-4e39-afbb-f20dc14dd854
0	19	19	Plazi	ffb07bec-2d10-492d-9c37-361fe0b79427	073294fe-ca59-4793-b7d6-a554a7d72be6
0	482	482	Ocean Biodiversity Information System	ba0670b9-4186-41e6-8e70-f9cb3065551a	0745302b-927a-4384-8459-dc1a56720c67
1838	1838	0	Participant Node Managers Committee	7f48e0c8-5c96-49ec-b972-30748e339115	081b21bf-b603-4622-a7ce-afbcdb25ae5e
0	27	27	Colombian Biodiversity Information System	7e865cba-7c46-417b-ade5-97f2cf5b7be0	0da80eab-199d-46cc-aabf-6a0c70313dad
8410	8410	0	Colombian Biodiversity Information System	7e865cba-7c46-417b-ade5-97f2cf5b7be0	0fae5c5d-346e-4751-a18b-1247dbd69326
24	24	0	Colombian Biodiversity Information System	7e865cba-7c46-417b-ade5-97f2cf5b7be0	1091b3ef-e327-4672-9e0b-64e2636476c1
10	10	0	Plazi	ffb07bec-2d10-492d-9c37-361fe0b79427	13168a01-934a-488a-95c2-fe1c57a0f738
1	1	0	Plazi	ffb07bec-2d10-492d-9c37-361fe0b79427	16475c73-8c20-4574-9ba4-694f7a62b63b
5	5	0	GBIF France	da44cd31-5901-4687-a106-6d1c7734ee3a	16687824-8c32-411b-958e-af70930140df
534	430	-104	Biodiversity Information System of Mexico	b324e8e9-9a4c-44fa-8f1a-7f39ea7ab576	166cebbc-5ae3-41b2-ba2f-1ebd57c861fc
38	38	0	Plazi	ffb07bec-2d10-492d-9c37-361fe0b79427	16d8cd1d-548b-4eb4-aa3f-c4b9c221c3a5
463	463	0	Biodiversity Information System of Mexico	b324e8e9-9a4c-44fa-8f1a-7f39ea7ab576	1b831946-267a-4ae3-8925-3bf247fd19b0
0	33	33	Ocean Biodiversity Information System	ba0670b9-4186-41e6-8e70-f9cb3065551a	1c90f582-aaba-4fe7-b4d4-efec352d282c
8	8	0	Plazi	ffb07bec-2d10-492d-9c37-361fe0b79427	1f335cef-39f2-4f29-ae13-7259f5797801
0	16	16	Plazi	ffb07bec-2d10-492d-9c37-361fe0b79427	20881dc7-0b50-487c-a6f6-be75271045af
367	367	0	GBIF Brazil	cdc9736d-5ff7-4ece-9959-3c744360cdb3	20e7ce8d-ec4f-4de8-a6b1-c16134d0a5bf
0	4	4	Participant Node Managers Committee	7f48e0c8-5c96-49ec-b972-30748e339115	2305a5f6-111d-4a0a-b36a-9356d3b0fcdb
0	21	21	Plazi	ffb07bec-2d10-492d-9c37-361fe0b79427	285595da-2040-4347-9dbb-376ee63fba48
2	2	0	Plazi	ffb07bec-2d10-492d-9c37-361fe0b79427	293814ba-56d0-4829-b78c-6fcca9392ae8
3	3	0	Plazi	ffb07bec-2d10-492d-9c37-361fe0b79427	2c18f734-2095-48fa-b7ae-cb6c886ae56e
4	4	0	Plazi	ffb07bec-2d10-492d-9c37-361fe0b79427	2c768f76-ec73-4bf6-9e0f-914b346c7dac
252	252	0	Plazi	ffb07bec-2d10-492d-9c37-361fe0b79427	2da65c0a-9c48-43f5-ada3-e088de28dec1
3	3	0	Plazi	ffb07bec-2d10-492d-9c37-361fe0b79427	2ee3c954-03da-4e1b-8fde-66de4737b120
0	15	15	Plazi	ffb07bec-2d10-492d-9c37-361fe0b79427	2fd3fdaa-0982-414b-a25a-f103b25df325
246	246	0	Plazi	ffb07bec-2d10-492d-9c37-361fe0b79427	30786276-ef8a-4cf1-b6c7-1cf0c992b30a
0	19	19	Plazi	ffb07bec-2d10-492d-9c37-361fe0b79427	30c1a0f4-4d47-4cf0-bcfe-e4749d687b5e
1426	1426	0	GBIF Guinea	b1cd2e84-c4ba-47bd-b72a-dfd1f92dce0a	358fa28d-3344-4372-826b-2416f47f1118
4318	4318	0	GBIF Peru	46e3639a-27f8-45af-bfbe-d19b77efb040	365e1c3b-cbf4-49c4-a391-6b8a36bb7922
2489	2489	0	U.S. Geological Survey	8618c64a-93e0-4300-b546-7249e5148ed2	37da8155-b024-4312-9456-9f69d0873c4b
155	155	0	GBIF France	da44cd31-5901-4687-a106-6d1c7734ee3a	3bba0dca-3c66-42fc-9757-da16f431a72c
0	1	1	Plazi	ffb07bec-2d10-492d-9c37-361fe0b79427	3e2a118d-b3d0-46c1-bb3f-7613b8f1fb99
0	15	15	Plazi	ffb07bec-2d10-492d-9c37-361fe0b79427	3e79baaa-3ab0-4829-9ed9-2867ea361655
4	4	0	Plazi	ffb07bec-2d10-492d-9c37-361fe0b79427	43d2d964-7ece-4f81-be1c-169c0592de90
5	5	0	Plazi	ffb07bec-2d10-492d-9c37-361fe0b79427	44f06df2-9e8d-40d1-92fa-fe2af75207f9
2	2	0	Plazi	ffb07bec-2d10-492d-9c37-361fe0b79427	47329c10-5819-49cd-bcb2-3281c248379a
0	7665	7665	Colombian Biodiversity Information System	7e865cba-7c46-417b-ade5-97f2cf5b7be0	48bac4c3-5fcd-4cb5-915a-873594240ed7
625	625	0	GBIF Germany	4f6826f2-4ff6-443d-b966-e6913bd24013	49bb63bf-754d-4b68-8b27-6d9826c89c6a
877	877	0	GBIF France	da44cd31-5901-4687-a106-6d1c7734ee3a	49ff3f7f-732e-4d23-8af0-ba79ed8dacb5
1012	1012	0	Atlas of Living Australia	4a6f1b71-969e-4fc5-a693-282b05e1220c	4c7fac39-7664-43a9-a01d-6eac3305784e
0	1	1	Plazi	ffb07bec-2d10-492d-9c37-361fe0b79427	547a2201-b826-4c5d-a541-1139ad9ee6e7
308	308	0	Biodiversity Information System of Mexico	b324e8e9-9a4c-44fa-8f1a-7f39ea7ab576	5598b86d-a34c-4b6e-920b-6c02ba08e1c0
0	7099	7099	GBIF Japan	db5705aa-6a6e-42f1-8942-d77b9f4896ea	56a41ab3-c1ca-40d7-8c24-1625627affaa
0	7	7	Plazi	ffb07bec-2d10-492d-9c37-361fe0b79427	58e39d93-e6bd-47c1-a5db-a6ba6f2ce497
7	7	0	GBIF Germany	4f6826f2-4ff6-443d-b966-e6913bd24013	598f6d91-4f3b-4147-8b6d-e8d21142ed8f
0	2	2	Plazi	ffb07bec-2d10-492d-9c37-361fe0b79427	5a70597c-a0b3-4c05-85bb-1279a59cf7a1
12	12	0	Plazi	ffb07bec-2d10-492d-9c37-361fe0b79427	5b259853-01f6-4307-8bef-58c98ec73bd3
2	2	0	Plazi	ffb07bec-2d10-492d-9c37-361fe0b79427	5c15b6b5-6e7f-4123-aa5e-b1de4fae06b8
0	14892	14892	Ocean Biodiversity Information System	ba0670b9-4186-41e6-8e70-f9cb3065551a	5c17bd55-962e-4f38-8275-04170ce0a993
0	10	10	Plazi	ffb07bec-2d10-492d-9c37-361fe0b79427	5edc796d-8171-47cc-95d3-4a0b8fd89f53
11847	11847	0	GBIF Benin	efb9c00e-f802-45dd-8826-a52ec45b89ff	60954cb1-3b60-48e7-a2c1-75ffcb6d16cd
5	5	0	Plazi	ffb07bec-2d10-492d-9c37-361fe0b79427	60cf9eb6-409b-40db-a6e6-a0bfadeb06fa
36	36	0	GBIF Germany	4f6826f2-4ff6-443d-b966-e6913bd24013	62d75a2e-f762-11e1-a439-00145eb45e9a
1	1	0	Plazi	ffb07bec-2d10-492d-9c37-361fe0b79427	6338e42a-7f06-488f-9b33-25e4992b5deb
61	61	0	GBIF Germany	4f6826f2-4ff6-443d-b966-e6913bd24013	64c66bf4-f762-11e1-a439-00145eb45e9a
837	837	0	GBIF Benin	efb9c00e-f802-45dd-8826-a52ec45b89ff	64f61819-8901-4a8b-9f55-caaec13e3dec
232	232	0	GBIF Germany	4f6826f2-4ff6-443d-b966-e6913bd24013	653a4560-f762-11e1-a439-00145eb45e9a
206	199	-7	GBIF Germany	4f6826f2-4ff6-443d-b966-e6913bd24013	65f00562-f762-11e1-a439-00145eb45e9a
14	14	0	GBIF Germany	4f6826f2-4ff6-443d-b966-e6913bd24013	661cc2aa-f762-11e1-a439-00145eb45e9a
53	53	0	GBIF Germany	4f6826f2-4ff6-443d-b966-e6913bd24013	667df30e-f762-11e1-a439-00145eb45e9a
4	4	0	Plazi	ffb07bec-2d10-492d-9c37-361fe0b79427	67a3511a-6f76-4118-89bf-8a685cb21ac5
98	98	0	GBIF Germany	4f6826f2-4ff6-443d-b966-e6913bd24013	69c7dda4-f762-11e1-a439-00145eb45e9a
58	56	-2	GBIF Germany	4f6826f2-4ff6-443d-b966-e6913bd24013	6a3e93cc-f762-11e1-a439-00145eb45e9a
3	3	0	Plazi	ffb07bec-2d10-492d-9c37-361fe0b79427	6a80f0f2-2ce5-4c61-a1b6-ebc31d0ff811
15	15	0	GBIF Germany	4f6826f2-4ff6-443d-b966-e6913bd24013	6b2c3974-f762-11e1-a439-00145eb45e9a
24	24	0	GBIF Germany	4f6826f2-4ff6-443d-b966-e6913bd24013	6b80d5c4-f762-11e1-a439-00145eb45e9a
18	18	0	GBIF Germany	4f6826f2-4ff6-443d-b966-e6913bd24013	6b8cd6ee-f762-11e1-a439-00145eb45e9a
31	31	0	Participant Node Managers Committee	7f48e0c8-5c96-49ec-b972-30748e339115	6cb5f9f4-5d8f-4523-80ea-14c06f588b50
75	75	0	GBIF Germany	4f6826f2-4ff6-443d-b966-e6913bd24013	6d4fa72c-f762-11e1-a439-00145eb45e9a
2	2	0	Plazi	ffb07bec-2d10-492d-9c37-361fe0b79427	6e80279e-4853-4c39-8ff2-f59c18084052
149	149	0	GBIF Germany	4f6826f2-4ff6-443d-b966-e6913bd24013	719b6474-f762-11e1-a439-00145eb45e9a
7139	7139	0	Atlas of Living Australia	4a6f1b71-969e-4fc5-a693-282b05e1220c	71d20bc8-f762-11e1-a439-00145eb45e9a
3415	3415	0	GBIF Japan	db5705aa-6a6e-42f1-8942-d77b9f4896ea	71e10380-f762-11e1-a439-00145eb45e9a
0	3	3	Plazi	ffb07bec-2d10-492d-9c37-361fe0b79427	71f0b51e-9437-4b21-9e8c-8dfef3442df0
366	366	0	GBIF Germany	4f6826f2-4ff6-443d-b966-e6913bd24013	73dd3c6c-f762-11e1-a439-00145eb45e9a
448	448	0	GBIF Germany	4f6826f2-4ff6-443d-b966-e6913bd24013	74b2a672-f762-11e1-a439-00145eb45e9a
312	312	0	GBIF Germany	4f6826f2-4ff6-443d-b966-e6913bd24013	75312542-f762-11e1-a439-00145eb45e9a
0	2	2	Plazi	ffb07bec-2d10-492d-9c37-361fe0b79427	786e641d-25ba-42e0-a57e-74ab944674ed
18	18	0	GBIF Germany	4f6826f2-4ff6-443d-b966-e6913bd24013	78a4821e-f762-11e1-a439-00145eb45e9a
35	35	0	GBIF Germany	4f6826f2-4ff6-443d-b966-e6913bd24013	7aa8e442-f762-11e1-a439-00145eb45e9a
4646	4646	0	Korean Biodiversity Information Facility	e0a1e772-0177-4800-94b4-2d023fe6cdf4	7af03d38-f762-11e1-a439-00145eb45e9a
60	60	0	Ocean Biodiversity Information System	ba0670b9-4186-41e6-8e70-f9cb3065551a	7b0b3928-76bd-4b4b-b11b-c5f858e294d8
1000	1000	0	Korean Biodiversity Information Facility	e0a1e772-0177-4800-94b4-2d023fe6cdf4	7b243d90-f762-11e1-a439-00145eb45e9a
1019	1019	0	Ocean Biodiversity Information System	ba0670b9-4186-41e6-8e70-f9cb3065551a	7b474f9c-f762-11e1-a439-00145eb45e9a
208	195	-13	GBIF Germany	4f6826f2-4ff6-443d-b966-e6913bd24013	7c47a978-f762-11e1-a439-00145eb45e9a
192	192	0	GBIF Germany	4f6826f2-4ff6-443d-b966-e6913bd24013	7c9669d2-f762-11e1-a439-00145eb45e9a
66	66	0	GBIF Germany	4f6826f2-4ff6-443d-b966-e6913bd24013	7c990156-f762-11e1-a439-00145eb45e9a
62	62	0	GBIF Germany	4f6826f2-4ff6-443d-b966-e6913bd24013	7cff9038-f762-11e1-a439-00145eb45e9a
75	75	0	GBIF Germany	4f6826f2-4ff6-443d-b966-e6913bd24013	7d1133ce-1387-11e2-bb2e-00145eb45e9a
2617	2535	-82	GBIF Germany	4f6826f2-4ff6-443d-b966-e6913bd24013	7d15cc40-f762-11e1-a439-00145eb45e9a
638	406	-232	GBIF Germany	4f6826f2-4ff6-443d-b966-e6913bd24013	7d9ed9ae-f762-11e1-a439-00145eb45e9a
3247	3246	-1	Biodiversity Information System of Mexico	b324e8e9-9a4c-44fa-8f1a-7f39ea7ab576	7fdb69da-f762-11e1-a439-00145eb45e9a
735	735	0	Biodiversity Information System of Mexico	b324e8e9-9a4c-44fa-8f1a-7f39ea7ab576	805f5024-f762-11e1-a439-00145eb45e9a
0	5	5	Plazi	ffb07bec-2d10-492d-9c37-361fe0b79427	80bc671c-4991-4e13-a555-9de553e59eb0
1555	1555	0	GBIF Germany	4f6826f2-4ff6-443d-b966-e6913bd24013	81b3deb8-f762-11e1-a439-00145eb45e9a
248	248	0	Atlas of Living Australia	4a6f1b71-969e-4fc5-a693-282b05e1220c	82e8ff34-f762-11e1-a439-00145eb45e9a
0	101	101	Ocean Biodiversity Information System	ba0670b9-4186-41e6-8e70-f9cb3065551a	83186c73-57e4-4718-b1fc-7ca7285dbdd0
69397	73062	3665	GBIF Spain	1f94b3ca-9345-4d65-afe2-4bace93aa0fe	837acfc2-f762-11e1-a439-00145eb45e9a
5791	5791	0	National Biodiversity Network	d897a5b9-35ee-4232-94bd-b0bcaac003c2	83f4fae5-66e6-4214-b09e-9c1b8ab633ff
0	26	26	Plazi	ffb07bec-2d10-492d-9c37-361fe0b79427	85bcec37-1fe9-43af-b850-6b5bf4d90375
0	6	6	Plazi	ffb07bec-2d10-492d-9c37-361fe0b79427	8679cc28-c25c-442f-a18c-76dc15c78b0f
9774	7707	-2067	GBIF Germany	4f6826f2-4ff6-443d-b966-e6913bd24013	86c600ca-f762-11e1-a439-00145eb45e9a
239	239	0	Colombian Biodiversity Information System	7e865cba-7c46-417b-ade5-97f2cf5b7be0	8797a31d-1d10-425f-8e95-c83ffc1a9e77
787	787	0	GBIF France	da44cd31-5901-4687-a106-6d1c7734ee3a	88b6877b-bf98-4c23-8094-dca66a0130d4
13596	13596	0	GBIF Norway	4f829580-180d-46a9-9c87-ed8ec959b545	88fd0226-d867-4946-be8b-31f584f2201d
112	84	-28	GBIF Germany	4f6826f2-4ff6-443d-b966-e6913bd24013	8960c112-f762-11e1-a439-00145eb45e9a
147	147	0	GBIF Germany	4f6826f2-4ff6-443d-b966-e6913bd24013	89f2871e-f762-11e1-a439-00145eb45e9a
0	41	41	Plazi	ffb07bec-2d10-492d-9c37-361fe0b79427	8acc9095-eaff-47d7-b3da-91b6c2fb636e
4	4	0	GBIF Germany	4f6826f2-4ff6-443d-b966-e6913bd24013	8bac391a-f762-11e1-a439-00145eb45e9a
193	193	0	GBIF Germany	4f6826f2-4ff6-443d-b966-e6913bd24013	8c2cb482-f762-11e1-a439-00145eb45e9a
4	4	0	GBIF Germany	4f6826f2-4ff6-443d-b966-e6913bd24013	8c40e25e-f762-11e1-a439-00145eb45e9a
183438	183438	0	GBIF New Zealand	4f9fd726-20dd-445e-89a1-8ed93792276f	8c535464-4c81-4417-a032-1d817fb352ae
1	1	0	GBIF Germany	4f6826f2-4ff6-443d-b966-e6913bd24013	8ca50c84-f762-11e1-a439-00145eb45e9a
38	20	-18	GBIF Germany	4f6826f2-4ff6-443d-b966-e6913bd24013	8d5ad3c0-f762-11e1-a439-00145eb45e9a
441	234	-207	GBIF Germany	4f6826f2-4ff6-443d-b966-e6913bd24013	8de9896c-f762-11e1-a439-00145eb45e9a
1447	966	-481	GBIF Germany	4f6826f2-4ff6-443d-b966-e6913bd24013	8e57b464-f762-11e1-a439-00145eb45e9a
1	1	0	GBIF Germany	4f6826f2-4ff6-443d-b966-e6913bd24013	8ee41710-f762-11e1-a439-00145eb45e9a
105	58	-47	GBIF Germany	4f6826f2-4ff6-443d-b966-e6913bd24013	8f129cc0-f762-11e1-a439-00145eb45e9a
3	2	-1	GBIF Germany	4f6826f2-4ff6-443d-b966-e6913bd24013	90d1ae2a-f762-11e1-a439-00145eb45e9a
0	24288	24288	GBIF Estonia	2c11b821-d22b-4c64-8cd3-c1578173b129	91afc73f-a11a-4e8b-9313-ed056697cf05
59	59	0	GBIF Germany	4f6826f2-4ff6-443d-b966-e6913bd24013	92003a5a-f762-11e1-a439-00145eb45e9a
0	804	804	Ocean Biodiversity Information System	ba0670b9-4186-41e6-8e70-f9cb3065551a	933eeab0-5f75-4bd3-be88-e4e6e07eabd6
39263	39263	0	U.S. Geological Survey	8618c64a-93e0-4300-b546-7249e5148ed2	93c707dc-4708-47fc-93d8-424702116442
22	22	0	National Biodiversity Network	d897a5b9-35ee-4232-94bd-b0bcaac003c2	94db69d0-b188-4068-829e-ce96d115ea13
0	2268	2268	Ocean Biodiversity Information System	ba0670b9-4186-41e6-8e70-f9cb3065551a	95e46400-f949-42e3-b257-4c1915cd4a85
3	3	0	Plazi	ffb07bec-2d10-492d-9c37-361fe0b79427	9605fa27-9455-4e7a-a88e-c2cfc6d5ed7f
209	209	0	GBIF Germany	4f6826f2-4ff6-443d-b966-e6913bd24013	97555878-f762-11e1-a439-00145eb45e9a
10	10	0	GBIF Germany	4f6826f2-4ff6-443d-b966-e6913bd24013	97a95c70-f762-11e1-a439-00145eb45e9a
239	239	0	GBIF Germany	4f6826f2-4ff6-443d-b966-e6913bd24013	97bf357c-f762-11e1-a439-00145eb45e9a
0	8	8	Plazi	ffb07bec-2d10-492d-9c37-361fe0b79427	98f82204-695b-437b-95b3-c063bbb6d03b
2	2	0	Plazi	ffb07bec-2d10-492d-9c37-361fe0b79427	9a794bd4-b2b3-469e-8469-3ecf5346294f
205	205	0	Korean Biodiversity Information Facility	e0a1e772-0177-4800-94b4-2d023fe6cdf4	9b407cb8-27fc-11e2-85e3-00145eb45e9a
249	249	0	Polish Biodiversity Information Network	2618bfdf-e194-4911-a241-80db3107bc51	9c4aa300-13e1-11de-b2e1-b8a03c50a862
14	14	0	Plazi	ffb07bec-2d10-492d-9c37-361fe0b79427	a1370a31-7951-434f-bed5-19b198c4e107
0	115	115	Participant Node Managers Committee	7f48e0c8-5c96-49ec-b972-30748e339115	a1e3d691-c4d9-4fdd-a52c-d6f377f57769
4	4	0	Plazi	ffb07bec-2d10-492d-9c37-361fe0b79427	a25be38c-9537-4878-8526-be65619f8e91
7	7	0	Plazi	ffb07bec-2d10-492d-9c37-361fe0b79427	a5c53b3d-2f01-4805-8cb0-2c788edc9737
56	56	0	Plazi	ffb07bec-2d10-492d-9c37-361fe0b79427	a8dbace4-1fba-463b-83b1-30929555b4bb
0	3	3	Plazi	ffb07bec-2d10-492d-9c37-361fe0b79427	a94a502d-d301-4b1f-bc9e-4494405eaa96
86	86	0	GBIF France	da44cd31-5901-4687-a106-6d1c7734ee3a	aa537d35-f947-4a4c-9c6a-3b86a9c8d3d6
46509	60221	13712	National Biodiversity Network	d897a5b9-35ee-4232-94bd-b0bcaac003c2	aa734892-b053-4ac2-9b3e-243c347ae481
18	18	0	Plazi	ffb07bec-2d10-492d-9c37-361fe0b79427	aafea428-4239-4eca-9bce-db46f1b1cd21
2	2	0	Plazi	ffb07bec-2d10-492d-9c37-361fe0b79427	ab0a9802-739c-40b2-b5af-5d41f42f5619
5194	5194	0	Netherlands Biodiversity Information Facility	0909d601-bda2-42df-9e63-a6d51847ebce	ab0b73e0-c064-11dd-a311-b8a03c50a862
20	20	0	Plazi	ffb07bec-2d10-492d-9c37-361fe0b79427	b00eef29-7f63-490c-adcc-c255c58de342
6255	6255	0	Biodiversity Information System of Mexico	b324e8e9-9a4c-44fa-8f1a-7f39ea7ab576	b0e3d03c-3f19-4ab7-b153-7d831d0b3727
0	7	7	Plazi	ffb07bec-2d10-492d-9c37-361fe0b79427	b315551e-6683-4c2b-ab68-8913e9d70131
1	1	0	Plazi	ffb07bec-2d10-492d-9c37-361fe0b79427	b3a38693-12da-40cc-97e6-0b182dc54c59
22	22	0	Plazi	ffb07bec-2d10-492d-9c37-361fe0b79427	b67fd890-6b70-4f56-8ac2-ffebe4c6f072
160	160	0	Colombian Biodiversity Information System	7e865cba-7c46-417b-ade5-97f2cf5b7be0	b764dc56-8fb4-499b-a4a9-d501c6489c78
0	1322	1322	Ocean Biodiversity Information System	ba0670b9-4186-41e6-8e70-f9cb3065551a	b92486f8-0d01-450a-bb6c-699d10c92a72
29	29	0	Plazi	ffb07bec-2d10-492d-9c37-361fe0b79427	bbf28781-8db4-49fd-accf-d06bf79ad976
193	193	0	GBIF Spain	1f94b3ca-9345-4d65-afe2-4bace93aa0fe	bc361eb3-7d2b-4180-9047-58ff3d80bf6b
29482	29482	0	National Biodiversity Network	d897a5b9-35ee-4232-94bd-b0bcaac003c2	be8970d8-8e56-4ba7-b09c-70e78457f465
1	1	0	Plazi	ffb07bec-2d10-492d-9c37-361fe0b79427	c04698fa-bd1c-4a8a-a388-cf2800b9fa0d
1101	1101	0	Belgian Biodiversity Platform	fb11cfe1-ebc3-45af-9159-17d9fddbcdac	c9b2b2ff-6596-4162-aac2-9a39a45c4e8d
788	788	0	Plazi	ffb07bec-2d10-492d-9c37-361fe0b79427	cad3930d-1dea-4aa6-92e2-80e38a71a4ce
724	724	0	GBIF France	da44cd31-5901-4687-a106-6d1c7734ee3a	cb114e1e-f9aa-4f0a-816d-3af7ca63bb7d
0	208	208	National Biodiversity Network	d897a5b9-35ee-4232-94bd-b0bcaac003c2	cc9ae2eb-b6e9-4a4e-80ec-13c21e49963f
180	180	0	Colombian Biodiversity Information System	7e865cba-7c46-417b-ade5-97f2cf5b7be0	ce27b20a-ae25-4bb6-a036-2394a5bd2330
126	126	0	GBIF Argentina	2426a871-9feb-40a1-96c6-0c593a76b835	d2f461a2-fddf-4a06-bb8e-f61ddbf045b2
4	4	0	Plazi	ffb07bec-2d10-492d-9c37-361fe0b79427	d2f7c247-c552-48ae-b4f5-9af4674786bb
193	193	0	GBIF France	da44cd31-5901-4687-a106-6d1c7734ee3a	d321f020-7d00-4ab5-a880-5cdca72320d5
0	2	2	Plazi	ffb07bec-2d10-492d-9c37-361fe0b79427	d5160a0e-64cf-4431-bedb-89e429fb6437
16	16	0	GBIF Togo	c9659a3e-07e9-4fcb-83c6-de8b9009a02e	d5bf428b-9a1a-48e1-93ce-9783eefa3484
17814	17814	0	National Biodiversity Network	d897a5b9-35ee-4232-94bd-b0bcaac003c2	d7d02fe4-7199-41ad-88e0-bb1351b73934
0	7735	7735	National Biodiversity Network	d897a5b9-35ee-4232-94bd-b0bcaac003c2	d96a84de-dba2-4134-b911-4556074f15e6
39	39	0	Plazi	ffb07bec-2d10-492d-9c37-361fe0b79427	db9f4a85-0168-4ef9-a25b-1137474e86e8
101	101	0	GBIF France	da44cd31-5901-4687-a106-6d1c7734ee3a	e0e8de00-ce4c-4776-8f6c-f6892ceb43ab
0	59	59	Ocean Biodiversity Information System	ba0670b9-4186-41e6-8e70-f9cb3065551a	e2ee4b2a-0ec0-41e2-a028-1063cf2a6cde
0	8066	8066	Ocean Biodiversity Information System	ba0670b9-4186-41e6-8e70-f9cb3065551a	e5d462f6-054a-4c6d-a9c2-568e275a5f05
829	1249	420	Colombian Biodiversity Information System	7e865cba-7c46-417b-ade5-97f2cf5b7be0	e77cff6f-d496-4775-8c9d-6f784faaf6e5
1165	1165	0	GBIF Brazil	cdc9736d-5ff7-4ece-9959-3c744360cdb3	e817b460-2982-4f41-be69-413b94228ced
0	101715	101715	GBIF Sweden	a0b3be64-6525-4387-ac67-a499950f92e1	eca0f10b-998a-4450-85c0-d2fae635000a
17	17	0	Plazi	ffb07bec-2d10-492d-9c37-361fe0b79427	edb887df-0e4c-4d20-b473-c0aae362a934
0	12	12	Plazi	ffb07bec-2d10-492d-9c37-361fe0b79427	ef8f6cbf-7d89-494a-bab5-fcb4047213ba
0	5	5	Plazi	ffb07bec-2d10-492d-9c37-361fe0b79427	f24a08b6-a24f-4c08-81e5-ae40f68bacd6
112	112	0	Colombian Biodiversity Information System	7e865cba-7c46-417b-ade5-97f2cf5b7be0	f273f6f6-5b88-4110-bd13-6996014e1e34
0	38	38	Plazi	ffb07bec-2d10-492d-9c37-361fe0b79427	f41f8119-ddaf-4071-9d37-6ddde2a47b17
36	36	0	Plazi	ffb07bec-2d10-492d-9c37-361fe0b79427	f9d0e547-ce5a-4814-be05-19540309c2df
1894	1894	0	National Biodiversity Network	d897a5b9-35ee-4232-94bd-b0bcaac003c2	f9e93ed8-8222-488c-b44b-377c06c6ecff
2723	2723	0	Biodiversity Information System of Mexico	b324e8e9-9a4c-44fa-8f1a-7f39ea7ab576	fb9f524e-b0e4-432f-82b1-6af2db6bef2f
33	33	0	Plazi	ffb07bec-2d10-492d-9c37-361fe0b79427	fc2f680d-ef06-4ba7-85aa-2af25b26b6c6
319	319	0	GBIF Germany	4f6826f2-4ff6-443d-b966-e6913bd24013	fd09da8d-9f58-42f6-be04-60ebbcd035ef
1	1	0	GBIF France	da44cd31-5901-4687-a106-6d1c7734ee3a	fd4fbc66-9655-4535-8f8b-1a08ec73ca33
2	2	0	Plazi	ffb07bec-2d10-492d-9c37-361fe0b79427	fd9dc514-4fd8-46f2-99fb-de4719a7314c
127	127	0	Plazi	ffb07bec-2d10-492d-9c37-361fe0b79427	ffaf3b73-8bfe-499d-9073-0ce8c104e078
137	137	0	GBIF France	da44cd31-5901-4687-a106-6d1c7734ee3a	0083ef0e-c2c2-4530-bc2a-4cd901205935
1960	1960	0	GBIF Germany	4f6826f2-4ff6-443d-b966-e6913bd24013	010f80df-206e-48ff-a7c4-af50a604e7d1
7735	7735	0	U.S. Geological Survey	8618c64a-93e0-4300-b546-7249e5148ed2	08dc18e5-e3c0-4f74-b49a-b8274aabe020
66	66	0	GBIF France	da44cd31-5901-4687-a106-6d1c7734ee3a	0940ec12-d77c-4af2-80d4-f624fb7c78da
1500	1500	0	Participant Node Managers Committee	7f48e0c8-5c96-49ec-b972-30748e339115	0a1b70f1-ea1e-405d-aa4e-4142888bd8d3
0	520	520	Ocean Biodiversity Information System	ba0670b9-4186-41e6-8e70-f9cb3065551a	0ad1d61a-49ad-46a0-8b9f-6fc3f6d6af1d
0	42	42	Plazi	ffb07bec-2d10-492d-9c37-361fe0b79427	0c820dc3-bd71-4eba-902e-59bd37283060
631	631	0	National Biodiversity Network	d897a5b9-35ee-4232-94bd-b0bcaac003c2	0d5243a0-cd0c-4b2d-ba1c-eaaf9006580e
4009	7009	3000	GBIF Japan	db5705aa-6a6e-42f1-8942-d77b9f4896ea	0ddec24e-35c6-4669-b783-75052199bdb7
3682	3682	0	Indonesian Biodiversity Information Facility	2ebd91f6-f14f-4375-b525-c011a3774f03	10f8ba9a-e298-4256-88b0-997205d66a30
2965	2965	0	GBIF Germany	4f6826f2-4ff6-443d-b966-e6913bd24013	11be4bf9-2504-48c7-9880-46ca729a4abc
0	279	279	Ocean Biodiversity Information System	ba0670b9-4186-41e6-8e70-f9cb3065551a	11eadc9d-5e20-422d-add3-3238d0c82f8a
5	5	0	Plazi	ffb07bec-2d10-492d-9c37-361fe0b79427	12141a60-1ea5-430f-b4c2-e105fb314388
0	150	150	Ocean Biodiversity Information System	ba0670b9-4186-41e6-8e70-f9cb3065551a	12495db0-7564-4a7c-bce2-2501efe4fc21
1522453	1621449	98996	National Biodiversity Network	d897a5b9-35ee-4232-94bd-b0bcaac003c2	1270b3c8-ff55-4b63-a407-dcd7e08cd23f
28	28	0	Plazi	ffb07bec-2d10-492d-9c37-361fe0b79427	14d62a66-617b-4fa4-aab2-83b42280fbd0
0	5	5	Plazi	ffb07bec-2d10-492d-9c37-361fe0b79427	18c536db-6020-42c6-ba39-48be66b42f3d
9	9	0	Plazi	ffb07bec-2d10-492d-9c37-361fe0b79427	1929e035-f3a3-45ba-9178-5dbd7f892446
2559	1199	-1360	GBIF Germany	4f6826f2-4ff6-443d-b966-e6913bd24013	1cf7c55e-0258-44fe-a556-b8b010f7b0ac
7170466	8169589	999123	National Biodiversity Network	d897a5b9-35ee-4232-94bd-b0bcaac003c2	1e266c3d-92ef-4d5a-8e4a-c04742c772c3
2579	2579	0	GBIF Chile	a8b16421-d80b-4ef3-8f22-098b01a89255	204130fb-8924-4601-b015-69411d9d7917
24599	24599	0	Canada Biodiversity Information Facility	8f83fc96-c966-4126-83f7-bf044dc49efa	21705170-d2b6-42de-8904-c3bca4b83591
46	46	0	Plazi	ffb07bec-2d10-492d-9c37-361fe0b79427	269321d2-8c60-4be5-b879-b516f39f62b9
0	429	429	DanBIF - Danish Biodiversity Information Facility	4ddd294f-02b7-4359-ac33-0806a9ca9c6b	273aec31-8e0f-4914-9fe5-ac2a76967d15
0	37	37	Plazi	ffb07bec-2d10-492d-9c37-361fe0b79427	2a6a68b5-abec-4b2f-87b8-91cc5e0f1e78
0	2	2	Ocean Biodiversity Information System	ba0670b9-4186-41e6-8e70-f9cb3065551a	2ddc4107-1430-4f93-953e-14756a38997c
0	12	12	Plazi	ffb07bec-2d10-492d-9c37-361fe0b79427	30721ca2-2400-428e-8068-3d1492e508aa
2	2	0	Plazi	ffb07bec-2d10-492d-9c37-361fe0b79427	35336a37-ad0d-402e-9029-3a62cd77bbff
3	3	0	Plazi	ffb07bec-2d10-492d-9c37-361fe0b79427	3a15e48e-ef22-4145-815c-21dca6f582ef
830	830	0	Biodiversity Information System of Mexico	b324e8e9-9a4c-44fa-8f1a-7f39ea7ab576	3b80b136-9181-46e5-a02b-92ed8985ba19
87143	87143	0	National Biodiversity Network	d897a5b9-35ee-4232-94bd-b0bcaac003c2	3bd7b984-6bbd-4194-95aa-114271d9ee68
0	60	60	Plazi	ffb07bec-2d10-492d-9c37-361fe0b79427	3fd96652-6dfe-48e1-820b-d27937520970
1229	1229	0	Biodiversity Information System of Mexico	b324e8e9-9a4c-44fa-8f1a-7f39ea7ab576	41164149-50d6-4681-91a8-60ca52497266
0	4	4	Plazi	ffb07bec-2d10-492d-9c37-361fe0b79427	42471919-3776-4eed-bb8b-a543dafa8557
1268	1268	0	GBIF Japan	db5705aa-6a6e-42f1-8942-d77b9f4896ea	43122b21-1230-49a9-9af8-4df4df950ecb
0	56	56	Ocean Biodiversity Information System	ba0670b9-4186-41e6-8e70-f9cb3065551a	45051205-debd-49ee-a797-fbd7e24ddb78
425	425	0	GBIF Germany	4f6826f2-4ff6-443d-b966-e6913bd24013	45fc35aa-2b02-4c1f-bde3-8f7368c7c0d2
0	401	401	Plazi	ffb07bec-2d10-492d-9c37-361fe0b79427	47bc051d-f837-48ea-b9da-83558ea1af75
2248	2248	0	National Biodiversity Network	d897a5b9-35ee-4232-94bd-b0bcaac003c2	480dcd04-6382-4f68-af59-5bb05747802c
2	2	0	Plazi	ffb07bec-2d10-492d-9c37-361fe0b79427	481fc51c-1277-4486-b6e2-97c838ce7cac
47	47	0	Plazi	ffb07bec-2d10-492d-9c37-361fe0b79427	4ba9c308-cd35-450c-a20d-19ee31d92e89
80	80	0	Plazi	ffb07bec-2d10-492d-9c37-361fe0b79427	4f13056b-fc90-4155-8790-809061971ace
4	4	0	Plazi	ffb07bec-2d10-492d-9c37-361fe0b79427	4f16c194-d6c7-4e57-bb9c-60673b0af410
798	798	0	National Biodiversity Network	d897a5b9-35ee-4232-94bd-b0bcaac003c2	4fbb2379-db6d-46bd-8f0b-4972cb76b188
23	23	0	GBIF Spain	1f94b3ca-9345-4d65-afe2-4bace93aa0fe	517a8673-1d7a-4017-a5ea-f62e3c210d7f
19	19	0	Plazi	ffb07bec-2d10-492d-9c37-361fe0b79427	52b1dca0-622d-4819-b077-e2f5e34ab8c4
251	184	-67	GBIF Germany	4f6826f2-4ff6-443d-b966-e6913bd24013	52fc5004-0d8f-4e6f-8d31-48345f9fa424
126	126	0	Plazi	ffb07bec-2d10-492d-9c37-361fe0b79427	5389c04e-b6b1-43ea-978b-f95aedcc9e0d
837	837	0	U.S. Geological Survey	8618c64a-93e0-4300-b546-7249e5148ed2	57b44b1c-d9c9-40fb-89db-04f30f091f88
0	10	10	Plazi	ffb07bec-2d10-492d-9c37-361fe0b79427	58925d20-ec99-46ae-bd43-80c4e7318bbf
2783	2783	0	Atlas of Living Australia	4a6f1b71-969e-4fc5-a693-282b05e1220c	592d585d-6186-4093-8375-77ad80da7c9a
58	58	0	GBIF France	da44cd31-5901-4687-a106-6d1c7734ee3a	5ab478ee-9619-40a8-bbbc-59c34aa09cfe
0	43	43	Ocean Biodiversity Information System	ba0670b9-4186-41e6-8e70-f9cb3065551a	5cafe349-5ce2-4511-888c-d19a4c588eae
9446	9446	0	National Biodiversity Network	d897a5b9-35ee-4232-94bd-b0bcaac003c2	5d030f0a-968a-43dd-8a94-931702f56f57
25	25	0	Plazi	ffb07bec-2d10-492d-9c37-361fe0b79427	5d4045c8-2c5a-4f75-8ca7-a2401ed0d227
59	59	0	GBIF France	da44cd31-5901-4687-a106-6d1c7734ee3a	5fa7b1f1-c371-4e7f-a771-b4cc81c94d28
11	11	0	Plazi	ffb07bec-2d10-492d-9c37-361fe0b79427	6109d429-ee5b-4857-9b13-a580bbf39fce
34	34	0	GBIF Germany	4f6826f2-4ff6-443d-b966-e6913bd24013	61447af2-f762-11e1-a439-00145eb45e9a
0	67	67	Ocean Biodiversity Information System	ba0670b9-4186-41e6-8e70-f9cb3065551a	61db9ecf-83c7-4733-ac5d-1e42bc7d663f
64	64	0	GBIF Germany	4f6826f2-4ff6-443d-b966-e6913bd24013	62af133e-f762-11e1-a439-00145eb45e9a
1	1	0	GBIF Germany	4f6826f2-4ff6-443d-b966-e6913bd24013	634feb60-f762-11e1-a439-00145eb45e9a
334	326	-8	GBIF Germany	4f6826f2-4ff6-443d-b966-e6913bd24013	65ea117a-f762-11e1-a439-00145eb45e9a
130	130	0	GBIF Germany	4f6826f2-4ff6-443d-b966-e6913bd24013	6661dee4-f762-11e1-a439-00145eb45e9a
72	72	0	GBIF Germany	4f6826f2-4ff6-443d-b966-e6913bd24013	66c8b826-f762-11e1-a439-00145eb45e9a
133	133	0	GBIF Germany	4f6826f2-4ff6-443d-b966-e6913bd24013	673018a4-f762-11e1-a439-00145eb45e9a
0	10	10	Plazi	ffb07bec-2d10-492d-9c37-361fe0b79427	67302988-0889-4717-a9b9-52ca0cd5fa81
142	142	0	GBIF Germany	4f6826f2-4ff6-443d-b966-e6913bd24013	6846a2bc-f762-11e1-a439-00145eb45e9a
79	79	0	GBIF Germany	4f6826f2-4ff6-443d-b966-e6913bd24013	68553e08-f762-11e1-a439-00145eb45e9a
30	30	0	GBIF Germany	4f6826f2-4ff6-443d-b966-e6913bd24013	68f9e142-f762-11e1-a439-00145eb45e9a
284	284	0	GBIF France	da44cd31-5901-4687-a106-6d1c7734ee3a	69133ff2-d6bf-4a2b-9a61-065f0f374168
201	201	0	GBIF Germany	4f6826f2-4ff6-443d-b966-e6913bd24013	69523b76-f762-11e1-a439-00145eb45e9a
98	98	0	GBIF Germany	4f6826f2-4ff6-443d-b966-e6913bd24013	69c1f92a-f762-11e1-a439-00145eb45e9a
16	16	0	Plazi	ffb07bec-2d10-492d-9c37-361fe0b79427	69c434f8-762e-4e43-bc29-d0da90994625
29	15	-14	GBIF Germany	4f6826f2-4ff6-443d-b966-e6913bd24013	6a00470c-f762-11e1-a439-00145eb45e9a
486	486	0	GBIF France	da44cd31-5901-4687-a106-6d1c7734ee3a	6a700c75-5679-4924-86a0-9c144377368f
919062	919062	0	National Biodiversity Network	d897a5b9-35ee-4232-94bd-b0bcaac003c2	6aa62933-35d4-4e74-af93-0fbc49655547
38	38	0	GBIF Germany	4f6826f2-4ff6-443d-b966-e6913bd24013	6aa68176-f762-11e1-a439-00145eb45e9a
11	11	0	Plazi	ffb07bec-2d10-492d-9c37-361fe0b79427	6c299d03-ac2c-45de-add8-c07f618d7a48
56	56	0	GBIF Germany	4f6826f2-4ff6-443d-b966-e6913bd24013	6cbc49a0-f762-11e1-a439-00145eb45e9a
51	51	0	GBIF Germany	4f6826f2-4ff6-443d-b966-e6913bd24013	6cc8e11a-f762-11e1-a439-00145eb45e9a
0	1	1	Plazi	ffb07bec-2d10-492d-9c37-361fe0b79427	6cf70992-83b3-457f-ae0b-4ad3d42e4cca
0	39	39	Ocean Biodiversity Information System	ba0670b9-4186-41e6-8e70-f9cb3065551a	6d360d24-436a-4752-a58d-39f5202c21a6
2982	2982	0	GBIF Germany	4f6826f2-4ff6-443d-b966-e6913bd24013	6d767848-f762-11e1-a439-00145eb45e9a
0	490	490	Colombian Biodiversity Information System	7e865cba-7c46-417b-ade5-97f2cf5b7be0	6f0491ff-4998-4eaf-92e1-cf402bfa1ec2
10	10	0	GBIF Germany	4f6826f2-4ff6-443d-b966-e6913bd24013	6fcf52b8-f762-11e1-a439-00145eb45e9a
224	224	0	GBIF Brazil	cdc9736d-5ff7-4ece-9959-3c744360cdb3	712ddbee-b0ae-438d-b477-e1c79063061e
77	77	0	Plazi	ffb07bec-2d10-492d-9c37-361fe0b79427	714c988e-9abd-4ba0-b0f2-27508e713840
3	3	0	Plazi	ffb07bec-2d10-492d-9c37-361fe0b79427	7194c16f-4e85-43de-810d-e64804bcc389
150	150	0	GBIF Germany	4f6826f2-4ff6-443d-b966-e6913bd24013	75b9b056-f762-11e1-a439-00145eb45e9a
103715	103715	0	Atlas of Living Australia	4a6f1b71-969e-4fc5-a693-282b05e1220c	764e832b-96ec-49bb-8de2-f8c5ca09afc2
31	31	0	GBIF Norway	4f829580-180d-46a9-9c87-ed8ec959b545	78360224-5493-45fd-a9a0-c336557f09c3
63	63	0	GBIF Germany	4f6826f2-4ff6-443d-b966-e6913bd24013	78c508c2-f762-11e1-a439-00145eb45e9a
195	88	-107	GBIF Germany	4f6826f2-4ff6-443d-b966-e6913bd24013	79acf196-f762-11e1-a439-00145eb45e9a
113	112	-1	GBIF Germany	4f6826f2-4ff6-443d-b966-e6913bd24013	79c39400-f762-11e1-a439-00145eb45e9a
656	656	0	National Biodiversity Network	d897a5b9-35ee-4232-94bd-b0bcaac003c2	7bb5d1e3-ee8d-4a96-97cd-bb8f56dc6375
29	29	0	Plazi	ffb07bec-2d10-492d-9c37-361fe0b79427	7bf420a2-9fec-43bc-aceb-0213770ed782
871	804	-67	GBIF Germany	4f6826f2-4ff6-443d-b966-e6913bd24013	7c8e68d6-f762-11e1-a439-00145eb45e9a
264	264	0	GBIF Norway	4f829580-180d-46a9-9c87-ed8ec959b545	7d1136a6-2dbe-48ec-ae09-efcc83a0550b
242	242	0	Society for the Management of Electronic Biodiversity Data	97818ee4-1461-4180-bf1d-b3201050124f	7d810c74-098e-422e-8437-2458b187b68a
96	96	0	GBIF Germany	4f6826f2-4ff6-443d-b966-e6913bd24013	7e584920-f762-11e1-a439-00145eb45e9a
170	170	0	GBIF France	da44cd31-5901-4687-a106-6d1c7734ee3a	7e85b50e-c422-473c-840e-c7cfb1ceab41
1405	1405	0	Biodiversity Information System of Mexico	b324e8e9-9a4c-44fa-8f1a-7f39ea7ab576	805548f4-f762-11e1-a439-00145eb45e9a
70	70	0	Korean Biodiversity Information Facility	e0a1e772-0177-4800-94b4-2d023fe6cdf4	83032062-f762-11e1-a439-00145eb45e9a
14842	19346	4504	GBIF Spain	1f94b3ca-9345-4d65-afe2-4bace93aa0fe	83492a58-f762-11e1-a439-00145eb45e9a
9	9	0	Plazi	ffb07bec-2d10-492d-9c37-361fe0b79427	84ed562e-82a2-435a-a512-c9df7de64be8
287	287	0	GBIF Japan	db5705aa-6a6e-42f1-8942-d77b9f4896ea	86864a3e-f762-11e1-a439-00145eb45e9a
1057	790	-267	GBIF Germany	4f6826f2-4ff6-443d-b966-e6913bd24013	8867edbc-f762-11e1-a439-00145eb45e9a
3364	3364	0	National Biodiversity Network	d897a5b9-35ee-4232-94bd-b0bcaac003c2	8a21c19d-af0e-48c4-8ca6-75e1119b26e6
50	50	0	GBIF Germany	4f6826f2-4ff6-443d-b966-e6913bd24013	8a474d08-f762-11e1-a439-00145eb45e9a
5	5	0	Plazi	ffb07bec-2d10-492d-9c37-361fe0b79427	8a5195eb-b912-4e28-afd8-1bd32e7c86a7
1755	1755	0	GBIF New Zealand	4f9fd726-20dd-445e-89a1-8ed93792276f	8bcd27df-6ec9-435d-af28-00459315305c
187	187	0	GBIF Germany	4f6826f2-4ff6-443d-b966-e6913bd24013	8c4c4428-f762-11e1-a439-00145eb45e9a
2	1	-1	GBIF Germany	4f6826f2-4ff6-443d-b966-e6913bd24013	8c83ffee-f762-11e1-a439-00145eb45e9a
29	29	0	GBIF Germany	4f6826f2-4ff6-443d-b966-e6913bd24013	8caf1b7a-f762-11e1-a439-00145eb45e9a
262	262	0	National Biodiversity Network	d897a5b9-35ee-4232-94bd-b0bcaac003c2	8cb69b65-4cff-4df3-bd30-2ccf0734a3dd
12	6	-6	GBIF Germany	4f6826f2-4ff6-443d-b966-e6913bd24013	8cf13faa-f762-11e1-a439-00145eb45e9a
2	2	0	Plazi	ffb07bec-2d10-492d-9c37-361fe0b79427	8e02bc0d-5e3e-48fe-8e53-460dba7b7a53
69	40	-29	GBIF Germany	4f6826f2-4ff6-443d-b966-e6913bd24013	8e669f42-f762-11e1-a439-00145eb45e9a
0	6	6	Plazi	ffb07bec-2d10-492d-9c37-361fe0b79427	8f1c0fde-2086-43a6-bd59-d462151b5f02
19	15	-4	GBIF Germany	4f6826f2-4ff6-443d-b966-e6913bd24013	8fe58ec8-f762-11e1-a439-00145eb45e9a
0	30	30	Plazi	ffb07bec-2d10-492d-9c37-361fe0b79427	9012af9a-3914-464b-9dff-06d23bcd2e4e
32	18	-14	GBIF Germany	4f6826f2-4ff6-443d-b966-e6913bd24013	90f85b24-f762-11e1-a439-00145eb45e9a
60	37	-23	GBIF Germany	4f6826f2-4ff6-443d-b966-e6913bd24013	910a4cbc-f762-11e1-a439-00145eb45e9a
25	22	-3	GBIF Germany	4f6826f2-4ff6-443d-b966-e6913bd24013	911cbd5c-f762-11e1-a439-00145eb45e9a
5	3	-2	GBIF Germany	4f6826f2-4ff6-443d-b966-e6913bd24013	912f1862-f762-11e1-a439-00145eb45e9a
114	105	-9	GBIF Germany	4f6826f2-4ff6-443d-b966-e6913bd24013	91505c20-f762-11e1-a439-00145eb45e9a
73	67	-6	GBIF Germany	4f6826f2-4ff6-443d-b966-e6913bd24013	91dce488-f762-11e1-a439-00145eb45e9a
1704	1870	166	U.S. Geological Survey	8618c64a-93e0-4300-b546-7249e5148ed2	9261ca90-4b88-491d-bcc8-db3470441689
125	125	0	GBIF Germany	4f6826f2-4ff6-443d-b966-e6913bd24013	93d43084-f762-11e1-a439-00145eb45e9a
0	5	5	Plazi	ffb07bec-2d10-492d-9c37-361fe0b79427	950f45c5-5207-49ce-9aea-271ddb4112e7
0	7	7	Plazi	ffb07bec-2d10-492d-9c37-361fe0b79427	98285ad0-3b08-4803-9990-60d9549f0e13
0	35	35	Plazi	ffb07bec-2d10-492d-9c37-361fe0b79427	9853754e-6cde-4385-8cd2-6c181400facd
18	18	0	GBIF Sweden	a0b3be64-6525-4387-ac67-a499950f92e1	98a4ec0e-9bf6-493b-a1f5-8742c66a462e
7	7	0	Colombian Biodiversity Information System	7e865cba-7c46-417b-ade5-97f2cf5b7be0	9932a4e8-7383-4dcd-8107-70cb89809723
4	4	0	Plazi	ffb07bec-2d10-492d-9c37-361fe0b79427	993aa1b8-72e2-4b88-89eb-faf840f95d1f
55	55	0	Plazi	ffb07bec-2d10-492d-9c37-361fe0b79427	993d2ddb-2f1b-40a7-8e9e-caf65f5a5f04
898	1005	107	National Biodiversity Network	d897a5b9-35ee-4232-94bd-b0bcaac003c2	9bd88bf0-4090-4785-a243-33b3b05d0e05
2325	2124	-201	GBIF Germany	4f6826f2-4ff6-443d-b966-e6913bd24013	9f5db154-686c-46d0-8b94-4ad4b528b741
51	51	0	GBIF Brazil	cdc9736d-5ff7-4ece-9959-3c744360cdb3	a009b2d1-10ea-493e-a9cd-0fef21c6850c
0	32	32	Plazi	ffb07bec-2d10-492d-9c37-361fe0b79427	a15310ca-751f-4aeb-8a91-8fb017cf6347
5	5	0	Plazi	ffb07bec-2d10-492d-9c37-361fe0b79427	a270ab31-7e52-4655-aaa4-55d34fcf7fb3
0	5	5	Plazi	ffb07bec-2d10-492d-9c37-361fe0b79427	a7f043d8-9029-46e0-880c-fda7cbd31430
26	26	0	Plazi	ffb07bec-2d10-492d-9c37-361fe0b79427	b3b39f39-c823-429d-9354-81c3df099513
1	1	0	Plazi	ffb07bec-2d10-492d-9c37-361fe0b79427	b42c7378-ff6d-40fc-98da-c1f2ea5649a3
127	127	0	GBIF Chile	a8b16421-d80b-4ef3-8f22-098b01a89255	b577bbff-2ed4-40ff-9690-ff3da147775b
147	147	0	Plazi	ffb07bec-2d10-492d-9c37-361fe0b79427	b58b4f66-4e7e-4141-9ec9-3e381ebe57be
221	221	0	Colombian Biodiversity Information System	7e865cba-7c46-417b-ade5-97f2cf5b7be0	b5b0b716-566e-4f29-81a1-15e9f42465b2
46	46	0	Plazi	ffb07bec-2d10-492d-9c37-361fe0b79427	b7ec7b7c-5b54-401f-a513-7776957b6a09
941	941	0	GBIF France	da44cd31-5901-4687-a106-6d1c7734ee3a	b912b7d5-161c-4fed-8aad-6282bfc4e874
26	26	0	GBIF Madagascar	2dbfc5c5-51b5-4494-9dfc-4d3f013a3b64	b9718c0d-08ff-437b-a159-909b50506c97
1668	1668	0	Colombian Biodiversity Information System	7e865cba-7c46-417b-ade5-97f2cf5b7be0	b9fc6957-38db-4f3f-819f-a44fb4dff293
5	5	0	Plazi	ffb07bec-2d10-492d-9c37-361fe0b79427	bc38c18d-80ad-463b-8c2c-a0ce1f0ade1f
11	11	0	Plazi	ffb07bec-2d10-492d-9c37-361fe0b79427	bdd50792-540c-4ca3-85af-cab257e8761c
0	77	77	Plazi	ffb07bec-2d10-492d-9c37-361fe0b79427	be48713a-1886-42b7-8356-5e607948fcef
1	1	0	Plazi	ffb07bec-2d10-492d-9c37-361fe0b79427	bee0a5c9-2395-455e-8ee5-0b19ed3aee31
17132	17141	9	GBIF Brazil	cdc9736d-5ff7-4ece-9959-3c744360cdb3	c0e8647d-dd4b-4300-8ad1-8c362fb21d75
98	98	0	GBIF France	da44cd31-5901-4687-a106-6d1c7734ee3a	c26c363c-1e4d-49ce-bc7f-0d53120daf20
891	1811	920	GBIF Japan	db5705aa-6a6e-42f1-8942-d77b9f4896ea	c33ef967-201f-4bda-8ac7-8debe58fa656
0	2	2	Plazi	ffb07bec-2d10-492d-9c37-361fe0b79427	c341b9c0-823e-4e3c-816a-a2ac81e92118
2	2	0	Plazi	ffb07bec-2d10-492d-9c37-361fe0b79427	c7b28cb6-382e-4a79-913f-d26efeed9205
33	33	0	Plazi	ffb07bec-2d10-492d-9c37-361fe0b79427	c828ed56-5b75-4093-afdf-994576a03ccb
1045440	1045440	0	GBIF France	da44cd31-5901-4687-a106-6d1c7734ee3a	ca435754-9190-4a87-9b2c-c21563898294
1	1	0	Plazi	ffb07bec-2d10-492d-9c37-361fe0b79427	ca98d9e2-c4c7-4471-86db-014365e4f385
0	37	37	Plazi	ffb07bec-2d10-492d-9c37-361fe0b79427	cd1d8a8e-2855-4538-8119-796e007f1d7f
2303	2303	0	GBIF Germany	4f6826f2-4ff6-443d-b966-e6913bd24013	cd282110-b7fb-43e5-a638-52a857f5cbac
93	93	0	GBIF Argentina	2426a871-9feb-40a1-96c6-0c593a76b835	ced70e73-ea05-4cbf-9e88-cf3a2d5c32b6
2	2	0	Plazi	ffb07bec-2d10-492d-9c37-361fe0b79427	cf3b1881-d20d-4d1a-a38a-dc0a865ee5ad
5325	5325	0	Biodiversity Information System of Mexico	b324e8e9-9a4c-44fa-8f1a-7f39ea7ab576	d0d7ddf4-c5c9-4049-b6a5-9130eadc014a
5640	5640	0	Atlas of Living Australia	4a6f1b71-969e-4fc5-a693-282b05e1220c	d26fc9c2-be20-4e41-aead-c630d4980a2c
0	1143	1143	Ocean Biodiversity Information System	ba0670b9-4186-41e6-8e70-f9cb3065551a	d397c56d-71d6-4122-97b9-4d5bbc271a10
8	8	0	Plazi	ffb07bec-2d10-492d-9c37-361fe0b79427	d504c977-fa95-4f65-9ae7-c4c10fd6096d
76	76	0	National Biodiversity Network	d897a5b9-35ee-4232-94bd-b0bcaac003c2	d505ee59-5898-4bb6-92d9-db1daf4cb7db
1136	1136	0	National Biodiversity Network	d897a5b9-35ee-4232-94bd-b0bcaac003c2	d5e3d5e3-cd39-42a6-ae41-7b02b24ffa08
0	3	3	Plazi	ffb07bec-2d10-492d-9c37-361fe0b79427	d8b665ea-5ea2-42af-b17c-75fca249c91e
0	164	164	Plazi	ffb07bec-2d10-492d-9c37-361fe0b79427	d9f10a58-d4f7-4a74-900a-d5f2e041d181
8	8	0	Plazi	ffb07bec-2d10-492d-9c37-361fe0b79427	e00fe824-5428-4280-8166-2c65a4c15bc4
44	44	0	Plazi	ffb07bec-2d10-492d-9c37-361fe0b79427	e9fcac10-f2bf-4f24-b015-b8c0f18faa14
11	11	0	GBIF France	da44cd31-5901-4687-a106-6d1c7734ee3a	eb2dd03b-ef48-42e0-8118-e7f5598b032b
4	4	0	Plazi	ffb07bec-2d10-492d-9c37-361fe0b79427	f38c1f5c-57c4-4203-b5e5-cc1a973c5e9d
5	5	0	Plazi	ffb07bec-2d10-492d-9c37-361fe0b79427	f4f44a91-99c8-45a1-8425-eddb885bae68
4300	4300	0	National Biodiversity Network	d897a5b9-35ee-4232-94bd-b0bcaac003c2	f70fe113-c542-4711-935e-349444ea52c1
0	2	2	Plazi	ffb07bec-2d10-492d-9c37-361fe0b79427	fe733af9-8234-4e41-835c-5184e34202bb
291	291	0	GBIF Argentina	2426a871-9feb-40a1-96c6-0c593a76b835	0152374e-de47-4789-b17a-d15fd0fa7ac2
2053	2053	0	GBIF France	da44cd31-5901-4687-a106-6d1c7734ee3a	0160cea6-4ff3-46a1-880d-de8c3a48f1e9
2	2	0	Plazi	ffb07bec-2d10-492d-9c37-361fe0b79427	01ab8b99-abde-4575-8de6-fc286c3247b6
7	7	0	Plazi	ffb07bec-2d10-492d-9c37-361fe0b79427	03626b36-bc96-449b-8001-50c415393e48
7	7	0	Plazi	ffb07bec-2d10-492d-9c37-361fe0b79427	06673f41-b1ca-4c1b-8d70-6fd459478809
10290	10290	0	National Biodiversity Network	d897a5b9-35ee-4232-94bd-b0bcaac003c2	0767b323-7d90-435e-811e-9c42b05ff70c
89	89	0	GBIF Sweden	a0b3be64-6525-4387-ac67-a499950f92e1	07c199dc-1c06-4964-b49e-3c80c42ea84e
14	14	0	Plazi	ffb07bec-2d10-492d-9c37-361fe0b79427	07ff55b2-760f-4411-a2bd-3ada508ece01
44	44	0	Biodiversity Information System of Mexico	b324e8e9-9a4c-44fa-8f1a-7f39ea7ab576	0b4099ce-bba5-4c52-a9e7-7761f524c676
11	11	0	Plazi	ffb07bec-2d10-492d-9c37-361fe0b79427	0cd32718-ed0b-4afa-b3ec-46f4f308b0a9
297	297	0	Ocean Biodiversity Information System	ba0670b9-4186-41e6-8e70-f9cb3065551a	0cfae73c-cef7-41e7-9e41-b41cb29be7c2
10	10	0	Colombian Biodiversity Information System	7e865cba-7c46-417b-ade5-97f2cf5b7be0	0d354303-c904-40ae-9db9-8f8175f26e65
4	4	0	National Biodiversity Network	d897a5b9-35ee-4232-94bd-b0bcaac003c2	0de51e60-60d0-466a-ab26-80c71f661834
3139	3139	0	Belgian Biodiversity Platform	fb11cfe1-ebc3-45af-9159-17d9fddbcdac	0e267af5-9724-40f1-9d55-67477b8d1e6c
0	2897	2897	Ocean Biodiversity Information System	ba0670b9-4186-41e6-8e70-f9cb3065551a	0ef83d2e-3e86-44e6-b9c6-e52d49dff93e
0	1	1	Plazi	ffb07bec-2d10-492d-9c37-361fe0b79427	11e1865b-25d2-4da9-b38a-17f72b9193d9
3750	3750	0	GBIF France	da44cd31-5901-4687-a106-6d1c7734ee3a	14c7ada0-fec5-422c-bb2e-a529df8a0ffc
40	40	0	Secretariat of the Pacific Regional Environment Programme	29c6a139-ea7f-41f5-8d9b-c55af8736182	166a2dab-9357-42da-bc83-91677ada1002
69	69	0	GBIF France	da44cd31-5901-4687-a106-6d1c7734ee3a	1a7703f2-03e2-46d5-aef8-eee805fb3633
37	37	0	Plazi	ffb07bec-2d10-492d-9c37-361fe0b79427	1aacfdba-5b68-4eb0-b744-dd27057e4ba9
13	13	0	Plazi	ffb07bec-2d10-492d-9c37-361fe0b79427	1c4e50f7-a4d3-4479-bb37-c26b1279bc0d
1136	1136	0	GBIF France	da44cd31-5901-4687-a106-6d1c7734ee3a	1d51df9d-72de-460d-9734-64d93020e68b
1706	1706	0	Netherlands Biodiversity Information Facility	0909d601-bda2-42df-9e63-a6d51847ebce	1edaeec2-9fdf-48d2-a459-2bb8635e9aba
448	448	0	GBIF France	da44cd31-5901-4687-a106-6d1c7734ee3a	1fbc1b59-4ce3-4be5-bc7a-581fce21e8b0
0	1321	1321	Ocean Biodiversity Information System	ba0670b9-4186-41e6-8e70-f9cb3065551a	24a04aa9-c109-4c60-903f-7a80c723cc77
1641	1641	0	National Biodiversity Network	d897a5b9-35ee-4232-94bd-b0bcaac003c2	259aafd2-1b97-4866-949b-1f913704d94b
2392	2392	0	GBIF Andorra	8df8d012-8e64-4c8a-886e-521a3bdfa623	268574ca-449f-4c9e-b1e2-1345767c192a
29838	29852	14	Biodiversity Information System of Mexico	b324e8e9-9a4c-44fa-8f1a-7f39ea7ab576	27ba04cd-45b9-4f5c-b032-d1bcc584fbdd
0	31	31	Plazi	ffb07bec-2d10-492d-9c37-361fe0b79427	28228da7-1a79-45b8-bb9c-698fe9764316
1436	1436	0	GBIF France	da44cd31-5901-4687-a106-6d1c7734ee3a	2853c930-b214-46d3-952a-f3bd1ce30f63
2506	2506	0	Indonesian Biodiversity Information Facility	2ebd91f6-f14f-4375-b525-c011a3774f03	2aad3bc7-4765-40ea-b478-3ac3cb53ff72
2560	2560	0	GBIF France	da44cd31-5901-4687-a106-6d1c7734ee3a	2b1af5e2-6742-4981-89ec-c269c70f42ac
1	1	0	Plazi	ffb07bec-2d10-492d-9c37-361fe0b79427	2b8d8e70-876c-4df9-b3f4-ccb54eb91ae8
25	25	0	Plazi	ffb07bec-2d10-492d-9c37-361fe0b79427	30ae322a-ca5b-4981-9e20-acac3d0f57b7
2927	2927	0	GBIF Argentina	2426a871-9feb-40a1-96c6-0c593a76b835	33aa4922-1b9f-45ba-9324-ee5b93b16d57
917	917	0	GBIF Germany	4f6826f2-4ff6-443d-b966-e6913bd24013	349fb9ee-d036-4899-827e-f9fa63fa7756
3	3	0	Plazi	ffb07bec-2d10-492d-9c37-361fe0b79427	3580edab-0b18-4e9a-a20f-1ca31f414f9b
0	6	6	Plazi	ffb07bec-2d10-492d-9c37-361fe0b79427	3643aa8b-8e5a-429e-b9d1-5075f3398e57
30	30	0	Plazi	ffb07bec-2d10-492d-9c37-361fe0b79427	373796c0-ef8a-4946-90df-99742e77f9eb
0	2	2	Plazi	ffb07bec-2d10-492d-9c37-361fe0b79427	382fd86f-2702-44a0-926b-2b6a70dc1589
8	8	0	Plazi	ffb07bec-2d10-492d-9c37-361fe0b79427	3ab5370c-156f-45ae-a6f2-db99ee44fdd9
32	75	43	Plazi	ffb07bec-2d10-492d-9c37-361fe0b79427	3bd7517c-522d-4aaa-b097-7bc41006546b
529	529	0	GBIF Argentina	2426a871-9feb-40a1-96c6-0c593a76b835	3c6ecec0-7c9c-4ce1-a3b8-5ff3eafc14a1
5459	8431	2972	National Biodiversity Network	d897a5b9-35ee-4232-94bd-b0bcaac003c2	3dc9bf37-32f5-492f-92fc-559faf6d93e8
0	580	580	National Biodiversity Network	d897a5b9-35ee-4232-94bd-b0bcaac003c2	3ecbd706-44d8-469d-b40b-3e1eacaa620c
12	12	0	Plazi	ffb07bec-2d10-492d-9c37-361fe0b79427	4088067b-9ee8-4fea-b597-059a9de5b6e2
0	4	4	Plazi	ffb07bec-2d10-492d-9c37-361fe0b79427	4093dd95-7b99-4f0d-b630-fc189b8b1cee
0	8	8	Plazi	ffb07bec-2d10-492d-9c37-361fe0b79427	422eec88-0286-4537-bc46-7920c65b7fdc
335	335	0	Plazi	ffb07bec-2d10-492d-9c37-361fe0b79427	423726f5-4886-413c-9aef-422348a3aae4
2	2	0	Plazi	ffb07bec-2d10-492d-9c37-361fe0b79427	4733d8ed-9397-4251-adb5-a93ed1f1c4a6
50	50	0	Plazi	ffb07bec-2d10-492d-9c37-361fe0b79427	476e50a8-5927-4479-8083-1f0b4165628d
7	7	0	Plazi	ffb07bec-2d10-492d-9c37-361fe0b79427	480b5d0b-1488-4f30-b630-229621a200ba
36	36	0	Plazi	ffb07bec-2d10-492d-9c37-361fe0b79427	491a2efd-49cd-4121-9087-6958eb73890b
8	8	0	Plazi	ffb07bec-2d10-492d-9c37-361fe0b79427	498bf72a-fb02-4c71-adab-0450f4b0432b
24	24	0	GBIF Germany	4f6826f2-4ff6-443d-b966-e6913bd24013	4af1468c-fb40-48c4-a4ca-62b00fa0b9a9
1	1	0	Plazi	ffb07bec-2d10-492d-9c37-361fe0b79427	4b429b63-7518-4b78-aa73-227e33008116
24	24	0	Plazi	ffb07bec-2d10-492d-9c37-361fe0b79427	4e5b6b73-2cfc-4127-9209-3b4a6c1d59bf
0	24	24	Plazi	ffb07bec-2d10-492d-9c37-361fe0b79427	4fd22274-dd46-49bd-b592-47f2a867e8b1
3	3	0	Plazi	ffb07bec-2d10-492d-9c37-361fe0b79427	511164fa-b1f3-448a-9d01-9ff882d456c3
0	11	11	Plazi	ffb07bec-2d10-492d-9c37-361fe0b79427	54639b46-5567-41b2-9b76-c758d1afc0e9
211	211	0	Biodiversity Information System of Mexico	b324e8e9-9a4c-44fa-8f1a-7f39ea7ab576	566d2e2e-fe34-4ad9-8bbe-124763bb0655
0	2	2	Plazi	ffb07bec-2d10-492d-9c37-361fe0b79427	583766f3-b509-43cd-9852-10be8804b947
1	1	0	Plazi	ffb07bec-2d10-492d-9c37-361fe0b79427	58bbd3a9-bcce-46fb-9f79-0202f6b60210
2248	2248	0	U.S. Geological Survey	8618c64a-93e0-4300-b546-7249e5148ed2	58ff104b-f10a-496a-bafe-54cc97f4918d
2	2	0	Plazi	ffb07bec-2d10-492d-9c37-361fe0b79427	5901e40e-9a93-49ec-bf52-2921f50e471b
1635	1635	0	Participant Node Managers Committee	7f48e0c8-5c96-49ec-b972-30748e339115	599ef018-1bbc-48fb-ac5c-e7e58ae29a7e
0	24	24	GBIF France	da44cd31-5901-4687-a106-6d1c7734ee3a	599ffe2d-d820-4d51-8c7c-d50996eaaa43
444	444	0	Plazi	ffb07bec-2d10-492d-9c37-361fe0b79427	5a65a6a9-d142-4121-b893-a83e929ffdbc
12	12	0	Plazi	ffb07bec-2d10-492d-9c37-361fe0b79427	5c3985bb-519d-487e-b0b8-5081059c8af3
468	468	0	Plazi	ffb07bec-2d10-492d-9c37-361fe0b79427	5d41ffeb-8b0d-4381-836d-ccd12a52142a
92	92	0	GBIF Germany	4f6826f2-4ff6-443d-b966-e6913bd24013	612c1034-f762-11e1-a439-00145eb45e9a
80	80	0	GBIF Germany	4f6826f2-4ff6-443d-b966-e6913bd24013	614d9f60-f762-11e1-a439-00145eb45e9a
189	189	0	Plazi	ffb07bec-2d10-492d-9c37-361fe0b79427	61bdc8ed-f0e1-4c9e-a7de-71ea43cecdd9
7	7	0	Participant Node Managers Committee	7f48e0c8-5c96-49ec-b972-30748e339115	61ed507f-4204-43c6-b463-d2db06d01b5e
128	128	0	GBIF Germany	4f6826f2-4ff6-443d-b966-e6913bd24013	62508210-f762-11e1-a439-00145eb45e9a
81	81	0	GBIF Germany	4f6826f2-4ff6-443d-b966-e6913bd24013	6299b2a0-f762-11e1-a439-00145eb45e9a
46580	46580	0	Atlas of Living Australia	4a6f1b71-969e-4fc5-a693-282b05e1220c	63fa6322-9962-44a5-8691-24cdb26e1370
15	15	0	Plazi	ffb07bec-2d10-492d-9c37-361fe0b79427	64bd6d7b-3058-43d9-9d64-02d72824b35b
162	162	0	GBIF Madagascar	2dbfc5c5-51b5-4494-9dfc-4d3f013a3b64	65174786-b679-46f1-b5a4-34f466e9241a
123	81	-42	GBIF Germany	4f6826f2-4ff6-443d-b966-e6913bd24013	65f860cc-f762-11e1-a439-00145eb45e9a
74	74	0	Colombian Biodiversity Information System	7e865cba-7c46-417b-ade5-97f2cf5b7be0	666dd901-5af9-41b0-ad20-3ba292687d01
357	357	0	GBIF Germany	4f6826f2-4ff6-443d-b966-e6913bd24013	672544ad-360c-4895-b76c-b524bf5144b3
0	44	44	Ocean Biodiversity Information System	ba0670b9-4186-41e6-8e70-f9cb3065551a	67ed8ccb-682c-48cd-a2b7-63039296c186
26	26	0	GBIF Germany	4f6826f2-4ff6-443d-b966-e6913bd24013	69318246-f762-11e1-a439-00145eb45e9a
104	104	0	GBIF Germany	4f6826f2-4ff6-443d-b966-e6913bd24013	69ba2d12-f762-11e1-a439-00145eb45e9a
181	181	0	GBIF Germany	4f6826f2-4ff6-443d-b966-e6913bd24013	6a114f34-f762-11e1-a439-00145eb45e9a
39	2	-37	GBIF Germany	4f6826f2-4ff6-443d-b966-e6913bd24013	6a3d21b8-f762-11e1-a439-00145eb45e9a
38	38	0	GBIF Germany	4f6826f2-4ff6-443d-b966-e6913bd24013	6ac37826-f762-11e1-a439-00145eb45e9a
20	20	0	GBIF Germany	4f6826f2-4ff6-443d-b966-e6913bd24013	6bc1d5ec-f762-11e1-a439-00145eb45e9a
19	19	0	GBIF Germany	4f6826f2-4ff6-443d-b966-e6913bd24013	6be4d5d8-f762-11e1-a439-00145eb45e9a
1	1	0	Plazi	ffb07bec-2d10-492d-9c37-361fe0b79427	6c9cf4da-a611-4100-b63f-95f094d99bed
0	116	116	Colombian Biodiversity Information System	7e865cba-7c46-417b-ade5-97f2cf5b7be0	6ebfb075-8d9f-42c0-8201-6a2c0d8d7362
14	14	0	Plazi	ffb07bec-2d10-492d-9c37-361fe0b79427	6fb40ed6-8bf1-4bd2-8602-12f477b1dfad
0	17	17	Plazi	ffb07bec-2d10-492d-9c37-361fe0b79427	714eee32-3f6a-4402-b3a9-a755fab8cb85
0	1	1	Ocean Biodiversity Information System	ba0670b9-4186-41e6-8e70-f9cb3065551a	717111a8-9165-4459-b500-dccc0e4b5899
21209	21209	0	U.S. Geological Survey	8618c64a-93e0-4300-b546-7249e5148ed2	71e82020-f762-11e1-a439-00145eb45e9a
136	136	0	GBIF Germany	4f6826f2-4ff6-443d-b966-e6913bd24013	72092b76-f762-11e1-a439-00145eb45e9a
5	5	0	Plazi	ffb07bec-2d10-492d-9c37-361fe0b79427	73aa8b64-60db-4dfb-93dc-ca07c364c1e7
309	309	0	GBIF Germany	4f6826f2-4ff6-443d-b966-e6913bd24013	7536835c-f762-11e1-a439-00145eb45e9a
6	6	0	GBIF Germany	4f6826f2-4ff6-443d-b966-e6913bd24013	7577ada0-f762-11e1-a439-00145eb45e9a
10	10	0	GBIF Germany	4f6826f2-4ff6-443d-b966-e6913bd24013	75f4def6-f762-11e1-a439-00145eb45e9a
3	3	0	Plazi	ffb07bec-2d10-492d-9c37-361fe0b79427	76ecc96e-5622-492a-b0d8-92d05febb2ac
55	55	0	Plazi	ffb07bec-2d10-492d-9c37-361fe0b79427	7737cac6-f286-4fc1-8494-01c55df12788
0	4	4	Participant Node Managers Committee	7f48e0c8-5c96-49ec-b972-30748e339115	77608885-1209-4507-adae-135b67209601
39	39	0	Colombian Biodiversity Information System	7e865cba-7c46-417b-ade5-97f2cf5b7be0	77e0b1e1-eb54-4311-bd15-193fa55ea75f
0	11	11	Plazi	ffb07bec-2d10-492d-9c37-361fe0b79427	79bb2b57-3ebe-417a-b48d-040b4d7ac150
1	1	0	GBIF Germany	4f6826f2-4ff6-443d-b966-e6913bd24013	7a7ad02a-f762-11e1-a439-00145eb45e9a
1040	1040	0	GBIF Germany	4f6826f2-4ff6-443d-b966-e6913bd24013	7c155464-f762-11e1-a439-00145eb45e9a
32	32	0	GBIF Germany	4f6826f2-4ff6-443d-b966-e6913bd24013	7cc1398c-f762-11e1-a439-00145eb45e9a
7	7	0	GBIF Brazil	cdc9736d-5ff7-4ece-9959-3c744360cdb3	7e443ccb-864a-4e65-a6a7-ea765595260f
0	100048	100048	GBIF Switzerland	169eb292-376b-4cc6-8e31-9c2c432de0ad	7f13209c-d5da-4494-be23-21af348d3b73
9811	9811	0	Biodiversity Information System of Mexico	b324e8e9-9a4c-44fa-8f1a-7f39ea7ab576	806835f4-f762-11e1-a439-00145eb45e9a
2	2	0	Plazi	ffb07bec-2d10-492d-9c37-361fe0b79427	8180176f-c99f-4c0c-b467-e87ccf280421
80	80	0	GBIF France	da44cd31-5901-4687-a106-6d1c7734ee3a	824cb48f-0a95-49d7-93b3-52761deb8cbb
990	990	0	National Biodiversity Network	d897a5b9-35ee-4232-94bd-b0bcaac003c2	82c7db2c-0a16-4c64-8347-290bfe43566d
26375	26375	0	Canada Biodiversity Information Facility	8f83fc96-c966-4126-83f7-bf044dc49efa	843df0c4-f762-11e1-a439-00145eb45e9a
6987	6987	0	Canada Biodiversity Information Facility	8f83fc96-c966-4126-83f7-bf044dc49efa	84461682-f762-11e1-a439-00145eb45e9a
58	58	0	GBIF Brazil	cdc9736d-5ff7-4ece-9959-3c744360cdb3	84a86bae-9b69-411c-bdd6-8c7d0047962d
5826	5826	0	Biodiversity Information System of Mexico	b324e8e9-9a4c-44fa-8f1a-7f39ea7ab576	8505687a-f762-11e1-a439-00145eb45e9a
58	58	0	Biodiversity Information System of Mexico	b324e8e9-9a4c-44fa-8f1a-7f39ea7ab576	8508f6fc-f762-11e1-a439-00145eb45e9a
29	29	0	GBIF Germany	4f6826f2-4ff6-443d-b966-e6913bd24013	85d3cfda-f762-11e1-a439-00145eb45e9a
836	836	0	GBIF Germany	4f6826f2-4ff6-443d-b966-e6913bd24013	86397e70-f762-11e1-a439-00145eb45e9a
639	639	0	Colombian Biodiversity Information System	7e865cba-7c46-417b-ade5-97f2cf5b7be0	87372877-711d-43cf-aae5-02b9eb18da41
737	535	-202	GBIF Germany	4f6826f2-4ff6-443d-b966-e6913bd24013	87f10f58-f762-11e1-a439-00145eb45e9a
15	15	0	Plazi	ffb07bec-2d10-492d-9c37-361fe0b79427	895191a3-419c-4251-9cb3-d7e73146b6b6
535	535	0	National Biodiversity Network	d897a5b9-35ee-4232-94bd-b0bcaac003c2	89eeb7da-723f-47e6-a18a-475b6da7b893
19	19	0	GBIF Germany	4f6826f2-4ff6-443d-b966-e6913bd24013	8a14f524-f762-11e1-a439-00145eb45e9a
13	13	0	Plazi	ffb07bec-2d10-492d-9c37-361fe0b79427	8c4bbdaf-f7ba-4274-a408-510406db64d9
47	47	0	GBIF Germany	4f6826f2-4ff6-443d-b966-e6913bd24013	8c87b97c-f762-11e1-a439-00145eb45e9a
63	63	0	GBIF France	da44cd31-5901-4687-a106-6d1c7734ee3a	8c932011-b6b1-4b06-9bef-72e4f3190d3a
31	31	0	GBIF Germany	4f6826f2-4ff6-443d-b966-e6913bd24013	8d2c9c58-f762-11e1-a439-00145eb45e9a
0	3	3	Plazi	ffb07bec-2d10-492d-9c37-361fe0b79427	8d4b293d-e91c-447a-933a-43c1a4c17698
260	260	0	GBIF Germany	4f6826f2-4ff6-443d-b966-e6913bd24013	8d6d5356-f762-11e1-a439-00145eb45e9a
347	305	-42	GBIF Germany	4f6826f2-4ff6-443d-b966-e6913bd24013	8e02ea24-f762-11e1-a439-00145eb45e9a
878	426	-452	GBIF Germany	4f6826f2-4ff6-443d-b966-e6913bd24013	8e22dbb8-f762-11e1-a439-00145eb45e9a
70	70	0	GBIF Germany	4f6826f2-4ff6-443d-b966-e6913bd24013	8e4e5072-f762-11e1-a439-00145eb45e9a
500	275	-225	GBIF Germany	4f6826f2-4ff6-443d-b966-e6913bd24013	907084a6-f762-11e1-a439-00145eb45e9a
67	67	0	GBIF Germany	4f6826f2-4ff6-443d-b966-e6913bd24013	926b8a58-f762-11e1-a439-00145eb45e9a
1545	1545	0	GBIF Germany	4f6826f2-4ff6-443d-b966-e6913bd24013	94161c1a-f762-11e1-a439-00145eb45e9a
13	13	0	Plazi	ffb07bec-2d10-492d-9c37-361fe0b79427	94bfdf43-b58a-4967-8435-8c2d71ff87e1
353	554	201	GBIF Germany	4f6826f2-4ff6-443d-b966-e6913bd24013	9680c748-f762-11e1-a439-00145eb45e9a
12497	12497	0	U.S. Geological Survey	8618c64a-93e0-4300-b546-7249e5148ed2	96cdea48-b78a-4345-ae6d-b2c7c6e0278a
47	47	0	Plazi	ffb07bec-2d10-492d-9c37-361fe0b79427	99c5ebab-c429-40d6-831c-45de0d451d64
41322	41322	0	GBIF France	da44cd31-5901-4687-a106-6d1c7734ee3a	9ae2d15c-6735-4069-b255-d737d919bcd6
0	106	106	Plazi	ffb07bec-2d10-492d-9c37-361fe0b79427	9d06c328-f898-4a9d-ad07-c59c765bfc83
110	110	0	Taiwan Biodiversity Information Facility	e1b85abc-61f9-430f-ba79-6813dec53a0f	a0998d3b-4a7f-4add-8044-299092d9c63f
291	291	0	Colombian Biodiversity Information System	7e865cba-7c46-417b-ade5-97f2cf5b7be0	a4813c2b-7fb9-4713-9a21-b3be0ea9042d
7938	7938	0	GBIF Norway	4f829580-180d-46a9-9c87-ed8ec959b545	a4e7ff0a-f9c0-481a-88ed-5986ec86b24a
20733	21764	1031	U.S. Geological Survey	8618c64a-93e0-4300-b546-7249e5148ed2	a4f29a62-d170-4775-b29a-09deaf138ee4
15723	15723	0	National Biodiversity Network	d897a5b9-35ee-4232-94bd-b0bcaac003c2	a5c2bea3-b6a9-4635-9f9b-f07db9875a61
705	449	-256	GBIF Germany	4f6826f2-4ff6-443d-b966-e6913bd24013	a85a83cb-ab57-4a89-bce7-abe45897de71
0	280	280	Plazi	ffb07bec-2d10-492d-9c37-361fe0b79427	a880f550-16bc-4733-9407-d09212861392
32784	32784	0	National Biodiversity Network	d897a5b9-35ee-4232-94bd-b0bcaac003c2	a8c8144a-3693-4d92-8bc4-49e00dd8defc
0	4	4	Ocean Biodiversity Information System	ba0670b9-4186-41e6-8e70-f9cb3065551a	a8d9cae9-39a0-4cc7-a71b-1ce6368676d9
0	13	13	Plazi	ffb07bec-2d10-492d-9c37-361fe0b79427	aa812c93-358d-4cbf-a797-6d320315ad2b
8	8	0	Plazi	ffb07bec-2d10-492d-9c37-361fe0b79427	ac80d266-8f8e-4fc5-a172-599a331449a4
10392	60472	50080	National Biodiversity Network	d897a5b9-35ee-4232-94bd-b0bcaac003c2	ad07ac5e-718d-40cc-8093-b61169b745ef
19	19	0	Plazi	ffb07bec-2d10-492d-9c37-361fe0b79427	ade5a386-314c-47c7-88b3-d7dfce2c2e57
1084	1084	0	National Biodiversity Network	d897a5b9-35ee-4232-94bd-b0bcaac003c2	b21c81c7-c044-440d-9246-4d1ff6664cd2
1	1	0	Plazi	ffb07bec-2d10-492d-9c37-361fe0b79427	b5bfdb5f-68ef-4c31-81f8-397162b7480a
188	188	0	National Biodiversity Network	d897a5b9-35ee-4232-94bd-b0bcaac003c2	b7443556-96ca-49d3-8c4a-502efe4794cd
781	781	0	Colombian Biodiversity Information System	7e865cba-7c46-417b-ade5-97f2cf5b7be0	b7464a9e-dc9e-47d8-9245-b32500e89ccc
26403	26403	0	South African Biodiversity Information Facility	7190b835-4e86-4b6e-85c1-19cc6677c250	b9f3beb1-13c0-484e-886b-83e9062be37a
11147	11147	0	GBIF Finland	dd514216-5c7c-45f3-910d-797424cb5be6	bafa5083-8081-42f8-9201-04c511f45098
771	771	0	GBIF France	da44cd31-5901-4687-a106-6d1c7734ee3a	bd37eb97-5d23-4ab7-8a8f-b94774c33db4
6451	6451	0	National Biodiversity Network	d897a5b9-35ee-4232-94bd-b0bcaac003c2	bde5b63d-8664-4632-bc8b-d06653b09b22
6067	6067	0	Atlas of Living Australia	4a6f1b71-969e-4fc5-a693-282b05e1220c	bf7cb159-620a-4d8b-8c62-e2658712b3ae
22	22	0	Plazi	ffb07bec-2d10-492d-9c37-361fe0b79427	c0a8cac9-8750-4f68-9cfc-de9e9f48572f
79473	79473	0	GBIF Norway	4f829580-180d-46a9-9c87-ed8ec959b545	c2c4566c-966a-4efe-a986-a59c459ef4e1
100753	100753	0	U.S. Geological Survey	8618c64a-93e0-4300-b546-7249e5148ed2	c53a27b8-d019-460e-8124-662b6fa14d85
27	27	0	Plazi	ffb07bec-2d10-492d-9c37-361fe0b79427	c6f362bc-4d6b-4e3a-b69a-a9e8392e6756
17	17	0	Colombian Biodiversity Information System	7e865cba-7c46-417b-ade5-97f2cf5b7be0	c87690cc-631b-4061-b69a-7ebb6150e21a
12	12	0	Plazi	ffb07bec-2d10-492d-9c37-361fe0b79427	c8f70086-b0f8-4063-8fe1-2150048f14d4
0	1	1	Plazi	ffb07bec-2d10-492d-9c37-361fe0b79427	ca812218-bdbc-43d4-a932-addc8bb07d56
0	525	525	Ocean Biodiversity Information System	ba0670b9-4186-41e6-8e70-f9cb3065551a	cad5cf4a-da40-4168-afc0-db34eab51365
774162	774161	-1	GBIF Finland	dd514216-5c7c-45f3-910d-797424cb5be6	cc885e78-0fae-49a3-9c6d-93ac90debd68
3533	3533	0	GBIF France	da44cd31-5901-4687-a106-6d1c7734ee3a	d0e6b375-b65e-4b31-95c9-7e8ebba462dd
231449	234600	3151	GBIF Norway	4f829580-180d-46a9-9c87-ed8ec959b545	d29d79fd-2dc4-4ef5-89b8-cdf66994de0d
2	2	0	Plazi	ffb07bec-2d10-492d-9c37-361fe0b79427	d378f7a8-31c9-45ce-b61e-287e601df15e
21802	21802	0	National Biodiversity Network	d897a5b9-35ee-4232-94bd-b0bcaac003c2	d89c047d-acfc-4ccd-8627-7e44bd330812
16	16	0	Participant Node Managers Committee	7f48e0c8-5c96-49ec-b972-30748e339115	d9000678-9f65-48a9-891b-dd8e00b138ca
729950	730608	658	Netherlands Biodiversity Information Facility	0909d601-bda2-42df-9e63-a6d51847ebce	d962a7dc-2183-4824-bb88-5e0ba14ec62d
201	201	0	GBIF France	da44cd31-5901-4687-a106-6d1c7734ee3a	dab141dc-d1ad-49db-93fd-07143b3d2158
5	5	0	Plazi	ffb07bec-2d10-492d-9c37-361fe0b79427	dcfccbc7-6b12-49ee-9b99-779aea3e2fc4
20	20	0	Belgian Biodiversity Platform	fb11cfe1-ebc3-45af-9159-17d9fddbcdac	e2dca6fa-10a6-4abe-9f04-4476342027e1
2224	2224	0	GBIF France	da44cd31-5901-4687-a106-6d1c7734ee3a	e319ac8b-b424-4273-990b-94b39a767701
2	2	0	Plazi	ffb07bec-2d10-492d-9c37-361fe0b79427	e31a5999-0456-4df7-a0a8-66dc524ef5b7
1591	1591	0	National Biodiversity Network	d897a5b9-35ee-4232-94bd-b0bcaac003c2	e361041b-d97b-4e60-8450-d5cf4823d18d
0	408	408	Ocean Biodiversity Information System	ba0670b9-4186-41e6-8e70-f9cb3065551a	e38a459a-06c4-4056-8f2c-4f0d2fc38605
0	13	13	Plazi	ffb07bec-2d10-492d-9c37-361fe0b79427	e3cbad23-7bba-464d-bccd-b5e88b507d54
3	3	0	Plazi	ffb07bec-2d10-492d-9c37-361fe0b79427	e46a921e-2fd8-44a2-ab26-68b838163040
218580	228192	9612	GBIF Norway	4f829580-180d-46a9-9c87-ed8ec959b545	e4deab67-0998-4140-b573-0ba1f624eb3e
2085	2085	0	GBIF Norway	4f829580-180d-46a9-9c87-ed8ec959b545	e64d7f8f-9569-4319-8a5e-eb4da0c9d782
28	28	0	Plazi	ffb07bec-2d10-492d-9c37-361fe0b79427	ecda8a03-7a9b-43bb-bf7c-7fadb3d47ccd
11686	11686	0	Colombian Biodiversity Information System	7e865cba-7c46-417b-ade5-97f2cf5b7be0	ed195c7e-2727-46f8-ac2e-37c0af2c8c59
9216	87069	77853	Colombian Biodiversity Information System	7e865cba-7c46-417b-ade5-97f2cf5b7be0	edaa3a20-1d73-42ee-85f2-19105c1c8525
2	2	0	Plazi	ffb07bec-2d10-492d-9c37-361fe0b79427	f0e20c73-973c-4f5e-bd6a-0f0b97dc351f
874	874	0	Atlas of Living Australia	4a6f1b71-969e-4fc5-a693-282b05e1220c	f2069019-06c4-40fc-97a4-6672134a1f1f
31	31	0	Plazi	ffb07bec-2d10-492d-9c37-361fe0b79427	f330755e-f750-40cc-aef2-d498ffe912bc
0	11	11	Plazi	ffb07bec-2d10-492d-9c37-361fe0b79427	f37862dc-d3d8-422d-8c39-debbbf81eb0c
401	401	0	GBIF Norway	4f829580-180d-46a9-9c87-ed8ec959b545	f5b325e5-4c25-4dd3-a028-297c685b3327
1	1	0	Plazi	ffb07bec-2d10-492d-9c37-361fe0b79427	f6772c44-65ca-4acb-a3bf-2cd5fdd54efb
692	692	0	GBIF Finland	dd514216-5c7c-45f3-910d-797424cb5be6	f68d4d58-fd61-4e44-be35-a99e1bd99351
71395	71395	0	Polish Biodiversity Information Network	2618bfdf-e194-4911-a241-80db3107bc51	f7c496b0-9300-11da-8596-b8a03c50a862
0	2	2	Colombian Biodiversity Information System	7e865cba-7c46-417b-ade5-97f2cf5b7be0	f8bac062-270f-4435-aefd-dff9a00d09ff
0	3	3	Plazi	ffb07bec-2d10-492d-9c37-361fe0b79427	fb547296-85de-4457-8ef8-9498bc9ee774
3621	3621	0	South African Biodiversity Information Facility	7190b835-4e86-4b6e-85c1-19cc6677c250	ffab0ec5-c5f9-4c26-9b63-28696dc5cac5
0	75	75	Plazi	ffb07bec-2d10-492d-9c37-361fe0b79427	02cf5931-b18e-4d58-a6ff-9c7b1e37e68d
0	21	21	Plazi	ffb07bec-2d10-492d-9c37-361fe0b79427	02d54075-6c21-4d05-b8f8-40828a70b492
10366	6132	-4234	GBIF Germany	4f6826f2-4ff6-443d-b966-e6913bd24013	02d744d1-d365-4da0-acd3-1e0ce526c6a3
0	192	192	Colombian Biodiversity Information System	7e865cba-7c46-417b-ade5-97f2cf5b7be0	03858853-6f04-4aa2-8d33-6d59d4a921ea
90	90	0	Plazi	ffb07bec-2d10-492d-9c37-361fe0b79427	047432aa-5846-4990-94df-8c46e0cc15f4
10030	10030	0	GBIF Argentina	2426a871-9feb-40a1-96c6-0c593a76b835	06df03fc-8973-490c-af74-089fffae9e24
35	1098	1063	GBIF Germany	4f6826f2-4ff6-443d-b966-e6913bd24013	0aff0933-c85b-4539-9f46-2140d69e2555
0	3	3	Plazi	ffb07bec-2d10-492d-9c37-361fe0b79427	0e37c39e-2994-495d-9960-0cc7e8df1122
23468	23575	107	GBIF Norway	4f829580-180d-46a9-9c87-ed8ec959b545	0f061eff-6854-4bb3-abe2-acb184ea3ab7
935	935	0	GBIF France	da44cd31-5901-4687-a106-6d1c7734ee3a	0f61447b-f8dc-40cb-bc20-2e57c6a98f26
13833	13833	0	Atlas of Living Australia	4a6f1b71-969e-4fc5-a693-282b05e1220c	1217d9ba-4be1-4965-ab8d-c2d866eef2b3
24861	24862	1	GBIF Brazil	cdc9736d-5ff7-4ece-9959-3c744360cdb3	14ef7ae8-1bab-4af7-915c-7c146b117c91
816	816	0	Participant Node Managers Committee	7f48e0c8-5c96-49ec-b972-30748e339115	1ac5595a-ed78-46d1-9c1f-624197928f38
170	98	-72	GBIF Germany	4f6826f2-4ff6-443d-b966-e6913bd24013	1c460a86-f345-4089-920f-03dce582dde4
19665	19665	0	GBIF Portugal	673f7038-4262-4149-b753-5658a4e912f6	1c620cf6-682f-440b-a2a3-cc097244d745
435	435	0	Atlas of Living Australia	4a6f1b71-969e-4fc5-a693-282b05e1220c	21bfb712-d63c-4ef3-9627-bab7b928fb13
143	143	0	Plazi	ffb07bec-2d10-492d-9c37-361fe0b79427	2334efd2-e346-48ff-85ff-0bc8661538b2
10	10	0	Plazi	ffb07bec-2d10-492d-9c37-361fe0b79427	249d0fa9-4a7c-4348-b0e5-98f13dc53348
14	14	0	Plazi	ffb07bec-2d10-492d-9c37-361fe0b79427	24fd05d3-c5e4-418e-bfe6-ea0b80a0ff0a
8	8	0	Plazi	ffb07bec-2d10-492d-9c37-361fe0b79427	2525291e-a481-499a-ab8d-df5a615cefa3
2	2	0	Plazi	ffb07bec-2d10-492d-9c37-361fe0b79427	254d6805-35a0-4114-adfa-c9af4059402a
1504	1504	0	GBIF Chile	a8b16421-d80b-4ef3-8f22-098b01a89255	28205d79-fe89-4007-8fc9-834bc52d4c70
6368	6368	0	GBIF France	da44cd31-5901-4687-a106-6d1c7734ee3a	284fb9f7-eaf1-46ea-b9e2-f490efafa63b
0	100	100	Plazi	ffb07bec-2d10-492d-9c37-361fe0b79427	288c6fc9-269b-468f-8811-d79d4350f6e4
4	4	0	Plazi	ffb07bec-2d10-492d-9c37-361fe0b79427	2922dbf4-12ec-49d4-ac36-565434419f51
8	8	0	Plazi	ffb07bec-2d10-492d-9c37-361fe0b79427	298f6dc6-661e-43d0-b37d-722967c2be93
0	16	16	Plazi	ffb07bec-2d10-492d-9c37-361fe0b79427	29a4191d-6969-4e29-8e4c-9177e61b17df
4266	4266	0	U.S. Geological Survey	8618c64a-93e0-4300-b546-7249e5148ed2	2bf0ebd2-cf6a-412b-b3eb-81d07106c946
0	31	31	Plazi	ffb07bec-2d10-492d-9c37-361fe0b79427	2f6a086a-6f1e-423a-87f9-0a3979e5e917
0	77	77	Plazi	ffb07bec-2d10-492d-9c37-361fe0b79427	32f83a63-c4f4-48af-bcbc-f0b930e4c173
18	18	0	Participant Node Managers Committee	7f48e0c8-5c96-49ec-b972-30748e339115	35199ea9-c8a7-43e7-a2c9-e90a6d76dabb
325	325	0	GBIF France	da44cd31-5901-4687-a106-6d1c7734ee3a	3601a96a-c1aa-4cf3-ae65-1c0cccdf342f
194	194	0	GBIF France	da44cd31-5901-4687-a106-6d1c7734ee3a	3a229d67-06bd-4313-883c-0ca1094efab4
0	13	13	Plazi	ffb07bec-2d10-492d-9c37-361fe0b79427	3a359258-cd9f-4475-8533-305fb40e786c
292	292	0	Plazi	ffb07bec-2d10-492d-9c37-361fe0b79427	3ab3ca17-b957-454a-bdcf-d664740802e6
0	19	19	Plazi	ffb07bec-2d10-492d-9c37-361fe0b79427	3bb8f2bd-8bea-4b04-aacf-f71ac54df345
6	6	0	Plazi	ffb07bec-2d10-492d-9c37-361fe0b79427	3e2dcfb2-a000-4876-95b0-dbe57d93a2f5
9	9	0	Plazi	ffb07bec-2d10-492d-9c37-361fe0b79427	43392ac3-1fe6-46e6-a2f5-2eb6fe61884b
1486	1507	21	GBIF Germany	4f6826f2-4ff6-443d-b966-e6913bd24013	43e4b44e-3a0c-11e2-b0ce-00145eb45e9a
45	45	0	Plazi	ffb07bec-2d10-492d-9c37-361fe0b79427	4469947c-31f9-46e6-b963-03ae79d84554
2	2	0	Plazi	ffb07bec-2d10-492d-9c37-361fe0b79427	453974f6-3db4-45a0-bd84-d8c9b01fde5b
0	141	141	Colombian Biodiversity Information System	7e865cba-7c46-417b-ade5-97f2cf5b7be0	46bb4b35-e76b-4796-910d-a6db24b63bb3
0	6	6	Plazi	ffb07bec-2d10-492d-9c37-361fe0b79427	48672e27-ecbb-48e7-ac16-82baa84f55e1
0	14490	14490	Korean Biodiversity Information Facility	e0a1e772-0177-4800-94b4-2d023fe6cdf4	48e0c35d-5943-4c94-9adf-9b01a932211c
4	4	0	Plazi	ffb07bec-2d10-492d-9c37-361fe0b79427	4b455544-f490-4283-b51f-3bab0af22419
4	4	0	Plazi	ffb07bec-2d10-492d-9c37-361fe0b79427	4c302dae-cd9a-430f-b961-79dd12640fd7
19	19	0	GBIF France	da44cd31-5901-4687-a106-6d1c7734ee3a	4c527500-5dfe-4ef1-b67f-c88212b3efbb
0	2	2	Plazi	ffb07bec-2d10-492d-9c37-361fe0b79427	508c0b66-c3b8-4b0c-9bc8-4ecd9499ab9e
106	106	0	GBIF Finland	dd514216-5c7c-45f3-910d-797424cb5be6	51408b36-de1a-4b52-91af-4052d1a64932
9658	9658	0	GBIF France	da44cd31-5901-4687-a106-6d1c7734ee3a	55bbcb99-8c43-4d68-add5-abc49d41b16f
32	32	0	Plazi	ffb07bec-2d10-492d-9c37-361fe0b79427	578c2892-8ead-46e7-9c46-de2968a3b3ba
971	971	0	GBIF Kenya	2a44d626-9f7a-4120-8a7a-4ab5ac15ff2a	581f48a5-534b-4948-ac09-bde34b23f7e7
7	7	0	Plazi	ffb07bec-2d10-492d-9c37-361fe0b79427	59c1a8ce-365c-42b7-8e45-f40f0eacdafd
0	1	1	Ocean Biodiversity Information System	ba0670b9-4186-41e6-8e70-f9cb3065551a	5a7bed1a-05b3-4405-8c08-7d94e34efcb4
1	1	0	Plazi	ffb07bec-2d10-492d-9c37-361fe0b79427	5b6f46f3-e85e-4396-9b23-ea30c66081ba
511	511	0	GBIF France	da44cd31-5901-4687-a106-6d1c7734ee3a	5c495fd8-684b-4532-8412-eeb47f28f47c
6	6	0	Plazi	ffb07bec-2d10-492d-9c37-361fe0b79427	5e229ea9-be13-4238-aef6-13a32e4eeba8
99	99	0	GBIF Germany	4f6826f2-4ff6-443d-b966-e6913bd24013	612510a4-f762-11e1-a439-00145eb45e9a
3	3	0	Plazi	ffb07bec-2d10-492d-9c37-361fe0b79427	62518638-260a-4275-b61e-1f0d5b313601
117	117	0	GBIF Germany	4f6826f2-4ff6-443d-b966-e6913bd24013	62b6831c-f762-11e1-a439-00145eb45e9a
4946	4946	0	Biodiversity Information System of Mexico	b324e8e9-9a4c-44fa-8f1a-7f39ea7ab576	62d15ada-100a-465f-b17b-bb5c8436470a
52	52	0	Polish Biodiversity Information Network	2618bfdf-e194-4911-a241-80db3107bc51	6313c4ae-7b7e-4c73-92db-8b9910c0c6c2
1110	1110	0	GBIF Germany	4f6826f2-4ff6-443d-b966-e6913bd24013	6367cfd2-f762-11e1-a439-00145eb45e9a
96	96	0	Plazi	ffb07bec-2d10-492d-9c37-361fe0b79427	642611e0-f3f9-486f-a232-cf8420662cd1
82	82	0	GBIF Germany	4f6826f2-4ff6-443d-b966-e6913bd24013	648c7c00-f762-11e1-a439-00145eb45e9a
17	17	0	GBIF Germany	4f6826f2-4ff6-443d-b966-e6913bd24013	648ddee2-f762-11e1-a439-00145eb45e9a
10288	10334	46	GBIF Germany	4f6826f2-4ff6-443d-b966-e6913bd24013	658ca29c-f762-11e1-a439-00145eb45e9a
100	100	0	Participant Node Managers Committee	7f48e0c8-5c96-49ec-b972-30748e339115	65f46473-283b-4228-95e7-87636709b82a
51	51	0	GBIF Germany	4f6826f2-4ff6-443d-b966-e6913bd24013	66b620c6-f762-11e1-a439-00145eb45e9a
51	51	0	GBIF Germany	4f6826f2-4ff6-443d-b966-e6913bd24013	67ceb126-f762-11e1-a439-00145eb45e9a
270	153	-117	GBIF Germany	4f6826f2-4ff6-443d-b966-e6913bd24013	68d73ff2-f762-11e1-a439-00145eb45e9a
0	2	2	Plazi	ffb07bec-2d10-492d-9c37-361fe0b79427	6ad586ab-de6a-4372-adb3-fbde96b0d97d
10	10	0	GBIF Germany	4f6826f2-4ff6-443d-b966-e6913bd24013	6ae05ab8-f762-11e1-a439-00145eb45e9a
6	6	0	GBIF Germany	4f6826f2-4ff6-443d-b966-e6913bd24013	6b49c2dc-f762-11e1-a439-00145eb45e9a
66	66	0	Plazi	ffb07bec-2d10-492d-9c37-361fe0b79427	6b73003c-9391-4d6b-83ec-751c121b1410
15	15	0	GBIF Germany	4f6826f2-4ff6-443d-b966-e6913bd24013	6be329b8-f762-11e1-a439-00145eb45e9a
100	100	0	GBIF Germany	4f6826f2-4ff6-443d-b966-e6913bd24013	6d5ac10c-f762-11e1-a439-00145eb45e9a
8	8	0	GBIF Germany	4f6826f2-4ff6-443d-b966-e6913bd24013	6fa33412-f762-11e1-a439-00145eb45e9a
27	27	0	GBIF Germany	4f6826f2-4ff6-443d-b966-e6913bd24013	700934ec-f762-11e1-a439-00145eb45e9a
27	27	0	GBIF Germany	4f6826f2-4ff6-443d-b966-e6913bd24013	700cf14a-f762-11e1-a439-00145eb45e9a
906	734	-172	GBIF Germany	4f6826f2-4ff6-443d-b966-e6913bd24013	701bb14e-f762-11e1-a439-00145eb45e9a
32768	61576	28808	Belgian Biodiversity Platform	fb11cfe1-ebc3-45af-9159-17d9fddbcdac	702973cf-6935-45bf-ba31-cecee3571cf9
390	390	0	GBIF Germany	4f6826f2-4ff6-443d-b966-e6913bd24013	71655776-f762-11e1-a439-00145eb45e9a
46	46	0	GBIF Germany	4f6826f2-4ff6-443d-b966-e6913bd24013	71c9d4da-f762-11e1-a439-00145eb45e9a
95	95	0	GBIF Germany	4f6826f2-4ff6-443d-b966-e6913bd24013	73c5ac5a-f762-11e1-a439-00145eb45e9a
10	10	0	Plazi	ffb07bec-2d10-492d-9c37-361fe0b79427	7408c18a-72d9-4302-a3a6-45a971320d2f
47	47	0	GBIF Germany	4f6826f2-4ff6-443d-b966-e6913bd24013	751d202e-f762-11e1-a439-00145eb45e9a
258	249	-9	GBIF Germany	4f6826f2-4ff6-443d-b966-e6913bd24013	798efcd6-f762-11e1-a439-00145eb45e9a
286	131	-155	GBIF Germany	4f6826f2-4ff6-443d-b966-e6913bd24013	79b597d8-f762-11e1-a439-00145eb45e9a
109	109	0	GBIF Germany	4f6826f2-4ff6-443d-b966-e6913bd24013	79c64092-f762-11e1-a439-00145eb45e9a
3090	1751	-1339	GBIF Germany	4f6826f2-4ff6-443d-b966-e6913bd24013	7a0ba2d6-f762-11e1-a439-00145eb45e9a
2894	2894	0	Korean Biodiversity Information Facility	e0a1e772-0177-4800-94b4-2d023fe6cdf4	7b0e1b14-f762-11e1-a439-00145eb45e9a
156	156	0	Ocean Biodiversity Information System	ba0670b9-4186-41e6-8e70-f9cb3065551a	7b6dd554-f762-11e1-a439-00145eb45e9a
11	11	0	GBIF Germany	4f6826f2-4ff6-443d-b966-e6913bd24013	7dde16c8-f762-11e1-a439-00145eb45e9a
0	772	772	Participant Node Managers Committee	7f48e0c8-5c96-49ec-b972-30748e339115	7f658a5f-72fa-4882-90bf-a986f514999b
1226	1226	0	GBIF Germany	4f6826f2-4ff6-443d-b966-e6913bd24013	818dc1d8-f762-11e1-a439-00145eb45e9a
170	170	0	GBIF Germany	4f6826f2-4ff6-443d-b966-e6913bd24013	8216499a-f762-11e1-a439-00145eb45e9a
30998	30998	0	Atlas of Living Australia	4a6f1b71-969e-4fc5-a693-282b05e1220c	82e218a4-f762-11e1-a439-00145eb45e9a
1208	1208	0	Atlas of Living Australia	4a6f1b71-969e-4fc5-a693-282b05e1220c	82eb67a6-f762-11e1-a439-00145eb45e9a
498736	498736	0	U.S. Geological Survey	8618c64a-93e0-4300-b546-7249e5148ed2	84ab7b76-f762-11e1-a439-00145eb45e9a
5234	5235	1	GBIF Germany	4f6826f2-4ff6-443d-b966-e6913bd24013	8590c99c-f762-11e1-a439-00145eb45e9a
0	5172	5172	Participant Node Managers Committee	7f48e0c8-5c96-49ec-b972-30748e339115	868e92bb-d93e-4fc9-886f-81149ec92ec2
1443	1160	-283	GBIF Germany	4f6826f2-4ff6-443d-b966-e6913bd24013	86bf21ec-f762-11e1-a439-00145eb45e9a
94	61	-33	GBIF Germany	4f6826f2-4ff6-443d-b966-e6913bd24013	871ce070-f762-11e1-a439-00145eb45e9a
43	33	-10	GBIF Germany	4f6826f2-4ff6-443d-b966-e6913bd24013	87419c08-f762-11e1-a439-00145eb45e9a
131	131	0	GBIF Germany	4f6826f2-4ff6-443d-b966-e6913bd24013	88252040-f762-11e1-a439-00145eb45e9a
28	7	-21	GBIF Germany	4f6826f2-4ff6-443d-b966-e6913bd24013	8865642a-f762-11e1-a439-00145eb45e9a
282	282	0	GBIF Germany	4f6826f2-4ff6-443d-b966-e6913bd24013	8a45f05c-f762-11e1-a439-00145eb45e9a
3	3	0	Plazi	ffb07bec-2d10-492d-9c37-361fe0b79427	8b24736e-68c8-486b-8af8-e0a1af952908
0	10	10	Plazi	ffb07bec-2d10-492d-9c37-361fe0b79427	8b82e556-ff8c-418e-8c03-320c952b0e3a
7	7	0	GBIF Germany	4f6826f2-4ff6-443d-b966-e6913bd24013	8bcc8b0c-f762-11e1-a439-00145eb45e9a
25	20	-5	GBIF Germany	4f6826f2-4ff6-443d-b966-e6913bd24013	8c90970e-f762-11e1-a439-00145eb45e9a
452	452	0	GBIF Germany	4f6826f2-4ff6-443d-b966-e6913bd24013	8d7b93e4-f762-11e1-a439-00145eb45e9a
48	12	-36	GBIF Germany	4f6826f2-4ff6-443d-b966-e6913bd24013	8dd42392-f762-11e1-a439-00145eb45e9a
74	19	-55	GBIF Germany	4f6826f2-4ff6-443d-b966-e6913bd24013	8ddefe20-f762-11e1-a439-00145eb45e9a
101	17	-84	GBIF Germany	4f6826f2-4ff6-443d-b966-e6913bd24013	8e0fa3b8-f762-11e1-a439-00145eb45e9a
12	12	0	Plazi	ffb07bec-2d10-492d-9c37-361fe0b79427	8eb6e6da-bfb9-40a0-b698-cbb1ef63d66e
3	3	0	GBIF Germany	4f6826f2-4ff6-443d-b966-e6913bd24013	8eec4732-f762-11e1-a439-00145eb45e9a
26915	26915	0	National Biodiversity Network	d897a5b9-35ee-4232-94bd-b0bcaac003c2	8ef263ab-fdea-4d63-b793-f3fa08841b2d
0	2	2	Plazi	ffb07bec-2d10-492d-9c37-361fe0b79427	8f13fe75-5503-4124-a1dc-fe32e5fb8120
6	6	0	Plazi	ffb07bec-2d10-492d-9c37-361fe0b79427	8f433d75-f6d5-4249-a019-42b838c9f20a
10	10	0	Plazi	ffb07bec-2d10-492d-9c37-361fe0b79427	8fd85c37-b1c5-49fe-9853-bee797b7a7e5
15927	15927	0	National Biodiversity Network	d897a5b9-35ee-4232-94bd-b0bcaac003c2	91b8e6ed-6771-4c39-a681-516fefd6d072
59	50	-9	GBIF Germany	4f6826f2-4ff6-443d-b966-e6913bd24013	92687b4c-f762-11e1-a439-00145eb45e9a
224	138	-86	GBIF Germany	4f6826f2-4ff6-443d-b966-e6913bd24013	92a95ad6-f762-11e1-a439-00145eb45e9a
0	2	2	Plazi	ffb07bec-2d10-492d-9c37-361fe0b79427	936bf523-7ddb-4a73-9ed7-dca59cbff055
15	15	0	GBIF Germany	4f6826f2-4ff6-443d-b966-e6913bd24013	9380c250-f762-11e1-a439-00145eb45e9a
2	2	0	GBIF Germany	4f6826f2-4ff6-443d-b966-e6913bd24013	938489e4-f762-11e1-a439-00145eb45e9a
24	24	0	GBIF Germany	4f6826f2-4ff6-443d-b966-e6913bd24013	93972c2a-f762-11e1-a439-00145eb45e9a
2	2	0	Plazi	ffb07bec-2d10-492d-9c37-361fe0b79427	94abe156-ba42-47c9-b3f4-584fa793e129
2353	1796	-557	GBIF Germany	4f6826f2-4ff6-443d-b966-e6913bd24013	95498928-f762-11e1-a439-00145eb45e9a
0	19	19	Plazi	ffb07bec-2d10-492d-9c37-361fe0b79427	96a956da-f886-4e59-9b3e-1932f2671d3d
19	19	0	Plazi	ffb07bec-2d10-492d-9c37-361fe0b79427	97eb2462-e968-4f36-81ab-fc2a832928ae
53	53	0	Plazi	ffb07bec-2d10-492d-9c37-361fe0b79427	98c8228e-a395-48d7-a988-4aa01c6936f8
193	193	0	GBIF France	da44cd31-5901-4687-a106-6d1c7734ee3a	9ec71442-958b-4275-a38c-d7fb937e11ce
4	4	0	Plazi	ffb07bec-2d10-492d-9c37-361fe0b79427	9fbc6f09-0c86-4d45-ac0a-709c5bdcd8c5
49	49	0	GBIF Brazil	cdc9736d-5ff7-4ece-9959-3c744360cdb3	a0472674-e2de-4620-942f-269007e118d5
8	8	0	Plazi	ffb07bec-2d10-492d-9c37-361fe0b79427	a1812e33-3729-490e-a444-2a46fa4395cc
2	2	0	Plazi	ffb07bec-2d10-492d-9c37-361fe0b79427	a55fd6ad-ccb7-4741-9580-a575bbf7e7fd
0	2	2	Plazi	ffb07bec-2d10-492d-9c37-361fe0b79427	a60dc5f9-4cdb-4689-ac94-b0d415592cee
13	13	0	Plazi	ffb07bec-2d10-492d-9c37-361fe0b79427	a83a3660-dffa-4f5c-9003-7cf68770168f
1	1	0	Plazi	ffb07bec-2d10-492d-9c37-361fe0b79427	a8b9540f-40d0-413e-9086-4e6f428d250c
374	374	0	Biodiversity Information System of Mexico	b324e8e9-9a4c-44fa-8f1a-7f39ea7ab576	aa6bf18d-4d34-417b-a009-3501002575af
60	60	0	GBIF Mauritania	a48482b4-725f-49e9-934d-2f572deaa361	ab596a6e-1c9f-4975-8092-8cc3380d2fc6
3	3	0	Plazi	ffb07bec-2d10-492d-9c37-361fe0b79427	ac717403-4bbb-4a44-b1ba-3f80264dc07e
5	5	0	Plazi	ffb07bec-2d10-492d-9c37-361fe0b79427	ad58c550-749d-414a-a85c-f49251e328c0
3	3	0	Plazi	ffb07bec-2d10-492d-9c37-361fe0b79427	ad9c1f20-5e3c-400f-9ca8-7a8c46347063
0	2	2	Plazi	ffb07bec-2d10-492d-9c37-361fe0b79427	afa77e0c-fc40-4daa-8fe4-2dc68fd9eac2
2513	2513	0	Biodiversity Information System of Mexico	b324e8e9-9a4c-44fa-8f1a-7f39ea7ab576	b23dae1f-1b66-432f-908b-be7737aff2b8
49339	49339	0	National Biodiversity Network	d897a5b9-35ee-4232-94bd-b0bcaac003c2	b56e76a0-2adb-4168-8d46-156a4fe7f10e
39	39	0	Plazi	ffb07bec-2d10-492d-9c37-361fe0b79427	b70dedd9-d080-4354-9ced-3928e81c63b6
2	2	0	Plazi	ffb07bec-2d10-492d-9c37-361fe0b79427	b7e564b2-a174-4a37-94cd-40051b16197d
0	27	27	Plazi	ffb07bec-2d10-492d-9c37-361fe0b79427	ba4e9443-94d7-4267-ba90-2514333cf2e2
6518	6518	0	Biodiversity Information System of Mexico	b324e8e9-9a4c-44fa-8f1a-7f39ea7ab576	ba7342d6-ede0-442c-a5e6-e965ad360851
185	185	0	GBIF Germany	4f6826f2-4ff6-443d-b966-e6913bd24013	bd38fae8-7f74-4940-bb7e-e69c7055658e
1	1	0	Plazi	ffb07bec-2d10-492d-9c37-361fe0b79427	bda38425-e50c-4d5e-8214-76fb96e0dff0
14	14	0	Plazi	ffb07bec-2d10-492d-9c37-361fe0b79427	c05e1804-fb7b-4e52-8f50-c82dbd4100d6
3032	3032	0	GBIF Estonia	2c11b821-d22b-4c64-8cd3-c1578173b129	cb6e66f1-3056-404d-a341-bb856762c57c
0	6	6	Plazi	ffb07bec-2d10-492d-9c37-361fe0b79427	cbcdb060-6372-4004-bcbb-327f8c67893d
7	7	0	Plazi	ffb07bec-2d10-492d-9c37-361fe0b79427	cc30a147-475f-41aa-a0cc-0517252c52fc
0	3	3	Plazi	ffb07bec-2d10-492d-9c37-361fe0b79427	ccbd2b65-3e07-454c-a80c-104b9fd304d2
177	177	0	GBIF Germany	4f6826f2-4ff6-443d-b966-e6913bd24013	cccf3842-f915-4eb3-b4b5-813790e601ca
8	8	0	Plazi	ffb07bec-2d10-492d-9c37-361fe0b79427	ce4e62c5-1d2a-478e-a0f3-1d2637e76f8e
372	372	0	South African Biodiversity Information Facility	7190b835-4e86-4b6e-85c1-19cc6677c250	cf2829a0-272b-4a2d-9e28-87b0ed88d829
41	21	-20	GBIF Germany	4f6826f2-4ff6-443d-b966-e6913bd24013	d1704fd0-974e-4b41-8bc0-211c8e850bbe
637628	637628	0	GBIF France	da44cd31-5901-4687-a106-6d1c7734ee3a	d38d6841-de2a-4a16-b39e-495402d8592b
0	2	2	Ocean Biodiversity Information System	ba0670b9-4186-41e6-8e70-f9cb3065551a	d4c9a544-0a59-4077-acdb-07860dd36b99
2	2	0	Plazi	ffb07bec-2d10-492d-9c37-361fe0b79427	d56a7790-5b2a-4bb2-8d3c-75f5dfe98ee1
976	976	0	Korean Biodiversity Information Facility	e0a1e772-0177-4800-94b4-2d023fe6cdf4	d870c5f8-5096-4054-aafa-27b7a26d2cee
1271	1271	0	Participant Node Managers Committee	7f48e0c8-5c96-49ec-b972-30748e339115	d888b684-3c55-44cd-b7d1-253d8cad1ca7
1	1	0	GBIF Brazil	cdc9736d-5ff7-4ece-9959-3c744360cdb3	df67f106-7c40-4ec9-a6da-378667fb405c
63	63	0	Plazi	ffb07bec-2d10-492d-9c37-361fe0b79427	e04784c0-e17d-4682-bc2c-3a901e9fce63
4	4	0	Plazi	ffb07bec-2d10-492d-9c37-361fe0b79427	e70e39cf-ffb6-4178-989c-6a42a3c0c3bf
35	35	0	Plazi	ffb07bec-2d10-492d-9c37-361fe0b79427	e8d5eead-b4cf-4c3c-ae8f-ac31a305baba
13	13	0	Secretariat of the Pacific Regional Environment Programme	29c6a139-ea7f-41f5-8d9b-c55af8736182	ec91f7af-286f-4a8d-8f32-cac13085363b
15	15	0	Plazi	ffb07bec-2d10-492d-9c37-361fe0b79427	eee60283-7896-4cf0-846c-a6c2ab9424db
0	32	32	Plazi	ffb07bec-2d10-492d-9c37-361fe0b79427	f248c45a-53fe-4cf8-bec0-c13e8aab9e9f
96276	96276	0	GBIF Norway	4f829580-180d-46a9-9c87-ed8ec959b545	f2a77c80-1e74-4c23-a3c9-c52cede89434
2	2	0	Plazi	ffb07bec-2d10-492d-9c37-361fe0b79427	f463aada-9f40-4254-84a5-3f86928f35d3
184	184	0	GBIF France	da44cd31-5901-4687-a106-6d1c7734ee3a	f50733b4-beaf-4255-ac43-689257dacb80
415	415	0	GBIF France	da44cd31-5901-4687-a106-6d1c7734ee3a	f91a7916-4974-4b3f-8186-b7a37f43e5d1
0	4	4	Ocean Biodiversity Information System	ba0670b9-4186-41e6-8e70-f9cb3065551a	fc771b82-ded0-4e69-9e89-089883b331da
0	2	2	Plazi	ffb07bec-2d10-492d-9c37-361fe0b79427	0178174a-5db2-4886-9493-e59bf591d439
0	412	412	Colombian Biodiversity Information System	7e865cba-7c46-417b-ade5-97f2cf5b7be0	024a7203-98a9-45d9-95db-a041c644905e
1	1	0	Plazi	ffb07bec-2d10-492d-9c37-361fe0b79427	04da8096-6a4c-44f8-901a-e4cbcb8bafcc
1691	1691	0	National Biodiversity Network	d897a5b9-35ee-4232-94bd-b0bcaac003c2	0b2bd45f-a171-4e7b-b6ec-ef368721727f
8	8	0	Biodiversity Information System of Mexico	b324e8e9-9a4c-44fa-8f1a-7f39ea7ab576	0c0665f3-69c7-4895-b990-becda73bd3d1
293	293	0	GBIF France	da44cd31-5901-4687-a106-6d1c7734ee3a	0c2774bb-db06-45ba-b71c-501e5c077a4d
24	24	0	Plazi	ffb07bec-2d10-492d-9c37-361fe0b79427	0df81c19-67d0-4593-a27f-189686b5435d
2599	2599	0	GBIF France	da44cd31-5901-4687-a106-6d1c7734ee3a	0f6a7e23-309e-4bbd-8126-d4edc1d1b7ea
60681	60687	6	U.S. Geological Survey	8618c64a-93e0-4300-b546-7249e5148ed2	10703862-f1d8-48a7-9853-dc65d8df1d86
29	29	0	Plazi	ffb07bec-2d10-492d-9c37-361fe0b79427	10af3127-3b6f-4332-928b-a0f40de1bd4f
0	4	4	Plazi	ffb07bec-2d10-492d-9c37-361fe0b79427	10d52e07-bc81-4176-adf1-9af558b27b33
0	11	11	Plazi	ffb07bec-2d10-492d-9c37-361fe0b79427	16533e21-bbe3-46c1-a4ba-70fca1112446
16	16	0	GBIF France	da44cd31-5901-4687-a106-6d1c7734ee3a	168d155d-681e-4a44-a4c0-47ef151ed434
5	5	0	Plazi	ffb07bec-2d10-492d-9c37-361fe0b79427	171e4276-5626-47dd-b6bf-ba7e7831a416
88	88	0	GBIF France	da44cd31-5901-4687-a106-6d1c7734ee3a	1a485922-36f1-4ee3-803a-c11bde0183ef
3	3	0	Plazi	ffb07bec-2d10-492d-9c37-361fe0b79427	1a869128-f012-4e30-867a-a1f950e6e990
0	30	30	GBIF France	da44cd31-5901-4687-a106-6d1c7734ee3a	1eeb3b55-61c1-49e0-ac61-74e554230d02
240	240	0	GBIF Germany	4f6826f2-4ff6-443d-b966-e6913bd24013	1f7fa6e8-2e65-45ba-bc13-9ab6c707d13b
0	26107	26107	U.S. Geological Survey	8618c64a-93e0-4300-b546-7249e5148ed2	265a1266-6e01-459e-9d1a-3127c9b222ed
360	340	-20	GBIF Germany	4f6826f2-4ff6-443d-b966-e6913bd24013	2a8c5e7d-4dc3-4a7e-9441-18c40fdc5fc1
88	88	0	Plazi	ffb07bec-2d10-492d-9c37-361fe0b79427	2bc1e4d3-59c5-4f54-91da-3daf478277d6
76	76	0	Plazi	ffb07bec-2d10-492d-9c37-361fe0b79427	2dd79a39-b22f-4b17-a541-3b0b40bfb216
0	12	12	Plazi	ffb07bec-2d10-492d-9c37-361fe0b79427	2e697ef5-3591-4c49-a68c-e32c4d395d7d
2572	2572	0	National Biodiversity Network	d897a5b9-35ee-4232-94bd-b0bcaac003c2	2ef11e3b-275c-4f37-b33f-ac2f6978f0e8
0	1177	1177	Participant Node Managers Committee	7f48e0c8-5c96-49ec-b972-30748e339115	2fedc948-4dd1-49d9-8cf8-e22da125801b
0	12991	12991	Ocean Biodiversity Information System	ba0670b9-4186-41e6-8e70-f9cb3065551a	3558b1b0-9349-4125-b611-1c13a8a00564
14	14	0	Participant Node Managers Committee	7f48e0c8-5c96-49ec-b972-30748e339115	3578a610-9401-4d52-9d06-69042e9b3543
1	1	0	Plazi	ffb07bec-2d10-492d-9c37-361fe0b79427	3a7ba1d8-e4fc-45e0-8696-b7540737e6aa
3	3	0	Plazi	ffb07bec-2d10-492d-9c37-361fe0b79427	3aab0fbe-cdf3-4a6d-893a-52e5cf4a3ea3
16	16	0	Plazi	ffb07bec-2d10-492d-9c37-361fe0b79427	3b0522dd-7d00-48cb-bfe2-0ad31ae352e5
6	6	0	Plazi	ffb07bec-2d10-492d-9c37-361fe0b79427	3c6d1ffd-6313-4471-bfeb-3e8a3608392f
7	7	0	Plazi	ffb07bec-2d10-492d-9c37-361fe0b79427	3dfbfcb5-aec2-45b9-81c4-ae176b4802cc
8	8	0	Participant Node Managers Committee	7f48e0c8-5c96-49ec-b972-30748e339115	4218c051-e33f-4653-bde2-927ea3601441
0	3	3	Plazi	ffb07bec-2d10-492d-9c37-361fe0b79427	45ca7f8c-613f-4483-b46c-7c2ed083a54a
7251	7251	0	GBIF France	da44cd31-5901-4687-a106-6d1c7734ee3a	47bbfddf-0e5f-4182-9725-c4f1f718732b
2	2	0	Plazi	ffb07bec-2d10-492d-9c37-361fe0b79427	4d45525c-5a3e-4e37-a64a-bbf25ba47313
92	92	0	GBIF Finland	dd514216-5c7c-45f3-910d-797424cb5be6	4ee3ee64-8ca4-4d5e-871e-09f437ae86df
2	2	0	Plazi	ffb07bec-2d10-492d-9c37-361fe0b79427	4f3f1965-6d8b-4382-8657-50b1d38e1f2e
0	6	6	Plazi	ffb07bec-2d10-492d-9c37-361fe0b79427	525fc81f-38b1-4fe0-8b1b-88b48608310e
1329271	1509759	180488	GBIF Spain	1f94b3ca-9345-4d65-afe2-4bace93aa0fe	52f2051b-c47e-403a-8e32-04b2f2273c20
368	368	0	Biodiversity Information System of Mexico	b324e8e9-9a4c-44fa-8f1a-7f39ea7ab576	53eae626-cd38-4916-9cbd-3182158bd993
31	31	0	Plazi	ffb07bec-2d10-492d-9c37-361fe0b79427	545aa4ea-1874-4f74-a4c4-a2aeb97ed657
218	218	0	Colombian Biodiversity Information System	7e865cba-7c46-417b-ade5-97f2cf5b7be0	54b18767-cf20-4a1a-a868-45ada0e83e41
0	3	3	Plazi	ffb07bec-2d10-492d-9c37-361fe0b79427	558ae6cd-0f5b-415b-8690-d5a0943c8116
9000	9000	0	Participant Node Managers Committee	7f48e0c8-5c96-49ec-b972-30748e339115	5788c83a-0e0a-42c1-8fcd-3b27ce7a672a
0	120	120	Ocean Biodiversity Information System	ba0670b9-4186-41e6-8e70-f9cb3065551a	5a50138e-b9b3-40fa-b9b9-090abc36b999
9530	9530	0	GBIF France	da44cd31-5901-4687-a106-6d1c7734ee3a	5e48d5d1-24fe-4795-bca2-4a03d51e4454
1374	1374	0	GBIF France	da44cd31-5901-4687-a106-6d1c7734ee3a	5e86b9ae-22bc-4de9-9b6e-61312782041d
69	69	0	GBIF Germany	4f6826f2-4ff6-443d-b966-e6913bd24013	61621940-f762-11e1-a439-00145eb45e9a
386	386	0	GBIF Germany	4f6826f2-4ff6-443d-b966-e6913bd24013	61bf9a01-ddca-4319-a9ea-2cd586be389b
53	53	0	GBIF Germany	4f6826f2-4ff6-443d-b966-e6913bd24013	62720fca-f762-11e1-a439-00145eb45e9a
42854	42854	0	National Biodiversity Network	d897a5b9-35ee-4232-94bd-b0bcaac003c2	62db49d6-860a-48cc-a651-b8ba6d94386c
0	40	40	Ocean Biodiversity Information System	ba0670b9-4186-41e6-8e70-f9cb3065551a	63d57228-0c6b-4f7e-83c8-5699fc773157
13450	13450	0	GBIF Israel	8cb55387-7802-40e8-86d6-d357a583c596	647ae6f8-8e26-4189-b448-02b45b7ad884
63	63	0	GBIF Germany	4f6826f2-4ff6-443d-b966-e6913bd24013	64800c2c-f762-11e1-a439-00145eb45e9a
25	25	0	GBIF Germany	4f6826f2-4ff6-443d-b966-e6913bd24013	64b9b26a-f762-11e1-a439-00145eb45e9a
693	693	0	GBIF Germany	4f6826f2-4ff6-443d-b966-e6913bd24013	6544b0a4-f762-11e1-a439-00145eb45e9a
159	159	0	GBIF Germany	4f6826f2-4ff6-443d-b966-e6913bd24013	663ef8fc-f762-11e1-a439-00145eb45e9a
51	51	0	GBIF Germany	4f6826f2-4ff6-443d-b966-e6913bd24013	67276f10-f762-11e1-a439-00145eb45e9a
63	63	0	GBIF Germany	4f6826f2-4ff6-443d-b966-e6913bd24013	6776fb70-f762-11e1-a439-00145eb45e9a
0	3	3	Plazi	ffb07bec-2d10-492d-9c37-361fe0b79427	684ba2d4-1239-41ff-813c-95ef2b795d15
82	82	0	Participant Node Managers Committee	7f48e0c8-5c96-49ec-b972-30748e339115	69a5c009-8beb-465b-9c27-55f9d8baf716
1553	1553	0	GBIF Argentina	2426a871-9feb-40a1-96c6-0c593a76b835	69d34c60-554c-4db3-82fb-fb091ebd7eff
1	1	0	Plazi	ffb07bec-2d10-492d-9c37-361fe0b79427	6a817715-356d-44bc-827a-d27d10c264c8
4	4	0	GBIF Germany	4f6826f2-4ff6-443d-b966-e6913bd24013	6b5dfc16-f762-11e1-a439-00145eb45e9a
0	21	21	Plazi	ffb07bec-2d10-492d-9c37-361fe0b79427	6c3bffa2-7772-4310-9d46-fda74a0a10a3
22	22	0	GBIF Germany	4f6826f2-4ff6-443d-b966-e6913bd24013	6cb62fa2-f762-11e1-a439-00145eb45e9a
117169	117169	0	U.S. Geological Survey	8618c64a-93e0-4300-b546-7249e5148ed2	6dc35c87-ff97-4708-9e45-6f764ddc1ef3
48	48	0	Atlas of Living Australia	4a6f1b71-969e-4fc5-a693-282b05e1220c	6f4fc23c-09fb-4307-8079-15eb970f7c9f
135	135	0	Plazi	ffb07bec-2d10-492d-9c37-361fe0b79427	70ec409b-10b2-459d-bd98-e3e45b41f3a9
10	10	0	Plazi	ffb07bec-2d10-492d-9c37-361fe0b79427	710c183e-b0f2-4955-8985-cd90a15a4ac2
0	2	2	Plazi	ffb07bec-2d10-492d-9c37-361fe0b79427	72328566-2e20-45b1-887a-649163252ee8
15	15	0	GBIF Germany	4f6826f2-4ff6-443d-b966-e6913bd24013	729d5a44-f762-11e1-a439-00145eb45e9a
6	6	0	GBIF Germany	4f6826f2-4ff6-443d-b966-e6913bd24013	73a79d6e-f762-11e1-a439-00145eb45e9a
100	100	0	GBIF Germany	4f6826f2-4ff6-443d-b966-e6913bd24013	74264f88-f762-11e1-a439-00145eb45e9a
67	67	0	GBIF Germany	4f6826f2-4ff6-443d-b966-e6913bd24013	745f6d7c-f762-11e1-a439-00145eb45e9a
0	58	58	Participant Node Managers Committee	7f48e0c8-5c96-49ec-b972-30748e339115	75e3bee0-27df-48e7-8d37-084256594cef
10246	10246	0	GBIF Brazil	cdc9736d-5ff7-4ece-9959-3c744360cdb3	7633580b-bfb5-4000-9b4a-f983ea0d4c57
730	730	0	GBIF France	da44cd31-5901-4687-a106-6d1c7734ee3a	771d6bb0-0b97-4aee-9d76-48cc83f6360c
3	3	0	Plazi	ffb07bec-2d10-492d-9c37-361fe0b79427	78096464-2861-4dfc-9dc2-f5d84078f80f
0	110	110	Ocean Biodiversity Information System	ba0670b9-4186-41e6-8e70-f9cb3065551a	78ba1f25-0d75-48d6-83bc-86b8bc0f28cd
13	13	0	GBIF Germany	4f6826f2-4ff6-443d-b966-e6913bd24013	78badea6-f762-11e1-a439-00145eb45e9a
192	192	0	GBIF Germany	4f6826f2-4ff6-443d-b966-e6913bd24013	7a71459b-3076-45af-9f1e-bbc085d3b419
934	934	0	GBIF France	da44cd31-5901-4687-a106-6d1c7734ee3a	7b387efa-8ad9-4520-afd9-16af70f6a416
337	337	0	National Biodiversity Network	d897a5b9-35ee-4232-94bd-b0bcaac003c2	7b3c668a-7f83-4f30-99d4-e1eadca41fbe
114357	114357	0	DanBIF - Danish Biodiversity Information Facility	4ddd294f-02b7-4359-ac33-0806a9ca9c6b	7b5bc5ba-4972-4876-b35a-3f9aac590fe5
339	339	0	GBIF Germany	4f6826f2-4ff6-443d-b966-e6913bd24013	7bbfef2e-f762-11e1-a439-00145eb45e9a
80	70	-10	GBIF Germany	4f6826f2-4ff6-443d-b966-e6913bd24013	7d9b138c-f762-11e1-a439-00145eb45e9a
42	42	0	Plazi	ffb07bec-2d10-492d-9c37-361fe0b79427	7e7ce782-0d14-4c1a-ae07-458d3df47dac
77	77	0	GBIF Germany	4f6826f2-4ff6-443d-b966-e6913bd24013	7ee002a2-f762-11e1-a439-00145eb45e9a
14	14	0	Plazi	ffb07bec-2d10-492d-9c37-361fe0b79427	7f509167-6b0d-4a3f-a0ba-f9c69808d0fd
5310	5310	0	Biodiversity Information System of Mexico	b324e8e9-9a4c-44fa-8f1a-7f39ea7ab576	7f9894f2-f762-11e1-a439-00145eb45e9a
5892	5892	0	Biodiversity Information System of Mexico	b324e8e9-9a4c-44fa-8f1a-7f39ea7ab576	80609448-f762-11e1-a439-00145eb45e9a
0	1	1	Plazi	ffb07bec-2d10-492d-9c37-361fe0b79427	80797411-00f5-414d-b9d7-f31b049a7b07
44	44	0	GBIF Germany	4f6826f2-4ff6-443d-b966-e6913bd24013	818a01e2-f762-11e1-a439-00145eb45e9a
17334	17334	0	GBIF Spain	1f94b3ca-9345-4d65-afe2-4bace93aa0fe	835bf26e-f762-11e1-a439-00145eb45e9a
50	50	0	Participant Node Managers Committee	7f48e0c8-5c96-49ec-b972-30748e339115	868108e2-66d8-4a6f-bf34-b5d230de3d45
84	84	0	Plazi	ffb07bec-2d10-492d-9c37-361fe0b79427	8693c7c6-1b69-4f15-aa74-1070d53c16a1
2957	2493	-464	GBIF Germany	4f6826f2-4ff6-443d-b966-e6913bd24013	870a8380-f762-11e1-a439-00145eb45e9a
1	1	0	GBIF France	da44cd31-5901-4687-a106-6d1c7734ee3a	87e0cd6f-bd44-4654-86b9-3f347a8ef225
2	2	0	Plazi	ffb07bec-2d10-492d-9c37-361fe0b79427	887812f6-db65-401a-a7ac-c3ad96c1aa34
177	177	0	GBIF Germany	4f6826f2-4ff6-443d-b966-e6913bd24013	89c3bea2-f762-11e1-a439-00145eb45e9a
58	58	0	GBIF Germany	4f6826f2-4ff6-443d-b966-e6913bd24013	8a5fc6f8-f762-11e1-a439-00145eb45e9a
17	17	0	Plazi	ffb07bec-2d10-492d-9c37-361fe0b79427	8bf7deb9-6336-4232-aa5f-cf6805630d2a
18	17	-1	GBIF Germany	4f6826f2-4ff6-443d-b966-e6913bd24013	8cbb6ae2-f762-11e1-a439-00145eb45e9a
1	1	0	Plazi	ffb07bec-2d10-492d-9c37-361fe0b79427	8d7baec4-4e6a-4ebb-95e6-bc67cb11cbe9
41	41	0	GBIF Germany	4f6826f2-4ff6-443d-b966-e6913bd24013	8dc199a2-f762-11e1-a439-00145eb45e9a
451	400	-51	GBIF Germany	4f6826f2-4ff6-443d-b966-e6913bd24013	8ebd8c4e-f762-11e1-a439-00145eb45e9a
368	368	0	GBIF Germany	4f6826f2-4ff6-443d-b966-e6913bd24013	8ef1c5f4-f762-11e1-a439-00145eb45e9a
4	3	-1	GBIF Germany	4f6826f2-4ff6-443d-b966-e6913bd24013	90c5f972-f762-11e1-a439-00145eb45e9a
6	6	0	Plazi	ffb07bec-2d10-492d-9c37-361fe0b79427	910a9389-d10e-4f66-a986-4f08e222e5a4
194	160	-34	GBIF Germany	4f6826f2-4ff6-443d-b966-e6913bd24013	915329dc-f762-11e1-a439-00145eb45e9a
1100	550	-550	GBIF Germany	4f6826f2-4ff6-443d-b966-e6913bd24013	919cb0f2-f762-11e1-a439-00145eb45e9a
2399	2399	0	National Biodiversity Network	d897a5b9-35ee-4232-94bd-b0bcaac003c2	91f232c7-607a-42a2-b823-78869187fe50
358	358	0	GBIF France	da44cd31-5901-4687-a106-6d1c7734ee3a	9205866b-4248-4ce6-935c-645c7624c559
16	16	0	GBIF Germany	4f6826f2-4ff6-443d-b966-e6913bd24013	92a565c0-f762-11e1-a439-00145eb45e9a
65	39	-26	GBIF Germany	4f6826f2-4ff6-443d-b966-e6913bd24013	93335b0a-f762-11e1-a439-00145eb45e9a
716	716	0	National Biodiversity Network	d897a5b9-35ee-4232-94bd-b0bcaac003c2	938966ef-8944-46d5-a58a-8df1f710a362
13	13	0	GBIF Germany	4f6826f2-4ff6-443d-b966-e6913bd24013	93ab538a-f762-11e1-a439-00145eb45e9a
0	3	3	Ocean Biodiversity Information System	ba0670b9-4186-41e6-8e70-f9cb3065551a	946f9b88-9570-41ef-95d4-0040a92627fb
3	3	0	Plazi	ffb07bec-2d10-492d-9c37-361fe0b79427	951c3959-2717-4e20-a943-7db40bc8453d
573	542	-31	GBIF Germany	4f6826f2-4ff6-443d-b966-e6913bd24013	953d5932-f762-11e1-a439-00145eb45e9a
0	248	248	Ocean Biodiversity Information System	ba0670b9-4186-41e6-8e70-f9cb3065551a	9a6a23bc-688f-4e31-9461-3ee3352575fa
0	1	1	Plazi	ffb07bec-2d10-492d-9c37-361fe0b79427	9b0a74cf-d16d-49be-bec7-64f24d699240
0	66	66	Ocean Biodiversity Information System	ba0670b9-4186-41e6-8e70-f9cb3065551a	9bbb61b9-ba4b-4360-81e0-6ae988e9f405
20	20	0	GBIF Sweden	a0b3be64-6525-4387-ac67-a499950f92e1	9c7c04db-547f-4161-9a5c-3a565429ec30
2	2	0	Plazi	ffb07bec-2d10-492d-9c37-361fe0b79427	9e74e9ee-be1b-425e-90f4-f233191c55fe
22	22	0	Plazi	ffb07bec-2d10-492d-9c37-361fe0b79427	9eb7e698-020f-4228-a1f3-c59327adad28
17621	17621	0	GBIF France	da44cd31-5901-4687-a106-6d1c7734ee3a	9fd6c3da-88f7-4df7-9a3f-3f3f9c703998
0	11605	11605	U.S. Geological Survey	8618c64a-93e0-4300-b546-7249e5148ed2	a0344d4c-1618-4765-9964-595269c8b334
0	7	7	Participant Node Managers Committee	7f48e0c8-5c96-49ec-b972-30748e339115	a1b03ce6-19f0-44b4-8dd9-ef68fe7bf180
198	198	0	Plazi	ffb07bec-2d10-492d-9c37-361fe0b79427	a3ea0a39-5d5d-4f18-a4b2-4c3aa667f06f
11	11	0	Plazi	ffb07bec-2d10-492d-9c37-361fe0b79427	a66592b8-63a8-4c2d-9471-e58ddb2c0559
0	29986	29986	GBIF Portugal	673f7038-4262-4149-b753-5658a4e912f6	a9b8c7d0-3a2b-4edb-8b7a-0e55f007b332
173	173	0	GBIF France	da44cd31-5901-4687-a106-6d1c7734ee3a	aa0d5449-d25e-451b-95eb-a5d7d112135c
59	59	0	Colombian Biodiversity Information System	7e865cba-7c46-417b-ade5-97f2cf5b7be0	ab4847c4-d1da-4a64-a022-11a13dca65a1
2467	2467	0	GBIF France	da44cd31-5901-4687-a106-6d1c7734ee3a	abf9b70d-8d79-4444-ba75-7aa8039f55bc
111	111	0	GBIF France	da44cd31-5901-4687-a106-6d1c7734ee3a	adcdeb1e-83ed-4b4d-b955-63c244c22e67
70	70	0	GBIF France	da44cd31-5901-4687-a106-6d1c7734ee3a	ae2fcce1-6c5f-4188-b3aa-8f34c1ab6ceb
3854	3854	0	GBIF France	da44cd31-5901-4687-a106-6d1c7734ee3a	aed76db5-bf6c-40f1-a5b3-542040a83185
9	9	0	Plazi	ffb07bec-2d10-492d-9c37-361fe0b79427	b0c3c201-4426-4512-8505-cb0a70e6ca65
0	8	8	Plazi	ffb07bec-2d10-492d-9c37-361fe0b79427	b2771290-8220-4e0c-8753-82429ba63e80
0	13	13	Plazi	ffb07bec-2d10-492d-9c37-361fe0b79427	b2b137ff-1010-4254-9d92-89b1325998db
0	4	4	Plazi	ffb07bec-2d10-492d-9c37-361fe0b79427	b569524f-ad28-4738-8370-7420355b600c
5592	5592	0	Biodiversity Information System of Mexico	b324e8e9-9a4c-44fa-8f1a-7f39ea7ab576	b6242377-797c-4f9b-b60a-25626bceb089
3	3	0	Plazi	ffb07bec-2d10-492d-9c37-361fe0b79427	b70119b4-6b49-4e87-a1b4-ff33339ed699
75	75	0	GBIF France	da44cd31-5901-4687-a106-6d1c7734ee3a	b71eaf28-9fe8-443a-ad54-0289b1f7dd44
1	1	0	Plazi	ffb07bec-2d10-492d-9c37-361fe0b79427	b79707bf-a40a-4a2a-8b2b-4b8b6c553fcf
830	830	0	Plazi	ffb07bec-2d10-492d-9c37-361fe0b79427	b91775a1-1123-41b5-9430-8a87164f966f
0	77	77	GBIF Iceland	4dbdcae6-9ac9-4005-ac15-4a95a3eb7701	bc743b0b-0df3-4b17-a9d6-1689d19fb8ce
1	1	0	National Biodiversity Network	d897a5b9-35ee-4232-94bd-b0bcaac003c2	bc7f3949-12ab-48e2-981f-dd439b28be0f
942	942	0	GBIF Spain	1f94b3ca-9345-4d65-afe2-4bace93aa0fe	bf01b611-e6c1-416e-b8a7-ca1e917a7634
0	25	25	Ocean Biodiversity Information System	ba0670b9-4186-41e6-8e70-f9cb3065551a	c1a3e41d-6d92-4509-a6f5-659e8b9f8565
0	43	43	GBIF France	da44cd31-5901-4687-a106-6d1c7734ee3a	c365bdf2-5cb3-4cdd-83ff-1872e49816e1
6	6	0	Plazi	ffb07bec-2d10-492d-9c37-361fe0b79427	c536f3b9-71f6-47f4-abcd-c4165ef1aed4
0	2	2	Plazi	ffb07bec-2d10-492d-9c37-361fe0b79427	c58193f5-3dc5-4ce6-b06e-308ef686e3e8
0	3484	3484	Ocean Biodiversity Information System	ba0670b9-4186-41e6-8e70-f9cb3065551a	c75cf966-d8b9-4c9e-9524-ac63faf2a21a
697	697	0	Korean Biodiversity Information Facility	e0a1e772-0177-4800-94b4-2d023fe6cdf4	c7c36b72-0895-4704-9ea1-ee7e502fbf07
6	6	0	Plazi	ffb07bec-2d10-492d-9c37-361fe0b79427	c9fe4006-c679-4b87-974d-f6f28afedc30
0	18	18	Plazi	ffb07bec-2d10-492d-9c37-361fe0b79427	ca9e3191-5db3-40d0-9bf1-4edf96f91a59
0	81	81	Plazi	ffb07bec-2d10-492d-9c37-361fe0b79427	cb03700a-fa68-425f-9546-f580382a091c
570	570	0	Ocean Biodiversity Information System	ba0670b9-4186-41e6-8e70-f9cb3065551a	cefd283f-acf1-4da1-a46a-b5079925a6e8
6	6	0	Participant Node Managers Committee	7f48e0c8-5c96-49ec-b972-30748e339115	cf2dcb75-0688-412b-a00d-59789e0768b4
33	33	0	Plazi	ffb07bec-2d10-492d-9c37-361fe0b79427	d226f633-d454-4e32-b12f-6d00c30bddfc
6	6	0	Plazi	ffb07bec-2d10-492d-9c37-361fe0b79427	d2a51b67-36a4-48c9-8ad1-1e213d4ec0e9
0	2	2	Plazi	ffb07bec-2d10-492d-9c37-361fe0b79427	d42b793f-013f-404f-982a-8d6115c2df94
438	438	0	GBIF Japan	db5705aa-6a6e-42f1-8942-d77b9f4896ea	d5d92045-cbd8-453a-9b4e-25a7b74c51c5
0	4	4	Plazi	ffb07bec-2d10-492d-9c37-361fe0b79427	d7307847-c272-43c7-84ca-213e1995975e
0	25	25	Plazi	ffb07bec-2d10-492d-9c37-361fe0b79427	d7d8ccff-7a58-4fc8-9eec-c2588b457d56
185792	185787	-5	GBIF Brazil	cdc9736d-5ff7-4ece-9959-3c744360cdb3	d82d5a18-0428-4e52-be16-f509153e8126
4	4	0	Plazi	ffb07bec-2d10-492d-9c37-361fe0b79427	d844ca14-6c6b-48e3-8a04-3b9490944ea4
29	29	0	Colombian Biodiversity Information System	7e865cba-7c46-417b-ade5-97f2cf5b7be0	d8983f85-dc76-416b-874a-626ccc439a17
1	1	0	Plazi	ffb07bec-2d10-492d-9c37-361fe0b79427	da8a0035-89c0-42db-8a5c-b154adac9900
71	71	0	Plazi	ffb07bec-2d10-492d-9c37-361fe0b79427	dc2674e2-e260-4b6e-ad3a-731d610bccc5
29	29	0	Plazi	ffb07bec-2d10-492d-9c37-361fe0b79427	dd19a534-4d21-4340-8acc-4f68a0f2a8aa
19633	19868	235	GBIF Brazil	cdc9736d-5ff7-4ece-9959-3c744360cdb3	dd760e14-7304-40a3-8d53-8aba23f569ce
12	12	0	Plazi	ffb07bec-2d10-492d-9c37-361fe0b79427	dea4639d-b50c-4987-b209-e99ffac69ae3
358	358	0	Colombian Biodiversity Information System	7e865cba-7c46-417b-ade5-97f2cf5b7be0	dfc4e080-b04a-447d-b1c3-3c2782813fc5
2829	2829	0	GBIF Brazil	cdc9736d-5ff7-4ece-9959-3c744360cdb3	dfd343d9-db84-4114-a6df-2b0beb8cd28e
6	6	0	Plazi	ffb07bec-2d10-492d-9c37-361fe0b79427	dfdc4db4-0057-411a-8ea7-a1c437c44b56
0	2442	2442	Participant Node Managers Committee	7f48e0c8-5c96-49ec-b972-30748e339115	e696401e-be79-4499-9b2f-4c4fbd2e7855
0	10	10	Plazi	ffb07bec-2d10-492d-9c37-361fe0b79427	e8e002a8-e417-434d-8f04-40c856de8518
2741	2789	48	GBIF Norway	4f829580-180d-46a9-9c87-ed8ec959b545	e92bb2ed-1efe-4d2a-a17d-52182c562db8
2415	2415	0	GBIF France	da44cd31-5901-4687-a106-6d1c7734ee3a	eadbd385-3683-4411-9221-80a2b669fa29
0	9	9	Plazi	ffb07bec-2d10-492d-9c37-361fe0b79427	f1561aec-5853-4a94-8054-70e80e4614fc
0	4	4	Plazi	ffb07bec-2d10-492d-9c37-361fe0b79427	f324cddb-e410-471d-94e5-d2462a373295
25	25	0	GBIF Japan	db5705aa-6a6e-42f1-8942-d77b9f4896ea	f3b40fa3-d59c-4149-96bd-68f9d1b8390c
0	4	4	Plazi	ffb07bec-2d10-492d-9c37-361fe0b79427	f4088ac1-11f6-4418-aaa2-98cdc9df19eb
2555	2555	0	Biodiversity Information System of Mexico	b324e8e9-9a4c-44fa-8f1a-7f39ea7ab576	f539f857-d9be-4342-a26d-fb6033fb9c1d
549	549	0	GBIF Brazil	cdc9736d-5ff7-4ece-9959-3c744360cdb3	f5407269-2da3-432d-a893-15a407d3810e
0	7	7	Plazi	ffb07bec-2d10-492d-9c37-361fe0b79427	f5c1cc3b-055c-41a7-8b9b-80a136141bad
25583	28166	2583	GBIF Japan	db5705aa-6a6e-42f1-8942-d77b9f4896ea	f803520b-ea49-4dec-b71c-2e36f0974253
1600	1600	0	GBIF Portugal	673f7038-4262-4149-b753-5658a4e912f6	f8f60588-ccd0-4721-92c6-a330fb203344
10	10	0	Plazi	ffb07bec-2d10-492d-9c37-361fe0b79427	f9cab1e7-a096-4f4c-8d25-a187be8df9ff
5251	5251	0	National Biodiversity Network	d897a5b9-35ee-4232-94bd-b0bcaac003c2	fc8ea08f-b6c8-4b33-91e9-1a94d459dc43
155	155	0	GBIF Germany	4f6826f2-4ff6-443d-b966-e6913bd24013	034b2c15-aba3-4eb9-ae64-7ecdddfb349d
3	3	0	Participant Node Managers Committee	7f48e0c8-5c96-49ec-b972-30748e339115	07029e9e-48af-4335-a3cd-3130a372a562
0	9	9	Plazi	ffb07bec-2d10-492d-9c37-361fe0b79427	077daeb1-8bd4-4832-8caa-21a475f1b091
3592	3592	0	Netherlands Biodiversity Information Facility	0909d601-bda2-42df-9e63-a6d51847ebce	0cee5d00-6166-11de-84be-b8a03c50a862
9	9	0	Plazi	ffb07bec-2d10-492d-9c37-361fe0b79427	0e53d94a-5563-4f09-9608-762d7e48fee2
22	22	0	Plazi	ffb07bec-2d10-492d-9c37-361fe0b79427	10385458-559f-4ed9-a5dc-5cef14b8e9e4
34	34	0	Plazi	ffb07bec-2d10-492d-9c37-361fe0b79427	10b36454-4441-4819-aeda-7f5606ef6fa9
185	185	0	GBIF France	da44cd31-5901-4687-a106-6d1c7734ee3a	11c7ec66-ccd9-4367-8f02-6fd40f51611a
3	3	0	Plazi	ffb07bec-2d10-492d-9c37-361fe0b79427	139e23bc-6e7b-4e55-8bd9-f1939475c8d6
232	232	0	Plazi	ffb07bec-2d10-492d-9c37-361fe0b79427	14597991-8ac8-4290-b2c8-133e4c4329d0
9	9	0	Plazi	ffb07bec-2d10-492d-9c37-361fe0b79427	14ee1f26-3b50-49f0-8126-1d5fcf9b1f46
11	11	0	Plazi	ffb07bec-2d10-492d-9c37-361fe0b79427	162ad8f8-13c6-4028-b569-e96be69315ac
6622	6622	0	GBIF France	da44cd31-5901-4687-a106-6d1c7734ee3a	166cbacd-528a-4a84-b1db-0177b50ac946
0	166	166	GBIF France	da44cd31-5901-4687-a106-6d1c7734ee3a	16950930-0064-4e16-ac4f-64934117ba4c
0	350	350	GBIF Chile	a8b16421-d80b-4ef3-8f22-098b01a89255	1a2e75a2-d179-4162-aec5-8d1025ee7954
35	35	0	Plazi	ffb07bec-2d10-492d-9c37-361fe0b79427	1a827faf-4ba6-4e0a-99f7-134104627212
901	901	0	GBIF Germany	4f6826f2-4ff6-443d-b966-e6913bd24013	1c44821f-1125-4ba0-89ae-695268962cf8
117126	117126	0	GBIF New Zealand	4f9fd726-20dd-445e-89a1-8ed93792276f	1cc1bd52-369e-4e54-b351-e7beacfda698
72	72	0	GBIF Portugal	673f7038-4262-4149-b753-5658a4e912f6	1f061e7b-a44a-41db-b48d-f70997160019
174621	175691	1070	U.S. Geological Survey	8618c64a-93e0-4300-b546-7249e5148ed2	1f2cfb6f-c91b-498e-80f3-8eeeec688292
1494	1494	0	GBIF Portugal	673f7038-4262-4149-b753-5658a4e912f6	211266f9-30e9-4260-acdb-f8e2e2c37974
62	62	0	GBIF France	da44cd31-5901-4687-a106-6d1c7734ee3a	21667901-5c18-4a2e-b26e-e05b951754ce
50	50	0	Plazi	ffb07bec-2d10-492d-9c37-361fe0b79427	24db334d-8e18-4158-a02b-84e08c9fefd3
4	4	0	Plazi	ffb07bec-2d10-492d-9c37-361fe0b79427	30994b77-8f7d-4d5b-bcde-9139bd22a937
13	13	0	Plazi	ffb07bec-2d10-492d-9c37-361fe0b79427	30f1e991-09b6-4ca4-b13a-5bb3c4318ef1
0	32	32	Plazi	ffb07bec-2d10-492d-9c37-361fe0b79427	330b4589-7947-450b-857f-812cb72beb6d
12109	12109	0	Colombian Biodiversity Information System	7e865cba-7c46-417b-ade5-97f2cf5b7be0	371b386a-d67b-4646-897e-a27cc1101067
2329	2329	0	GBIF Benin	efb9c00e-f802-45dd-8826-a52ec45b89ff	37d71109-216b-461d-b3a4-a100eef077cc
97	97	0	Biodiversity Information System of Mexico	b324e8e9-9a4c-44fa-8f1a-7f39ea7ab576	38b988d2-c0b6-4d89-a358-35a1e372a877
933265	933265	0	National Biodiversity Network	d897a5b9-35ee-4232-94bd-b0bcaac003c2	3a0e9440-0a97-4a04-8089-7398c77da0be
7	7	0	Plazi	ffb07bec-2d10-492d-9c37-361fe0b79427	3c82fb79-a325-4d9c-9d02-7da4af90ed6e
9	9	0	Plazi	ffb07bec-2d10-492d-9c37-361fe0b79427	3dfc64e7-8c23-456d-9678-1bb0858ac470
0	5	5	Plazi	ffb07bec-2d10-492d-9c37-361fe0b79427	3e8abb3e-8e3f-4075-b548-e42def5046ef
20	20	0	Plazi	ffb07bec-2d10-492d-9c37-361fe0b79427	3f271fad-0174-4cd5-b641-b19327e8fd84
0	6	6	Plazi	ffb07bec-2d10-492d-9c37-361fe0b79427	3f677063-d4b0-476d-bda4-65c8b5b89c84
8	8	0	Plazi	ffb07bec-2d10-492d-9c37-361fe0b79427	41e6ddc4-f402-4e0c-8438-d8498be47a7d
645	645	0	U.S. Geological Survey	8618c64a-93e0-4300-b546-7249e5148ed2	423d9318-4dd4-4d31-81cb-27778c44a3bc
51	51	0	Canada Biodiversity Information Facility	8f83fc96-c966-4126-83f7-bf044dc49efa	426f591a-e285-444a-97d3-5d52ba17d1f8
39	39	0	Plazi	ffb07bec-2d10-492d-9c37-361fe0b79427	45ad9c46-a516-4dc0-a6f8-4292ce31ddd0
0	17	17	Plazi	ffb07bec-2d10-492d-9c37-361fe0b79427	4c0c7456-9393-44ec-897f-48d224a67d39
8	8	0	Plazi	ffb07bec-2d10-492d-9c37-361fe0b79427	4dfefad7-ba65-470c-8160-112cb68332f3
0	36	36	Plazi	ffb07bec-2d10-492d-9c37-361fe0b79427	4e3af683-d8a6-40de-991b-c4584d66b8cc
1	1	0	Plazi	ffb07bec-2d10-492d-9c37-361fe0b79427	51683189-1c26-4176-80d6-028f87f69dcc
40432	40432	0	Korean Biodiversity Information Facility	e0a1e772-0177-4800-94b4-2d023fe6cdf4	51fa6038-895d-4ed7-bf80-0754fa4d5f54
2	2	0	Plazi	ffb07bec-2d10-492d-9c37-361fe0b79427	56a92bb6-23a4-4d68-bdd3-cf125f233dad
356	377	21	Netherlands Biodiversity Information Facility	0909d601-bda2-42df-9e63-a6d51847ebce	5751c38c-078c-431a-be43-af27f5e38db2
15554	15554	0	National Biodiversity Network	d897a5b9-35ee-4232-94bd-b0bcaac003c2	5930b5ba-7ece-44e5-9227-0d70e9aa5f65
0	1	1	Plazi	ffb07bec-2d10-492d-9c37-361fe0b79427	59461c15-34d6-454e-9613-e03fe6332d23
182397	179333	-3064	National Biodiversity Network	d897a5b9-35ee-4232-94bd-b0bcaac003c2	5a1b62b2-4a1f-4404-b481-87836564d4a5
5	5	0	Plazi	ffb07bec-2d10-492d-9c37-361fe0b79427	5a72948d-d22e-4b00-b008-e0d4bf880084
7	7	0	Plazi	ffb07bec-2d10-492d-9c37-361fe0b79427	5a7f73c5-5646-446f-a72c-3ea18d8f634f
0	4	4	Participant Node Managers Committee	7f48e0c8-5c96-49ec-b972-30748e339115	5ce4d854-71ba-4d3b-9e0c-3b046e4236d6
2164	2164	0	Colombian Biodiversity Information System	7e865cba-7c46-417b-ade5-97f2cf5b7be0	5f19459c-0da2-4d2a-8180-87a917410b07
123	123	0	GBIF Germany	4f6826f2-4ff6-443d-b966-e6913bd24013	610c4bfa-f762-11e1-a439-00145eb45e9a
7576	7576	0	GBIF France	da44cd31-5901-4687-a106-6d1c7734ee3a	618212a3-6fd6-4347-b795-ee2c6246ebeb
27	27	0	Plazi	ffb07bec-2d10-492d-9c37-361fe0b79427	62014a8c-1b33-4609-8f33-656de4f3fdb5
5074	5074	0	Participant Node Managers Committee	7f48e0c8-5c96-49ec-b972-30748e339115	627a1541-e17f-4f3a-8339-c511e6b20df1
8	8	0	GBIF Germany	4f6826f2-4ff6-443d-b966-e6913bd24013	631538e4-f762-11e1-a439-00145eb45e9a
338	338	0	GBIF Germany	4f6826f2-4ff6-443d-b966-e6913bd24013	637fb3a4-f762-11e1-a439-00145eb45e9a
74	74	0	GBIF Germany	4f6826f2-4ff6-443d-b966-e6913bd24013	63864a2a-f762-11e1-a439-00145eb45e9a
254	254	0	GBIF Germany	4f6826f2-4ff6-443d-b966-e6913bd24013	63a3863a-f762-11e1-a439-00145eb45e9a
140	140	0	GBIF Germany	4f6826f2-4ff6-443d-b966-e6913bd24013	63aa34da-f762-11e1-a439-00145eb45e9a
31	31	0	GBIF Germany	4f6826f2-4ff6-443d-b966-e6913bd24013	646f27cc-f762-11e1-a439-00145eb45e9a
9	9	0	Plazi	ffb07bec-2d10-492d-9c37-361fe0b79427	64d84a28-6895-4f01-9ab7-6b4f37cec4ee
0	2	2	Plazi	ffb07bec-2d10-492d-9c37-361fe0b79427	64e33227-5b0b-4103-a4b1-202a97c81330
147	140	-7	GBIF Germany	4f6826f2-4ff6-443d-b966-e6913bd24013	64ff6f58-f762-11e1-a439-00145eb45e9a
0	17	17	Plazi	ffb07bec-2d10-492d-9c37-361fe0b79427	653336f0-4ebd-4b90-96c8-8b8b68109fc8
0	974	974	Belgian Biodiversity Platform	fb11cfe1-ebc3-45af-9159-17d9fddbcdac	6577f9a2-992b-43de-830d-fd186e0722b1
6386	6386	0	Participant Node Managers Committee	7f48e0c8-5c96-49ec-b972-30748e339115	665edebe-8d21-49bd-9435-155ef2789ab0
44	44	0	GBIF Germany	4f6826f2-4ff6-443d-b966-e6913bd24013	669cebb0-f762-11e1-a439-00145eb45e9a
78	78	0	GBIF Germany	4f6826f2-4ff6-443d-b966-e6913bd24013	66ca0a28-f762-11e1-a439-00145eb45e9a
131	131	0	GBIF Germany	4f6826f2-4ff6-443d-b966-e6913bd24013	674ff548-f762-11e1-a439-00145eb45e9a
54	54	0	GBIF Germany	4f6826f2-4ff6-443d-b966-e6913bd24013	67784b06-f762-11e1-a439-00145eb45e9a
104	104	0	GBIF Germany	4f6826f2-4ff6-443d-b966-e6913bd24013	686dc00e-f762-11e1-a439-00145eb45e9a
5	5	0	Plazi	ffb07bec-2d10-492d-9c37-361fe0b79427	68f31503-d38a-4c39-9774-a7802bb3fe09
0	860	860	Ocean Biodiversity Information System	ba0670b9-4186-41e6-8e70-f9cb3065551a	69482ca4-c584-4514-85ae-97d166891dae
199	199	0	GBIF Sweden	a0b3be64-6525-4387-ac67-a499950f92e1	6a3fc651-625f-41af-bdbe-53d505ae367b
1639	1639	0	GBIF Portugal	673f7038-4262-4149-b753-5658a4e912f6	6aa5ac09-2b55-4078-bd2d-ec94fb91850a
24	24	0	GBIF Germany	4f6826f2-4ff6-443d-b966-e6913bd24013	6b23d9f0-f762-11e1-a439-00145eb45e9a
846	846	0	GBIF Andorra	8df8d012-8e64-4c8a-886e-521a3bdfa623	6beb2310-5448-4904-b48c-b95ffc6224fa
247	247	0	GBIF Germany	4f6826f2-4ff6-443d-b966-e6913bd24013	6d638fe4-f762-11e1-a439-00145eb45e9a
817	817	0	GBIF France	da44cd31-5901-4687-a106-6d1c7734ee3a	6db59d35-e3d0-4dcd-9526-3fa59c559f5f
16383	16383	0	National Biodiversity Network	d897a5b9-35ee-4232-94bd-b0bcaac003c2	70b7c7b1-fbea-4771-8b63-ee1c7fae393d
129	129	0	GBIF Germany	4f6826f2-4ff6-443d-b966-e6913bd24013	70f60f4c-f762-11e1-a439-00145eb45e9a
83	83	0	GBIF Germany	4f6826f2-4ff6-443d-b966-e6913bd24013	71aec1b8-f762-11e1-a439-00145eb45e9a
0	132	132	Plazi	ffb07bec-2d10-492d-9c37-361fe0b79427	726fdd32-9199-4ca9-9dcd-2892bc30b2e3
119	119	0	GBIF Germany	4f6826f2-4ff6-443d-b966-e6913bd24013	72ec9b72-f762-11e1-a439-00145eb45e9a
0	3	3	Plazi	ffb07bec-2d10-492d-9c37-361fe0b79427	7360c545-900f-4fc1-b577-b75d0a72a831
104	104	0	GBIF France	da44cd31-5901-4687-a106-6d1c7734ee3a	749466d8-7602-496d-8e9c-89de67cee5d3
3145	3145	0	National Biodiversity Network	d897a5b9-35ee-4232-94bd-b0bcaac003c2	749b1cfc-478c-44bc-87bb-e21bc93a3adb
9	9	0	Plazi	ffb07bec-2d10-492d-9c37-361fe0b79427	74d0dd04-67a2-427c-8638-16a0d306a232
32	32	0	GBIF Germany	4f6826f2-4ff6-443d-b966-e6913bd24013	755c7db4-f762-11e1-a439-00145eb45e9a
0	123	123	Participant Node Managers Committee	7f48e0c8-5c96-49ec-b972-30748e339115	76647a0c-447e-4661-805b-0c88617c24e1
15	15	0	GBIF Germany	4f6826f2-4ff6-443d-b966-e6913bd24013	791165a0-f762-11e1-a439-00145eb45e9a
11	11	0	Plazi	ffb07bec-2d10-492d-9c37-361fe0b79427	79cf1fbe-528a-42a5-9030-950059ef6796
500	500	0	Korean Biodiversity Information Facility	e0a1e772-0177-4800-94b4-2d023fe6cdf4	7aff0afc-f762-11e1-a439-00145eb45e9a
28799	28799	0	National Biodiversity Network	d897a5b9-35ee-4232-94bd-b0bcaac003c2	7b361b5a-f762-11e1-a439-00145eb45e9a
0	13	13	Plazi	ffb07bec-2d10-492d-9c37-361fe0b79427	7b8357f6-c264-4dac-8909-ab7d60319003
19	19	0	Plazi	ffb07bec-2d10-492d-9c37-361fe0b79427	7bcd6fde-897c-408b-b64c-26d30c160d7e
1379	1338	-41	GBIF Germany	4f6826f2-4ff6-443d-b966-e6913bd24013	7cd6d300-f762-11e1-a439-00145eb45e9a
798	798	0	GBIF Germany	4f6826f2-4ff6-443d-b966-e6913bd24013	7dcfc7a8-f762-11e1-a439-00145eb45e9a
352	352	0	GBIF Malawi	2a42e4d7-ad4a-41b3-84c4-de4aa7b74d35	7ec7c087-c3d7-48b7-98e7-8020ca203577
503	503	0	Biodiversity Information System of Mexico	b324e8e9-9a4c-44fa-8f1a-7f39ea7ab576	7fa35c3e-f762-11e1-a439-00145eb45e9a
302	302	0	U.S. Geological Survey	8618c64a-93e0-4300-b546-7249e5148ed2	80eaf2ed-c5ec-4c36-a9b7-a0b7023a8edf
2	2	0	Plazi	ffb07bec-2d10-492d-9c37-361fe0b79427	80fadc4c-020f-4fc9-a3cd-25ab596c9646
48	48	0	GBIF Germany	4f6826f2-4ff6-443d-b966-e6913bd24013	814a0b64-f762-11e1-a439-00145eb45e9a
2688	1568	-1120	GBIF Germany	4f6826f2-4ff6-443d-b966-e6913bd24013	81f4482c-f762-11e1-a439-00145eb45e9a
3481	3481	0	National Biodiversity Network	d897a5b9-35ee-4232-94bd-b0bcaac003c2	821765c9-59dc-4310-9970-d82c2eb9eff7
44301	61417	17116	GBIF Japan	db5705aa-6a6e-42f1-8942-d77b9f4896ea	84a4404a-f762-11e1-a439-00145eb45e9a
495	495	0	Taiwan Biodiversity Information Facility	e1b85abc-61f9-430f-ba79-6813dec53a0f	85bc2470-98a1-11de-b4da-b8a03c50a862
1312	1047	-265	GBIF Germany	4f6826f2-4ff6-443d-b966-e6913bd24013	86ff6578-eb9a-4b28-b676-c2aec419ccfd
1197	736	-461	GBIF Germany	4f6826f2-4ff6-443d-b966-e6913bd24013	87961b52-f762-11e1-a439-00145eb45e9a
311	220	-91	GBIF Germany	4f6826f2-4ff6-443d-b966-e6913bd24013	87cca37a-f762-11e1-a439-00145eb45e9a
10	10	0	GBIF Germany	4f6826f2-4ff6-443d-b966-e6913bd24013	880acdbc-f762-11e1-a439-00145eb45e9a
18	18	0	GBIF Germany	4f6826f2-4ff6-443d-b966-e6913bd24013	886fd69e-f762-11e1-a439-00145eb45e9a
18	18	0	GBIF Germany	4f6826f2-4ff6-443d-b966-e6913bd24013	888257ec-f762-11e1-a439-00145eb45e9a
6782	6782	0	Ocean Biodiversity Information System	ba0670b9-4186-41e6-8e70-f9cb3065551a	89268632-f762-11e1-a439-00145eb45e9a
454	454	0	GBIF Germany	4f6826f2-4ff6-443d-b966-e6913bd24013	893db33e-f762-11e1-a439-00145eb45e9a
0	2	2	Plazi	ffb07bec-2d10-492d-9c37-361fe0b79427	89d50102-324a-4481-a87e-c2017f48f78c
19	19	0	GBIF Germany	4f6826f2-4ff6-443d-b966-e6913bd24013	89e765d2-f762-11e1-a439-00145eb45e9a
12926	12926	0	GBIF Chile	a8b16421-d80b-4ef3-8f22-098b01a89255	8a5e7684-cd6c-4b46-b8c6-467542eea1a2
2	2	0	Plazi	ffb07bec-2d10-492d-9c37-361fe0b79427	8b4c5b00-0905-4960-8df0-adeb44b688ef
117	117	0	GBIF Germany	4f6826f2-4ff6-443d-b966-e6913bd24013	8c2e01a2-f762-11e1-a439-00145eb45e9a
3	3	0	Plazi	ffb07bec-2d10-492d-9c37-361fe0b79427	8d301420-9378-42e7-b04d-6a840759f4df
1123	966	-157	GBIF Germany	4f6826f2-4ff6-443d-b966-e6913bd24013	8d99b8c4-f762-11e1-a439-00145eb45e9a
4567	4743	176	GBIF Brazil	cdc9736d-5ff7-4ece-9959-3c744360cdb3	8dd06261-d1a7-4c2b-9007-c3a4d93dfee3
378	378	0	GBIF Germany	4f6826f2-4ff6-443d-b966-e6913bd24013	8e165406-f762-11e1-a439-00145eb45e9a
10	10	0	Plazi	ffb07bec-2d10-492d-9c37-361fe0b79427	8e6eab2a-eba6-4eed-b9f7-5498b9b82474
165	142	-23	GBIF Germany	4f6826f2-4ff6-443d-b966-e6913bd24013	8ec46a3c-f762-11e1-a439-00145eb45e9a
298	225	-73	GBIF Germany	4f6826f2-4ff6-443d-b966-e6913bd24013	8fd14d14-f762-11e1-a439-00145eb45e9a
38	31	-7	GBIF Germany	4f6826f2-4ff6-443d-b966-e6913bd24013	90e270c0-f762-11e1-a439-00145eb45e9a
20	20	0	Colombian Biodiversity Information System	7e865cba-7c46-417b-ade5-97f2cf5b7be0	90eeaf09-4329-4474-b164-5946725ff6cc
2	2	0	Plazi	ffb07bec-2d10-492d-9c37-361fe0b79427	9154aa94-fd90-41cd-ae54-288ccd433d67
11	10	-1	GBIF Germany	4f6826f2-4ff6-443d-b966-e6913bd24013	9198aa7a-f762-11e1-a439-00145eb45e9a
46448	46448	0	Atlas of Living Australia	4a6f1b71-969e-4fc5-a693-282b05e1220c	92580ab9-28a5-490f-9a6a-a5fa45449332
293389	299896	6507	U.S. Geological Survey	8618c64a-93e0-4300-b546-7249e5148ed2	95c938a8-f762-11e1-a439-00145eb45e9a
897	897	0	Atlas of Living Australia	4a6f1b71-969e-4fc5-a693-282b05e1220c	96aa3736-f762-11e1-a439-00145eb45e9a
5	5	0	Plazi	ffb07bec-2d10-492d-9c37-361fe0b79427	96adde9f-01e0-4f88-bc0b-be935f8f2368
82	82	0	GBIF France	da44cd31-5901-4687-a106-6d1c7734ee3a	99182513-1c74-4cb3-8334-6837862a032d
4	4	0	Plazi	ffb07bec-2d10-492d-9c37-361fe0b79427	991d3cda-9d4f-4daa-b869-bf15935c1842
1	1	0	Plazi	ffb07bec-2d10-492d-9c37-361fe0b79427	9bf3a9f5-cd36-4be6-bba9-49607815bcd0
0	54	54	Plazi	ffb07bec-2d10-492d-9c37-361fe0b79427	9f4cbf5f-22ae-4bc7-ad0b-519f93d0c4ad
100	100	0	GBIF France	da44cd31-5901-4687-a106-6d1c7734ee3a	a02b57b4-7c6e-4753-9ff1-dc842d7bd7f9
77	77	0	Plazi	ffb07bec-2d10-492d-9c37-361fe0b79427	a02f182b-32e4-4649-afe0-983cb21ceb9e
167	167	0	GBIF Japan	db5705aa-6a6e-42f1-8942-d77b9f4896ea	a4f3eba8-d023-4762-88f8-fcc6e81ce74d
4540802	4540802	0	National Biodiversity Network	d897a5b9-35ee-4232-94bd-b0bcaac003c2	a74db578-ac84-4907-ab8f-8de6eaa7df56
2	2	0	Plazi	ffb07bec-2d10-492d-9c37-361fe0b79427	a7b70293-de71-4c49-8531-09937ffa5428
585	585	0	Plazi	ffb07bec-2d10-492d-9c37-361fe0b79427	a8aa5ad0-dbcc-4e48-9211-b83b90e0aee7
9	9	0	Plazi	ffb07bec-2d10-492d-9c37-361fe0b79427	a96fe539-8bd2-4121-99cc-dd0b7943a7e0
0	71	71	Plazi	ffb07bec-2d10-492d-9c37-361fe0b79427	aae4f8ee-4581-4c88-91b4-cf8fe9298a28
3295	3295	0	GBIF Argentina	2426a871-9feb-40a1-96c6-0c593a76b835	adf721a5-4e28-4605-98ea-8d2ce9ea3020
385	412	27	U.S. Geological Survey	8618c64a-93e0-4300-b546-7249e5148ed2	b11cbb9e-8ee0-4d9a-8eac-da5d5ab53a31
3201	3201	0	Polish Biodiversity Information Network	2618bfdf-e194-4911-a241-80db3107bc51	b97fb580-30b2-11de-b171-b8a03c50a862
0	5	5	Plazi	ffb07bec-2d10-492d-9c37-361fe0b79427	b9fae2dc-d0a9-4555-9a50-ba0266e87075
571	571	0	GBIF Spain	1f94b3ca-9345-4d65-afe2-4bace93aa0fe	bcabcfcc-b613-43b6-b0bd-4c79ecc396da
140	140	0	National Biodiversity Network	d897a5b9-35ee-4232-94bd-b0bcaac003c2	c5cd6324-d474-481c-8a22-cf8bc044d3c6
1	1	0	Plazi	ffb07bec-2d10-492d-9c37-361fe0b79427	c5f8c0ed-cfa8-4de4-a92c-7c65af0e3899
863	863	0	Participant Node Managers Committee	7f48e0c8-5c96-49ec-b972-30748e339115	c8d80e2d-be82-44ae-9211-113d995160a7
0	176	176	Plazi	ffb07bec-2d10-492d-9c37-361fe0b79427	cb334de2-3183-406d-b5d9-09cd19392125
735	735	0	GBIF Germany	4f6826f2-4ff6-443d-b966-e6913bd24013	cc0a4400-9fae-4a78-8863-48142772023d
52397	57016	4619	GBIF Brazil	cdc9736d-5ff7-4ece-9959-3c744360cdb3	cd6905cf-54d7-4628-b762-f63d269e239b
0	60	60	Plazi	ffb07bec-2d10-492d-9c37-361fe0b79427	cebb6e47-b2e0-45bb-85d2-e73b7fae63a7
0	7	7	Plazi	ffb07bec-2d10-492d-9c37-361fe0b79427	cee2b5b0-e6bb-42d7-9251-858861f02691
0	23	23	Ocean Biodiversity Information System	ba0670b9-4186-41e6-8e70-f9cb3065551a	d1b948f5-db0c-4968-b5f3-b09da9a008a2
296	296	0	GBIF Argentina	2426a871-9feb-40a1-96c6-0c593a76b835	d2d258c8-c084-48c1-8e3d-63a2c1829b35
18	18	0	Plazi	ffb07bec-2d10-492d-9c37-361fe0b79427	d8db2633-9bda-4f4e-9ee6-a5f4bf19ad59
10	10	0	Plazi	ffb07bec-2d10-492d-9c37-361fe0b79427	d97f2cf2-84f5-4c97-9650-1d5878379872
0	2	2	Plazi	ffb07bec-2d10-492d-9c37-361fe0b79427	dac4e722-2551-4311-b7f1-7613b57649cf
0	6	6	Plazi	ffb07bec-2d10-492d-9c37-361fe0b79427	e135da9b-6edb-4737-8316-c65f4c3f4cf8
27	27	0	Plazi	ffb07bec-2d10-492d-9c37-361fe0b79427	e347cf11-d189-4eea-830c-37d8d50c9342
43928	43928	0	National Biodiversity Network	d897a5b9-35ee-4232-94bd-b0bcaac003c2	e351951e-32da-46d6-b61c-e9816d39e0d4
5	5	0	Plazi	ffb07bec-2d10-492d-9c37-361fe0b79427	e35733ef-de80-48a5-ba8d-60906e513e5b
0	652	652	Ocean Biodiversity Information System	ba0670b9-4186-41e6-8e70-f9cb3065551a	e7742aab-883c-49ad-bb12-ddb6dff6129e
5115	5115	0	Ocean Biodiversity Information System	ba0670b9-4186-41e6-8e70-f9cb3065551a	eaab2265-463e-48e5-8dcd-f8d398da7f75
2110	2110	0	GBIF Brazil	cdc9736d-5ff7-4ece-9959-3c744360cdb3	fbb9dae5-dd42-4171-99d0-47502913ff43
438	438	0	Colombian Biodiversity Information System	7e865cba-7c46-417b-ade5-97f2cf5b7be0	fcf330f6-0404-4563-b6c8-b6549d2d8c48
184	184	0	GBIF France	da44cd31-5901-4687-a106-6d1c7734ee3a	fd1102ab-2452-4336-924d-6068d1c2a699
221	221	0	Belgian Biodiversity Platform	fb11cfe1-ebc3-45af-9159-17d9fddbcdac	024c32b6-5436-4e0c-bc48-47980dec4980
217	217	0	GBIF France	da44cd31-5901-4687-a106-6d1c7734ee3a	03e153ce-2609-46da-bcf7-d2f8eb5643c0
712	712	0	Biodiversity Information System of Mexico	b324e8e9-9a4c-44fa-8f1a-7f39ea7ab576	06cba4a5-009f-46bd-bcf4-1b196c30e19b
0	80	80	Plazi	ffb07bec-2d10-492d-9c37-361fe0b79427	07c83cbb-d592-43c1-894e-9fbcd0f48339
1	1	0	Plazi	ffb07bec-2d10-492d-9c37-361fe0b79427	0abe85e4-f324-45c3-8bf7-8b943b81d8f0
5346	5346	0	National Biodiversity Network	d897a5b9-35ee-4232-94bd-b0bcaac003c2	0b0eb608-3e7d-445d-ac1b-e8a88ddcf97e
6199	6199	0	South African Biodiversity Information Facility	7190b835-4e86-4b6e-85c1-19cc6677c250	0b2f8a72-cfec-4c00-9424-9ee0bd8bec72
0	12	12	Plazi	ffb07bec-2d10-492d-9c37-361fe0b79427	0b735edc-d682-4b2e-9fb5-69de294147ee
0	3	3	Plazi	ffb07bec-2d10-492d-9c37-361fe0b79427	0bc5bda1-a24b-4d65-8798-9202d45fd4d6
159	159	0	Netherlands Biodiversity Information Facility	0909d601-bda2-42df-9e63-a6d51847ebce	0d384803-0d1b-4409-ada1-22d8009ecfa9
0	367	367	Ocean Biodiversity Information System	ba0670b9-4186-41e6-8e70-f9cb3065551a	0deb27f8-c564-47d1-a0e0-f164277bdb3a
0	75	75	Ocean Biodiversity Information System	ba0670b9-4186-41e6-8e70-f9cb3065551a	13420aae-6250-4c08-8575-fd9dbebe0d80
2	2	0	Plazi	ffb07bec-2d10-492d-9c37-361fe0b79427	15b6f9da-ac3f-401a-b219-3d1e23290a17
9717	9717	0	Atlas of Living Australia	4a6f1b71-969e-4fc5-a693-282b05e1220c	1ba242f4-6bff-4735-bdec-89357c997da5
2568	2568	0	U.S. Geological Survey	8618c64a-93e0-4300-b546-7249e5148ed2	1c37eefc-6e7c-49a5-9ea1-f1e9eefb07bc
601868	601868	0	U.S. Geological Survey	8618c64a-93e0-4300-b546-7249e5148ed2	1d39953f-5c1a-4dad-8524-70191eb4fe6c
8	8	0	Plazi	ffb07bec-2d10-492d-9c37-361fe0b79427	1fdf27ec-2318-4726-ac75-a4c5e2121634
1329	1329	0	Belgian Biodiversity Platform	fb11cfe1-ebc3-45af-9159-17d9fddbcdac	22252fe5-d06e-46d3-8f6d-dc1aa57de904
5116	5116	0	Colombian Biodiversity Information System	7e865cba-7c46-417b-ade5-97f2cf5b7be0	223fd94e-c0d3-4ff1-bdea-29648e1c797a
528	528	0	GBIF Nigeria	6529bcb5-a542-4fda-be87-54a624515335	226e397f-205d-454a-9ff3-444ed90f79b0
266	266	0	National Biodiversity Network	d897a5b9-35ee-4232-94bd-b0bcaac003c2	22853f51-25e9-40c2-9bd0-ed995b2346d8
0	346	346	Ocean Biodiversity Information System	ba0670b9-4186-41e6-8e70-f9cb3065551a	25bf34e6-48ef-41aa-9b62-876ca0c66a2a
2	2	0	Plazi	ffb07bec-2d10-492d-9c37-361fe0b79427	27f33714-c0e8-423e-afda-97265b21193a
6	6	0	Plazi	ffb07bec-2d10-492d-9c37-361fe0b79427	2fd5ca7b-4074-44f4-8f90-9d62c77b6ba5
276	276	0	GBIF France	da44cd31-5901-4687-a106-6d1c7734ee3a	30356a3b-b4d7-417e-852b-d4484f5243be
10	10	0	Plazi	ffb07bec-2d10-492d-9c37-361fe0b79427	30de3e76-7464-49f8-ba36-15a9cc71b955
0	9142	9142	Netherlands Biodiversity Information Facility	0909d601-bda2-42df-9e63-a6d51847ebce	39b4ca7a-27f7-4489-8b49-c539144ccdc8
2	2	0	Plazi	ffb07bec-2d10-492d-9c37-361fe0b79427	3c0c1c12-9bab-4c11-86ec-5729065f9fdf
277	277	0	GBIF France	da44cd31-5901-4687-a106-6d1c7734ee3a	420a08fb-21b5-43f8-bee5-fbc4e31562e1
0	46	46	Plazi	ffb07bec-2d10-492d-9c37-361fe0b79427	42486238-d0b4-430b-8d23-b20575271382
0	68	68	Plazi	ffb07bec-2d10-492d-9c37-361fe0b79427	44450b6f-59be-485c-8fc3-8e673f8b03f5
47695	47695	0	Biodiversity Information System of Mexico	b324e8e9-9a4c-44fa-8f1a-7f39ea7ab576	48266cb4-8129-4ef9-b768-945577350db2
210017	210017	0	U.S. Geological Survey	8618c64a-93e0-4300-b546-7249e5148ed2	486ca376-f3a2-4084-8618-1c82a59c5240
11	11	0	Plazi	ffb07bec-2d10-492d-9c37-361fe0b79427	4a915173-7f0f-43e2-97a9-f4a744ee44a8
0	22	22	Plazi	ffb07bec-2d10-492d-9c37-361fe0b79427	4cc17c90-b9e8-475b-b95f-421b35976453
0	4	4	Plazi	ffb07bec-2d10-492d-9c37-361fe0b79427	4d549485-cfa2-4efb-a676-e855443d2613
7	7	0	GBIF Brazil	cdc9736d-5ff7-4ece-9959-3c744360cdb3	5212c57e-f3da-4358-887b-99152a1f437e
0	492	492	Colombian Biodiversity Information System	7e865cba-7c46-417b-ade5-97f2cf5b7be0	52cff57e-1f97-4178-a53d-1d033c20c94e
13	13	0	National Biodiversity Network	d897a5b9-35ee-4232-94bd-b0bcaac003c2	54da87df-4755-4069-a9f9-ee424c4302a3
23020	23020	0	National Biodiversity Network	d897a5b9-35ee-4232-94bd-b0bcaac003c2	55224a2e-b71e-4b94-99b0-695bf835e6b6
6158	6158	0	GBIF France	da44cd31-5901-4687-a106-6d1c7734ee3a	5712a322-45df-4038-9421-043b802ee333
3	3	0	Plazi	ffb07bec-2d10-492d-9c37-361fe0b79427	57166eb2-9e55-45a1-bfb9-0282c1516b94
1	1	0	Plazi	ffb07bec-2d10-492d-9c37-361fe0b79427	5a771e17-dcab-482b-b758-ce2c83a9c7a2
1708	1708	0	GBIF Finland	dd514216-5c7c-45f3-910d-797424cb5be6	5cc9ff48-37b9-409b-9dfa-9b8b73014f46
152	152	0	GBIF Portugal	673f7038-4262-4149-b753-5658a4e912f6	60221fcb-bf65-43fc-b86c-1daadcb75fec
46	46	0	GBIF Germany	4f6826f2-4ff6-443d-b966-e6913bd24013	61a0ad90-f762-11e1-a439-00145eb45e9a
2	2	0	Plazi	ffb07bec-2d10-492d-9c37-361fe0b79427	63d0003b-83e2-43ff-989e-34e9ba7c22ed
21855	21855	0	National Biodiversity Network	d897a5b9-35ee-4232-94bd-b0bcaac003c2	6489fd9e-d7df-442d-bf1f-b6fada71ee4a
0	116	116	GBIF Malawi	2a42e4d7-ad4a-41b3-84c4-de4aa7b74d35	65bf3cf2-e307-47e7-9d9e-bf78ea61c4b4
94	94	0	Plazi	ffb07bec-2d10-492d-9c37-361fe0b79427	6850322c-46da-4d24-a2c0-e26006e3fc9e
331	192	-139	GBIF Germany	4f6826f2-4ff6-443d-b966-e6913bd24013	69f97490-f762-11e1-a439-00145eb45e9a
1482	1482	0	GBIF Germany	4f6826f2-4ff6-443d-b966-e6913bd24013	6a2f03e4-f762-11e1-a439-00145eb45e9a
1373	1373	0	GBIF Germany	4f6826f2-4ff6-443d-b966-e6913bd24013	6a834b0c-f762-11e1-a439-00145eb45e9a
40	40	0	GBIF Germany	4f6826f2-4ff6-443d-b966-e6913bd24013	6ac62364-f762-11e1-a439-00145eb45e9a
1	1	0	Plazi	ffb07bec-2d10-492d-9c37-361fe0b79427	6b1f5d00-c923-4929-9918-5a6aad58263e
1	1	0	Plazi	ffb07bec-2d10-492d-9c37-361fe0b79427	6b5f3c6f-c7df-4475-9c8a-3844b07a73de
7574	7574	0	National Biodiversity Network	d897a5b9-35ee-4232-94bd-b0bcaac003c2	72704e74-30b1-424b-97ab-01d082884142
1	1	0	Plazi	ffb07bec-2d10-492d-9c37-361fe0b79427	72fb038a-09d2-4777-96ea-ced44b6fcc40
26	26	0	GBIF Germany	4f6826f2-4ff6-443d-b966-e6913bd24013	739af51e-f762-11e1-a439-00145eb45e9a
435	435	0	GBIF Brazil	cdc9736d-5ff7-4ece-9959-3c744360cdb3	739cf09a-d05e-4241-91ba-418b756f3ed5
42	42	0	GBIF Germany	4f6826f2-4ff6-443d-b966-e6913bd24013	73c1a89e-f762-11e1-a439-00145eb45e9a
137	137	0	GBIF Germany	4f6826f2-4ff6-443d-b966-e6913bd24013	75af0d54-f762-11e1-a439-00145eb45e9a
147	147	0	GBIF Germany	4f6826f2-4ff6-443d-b966-e6913bd24013	75baef3e-f762-11e1-a439-00145eb45e9a
236	215	-21	GBIF Germany	4f6826f2-4ff6-443d-b966-e6913bd24013	7607f252-f762-11e1-a439-00145eb45e9a
0	1	1	Plazi	ffb07bec-2d10-492d-9c37-361fe0b79427	764a4391-628c-4984-8426-7405cd3b8544
3	3	0	Plazi	ffb07bec-2d10-492d-9c37-361fe0b79427	76d20984-90c9-4e92-a089-50bb0eeb9bfc
170040	170040	0	U.S. Geological Survey	8618c64a-93e0-4300-b546-7249e5148ed2	76dd8f0d-2daa-4a69-9fcd-55e04230334a
0	1477	1477	Participant Node Managers Committee	7f48e0c8-5c96-49ec-b972-30748e339115	77678b97-f9c0-4037-8920-bd99a728c385
11	11	0	GBIF Germany	4f6826f2-4ff6-443d-b966-e6913bd24013	78b45770-f762-11e1-a439-00145eb45e9a
36	36	0	Plazi	ffb07bec-2d10-492d-9c37-361fe0b79427	7936f9fd-8e67-41d1-8172-4e59f5605201
2121	1375	-746	GBIF Germany	4f6826f2-4ff6-443d-b966-e6913bd24013	79e67862-f762-11e1-a439-00145eb45e9a
6	6	0	Plazi	ffb07bec-2d10-492d-9c37-361fe0b79427	7a4b77e7-3da2-4dfc-b6c8-e0a8307f2f64
5110	4088	-1022	GBIF Germany	4f6826f2-4ff6-443d-b966-e6913bd24013	7c6bae7c-f762-11e1-a439-00145eb45e9a
17673	17673	0	GBIF Germany	4f6826f2-4ff6-443d-b966-e6913bd24013	7caebaa5-a59c-44f3-b2c2-8f21027bf177
1562	1571	9	GBIF Germany	4f6826f2-4ff6-443d-b966-e6913bd24013	7db48484-f762-11e1-a439-00145eb45e9a
50	50	0	Colombian Biodiversity Information System	7e865cba-7c46-417b-ade5-97f2cf5b7be0	7e1ab45d-7899-48db-9fc6-7fc945d16518
386	308	-78	GBIF Germany	4f6826f2-4ff6-443d-b966-e6913bd24013	7f3b4612-f762-11e1-a439-00145eb45e9a
2025	2025	0	Biodiversity Information System of Mexico	b324e8e9-9a4c-44fa-8f1a-7f39ea7ab576	7fffa0a2-f762-11e1-a439-00145eb45e9a
3	3	0	Plazi	ffb07bec-2d10-492d-9c37-361fe0b79427	8020b911-1349-42e9-8a82-9fc080be7293
7	7	0	Plazi	ffb07bec-2d10-492d-9c37-361fe0b79427	80e250b8-62eb-4505-bf80-227f64e261ea
4771	4730	-41	National Biodiversity Network	d897a5b9-35ee-4232-94bd-b0bcaac003c2	813d800b-7d9f-4550-9e04-1e13bb114e7e
8	8	0	GBIF Germany	4f6826f2-4ff6-443d-b966-e6913bd24013	8146567c-f762-11e1-a439-00145eb45e9a
60	60	0	GBIF Germany	4f6826f2-4ff6-443d-b966-e6913bd24013	81738516-f762-11e1-a439-00145eb45e9a
21	21	0	Plazi	ffb07bec-2d10-492d-9c37-361fe0b79427	818727b6-315f-4325-9d8d-98efc4d21f4f
2176	2176	0	Atlas of Living Australia	4a6f1b71-969e-4fc5-a693-282b05e1220c	82e7db90-f762-11e1-a439-00145eb45e9a
602	602	0	National Biodiversity Network	d897a5b9-35ee-4232-94bd-b0bcaac003c2	844b5647-f5d8-48b3-a900-1b50aea2d13f
4770	4770	0	Canada Biodiversity Information Facility	8f83fc96-c966-4126-83f7-bf044dc49efa	8473de00-f762-11e1-a439-00145eb45e9a
29581	29581	0	Atlas of Living Australia	4a6f1b71-969e-4fc5-a693-282b05e1220c	84a47405-034b-4ab3-bb49-b2ab36a21a88
0	5	5	Plazi	ffb07bec-2d10-492d-9c37-361fe0b79427	85e3f740-2664-491c-ad7b-a3702812ce40
0	3338	3338	Participant Node Managers Committee	7f48e0c8-5c96-49ec-b972-30748e339115	86812e1d-3d3e-4e61-8853-43697e845cac
4228	4228	0	GBIF France	da44cd31-5901-4687-a106-6d1c7734ee3a	868cfc73-d720-483e-9984-a7cd75fad7e8
43319	43319	0	GBIF France	da44cd31-5901-4687-a106-6d1c7734ee3a	8753ad24-d1b7-4cd1-a610-d081c56b6f73
288514	289642	1128	Netherlands Biodiversity Information Facility	0909d601-bda2-42df-9e63-a6d51847ebce	889c91a3-614f-4355-8df8-b6d0260a118c
7	7	0	Participant Node Managers Committee	7f48e0c8-5c96-49ec-b972-30748e339115	8a598f88-5cbb-4d90-8539-d68aa32340da
92	92	0	GBIF Germany	4f6826f2-4ff6-443d-b966-e6913bd24013	8cbf2d9e-f762-11e1-a439-00145eb45e9a
19	18	-1	GBIF Germany	4f6826f2-4ff6-443d-b966-e6913bd24013	8d53972c-f762-11e1-a439-00145eb45e9a
56	53	-3	GBIF Germany	4f6826f2-4ff6-443d-b966-e6913bd24013	8d9311f4-f762-11e1-a439-00145eb45e9a
15	15	0	Plazi	ffb07bec-2d10-492d-9c37-361fe0b79427	8e1d07cd-5dc3-4288-9c9a-c7b409549f55
774	774	0	Colombian Biodiversity Information System	7e865cba-7c46-417b-ade5-97f2cf5b7be0	8e4e5830-2f87-47d7-a265-3411f172a640
13	13	0	Plazi	ffb07bec-2d10-492d-9c37-361fe0b79427	8f770118-6827-4e3f-ba56-d94dbc0a8c22
526	241	-285	GBIF Germany	4f6826f2-4ff6-443d-b966-e6913bd24013	907306ae-f762-11e1-a439-00145eb45e9a
6	6	0	Plazi	ffb07bec-2d10-492d-9c37-361fe0b79427	90a4dab5-ffa0-4fbe-a9b6-96904940afcf
68	42	-26	GBIF Germany	4f6826f2-4ff6-443d-b966-e6913bd24013	91344efe-f762-11e1-a439-00145eb45e9a
3387	3387	0	International Centre for Insect Physiology and Ecology	b9628650-eeb8-44e3-80b8-ea6626956793	91f87e60-32ba-447c-9307-7333e1080205
99	99	0	Colombian Biodiversity Information System	7e865cba-7c46-417b-ade5-97f2cf5b7be0	92b72b47-2793-444d-ac7e-1a092cb7510e
0	68	68	Plazi	ffb07bec-2d10-492d-9c37-361fe0b79427	93602399-e4fc-48cc-a30b-f981150a39a9
0	34	34	Plazi	ffb07bec-2d10-492d-9c37-361fe0b79427	93917b8d-1ce7-425e-912a-5892214c81b4
1	1	0	Plazi	ffb07bec-2d10-492d-9c37-361fe0b79427	93a069df-dcea-4f5b-982b-32fa59a230c1
714	699	-15	GBIF Germany	4f6826f2-4ff6-443d-b966-e6913bd24013	93f12770-f762-11e1-a439-00145eb45e9a
693	693	0	GBIF Germany	4f6826f2-4ff6-443d-b966-e6913bd24013	942a6454-f762-11e1-a439-00145eb45e9a
293	293	0	Ocean Biodiversity Information System	ba0670b9-4186-41e6-8e70-f9cb3065551a	95d060a6-f762-11e1-a439-00145eb45e9a
607514	607514	0	Korean Biodiversity Information Facility	e0a1e772-0177-4800-94b4-2d023fe6cdf4	961a5ce1-f843-4e75-86a6-51aa959fc12c
79418	79628	210	U.S. Geological Survey	8618c64a-93e0-4300-b546-7249e5148ed2	9643f840-f762-11e1-a439-00145eb45e9a
6	6	0	Plazi	ffb07bec-2d10-492d-9c37-361fe0b79427	96b32b7c-5d14-4458-a179-b6d4ecc16b0d
599829	691782	91953	U.S. Geological Survey	8618c64a-93e0-4300-b546-7249e5148ed2	9781ce05-2379-4a10-ab3b-c91346510df8
138	138	0	Plazi	ffb07bec-2d10-492d-9c37-361fe0b79427	9823b3d4-a8ba-4196-b924-02bf807b4d61
0	5447	5447	Biodiversity Information System of Mexico	b324e8e9-9a4c-44fa-8f1a-7f39ea7ab576	99008c5e-b509-4d5e-b081-a20716d3b38b
18	18	0	GBIF Portugal	673f7038-4262-4149-b753-5658a4e912f6	9c95b714-d716-408e-a893-860254c0a706
442	442	0	GBIF France	da44cd31-5901-4687-a106-6d1c7734ee3a	a5c2e18e-43cb-4adc-b544-803d0f655538
0	10	10	Plazi	ffb07bec-2d10-492d-9c37-361fe0b79427	a6962404-c25a-4f39-89a3-94ddc02bbe66
2452	2452	0	Colombian Biodiversity Information System	7e865cba-7c46-417b-ade5-97f2cf5b7be0	a8f65e0b-5b75-4880-bebc-f9a3efe13ccd
2239	2239	0	Biodiversity Information System of Mexico	b324e8e9-9a4c-44fa-8f1a-7f39ea7ab576	ab195e05-de54-48f8-bfd7-c574164c2218
2388	2388	0	National Biodiversity Network	d897a5b9-35ee-4232-94bd-b0bcaac003c2	ad2bf4ca-61ca-49b2-b08a-8eff75725a76
2	2	0	Plazi	ffb07bec-2d10-492d-9c37-361fe0b79427	ad3e7788-7b8c-48c6-980c-76eac8bd2e0c
2	2	0	Plazi	ffb07bec-2d10-492d-9c37-361fe0b79427	af287f7c-0f70-43de-9bb1-b6275833a1c1
0	1	1	Plazi	ffb07bec-2d10-492d-9c37-361fe0b79427	af6feb51-5aa6-4bd8-8f57-00e042f92e43
0	63	63	Plazi	ffb07bec-2d10-492d-9c37-361fe0b79427	b1263db5-13a0-4849-97e8-e4b4d1a37534
743	743	0	GBIF France	da44cd31-5901-4687-a106-6d1c7734ee3a	b151809f-3b6a-418d-b9a9-1c203328082f
6	6	0	Plazi	ffb07bec-2d10-492d-9c37-361fe0b79427	b1ce356a-ab8f-4366-924c-92a6600b5985
1	1	0	Plazi	ffb07bec-2d10-492d-9c37-361fe0b79427	b4a9d454-c103-4db2-ad54-da79735dc5d5
1192	1192	0	GBIF Kenya	2a44d626-9f7a-4120-8a7a-4ab5ac15ff2a	b69707a4-124c-4e14-a2ff-3bdbf2792aa2
0	23	23	Plazi	ffb07bec-2d10-492d-9c37-361fe0b79427	b6f24c75-5ddd-412a-9f78-1293d00419a6
935	935	0	GBIF Kenya	2a44d626-9f7a-4120-8a7a-4ab5ac15ff2a	b99b4a2f-9797-4f67-8689-dd89f27ae270
10	10	0	GBIF Germany	4f6826f2-4ff6-443d-b966-e6913bd24013	bc29de5d-d286-46cf-88c1-e97142989d11
0	71	71	Colombian Biodiversity Information System	7e865cba-7c46-417b-ade5-97f2cf5b7be0	bdfef7a0-df16-4776-b4dc-f64683e3e096
2	2	0	Plazi	ffb07bec-2d10-492d-9c37-361fe0b79427	c033876b-985f-4590-a471-901ae09606ca
0	99	99	Ocean Biodiversity Information System	ba0670b9-4186-41e6-8e70-f9cb3065551a	c145907c-2a84-4ae3-ab66-9633a18bbbd0
2	2	0	Plazi	ffb07bec-2d10-492d-9c37-361fe0b79427	c1de67dd-5692-46b2-9ecc-e3674077e3af
5	5	0	Plazi	ffb07bec-2d10-492d-9c37-361fe0b79427	c251de0a-9fd8-4cd8-84d3-0dfaed2fc0b3
0	11	11	Plazi	ffb07bec-2d10-492d-9c37-361fe0b79427	c4eee649-5e43-46d6-8dc5-83ef3a325735
63	63	0	GBIF France	da44cd31-5901-4687-a106-6d1c7734ee3a	c70094e9-ab69-4069-9429-fc3f5816a71e
5	5	0	Plazi	ffb07bec-2d10-492d-9c37-361fe0b79427	c880c45c-3949-49c6-a3f5-33143cd8ade2
1	1	0	Plazi	ffb07bec-2d10-492d-9c37-361fe0b79427	caba107c-17b1-459c-b270-e09088787c8c
1317747	1318467	720	GBIF France	da44cd31-5901-4687-a106-6d1c7734ee3a	cb9beff3-a185-486f-975a-732251444158
1460	1460	0	Biodiversity Information System of Mexico	b324e8e9-9a4c-44fa-8f1a-7f39ea7ab576	ccf06a72-73f0-4fa4-975e-e8db683369e5
7667	7667	0	GBIF Israel	8cb55387-7802-40e8-86d6-d357a583c596	cdae52c7-a6f2-460e-b0e9-33c795a34224
0	565	565	Ocean Biodiversity Information System	ba0670b9-4186-41e6-8e70-f9cb3065551a	cf34dedc-6789-4763-ac08-907431a7d93c
191	191	0	Belgian Biodiversity Platform	fb11cfe1-ebc3-45af-9159-17d9fddbcdac	d114f791-b86a-4f26-9356-17b0645f41b3
12	12	0	Colombian Biodiversity Information System	7e865cba-7c46-417b-ade5-97f2cf5b7be0	d2947c15-1c5e-4a57-95d4-944cbb493523
846	846	0	GBIF France	da44cd31-5901-4687-a106-6d1c7734ee3a	d3fcc4bd-bdbc-403d-92a0-bdb12fdec2fb
0	2	2	Plazi	ffb07bec-2d10-492d-9c37-361fe0b79427	d59ef689-6666-421e-8e46-c3fa65865db4
0	953	953	Tanzania Biodiversity Information Facility	abd95ca6-3959-4db9-aaa6-2de1aeecf514	d8518236-7e97-4608-b028-103471261e84
6	6	0	GBIF Brazil	cdc9736d-5ff7-4ece-9959-3c744360cdb3	dcfcfd0d-de39-48b3-ae82-ed05dd17bab2
20	20	0	Plazi	ffb07bec-2d10-492d-9c37-361fe0b79427	dd087875-567f-4dc2-a6f0-06cd5cadf8bc
2749	2749	0	Belgian Biodiversity Platform	fb11cfe1-ebc3-45af-9159-17d9fddbcdac	dd3ae3d0-1fb5-11df-8ea3-b8a03c50a862
285	285	0	GBIF France	da44cd31-5901-4687-a106-6d1c7734ee3a	df1631f7-3a5b-4242-8052-0001d32c395f
58031	58031	0	Costa Rica Biodiversity Facility	3379bb09-1a58-41e7-9c57-e3b66c3eb5a0	e0685eeb-5929-4d41-a2da-20712ee7a82c
247	247	0	National Biodiversity Network	d897a5b9-35ee-4232-94bd-b0bcaac003c2	e09e1e1f-2460-4017-a964-e999abd2bf66
6	6	0	Plazi	ffb07bec-2d10-492d-9c37-361fe0b79427	e15f113d-cff7-4ab7-b91b-82c355094382
49	49	0	Plazi	ffb07bec-2d10-492d-9c37-361fe0b79427	e3157d39-d48d-4df2-94a8-b097803e4342
72	72	0	Plazi	ffb07bec-2d10-492d-9c37-361fe0b79427	ea76f076-28b0-4986-90c9-2e49b08bf46a
16493	16493	0	GBIF Argentina	2426a871-9feb-40a1-96c6-0c593a76b835	ee789ae4-ef51-4ff2-931b-bc61b2dbe40e
0	2	2	Plazi	ffb07bec-2d10-492d-9c37-361fe0b79427	f2866618-3373-417a-9e3d-f7de5b7d1b03
36	36	0	National Biodiversity Network	d897a5b9-35ee-4232-94bd-b0bcaac003c2	f2e0e554-776f-4da5-b712-e9860201fb07
83	83	0	National Biodiversity Network	d897a5b9-35ee-4232-94bd-b0bcaac003c2	f4642044-eb59-4645-8928-1f6388c22eb8
1	1	0	Plazi	ffb07bec-2d10-492d-9c37-361fe0b79427	f81e827f-2655-4d19-a03c-ecc8ec20b39d
242	242	0	U.S. Geological Survey	8618c64a-93e0-4300-b546-7249e5148ed2	f8d03ba0-f81b-482c-a7d0-bd3254e9e7e7
988	988	0	GBIF Germany	4f6826f2-4ff6-443d-b966-e6913bd24013	fe7b0de4-c800-4564-afdc-d98ab465a3e3
1	1	0	Plazi	ffb07bec-2d10-492d-9c37-361fe0b79427	0081d7e4-e694-400c-8683-132166e3e038
834	834	0	GBIF Madagascar	2dbfc5c5-51b5-4494-9dfc-4d3f013a3b64	00cdcfb5-db92-4839-9b43-45950cb33bcb
2	2	0	Plazi	ffb07bec-2d10-492d-9c37-361fe0b79427	011283e4-2ee0-47ac-b233-224d7fac7ecc
591	591	0	GBIF France	da44cd31-5901-4687-a106-6d1c7734ee3a	040d7533-d3b2-4ee1-903e-bf0c5c7198a0
6848	6848	0	Canada Biodiversity Information Facility	8f83fc96-c966-4126-83f7-bf044dc49efa	042b2294-d6ec-4a9c-bafe-0be82c035350
11	11	0	GBIF Germany	4f6826f2-4ff6-443d-b966-e6913bd24013	04d71176-dd05-44ab-93fa-46a3749f425d
0	13	13	Plazi	ffb07bec-2d10-492d-9c37-361fe0b79427	0989fb63-365b-4998-b4a0-c37bd010cbbb
0	19	19	Plazi	ffb07bec-2d10-492d-9c37-361fe0b79427	0a4b5399-02ed-409f-b501-77f52fa2caff
1	1	0	Plazi	ffb07bec-2d10-492d-9c37-361fe0b79427	0a520a02-3471-4f4f-bad4-03ad7fdd750c
2794	2794	0	GBIF France	da44cd31-5901-4687-a106-6d1c7734ee3a	0b9aadca-7e08-4f6d-8855-b7b2358aff02
504	503	-1	Biodiversity Information System of Mexico	b324e8e9-9a4c-44fa-8f1a-7f39ea7ab576	11081e0b-5ead-4d79-909f-b99cc4ebd444
0	45	45	National Biodiversity Data Centre	422b00b2-6c94-4bb6-976b-c359916efdb8	147a98bf-db28-4ee2-9780-8121ded52a92
0	170	170	Participant Node Managers Committee	7f48e0c8-5c96-49ec-b972-30748e339115	1a224755-38c6-4e01-aaac-beb8ff0e2fac
32	32	0	GBIF Germany	4f6826f2-4ff6-443d-b966-e6913bd24013	1a58b1f6-fa25-46d0-9086-ff4acb2c8049
0	1	1	Plazi	ffb07bec-2d10-492d-9c37-361fe0b79427	1b2a3450-a761-422e-a6b0-d0c62c1afc2a
0	7	7	Participant Node Managers Committee	7f48e0c8-5c96-49ec-b972-30748e339115	1beb4a82-9967-4e82-841e-3ad12725ffd6
1013	1013	0	GBIF France	da44cd31-5901-4687-a106-6d1c7734ee3a	1d257f2a-a22a-4c6f-80cd-22f152ad8d46
0	142	142	Plazi	ffb07bec-2d10-492d-9c37-361fe0b79427	209efba8-a825-441c-bb34-32057cb38ddf
380	380	0	GBIF Germany	4f6826f2-4ff6-443d-b966-e6913bd24013	23aad1ff-bb31-46a0-8d7a-637cdcab7a4d
177	177	0	GBIF Brazil	cdc9736d-5ff7-4ece-9959-3c744360cdb3	24217e09-f3b0-45a6-a0d5-e10b69a09370
0	7	7	Plazi	ffb07bec-2d10-492d-9c37-361fe0b79427	25ab46cc-e4e0-4b43-8835-4078aefa83aa
523	523	0	GBIF France	da44cd31-5901-4687-a106-6d1c7734ee3a	2a04fd6d-ed41-4773-8974-ad79c067d466
3281	3281	0	GBIF Portugal	673f7038-4262-4149-b753-5658a4e912f6	2a15f6bf-c850-4a52-84cf-d127224be076
8881	8881	0	GBIF France	da44cd31-5901-4687-a106-6d1c7734ee3a	2aaf8ea9-0460-41d2-a651-3583479947c6
11	11	0	Plazi	ffb07bec-2d10-492d-9c37-361fe0b79427	2d1727bb-465d-43e4-a6f7-56cc7efcedaf
1	1	0	GBIF Finland	dd514216-5c7c-45f3-910d-797424cb5be6	2dd1b3bf-f2cd-4696-8314-8a01febc9828
19	19	0	Plazi	ffb07bec-2d10-492d-9c37-361fe0b79427	2e35c402-5fb4-4f5a-aaf6-240dc8eba005
4929	4929	0	National Biodiversity Network	d897a5b9-35ee-4232-94bd-b0bcaac003c2	30d7727f-2a7e-456f-8c66-9b86d22c487a
0	132	132	Plazi	ffb07bec-2d10-492d-9c37-361fe0b79427	32c50ac2-bfd6-462c-a8ca-4806b75907d0
0	6	6	Plazi	ffb07bec-2d10-492d-9c37-361fe0b79427	33029ba1-804a-42bc-bf91-9695e19c3ddd
1	1	0	Plazi	ffb07bec-2d10-492d-9c37-361fe0b79427	33547387-5f3a-4dd6-b068-e868510a7a3f
17	17	0	Plazi	ffb07bec-2d10-492d-9c37-361fe0b79427	341389a7-6315-486b-b238-601ac4a1297d
124	124	0	Plazi	ffb07bec-2d10-492d-9c37-361fe0b79427	34c998ff-fad8-436e-a614-4760b01fcc01
7804	7804	0	Biodiversity Information System of Mexico	b324e8e9-9a4c-44fa-8f1a-7f39ea7ab576	360ea197-6713-46f3-bde3-ed5c29afa0f4
2072	2072	0	GBIF Spain	1f94b3ca-9345-4d65-afe2-4bace93aa0fe	370c7ee7-9290-4afc-89f0-f26fb3ac7086
953	953	0	GBIF France	da44cd31-5901-4687-a106-6d1c7734ee3a	384fed5b-4469-4333-97a7-3cddce92338c
63	63	0	Plazi	ffb07bec-2d10-492d-9c37-361fe0b79427	39f06af4-6b27-4970-9017-81a76f44b6c2
246253	246253	0	GBIF Spain	1f94b3ca-9345-4d65-afe2-4bace93aa0fe	3ccbdf5b-7935-44f9-a7f9-fa3573b8b958
32311	32311	0	Atlas of Living Australia	4a6f1b71-969e-4fc5-a693-282b05e1220c	3d5d2fc8-05bb-4d16-afb2-9d61a891e2d5
6	6	0	Plazi	ffb07bec-2d10-492d-9c37-361fe0b79427	3d92fbec-d3af-415f-a26e-d71ae0afa9f8
7	7	0	Plazi	ffb07bec-2d10-492d-9c37-361fe0b79427	3e9066f1-c580-45a6-92e3-b44a3a63e828
1684	1684	0	GBIF Brazil	cdc9736d-5ff7-4ece-9959-3c744360cdb3	42843f95-6fe3-47e4-bd0c-f4fcadca232f
1635	1992	357	GBIF Brazil	cdc9736d-5ff7-4ece-9959-3c744360cdb3	435a8964-e58a-488c-8c93-1fd62eab13cc
0	59	59	Colombian Biodiversity Information System	7e865cba-7c46-417b-ade5-97f2cf5b7be0	49836797-d991-4dcd-8ba9-020edb54fc03
0	31	31	Plazi	ffb07bec-2d10-492d-9c37-361fe0b79427	49f3bd37-fa27-45a4-90b2-1e80c7f027ac
4	4	0	Plazi	ffb07bec-2d10-492d-9c37-361fe0b79427	4af745b9-4d1b-4959-92ce-0aefd900d164
135	135	0	GBIF Germany	4f6826f2-4ff6-443d-b966-e6913bd24013	4dd2e719-3588-4302-a0e2-0458a2e79f64
0	170	170	Ocean Biodiversity Information System	ba0670b9-4186-41e6-8e70-f9cb3065551a	4e4a606e-ee68-48a8-90f1-e32a392dadf3
43373	43373	0	National Biodiversity Network	d897a5b9-35ee-4232-94bd-b0bcaac003c2	520237b3-b0b3-47b5-90e1-af12098d6128
203	203	0	Plazi	ffb07bec-2d10-492d-9c37-361fe0b79427	54115d80-05ed-4ee7-b035-1ac714f9c31d
0	181	181	Plazi	ffb07bec-2d10-492d-9c37-361fe0b79427	5609efe0-4abd-4ffd-bcf2-518327f91825
2366	2366	0	National Biodiversity Network	d897a5b9-35ee-4232-94bd-b0bcaac003c2	57bdb985-4a64-4b8d-99f0-c000d77d1b90
103	103	0	Plazi	ffb07bec-2d10-492d-9c37-361fe0b79427	57f8ff28-59ea-403a-8d53-2f16eef6d0d8
0	43	43	Plazi	ffb07bec-2d10-492d-9c37-361fe0b79427	58d3914a-d15e-4a52-90c9-54aeb06d9ee7
11	11	0	Plazi	ffb07bec-2d10-492d-9c37-361fe0b79427	5c00d68f-baf0-4355-b1c8-033925c16b5e
5	5	0	Plazi	ffb07bec-2d10-492d-9c37-361fe0b79427	5cdca881-494b-4afe-be12-03114eaa9ff6
549	549	0	GBIF Germany	4f6826f2-4ff6-443d-b966-e6913bd24013	5ef26212-fa9e-4ce9-8e70-2ccddf3dae44
675	675	0	GBIF Portugal	673f7038-4262-4149-b753-5658a4e912f6	6005f3b4-da6a-4d88-ac92-81f2e950eb24
548	553	5	GBIF Japan	db5705aa-6a6e-42f1-8942-d77b9f4896ea	600edbb7-7d77-49ec-9085-3427306dd058
53	53	0	GBIF Germany	4f6826f2-4ff6-443d-b966-e6913bd24013	6275bd8c-f762-11e1-a439-00145eb45e9a
21	21	0	GBIF Germany	4f6826f2-4ff6-443d-b966-e6913bd24013	62897048-f762-11e1-a439-00145eb45e9a
0	41	41	Colombian Biodiversity Information System	7e865cba-7c46-417b-ade5-97f2cf5b7be0	62b3e751-30d6-420b-8190-fa043d885df7
32	32	0	GBIF Germany	4f6826f2-4ff6-443d-b966-e6913bd24013	633d67ec-f762-11e1-a439-00145eb45e9a
14576	14576	0	Colombian Biodiversity Information System	7e865cba-7c46-417b-ade5-97f2cf5b7be0	6424b95e-eee2-41fc-9450-bac5d6767525
114	114	0	GBIF Germany	4f6826f2-4ff6-443d-b966-e6913bd24013	6458d8b4-f762-11e1-a439-00145eb45e9a
74	74	0	GBIF France	da44cd31-5901-4687-a106-6d1c7734ee3a	6640c524-a08f-4a5e-85d3-40b30b7e2135
61	61	0	GBIF Germany	4f6826f2-4ff6-443d-b966-e6913bd24013	66c5f30c-f762-11e1-a439-00145eb45e9a
68	68	0	GBIF Germany	4f6826f2-4ff6-443d-b966-e6913bd24013	66d5a2b6-f762-11e1-a439-00145eb45e9a
1620	420	-1200	GBIF Germany	4f6826f2-4ff6-443d-b966-e6913bd24013	67142e42-9200-49d6-bfad-fd940495445a
94	94	0	GBIF Germany	4f6826f2-4ff6-443d-b966-e6913bd24013	67e75244-f762-11e1-a439-00145eb45e9a
2845	2845	0	National Biodiversity Network	d897a5b9-35ee-4232-94bd-b0bcaac003c2	67e8b123-bfbe-4b10-bbae-a28a97c75311
109	109	0	GBIF Germany	4f6826f2-4ff6-443d-b966-e6913bd24013	683815f8-f762-11e1-a439-00145eb45e9a
10	10	0	Plazi	ffb07bec-2d10-492d-9c37-361fe0b79427	69436d49-1930-487a-ba94-21a15a57c098
198	198	0	GBIF Germany	4f6826f2-4ff6-443d-b966-e6913bd24013	6d50d3a4-f762-11e1-a439-00145eb45e9a
10	10	0	GBIF Kenya	2a44d626-9f7a-4120-8a7a-4ab5ac15ff2a	6e3f6699-5a84-4b28-8d80-8d1dd77d6c14
98	89	-9	GBIF Germany	4f6826f2-4ff6-443d-b966-e6913bd24013	723be76e-649a-4b4b-b27c-07888dc19e83
36	36	0	GBIF Germany	4f6826f2-4ff6-443d-b966-e6913bd24013	72b4544c-f762-11e1-a439-00145eb45e9a
83	83	0	GBIF Germany	4f6826f2-4ff6-443d-b966-e6913bd24013	72e51820-f762-11e1-a439-00145eb45e9a
5	5	0	Plazi	ffb07bec-2d10-492d-9c37-361fe0b79427	72f3e4d9-31fa-4541-975f-d766a1589b6b
182	182	0	GBIF Germany	4f6826f2-4ff6-443d-b966-e6913bd24013	747884b0-f762-11e1-a439-00145eb45e9a
449	449	0	GBIF Germany	4f6826f2-4ff6-443d-b966-e6913bd24013	7483c10b-e75d-41d4-9d75-76aa45cfd291
101	101	0	GBIF Uruguay	a3ceb6dd-0a65-4f30-a385-30f6937c2096	79240b21-671e-4ede-9d65-aa6b735230fd
0	10	10	Plazi	ffb07bec-2d10-492d-9c37-361fe0b79427	799ca96d-5fd6-4342-8c05-1c83c61483ac
0	58	58	Netherlands Biodiversity Information Facility	0909d601-bda2-42df-9e63-a6d51847ebce	79f334f2-2a53-4571-b1bc-9ffd078ff3cf
8649	8649	0	Korean Biodiversity Information Facility	e0a1e772-0177-4800-94b4-2d023fe6cdf4	7af14f52-f762-11e1-a439-00145eb45e9a
420	420	0	GBIF Germany	4f6826f2-4ff6-443d-b966-e6913bd24013	7bb714ee-f762-11e1-a439-00145eb45e9a
1188	924	-264	GBIF Germany	4f6826f2-4ff6-443d-b966-e6913bd24013	7c2da17c-f762-11e1-a439-00145eb45e9a
74	74	0	GBIF Germany	4f6826f2-4ff6-443d-b966-e6913bd24013	7c9bc012-f762-11e1-a439-00145eb45e9a
439	441	2	GBIF Germany	4f6826f2-4ff6-443d-b966-e6913bd24013	7cf5c968-1387-11e2-bb2e-00145eb45e9a
1161	1161	0	GBIF Germany	4f6826f2-4ff6-443d-b966-e6913bd24013	7d6362f2-f762-11e1-a439-00145eb45e9a
74	74	0	GBIF Germany	4f6826f2-4ff6-443d-b966-e6913bd24013	7dc103e4-1387-11e2-bb2e-00145eb45e9a
0	195	195	U.S. Geological Survey	8618c64a-93e0-4300-b546-7249e5148ed2	7f9b9e18-e266-4bc0-ac29-37b86c5fc24f
4034	4034	0	Participant Node Managers Committee	7f48e0c8-5c96-49ec-b972-30748e339115	7fadb3a5-77af-4987-825e-8e48662cb507
0	1	1	Plazi	ffb07bec-2d10-492d-9c37-361fe0b79427	811c5269-b3df-4b1b-847e-139439edfbde
0	130	130	Plazi	ffb07bec-2d10-492d-9c37-361fe0b79427	81282108-3550-4a28-83ca-15bb5b23881a
1229	1229	0	GBIF France	da44cd31-5901-4687-a106-6d1c7734ee3a	826e2ac8-8e47-41ad-bb05-d561325802e2
6	6	0	Plazi	ffb07bec-2d10-492d-9c37-361fe0b79427	84cdea0d-dde9-4818-9d97-b42809cde87f
38	38	0	GBIF Germany	4f6826f2-4ff6-443d-b966-e6913bd24013	85d73d50-f762-11e1-a439-00145eb45e9a
6	6	0	Plazi	ffb07bec-2d10-492d-9c37-361fe0b79427	8625cbc2-f6e9-4503-a875-6d170d956e3d
200	150	-50	GBIF Germany	4f6826f2-4ff6-443d-b966-e6913bd24013	87763ca6-f762-11e1-a439-00145eb45e9a
6178	4524	-1654	GBIF Germany	4f6826f2-4ff6-443d-b966-e6913bd24013	87976dea-f762-11e1-a439-00145eb45e9a
0	10	10	Plazi	ffb07bec-2d10-492d-9c37-361fe0b79427	88488cba-2f64-4fbe-a0fa-ca99dd98ae55
0	316	316	Belgian Biodiversity Platform	fb11cfe1-ebc3-45af-9159-17d9fddbcdac	8a80c717-bdb1-452a-9268-c7335f8f832b
30817	30817	0	National Biodiversity Network	d897a5b9-35ee-4232-94bd-b0bcaac003c2	8c3e7db0-5c1a-49df-af56-9cb84d8511ff
137	115	-22	GBIF Germany	4f6826f2-4ff6-443d-b966-e6913bd24013	900cb98a-f762-11e1-a439-00145eb45e9a
441	254	-187	GBIF Germany	4f6826f2-4ff6-443d-b966-e6913bd24013	905d05c0-f762-11e1-a439-00145eb45e9a
18	12	-6	GBIF Germany	4f6826f2-4ff6-443d-b966-e6913bd24013	90d2fc94-f762-11e1-a439-00145eb45e9a
6	6	0	Plazi	ffb07bec-2d10-492d-9c37-361fe0b79427	915dc71e-0d15-4a61-a2e7-f24bc6d647e1
0	12	12	Plazi	ffb07bec-2d10-492d-9c37-361fe0b79427	916e2dad-dbf7-4d1d-b0ca-92ebada04370
2	2	0	GBIF Germany	4f6826f2-4ff6-443d-b966-e6913bd24013	937428a6-f762-11e1-a439-00145eb45e9a
56582	56582	0	Atlas of Living Australia	4a6f1b71-969e-4fc5-a693-282b05e1220c	9380202e-de78-488f-ada2-d0000e2e8a04
804	804	0	GBIF Germany	4f6826f2-4ff6-443d-b966-e6913bd24013	940a8648-f762-11e1-a439-00145eb45e9a
3	3	0	Plazi	ffb07bec-2d10-492d-9c37-361fe0b79427	94ba47a6-9421-48a4-add4-6f49f48575b7
310	310	0	GBIF Germany	4f6826f2-4ff6-443d-b966-e6913bd24013	95936188-f762-11e1-a439-00145eb45e9a
460	460	0	GBIF Germany	4f6826f2-4ff6-443d-b966-e6913bd24013	95d7ab9a-f762-11e1-a439-00145eb45e9a
141	141	0	GBIF Germany	4f6826f2-4ff6-443d-b966-e6913bd24013	960ddbc0-f762-11e1-a439-00145eb45e9a
104	104	0	GBIF Germany	4f6826f2-4ff6-443d-b966-e6913bd24013	9611945d-a051-47d0-85b8-b1a92b7a2196
214	214	0	GBIF Germany	4f6826f2-4ff6-443d-b966-e6913bd24013	96d1af14-f762-11e1-a439-00145eb45e9a
255	210	-45	GBIF Germany	4f6826f2-4ff6-443d-b966-e6913bd24013	9857d41e-3ca4-49ec-99ba-f67fd09c2723
307397	302630	-4767	Biodiversity Information System of Mexico	b324e8e9-9a4c-44fa-8f1a-7f39ea7ab576	98c51784-da02-4f0e-81a4-f3635cb3cba7
8	9	1	Plazi	ffb07bec-2d10-492d-9c37-361fe0b79427	9938488f-b51e-426d-8e49-1f5e12985e55
1	1	0	Plazi	ffb07bec-2d10-492d-9c37-361fe0b79427	9ca3d5a0-a90d-4622-9a36-1b11ab2045c4
48469	48469	0	U.S. Geological Survey	8618c64a-93e0-4300-b546-7249e5148ed2	9f2bc0a9-db10-4cfb-96c4-e6c25d39e6af
189	189	0	Ocean Biodiversity Information System	ba0670b9-4186-41e6-8e70-f9cb3065551a	a375889c-8799-4ea3-8827-de3dce518663
545	545	0	Biodiversity Information System of Mexico	b324e8e9-9a4c-44fa-8f1a-7f39ea7ab576	a6fd2493-a0b3-452e-8be7-17ab4aa829f3
7	7	0	Plazi	ffb07bec-2d10-492d-9c37-361fe0b79427	a80f275c-a61f-4a5b-a6fe-ddd05d42c73f
0	8	8	Participant Node Managers Committee	7f48e0c8-5c96-49ec-b972-30748e339115	a9829ebd-d6c9-480c-9d21-71641bac1400
35	1180	1145	GBIF Germany	4f6826f2-4ff6-443d-b966-e6913bd24013	aa639879-c067-4832-9830-32206eee3da5
7814	7814	0	Biodiversity Information System of Mexico	b324e8e9-9a4c-44fa-8f1a-7f39ea7ab576	ac62357d-eaf9-4284-9720-7d327f5f5c99
494	494	0	National Biodiversity Network	d897a5b9-35ee-4232-94bd-b0bcaac003c2	ac839d0c-d86b-4cc1-af13-7754407658ce
86	86	0	Plazi	ffb07bec-2d10-492d-9c37-361fe0b79427	ae7f2b81-fd03-4ded-b33d-9f086dd3a0c8
42	42	0	Plazi	ffb07bec-2d10-492d-9c37-361fe0b79427	b0494d52-10ee-4896-9899-04cb50b391f0
820	820	0	Colombian Biodiversity Information System	7e865cba-7c46-417b-ade5-97f2cf5b7be0	b0637f64-52a5-4938-b9e0-63f702fdecdc
138	138	0	Plazi	ffb07bec-2d10-492d-9c37-361fe0b79427	b0c87592-1fbb-49d4-9db0-df99055671af
1148	1148	0	Belgian Biodiversity Platform	fb11cfe1-ebc3-45af-9159-17d9fddbcdac	b10b4c57-e186-4699-8e1c-0350c4993972
4	4	0	Plazi	ffb07bec-2d10-492d-9c37-361fe0b79427	b120c39b-e965-4827-9fd4-ef2d98b8e594
8	8	0	Plazi	ffb07bec-2d10-492d-9c37-361fe0b79427	b3e8347a-67c3-4330-ab37-461e2239ce95
44	44	0	Plazi	ffb07bec-2d10-492d-9c37-361fe0b79427	b496edfb-b66d-43ff-aa30-86d347eb98ae
84	84	0	Plazi	ffb07bec-2d10-492d-9c37-361fe0b79427	b753c71a-aad2-4e6e-9e62-c80348c2cff2
4	4	0	Plazi	ffb07bec-2d10-492d-9c37-361fe0b79427	b7fb6881-1964-47e7-9fbf-2445456b5b65
1589	1589	0	GBIF France	da44cd31-5901-4687-a106-6d1c7734ee3a	be08cce1-1b48-48be-a3b1-1cafe3002c60
0	7606	7606	Participant Node Managers Committee	7f48e0c8-5c96-49ec-b972-30748e339115	bf77f311-65ad-4008-bce9-0805a0f087d4
7600	7600	0	Atlas of Living Australia	4a6f1b71-969e-4fc5-a693-282b05e1220c	bfbac936-6715-4f50-9b18-175bffb85025
2	2	0	Plazi	ffb07bec-2d10-492d-9c37-361fe0b79427	c4a29c39-169e-4f88-8303-38ec5207aff6
76	76	0	Plazi	ffb07bec-2d10-492d-9c37-361fe0b79427	c4d067fa-4c56-4248-8084-caf4dd1eea21
17	17	0	GBIF Brazil	cdc9736d-5ff7-4ece-9959-3c744360cdb3	c523647a-8668-4d19-abd8-ee9d924b2cc5
8	8	0	Plazi	ffb07bec-2d10-492d-9c37-361fe0b79427	c5c601d2-c2d1-4841-a206-5b6778989ad6
1	1	0	Plazi	ffb07bec-2d10-492d-9c37-361fe0b79427	c6fc3b04-6242-471b-bf0a-10c83292f082
471666	471665	-1	National Biodiversity Network	d897a5b9-35ee-4232-94bd-b0bcaac003c2	cc2031d1-395d-4052-8ce1-796a08c3dbf2
0	8	8	Plazi	ffb07bec-2d10-492d-9c37-361fe0b79427	d080b83a-2be4-413f-95d7-f85521993d90
171	171	0	GBIF Germany	4f6826f2-4ff6-443d-b966-e6913bd24013	d149c0a9-6912-4892-aff1-cf3e7b2aa82a
4	4	0	Plazi	ffb07bec-2d10-492d-9c37-361fe0b79427	d296b045-16db-4f41-83d8-8e82e33202e4
21	21	0	Colombian Biodiversity Information System	7e865cba-7c46-417b-ade5-97f2cf5b7be0	d51004b2-e9e2-4d37-8750-5e2d7f8e1819
0	2	2	Plazi	ffb07bec-2d10-492d-9c37-361fe0b79427	d5a35edd-8bc1-4bf7-b6c7-0538c8c4b46f
18	18	0	Plazi	ffb07bec-2d10-492d-9c37-361fe0b79427	d67f767a-7d54-4fd9-9032-619d863b9ae8
0	97	97	Plazi	ffb07bec-2d10-492d-9c37-361fe0b79427	d75cdcea-4b81-4b1f-ada5-69135a4d7b98
961352	961352	0	U.S. Geological Survey	8618c64a-93e0-4300-b546-7249e5148ed2	e0ae862b-d456-4cb2-900b-c4928b75a1f8
4	4	0	Plazi	ffb07bec-2d10-492d-9c37-361fe0b79427	e0d013c3-2082-4403-9f98-c074bbd4ca46
231	231	0	GBIF Sweden	a0b3be64-6525-4387-ac67-a499950f92e1	e26ebaa1-b488-4075-9212-579f5105fafb
1	1	0	Plazi	ffb07bec-2d10-492d-9c37-361fe0b79427	e320619c-87b6-4f6d-a630-16fdaf828dfa
8545	8545	0	GBIF France	da44cd31-5901-4687-a106-6d1c7734ee3a	e42bf2ce-364f-444c-ba0e-c5947cc5f4b3
62	62	0	Plazi	ffb07bec-2d10-492d-9c37-361fe0b79427	e664781d-4584-44b8-b5fa-e0ea029fdc0d
0	38	38	Plazi	ffb07bec-2d10-492d-9c37-361fe0b79427	eb63b27c-d4a7-4ee6-8b5e-0991232f95e4
3	3	0	Plazi	ffb07bec-2d10-492d-9c37-361fe0b79427	ec43cb90-ad42-467e-8ada-43bc3248ce78
11	11	0	Plazi	ffb07bec-2d10-492d-9c37-361fe0b79427	ed64cd3a-2478-45f1-a0e6-ae0384f6c740
28	28	0	Colombian Biodiversity Information System	7e865cba-7c46-417b-ade5-97f2cf5b7be0	f0da296e-e055-4860-8655-f67099f68891
39	39	0	Plazi	ffb07bec-2d10-492d-9c37-361fe0b79427	f2507102-8b9c-4f7c-b171-a415768baafd
0	13356	13356	Ocean Biodiversity Information System	ba0670b9-4186-41e6-8e70-f9cb3065551a	f4af0194-7169-4f91-92f2-49c4394d3eef
21	21	0	Plazi	ffb07bec-2d10-492d-9c37-361fe0b79427	f4af0ca5-f386-4f51-a604-61e9e135cba4
8	8	0	Plazi	ffb07bec-2d10-492d-9c37-361fe0b79427	f742f080-dffe-4c81-aa44-88279b2b3243
4306	4306	0	GBIF Norway	4f829580-180d-46a9-9c87-ed8ec959b545	fbcbdda3-abc2-47ae-9b8e-b75ab1128d54
2371	2371	0	GBIF France	da44cd31-5901-4687-a106-6d1c7734ee3a	fd0807e5-f55d-49af-bc79-7e133fab08bc
0	183	183	Colombian Biodiversity Information System	7e865cba-7c46-417b-ade5-97f2cf5b7be0	fd26a7a9-6f28-4c88-9915-a9cc9109f4c9
0	5	5	Plazi	ffb07bec-2d10-492d-9c37-361fe0b79427	fe646422-0996-4bbd-8137-4e7a16ee8472
502809	512121	9312	GBIF France	da44cd31-5901-4687-a106-6d1c7734ee3a	fea77396-7b26-44cb-8580-aefadc8db276
2246	2248	2	U.S. Geological Survey	8618c64a-93e0-4300-b546-7249e5148ed2	001e060d-ac3b-46d9-955f-50fba13102d2
0	7	7	Plazi	ffb07bec-2d10-492d-9c37-361fe0b79427	012626c5-792b-45f3-b7e6-16ec61420de8
0	1	1	Plazi	ffb07bec-2d10-492d-9c37-361fe0b79427	01dd76e0-3665-4cb3-bec0-c6bc6c8cc482
880	880	0	Colombian Biodiversity Information System	7e865cba-7c46-417b-ade5-97f2cf5b7be0	02428eee-d2e5-4927-98f3-292a5c45d0b6
181857	185604	3747	Canada Biodiversity Information Facility	8f83fc96-c966-4126-83f7-bf044dc49efa	07fd0d79-4883-435f-bba1-58fef110cd13
39	39	0	Plazi	ffb07bec-2d10-492d-9c37-361fe0b79427	0e5f6453-78e1-4fed-831b-a6385cc5cf07
109	109	0	Colombian Biodiversity Information System	7e865cba-7c46-417b-ade5-97f2cf5b7be0	1452b04f-4352-43a4-9a51-c10c456cf6e9
0	8	8	Plazi	ffb07bec-2d10-492d-9c37-361fe0b79427	146052d6-ccc2-48f3-b059-3757ce97ba4e
5	5	0	Plazi	ffb07bec-2d10-492d-9c37-361fe0b79427	1538b033-b51e-4e1f-833d-5fec242a80e1
2740	2740	0	GBIF France	da44cd31-5901-4687-a106-6d1c7734ee3a	16b9f0be-1118-498e-a80d-cc415f57ede8
5009	5009	0	National Biodiversity Network	d897a5b9-35ee-4232-94bd-b0bcaac003c2	16cc76d2-dfac-400e-8117-9c1c24d768e3
121	121	0	GBIF France	da44cd31-5901-4687-a106-6d1c7734ee3a	1720793b-0607-4f65-84e6-4781bd7870e3
14	14	0	Plazi	ffb07bec-2d10-492d-9c37-361fe0b79427	1b6f6349-3312-406e-9e37-d996e10d3596
66	66	0	GBIF Argentina	2426a871-9feb-40a1-96c6-0c593a76b835	1bad0cf8-3f3b-4eb5-a466-25f7d96f9494
33954	33954	0	GBIF France	da44cd31-5901-4687-a106-6d1c7734ee3a	1c124078-9b39-4042-84af-b2f948dad993
0	6153	6153	Participant Node Managers Committee	7f48e0c8-5c96-49ec-b972-30748e339115	1c52ce65-b940-4bb8-8666-3025e58ef9ed
2126	1692	-434	GBIF Germany	4f6826f2-4ff6-443d-b966-e6913bd24013	1d779453-876d-4193-88b6-e5f37c3d9284
7	7	0	Plazi	ffb07bec-2d10-492d-9c37-361fe0b79427	25ef4ba0-e90b-4e1c-9b5f-ecdc7fea4514
18106	18106	0	Korean Biodiversity Information Facility	e0a1e772-0177-4800-94b4-2d023fe6cdf4	266726e3-9f9b-44ed-86f2-d590f6c9626e
217	217	0	GBIF France	da44cd31-5901-4687-a106-6d1c7734ee3a	2989d8ba-26f6-405c-8a7c-60d7b4eb0a1d
46	46	0	GBIF France	da44cd31-5901-4687-a106-6d1c7734ee3a	2c3e0a42-d604-4e6d-88e7-11c7d581e052
10	10	0	Plazi	ffb07bec-2d10-492d-9c37-361fe0b79427	2dcc835c-cae7-4b6f-bd33-894b3bf96b32
4	4	0	Plazi	ffb07bec-2d10-492d-9c37-361fe0b79427	3216f841-dd7a-4f3e-bf08-fee6aa61d454
0	917	917	Ocean Biodiversity Information System	ba0670b9-4186-41e6-8e70-f9cb3065551a	344dcc3a-dbc4-436f-bf50-5f8f3097041c
20	20	0	Plazi	ffb07bec-2d10-492d-9c37-361fe0b79427	3547b291-1caf-4dcd-bd68-6a37f3421015
0	5	5	Participant Node Managers Committee	7f48e0c8-5c96-49ec-b972-30748e339115	35629239-0512-4efe-b342-fb7d613460ec
0	576	576	Colombian Biodiversity Information System	7e865cba-7c46-417b-ade5-97f2cf5b7be0	36becc50-3386-4454-88ef-8d72f7f48585
10168	10168	0	Colombian Biodiversity Information System	7e865cba-7c46-417b-ade5-97f2cf5b7be0	37700302-4c97-4bf7-b054-213f254b45d2
2	2	0	Plazi	ffb07bec-2d10-492d-9c37-361fe0b79427	39b5798d-50bf-4ee1-ab88-0f6ffacb8878
3	3	0	Plazi	ffb07bec-2d10-492d-9c37-361fe0b79427	3a78180e-4588-4829-b3d0-861202ef880c
16	16	0	Plazi	ffb07bec-2d10-492d-9c37-361fe0b79427	3bfff749-ac8e-4d52-a222-6ecc380004bc
91785	92671	886	U.S. Geological Survey	8618c64a-93e0-4300-b546-7249e5148ed2	3c59bd42-7bfd-421b-8da4-275780390e4c
5710	6148	438	Colombian Biodiversity Information System	7e865cba-7c46-417b-ade5-97f2cf5b7be0	3d88255b-67ae-4f82-899b-06186eab2995
1	1	0	Plazi	ffb07bec-2d10-492d-9c37-361fe0b79427	3fa62ed0-7d56-4a98-b1d3-22e3f87750cd
0	27	27	Plazi	ffb07bec-2d10-492d-9c37-361fe0b79427	432bca9f-72a0-4728-aa8a-2092f7c6e2b6
260	260	0	GBIF Argentina	2426a871-9feb-40a1-96c6-0c593a76b835	43fe439f-8a5e-41b4-9fba-c5d4eeba4f8b
3	3	0	Plazi	ffb07bec-2d10-492d-9c37-361fe0b79427	45e85401-63c7-4183-b799-7e22af26e4eb
72	72	0	GBIF Germany	4f6826f2-4ff6-443d-b966-e6913bd24013	467b05d6-8100-495e-a72b-caba79e15f0a
0	195	195	Plazi	ffb07bec-2d10-492d-9c37-361fe0b79427	4734c0c4-4948-4b10-beb1-ad949fbd7673
0	2	2	Plazi	ffb07bec-2d10-492d-9c37-361fe0b79427	49bb246b-e3af-40c6-a753-4bea905e896e
9	9	0	Plazi	ffb07bec-2d10-492d-9c37-361fe0b79427	4a89dff5-dca5-4306-b499-05fd7d675990
2	2	0	Plazi	ffb07bec-2d10-492d-9c37-361fe0b79427	4b64c69c-6f25-4930-8240-8d3abe3ab2c1
0	6	6	Plazi	ffb07bec-2d10-492d-9c37-361fe0b79427	4d170749-dff3-4f3d-b0fb-57d11289eb38
6	6	0	Plazi	ffb07bec-2d10-492d-9c37-361fe0b79427	51a00f4c-b78d-4728-bc1c-0646bae1ac42
3	3	0	Plazi	ffb07bec-2d10-492d-9c37-361fe0b79427	54b2150d-e662-450d-b3c2-73b51ac32041
0	26	26	Plazi	ffb07bec-2d10-492d-9c37-361fe0b79427	54e8e365-919d-4c50-b6da-a03adaeee330
3346	3346	0	National Biodiversity Network	d897a5b9-35ee-4232-94bd-b0bcaac003c2	55a829aa-8295-4d5c-a0e7-8b506f1ae29e
8284	8284	0	Colombian Biodiversity Information System	7e865cba-7c46-417b-ade5-97f2cf5b7be0	55d3f041-5cd7-45cf-99e0-80cddfd035d7
238	238	0	National Biodiversity Network	d897a5b9-35ee-4232-94bd-b0bcaac003c2	58af2fa8-c6ea-4cb8-98ef-144512ee26a9
0	64	64	Plazi	ffb07bec-2d10-492d-9c37-361fe0b79427	5921c016-e858-44dc-b266-a784c514d6dc
0	7	7	Plazi	ffb07bec-2d10-492d-9c37-361fe0b79427	5a5c40f6-e3a9-4cf4-9ec0-898275a1d786
600	600	0	GBIF Argentina	2426a871-9feb-40a1-96c6-0c593a76b835	5bcb98a8-0db3-466f-b54a-9d7cb846c3db
3	3	0	Plazi	ffb07bec-2d10-492d-9c37-361fe0b79427	5ee45025-1772-4fe3-85cb-18f0cfe72445
247	247	0	Colombian Biodiversity Information System	7e865cba-7c46-417b-ade5-97f2cf5b7be0	5f8f60e1-c24b-43b7-9511-4292b4c23d97
185	185	0	GBIF Germany	4f6826f2-4ff6-443d-b966-e6913bd24013	61401066-f762-11e1-a439-00145eb45e9a
31	31	0	GBIF Germany	4f6826f2-4ff6-443d-b966-e6913bd24013	627a9a82-f762-11e1-a439-00145eb45e9a
895	895	0	GBIF France	da44cd31-5901-4687-a106-6d1c7734ee3a	6301ff7e-0a2f-4943-a19f-982f46815d5c
0	7	7	Plazi	ffb07bec-2d10-492d-9c37-361fe0b79427	64a55ff4-0a71-491f-a4f4-9b2cd5a41431
38	38	0	GBIF Germany	4f6826f2-4ff6-443d-b966-e6913bd24013	64bacf88-f762-11e1-a439-00145eb45e9a
479	479	0	GBIF Germany	4f6826f2-4ff6-443d-b966-e6913bd24013	64f56e22-f762-11e1-a439-00145eb45e9a
2	2	0	Plazi	ffb07bec-2d10-492d-9c37-361fe0b79427	6537c69f-8419-4a67-94fd-e0433b3fd47a
561	364	-197	GBIF Germany	4f6826f2-4ff6-443d-b966-e6913bd24013	6545dd94-f762-11e1-a439-00145eb45e9a
514	514	0	GBIF Germany	4f6826f2-4ff6-443d-b966-e6913bd24013	655107f0-f762-11e1-a439-00145eb45e9a
841	841	0	National Biodiversity Network	d897a5b9-35ee-4232-94bd-b0bcaac003c2	65d7fc8c-d7dd-49c5-90bb-09af59780a40
1737	1737	0	Colombian Biodiversity Information System	7e865cba-7c46-417b-ade5-97f2cf5b7be0	66e4892a-fe5a-4be9-9ce4-dc86d71cd639
148	148	0	GBIF Germany	4f6826f2-4ff6-443d-b966-e6913bd24013	6743af0e-f762-11e1-a439-00145eb45e9a
315	315	0	Plazi	ffb07bec-2d10-492d-9c37-361fe0b79427	685869d3-363a-4373-8250-4d5abe080321
81	81	0	GBIF Sweden	a0b3be64-6525-4387-ac67-a499950f92e1	68c73384-cdb9-44da-8305-6fa63a05200a
1330	1394	64	GBIF Brazil	cdc9736d-5ff7-4ece-9959-3c744360cdb3	6a4e55d7-4468-4ad8-a5d5-f9ca5d6fa41e
2	2	0	GBIF Germany	4f6826f2-4ff6-443d-b966-e6913bd24013	6ae85af6-f762-11e1-a439-00145eb45e9a
18	18	0	GBIF Germany	4f6826f2-4ff6-443d-b966-e6913bd24013	6b166cde-f762-11e1-a439-00145eb45e9a
28	28	0	GBIF Germany	4f6826f2-4ff6-443d-b966-e6913bd24013	6b575df2-f762-11e1-a439-00145eb45e9a
12	12	0	GBIF Germany	4f6826f2-4ff6-443d-b966-e6913bd24013	6bb6f9c4-f762-11e1-a439-00145eb45e9a
144	144	0	Plazi	ffb07bec-2d10-492d-9c37-361fe0b79427	6d726d36-043e-4f11-885e-19423f04957a
0	26	26	Plazi	ffb07bec-2d10-492d-9c37-361fe0b79427	6d81cd5b-1b1f-4655-a051-dcc64153431a
92	92	0	GBIF France	da44cd31-5901-4687-a106-6d1c7734ee3a	705e7673-a122-4607-a73b-faea77d048c1
136	136	0	GBIF France	da44cd31-5901-4687-a106-6d1c7734ee3a	71a5a9ce-45f2-466e-a246-a4a79370719f
17	17	0	GBIF Germany	4f6826f2-4ff6-443d-b966-e6913bd24013	7296f870-f762-11e1-a439-00145eb45e9a
2	2	0	Plazi	ffb07bec-2d10-492d-9c37-361fe0b79427	72a9c8a5-3284-4081-907e-ed24c6b498db
3	3	0	GBIF Germany	4f6826f2-4ff6-443d-b966-e6913bd24013	72aa4ace-f762-11e1-a439-00145eb45e9a
0	407	407	Plazi	ffb07bec-2d10-492d-9c37-361fe0b79427	73c0dde0-1a03-4fe2-8d13-05cd614ff3b1
262	262	0	GBIF Germany	4f6826f2-4ff6-443d-b966-e6913bd24013	744989f8-f762-11e1-a439-00145eb45e9a
102	102	0	GBIF Germany	4f6826f2-4ff6-443d-b966-e6913bd24013	747f3184-f762-11e1-a439-00145eb45e9a
0	4	4	Plazi	ffb07bec-2d10-492d-9c37-361fe0b79427	751b0546-7fab-47a0-886f-4ef27924aae8
31	31	0	Plazi	ffb07bec-2d10-492d-9c37-361fe0b79427	75d37244-7649-49b9-b6f8-f603c61005b8
0	57	57	Ocean Biodiversity Information System	ba0670b9-4186-41e6-8e70-f9cb3065551a	77660dbf-8b97-47a6-93ec-9319e2299282
31387	32124	737	U.S. Geological Survey	8618c64a-93e0-4300-b546-7249e5148ed2	78ff8409-15b9-456f-9793-291b030190a7
210	193	-17	GBIF Germany	4f6826f2-4ff6-443d-b966-e6913bd24013	795f8398-f762-11e1-a439-00145eb45e9a
15	15	0	GBIF Germany	4f6826f2-4ff6-443d-b966-e6913bd24013	7acdb466-f762-11e1-a439-00145eb45e9a
2	2	0	Plazi	ffb07bec-2d10-492d-9c37-361fe0b79427	7c01e64a-21f3-4786-a02e-46fe3dfb8fb4
1890	1512	-378	GBIF Germany	4f6826f2-4ff6-443d-b966-e6913bd24013	7c6e3e08-f762-11e1-a439-00145eb45e9a
227	227	0	Plazi	ffb07bec-2d10-492d-9c37-361fe0b79427	7d3f7d13-68b6-4560-9de7-41a6b05f3776
3845	3845	0	GBIF Germany	4f6826f2-4ff6-443d-b966-e6913bd24013	7d7da392-f762-11e1-a439-00145eb45e9a
107	107	0	GBIF Germany	4f6826f2-4ff6-443d-b966-e6913bd24013	7ed35ff2-f762-11e1-a439-00145eb45e9a
0	514	514	Ocean Biodiversity Information System	ba0670b9-4186-41e6-8e70-f9cb3065551a	7f27a7ef-1a49-4674-95b4-177a014f9aad
12859	12859	0	Participant Node Managers Committee	7f48e0c8-5c96-49ec-b972-30748e339115	7fafc0ae-7e73-4cec-b280-84bb69b62d75
1	1	0	Plazi	ffb07bec-2d10-492d-9c37-361fe0b79427	7fe04a05-d425-409f-8fa7-90d5a31a5ee9
5918	5918	0	Biodiversity Information System of Mexico	b324e8e9-9a4c-44fa-8f1a-7f39ea7ab576	805ce94c-f762-11e1-a439-00145eb45e9a
1453	1453	0	Biodiversity Information System of Mexico	b324e8e9-9a4c-44fa-8f1a-7f39ea7ab576	808ddbce-f762-11e1-a439-00145eb45e9a
19175	21175	2000	GBIF Japan	db5705aa-6a6e-42f1-8942-d77b9f4896ea	80f17ef4-f762-11e1-a439-00145eb45e9a
0	10	10	Plazi	ffb07bec-2d10-492d-9c37-361fe0b79427	816b600c-aa34-4a0b-8b12-9bcfa046d465
90	90	0	GBIF Germany	4f6826f2-4ff6-443d-b966-e6913bd24013	825218f8-f762-11e1-a439-00145eb45e9a
468	474	6	GBIF Germany	4f6826f2-4ff6-443d-b966-e6913bd24013	82bffa94-f762-11e1-a439-00145eb45e9a
7173	7173	0	Participant Node Managers Committee	7f48e0c8-5c96-49ec-b972-30748e339115	83fe83bb-8667-4263-9d4a-67a76e03e94d
4	4	0	Plazi	ffb07bec-2d10-492d-9c37-361fe0b79427	844fafcf-8f84-4039-ade1-7a03eadaf1d4
180988	207416	26428	U.S. Geological Survey	8618c64a-93e0-4300-b546-7249e5148ed2	84829fe4-f762-11e1-a439-00145eb45e9a
76325	76325	0	U.S. Geological Survey	8618c64a-93e0-4300-b546-7249e5148ed2	84b4d6e4-f762-11e1-a439-00145eb45e9a
24	24	0	Plazi	ffb07bec-2d10-492d-9c37-361fe0b79427	85579781-9936-4971-94d1-1f0c27641991
27	27	0	Plazi	ffb07bec-2d10-492d-9c37-361fe0b79427	869342b8-498b-4aaa-bc1d-ca484c183806
483	330	-153	GBIF Germany	4f6826f2-4ff6-443d-b966-e6913bd24013	86d2364c-f762-11e1-a439-00145eb45e9a
761	631	-130	GBIF Germany	4f6826f2-4ff6-443d-b966-e6913bd24013	873efa7a-f762-11e1-a439-00145eb45e9a
21	15	-6	GBIF Germany	4f6826f2-4ff6-443d-b966-e6913bd24013	87617c30-f762-11e1-a439-00145eb45e9a
10	10	0	GBIF Germany	4f6826f2-4ff6-443d-b966-e6913bd24013	879cb124-f762-11e1-a439-00145eb45e9a
95	95	0	National Biodiversity Network	d897a5b9-35ee-4232-94bd-b0bcaac003c2	88ead26e-a55c-4574-8e72-de3086092768
22	22	0	Ocean Biodiversity Information System	ba0670b9-4186-41e6-8e70-f9cb3065551a	89182920-f762-11e1-a439-00145eb45e9a
186	157	-29	GBIF Germany	4f6826f2-4ff6-443d-b966-e6913bd24013	89638f5a-f762-11e1-a439-00145eb45e9a
0	9	9	Plazi	ffb07bec-2d10-492d-9c37-361fe0b79427	898662d4-7bbc-4417-b97e-aed597c7e49c
3043	3043	0	National Biodiversity Network	d897a5b9-35ee-4232-94bd-b0bcaac003c2	89dbf191-4f08-4632-a66f-74b936bcb2e5
194	194	0	GBIF Germany	4f6826f2-4ff6-443d-b966-e6913bd24013	8a10ba90-f762-11e1-a439-00145eb45e9a
55056	55056	0	National Biodiversity Network	d897a5b9-35ee-4232-94bd-b0bcaac003c2	8bb6b7ef-553f-40a8-872b-c6a54ecf2f68
10	10	0	GBIF Germany	4f6826f2-4ff6-443d-b966-e6913bd24013	8bc53460-f762-11e1-a439-00145eb45e9a
66	66	0	GBIF Germany	4f6826f2-4ff6-443d-b966-e6913bd24013	8bd04f58-f762-11e1-a439-00145eb45e9a
0	3460	3460	Korean Biodiversity Information Facility	e0a1e772-0177-4800-94b4-2d023fe6cdf4	8de067be-9e1e-4823-984e-44d329c2cadd
0	150	150	Plazi	ffb07bec-2d10-492d-9c37-361fe0b79427	8df27694-d6a3-43d8-8a92-a085ef706e26
409	409	0	GBIF Japan	db5705aa-6a6e-42f1-8942-d77b9f4896ea	8f36cf96-6fe0-429c-9a57-2be5f4d3907c
552	552	0	Ocean Biodiversity Information System	ba0670b9-4186-41e6-8e70-f9cb3065551a	8fc75df8-38c7-4744-aa97-f199a0df753f
1032	1032	0	Biodiversity Information System of Mexico	b324e8e9-9a4c-44fa-8f1a-7f39ea7ab576	8fdf4c89-8c37-4070-94dc-0b63bf85abaa
678	492	-186	GBIF Germany	4f6826f2-4ff6-443d-b966-e6913bd24013	90661778-f762-11e1-a439-00145eb45e9a
0	22	22	Plazi	ffb07bec-2d10-492d-9c37-361fe0b79427	9071bf14-8c4a-4e46-8ce8-2d1171712022
347	265	-82	GBIF Germany	4f6826f2-4ff6-443d-b966-e6913bd24013	90924762-f762-11e1-a439-00145eb45e9a
43	26	-17	GBIF Germany	4f6826f2-4ff6-443d-b966-e6913bd24013	910136fe-f762-11e1-a439-00145eb45e9a
0	2522	2522	National Biodiversity Network	d897a5b9-35ee-4232-94bd-b0bcaac003c2	9124d256-aa5f-4172-8f0d-08bf624cf899
102	66	-36	GBIF Germany	4f6826f2-4ff6-443d-b966-e6913bd24013	91a22a5a-f762-11e1-a439-00145eb45e9a
2	2	0	Plazi	ffb07bec-2d10-492d-9c37-361fe0b79427	91efc7f9-e488-4df1-9d2a-2d705e739e10
10	10	0	GBIF Germany	4f6826f2-4ff6-443d-b966-e6913bd24013	920304e2-f762-11e1-a439-00145eb45e9a
6	6	0	GBIF Germany	4f6826f2-4ff6-443d-b966-e6913bd24013	93d04f64-f762-11e1-a439-00145eb45e9a
229	229	0	GBIF Germany	4f6826f2-4ff6-443d-b966-e6913bd24013	93e8137e-f762-11e1-a439-00145eb45e9a
0	5	5	Plazi	ffb07bec-2d10-492d-9c37-361fe0b79427	953683f3-0bf3-462e-acf3-70ff3c2c378d
266	258	-8	GBIF Germany	4f6826f2-4ff6-443d-b966-e6913bd24013	953fffca-f762-11e1-a439-00145eb45e9a
7	7	0	Plazi	ffb07bec-2d10-492d-9c37-361fe0b79427	95845b42-e1f3-464a-a176-b438c539f00b
3	3	0	U.S. Geological Survey	8618c64a-93e0-4300-b546-7249e5148ed2	96e156e5-6a45-40d2-93f3-1bcdb6af6e30
65	65	0	GBIF Germany	4f6826f2-4ff6-443d-b966-e6913bd24013	97cb2b7a-f762-11e1-a439-00145eb45e9a
0	9	9	Plazi	ffb07bec-2d10-492d-9c37-361fe0b79427	9825c147-58b8-40c9-bc7f-ad34a7b90991
0	17	17	Ocean Biodiversity Information System	ba0670b9-4186-41e6-8e70-f9cb3065551a	9bb489bd-941b-4499-8a36-d9b57f3abfe6
106970	106970	0	GBIF Brazil	cdc9736d-5ff7-4ece-9959-3c744360cdb3	9e54731f-ca52-4389-95cb-e4feedc7593e
1	1	0	Plazi	ffb07bec-2d10-492d-9c37-361fe0b79427	a1dc7565-80dc-4a06-a915-ce574cf3b919
188	159	-29	GBIF Germany	4f6826f2-4ff6-443d-b966-e6913bd24013	a2942b1d-ebaf-4280-ace3-b64f5af0144d
379	379	0	Colombian Biodiversity Information System	7e865cba-7c46-417b-ade5-97f2cf5b7be0	a46c9bf3-0b1d-4900-967c-da1bd9c3cc32
0	310	310	Participant Node Managers Committee	7f48e0c8-5c96-49ec-b972-30748e339115	a48ce09c-1e88-44bc-aa65-9db0d4c545db
1	1	0	Plazi	ffb07bec-2d10-492d-9c37-361fe0b79427	a6094fee-c9fe-423a-9990-3e9e8b939267
0	1	1	Plazi	ffb07bec-2d10-492d-9c37-361fe0b79427	a6625916-b550-4888-9bff-18ed834ada51
72775	72775	0	GBIF France	da44cd31-5901-4687-a106-6d1c7734ee3a	af0dade1-e3c0-4682-8ca5-de368cfeff1d
4	4	0	Plazi	ffb07bec-2d10-492d-9c37-361fe0b79427	afbbeeff-25e4-44c5-b563-5c741fa8d0f9
21	21	0	National Biodiversity Network	d897a5b9-35ee-4232-94bd-b0bcaac003c2	b031d82e-33ac-406a-b634-0c473dfaa2bf
0	3	3	Plazi	ffb07bec-2d10-492d-9c37-361fe0b79427	b1e518d3-2219-4d40-937d-139937bf1e23
342	342	0	GBIF Uganda	71b40829-6a12-4c3d-8fee-5746f5e9cf8c	b34036fa-f8de-4bbe-b2a2-f90ba0a234fd
52	52	0	Plazi	ffb07bec-2d10-492d-9c37-361fe0b79427	b44cc4b4-b91b-4b33-a875-3cc2e4d988d5
2	2	0	Plazi	ffb07bec-2d10-492d-9c37-361fe0b79427	b5331c96-ecb8-49aa-a7dd-545949989adf
0	33	33	Plazi	ffb07bec-2d10-492d-9c37-361fe0b79427	b5e03b4c-6014-47cb-8e7a-01bf4307430f
0	73	73	Ocean Biodiversity Information System	ba0670b9-4186-41e6-8e70-f9cb3065551a	baf4fbc7-0d5d-4ee8-b185-94e5e507a4a7
1	1	0	Plazi	ffb07bec-2d10-492d-9c37-361fe0b79427	bffc97b7-65af-4487-a6eb-40e3b91f1e97
7320	7320	0	Polish Biodiversity Information Network	2618bfdf-e194-4911-a241-80db3107bc51	c1b0f4a0-3330-11de-8db7-b8a03c50a862
20	20	0	GBIF France	da44cd31-5901-4687-a106-6d1c7734ee3a	c6cc2da8-8cae-4540-b6ad-5fb2373a537c
1726	1726	0	GBIF Kenya	2a44d626-9f7a-4120-8a7a-4ab5ac15ff2a	c7ac7bb5-dde8-4ffc-9ae3-d72ce796d625
2	2	0	Plazi	ffb07bec-2d10-492d-9c37-361fe0b79427	c9fcc53d-7d9f-4f27-9c1c-26ce72ddab3d
0	1	1	Plazi	ffb07bec-2d10-492d-9c37-361fe0b79427	cbff96af-9b3d-43ad-9e06-bb066b87b037
0	5141	5141	Participant Node Managers Committee	7f48e0c8-5c96-49ec-b972-30748e339115	cc76b68b-87cc-442b-9a59-faef85741cc4
872	872	0	GBIF Argentina	2426a871-9feb-40a1-96c6-0c593a76b835	d46b37d6-c4d1-4bb9-abbf-5f8a16f45c04
3	3	0	Plazi	ffb07bec-2d10-492d-9c37-361fe0b79427	d64fa90b-ff2e-4800-9028-1fed547bc2ea
65	65	0	National Biodiversity Network	d897a5b9-35ee-4232-94bd-b0bcaac003c2	d6fddd7b-d1bc-451e-9b12-6b806d486d4b
1084	1074	-10	GBIF Germany	4f6826f2-4ff6-443d-b966-e6913bd24013	d74d612c-d854-4401-9ba9-f2d906bdb633
412	412	0	National Biodiversity Network	d897a5b9-35ee-4232-94bd-b0bcaac003c2	dd6f4b03-8219-49dd-9934-e78ae3f6d8e4
0	2	2	Plazi	ffb07bec-2d10-492d-9c37-361fe0b79427	de40dea4-a7f4-43cc-8e7d-de7220d86942
2654	2654	0	National Biodiversity Network	d897a5b9-35ee-4232-94bd-b0bcaac003c2	e19276e7-0698-4145-ab85-c32c6c76b098
5	5	0	Plazi	ffb07bec-2d10-492d-9c37-361fe0b79427	e3553d4d-c82d-4f42-bca5-3d83f38c030c
0	65	65	GBIF Spain	1f94b3ca-9345-4d65-afe2-4bace93aa0fe	e3ec9e8b-6935-4896-98dd-831af9a49c20
0	6	6	Plazi	ffb07bec-2d10-492d-9c37-361fe0b79427	e69bbfd1-e2a0-48d3-a70f-a918fa84b8ed
2153	2153	0	Atlas of Living Australia	4a6f1b71-969e-4fc5-a693-282b05e1220c	e8d7be1a-865f-4dee-bf10-a042ef43c89f
60	60	0	Plazi	ffb07bec-2d10-492d-9c37-361fe0b79427	e9191d57-25b8-4d3f-bab0-dc27b7987e91
1331	1331	0	National Biodiversity Network	d897a5b9-35ee-4232-94bd-b0bcaac003c2	eb8547b1-4a02-4d68-9159-9e025d4b54da
224	224	0	GBIF Germany	4f6826f2-4ff6-443d-b966-e6913bd24013	ecaee39f-62d7-43d4-ae1a-801c6a14a263
13	13	0	Plazi	ffb07bec-2d10-492d-9c37-361fe0b79427	ecce8cc1-c31c-4e70-a4e4-3ab78c97f131
451	451	0	GBIF Sweden	a0b3be64-6525-4387-ac67-a499950f92e1	eef3e123-0744-4a4c-a22d-b9f45ba90479
0	2	2	Plazi	ffb07bec-2d10-492d-9c37-361fe0b79427	efb1dd4d-d1c3-497c-998a-6b414dfc7bca
43	43	0	Colombian Biodiversity Information System	7e865cba-7c46-417b-ade5-97f2cf5b7be0	f0090be2-6b7f-40aa-9963-b8a1f749aa72
0	12852	12852	Participant Node Managers Committee	7f48e0c8-5c96-49ec-b972-30748e339115	f0633e1c-1b2d-4d80-b881-065e5de44897
3	3	0	Plazi	ffb07bec-2d10-492d-9c37-361fe0b79427	f1a24c6c-c728-4859-9f0f-3789c913ebfa
260	260	0	Ocean Biodiversity Information System	ba0670b9-4186-41e6-8e70-f9cb3065551a	f2654dba-a152-4731-807c-4c90b75ced00
32	32	0	Plazi	ffb07bec-2d10-492d-9c37-361fe0b79427	f39d035d-0ca0-4d8a-888d-700de6678d8b
1698	1698	0	National Biodiversity Network	d897a5b9-35ee-4232-94bd-b0bcaac003c2	f48370df-fe76-4adb-a006-731c68daf2d5
0	1	1	Plazi	ffb07bec-2d10-492d-9c37-361fe0b79427	f5c4a8ff-7188-4460-a0d1-e63966fcea98
19	19	0	Plazi	ffb07bec-2d10-492d-9c37-361fe0b79427	f741a993-17fe-48af-91b3-2570006e8a98
12	12	0	Plazi	ffb07bec-2d10-492d-9c37-361fe0b79427	f856b95c-dd39-4a84-b152-11bce44818e2
54	54	0	Ocean Biodiversity Information System	ba0670b9-4186-41e6-8e70-f9cb3065551a	f959a912-e5b3-49b5-b770-bb05f2dac252
0	1	1	Plazi	ffb07bec-2d10-492d-9c37-361fe0b79427	f9d260c7-bd61-4392-a754-a014dcb3f8bb
88	88	0	GBIF Uganda	71b40829-6a12-4c3d-8fee-5746f5e9cf8c	0092bb9d-962f-46da-b1b8-e07d8de1aa19
402	402	0	National Biodiversity Network	d897a5b9-35ee-4232-94bd-b0bcaac003c2	03bc05c1-8d24-469d-bdfe-4d8800a0b983
40	40	0	Colombian Biodiversity Information System	7e865cba-7c46-417b-ade5-97f2cf5b7be0	0424f140-6ae4-4177-a907-f77ede5e6b36
0	97	97	Plazi	ffb07bec-2d10-492d-9c37-361fe0b79427	096f9dbd-b8f9-491c-b952-8a79357566fd
0	5	5	Plazi	ffb07bec-2d10-492d-9c37-361fe0b79427	0a07a36b-37fb-4f0c-883e-924aa79acc6d
0	339	339	Ocean Biodiversity Information System	ba0670b9-4186-41e6-8e70-f9cb3065551a	0a408865-d68b-4b5c-b5ab-11313fd637f2
3	3	0	Plazi	ffb07bec-2d10-492d-9c37-361fe0b79427	0b6e55b2-9400-49f1-9139-e2c6df595a34
0	36	36	Plazi	ffb07bec-2d10-492d-9c37-361fe0b79427	0b7d66df-755c-4a1a-b925-3c71e1e8fab4
5	5	0	Plazi	ffb07bec-2d10-492d-9c37-361fe0b79427	0c6fc1dc-7274-4125-8a3a-2f1daa2970aa
1	1	0	Plazi	ffb07bec-2d10-492d-9c37-361fe0b79427	0f85c38c-92ad-407b-b21e-54932bdc6058
2268	2268	0	GBIF Chile	a8b16421-d80b-4ef3-8f22-098b01a89255	104b5f14-00bf-4d4f-9cd5-d9efcd799c45
3255	3255	0	National Biodiversity Network	d897a5b9-35ee-4232-94bd-b0bcaac003c2	11a24c97-653b-4e4c-a524-a4c06ffab25f
647	647	0	Participant Node Managers Committee	7f48e0c8-5c96-49ec-b972-30748e339115	123a9782-f545-4b98-a4dd-dfaa6141caba
0	2	2	Plazi	ffb07bec-2d10-492d-9c37-361fe0b79427	13ea2b73-6c57-4d42-8fca-6d2e28944a9c
916	916	0	Colombian Biodiversity Information System	7e865cba-7c46-417b-ade5-97f2cf5b7be0	158cea08-e128-447b-8154-30d3f0bfe9ce
1	1	0	Plazi	ffb07bec-2d10-492d-9c37-361fe0b79427	168fb08a-bd7e-4b26-a0a7-bba3feed09cd
0	3	3	Plazi	ffb07bec-2d10-492d-9c37-361fe0b79427	16a74f8d-6ac6-4fc3-917e-048d25a01097
21	21	0	Plazi	ffb07bec-2d10-492d-9c37-361fe0b79427	19829187-393b-46c5-8e83-c132a5742fb3
29	29	0	Plazi	ffb07bec-2d10-492d-9c37-361fe0b79427	19cf9485-c4c2-4bf1-a834-f13dfcfc50e1
1182	1182	0	GBIF France	da44cd31-5901-4687-a106-6d1c7734ee3a	1b672ec8-4d5c-4cef-94f9-05c3e02b3be8
5109	5109	0	GBIF France	da44cd31-5901-4687-a106-6d1c7734ee3a	1ebea052-40f2-4544-831b-869591067a80
23	23	0	National Biodiversity Network	d897a5b9-35ee-4232-94bd-b0bcaac003c2	2df3e7e7-66f1-4e93-8fb4-3888351056d1
93	93	0	Plazi	ffb07bec-2d10-492d-9c37-361fe0b79427	36a60321-234f-4964-9d69-2284926cd65f
934	934	0	GBIF Germany	4f6826f2-4ff6-443d-b966-e6913bd24013	406755e6-e0eb-4d52-82f4-d6a30df8a4d0
79717	79717	0	Atlas of Living Australia	4a6f1b71-969e-4fc5-a693-282b05e1220c	42793207-9afe-4991-bff4-db2be2e6182e
394	394	0	GBIF Brazil	cdc9736d-5ff7-4ece-9959-3c744360cdb3	42a88234-f16a-4497-9205-04135ef32266
0	2	2	Plazi	ffb07bec-2d10-492d-9c37-361fe0b79427	434e0d91-de7e-4ffc-bdff-d11a25221f4a
19	19	0	Plazi	ffb07bec-2d10-492d-9c37-361fe0b79427	43de8956-0706-4f8d-b5a9-f51c30c276d8
1	1	0	Plazi	ffb07bec-2d10-492d-9c37-361fe0b79427	44296d5c-6021-4a7d-affd-bd98e3b964c8
18	18	0	Plazi	ffb07bec-2d10-492d-9c37-361fe0b79427	45c1dbc9-cfc9-4d53-ae3c-35ef9d39d870
81	81	0	Plazi	ffb07bec-2d10-492d-9c37-361fe0b79427	46f65f25-609f-45ca-a958-d1e518f90344
0	33	33	Plazi	ffb07bec-2d10-492d-9c37-361fe0b79427	47bf26ef-e77a-4a5e-ab7c-65a7519ad79d
235	235	0	GBIF Finland	dd514216-5c7c-45f3-910d-797424cb5be6	4a86fcdc-b4ca-4331-8497-c222c1f81e0f
36	36	0	GBIF Germany	4f6826f2-4ff6-443d-b966-e6913bd24013	4a958f28-b265-4fa7-962a-b421465a1400
1	1	0	Plazi	ffb07bec-2d10-492d-9c37-361fe0b79427	502f1a4d-d7c9-4b43-9943-a8c946a1f823
5343753	5192157	-151596	National Biodiversity Network	d897a5b9-35ee-4232-94bd-b0bcaac003c2	53f13c8f-413e-4537-bda6-98666cd7975f
80	80	0	GBIF France	da44cd31-5901-4687-a106-6d1c7734ee3a	548c6540-65fe-45b0-8a64-cafa629fd30a
144765	144765	0	GBIF Sweden	a0b3be64-6525-4387-ac67-a499950f92e1	56aa0680-0c60-11dd-84cd-b8a03c50a862
2	2	0	Plazi	ffb07bec-2d10-492d-9c37-361fe0b79427	5822d319-a8c9-4b6c-b139-08620caed3cc
3	3	0	Participant Node Managers Committee	7f48e0c8-5c96-49ec-b972-30748e339115	58fffbfe-5b97-4e30-bebc-a7bc4bdc802f
74729	74729	0	GBIF France	da44cd31-5901-4687-a106-6d1c7734ee3a	5aa17427-58c4-4221-bb6c-20ab297d6a02
0	2	2	Ocean Biodiversity Information System	ba0670b9-4186-41e6-8e70-f9cb3065551a	5c6a0972-d4f7-4df6-b7c9-4ff39297d705
0	2	2	Plazi	ffb07bec-2d10-492d-9c37-361fe0b79427	5cee01bf-7fbf-40c9-8fce-c138dfd3585e
0	195	195	Plazi	ffb07bec-2d10-492d-9c37-361fe0b79427	5de18cc9-f4ed-40e4-95b7-c7452b5f13c1
1418	1418	0	Participant Node Managers Committee	7f48e0c8-5c96-49ec-b972-30748e339115	5e39eb71-b166-42b3-8367-6b106d183751
120	120	0	GBIF Germany	4f6826f2-4ff6-443d-b966-e6913bd24013	6111097e-f762-11e1-a439-00145eb45e9a
201	201	0	Colombian Biodiversity Information System	7e865cba-7c46-417b-ade5-97f2cf5b7be0	615a09d3-260b-4ba7-a07e-c5d9f719587f
97	97	0	GBIF Germany	4f6826f2-4ff6-443d-b966-e6913bd24013	616b40e2-f762-11e1-a439-00145eb45e9a
95	95	0	GBIF Germany	4f6826f2-4ff6-443d-b966-e6913bd24013	61961c0e-f762-11e1-a439-00145eb45e9a
493	493	0	GBIF France	da44cd31-5901-4687-a106-6d1c7734ee3a	63e83e52-8b85-498c-8fc7-681725b4afca
11	11	0	Plazi	ffb07bec-2d10-492d-9c37-361fe0b79427	63f723f9-0796-4a29-b813-1cb4133f4617
3	3	0	Plazi	ffb07bec-2d10-492d-9c37-361fe0b79427	64a14054-6473-4319-96ca-bbb539975f57
110	110	0	GBIF Germany	4f6826f2-4ff6-443d-b966-e6913bd24013	67a8e720-f762-11e1-a439-00145eb45e9a
119	119	0	GBIF Germany	4f6826f2-4ff6-443d-b966-e6913bd24013	68a1fc98-f762-11e1-a439-00145eb45e9a
217	217	0	Biodiversity Information System of Mexico	b324e8e9-9a4c-44fa-8f1a-7f39ea7ab576	68aa961c-846b-4992-b790-53693bbf9131
947	947	0	Colombian Biodiversity Information System	7e865cba-7c46-417b-ade5-97f2cf5b7be0	692abfb0-83ab-4e52-a547-50c77ccf25ef
10	10	0	GBIF Germany	4f6826f2-4ff6-443d-b966-e6913bd24013	6a8f15c2-f762-11e1-a439-00145eb45e9a
0	5	5	Plazi	ffb07bec-2d10-492d-9c37-361fe0b79427	6b65401f-a006-4e87-a6ad-6ff47d9066ea
18	18	0	GBIF Germany	4f6826f2-4ff6-443d-b966-e6913bd24013	6b9c8e40-f762-11e1-a439-00145eb45e9a
2	2	0	Plazi	ffb07bec-2d10-492d-9c37-361fe0b79427	6d724005-a6af-4345-9407-5932133b3c4b
25	25	0	Colombian Biodiversity Information System	7e865cba-7c46-417b-ade5-97f2cf5b7be0	6ed62c8a-65a5-4bb3-a66b-4251d3b088ce
14041	14041	0	Participant Node Managers Committee	7f48e0c8-5c96-49ec-b972-30748e339115	6ee7cc49-13fc-4cc3-b6d1-ab3e50903ec4
0	32175	32175	U.S. Geological Survey	8618c64a-93e0-4300-b546-7249e5148ed2	6ff41330-8bc9-4283-819b-8759784f5e94
49	49	0	Biodiversity Information System of Mexico	b324e8e9-9a4c-44fa-8f1a-7f39ea7ab576	70e7429f-ec92-40f6-8ab6-15a1e18282a3
4	4	0	Plazi	ffb07bec-2d10-492d-9c37-361fe0b79427	740ce08a-799c-4d63-97cd-0b58c2cf5a79
10	10	0	GBIF Germany	4f6826f2-4ff6-443d-b966-e6913bd24013	7431fd1a-f762-11e1-a439-00145eb45e9a
56	56	0	GBIF Germany	4f6826f2-4ff6-443d-b966-e6913bd24013	7479df4a-f762-11e1-a439-00145eb45e9a
72	72	0	Plazi	ffb07bec-2d10-492d-9c37-361fe0b79427	74c4d110-f574-4169-90e1-a5f2c7e34602
643	642	-1	GBIF Germany	4f6826f2-4ff6-443d-b966-e6913bd24013	757b7c32-f762-11e1-a439-00145eb45e9a
66164	66164	0	U.S. Geological Survey	8618c64a-93e0-4300-b546-7249e5148ed2	7606f22a-2121-4853-b3ab-2e693c6790dd
18	18	0	Colombian Biodiversity Information System	7e865cba-7c46-417b-ade5-97f2cf5b7be0	76335091-ae41-4e85-ac82-77b80f8cefd7
1836	1836	0	GBIF Benin	efb9c00e-f802-45dd-8826-a52ec45b89ff	7697b074-c59c-4871-8cc0-58322facd4e5
222	222	0	Colombian Biodiversity Information System	7e865cba-7c46-417b-ade5-97f2cf5b7be0	76df66d1-8755-4381-b02d-865748aa2561
690	690	0	GBIF Germany	4f6826f2-4ff6-443d-b966-e6913bd24013	784513ce-f762-11e1-a439-00145eb45e9a
18	18	0	GBIF Germany	4f6826f2-4ff6-443d-b966-e6913bd24013	78a60300-f762-11e1-a439-00145eb45e9a
217	217	0	Ocean Biodiversity Information System	ba0670b9-4186-41e6-8e70-f9cb3065551a	78c7ec59-a9ae-4b1c-ac6f-8d3ff712e4a1
4	4	0	Plazi	ffb07bec-2d10-492d-9c37-361fe0b79427	7a3e1904-034e-4dd3-82c3-ccbc568454ef
392	392	0	Ocean Biodiversity Information System	ba0670b9-4186-41e6-8e70-f9cb3065551a	7a86aa20-8049-418d-b008-d586246f322f
192	192	0	Plazi	ffb07bec-2d10-492d-9c37-361fe0b79427	7aff0d3b-eb60-43e7-ace6-caffff8c1d72
78	78	0	Korean Biodiversity Information Facility	e0a1e772-0177-4800-94b4-2d023fe6cdf4	7b0f4480-f762-11e1-a439-00145eb45e9a
7953	5061	-2892	GBIF Germany	4f6826f2-4ff6-443d-b966-e6913bd24013	7c90e386-f762-11e1-a439-00145eb45e9a
33	33	0	GBIF Germany	4f6826f2-4ff6-443d-b966-e6913bd24013	7cbaceab-8f6e-472e-9d9e-e9bb11c5e6e9
205	173	-32	GBIF Germany	4f6826f2-4ff6-443d-b966-e6913bd24013	7d3a56b4-f762-11e1-a439-00145eb45e9a
30	30	0	GBIF Germany	4f6826f2-4ff6-443d-b966-e6913bd24013	7d707fa0-f762-11e1-a439-00145eb45e9a
213	213	0	GBIF Germany	4f6826f2-4ff6-443d-b966-e6913bd24013	7db02fe1-5cd5-415e-b140-24f1a231c937
402	390	-12	GBIF Germany	4f6826f2-4ff6-443d-b966-e6913bd24013	7e20d620-f762-11e1-a439-00145eb45e9a
302566	323472	20906	GBIF Austria	1e789bc9-79fc-4e60-a49e-89dfc45a7188	7f5260c2-f762-11e1-a439-00145eb45e9a
1821	1821	0	Biodiversity Information System of Mexico	b324e8e9-9a4c-44fa-8f1a-7f39ea7ab576	7f818456-f762-11e1-a439-00145eb45e9a
86	86	0	Plazi	ffb07bec-2d10-492d-9c37-361fe0b79427	80783542-5446-42b3-a9bd-177b0e4ec73a
6414	6414	0	Biodiversity Information System of Mexico	b324e8e9-9a4c-44fa-8f1a-7f39ea7ab576	808a017a-f762-11e1-a439-00145eb45e9a
2027	2027	0	GBIF Germany	4f6826f2-4ff6-443d-b966-e6913bd24013	81a15efa-f762-11e1-a439-00145eb45e9a
979	979	0	GBIF Germany	4f6826f2-4ff6-443d-b966-e6913bd24013	81c65f8e-f762-11e1-a439-00145eb45e9a
258	258	0	GBIF Germany	4f6826f2-4ff6-443d-b966-e6913bd24013	8235da12-f762-11e1-a439-00145eb45e9a
98	98	0	GBIF Germany	4f6826f2-4ff6-443d-b966-e6913bd24013	8285900c-f762-11e1-a439-00145eb45e9a
229	229	0	Participant Node Managers Committee	7f48e0c8-5c96-49ec-b972-30748e339115	82cf3d36-63aa-445f-9205-45727e96a4dd
0	438	438	GBIF Japan	db5705aa-6a6e-42f1-8942-d77b9f4896ea	8371fa54-ceff-4e40-aa10-999359446188
551	551	0	Ocean Biodiversity Information System	ba0670b9-4186-41e6-8e70-f9cb3065551a	83f318b0-f762-11e1-a439-00145eb45e9a
249	249	0	Atlas of Living Australia	4a6f1b71-969e-4fc5-a693-282b05e1220c	852fd378-2356-4b27-be1b-e7c05aa3ed36
10654	10654	0	GBIF Japan	db5705aa-6a6e-42f1-8942-d77b9f4896ea	86a13bf0-f762-11e1-a439-00145eb45e9a
988	752	-236	GBIF Germany	4f6826f2-4ff6-443d-b966-e6913bd24013	86f8c6f4-f762-11e1-a439-00145eb45e9a
3460	2872	-588	GBIF Germany	4f6826f2-4ff6-443d-b966-e6913bd24013	878b7210-f762-11e1-a439-00145eb45e9a
4	4	0	Plazi	ffb07bec-2d10-492d-9c37-361fe0b79427	87c6546c-494b-4271-94e0-b4d15b19c56b
1432	1140	-292	GBIF Germany	4f6826f2-4ff6-443d-b966-e6913bd24013	881aa7dc-f762-11e1-a439-00145eb45e9a
282	207	-75	GBIF Germany	4f6826f2-4ff6-443d-b966-e6913bd24013	88213aac-f762-11e1-a439-00145eb45e9a
117025	116953	-72	National Biodiversity Network	d897a5b9-35ee-4232-94bd-b0bcaac003c2	887e6209-ea70-46a7-9652-fc94ca97ae0a
520	520	0	GBIF Kenya	2a44d626-9f7a-4120-8a7a-4ab5ac15ff2a	88e15b3d-e8fa-4527-b164-83078901de99
7	7	0	GBIF Spain	1f94b3ca-9345-4d65-afe2-4bace93aa0fe	892362cc-9d86-492d-9fc8-c06541bd8714
307	307	0	GBIF Germany	4f6826f2-4ff6-443d-b966-e6913bd24013	899341c8-f762-11e1-a439-00145eb45e9a
791	791	0	GBIF France	da44cd31-5901-4687-a106-6d1c7734ee3a	8a113630-dcf5-4bf5-a165-1e6aa74a5224
353	353	0	GBIF Germany	4f6826f2-4ff6-443d-b966-e6913bd24013	8a578704-f762-11e1-a439-00145eb45e9a
118	118	0	GBIF Germany	4f6826f2-4ff6-443d-b966-e6913bd24013	8a8e9b5e-f762-11e1-a439-00145eb45e9a
0	3	3	Plazi	ffb07bec-2d10-492d-9c37-361fe0b79427	8ce4aff4-106f-4fa8-934d-3c300713b7ba
4179	4179	0	Biodiversity Information System of Mexico	b324e8e9-9a4c-44fa-8f1a-7f39ea7ab576	8d373621-9ffe-42d2-82e9-a58af26de229
0	11	11	Plazi	ffb07bec-2d10-492d-9c37-361fe0b79427	8db947d3-95b4-46a4-ab2d-f4edf56a9a2f
69	27	-42	GBIF Germany	4f6826f2-4ff6-443d-b966-e6913bd24013	8e34bc2a-f762-11e1-a439-00145eb45e9a
27	21	-6	GBIF Germany	4f6826f2-4ff6-443d-b966-e6913bd24013	8e5914a8-f762-11e1-a439-00145eb45e9a
850	850	0	Participant Node Managers Committee	7f48e0c8-5c96-49ec-b972-30748e339115	8e6636ad-0b6a-426a-9515-985288f558ba
300	242	-58	GBIF Germany	4f6826f2-4ff6-443d-b966-e6913bd24013	8ecb582e-f762-11e1-a439-00145eb45e9a
140	127	-13	GBIF Germany	4f6826f2-4ff6-443d-b966-e6913bd24013	8f291220-f762-11e1-a439-00145eb45e9a
37	24	-13	GBIF Germany	4f6826f2-4ff6-443d-b966-e6913bd24013	90470216-f762-11e1-a439-00145eb45e9a
0	25	25	Plazi	ffb07bec-2d10-492d-9c37-361fe0b79427	90731927-c853-4b70-865e-3d06d92a7e76
22	22	0	Plazi	ffb07bec-2d10-492d-9c37-361fe0b79427	913d9d2a-1d0a-4857-96d6-05a2a8297620
702	378	-324	GBIF Germany	4f6826f2-4ff6-443d-b966-e6913bd24013	91a0cf5c-f762-11e1-a439-00145eb45e9a
30	30	0	Plazi	ffb07bec-2d10-492d-9c37-361fe0b79427	91a51391-41b1-4184-bb62-6cd3bbbfdd74
0	2	2	Plazi	ffb07bec-2d10-492d-9c37-361fe0b79427	92e598fc-f5fe-45c4-9020-cab8bab17668
736658	737359	701	Atlas of Living Australia	4a6f1b71-969e-4fc5-a693-282b05e1220c	9360958c-3534-4d53-874e-4a952eea3e6d
0	1	1	Plazi	ffb07bec-2d10-492d-9c37-361fe0b79427	94860608-e444-4d41-b59e-b763d4b570fe
0	5	5	Plazi	ffb07bec-2d10-492d-9c37-361fe0b79427	95502ed7-70ba-4246-bc62-ec628ba12f4e
1142	1142	0	GBIF Germany	4f6826f2-4ff6-443d-b966-e6913bd24013	96ad9cef-e5c5-4ac9-9316-cde445aa25b9
0	5	5	Plazi	ffb07bec-2d10-492d-9c37-361fe0b79427	97206d42-b297-42aa-9212-adcd248b9f6c
66	66	0	GBIF Germany	4f6826f2-4ff6-443d-b966-e6913bd24013	976696b0-f762-11e1-a439-00145eb45e9a
0	165	165	GBIF Portugal	673f7038-4262-4149-b753-5658a4e912f6	983beec4-f12b-44a1-a8bb-110cbab0bc02
1462	1462	0	Colombian Biodiversity Information System	7e865cba-7c46-417b-ade5-97f2cf5b7be0	9a29807f-4856-4513-b00a-ed7be739d777
37479	37479	0	GBIF France	da44cd31-5901-4687-a106-6d1c7734ee3a	9a3b74a9-f614-4d9a-9191-0dc6d471f15f
3840	3840	0	National Biodiversity Network	d897a5b9-35ee-4232-94bd-b0bcaac003c2	9dd33b14-c388-4f7b-a453-aca8bb51d360
146	146	0	GBIF Uganda	71b40829-6a12-4c3d-8fee-5746f5e9cf8c	a128a6d6-9be3-4347-a7dd-3fc9b0f8230d
2	2	0	Plazi	ffb07bec-2d10-492d-9c37-361fe0b79427	a140df62-e938-4fe0-8092-f6a1c168120e
7	7	0	Plazi	ffb07bec-2d10-492d-9c37-361fe0b79427	a3e3eefb-67d7-4675-b8f1-7f0f066fbbf9
4504	4504	0	Ocean Biodiversity Information System	ba0670b9-4186-41e6-8e70-f9cb3065551a	a6058a01-5880-41f5-9dbf-3eef8591f714
115	115	0	Plazi	ffb07bec-2d10-492d-9c37-361fe0b79427	aa93de4b-c9ed-4b3e-a1c2-3f5d90faba57
27	27	0	National Biodiversity Network	d897a5b9-35ee-4232-94bd-b0bcaac003c2	ac17b5de-b357-4b28-9b1d-06cdd4352f48
466	466	0	GBIF Germany	4f6826f2-4ff6-443d-b966-e6913bd24013	aefecb49-57ff-4bd0-a140-1ac1a68b9c18
12	12	0	Plazi	ffb07bec-2d10-492d-9c37-361fe0b79427	af1c028a-08be-4840-a31a-2c67b8004800
0	7126	7126	GBIF Benin	efb9c00e-f802-45dd-8826-a52ec45b89ff	aff3a10a-a86b-4eff-98e4-d63f92fd6f7e
9	9	0	Participant Node Managers Committee	7f48e0c8-5c96-49ec-b972-30748e339115	b1ffa78a-30c3-49c1-bc6c-4f7187791a7d
0	4	4	Plazi	ffb07bec-2d10-492d-9c37-361fe0b79427	b2447116-6c26-4fbe-8ece-ff485762c0ce
41	41	0	GBIF France	da44cd31-5901-4687-a106-6d1c7734ee3a	b47517a3-a795-47b0-bb8e-8ca69bf87540
48476	54670	6194	GBIF Norway	4f829580-180d-46a9-9c87-ed8ec959b545	b49a2978-0e30-4748-a99f-9301d17ae119
263	263	0	GBIF France	da44cd31-5901-4687-a106-6d1c7734ee3a	b58606ca-cffd-49c8-a485-ac122b6bbca7
54	54	0	Plazi	ffb07bec-2d10-492d-9c37-361fe0b79427	b5ee7b41-2baf-4f34-8695-a79143833238
3	3	0	Plazi	ffb07bec-2d10-492d-9c37-361fe0b79427	b7b9c57e-28e5-4171-938d-dea133d437c6
32	32	0	GBIF France	da44cd31-5901-4687-a106-6d1c7734ee3a	b94691d7-12cd-457d-ae4a-fc99c6304475
153	153	0	GBIF Germany	4f6826f2-4ff6-443d-b966-e6913bd24013	ba8045cf-13b0-42af-9359-957cc4b15460
189	189	0	GBIF Norway	4f829580-180d-46a9-9c87-ed8ec959b545	bb94d12c-8a31-4ed1-b554-92fe929ad6c4
3	3	0	Plazi	ffb07bec-2d10-492d-9c37-361fe0b79427	bbc6bb56-338b-4422-ab11-aad8c8e30fd4
103	103	0	Plazi	ffb07bec-2d10-492d-9c37-361fe0b79427	c12aaed8-264c-459c-b1aa-09eaeb686670
0	5	5	Plazi	ffb07bec-2d10-492d-9c37-361fe0b79427	c2705442-b93b-4855-809f-29ce80b1b473
12	12	0	Plazi	ffb07bec-2d10-492d-9c37-361fe0b79427	c3e73497-5ec4-445e-8160-47435bbd7491
0	203	203	National Biodiversity Network	d897a5b9-35ee-4232-94bd-b0bcaac003c2	c5c2c21d-7cf1-4b1f-a342-7f3bf6c67670
5	5	0	Plazi	ffb07bec-2d10-492d-9c37-361fe0b79427	c9c0aa57-d54c-47ed-931b-b0252a9d5054
1564	1564	0	U.S. Geological Survey	8618c64a-93e0-4300-b546-7249e5148ed2	cccd7d2f-33f5-4cc4-8076-6f2522befa92
3	3	0	Plazi	ffb07bec-2d10-492d-9c37-361fe0b79427	cd29ae35-aaca-44e3-a561-33ed06267e2e
4	4	0	Plazi	ffb07bec-2d10-492d-9c37-361fe0b79427	ce0ab832-46b8-40e9-8aaa-9ca99ab24f32
50430	50430	0	U.S. Geological Survey	8618c64a-93e0-4300-b546-7249e5148ed2	d0e9b7eb-29a9-4695-bb13-22585df648a5
0	2	2	Plazi	ffb07bec-2d10-492d-9c37-361fe0b79427	d10065ab-7097-4e15-adb5-26dc279e18da
460507	460507	0	Netherlands Biodiversity Information Facility	0909d601-bda2-42df-9e63-a6d51847ebce	d19c0287-15ee-45fd-b810-d30e8026a785
83806	83806	0	Biodiversity Information System of Mexico	b324e8e9-9a4c-44fa-8f1a-7f39ea7ab576	d3de41c3-3d5b-4fe6-aece-90c6509dc2b9
1406	1406	0	GBIF Germany	4f6826f2-4ff6-443d-b966-e6913bd24013	d7a8eec1-04a2-40b6-8c98-6d2c1996b5bb
1	1	0	GBIF Japan	db5705aa-6a6e-42f1-8942-d77b9f4896ea	dba02a97-3fbc-41a8-991d-72c522c72fad
0	24	24	Plazi	ffb07bec-2d10-492d-9c37-361fe0b79427	dc88efa4-138d-4efa-9917-cefe12f07561
350	350	0	GBIF Argentina	2426a871-9feb-40a1-96c6-0c593a76b835	dd047c25-da08-4a26-9490-52252dbdfad7
153	153	0	Plazi	ffb07bec-2d10-492d-9c37-361fe0b79427	dd97793c-f4a6-4204-a111-c112533f9b06
0	169	169	Plazi	ffb07bec-2d10-492d-9c37-361fe0b79427	dde09a91-0a09-4f99-a10f-7bf4d47ba7b7
0	1471	1471	Ocean Biodiversity Information System	ba0670b9-4186-41e6-8e70-f9cb3065551a	df396e97-bf8f-448b-8fe3-fa1315c87057
1	1	0	Plazi	ffb07bec-2d10-492d-9c37-361fe0b79427	e056673e-f93f-420a-97f1-a32a4e43e269
1612	1612	0	Participant Node Managers Committee	7f48e0c8-5c96-49ec-b972-30748e339115	e69b51d3-5d4d-4f57-a0bf-8895ea1e5d71
0	169	169	Plazi	ffb07bec-2d10-492d-9c37-361fe0b79427	e7ce9dca-1d2b-4aad-8471-7ea2c177da53
0	3	3	Plazi	ffb07bec-2d10-492d-9c37-361fe0b79427	e821345c-e11b-4789-b3d7-ccf922a03dd7
1008	1047	39	U.S. Geological Survey	8618c64a-93e0-4300-b546-7249e5148ed2	e96599ca-d9aa-464d-8d3a-4492e175ee8f
0	2	2	Plazi	ffb07bec-2d10-492d-9c37-361fe0b79427	e9777a1d-2f8a-484b-aa14-6a410b3c8692
0	43	43	Plazi	ffb07bec-2d10-492d-9c37-361fe0b79427	eb09193e-683a-4642-829f-ff0048c6e9d4
0	460	460	GBIF France	da44cd31-5901-4687-a106-6d1c7734ee3a	ecb3c8f3-b015-435e-a025-5e0ae99f181c
3490	3490	0	GBIF France	da44cd31-5901-4687-a106-6d1c7734ee3a	ecb800ca-503d-4762-ad64-9b34a5710bee
1	1	0	Plazi	ffb07bec-2d10-492d-9c37-361fe0b79427	ecef51dd-2a6b-4d18-afc8-e37c50cdd865
2	2	0	GBIF Germany	4f6826f2-4ff6-443d-b966-e6913bd24013	edd11cf7-ef62-45a2-a432-e07820ff02ef
1000134	1000134	0	Korean Biodiversity Information Facility	e0a1e772-0177-4800-94b4-2d023fe6cdf4	ef6e0754-8bf2-4854-9aa3-3a2a1a90810b
69	69	0	Plazi	ffb07bec-2d10-492d-9c37-361fe0b79427	f3774cb8-3c64-48dd-bcb3-f2be54312d49
940	940	0	Participant Node Managers Committee	7f48e0c8-5c96-49ec-b972-30748e339115	f412ff44-1b43-4ca1-8e10-86b34cd82da5
5	5	0	Plazi	ffb07bec-2d10-492d-9c37-361fe0b79427	f69431e0-57d9-43c0-ac86-4251f2d99c66
960	960	0	National Biodiversity Network	d897a5b9-35ee-4232-94bd-b0bcaac003c2	f9e48836-88b1-47d3-bb82-7a62ea22dd7d
818	818	0	GBIF France	da44cd31-5901-4687-a106-6d1c7734ee3a	fc0501d4-ee53-49e0-a6ad-0e47c73507e3
103	103	0	Plazi	ffb07bec-2d10-492d-9c37-361fe0b79427	01608b37-4404-49ba-a0b9-df231d20006d
84513	84513	0	GBIF Brazil	cdc9736d-5ff7-4ece-9959-3c744360cdb3	02cb399f-3283-49fa-bce0-627c7f83083f
4	4	0	Plazi	ffb07bec-2d10-492d-9c37-361fe0b79427	05961829-968b-4bc0-87c2-67bd60072ce7
80	80	0	Plazi	ffb07bec-2d10-492d-9c37-361fe0b79427	06d40acc-4fc2-4de6-9aab-96f3776ef44c
1	1	0	Plazi	ffb07bec-2d10-492d-9c37-361fe0b79427	07f9d14c-bd8e-4794-b730-f7f707387d47
304	304	0	Colombian Biodiversity Information System	7e865cba-7c46-417b-ade5-97f2cf5b7be0	08bce4f0-7b52-44a5-945b-0cf570bb2880
123	123	0	Plazi	ffb07bec-2d10-492d-9c37-361fe0b79427	08f34ac5-d51e-447f-8c23-168d83dfa73e
0	1	1	Plazi	ffb07bec-2d10-492d-9c37-361fe0b79427	0b2934a8-4088-4133-becb-a937c39cad7d
2	2	0	Plazi	ffb07bec-2d10-492d-9c37-361fe0b79427	0b6ae262-cdb5-4573-a937-9ab9ba5c7488
301	301	0	GBIF Germany	4f6826f2-4ff6-443d-b966-e6913bd24013	0cdacecd-2692-4cb4-ba77-c5c6ddf31102
156	156	0	GBIF France	da44cd31-5901-4687-a106-6d1c7734ee3a	0e14f82b-8eb6-479a-b374-c62f475c9edd
0	4	4	Plazi	ffb07bec-2d10-492d-9c37-361fe0b79427	0e1cf30b-0231-4f46-83c3-45fcc57f2515
6	6	0	Plazi	ffb07bec-2d10-492d-9c37-361fe0b79427	10024a1b-87c9-41ad-a2a3-d9ec4574c0f2
1	1	0	Plazi	ffb07bec-2d10-492d-9c37-361fe0b79427	108cecd1-7949-42ee-b412-1e38b18f21d9
13565	13565	0	GBIF Germany	4f6826f2-4ff6-443d-b966-e6913bd24013	1118afbc-0f5d-4f71-bb02-9c87f8a99ce6
105	105	0	Colombian Biodiversity Information System	7e865cba-7c46-417b-ade5-97f2cf5b7be0	12899553-c5f0-4f27-824f-e66e70af7456
0	20	20	Plazi	ffb07bec-2d10-492d-9c37-361fe0b79427	13e7ed74-2c38-4709-a448-58a005e01fc3
4780	4790	10	GBIF Norway	4f829580-180d-46a9-9c87-ed8ec959b545	1571f0b4-efac-4e12-86ea-eb57ba6b5b43
0	2	2	Plazi	ffb07bec-2d10-492d-9c37-361fe0b79427	18580358-b480-42d8-943f-677d86eac7de
4	4	0	Plazi	ffb07bec-2d10-492d-9c37-361fe0b79427	18a49e5c-e025-463f-a7cf-72b5a1f69401
255	255	0	Plazi	ffb07bec-2d10-492d-9c37-361fe0b79427	1d1f5565-905a-488d-82e0-9837e47f423b
0	66	66	Plazi	ffb07bec-2d10-492d-9c37-361fe0b79427	1d51f348-b3b2-46ff-a370-636249acbdc3
0	1492	1492	GBIF Uganda	71b40829-6a12-4c3d-8fee-5746f5e9cf8c	1dc8b287-7eab-49a8-ad49-efcb4671b2a6
203	203	0	GBIF France	da44cd31-5901-4687-a106-6d1c7734ee3a	1e9a4e01-106f-421c-8be0-88299960d976
2268	2268	0	National Biodiversity Network	d897a5b9-35ee-4232-94bd-b0bcaac003c2	1ed81a8b-4f1a-4037-a347-84f01cae6e01
0	4	4	Plazi	ffb07bec-2d10-492d-9c37-361fe0b79427	25f169b1-2226-40d4-a56e-1c2dbcfbd3c9
2082	2082	0	World Federation for Culture Collections	a6bdc523-5368-4e0f-9d2e-de1c262ac092	2b016c65-5b3d-4517-9b3c-d04a5234de48
130115	130114	-1	National Biodiversity Network	d897a5b9-35ee-4232-94bd-b0bcaac003c2	2c7c72b2-ac29-4be3-a95f-6b09e8f4b932
0	3045	3045	GBIF Japan	db5705aa-6a6e-42f1-8942-d77b9f4896ea	32224326-dc19-4778-95b4-63f8e09fe4e2
87	87	0	Plazi	ffb07bec-2d10-492d-9c37-361fe0b79427	3260db2c-554b-4bd2-8c89-3374005b736f
939	939	0	GBIF France	da44cd31-5901-4687-a106-6d1c7734ee3a	33244db4-63eb-446f-bd83-16e4119ad6e3
781	781	0	Belgian Biodiversity Platform	fb11cfe1-ebc3-45af-9159-17d9fddbcdac	33b837c9-dd05-48e3-b4ad-3273eb292125
1	1	0	GBIF Portugal	673f7038-4262-4149-b753-5658a4e912f6	35fbe1f8-7afd-4892-ae73-086719c93a43
0	22	22	Plazi	ffb07bec-2d10-492d-9c37-361fe0b79427	364a2818-9890-4a57-91cd-d5dcf0f36c6f
66	66	0	GBIF France	da44cd31-5901-4687-a106-6d1c7734ee3a	36effa82-73b8-4d33-9824-41372d1936ac
122801	122801	0	GBIF France	da44cd31-5901-4687-a106-6d1c7734ee3a	38b69d98-e980-4a30-aaf7-f9616d34ae02
0	6	6	Plazi	ffb07bec-2d10-492d-9c37-361fe0b79427	3a090e10-1fd7-48bc-8aa7-54dfe7a309c8
287	1184	897	U.S. Geological Survey	8618c64a-93e0-4300-b546-7249e5148ed2	3fed506c-d04f-4cd4-b373-bd602572f39b
56	186	130	National Biodiversity Network	d897a5b9-35ee-4232-94bd-b0bcaac003c2	417dc773-fc19-43bc-b97d-88d7a94d384b
137	137	0	National Biodiversity Network	d897a5b9-35ee-4232-94bd-b0bcaac003c2	437fa56c-e7bb-4534-93c5-8af0bebd5d72
41	41	0	Plazi	ffb07bec-2d10-492d-9c37-361fe0b79427	44a2fcf6-cc1b-4c07-9554-dd6dd279a76d
16	16	0	Indonesian Biodiversity Information Facility	2ebd91f6-f14f-4375-b525-c011a3774f03	46b22f62-bd4f-4157-8a57-f97cf22fda9e
210	210	0	GBIF Germany	4f6826f2-4ff6-443d-b966-e6913bd24013	496d883c-57be-4d39-b14b-513b1fe2e5b3
119	98	-21	GBIF Germany	4f6826f2-4ff6-443d-b966-e6913bd24013	49ce4e91-d3d8-4e74-9a97-59deadfdbdaa
363	363	0	Participant Node Managers Committee	7f48e0c8-5c96-49ec-b972-30748e339115	4d3bd58b-b832-490b-9782-c5d9d46ad8f2
15	15	0	Plazi	ffb07bec-2d10-492d-9c37-361fe0b79427	50a9b0c6-0c24-49d2-8eb3-0e546ede239f
2	2	0	GBIF Japan	db5705aa-6a6e-42f1-8942-d77b9f4896ea	51bef1c2-e984-4eb1-aa9a-5a62d67e47a2
213	213	0	Participant Node Managers Committee	7f48e0c8-5c96-49ec-b972-30748e339115	591a3831-a732-4047-a322-38503c4dc69d
10	10	0	Plazi	ffb07bec-2d10-492d-9c37-361fe0b79427	59cba35e-ab8c-4b08-b149-1bc4e44e8d8b
3	3	0	Plazi	ffb07bec-2d10-492d-9c37-361fe0b79427	5bf16196-176c-4d6c-af82-7121d4bc968e
123882	126091	2209	GBIF Estonia	2c11b821-d22b-4c64-8cd3-c1578173b129	5c3dbe27-ca42-4beb-8263-d16e7d238c4d
4	4	0	Plazi	ffb07bec-2d10-492d-9c37-361fe0b79427	5d2d8f64-df75-4a26-afb7-9309a7489bae
363	363	0	ASEAN Centre for Biodiversity	af2a0fa1-4c8e-4bdc-8954-b1a55e32b0f1	60a27375-7686-4f2d-bead-788af30a654f
63	63	0	GBIF Germany	4f6826f2-4ff6-443d-b966-e6913bd24013	61c88f72-f762-11e1-a439-00145eb45e9a
61	61	0	GBIF Germany	4f6826f2-4ff6-443d-b966-e6913bd24013	6217a850-f762-11e1-a439-00145eb45e9a
214	214	0	GBIF Germany	4f6826f2-4ff6-443d-b966-e6913bd24013	6225b5f8-f762-11e1-a439-00145eb45e9a
11	11	0	GBIF Germany	4f6826f2-4ff6-443d-b966-e6913bd24013	62c81366-f762-11e1-a439-00145eb45e9a
930	930	0	GBIF Germany	4f6826f2-4ff6-443d-b966-e6913bd24013	64ad6172-f762-11e1-a439-00145eb45e9a
9	8	-1	GBIF Germany	4f6826f2-4ff6-443d-b966-e6913bd24013	65c76152-f762-11e1-a439-00145eb45e9a
171	171	0	GBIF Germany	4f6826f2-4ff6-443d-b966-e6913bd24013	67908f7c-f762-11e1-a439-00145eb45e9a
23	23	0	GBIF Germany	4f6826f2-4ff6-443d-b966-e6913bd24013	68fda2aa-f762-11e1-a439-00145eb45e9a
62	62	0	GBIF Germany	4f6826f2-4ff6-443d-b966-e6913bd24013	690678b2-f762-11e1-a439-00145eb45e9a
1	1	0	Plazi	ffb07bec-2d10-492d-9c37-361fe0b79427	6af2b8e0-dece-4820-9283-03f4bbd354fa
24	24	0	GBIF Germany	4f6826f2-4ff6-443d-b966-e6913bd24013	6b3994ca-f762-11e1-a439-00145eb45e9a
2	2	0	Plazi	ffb07bec-2d10-492d-9c37-361fe0b79427	6c0b16e3-4dc8-405d-9ab7-272306e22c41
849	849	0	Scientific Committee on Antarctic Research	51e4e8ff-bff0-4996-8b27-9107d61b3478	6c808b65-184a-4ec2-a658-d55d5e1f9ba5
12	12	0	GBIF Germany	4f6826f2-4ff6-443d-b966-e6913bd24013	6ffb63c6-f762-11e1-a439-00145eb45e9a
1000	1000	0	GBIF Japan	db5705aa-6a6e-42f1-8942-d77b9f4896ea	71da0e5e-f762-11e1-a439-00145eb45e9a
16	16	0	GBIF Germany	4f6826f2-4ff6-443d-b966-e6913bd24013	7295bdfc-f762-11e1-a439-00145eb45e9a
5	5	0	GBIF Germany	4f6826f2-4ff6-443d-b966-e6913bd24013	74434d68-f762-11e1-a439-00145eb45e9a
12	12	0	GBIF Germany	4f6826f2-4ff6-443d-b966-e6913bd24013	750a467a-f762-11e1-a439-00145eb45e9a
215	215	0	Colombian Biodiversity Information System	7e865cba-7c46-417b-ade5-97f2cf5b7be0	75503e02-2081-4921-85d9-496f38e9da7f
82	48	-34	GBIF Germany	4f6826f2-4ff6-443d-b966-e6913bd24013	78743fd2-f762-11e1-a439-00145eb45e9a
10	10	0	GBIF Germany	4f6826f2-4ff6-443d-b966-e6913bd24013	79012be0-f762-11e1-a439-00145eb45e9a
1519	1519	0	GBIF Germany	4f6826f2-4ff6-443d-b966-e6913bd24013	7ba0e7fa-f762-11e1-a439-00145eb45e9a
566	566	0	Colombian Biodiversity Information System	7e865cba-7c46-417b-ade5-97f2cf5b7be0	7c0c1d99-15c8-4e2f-a4ca-ef5594ee93b1
222	114	-108	GBIF Germany	4f6826f2-4ff6-443d-b966-e6913bd24013	7cc51ec6-f762-11e1-a439-00145eb45e9a
215195	215195	0	GBIF Germany	4f6826f2-4ff6-443d-b966-e6913bd24013	7d8ed137-1d30-42f1-8b78-12a4957e4690
0	1	1	Plazi	ffb07bec-2d10-492d-9c37-361fe0b79427	7e7cf2bf-f1a6-4b53-9f94-47b8e0451946
51	39	-12	GBIF Germany	4f6826f2-4ff6-443d-b966-e6913bd24013	7ea5bda4-f762-11e1-a439-00145eb45e9a
2	2	0	Plazi	ffb07bec-2d10-492d-9c37-361fe0b79427	7ec03f14-8fea-4a06-a95a-28a755f9140c
973	973	0	Biodiversity Information System of Mexico	b324e8e9-9a4c-44fa-8f1a-7f39ea7ab576	7fd7b40c-f762-11e1-a439-00145eb45e9a
1201	1201	0	Biodiversity Information System of Mexico	b324e8e9-9a4c-44fa-8f1a-7f39ea7ab576	804b0146-f762-11e1-a439-00145eb45e9a
1092	676	-416	GBIF Germany	4f6826f2-4ff6-443d-b966-e6913bd24013	81e55678-f762-11e1-a439-00145eb45e9a
262	262	0	Participant Node Managers Committee	7f48e0c8-5c96-49ec-b972-30748e339115	8235c206-82a0-460f-aa10-503071b1785f
47771	51095	3324	GBIF Germany	4f6826f2-4ff6-443d-b966-e6913bd24013	8291593c-f762-11e1-a439-00145eb45e9a
3	3	0	Plazi	ffb07bec-2d10-492d-9c37-361fe0b79427	82d4c2c5-ab09-4031-bdb8-adb5fc75cebc
78283	82501	4218	U.S. Geological Survey	8618c64a-93e0-4300-b546-7249e5148ed2	832cb04e-f762-11e1-a439-00145eb45e9a
20979	20979	0	GBIF Spain	1f94b3ca-9345-4d65-afe2-4bace93aa0fe	835e62e2-f762-11e1-a439-00145eb45e9a
732	828	96	Colombian Biodiversity Information System	7e865cba-7c46-417b-ade5-97f2cf5b7be0	83964202-07d9-4a27-8391-975144bcc1da
0	64	64	Plazi	ffb07bec-2d10-492d-9c37-361fe0b79427	847ff980-f84b-46a1-9e94-37d1cd058637
49	45	-4	GBIF Germany	4f6826f2-4ff6-443d-b966-e6913bd24013	84f793b6-27d7-4751-b11d-18f37f8d6b3a
153	153	0	GBIF Germany	4f6826f2-4ff6-443d-b966-e6913bd24013	856fc745-2315-472e-aeb5-16c8edc5dad7
7386	7386	0	GBIF Japan	db5705aa-6a6e-42f1-8942-d77b9f4896ea	8614cad0-f762-11e1-a439-00145eb45e9a
0	1	1	Plazi	ffb07bec-2d10-492d-9c37-361fe0b79427	89c8eecf-61a8-4370-9c41-716ec0052d44
1312	1312	0	GBIF Germany	4f6826f2-4ff6-443d-b966-e6913bd24013	89df09aa-f762-11e1-a439-00145eb45e9a
4	4	0	Plazi	ffb07bec-2d10-492d-9c37-361fe0b79427	8bb486cb-88a9-4945-9486-dbdf26e717d9
2640	2080	-560	GBIF Germany	4f6826f2-4ff6-443d-b966-e6913bd24013	8e9d72ec-f762-11e1-a439-00145eb45e9a
3	2	-1	GBIF Germany	4f6826f2-4ff6-443d-b966-e6913bd24013	8ee6caaa-f762-11e1-a439-00145eb45e9a
763	445	-318	GBIF Germany	4f6826f2-4ff6-443d-b966-e6913bd24013	8f71ac10-f762-11e1-a439-00145eb45e9a
144	55	-89	GBIF Germany	4f6826f2-4ff6-443d-b966-e6913bd24013	908cfa14-f762-11e1-a439-00145eb45e9a
72	53	-19	GBIF Germany	4f6826f2-4ff6-443d-b966-e6913bd24013	90dfd072-f762-11e1-a439-00145eb45e9a
1	1	0	GBIF Germany	4f6826f2-4ff6-443d-b966-e6913bd24013	912094a4-f762-11e1-a439-00145eb45e9a
2	2	0	Plazi	ffb07bec-2d10-492d-9c37-361fe0b79427	9195a7a3-87bd-40a9-9165-2b2363b953b2
0	35	35	Plazi	ffb07bec-2d10-492d-9c37-361fe0b79427	91d4b50e-4d88-47dd-9b1b-f9cc9bf72bff
7	7	0	GBIF Germany	4f6826f2-4ff6-443d-b966-e6913bd24013	92792cee-f762-11e1-a439-00145eb45e9a
214	214	0	GBIF Germany	4f6826f2-4ff6-443d-b966-e6913bd24013	930fbdd0-f762-11e1-a439-00145eb45e9a
13994	13994	0	GBIF France	da44cd31-5901-4687-a106-6d1c7734ee3a	9452b0e4-7c3b-4f2e-b767-40b775e23f6c
0	37	37	Ocean Biodiversity Information System	ba0670b9-4186-41e6-8e70-f9cb3065551a	95613dfa-8731-4f9d-ada1-85b8b47a5225
35979	326760	290781	U.S. Geological Survey	8618c64a-93e0-4300-b546-7249e5148ed2	95b694cd-e9db-4831-b6a9-0a6d433d92c1
45532	47807	2275	GBIF Germany	4f6826f2-4ff6-443d-b966-e6913bd24013	9668b676-f762-11e1-a439-00145eb45e9a
50	50	0	Colombian Biodiversity Information System	7e865cba-7c46-417b-ade5-97f2cf5b7be0	9776f17f-8b1c-436b-91c7-d7063fab1709
12	12	0	GBIF Germany	4f6826f2-4ff6-443d-b966-e6913bd24013	97a1570a-f762-11e1-a439-00145eb45e9a
0	113	113	Plazi	ffb07bec-2d10-492d-9c37-361fe0b79427	99959baa-aaf6-4631-b65e-3d984c9e85ca
0	1901	1901	Colombian Biodiversity Information System	7e865cba-7c46-417b-ade5-97f2cf5b7be0	9a37f7e6-aed7-4a80-ba31-82c22b4edf08
0	4575	4575	Belgian Biodiversity Platform	fb11cfe1-ebc3-45af-9159-17d9fddbcdac	9ccfd70c-6d44-45f3-8c39-5e920f9a08d5
0	261	261	Plazi	ffb07bec-2d10-492d-9c37-361fe0b79427	9dd1d834-3114-4f1d-bcde-53d3783f4567
271	271	0	Plazi	ffb07bec-2d10-492d-9c37-361fe0b79427	9ee1348c-ac1e-4288-8d0a-f934b11d87d5
6756	6756	0	GBIF Benin	efb9c00e-f802-45dd-8826-a52ec45b89ff	a19f9ba6-4869-4124-b3ef-8b885e16a4d2
0	7	7	Ocean Biodiversity Information System	ba0670b9-4186-41e6-8e70-f9cb3065551a	a5e6e200-815e-40a3-a4dc-df904f108b5b
8	8	0	Plazi	ffb07bec-2d10-492d-9c37-361fe0b79427	a68baa5e-0836-455a-acdc-2a874ac60cef
355	355	0	GBIF Germany	4f6826f2-4ff6-443d-b966-e6913bd24013	a786ae17-dcd8-4302-abb3-72d1a528b413
0	2964	2964	Atlas of Living Australia	4a6f1b71-969e-4fc5-a693-282b05e1220c	a8187367-d9e2-4ac7-802a-d3d00a9685c8
17	17	0	Plazi	ffb07bec-2d10-492d-9c37-361fe0b79427	a919cdc6-b064-4dab-a1cb-05cc9ddc8fb6
0	2	2	Plazi	ffb07bec-2d10-492d-9c37-361fe0b79427	aa270dae-656e-49a7-b237-a34a9dbc27da
14	14	0	Plazi	ffb07bec-2d10-492d-9c37-361fe0b79427	aba54256-0aef-49ac-9312-a35debcec068
16809	16809	0	GBIF Japan	db5705aa-6a6e-42f1-8942-d77b9f4896ea	ad10d89e-868d-4b9e-ab4e-96e35b19a309
31	31	0	GBIF France	da44cd31-5901-4687-a106-6d1c7734ee3a	ae75bad9-e9ec-44a5-bf01-2f1c0664cfcf
19	19	0	Plazi	ffb07bec-2d10-492d-9c37-361fe0b79427	aec44da6-3bb9-4130-a87e-c0cb11cbc2e7
37201	37201	0	U.S. Geological Survey	8618c64a-93e0-4300-b546-7249e5148ed2	aedcba44-1b8c-47e0-ab48-9370e779b6e1
71280	71280	0	Atlas of Living Australia	4a6f1b71-969e-4fc5-a693-282b05e1220c	b0361e24-d3c6-4229-9c07-671d0ee428b0
1	1	0	Plazi	ffb07bec-2d10-492d-9c37-361fe0b79427	b0964cc0-dfc2-4a1e-84db-77d9284061af
15	15	0	National Biodiversity Network	d897a5b9-35ee-4232-94bd-b0bcaac003c2	b0b756f7-4e99-4ec4-9710-3891ae7bddd3
0	24	24	Plazi	ffb07bec-2d10-492d-9c37-361fe0b79427	b2e5c0b0-2582-4a40-8bc8-3d416772ed35
14709	29461	14752	National Biodiversity Network	d897a5b9-35ee-4232-94bd-b0bcaac003c2	b480871a-6c2f-4c35-ab94-6de203c4ff28
0	141	141	Plazi	ffb07bec-2d10-492d-9c37-361fe0b79427	b4b99917-e609-4b32-aba7-62bbddd1f0cf
53213	53213	0	GBIF France	da44cd31-5901-4687-a106-6d1c7734ee3a	b59b09c0-2d1d-4946-ae1e-56adff92515c
0	1129	1129	Ocean Biodiversity Information System	ba0670b9-4186-41e6-8e70-f9cb3065551a	b601ff3b-4ba0-4929-8ba4-baa41edc7b0a
0	1	1	Plazi	ffb07bec-2d10-492d-9c37-361fe0b79427	b64cec11-d9b8-4698-bbe3-9c6021df97cd
0	14	14	Plazi	ffb07bec-2d10-492d-9c37-361fe0b79427	b6897964-2462-4d97-95d6-b52141ae2f25
0	4	4	Plazi	ffb07bec-2d10-492d-9c37-361fe0b79427	b7f06554-7783-40d2-9cc6-b84e5d955abf
1	1	0	GBIF France	da44cd31-5901-4687-a106-6d1c7734ee3a	bf75aa51-e5f9-4f5b-8839-da5c28d7d39e
2421	2421	0	Biodiversity Information System of Mexico	b324e8e9-9a4c-44fa-8f1a-7f39ea7ab576	c0a19d95-471c-44d6-956c-df9b1db6995f
0	1	1	Plazi	ffb07bec-2d10-492d-9c37-361fe0b79427	c0ed67fd-4ab4-4251-91c9-a1485a430652
119382	119382	0	Canada Biodiversity Information Facility	8f83fc96-c966-4126-83f7-bf044dc49efa	c5c4a23e-2035-4416-ab64-032d6df52ddb
0	4	4	Plazi	ffb07bec-2d10-492d-9c37-361fe0b79427	c7915691-7d48-406b-bff5-c56b802f9851
8	8	0	Plazi	ffb07bec-2d10-492d-9c37-361fe0b79427	c96e6bc4-729c-469c-9f1e-1f301d83357d
2	1030	1028	GBIF Germany	4f6826f2-4ff6-443d-b966-e6913bd24013	cc6e9222-cc46-4e16-9e85-7da62a30f073
0	199	199	Plazi	ffb07bec-2d10-492d-9c37-361fe0b79427	d073f599-4282-4f4b-a071-5120d1a4af1e
0	2	2	Plazi	ffb07bec-2d10-492d-9c37-361fe0b79427	d09227b0-6877-4c4e-ac6a-dc6a665c86da
8451	8451	0	National Biodiversity Network	d897a5b9-35ee-4232-94bd-b0bcaac003c2	d20ea853-b19c-4a08-aebb-e5d2fe9e65c0
74	74	0	GBIF Guinea	b1cd2e84-c4ba-47bd-b72a-dfd1f92dce0a	d4bffb9c-ca62-4ab0-8ed4-7c7e6c4cc0d8
94	94	0	GBIF France	da44cd31-5901-4687-a106-6d1c7734ee3a	d4cbd8de-00d7-44c3-97f3-ffd55428a939
0	7	7	Plazi	ffb07bec-2d10-492d-9c37-361fe0b79427	d878d258-67c3-4ce5-a4f3-51b3e6c903ff
0	5	5	Plazi	ffb07bec-2d10-492d-9c37-361fe0b79427	d9007d55-2673-492b-890a-9ef5bdaf06fd
0	3	3	Plazi	ffb07bec-2d10-492d-9c37-361fe0b79427	d939667c-e366-4d35-b74c-8eabebe8d20b
8	8	0	Plazi	ffb07bec-2d10-492d-9c37-361fe0b79427	db36d249-3bdf-459d-b4ce-1451eb29259a
1	1	0	Plazi	ffb07bec-2d10-492d-9c37-361fe0b79427	de320657-5f6f-4327-8497-bb19f6337ff1
1	1	0	Plazi	ffb07bec-2d10-492d-9c37-361fe0b79427	e10a4e78-120e-4d07-abbd-12a31339f01b
4	4	0	Plazi	ffb07bec-2d10-492d-9c37-361fe0b79427	e32a163c-2211-4bc5-9226-543322d9abc0
17713	17917	204	U.S. Geological Survey	8618c64a-93e0-4300-b546-7249e5148ed2	ea9f5b0b-ad97-45ea-935a-ba2784c80cbb
2270	2270	0	Biodiversity Information System of Mexico	b324e8e9-9a4c-44fa-8f1a-7f39ea7ab576	eda1016d-1f81-4c43-833f-5ae3f5b12504
29	29	0	Plazi	ffb07bec-2d10-492d-9c37-361fe0b79427	efead65a-230a-45b1-b542-9595705ae890
118	118	0	Plazi	ffb07bec-2d10-492d-9c37-361fe0b79427	f53d79ee-1997-4be6-bf99-120dbd8aa99c
974	974	0	Colombian Biodiversity Information System	7e865cba-7c46-417b-ade5-97f2cf5b7be0	f5ff3e05-fdd3-4ef8-8c0b-490965019feb
0	1	1	Plazi	ffb07bec-2d10-492d-9c37-361fe0b79427	f94f6be5-0e09-477e-8b06-7bcd58165d6f
16800	16800	0	Korean Biodiversity Information Facility	e0a1e772-0177-4800-94b4-2d023fe6cdf4	fa172337-ee05-48a9-b23b-13678f52308a
1956	1956	0	National Biodiversity Network	d897a5b9-35ee-4232-94bd-b0bcaac003c2	fceb1041-5194-4940-967c-b0479f562a3b
36	36	0	Plazi	ffb07bec-2d10-492d-9c37-361fe0b79427	fe48cda7-f0d3-4a74-88f7-6bb854e9367a
0	160	160	Ocean Biodiversity Information System	ba0670b9-4186-41e6-8e70-f9cb3065551a	fe765c4b-eb8d-4b12-9e63-a9283c0249da
8	8	0	Plazi	ffb07bec-2d10-492d-9c37-361fe0b79427	000e5e3d-ee09-4d51-b106-d4ad23a37513
5300	5300	0	Biodiversity Information System of Mexico	b324e8e9-9a4c-44fa-8f1a-7f39ea7ab576	014e217e-d654-4a10-9b54-185053761b9e
1827	1827	0	GBIF France	da44cd31-5901-4687-a106-6d1c7734ee3a	01e416c5-1ba7-42b7-9402-17ddfd651cca
0	33	33	Plazi	ffb07bec-2d10-492d-9c37-361fe0b79427	036e3bf9-d7de-42ca-8b75-effc704a0284
1	1	0	Plazi	ffb07bec-2d10-492d-9c37-361fe0b79427	037c9864-82ed-4be6-bded-705bfb82ca14
3	3	0	Plazi	ffb07bec-2d10-492d-9c37-361fe0b79427	04449b7c-877b-4e2c-a60c-3f9fc8c0afb5
103	103	0	GBIF France	da44cd31-5901-4687-a106-6d1c7734ee3a	057a2886-012e-4c98-b1cb-40a03284363a
0	6	6	Plazi	ffb07bec-2d10-492d-9c37-361fe0b79427	059f21b5-3e0d-48ed-8fd0-fef470688a11
2	2	0	Plazi	ffb07bec-2d10-492d-9c37-361fe0b79427	080ba04a-c276-46d4-9a58-074dab625b13
0	2	2	Plazi	ffb07bec-2d10-492d-9c37-361fe0b79427	08fe6cff-cea4-4f77-a5d1-96b24914a124
0	410	410	Belgian Biodiversity Platform	fb11cfe1-ebc3-45af-9159-17d9fddbcdac	09351826-01ad-4914-aaca-5f9aaee2a16f
0	15	15	Plazi	ffb07bec-2d10-492d-9c37-361fe0b79427	0c695ac5-0bed-4d52-8903-a1da2ed60025
4032	1280	-2752	GBIF Germany	4f6826f2-4ff6-443d-b966-e6913bd24013	0cd9bc4b-8939-40a9-bdcc-46228d1d0af2
9	9	0	Plazi	ffb07bec-2d10-492d-9c37-361fe0b79427	0e5da2ee-ab64-4a9c-9264-168198db0e19
47	47	0	Colombian Biodiversity Information System	7e865cba-7c46-417b-ade5-97f2cf5b7be0	132c0b90-dc65-4059-8a76-6759ece07864
0	2	2	Plazi	ffb07bec-2d10-492d-9c37-361fe0b79427	136036c0-9930-478f-ac47-8eb789b8659a
4	4	0	Plazi	ffb07bec-2d10-492d-9c37-361fe0b79427	13dbf248-2697-49aa-a2e5-c8bb9856bf25
1522	1522	0	Participant Node Managers Committee	7f48e0c8-5c96-49ec-b972-30748e339115	17a665f3-f6fa-4a01-bc9c-72bcee86f4f8
0	3661	3661	ASEAN Centre for Biodiversity	af2a0fa1-4c8e-4bdc-8954-b1a55e32b0f1	18896efa-22df-4fbd-9782-42f47257e753
1271	1271	0	National Biodiversity Network	d897a5b9-35ee-4232-94bd-b0bcaac003c2	1a1e1843-fb8d-4876-b8bd-1d728dba8e8c
7	7	0	Plazi	ffb07bec-2d10-492d-9c37-361fe0b79427	1b60b99c-115e-4bf5-898f-7a35a144d66f
763	763	0	Colombian Biodiversity Information System	7e865cba-7c46-417b-ade5-97f2cf5b7be0	1cd2fdd6-24d3-4402-905f-8a72ddffd3ad
0	150	150	Ocean Biodiversity Information System	ba0670b9-4186-41e6-8e70-f9cb3065551a	1e3cc4ef-354e-442d-9905-8af71ec569ff
7	7	0	Plazi	ffb07bec-2d10-492d-9c37-361fe0b79427	200ef741-1d88-4e22-a7c3-60c863a90798
34	34	0	Plazi	ffb07bec-2d10-492d-9c37-361fe0b79427	2173c9e3-bd5a-4f3d-9e9f-e04762a5efca
235	235	0	Plazi	ffb07bec-2d10-492d-9c37-361fe0b79427	291701d4-652e-440e-adab-f6b0201c0972
0	13	13	Plazi	ffb07bec-2d10-492d-9c37-361fe0b79427	2aa88113-f72c-4a06-bc79-3ce806bec0d8
0	1	1	Plazi	ffb07bec-2d10-492d-9c37-361fe0b79427	2eac2bd6-7aaa-4d9d-a751-8b498817e899
81329	81329	0	Belgian Biodiversity Platform	fb11cfe1-ebc3-45af-9159-17d9fddbcdac	2f59780e-3d77-403a-9437-9a560ea5f764
396	396	0	National Biodiversity Network	d897a5b9-35ee-4232-94bd-b0bcaac003c2	3043aac0-611e-453c-b6fe-32bc10d72264
0	4	4	Plazi	ffb07bec-2d10-492d-9c37-361fe0b79427	33000e96-4c36-46dc-92d4-8134ca756f31
0	47	47	Plazi	ffb07bec-2d10-492d-9c37-361fe0b79427	35339991-5eef-417d-9a58-b8bf6d06fa65
0	872	872	Participant Node Managers Committee	7f48e0c8-5c96-49ec-b972-30748e339115	374edb5d-8b71-4dfb-96f3-4ac464965d1d
1803	1803	0	Tanzania Biodiversity Information Facility	abd95ca6-3959-4db9-aaa6-2de1aeecf514	3b675090-f91c-11dd-af50-b8a03c50a862
725	725	0	Participant Node Managers Committee	7f48e0c8-5c96-49ec-b972-30748e339115	3c273f73-9fc0-4cc7-906a-d05614b6aa40
48858	48858	0	GBIF France	da44cd31-5901-4687-a106-6d1c7734ee3a	3cd814ac-f90e-4e5b-a5e0-35446cfa61f1
0	4	4	Plazi	ffb07bec-2d10-492d-9c37-361fe0b79427	3d1b1ce8-cd07-4730-8e58-36433c6c3675
0	23	23	Plazi	ffb07bec-2d10-492d-9c37-361fe0b79427	3ddea826-544c-452c-994e-01c1a4973a4b
0	3	3	Plazi	ffb07bec-2d10-492d-9c37-361fe0b79427	3e2dc366-0529-41cd-ac5a-f3653df072bd
0	215	215	Plazi	ffb07bec-2d10-492d-9c37-361fe0b79427	3eda26cc-d820-46b2-83b0-369405452077
0	49	49	Plazi	ffb07bec-2d10-492d-9c37-361fe0b79427	43ff5da2-428c-4798-a06b-156642890666
2840	2840	0	National Biodiversity Network	d897a5b9-35ee-4232-94bd-b0bcaac003c2	46c453aa-9f8f-4b2b-baa9-f89cf84bf84c
0	3	3	Plazi	ffb07bec-2d10-492d-9c37-361fe0b79427	4a12b144-e444-4353-a054-f8b300dc9751
553	553	0	Colombian Biodiversity Information System	7e865cba-7c46-417b-ade5-97f2cf5b7be0	4a98d3d0-f2e5-4c70-a1f5-3744b218d55d
54	54	0	GBIF France	da44cd31-5901-4687-a106-6d1c7734ee3a	4aeb13ad-c7e3-4bc1-88ff-302023454e53
5540	5540	0	Colombian Biodiversity Information System	7e865cba-7c46-417b-ade5-97f2cf5b7be0	4bc7e4b3-fc9a-4d80-9de8-f2c8e09b408d
0	12	12	Plazi	ffb07bec-2d10-492d-9c37-361fe0b79427	4d046ba4-dfd4-4c12-a93c-3b30eec0c78e
23103	23103	0	National Biodiversity Network	d897a5b9-35ee-4232-94bd-b0bcaac003c2	4f03bd51-a00c-4060-9eb6-b8db70c8a07b
15593	15593	0	GBIF Japan	db5705aa-6a6e-42f1-8942-d77b9f4896ea	58a8aefd-9312-4046-9d8f-d289030298f1
2	2	0	Plazi	ffb07bec-2d10-492d-9c37-361fe0b79427	599b7ef4-23cf-4893-ad32-9bba9b1c76ae
3	3	0	Plazi	ffb07bec-2d10-492d-9c37-361fe0b79427	59efae63-9286-44d9-bf6e-f06fe0f7049e
26	26	0	Plazi	ffb07bec-2d10-492d-9c37-361fe0b79427	5f00a3f5-ecce-427f-b83e-4756bab5f231
104	104	0	GBIF Germany	4f6826f2-4ff6-443d-b966-e6913bd24013	61219a1e-f762-11e1-a439-00145eb45e9a
9	9	0	Plazi	ffb07bec-2d10-492d-9c37-361fe0b79427	615b1762-f564-4f34-97b1-98b083bd00d3
62	62	0	GBIF Germany	4f6826f2-4ff6-443d-b966-e6913bd24013	6276fa08-f762-11e1-a439-00145eb45e9a
18	18	0	Plazi	ffb07bec-2d10-492d-9c37-361fe0b79427	631a39f7-40d8-47fa-96e0-d04aa885c01e
128	128	0	GBIF Germany	4f6826f2-4ff6-443d-b966-e6913bd24013	657d788a-f762-11e1-a439-00145eb45e9a
937972	937972	0	GBIF France	da44cd31-5901-4687-a106-6d1c7734ee3a	66551429-5e35-4848-94f5-b13bcad669a5
62	62	0	GBIF Germany	4f6826f2-4ff6-443d-b966-e6913bd24013	676f6b30-f762-11e1-a439-00145eb45e9a
66	66	0	GBIF Germany	4f6826f2-4ff6-443d-b966-e6913bd24013	685e0d08-f762-11e1-a439-00145eb45e9a
322	190	-132	GBIF Germany	4f6826f2-4ff6-443d-b966-e6913bd24013	68d3a46e-f762-11e1-a439-00145eb45e9a
96	96	0	GBIF Germany	4f6826f2-4ff6-443d-b966-e6913bd24013	691ac39e-f762-11e1-a439-00145eb45e9a
54	36	-18	GBIF Germany	4f6826f2-4ff6-443d-b966-e6913bd24013	69fc1498-f762-11e1-a439-00145eb45e9a
525	525	0	GBIF Germany	4f6826f2-4ff6-443d-b966-e6913bd24013	6a5f9f99-8624-46f4-8d61-1a19b3957d90
32	32	0	GBIF Germany	4f6826f2-4ff6-443d-b966-e6913bd24013	6aaa887a-f762-11e1-a439-00145eb45e9a
2	2	0	Plazi	ffb07bec-2d10-492d-9c37-361fe0b79427	6b6a2b6e-af31-483d-a17b-8521c988e4ac
1572	1572	0	GBIF Germany	4f6826f2-4ff6-443d-b966-e6913bd24013	6ba5b22c-f762-11e1-a439-00145eb45e9a
17	17	0	Plazi	ffb07bec-2d10-492d-9c37-361fe0b79427	6c2ad151-a6e0-4c1b-be84-d1950abe22dd
18	18	0	GBIF Germany	4f6826f2-4ff6-443d-b966-e6913bd24013	6c752de0-f762-11e1-a439-00145eb45e9a
239	239	0	Society for the Management of Electronic Biodiversity Data	97818ee4-1461-4180-bf1d-b3201050124f	6d914327-6c7f-4ceb-8f67-4b80792ceded
4	4	0	Plazi	ffb07bec-2d10-492d-9c37-361fe0b79427	6db7c63d-267c-4441-8de7-345870b651d2
13053	13053	0	National Biodiversity Network	d897a5b9-35ee-4232-94bd-b0bcaac003c2	6dfb5f20-5c61-4575-80a3-ecb6d286c725
200	200	0	U.S. Geological Survey	8618c64a-93e0-4300-b546-7249e5148ed2	6f6da8ae-e270-49e0-b0b4-5ea7c968f9da
0	52	52	Colombian Biodiversity Information System	7e865cba-7c46-417b-ade5-97f2cf5b7be0	71789c32-3fad-4430-8b8a-3e5c14e1f46b
27	27	0	GBIF Germany	4f6826f2-4ff6-443d-b966-e6913bd24013	71c25782-f762-11e1-a439-00145eb45e9a
804	804	0	GBIF France	da44cd31-5901-4687-a106-6d1c7734ee3a	72749f26-86dc-4b9d-b1bc-1d965a59ea3d
813	796	-17	GBIF Germany	4f6826f2-4ff6-443d-b966-e6913bd24013	73da4b10-f762-11e1-a439-00145eb45e9a
574	574	0	GBIF France	da44cd31-5901-4687-a106-6d1c7734ee3a	74f77cb8-e890-47a2-b56f-165859ac6167
5	5	0	Plazi	ffb07bec-2d10-492d-9c37-361fe0b79427	75553cde-491f-4bf9-ac3d-95d83262c269
66	66	0	GBIF Germany	4f6826f2-4ff6-443d-b966-e6913bd24013	75806ea4-f762-11e1-a439-00145eb45e9a
198	198	0	GBIF Germany	4f6826f2-4ff6-443d-b966-e6913bd24013	75f8b36e-f762-11e1-a439-00145eb45e9a
28	28	0	Plazi	ffb07bec-2d10-492d-9c37-361fe0b79427	780e139c-d08a-4aae-be97-171bf368b1d5
10	10	0	GBIF Germany	4f6826f2-4ff6-443d-b966-e6913bd24013	78e76c46-f762-11e1-a439-00145eb45e9a
0	2	2	Plazi	ffb07bec-2d10-492d-9c37-361fe0b79427	7a62beba-ab4f-4473-bb31-ba67f6260b91
0	41	41	Plazi	ffb07bec-2d10-492d-9c37-361fe0b79427	7ba5f9ac-4317-459f-9829-2975de0a42ff
3236	3236	0	GBIF Germany	4f6826f2-4ff6-443d-b966-e6913bd24013	7cd82444-f762-11e1-a439-00145eb45e9a
825	825	0	GBIF Germany	4f6826f2-4ff6-443d-b966-e6913bd24013	7e53d17e-f762-11e1-a439-00145eb45e9a
0	418	418	Plazi	ffb07bec-2d10-492d-9c37-361fe0b79427	7e93dad8-0c75-4ded-9ab8-ce44992288f3
162	162	0	GBIF Germany	4f6826f2-4ff6-443d-b966-e6913bd24013	7eb0df2c-f762-11e1-a439-00145eb45e9a
650	650	0	GBIF France	da44cd31-5901-4687-a106-6d1c7734ee3a	7f497e5e-8db1-45ac-8336-400b935df662
933	930	-3	Biodiversity Information System of Mexico	b324e8e9-9a4c-44fa-8f1a-7f39ea7ab576	801b523e-f762-11e1-a439-00145eb45e9a
352	352	0	Biodiversity Information System of Mexico	b324e8e9-9a4c-44fa-8f1a-7f39ea7ab576	80811fba-f762-11e1-a439-00145eb45e9a
2	2	0	GBIF Germany	4f6826f2-4ff6-443d-b966-e6913bd24013	81401a32-f762-11e1-a439-00145eb45e9a
161	161	0	GBIF Germany	4f6826f2-4ff6-443d-b966-e6913bd24013	8191832c-f762-11e1-a439-00145eb45e9a
12540	12540	0	Biodiversity Information System of Mexico	b324e8e9-9a4c-44fa-8f1a-7f39ea7ab576	83dc7429-4457-4d49-ac7a-ad1326d6aad4
249696	250302	606	Netherlands Biodiversity Information Facility	0909d601-bda2-42df-9e63-a6d51847ebce	843633a9-07cb-4918-a79f-6061b52c9dfd
2269	1878	-391	GBIF Germany	4f6826f2-4ff6-443d-b966-e6913bd24013	86ea02b8-f762-11e1-a439-00145eb45e9a
742	742	0	GBIF Germany	4f6826f2-4ff6-443d-b966-e6913bd24013	88c181ce-f762-11e1-a439-00145eb45e9a
242	242	0	GBIF Germany	4f6826f2-4ff6-443d-b966-e6913bd24013	899d3214-f762-11e1-a439-00145eb45e9a
1015	1015	0	Biodiversity Information System of Mexico	b324e8e9-9a4c-44fa-8f1a-7f39ea7ab576	8a397061-e613-46a8-bcbd-52195a7695b4
202	202	0	GBIF Germany	4f6826f2-4ff6-443d-b966-e6913bd24013	8a6ac2b0-f762-11e1-a439-00145eb45e9a
235250	235250	0	Belgian Biodiversity Platform	fb11cfe1-ebc3-45af-9159-17d9fddbcdac	8ae09016-b819-450e-b8f6-c1f249110502
18	10	-8	GBIF Germany	4f6826f2-4ff6-443d-b966-e6913bd24013	8cba25ba-f762-11e1-a439-00145eb45e9a
48	32	-16	GBIF Germany	4f6826f2-4ff6-443d-b966-e6913bd24013	8e73021e-f762-11e1-a439-00145eb45e9a
217	126	-91	GBIF Germany	4f6826f2-4ff6-443d-b966-e6913bd24013	8e89047e-f762-11e1-a439-00145eb45e9a
561	407	-154	GBIF Germany	4f6826f2-4ff6-443d-b966-e6913bd24013	8fe3034c-f762-11e1-a439-00145eb45e9a
25	9	-16	GBIF Germany	4f6826f2-4ff6-443d-b966-e6913bd24013	90315e98-f762-11e1-a439-00145eb45e9a
13	7	-6	GBIF Germany	4f6826f2-4ff6-443d-b966-e6913bd24013	90fff5aa-f762-11e1-a439-00145eb45e9a
535	375	-160	GBIF Germany	4f6826f2-4ff6-443d-b966-e6913bd24013	91de33ba-f762-11e1-a439-00145eb45e9a
138	138	0	GBIF Germany	4f6826f2-4ff6-443d-b966-e6913bd24013	92b72788-f762-11e1-a439-00145eb45e9a
281	281	0	GBIF Germany	4f6826f2-4ff6-443d-b966-e6913bd24013	93aa12fe-f762-11e1-a439-00145eb45e9a
5340	5340	0	GBIF Benin	efb9c00e-f802-45dd-8826-a52ec45b89ff	945157f4-faa2-44d3-baf9-594c4cba66a9
4629	5129	500	GBIF Japan	db5705aa-6a6e-42f1-8942-d77b9f4896ea	95f132fe-f762-11e1-a439-00145eb45e9a
0	10	10	Plazi	ffb07bec-2d10-492d-9c37-361fe0b79427	96e480cd-22b3-4ad3-b973-02b06c2cacd8
0	2	2	Plazi	ffb07bec-2d10-492d-9c37-361fe0b79427	9791d7bd-96ed-4df1-8926-44a98b557548
6051	6051	0	GBIF Brazil	cdc9736d-5ff7-4ece-9959-3c744360cdb3	98d7a49c-5776-41eb-a928-b6f5174eadd1
0	10	10	Plazi	ffb07bec-2d10-492d-9c37-361fe0b79427	9c86da8c-0a46-403a-baba-d35df7a5dce1
3661	3661	0	GBIF Germany	4f6826f2-4ff6-443d-b966-e6913bd24013	9d98a708-c678-4c73-afdc-16c12f46725e
19	19	0	Plazi	ffb07bec-2d10-492d-9c37-361fe0b79427	9dc8b6f0-e74e-4ace-87c0-ff865f7a1a4a
8	8	0	Plazi	ffb07bec-2d10-492d-9c37-361fe0b79427	9dfb5f5f-ad7e-481f-ae85-1c92732af7e4
9	9	0	Plazi	ffb07bec-2d10-492d-9c37-361fe0b79427	9e80d4ec-9773-4e8a-839c-36b09bbf4e75
19	19	0	Plazi	ffb07bec-2d10-492d-9c37-361fe0b79427	9f9fc94b-4863-4ab2-9628-e5d6d3a71fc5
0	101	101	Plazi	ffb07bec-2d10-492d-9c37-361fe0b79427	a09df80c-5d8b-44da-8f25-723f107c6c49
0	239	239	U.S. Geological Survey	8618c64a-93e0-4300-b546-7249e5148ed2	a28138cb-d42a-460d-b16d-8ed2f911022f
8	8	0	Plazi	ffb07bec-2d10-492d-9c37-361fe0b79427	a2bf5df0-d436-4b4b-b5bf-c80dbbf73146
2	2	0	Plazi	ffb07bec-2d10-492d-9c37-361fe0b79427	a435adb8-3cba-4dde-a36c-deba6ea177c1
41	41	0	Plazi	ffb07bec-2d10-492d-9c37-361fe0b79427	a49771bc-fc80-41c8-bc78-c4b525ecc201
1784	5861	4077	Colombian Biodiversity Information System	7e865cba-7c46-417b-ade5-97f2cf5b7be0	a57429db-1b67-4569-8731-76a240a74a89
3	3	0	Plazi	ffb07bec-2d10-492d-9c37-361fe0b79427	a7047367-2efd-42c0-b363-2274e7160746
6	6	0	Plazi	ffb07bec-2d10-492d-9c37-361fe0b79427	ad9ecc16-02ac-4f07-ae49-700c5cadbb0f
9	9	0	Plazi	ffb07bec-2d10-492d-9c37-361fe0b79427	b1bebdfa-3977-46b4-98ae-94d891747bbb
0	4	4	Plazi	ffb07bec-2d10-492d-9c37-361fe0b79427	b585e3bb-86bb-434f-b87f-b1bd90e8d496
37	37	0	Colombian Biodiversity Information System	7e865cba-7c46-417b-ade5-97f2cf5b7be0	b5a2dfc2-dc20-4af9-adfd-09b910e112d2
21621	21621	0	National Biodiversity Network	d897a5b9-35ee-4232-94bd-b0bcaac003c2	b609bc74-059c-4a65-8ab0-85bd96257a78
0	26	26	Ocean Biodiversity Information System	ba0670b9-4186-41e6-8e70-f9cb3065551a	b62b5889-72df-4188-8fb1-888b26132fae
188	188	0	GBIF Germany	4f6826f2-4ff6-443d-b966-e6913bd24013	b6e59324-3888-49de-9038-1adb1c9af9c6
38	38	0	Plazi	ffb07bec-2d10-492d-9c37-361fe0b79427	b9453839-5f43-4081-a642-f7bb30caf894
0	48	48	Ocean Biodiversity Information System	ba0670b9-4186-41e6-8e70-f9cb3065551a	b9792eba-8e09-4119-b497-99b6e0d28b74
215823	215823	0	U.S. Geological Survey	8618c64a-93e0-4300-b546-7249e5148ed2	b9d90a50-3138-4837-b4b1-775f3526889c
4	4	0	Plazi	ffb07bec-2d10-492d-9c37-361fe0b79427	ba16ea95-0ab8-4669-b501-cddb7326e00e
0	135	135	Plazi	ffb07bec-2d10-492d-9c37-361fe0b79427	bbecfe17-0d11-474f-9637-19918ef2716d
2284	2284	0	Biodiversity Information System of Mexico	b324e8e9-9a4c-44fa-8f1a-7f39ea7ab576	bbedc129-ddc2-4651-b64d-f9d7666e4b74
2	2	0	Plazi	ffb07bec-2d10-492d-9c37-361fe0b79427	bc0802b7-5918-428d-8cb8-c2f047e32cc7
0	29	29	Plazi	ffb07bec-2d10-492d-9c37-361fe0b79427	bc32a3b9-3917-47ef-8b02-b914c660daac
7	7	0	Plazi	ffb07bec-2d10-492d-9c37-361fe0b79427	be157984-b43b-42c4-aeb5-6c2682bab7e0
0	6	6	Plazi	ffb07bec-2d10-492d-9c37-361fe0b79427	bf24d1c3-1400-44f6-8365-3fc9d970bee2
63	63	0	GBIF Germany	4f6826f2-4ff6-443d-b966-e6913bd24013	bf75c1e6-54d7-4ff6-8f18-c6c578a4ce05
2	2	0	Plazi	ffb07bec-2d10-492d-9c37-361fe0b79427	c10a2aee-17da-4e8e-a26b-1edfc3a5d7e8
0	56	56	Ocean Biodiversity Information System	ba0670b9-4186-41e6-8e70-f9cb3065551a	c2c49376-3b67-416f-a1c8-60690afaff4a
41232	41232	0	GBIF Spain	1f94b3ca-9345-4d65-afe2-4bace93aa0fe	c7e92c5c-f2f2-4caf-a9d5-3d3e0c4c088a
78	78	0	Biodiversity Information System of Mexico	b324e8e9-9a4c-44fa-8f1a-7f39ea7ab576	c7fea31c-a458-4890-883d-94dd003e230b
0	2	2	Plazi	ffb07bec-2d10-492d-9c37-361fe0b79427	c81dc26c-be40-4ebd-b8b3-24f5910f9b47
2578	2578	0	GBIF Japan	db5705aa-6a6e-42f1-8942-d77b9f4896ea	c8d09c03-2715-4f29-9158-fb22094cc3b5
5192	5192	0	Participant Node Managers Committee	7f48e0c8-5c96-49ec-b972-30748e339115	c988d44d-e992-4653-be46-124cefa0d314
0	2	2	Plazi	ffb07bec-2d10-492d-9c37-361fe0b79427	cef16f5d-3805-4864-af30-bcb2f1f7f518
210	210	0	GBIF Argentina	2426a871-9feb-40a1-96c6-0c593a76b835	cf2131ea-e2c2-4cd5-a1c5-9e3eb1047a67
0	4	4	Plazi	ffb07bec-2d10-492d-9c37-361fe0b79427	cf8ffd13-ba49-498f-bcce-bb7f529213af
47	47	0	Plazi	ffb07bec-2d10-492d-9c37-361fe0b79427	d05987e2-6008-4deb-9773-1d988013beba
1774	1774	0	Belgian Biodiversity Platform	fb11cfe1-ebc3-45af-9159-17d9fddbcdac	d3290fe3-c924-4708-87d5-1955db1f9077
9	9	0	Plazi	ffb07bec-2d10-492d-9c37-361fe0b79427	d3e9578f-3031-417e-8f1a-1bcec3bfda48
288	288	0	Biodiversity Information System of Mexico	b324e8e9-9a4c-44fa-8f1a-7f39ea7ab576	d603329b-9cfa-4238-8509-c28432bf1c9d
11129	11129	0	Canada Biodiversity Information Facility	8f83fc96-c966-4126-83f7-bf044dc49efa	d7cfd2ed-8af4-427f-a16e-eb66b7e2c419
7	7	0	GBIF France	da44cd31-5901-4687-a106-6d1c7734ee3a	d813f10b-436c-4726-bf9b-fbaed2d0c978
2985	2695	-290	Biodiversity Information System of Mexico	b324e8e9-9a4c-44fa-8f1a-7f39ea7ab576	d9f88728-5c0d-4fbe-a0ef-9559c2d9bf46
4	4	0	Plazi	ffb07bec-2d10-492d-9c37-361fe0b79427	da0ef803-9cde-45c3-8bab-c2a3da016983
17117	17117	0	South African Biodiversity Information Facility	7190b835-4e86-4b6e-85c1-19cc6677c250	da38f103-4410-43d1-b716-ea6b1b92bbac
0	25	25	Colombian Biodiversity Information System	7e865cba-7c46-417b-ade5-97f2cf5b7be0	da5434df-ce6f-4b75-8531-a7759cc739ff
0	20	20	Plazi	ffb07bec-2d10-492d-9c37-361fe0b79427	dbba77b3-c98e-4cd3-a73a-524fa2899baa
185	185	0	Plazi	ffb07bec-2d10-492d-9c37-361fe0b79427	de014b0b-a500-4236-9610-b6fe83e74184
5	5	0	Participant Node Managers Committee	7f48e0c8-5c96-49ec-b972-30748e339115	de4ddd94-937b-4acc-9009-3d9e348c9ea1
31251	33023	1772	National Biodiversity Network	d897a5b9-35ee-4232-94bd-b0bcaac003c2	e21033eb-b5b1-4043-a035-abf57e65efe7
9383	14258	4875	Netherlands Biodiversity Information Facility	0909d601-bda2-42df-9e63-a6d51847ebce	e2bc2f00-62f3-4fd4-b9f3-89c030bca07a
23	23	0	Plazi	ffb07bec-2d10-492d-9c37-361fe0b79427	e5db68d9-b799-4a84-9143-fc8bfb0628e1
2	2	0	Plazi	ffb07bec-2d10-492d-9c37-361fe0b79427	e924288f-3da1-46f3-97a7-266b2fd6a856
5089	5089	0	GBIF Spain	1f94b3ca-9345-4d65-afe2-4bace93aa0fe	ebd49d9b-696b-4dba-8700-8526b1e7b4a2
0	5	5	Plazi	ffb07bec-2d10-492d-9c37-361fe0b79427	ed906a94-b869-4f50-8fec-4bd128e3bbdc
3570	3570	0	Taiwan Biodiversity Information Facility	e1b85abc-61f9-430f-ba79-6813dec53a0f	f1d263a0-98a0-11de-b4d9-b8a03c50a862
17105	17105	0	GBIF Nigeria	6529bcb5-a542-4fda-be87-54a624515335	f455bc89-8b18-4ad2-a982-cb961022a3ab
0	176	176	Plazi	ffb07bec-2d10-492d-9c37-361fe0b79427	fa25aff8-4a19-41ad-9d0b-70eecd36bc56
50	50	0	Plazi	ffb07bec-2d10-492d-9c37-361fe0b79427	fb0d8b09-a0fc-47d2-9af1-37d24cc23e56
0	8	8	Plazi	ffb07bec-2d10-492d-9c37-361fe0b79427	057ede68-00bf-4e4c-871d-1c0b7ebf847e
0	283	283	Ocean Biodiversity Information System	ba0670b9-4186-41e6-8e70-f9cb3065551a	0841d866-086d-4ee1-9646-bfc6a018f303
2537	2537	0	GBIF Norway	4f829580-180d-46a9-9c87-ed8ec959b545	08ec09cc-2de8-4e37-8441-d052f6da5af7
53	53	0	GBIF Germany	4f6826f2-4ff6-443d-b966-e6913bd24013	090aed50-8139-489f-8dda-26b25c874a8d
3719	3719	0	GBIF France	da44cd31-5901-4687-a106-6d1c7734ee3a	09969fa8-116e-4506-ac06-61bb0b32c7c0
1	1	0	Participant Node Managers Committee	7f48e0c8-5c96-49ec-b972-30748e339115	0aca85b0-2d6e-43b8-bae5-7973a2b53989
0	2	2	Plazi	ffb07bec-2d10-492d-9c37-361fe0b79427	0bbde721-80ef-494e-928f-1200335d7ed6
0	12	12	Plazi	ffb07bec-2d10-492d-9c37-361fe0b79427	0bea0b31-8bff-43bf-aebb-8cda61f093d9
2	2	0	Plazi	ffb07bec-2d10-492d-9c37-361fe0b79427	0d13589e-a8f4-44c4-9c80-f1202e57cbc5
493	493	0	GBIF France	da44cd31-5901-4687-a106-6d1c7734ee3a	11d35c65-edea-49c9-9be0-64cb1c4d384c
4564	4564	0	GBIF Portugal	673f7038-4262-4149-b753-5658a4e912f6	12475130-8b28-11de-b647-b8a03c50a862
0	17	17	Plazi	ffb07bec-2d10-492d-9c37-361fe0b79427	13d05d68-bf03-4cfb-b96c-b7017e829854
8926	8926	0	National Biodiversity Network	d897a5b9-35ee-4232-94bd-b0bcaac003c2	14a6dd9e-c8b5-4489-af8d-e7ad8d9e2a73
183	184	1	National Biodiversity Network	d897a5b9-35ee-4232-94bd-b0bcaac003c2	1c599438-5abd-484f-8deb-d0263dec510f
9349	9349	0	Canada Biodiversity Information Facility	8f83fc96-c966-4126-83f7-bf044dc49efa	1cb0f057-172b-4c10-99d8-cd38966dab31
272	272	0	National Biodiversity Network	d897a5b9-35ee-4232-94bd-b0bcaac003c2	1cc7ea6d-ae95-482d-932d-3d414978ff14
0	17	17	Plazi	ffb07bec-2d10-492d-9c37-361fe0b79427	1d365dfe-b498-4540-aa83-c246f1c5a06e
5	5	0	Plazi	ffb07bec-2d10-492d-9c37-361fe0b79427	1e1d77a3-9d77-4e48-b963-022859a48102
0	14	14	Ocean Biodiversity Information System	ba0670b9-4186-41e6-8e70-f9cb3065551a	1e5e5948-c599-47ae-b6a2-f1bbf749c3a7
828	828	0	U.S. Geological Survey	8618c64a-93e0-4300-b546-7249e5148ed2	1f214c81-1fbf-4aca-bf3a-d1fbbe10b710
0	1	1	Plazi	ffb07bec-2d10-492d-9c37-361fe0b79427	20796331-f842-4b88-9cb1-1a7374c514f8
0	465	465	Plazi	ffb07bec-2d10-492d-9c37-361fe0b79427	24015f76-6d6f-461f-be58-aa9ff6ae55ed
0	487	487	U.S. Geological Survey	8618c64a-93e0-4300-b546-7249e5148ed2	2599eef3-f643-48a3-aa03-346ec2df7451
0	5	5	Plazi	ffb07bec-2d10-492d-9c37-361fe0b79427	25a1d6a3-0aac-46f0-b73c-c69451b5f906
82	82	0	Plazi	ffb07bec-2d10-492d-9c37-361fe0b79427	278c6fda-d58f-44b1-b72c-40fed75738c4
12797	12876	79	GBIF Luxembourg	b0ccbf42-26b3-412e-b38a-339889154d77	2814930a-3b93-48d6-b887-00979481ac9e
48	48	0	Plazi	ffb07bec-2d10-492d-9c37-361fe0b79427	2bc222ca-6419-489e-b594-58eaca64306c
0	4	4	Plazi	ffb07bec-2d10-492d-9c37-361fe0b79427	30ae89a2-0e0d-4242-bb0e-a42caa446041
9	9	0	Plazi	ffb07bec-2d10-492d-9c37-361fe0b79427	31929020-517f-40aa-bebf-0599d78ace42
79	79	0	Colombian Biodiversity Information System	7e865cba-7c46-417b-ade5-97f2cf5b7be0	31a289d5-7115-4227-8a00-ea52ea008404
151	151	0	National Biodiversity Network	d897a5b9-35ee-4232-94bd-b0bcaac003c2	3498e164-cd56-480d-a4c8-350a627743d9
585	585	0	GBIF Finland	dd514216-5c7c-45f3-910d-797424cb5be6	3779d91b-a2e2-4957-8e8a-01f8ee1c38dd
2	2	0	Plazi	ffb07bec-2d10-492d-9c37-361fe0b79427	3804c861-732b-4f50-b6bd-49d10632b73a
5	5	0	Plazi	ffb07bec-2d10-492d-9c37-361fe0b79427	380557b0-b78e-4dd3-a582-75f6fa6d04b4
885	186	-699	GBIF Germany	4f6826f2-4ff6-443d-b966-e6913bd24013	3907c344-bced-4c70-8fab-d45ad186a0b8
99620	103413	3793	GBIF France	da44cd31-5901-4687-a106-6d1c7734ee3a	3959ee49-7678-4a88-9049-5dfc55ccebf3
19	19	0	Plazi	ffb07bec-2d10-492d-9c37-361fe0b79427	3b16ccee-0aff-4e22-861b-bee3c665c3e9
5436	5436	0	GBIF France	da44cd31-5901-4687-a106-6d1c7734ee3a	3bee65e6-5de2-4e7f-9384-5f94574f59c6
2	2	0	Plazi	ffb07bec-2d10-492d-9c37-361fe0b79427	3c516d90-f9f4-4003-9329-fd4fe506f0b8
1214	1214	0	National Biodiversity Network	d897a5b9-35ee-4232-94bd-b0bcaac003c2	463138bd-134d-436b-8c53-598dd849b294
2	2	0	Plazi	ffb07bec-2d10-492d-9c37-361fe0b79427	4a6a79da-9274-4617-8584-b5e45a85a1df
3	3	0	Plazi	ffb07bec-2d10-492d-9c37-361fe0b79427	4b8ec547-63b7-411f-84c7-7e38e9e8b7f5
0	1	1	Plazi	ffb07bec-2d10-492d-9c37-361fe0b79427	4dac1de7-5633-4591-96d2-f54832495d88
42829	42829	0	Ghana Biodiversity Information Facility	b5633b75-6a86-4fdf-9cfc-506047fb9dc7	4faff7c0-b7f3-442b-88ec-b87d3e0721a3
2	2	0	Plazi	ffb07bec-2d10-492d-9c37-361fe0b79427	515689b4-9ffa-4ab0-8607-cff2209205d4
2791	2791	0	GBIF Japan	db5705aa-6a6e-42f1-8942-d77b9f4896ea	519ef273-f2d9-47fd-bcbf-5451c33ab8d1
450	225	-225	GBIF Germany	4f6826f2-4ff6-443d-b966-e6913bd24013	51ec7498-7a9e-4e98-bf9e-4e3fcbb723a1
1	1	0	Plazi	ffb07bec-2d10-492d-9c37-361fe0b79427	53f7be60-8915-4efc-93a7-896b2b377820
194	194	0	GBIF Germany	4f6826f2-4ff6-443d-b966-e6913bd24013	541c607a-0cd5-4ed2-bdeb-34142603d5e8
0	8	8	Plazi	ffb07bec-2d10-492d-9c37-361fe0b79427	55f49b20-5777-46e9-a5d3-e1a398f60eff
134201	147712	13511	Belgian Biodiversity Platform	fb11cfe1-ebc3-45af-9159-17d9fddbcdac	59b549c0-7da9-4095-98c1-56da90837723
214	214	0	Participant Node Managers Committee	7f48e0c8-5c96-49ec-b972-30748e339115	5a103514-217f-4c0a-a66c-75913c09dd4e
22	22	0	Plazi	ffb07bec-2d10-492d-9c37-361fe0b79427	5b9e7cde-13c4-4e9c-8cb2-7a4478ca3899
120	120	0	GBIF Germany	4f6826f2-4ff6-443d-b966-e6913bd24013	5c6ff99a-d30b-47af-80b5-7a278d4edb73
13	13	0	National Biodiversity Network	d897a5b9-35ee-4232-94bd-b0bcaac003c2	5d2271cf-2f26-4749-9136-8cb382eedf54
0	471404	471404	U.S. Geological Survey	8618c64a-93e0-4300-b546-7249e5148ed2	5f06e39d-81cf-4606-8891-6db72600231b
460	460	0	Colombian Biodiversity Information System	7e865cba-7c46-417b-ade5-97f2cf5b7be0	5f8c86d2-7a9d-4bb0-a220-27bcae71fce6
660	517	-143	GBIF Germany	4f6826f2-4ff6-443d-b966-e6913bd24013	5f9aece5-d779-4550-b9ee-0b7382321d33
168	168	0	GBIF Germany	4f6826f2-4ff6-443d-b966-e6913bd24013	61148d1a-f762-11e1-a439-00145eb45e9a
31	31	0	GBIF Germany	4f6826f2-4ff6-443d-b966-e6913bd24013	61b6db06-f762-11e1-a439-00145eb45e9a
139	139	0	GBIF Germany	4f6826f2-4ff6-443d-b966-e6913bd24013	62132a6e-f762-11e1-a439-00145eb45e9a
0	1319	1319	Plazi	ffb07bec-2d10-492d-9c37-361fe0b79427	62322993-ca80-4b6c-ac95-861cbb236abd
22371	22371	0	Korean Biodiversity Information Facility	e0a1e772-0177-4800-94b4-2d023fe6cdf4	6258c1c8-b27e-4497-8079-ac084029b81b
11	11	0	GBIF Germany	4f6826f2-4ff6-443d-b966-e6913bd24013	62ee2b50-f762-11e1-a439-00145eb45e9a
1462	1462	0	GBIF Spain	1f94b3ca-9345-4d65-afe2-4bace93aa0fe	6360a554-f762-11e1-a439-00145eb45e9a
1705	1705	0	Biodiversity Information System of Mexico	b324e8e9-9a4c-44fa-8f1a-7f39ea7ab576	637a2be6-5c0d-43c9-915d-618945608b5c
57	57	0	GBIF Germany	4f6826f2-4ff6-443d-b966-e6913bd24013	6463e498-f762-11e1-a439-00145eb45e9a
39	36	-3	GBIF Germany	4f6826f2-4ff6-443d-b966-e6913bd24013	65d60068-f762-11e1-a439-00145eb45e9a
49	49	0	GBIF Germany	4f6826f2-4ff6-443d-b966-e6913bd24013	6728abdc-f762-11e1-a439-00145eb45e9a
7621	7621	0	GBIF Portugal	673f7038-4262-4149-b753-5658a4e912f6	677f03d8-8229-4274-9e6f-9f1078369c0b
82	82	0	GBIF Germany	4f6826f2-4ff6-443d-b966-e6913bd24013	67f3bdae-f762-11e1-a439-00145eb45e9a
68	68	0	Plazi	ffb07bec-2d10-492d-9c37-361fe0b79427	6864c238-7b12-4f62-bc5b-737457a6ccc2
28	28	0	GBIF Germany	4f6826f2-4ff6-443d-b966-e6913bd24013	693caab8-f762-11e1-a439-00145eb45e9a
0	1	1	Ocean Biodiversity Information System	ba0670b9-4186-41e6-8e70-f9cb3065551a	69673979-7aeb-42ba-a3b9-e16b5365a868
10	10	0	GBIF Germany	4f6826f2-4ff6-443d-b966-e6913bd24013	6adde4fe-f762-11e1-a439-00145eb45e9a
227	227	0	GBIF Germany	4f6826f2-4ff6-443d-b966-e6913bd24013	6caafa42-f762-11e1-a439-00145eb45e9a
0	2	2	Plazi	ffb07bec-2d10-492d-9c37-361fe0b79427	6db037e9-f330-4ee4-84b4-773f39477137
118	118	0	GBIF Germany	4f6826f2-4ff6-443d-b966-e6913bd24013	70e88642-f762-11e1-a439-00145eb45e9a
1421	1421	0	GBIF France	da44cd31-5901-4687-a106-6d1c7734ee3a	711f0bf3-36e1-47e2-8dc4-77a168831d42
513	513	0	GBIF Germany	4f6826f2-4ff6-443d-b966-e6913bd24013	7128853a-f762-11e1-a439-00145eb45e9a
24	24	0	GBIF Germany	4f6826f2-4ff6-443d-b966-e6913bd24013	719a38ec-f762-11e1-a439-00145eb45e9a
50	50	0	Plazi	ffb07bec-2d10-492d-9c37-361fe0b79427	71d764da-ecc4-4dd9-979a-a0c31449b412
7	7	0	Plazi	ffb07bec-2d10-492d-9c37-361fe0b79427	733ba0ac-27c8-41ea-8e23-311fcbe1d9e0
51	51	0	GBIF Germany	4f6826f2-4ff6-443d-b966-e6913bd24013	7355fb44-f762-11e1-a439-00145eb45e9a
0	16	16	Plazi	ffb07bec-2d10-492d-9c37-361fe0b79427	741e1ee3-ec1c-4291-904e-9ae7896fd71c
901	901	0	GBIF Germany	4f6826f2-4ff6-443d-b966-e6913bd24013	749815dc-f762-11e1-a439-00145eb45e9a
14	13	-1	GBIF Germany	4f6826f2-4ff6-443d-b966-e6913bd24013	74bd53b0-f762-11e1-a439-00145eb45e9a
107	107	0	GBIF Germany	4f6826f2-4ff6-443d-b966-e6913bd24013	7507a83e-f762-11e1-a439-00145eb45e9a
784	784	0	GBIF Germany	4f6826f2-4ff6-443d-b966-e6913bd24013	752d0ae8-f762-11e1-a439-00145eb45e9a
238	238	0	GBIF Germany	4f6826f2-4ff6-443d-b966-e6913bd24013	75d3b2b2-f762-11e1-a439-00145eb45e9a
2	2	0	Plazi	ffb07bec-2d10-492d-9c37-361fe0b79427	77c67d9b-7a16-4f31-aed9-9c9e2c49a4fa
3221	3221	0	GBIF Malawi	2a42e4d7-ad4a-41b3-84c4-de4aa7b74d35	789e1248-c737-4d6a-bcec-e4b92775becc
711	551	-160	GBIF Germany	4f6826f2-4ff6-443d-b966-e6913bd24013	7989f312-f762-11e1-a439-00145eb45e9a
204	153	-51	GBIF Germany	4f6826f2-4ff6-443d-b966-e6913bd24013	7c1186c2-f762-11e1-a439-00145eb45e9a
2	2	0	Plazi	ffb07bec-2d10-492d-9c37-361fe0b79427	7c716a20-1e6b-4f3c-a523-444963f08d1e
561	561	0	GBIF Germany	4f6826f2-4ff6-443d-b966-e6913bd24013	7c97b2ba-f762-11e1-a439-00145eb45e9a
176	144	-32	GBIF Germany	4f6826f2-4ff6-443d-b966-e6913bd24013	7d20343c-f762-11e1-a439-00145eb45e9a
0	126	126	Belgian Biodiversity Platform	fb11cfe1-ebc3-45af-9159-17d9fddbcdac	7dc4507b-63b7-4579-bd29-c5950018895b
1877	1877	0	Biodiversity Information System of Mexico	b324e8e9-9a4c-44fa-8f1a-7f39ea7ab576	7f99d132-f762-11e1-a439-00145eb45e9a
2288	2288	0	Biodiversity Information System of Mexico	b324e8e9-9a4c-44fa-8f1a-7f39ea7ab576	7fbf4372-f762-11e1-a439-00145eb45e9a
2682	2682	0	Biodiversity Information System of Mexico	b324e8e9-9a4c-44fa-8f1a-7f39ea7ab576	7fc07b3e-f762-11e1-a439-00145eb45e9a
1360	1360	0	Biodiversity Information System of Mexico	b324e8e9-9a4c-44fa-8f1a-7f39ea7ab576	803e8402-f762-11e1-a439-00145eb45e9a
44	44	0	Biodiversity Information System of Mexico	b324e8e9-9a4c-44fa-8f1a-7f39ea7ab576	80980a90-f762-11e1-a439-00145eb45e9a
760	760	0	GBIF Japan	db5705aa-6a6e-42f1-8942-d77b9f4896ea	80eb78e2-f762-11e1-a439-00145eb45e9a
8516	9016	500	GBIF Japan	db5705aa-6a6e-42f1-8942-d77b9f4896ea	80f89432-f762-11e1-a439-00145eb45e9a
5202	5202	0	DanBIF - Danish Biodiversity Information Facility	4ddd294f-02b7-4359-ac33-0806a9ca9c6b	812fae0e-f762-11e1-a439-00145eb45e9a
49146	51813	2667	GBIF Estonia	2c11b821-d22b-4c64-8cd3-c1578173b129	81321482-f762-11e1-a439-00145eb45e9a
0	2	2	Plazi	ffb07bec-2d10-492d-9c37-361fe0b79427	819af5ee-bd5b-4878-9d2f-8355b03d79f4
63028	102442	39414	U.S. Geological Survey	8618c64a-93e0-4300-b546-7249e5148ed2	81e6cff2-b409-417e-8c72-e1bbafb7c61f
120	116	-4	GBIF Germany	4f6826f2-4ff6-443d-b966-e6913bd24013	8221db02-f762-11e1-a439-00145eb45e9a
408	103	-305	GBIF Germany	4f6826f2-4ff6-443d-b966-e6913bd24013	822e8e8f-06cc-4a5a-8e84-1615641aec0b
192	192	0	GBIF Germany	4f6826f2-4ff6-443d-b966-e6913bd24013	825359fc-f762-11e1-a439-00145eb45e9a
3	3	0	Plazi	ffb07bec-2d10-492d-9c37-361fe0b79427	8264af7b-43c7-429e-8d8f-d6e3bdf9d67c
1116	1116	0	GBIF Spain	1f94b3ca-9345-4d65-afe2-4bace93aa0fe	838211b0-f762-11e1-a439-00145eb45e9a
71494	92919	21425	GBIF Japan	db5705aa-6a6e-42f1-8942-d77b9f4896ea	848d312a-f762-11e1-a439-00145eb45e9a
15	15	0	Plazi	ffb07bec-2d10-492d-9c37-361fe0b79427	85d6df30-1328-4918-a149-d9ca8cf77316
399	399	0	GBIF Spain	1f94b3ca-9345-4d65-afe2-4bace93aa0fe	86b8ee8a-f762-11e1-a439-00145eb45e9a
746	543	-203	GBIF Germany	4f6826f2-4ff6-443d-b966-e6913bd24013	8718e7e0-f762-11e1-a439-00145eb45e9a
5	5	0	Plazi	ffb07bec-2d10-492d-9c37-361fe0b79427	8775969f-a46a-45c1-af4e-9cf526f6f9d3
1039	866	-173	GBIF Germany	4f6826f2-4ff6-443d-b966-e6913bd24013	8860080e-f762-11e1-a439-00145eb45e9a
0	3	3	Plazi	ffb07bec-2d10-492d-9c37-361fe0b79427	897f5389-ea77-46a9-8b5a-f390d6591873
80	80	0	GBIF Germany	4f6826f2-4ff6-443d-b966-e6913bd24013	89ce8896-f762-11e1-a439-00145eb45e9a
0	4	4	Plazi	ffb07bec-2d10-492d-9c37-361fe0b79427	8a2bc12c-f5ec-4d85-a1d7-a5f40905551a
1013	1013	0	U.S. Geological Survey	8618c64a-93e0-4300-b546-7249e5148ed2	8a5459ee-3d3a-4e0a-9fb0-0cbbb9e5a6f9
92	92	0	GBIF Germany	4f6826f2-4ff6-443d-b966-e6913bd24013	8a8a704c-f762-11e1-a439-00145eb45e9a
1262	1262	0	National Biodiversity Network	d897a5b9-35ee-4232-94bd-b0bcaac003c2	8b97e0ae-c803-4d24-8098-74874113c344
178	178	0	GBIF Germany	4f6826f2-4ff6-443d-b966-e6913bd24013	8baeb032-f762-11e1-a439-00145eb45e9a
3	3	0	GBIF Germany	4f6826f2-4ff6-443d-b966-e6913bd24013	8c37ebb8-f762-11e1-a439-00145eb45e9a
90	90	0	GBIF Germany	4f6826f2-4ff6-443d-b966-e6913bd24013	8cd47d2a-f762-11e1-a439-00145eb45e9a
544	468	-76	GBIF Germany	4f6826f2-4ff6-443d-b966-e6913bd24013	8cf31e08-7b1b-43cf-ab84-0ee152ad5e58
0	9	9	Plazi	ffb07bec-2d10-492d-9c37-361fe0b79427	8d1526d7-3d77-4ed0-aec8-4fba52d26081
617	617	0	GBIF Germany	4f6826f2-4ff6-443d-b966-e6913bd24013	8e4b8cfc-f762-11e1-a439-00145eb45e9a
1386	840	-546	GBIF Germany	4f6826f2-4ff6-443d-b966-e6913bd24013	8edd59ac-f762-11e1-a439-00145eb45e9a
910	858	-52	GBIF Germany	4f6826f2-4ff6-443d-b966-e6913bd24013	8f0d7cfe-f762-11e1-a439-00145eb45e9a
3	3	0	Plazi	ffb07bec-2d10-492d-9c37-361fe0b79427	8f2c29d6-cb44-49ef-95ad-f17e90af4ffe
3003	3003	0	National Biodiversity Network	d897a5b9-35ee-4232-94bd-b0bcaac003c2	8f3e4aa1-b258-47e8-9e2b-ff8ae6476572
126	112	-14	GBIF Germany	4f6826f2-4ff6-443d-b966-e6913bd24013	8f59c1fe-f762-11e1-a439-00145eb45e9a
112	90	-22	GBIF Germany	4f6826f2-4ff6-443d-b966-e6913bd24013	8fabc2ec-f762-11e1-a439-00145eb45e9a
4	4	0	Plazi	ffb07bec-2d10-492d-9c37-361fe0b79427	8fb93f7a-eb88-4817-a62c-147a164bc92c
7	7	0	Plazi	ffb07bec-2d10-492d-9c37-361fe0b79427	8fbcba87-03b8-4dfe-9740-e1eb784a32b3
23	20	-3	GBIF Germany	4f6826f2-4ff6-443d-b966-e6913bd24013	9020ad00-f762-11e1-a439-00145eb45e9a
15	12	-3	GBIF Germany	4f6826f2-4ff6-443d-b966-e6913bd24013	90febbf4-f762-11e1-a439-00145eb45e9a
329	283	-46	GBIF Germany	4f6826f2-4ff6-443d-b966-e6913bd24013	9151c466-f762-11e1-a439-00145eb45e9a
0	62	62	Plazi	ffb07bec-2d10-492d-9c37-361fe0b79427	91c16ce4-b48a-45e2-8b48-d88ddd2d450b
0	396	396	GBIF France	da44cd31-5901-4687-a106-6d1c7734ee3a	91c9a937-0e2a-4f0b-84e5-058334acdd7c
1018	889	-129	GBIF Germany	4f6826f2-4ff6-443d-b966-e6913bd24013	922f6dfc-f762-11e1-a439-00145eb45e9a
96	96	0	GBIF Germany	4f6826f2-4ff6-443d-b966-e6913bd24013	925f8b68-f762-11e1-a439-00145eb45e9a
972	978	6	GBIF Germany	4f6826f2-4ff6-443d-b966-e6913bd24013	954583d2-f762-11e1-a439-00145eb45e9a
3974	3974	0	DanBIF - Danish Biodiversity Information Facility	4ddd294f-02b7-4359-ac33-0806a9ca9c6b	9648a106-f762-11e1-a439-00145eb45e9a
312	312	0	Atlas of Living Australia	4a6f1b71-969e-4fc5-a693-282b05e1220c	96a14e46-f762-11e1-a439-00145eb45e9a
440	440	0	Biodiversity Information System of Mexico	b324e8e9-9a4c-44fa-8f1a-7f39ea7ab576	96b2e606-f762-11e1-a439-00145eb45e9a
17669	20440	2771	National Biodiversity Network	d897a5b9-35ee-4232-94bd-b0bcaac003c2	97d01261-0027-4e89-a0d2-4a7d700f5fdb
1549	1549	0	Korean Biodiversity Information Facility	e0a1e772-0177-4800-94b4-2d023fe6cdf4	99c9670a-27fc-11e2-85e3-00145eb45e9a
3	3	0	Plazi	ffb07bec-2d10-492d-9c37-361fe0b79427	9ae1ea74-b6cc-4177-ac74-376cff37fea8
2085	2085	0	GBIF France	da44cd31-5901-4687-a106-6d1c7734ee3a	9b72b0f3-f1aa-4eb9-80e0-dac19e8f923b
5	5	0	Plazi	ffb07bec-2d10-492d-9c37-361fe0b79427	9bc49ecc-5057-4e27-b8b2-00708f71b268
18	18	0	Plazi	ffb07bec-2d10-492d-9c37-361fe0b79427	9d413477-2ebc-45ab-a3de-71d5aeec3c7b
2	2	0	Plazi	ffb07bec-2d10-492d-9c37-361fe0b79427	9e100e30-5482-429b-bb8a-1dc29c0e8183
0	2	2	Plazi	ffb07bec-2d10-492d-9c37-361fe0b79427	9efaf9b7-13c1-4b44-b522-aad50204de86
0	26623	26623	U.S. Geological Survey	8618c64a-93e0-4300-b546-7249e5148ed2	9fa0d645-35fe-4a9e-903f-86fdeb11eb56
346	346	0	Participant Node Managers Committee	7f48e0c8-5c96-49ec-b972-30748e339115	a02e4f7e-7450-42a2-8fc3-889672d6832e
0	6	6	Plazi	ffb07bec-2d10-492d-9c37-361fe0b79427	a38a4b0b-b848-4731-9421-4a845dce1e3d
124	124	0	Colombian Biodiversity Information System	7e865cba-7c46-417b-ade5-97f2cf5b7be0	a4cd59ef-679c-4084-a1a5-b07c83176920
19	19	0	Plazi	ffb07bec-2d10-492d-9c37-361fe0b79427	a5d06ccb-4cdc-485c-849b-46dfa8ac159d
42927	42927	0	Colombian Biodiversity Information System	7e865cba-7c46-417b-ade5-97f2cf5b7be0	a6bc8ba7-1489-4724-8e72-fd5d0325a9c4
4	4	0	Plazi	ffb07bec-2d10-492d-9c37-361fe0b79427	a72c2dd3-fde1-4c7f-9908-8bce53b249d6
4779	4779	0	GBIF France	da44cd31-5901-4687-a106-6d1c7734ee3a	a73b0f8a-d5c1-40f6-9151-a60d80a024fd
1008	1008	0	GBIF Norway	4f829580-180d-46a9-9c87-ed8ec959b545	a855a639-cccb-4286-af92-f7567d74a887
0	9	9	Ocean Biodiversity Information System	ba0670b9-4186-41e6-8e70-f9cb3065551a	aac2dff6-2f38-4e6e-b69d-5630088ce6b5
79	79	0	Colombian Biodiversity Information System	7e865cba-7c46-417b-ade5-97f2cf5b7be0	ab3f01ff-2a38-470c-a37e-1339f7598873
12649	12649	0	GBIF Argentina	2426a871-9feb-40a1-96c6-0c593a76b835	ab6daa78-3b69-4be7-9cb6-09d1a439a95e
0	4	4	Plazi	ffb07bec-2d10-492d-9c37-361fe0b79427	add12ea0-aa6f-463a-8e32-cc510220ce68
661	661	0	GBIF Benin	efb9c00e-f802-45dd-8826-a52ec45b89ff	b012565d-699d-412f-9720-f0fb482d9a3f
9299	9299	0	Colombian Biodiversity Information System	7e865cba-7c46-417b-ade5-97f2cf5b7be0	b25cc2e7-36aa-41ff-aa2a-441b12c6d423
973	973	0	Participant Node Managers Committee	7f48e0c8-5c96-49ec-b972-30748e339115	b2d6d198-fad5-492f-a36b-8da2296189bb
253	253	0	GBIF Portugal	673f7038-4262-4149-b753-5658a4e912f6	b38458c6-812f-46ec-bc4e-fdaa6059d23d
0	11	11	Plazi	ffb07bec-2d10-492d-9c37-361fe0b79427	b3fb2585-d858-4d3d-acde-bf5597a58107
0	33	33	Plazi	ffb07bec-2d10-492d-9c37-361fe0b79427	b58a6a37-ab8b-4edb-9391-e14ab1c36da5
5	5	0	Plazi	ffb07bec-2d10-492d-9c37-361fe0b79427	b59ceaea-b2b8-4c81-a78a-083ea9cfe615
2	2	0	Plazi	ffb07bec-2d10-492d-9c37-361fe0b79427	b5cdd86c-c6cd-4ef6-8328-a7628fed2ae9
0	5628	5628	GBIF Ecuador	2dc472f1-c3d9-486d-b3c1-12ca7ba1ed22	b7700738-3e8b-4b9a-a105-3a2109555109
250	250	0	GBIF France	da44cd31-5901-4687-a106-6d1c7734ee3a	b7794db8-a1e3-4b45-8908-653ac72c3b9f
25611	25611	0	Ocean Biodiversity Information System	ba0670b9-4186-41e6-8e70-f9cb3065551a	bb54104f-3883-443b-b4fa-c43c6194d8d6
89	89	0	GBIF Germany	4f6826f2-4ff6-443d-b966-e6913bd24013	bb85653b-1e99-46bd-82ce-3e34c14678bb
0	2	2	Plazi	ffb07bec-2d10-492d-9c37-361fe0b79427	bb9fed3d-8c07-41d8-947a-06926ac852a5
0	169	169	GBIF Argentina	2426a871-9feb-40a1-96c6-0c593a76b835	bd1bb1a3-9715-45ff-b8f1-04fac4f11d0c
138	138	0	Participant Node Managers Committee	7f48e0c8-5c96-49ec-b972-30748e339115	bd2ab2c9-1a1d-49aa-97e6-0629d8c74d9b
454	454	0	GBIF Argentina	2426a871-9feb-40a1-96c6-0c593a76b835	bf750dad-8c2c-4988-9f89-dc113d51c434
45310	93641	48331	BioCASE	d8bbf693-a180-4995-94fe-6130795dcf2f	bf97ab5c-c909-4d0b-ae3c-7d34775770f9
48397	48397	0	U.S. Geological Survey	8618c64a-93e0-4300-b546-7249e5148ed2	c081d6d4-cb80-45b3-b9cd-dab5568b8c5e
0	78	78	GBIF Japan	db5705aa-6a6e-42f1-8942-d77b9f4896ea	c0ef22c2-416c-4b88-b855-90493db00735
37	37	0	Plazi	ffb07bec-2d10-492d-9c37-361fe0b79427	c167b7f0-f7c7-4d89-96b4-5ce35b9507f3
0	3	3	Plazi	ffb07bec-2d10-492d-9c37-361fe0b79427	c2bc6e34-0d58-4c44-8867-9a4be5b2e403
4	4	0	Plazi	ffb07bec-2d10-492d-9c37-361fe0b79427	c3fec010-6e0c-41e3-aece-3c6caccc951a
9	9	0	Plazi	ffb07bec-2d10-492d-9c37-361fe0b79427	c5e3ce0c-4b99-4eef-a3b7-28fd57ac1472
33	33	0	Plazi	ffb07bec-2d10-492d-9c37-361fe0b79427	c700f790-3418-4f26-bccc-cf001dd38057
268	268	0	GBIF Germany	4f6826f2-4ff6-443d-b966-e6913bd24013	c8844a63-c0cb-4ceb-b91a-b5f3fbfabaf5
26	26	0	Ocean Biodiversity Information System	ba0670b9-4186-41e6-8e70-f9cb3065551a	c8bdb21e-82e4-4959-a17a-b416ac465403
138	138	0	GBIF France	da44cd31-5901-4687-a106-6d1c7734ee3a	c9f87043-5994-48c6-8b3e-f472292e4106
36	36	0	Plazi	ffb07bec-2d10-492d-9c37-361fe0b79427	ce6f1bf6-5cf5-4cad-9f75-759930ba4a09
2175	2175	0	National Biodiversity Network	d897a5b9-35ee-4232-94bd-b0bcaac003c2	cf49d39e-6e04-4cc8-8e74-98345b04641d
29	29	0	Plazi	ffb07bec-2d10-492d-9c37-361fe0b79427	cf61aa1d-1850-496a-92d4-2e5e5362ca24
4814	4814	0	GBIF France	da44cd31-5901-4687-a106-6d1c7734ee3a	d1a42105-df9a-49fb-808b-99f0b5cc49b5
2	2	0	Plazi	ffb07bec-2d10-492d-9c37-361fe0b79427	d366d4d7-624a-45e0-8153-48501605164e
735	735	0	GBIF Germany	4f6826f2-4ff6-443d-b966-e6913bd24013	d42c9308-f077-40bd-bb0f-605fcdc14a06
587	587	0	Colombian Biodiversity Information System	7e865cba-7c46-417b-ade5-97f2cf5b7be0	d60abc0b-d936-40eb-a696-d54b9499e493
8	8	0	Plazi	ffb07bec-2d10-492d-9c37-361fe0b79427	d7cfa6d1-c646-45a8-bc03-30cf772c68a1
14	14	0	Plazi	ffb07bec-2d10-492d-9c37-361fe0b79427	d8c8eaa7-a282-4d37-8285-8f6a19f6970f
8	8	0	Plazi	ffb07bec-2d10-492d-9c37-361fe0b79427	d9133d62-096e-4ec1-873a-4a3af73c050c
157	157	0	GBIF France	da44cd31-5901-4687-a106-6d1c7734ee3a	dd9f0c81-b7c6-449a-a6a6-5649dd982010
26	26	0	Plazi	ffb07bec-2d10-492d-9c37-361fe0b79427	e26a36b7-3f90-4336-8313-a4155a50cdb0
21097	21097	0	Ocean Biodiversity Information System	ba0670b9-4186-41e6-8e70-f9cb3065551a	e3803a54-b4fd-46d7-ab67-ad8f6871fae5
5430	5430	0	GBIF France	da44cd31-5901-4687-a106-6d1c7734ee3a	e44ff4bb-9f72-43d6-b66d-66d00c969380
0	164	164	Ocean Biodiversity Information System	ba0670b9-4186-41e6-8e70-f9cb3065551a	e4b77eb9-cb6a-4da1-b1a0-5eea642f4d1a
3	3	0	Plazi	ffb07bec-2d10-492d-9c37-361fe0b79427	e5064ebd-a986-469a-8c21-ab54067e3163
122	122	0	Ocean Biodiversity Information System	ba0670b9-4186-41e6-8e70-f9cb3065551a	e6a7eff1-f9fa-444e-b3f5-d6f3c4bfe1b2
4	4	0	Plazi	ffb07bec-2d10-492d-9c37-361fe0b79427	e7633da7-6018-4595-a3ba-f81dc2a256e0
0	150	150	Plazi	ffb07bec-2d10-492d-9c37-361fe0b79427	e98cc372-5374-45f3-b965-c57d9a916566
4	4	0	Plazi	ffb07bec-2d10-492d-9c37-361fe0b79427	ea32acea-eb9a-45e7-b495-d0179705239a
1757	1757	0	National Biodiversity Network	d897a5b9-35ee-4232-94bd-b0bcaac003c2	eca31136-2ea8-4849-8d7f-fc0676b0cde3
55	55	0	Plazi	ffb07bec-2d10-492d-9c37-361fe0b79427	eddea689-dc54-4802-a738-abcb61384604
0	29	29	Plazi	ffb07bec-2d10-492d-9c37-361fe0b79427	f0b863fc-27c6-494b-b642-d065c84b93b9
5	5	0	Plazi	ffb07bec-2d10-492d-9c37-361fe0b79427	f144db47-5259-4ca2-923e-f9ddaacddede
6475	6490	15	U.S. Geological Survey	8618c64a-93e0-4300-b546-7249e5148ed2	f36b26ac-97d1-40f6-a9a0-484defff98e7
4959	4959	0	GBIF Spain	1f94b3ca-9345-4d65-afe2-4bace93aa0fe	f56b1d14-e092-4704-9c77-091f317dc94d
0	122	122	Colombian Biodiversity Information System	7e865cba-7c46-417b-ade5-97f2cf5b7be0	f8094518-4379-4f98-9660-0981b7bd6b37
1798	1798	0	Korean Biodiversity Information Facility	e0a1e772-0177-4800-94b4-2d023fe6cdf4	fa32bb48-b68e-49e3-a9ef-460444fef979
0	88	88	Plazi	ffb07bec-2d10-492d-9c37-361fe0b79427	fb563f76-250f-45f2-ae03-4d7605ad7e33
6	6	0	Plazi	ffb07bec-2d10-492d-9c37-361fe0b79427	fc6835d1-94b5-4ca4-8408-4ea90e41f228
328	328	0	Biodiversity Information System of Mexico	b324e8e9-9a4c-44fa-8f1a-7f39ea7ab576	ff05d6c3-4a9d-47bf-8aab-56834d875781
36533	36533	0	GBIF France	da44cd31-5901-4687-a106-6d1c7734ee3a	ffac22e7-fa1f-457f-a14a-a80ba967f4e1
627	627	0	GBIF France	da44cd31-5901-4687-a106-6d1c7734ee3a	034d5d78-2cb7-45e9-9a32-81aed087920a
2627	2627	0	GBIF France	da44cd31-5901-4687-a106-6d1c7734ee3a	06ca0401-92c5-43f2-9ef0-236f13bc6a79
0	7996	7996	Colombian Biodiversity Information System	7e865cba-7c46-417b-ade5-97f2cf5b7be0	0760929c-5516-4bbb-a3d2-b8817770a93b
0	301	301	Ocean Biodiversity Information System	ba0670b9-4186-41e6-8e70-f9cb3065551a	0a695fea-fcb3-4dd5-b22d-9f7ebede2afd
2	2	0	Plazi	ffb07bec-2d10-492d-9c37-361fe0b79427	0b3955c1-560e-4b28-8c67-f64f4aa4ca36
15	15	0	Participant Node Managers Committee	7f48e0c8-5c96-49ec-b972-30748e339115	0e89d2d8-4bc6-4d25-b281-d97ac13a031a
5	5	0	Plazi	ffb07bec-2d10-492d-9c37-361fe0b79427	0f860d14-6b09-48af-8cdf-b2b92b65cbe3
44	44	0	Participant Node Managers Committee	7f48e0c8-5c96-49ec-b972-30748e339115	13449d6d-ddfa-4f6c-92d8-a643b978ce49
73	73	0	GBIF Germany	4f6826f2-4ff6-443d-b966-e6913bd24013	1423cffa-3313-45b7-bc95-8664aabe3900
107	107	0	GBIF France	da44cd31-5901-4687-a106-6d1c7734ee3a	143db665-eb40-4838-acb5-5e05fd332aba
0	8	8	Plazi	ffb07bec-2d10-492d-9c37-361fe0b79427	150a4a05-d154-47f3-b03d-b7b358ab5320
1	1	0	Plazi	ffb07bec-2d10-492d-9c37-361fe0b79427	165e3b68-777e-46c9-a3b1-2b3fe2d3f102
6	6	0	Plazi	ffb07bec-2d10-492d-9c37-361fe0b79427	17d34f0a-b85d-4141-baf6-c4fe85ecfd83
12	12	0	Plazi	ffb07bec-2d10-492d-9c37-361fe0b79427	1abe0f03-7e7f-41a7-9621-2d74bfdf0568
3	3	0	Plazi	ffb07bec-2d10-492d-9c37-361fe0b79427	1dcede12-d692-4ea3-bc9a-adcb17ec6f63
0	29	29	Plazi	ffb07bec-2d10-492d-9c37-361fe0b79427	20436c9c-2b03-46c4-b53c-b14cc674f8e3
17	17	0	Plazi	ffb07bec-2d10-492d-9c37-361fe0b79427	28bfc40d-d8d5-4a85-941f-d6dca17ec213
175	175	0	Plazi	ffb07bec-2d10-492d-9c37-361fe0b79427	2a01bfb5-6e33-42b5-ab5d-4f8512c9128f
280	278	-2	GBIF Germany	4f6826f2-4ff6-443d-b966-e6913bd24013	2aaa6ece-2bd6-432a-80aa-f5f00308e9ee
1	1	0	Plazi	ffb07bec-2d10-492d-9c37-361fe0b79427	2ca1772e-6b15-4266-9a84-ac7b10ce8938
24	24	0	Biodiversity Information System of Mexico	b324e8e9-9a4c-44fa-8f1a-7f39ea7ab576	2d21ceb2-e459-4025-a62f-6b65c494de47
3	3	0	Plazi	ffb07bec-2d10-492d-9c37-361fe0b79427	2ef1559b-d9f5-41c2-a07e-aa76a61fc983
16	16	0	Participant Node Managers Committee	7f48e0c8-5c96-49ec-b972-30748e339115	31e723a0-57a9-416f-a704-5f9ad27fd5b6
32	32	0	Plazi	ffb07bec-2d10-492d-9c37-361fe0b79427	3251efdb-f216-4473-bab3-3291db4da615
0	2	2	Plazi	ffb07bec-2d10-492d-9c37-361fe0b79427	327074ac-0102-495e-92f7-d89c9441ef2b
0	10	10	Plazi	ffb07bec-2d10-492d-9c37-361fe0b79427	32aba51d-7618-467b-9ffe-7f430d20bc7f
1	1	0	Plazi	ffb07bec-2d10-492d-9c37-361fe0b79427	34d0e200-4afa-42f8-b920-1ae5debbc1bf
0	1	1	Plazi	ffb07bec-2d10-492d-9c37-361fe0b79427	34f64fbc-1d32-4a6f-9dc6-86ea4a7e5990
175	175	0	Plazi	ffb07bec-2d10-492d-9c37-361fe0b79427	386a0d21-1155-4a5e-b3a0-bbf1369f64af
0	2	2	Plazi	ffb07bec-2d10-492d-9c37-361fe0b79427	3a4a468d-2333-40c1-987a-ab7c5064c724
0	25	25	Plazi	ffb07bec-2d10-492d-9c37-361fe0b79427	3e4c36ed-130a-49c1-bc51-1ae22bd74943
0	5303	5303	Belgian Biodiversity Platform	fb11cfe1-ebc3-45af-9159-17d9fddbcdac	403ac8e4-dfaa-4bcd-ab2e-f30f4632b12d
7787	7784	-3	National Biodiversity Network	d897a5b9-35ee-4232-94bd-b0bcaac003c2	4273f8ff-73c6-4791-89dc-b64f47b7416a
0	500	500	Participant Node Managers Committee	7f48e0c8-5c96-49ec-b972-30748e339115	430b76a7-2774-491c-94ce-61dde530f6a6
0	115	115	Plazi	ffb07bec-2d10-492d-9c37-361fe0b79427	4aa2e26d-4581-4d6a-ac67-346c45369a48
3	3	0	Plazi	ffb07bec-2d10-492d-9c37-361fe0b79427	4adb82b9-68d9-46c2-bb04-13bc38faa0be
20	20	0	Plazi	ffb07bec-2d10-492d-9c37-361fe0b79427	4afb9953-2445-42e2-97c4-566dee230136
3	3	0	Plazi	ffb07bec-2d10-492d-9c37-361fe0b79427	4c0ed5ec-cd9f-4780-a8b7-e613506135b3
6	6	0	Plazi	ffb07bec-2d10-492d-9c37-361fe0b79427	4c4abb21-6202-432a-a2f3-1d77c4bd8cd8
7	7	0	Plazi	ffb07bec-2d10-492d-9c37-361fe0b79427	4c9b341f-ea31-4d24-b845-e9b0a8d82439
0	9	9	Plazi	ffb07bec-2d10-492d-9c37-361fe0b79427	4f6b986e-3eeb-4457-953b-ff29a87048d5
0	4	4	Plazi	ffb07bec-2d10-492d-9c37-361fe0b79427	4f9d79d6-bbfc-4091-ab93-94c0adf65fa5
636	636	0	GBIF Madagascar	2dbfc5c5-51b5-4494-9dfc-4d3f013a3b64	54661f8e-3d4e-41cb-b8c1-ac9298f020d3
5	5	0	Plazi	ffb07bec-2d10-492d-9c37-361fe0b79427	564eeb98-e1de-4aac-b88d-642aeb6747c9
92	92	0	Atlas of Living Australia	4a6f1b71-969e-4fc5-a693-282b05e1220c	58f732a6-b36e-4d86-bb67-22fe034ba196
2	2	0	Plazi	ffb07bec-2d10-492d-9c37-361fe0b79427	59be1e21-830e-4ab7-b010-282783f7d04b
845	845	0	GBIF Malawi	2a42e4d7-ad4a-41b3-84c4-de4aa7b74d35	5b7e2ecf-162e-4458-a92c-04d706ace8e9
2256	2256	0	Ocean Biodiversity Information System	ba0670b9-4186-41e6-8e70-f9cb3065551a	606a9bcd-3896-4ff2-9c46-ed24fea6777a
72	72	0	GBIF Germany	4f6826f2-4ff6-443d-b966-e6913bd24013	61319a68-f762-11e1-a439-00145eb45e9a
28	28	0	GBIF Germany	4f6826f2-4ff6-443d-b966-e6913bd24013	6167e564-f762-11e1-a439-00145eb45e9a
7	7	0	Plazi	ffb07bec-2d10-492d-9c37-361fe0b79427	622759a0-ecc7-4ec8-ac1e-742f8092d165
1	1	0	Plazi	ffb07bec-2d10-492d-9c37-361fe0b79427	62783a68-e561-4d7a-838d-4d3f5324e3a9
56	56	0	GBIF Germany	4f6826f2-4ff6-443d-b966-e6913bd24013	62cbe734-f762-11e1-a439-00145eb45e9a
107	107	0	GBIF Germany	4f6826f2-4ff6-443d-b966-e6913bd24013	63767ffa-f762-11e1-a439-00145eb45e9a
102	102	0	GBIF Germany	4f6826f2-4ff6-443d-b966-e6913bd24013	63cea61c-f762-11e1-a439-00145eb45e9a
101	101	0	GBIF Germany	4f6826f2-4ff6-443d-b966-e6913bd24013	6429f56c-f762-11e1-a439-00145eb45e9a
53	53	0	Plazi	ffb07bec-2d10-492d-9c37-361fe0b79427	65575e2a-b926-423a-a565-82d041ddf1f9
376	376	0	GBIF Germany	4f6826f2-4ff6-443d-b966-e6913bd24013	65593dd0-f762-11e1-a439-00145eb45e9a
79	79	0	GBIF Germany	4f6826f2-4ff6-443d-b966-e6913bd24013	659995ba-f762-11e1-a439-00145eb45e9a
184	179	-5	GBIF Germany	4f6826f2-4ff6-443d-b966-e6913bd24013	65e1b200-f762-11e1-a439-00145eb45e9a
4	4	0	Plazi	ffb07bec-2d10-492d-9c37-361fe0b79427	66272dcd-1efe-47d6-b4e1-daae53293aab
0	3	3	Plazi	ffb07bec-2d10-492d-9c37-361fe0b79427	6677b4e9-a47f-405d-8d1f-579c4996cba5
253	253	0	National Biodiversity Data Centre	422b00b2-6c94-4bb6-976b-c359916efdb8	6696b965-db95-4369-ae4b-9001bc295bd8
85	85	0	GBIF Germany	4f6826f2-4ff6-443d-b966-e6913bd24013	66ce327e-f762-11e1-a439-00145eb45e9a
46	46	0	GBIF Germany	4f6826f2-4ff6-443d-b966-e6913bd24013	67c0f9a0-f762-11e1-a439-00145eb45e9a
35	35	0	GBIF Germany	4f6826f2-4ff6-443d-b966-e6913bd24013	67cd736a-f762-11e1-a439-00145eb45e9a
33	33	0	GBIF Germany	4f6826f2-4ff6-443d-b966-e6913bd24013	687eb742-f762-11e1-a439-00145eb45e9a
130	130	0	Plazi	ffb07bec-2d10-492d-9c37-361fe0b79427	6897769f-4a7a-4aa7-b149-8c5b2ccefd16
106	64	-42	GBIF Germany	4f6826f2-4ff6-443d-b966-e6913bd24013	68d4d6cc-f762-11e1-a439-00145eb45e9a
7	7	0	Plazi	ffb07bec-2d10-492d-9c37-361fe0b79427	69a31ee1-99ed-4c8a-8016-e7a4686e29d4
8	8	0	Biodiversity Information System of Mexico	b324e8e9-9a4c-44fa-8f1a-7f39ea7ab576	6af169fe-229d-424a-b3ed-c2e91659ed4d
26718	26718	0	GBIF Argentina	2426a871-9feb-40a1-96c6-0c593a76b835	6ba93ace-e2cf-471b-8c62-532d83dddebb
4	4	0	Plazi	ffb07bec-2d10-492d-9c37-361fe0b79427	6bb9b782-a871-4132-bd36-21e4f0638019
12100	12100	0	National Biodiversity Network	d897a5b9-35ee-4232-94bd-b0bcaac003c2	6bc71dac-2d01-43ec-a424-8182f5e30493
51	51	0	GBIF Finland	dd514216-5c7c-45f3-910d-797424cb5be6	6bc7c67e-11b6-4980-8c7b-ba5e1d45c1dd
27	27	0	GBIF Germany	4f6826f2-4ff6-443d-b966-e6913bd24013	6bedb45a-f762-11e1-a439-00145eb45e9a
35	35	0	GBIF Germany	4f6826f2-4ff6-443d-b966-e6913bd24013	6c84dc72-f762-11e1-a439-00145eb45e9a
52	52	0	GBIF Germany	4f6826f2-4ff6-443d-b966-e6913bd24013	6cc019ae-f762-11e1-a439-00145eb45e9a
44	44	0	GBIF Germany	4f6826f2-4ff6-443d-b966-e6913bd24013	6cea6006-f762-11e1-a439-00145eb45e9a
0	11	11	Ocean Biodiversity Information System	ba0670b9-4186-41e6-8e70-f9cb3065551a	6d1ffd3b-49d9-442c-8035-8da0766599c3
95	95	0	GBIF Germany	4f6826f2-4ff6-443d-b966-e6913bd24013	6d5fb25c-f762-11e1-a439-00145eb45e9a
0	274	274	GBIF Benin	efb9c00e-f802-45dd-8826-a52ec45b89ff	6e1ace05-aafb-4652-8d3c-333939b69664
3	3	0	U.S. Geological Survey	8618c64a-93e0-4300-b546-7249e5148ed2	70ffd6db-ec96-47d9-a580-1dde2b16be6f
2208	2208	0	National Biodiversity Network	d897a5b9-35ee-4232-94bd-b0bcaac003c2	72937e85-1432-44a5-87e4-db5a1e60e17d
6747	11527	4780	U.S. Geological Survey	8618c64a-93e0-4300-b546-7249e5148ed2	72c42d42-030c-4b13-8815-281d3df11429
0	15	15	Plazi	ffb07bec-2d10-492d-9c37-361fe0b79427	7305967d-2045-4662-bee1-46c24d776b7f
10	10	0	GBIF Germany	4f6826f2-4ff6-443d-b966-e6913bd24013	7383e464-f762-11e1-a439-00145eb45e9a
0	7	7	Plazi	ffb07bec-2d10-492d-9c37-361fe0b79427	739bf2f8-6018-4fd6-a873-9211f6c1df8b
1373	1373	0	GBIF Japan	db5705aa-6a6e-42f1-8942-d77b9f4896ea	73c0bec5-417f-4d9c-8084-e80b027a1d61
17041	17041	0	GBIF France	da44cd31-5901-4687-a106-6d1c7734ee3a	743071a4-0900-4f6a-8571-28ff62a1d9fa
206	206	0	GBIF Germany	4f6826f2-4ff6-443d-b966-e6913bd24013	75d792f6-f762-11e1-a439-00145eb45e9a
322	322	0	GBIF Germany	4f6826f2-4ff6-443d-b966-e6913bd24013	774c72e6-f762-11e1-a439-00145eb45e9a
0	2	2	Plazi	ffb07bec-2d10-492d-9c37-361fe0b79427	77b84e13-be60-49ef-96e6-cd5dabb5669f
500	500	0	Korean Biodiversity Information Facility	e0a1e772-0177-4800-94b4-2d023fe6cdf4	7af3908c-f762-11e1-a439-00145eb45e9a
850	850	0	GBIF Germany	4f6826f2-4ff6-443d-b966-e6913bd24013	7bf672c4-f762-11e1-a439-00145eb45e9a
720	480	-240	GBIF Germany	4f6826f2-4ff6-443d-b966-e6913bd24013	7c37f096-f762-11e1-a439-00145eb45e9a
535	273	-262	GBIF Germany	4f6826f2-4ff6-443d-b966-e6913bd24013	7c86987c-f762-11e1-a439-00145eb45e9a
310	310	0	GBIF Germany	4f6826f2-4ff6-443d-b966-e6913bd24013	7ccb3c2a-f762-11e1-a439-00145eb45e9a
92	92	0	Participant Node Managers Committee	7f48e0c8-5c96-49ec-b972-30748e339115	7eee6e2c-571c-41f4-8920-9a39d46ff142
2572	2572	0	Biodiversity Information System of Mexico	b324e8e9-9a4c-44fa-8f1a-7f39ea7ab576	80717510-f762-11e1-a439-00145eb45e9a
5276	5276	0	Biodiversity Information System of Mexico	b324e8e9-9a4c-44fa-8f1a-7f39ea7ab576	80791f5e-f762-11e1-a439-00145eb45e9a
324	324	0	GBIF Germany	4f6826f2-4ff6-443d-b966-e6913bd24013	81e9cadc-f762-11e1-a439-00145eb45e9a
833	833	0	GBIF Germany	4f6826f2-4ff6-443d-b966-e6913bd24013	81fd1cfe-f762-11e1-a439-00145eb45e9a
603	603	0	GBIF Germany	4f6826f2-4ff6-443d-b966-e6913bd24013	856cdf96-f762-11e1-a439-00145eb45e9a
6644	6644	0	GBIF Spain	1f94b3ca-9345-4d65-afe2-4bace93aa0fe	85fc0ce8-f762-11e1-a439-00145eb45e9a
18656	18656	0	GBIF Brazil	cdc9736d-5ff7-4ece-9959-3c744360cdb3	86afafd2-f762-11e1-a439-00145eb45e9a
1407	1163	-244	GBIF Germany	4f6826f2-4ff6-443d-b966-e6913bd24013	86eb6248-f762-11e1-a439-00145eb45e9a
819	610	-209	GBIF Germany	4f6826f2-4ff6-443d-b966-e6913bd24013	871781d4-f762-11e1-a439-00145eb45e9a
645	645	0	Participant Node Managers Committee	7f48e0c8-5c96-49ec-b972-30748e339115	8934ff78-0c43-4ca1-b617-e5e9aeb19e68
51065	51065	0	Ocean Biodiversity Information System	ba0670b9-4186-41e6-8e70-f9cb3065551a	899c4252-f6d0-4b85-a966-ac40d86c06af
125	125	0	GBIF Germany	4f6826f2-4ff6-443d-b966-e6913bd24013	89ab60e6-f762-11e1-a439-00145eb45e9a
310	310	0	GBIF Germany	4f6826f2-4ff6-443d-b966-e6913bd24013	89bf900c-f762-11e1-a439-00145eb45e9a
2984	2984	0	National Biodiversity Network	d897a5b9-35ee-4232-94bd-b0bcaac003c2	89fc85d7-1d30-4998-8dda-8033cb7d751c
100	100	0	GBIF France	da44cd31-5901-4687-a106-6d1c7734ee3a	8a1c2143-5df5-473f-9258-8a1ca0de6c1d
157	157	0	GBIF Germany	4f6826f2-4ff6-443d-b966-e6913bd24013	8a6ed350-f762-11e1-a439-00145eb45e9a
333	333	0	GBIF Germany	4f6826f2-4ff6-443d-b966-e6913bd24013	8a823b8e-f762-11e1-a439-00145eb45e9a
1015	1015	0	Colombian Biodiversity Information System	7e865cba-7c46-417b-ade5-97f2cf5b7be0	8b85c5ec-1262-4adf-86a2-b4921d277948
0	15	15	Plazi	ffb07bec-2d10-492d-9c37-361fe0b79427	8bc26961-9853-4113-a63d-4cf691aa7100
88961	91845	2884	Atlas of Living Australia	4a6f1b71-969e-4fc5-a693-282b05e1220c	8bc47548-aaed-4ad6-96d0-85c97955a81e
24	24	0	GBIF Germany	4f6826f2-4ff6-443d-b966-e6913bd24013	8bd539a0-f762-11e1-a439-00145eb45e9a
266	266	0	GBIF Germany	4f6826f2-4ff6-443d-b966-e6913bd24013	8bea4fc0-f762-11e1-a439-00145eb45e9a
666	666	0	GBIF New Zealand	4f9fd726-20dd-445e-89a1-8ed93792276f	8cd0f2da-8ffd-47d1-8920-8557a3658e4d
8	8	0	Participant Node Managers Committee	7f48e0c8-5c96-49ec-b972-30748e339115	8d5234fa-d3ed-4ae9-a16d-b34eab35a909
8	8	0	GBIF Brazil	cdc9736d-5ff7-4ece-9959-3c744360cdb3	8dc279ac-38a5-4ae2-bdc2-d759a8b15203
842	842	0	GBIF Germany	4f6826f2-4ff6-443d-b966-e6913bd24013	8f1a7a76-f762-11e1-a439-00145eb45e9a
356	356	0	GBIF France	da44cd31-5901-4687-a106-6d1c7734ee3a	8ff4eeb5-5933-49ec-bdc0-9debd68c5944
28	28	0	Plazi	ffb07bec-2d10-492d-9c37-361fe0b79427	900529a8-34be-4134-88d1-20143ee9ef14
75573	75573	0	Canada Biodiversity Information Facility	8f83fc96-c966-4126-83f7-bf044dc49efa	90302970-1bc6-4865-be76-9aef1dd707f9
580	493	-87	GBIF Germany	4f6826f2-4ff6-443d-b966-e6913bd24013	915c4954-f762-11e1-a439-00145eb45e9a
23	23	0	GBIF Germany	4f6826f2-4ff6-443d-b966-e6913bd24013	915d88dc-f762-11e1-a439-00145eb45e9a
36	36	0	GBIF Germany	4f6826f2-4ff6-443d-b966-e6913bd24013	9287ef54-f762-11e1-a439-00145eb45e9a
930	930	0	GBIF Germany	4f6826f2-4ff6-443d-b966-e6913bd24013	929d0466-f762-11e1-a439-00145eb45e9a
8637	8637	0	GBIF Germany	4f6826f2-4ff6-443d-b966-e6913bd24013	9450a5ba-f762-11e1-a439-00145eb45e9a
982	982	0	GBIF France	da44cd31-5901-4687-a106-6d1c7734ee3a	94e56037-058c-4ffc-a7db-5b11d2fcaa73
65	65	0	GBIF Germany	4f6826f2-4ff6-443d-b966-e6913bd24013	95661eb2-f762-11e1-a439-00145eb45e9a
11	10	-1	GBIF Germany	4f6826f2-4ff6-443d-b966-e6913bd24013	95704432-f762-11e1-a439-00145eb45e9a
129	129	0	Atlas of Living Australia	4a6f1b71-969e-4fc5-a693-282b05e1220c	95e3d104-f762-11e1-a439-00145eb45e9a
36779	39882	3103	GBIF Germany	4f6826f2-4ff6-443d-b966-e6913bd24013	966c9070-f762-11e1-a439-00145eb45e9a
1	1	0	Plazi	ffb07bec-2d10-492d-9c37-361fe0b79427	97b45cd3-b0b6-44ca-8c76-a7c81bf4b555
27	27	0	GBIF Germany	4f6826f2-4ff6-443d-b966-e6913bd24013	97cc8d62-f762-11e1-a439-00145eb45e9a
0	19	19	Ocean Biodiversity Information System	ba0670b9-4186-41e6-8e70-f9cb3065551a	981f9634-9895-486e-8886-68ae41420920
2623	2623	0	Participant Node Managers Committee	7f48e0c8-5c96-49ec-b972-30748e339115	9938a2fd-d07f-45c9-8dc3-f5b88258410d
5625	5625	0	GBIF Benin	efb9c00e-f802-45dd-8826-a52ec45b89ff	9b039d75-b613-40bd-9368-182f124be97c
0	1	1	Plazi	ffb07bec-2d10-492d-9c37-361fe0b79427	9c9de6b1-d7bb-44a4-8ba5-83b44ac2838a
0	18	18	Plazi	ffb07bec-2d10-492d-9c37-361fe0b79427	9ecf4292-270f-4343-aeaa-04bc7b75de2b
13	13	0	Plazi	ffb07bec-2d10-492d-9c37-361fe0b79427	a2bf715a-07c1-4693-adbb-f8f85b8d8faa
9	9	0	Participant Node Managers Committee	7f48e0c8-5c96-49ec-b972-30748e339115	a6316c3b-6635-4404-aa6f-f300ebd70212
205	205	0	U.S. Geological Survey	8618c64a-93e0-4300-b546-7249e5148ed2	a6f18fb4-6bc1-4251-a4cb-53ac96ac8cb3
3	3	0	Plazi	ffb07bec-2d10-492d-9c37-361fe0b79427	ab3de899-d2fc-44d3-9b65-d10a34847a59
0	4	4	Plazi	ffb07bec-2d10-492d-9c37-361fe0b79427	ac457674-79d3-469a-a5b1-df7ff74b35a9
0	54	54	Plazi	ffb07bec-2d10-492d-9c37-361fe0b79427	ac9744b2-e909-47c4-aa49-32a2c6ec545b
4	4	0	Plazi	ffb07bec-2d10-492d-9c37-361fe0b79427	ae830ee1-1095-40a7-8384-95d7039acaa4
0	49649	49649	Korean Biodiversity Information Facility	e0a1e772-0177-4800-94b4-2d023fe6cdf4	ae905ddd-21f1-47f5-b835-28b01a2e36db
2	2	0	Plazi	ffb07bec-2d10-492d-9c37-361fe0b79427	b0542c47-7cd4-4c2f-928d-8646243f1864
0	23	23	Plazi	ffb07bec-2d10-492d-9c37-361fe0b79427	b11f3666-84d9-425d-a746-f842bafef483
5	5	0	Plazi	ffb07bec-2d10-492d-9c37-361fe0b79427	b61823f1-58a8-4e7b-a3e8-0c37de8923e7
2489	2489	0	South African Biodiversity Information Facility	7190b835-4e86-4b6e-85c1-19cc6677c250	b79aa9e2-e14b-40df-98d6-10b98a618064
6	6	0	Plazi	ffb07bec-2d10-492d-9c37-361fe0b79427	be130475-bfb1-47fc-9790-98596a726b24
3	3	0	Plazi	ffb07bec-2d10-492d-9c37-361fe0b79427	bf3d42d8-90fd-4058-b313-145624247f0e
0	711376	711376	GBIF Switzerland	169eb292-376b-4cc6-8e31-9c2c432de0ad	c0633ec5-19cd-4a58-b84c-ca55c2e7ae64
3460	3460	0	GBIF Chile	a8b16421-d80b-4ef3-8f22-098b01a89255	c2d8bc68-8f4d-465e-80b2-734a4bb9d806
3	3	0	Plazi	ffb07bec-2d10-492d-9c37-361fe0b79427	c48fb3ab-be75-4eea-b4c5-73f0870aba5f
41201	41201	0	GBIF Norway	4f829580-180d-46a9-9c87-ed8ec959b545	c5fe763f-6851-4610-bdc3-67143540be67
32	32	0	Plazi	ffb07bec-2d10-492d-9c37-361fe0b79427	c6313e17-b1c7-4c70-81c7-00e6e76b8da5
0	233	233	Colombian Biodiversity Information System	7e865cba-7c46-417b-ade5-97f2cf5b7be0	cb2ac52e-c0ae-449c-9714-d254db468139
0	754	754	Ocean Biodiversity Information System	ba0670b9-4186-41e6-8e70-f9cb3065551a	ccb2ed5f-798e-40fe-8017-95105e59c2f9
11	11	0	GBIF France	da44cd31-5901-4687-a106-6d1c7734ee3a	cd28d50e-d548-43c2-91fe-d719fb2dae78
0	58	58	Plazi	ffb07bec-2d10-492d-9c37-361fe0b79427	cf3704b3-0dab-4850-a334-0e327c311ba5
1696	1696	0	Plazi	ffb07bec-2d10-492d-9c37-361fe0b79427	cf486ccc-d298-4179-8ccf-e29a9c894ab4
445	445	0	Plazi	ffb07bec-2d10-492d-9c37-361fe0b79427	d797f61c-5c5c-40ab-9cdd-c0665e16dbb6
0	20	20	Plazi	ffb07bec-2d10-492d-9c37-361fe0b79427	d7b7d634-c4a3-4e4d-b919-a502df02112f
0	5	5	Plazi	ffb07bec-2d10-492d-9c37-361fe0b79427	d97954ef-b4c9-4e24-9356-a7afb4c80c63
2115	2115	0	GBIF Germany	4f6826f2-4ff6-443d-b966-e6913bd24013	dda53a61-c0cf-4114-a254-99d0dce2b201
0	169	169	Plazi	ffb07bec-2d10-492d-9c37-361fe0b79427	dde87a19-79a2-44a3-8533-b8970944cb99
0	2749	2749	Ocean Biodiversity Information System	ba0670b9-4186-41e6-8e70-f9cb3065551a	e20d61a9-4ba1-41d6-9256-722e8c57cb34
74730	74730	0	GBIF Germany	4f6826f2-4ff6-443d-b966-e6913bd24013	e5774d90-9f01-42bb-a747-32331be82b18
0	1	1	Plazi	ffb07bec-2d10-492d-9c37-361fe0b79427	e5d07c2a-0cd7-45d9-981b-92cd4dc028cd
0	7	7	Participant Node Managers Committee	7f48e0c8-5c96-49ec-b972-30748e339115	e7f85907-4693-4892-bcc7-b2b78ced3386
0	23	23	Plazi	ffb07bec-2d10-492d-9c37-361fe0b79427	e80ce2ff-75c8-4cbe-9b01-12c25179e9a1
582	582	0	GBIF Brazil	cdc9736d-5ff7-4ece-9959-3c744360cdb3	ec5c8ed6-468e-41b0-bb4c-934b36fb3733
539	539	0	Colombian Biodiversity Information System	7e865cba-7c46-417b-ade5-97f2cf5b7be0	eea3ca22-7cf1-42b8-9381-20defc2f109e
1	1	0	Plazi	ffb07bec-2d10-492d-9c37-361fe0b79427	f1ec77fe-24ea-432b-90a2-c229f9845a9b
5	5	0	Plazi	ffb07bec-2d10-492d-9c37-361fe0b79427	f5c02b13-c2fb-404a-8301-2665ca5d2bc1
88	88	0	GBIF Germany	4f6826f2-4ff6-443d-b966-e6913bd24013	f72b3447-2ae8-4dee-904a-0bd96ed19730
2	2	0	Plazi	ffb07bec-2d10-492d-9c37-361fe0b79427	f901316b-5ec0-45b3-96f6-566c6344dd8f
7	7	0	Plazi	ffb07bec-2d10-492d-9c37-361fe0b79427	f9d61211-fb08-4a60-8561-4a60e5a349ca
20	20	0	Biodiversity Information System of Mexico	b324e8e9-9a4c-44fa-8f1a-7f39ea7ab576	fa968290-13d4-4c3c-bff3-fd5085e86023
61	61	0	National Biodiversity Network	d897a5b9-35ee-4232-94bd-b0bcaac003c2	fb337245-5db6-4034-9ba1-8f7f24fea5e7
839	839	0	Biodiversity Information System of Mexico	b324e8e9-9a4c-44fa-8f1a-7f39ea7ab576	fcbb959f-5b14-4568-a471-1a3c53bf1b74
1967	1967	0	Colombian Biodiversity Information System	7e865cba-7c46-417b-ade5-97f2cf5b7be0	fcc8eb19-9c45-408d-959d-169c21119ea8
1	1	0	Plazi	ffb07bec-2d10-492d-9c37-361fe0b79427	01f9a310-e503-4558-945b-dce61bdc2dbf
4	4	0	Plazi	ffb07bec-2d10-492d-9c37-361fe0b79427	05ee2615-3587-4520-8234-b0cbfeae1133
834	834	0	South African Biodiversity Information Facility	7190b835-4e86-4b6e-85c1-19cc6677c250	065c4d4a-eead-44a4-ac94-19df2a0a47ad
255	255	0	GBIF France	da44cd31-5901-4687-a106-6d1c7734ee3a	06933bc4-357d-4acf-8783-7d951dec97b0
3	3	0	Plazi	ffb07bec-2d10-492d-9c37-361fe0b79427	08fb4170-35b0-4c30-b9e1-89cfa4925313
4	4	0	Plazi	ffb07bec-2d10-492d-9c37-361fe0b79427	0ad3be00-68a2-490e-bd84-d96ef645fe2e
643	643	0	GBIF France	da44cd31-5901-4687-a106-6d1c7734ee3a	0b673581-fad1-4ee0-ab40-f8d10c729268
628	628	0	GBIF France	da44cd31-5901-4687-a106-6d1c7734ee3a	0c9e6d04-d821-4eec-a8e0-4b43a74b34cc
0	5	5	Plazi	ffb07bec-2d10-492d-9c37-361fe0b79427	0d3b8190-349b-415b-8d5f-77ac801fd128
18	18	0	Biodiversity Information System of Mexico	b324e8e9-9a4c-44fa-8f1a-7f39ea7ab576	0dcad564-005a-4755-9ff2-c5a9a381a636
4	4	0	Plazi	ffb07bec-2d10-492d-9c37-361fe0b79427	0ee1981e-5117-482d-9900-38ef71cfaf24
167	167	0	Participant Node Managers Committee	7f48e0c8-5c96-49ec-b972-30748e339115	0eef4aa0-c618-4f61-9844-1824ce24d29a
246	246	0	GBIF France	da44cd31-5901-4687-a106-6d1c7734ee3a	0fc0161f-bb2c-4071-9cab-7b08c207b6f5
0	2	2	Plazi	ffb07bec-2d10-492d-9c37-361fe0b79427	10258b36-1a5c-4630-af45-c6940bfe3a0c
2665	2667	2	Belgian Biodiversity Platform	fb11cfe1-ebc3-45af-9159-17d9fddbcdac	10b6b3f2-ce6e-47d8-bad1-a948349b7bef
3	3	0	Plazi	ffb07bec-2d10-492d-9c37-361fe0b79427	12550c36-7b7c-43a9-8aa2-0d2c3940d448
0	1539	1539	Ocean Biodiversity Information System	ba0670b9-4186-41e6-8e70-f9cb3065551a	1386b3b4-cafb-4667-9110-9955b8e753ac
305	305	0	Plazi	ffb07bec-2d10-492d-9c37-361fe0b79427	16dfaaea-fa3b-4dda-a047-13359b05bfa1
499	499	0	Participant Node Managers Committee	7f48e0c8-5c96-49ec-b972-30748e339115	177d1017-a295-481e-9b02-27391288c5e0
1464	1464	0	Colombian Biodiversity Information System	7e865cba-7c46-417b-ade5-97f2cf5b7be0	19c2b930-c4c8-46f5-9635-b48e4adc504a
1	1	0	Plazi	ffb07bec-2d10-492d-9c37-361fe0b79427	1a06eb9e-ef0a-4613-840f-6b46a8c49cb6
188	188	0	Plazi	ffb07bec-2d10-492d-9c37-361fe0b79427	1c94057f-64de-4f19-b047-2223e4d664e8
2	2	0	Plazi	ffb07bec-2d10-492d-9c37-361fe0b79427	204360f1-9583-4ffe-9c41-52773c226270
1776	1776	0	U.S. Geological Survey	8618c64a-93e0-4300-b546-7249e5148ed2	20a7d0be-5166-4b11-91ca-2c535ee904e3
141	141	0	GBIF Chile	a8b16421-d80b-4ef3-8f22-098b01a89255	2401cd5e-26a8-4a0c-9007-e5e6137a1364
139	139	0	Plazi	ffb07bec-2d10-492d-9c37-361fe0b79427	24f177e7-21c3-4db9-a99e-c8d9c028eee4
0	17	17	Plazi	ffb07bec-2d10-492d-9c37-361fe0b79427	27992481-4564-418c-851f-64ba0c63abfc
0	4	4	Plazi	ffb07bec-2d10-492d-9c37-361fe0b79427	27b8f170-95d1-4132-a493-c0b78c109163
2	2	0	Plazi	ffb07bec-2d10-492d-9c37-361fe0b79427	2821abff-9e77-4150-abd4-fda213d290e3
455	455	0	Participant Node Managers Committee	7f48e0c8-5c96-49ec-b972-30748e339115	28b321a4-8ca4-4535-97e3-3f96562af979
1	1	0	Plazi	ffb07bec-2d10-492d-9c37-361fe0b79427	297b785a-3176-4348-8763-eb6221eca7cb
26890	26890	0	GBIF France	da44cd31-5901-4687-a106-6d1c7734ee3a	2a6a151d-f079-4bff-89ac-6ba3e9588a21
55	55	0	GBIF Germany	4f6826f2-4ff6-443d-b966-e6913bd24013	2adbe7bd-e13b-4b67-92c7-cfc0ee970f1f
0	1	1	Plazi	ffb07bec-2d10-492d-9c37-361fe0b79427	2fae9b0a-ea4d-4715-9ee6-93a215740e7c
0	1	1	Ocean Biodiversity Information System	ba0670b9-4186-41e6-8e70-f9cb3065551a	30705883-ca02-4ee6-8d66-3925a63be046
0	142	142	Plazi	ffb07bec-2d10-492d-9c37-361fe0b79427	308129a3-a99f-4012-bb41-d3220692c398
4585	4585	0	Atlas of Living Australia	4a6f1b71-969e-4fc5-a693-282b05e1220c	30d9b134-c7df-4e90-8142-02d7a54f47b8
0	169	169	Participant Node Managers Committee	7f48e0c8-5c96-49ec-b972-30748e339115	33300ebe-ee45-4920-9c08-9d45188d5c66
9	9	0	Biodiversity Information System of Mexico	b324e8e9-9a4c-44fa-8f1a-7f39ea7ab576	33e67b5a-f6e5-4f31-a60f-3b1d259551b7
382	382	0	GBIF Argentina	2426a871-9feb-40a1-96c6-0c593a76b835	345da015-d276-4541-a0c2-08784f5492a4
0	2	2	Plazi	ffb07bec-2d10-492d-9c37-361fe0b79427	34f5cc63-2c6f-4b44-884c-6775772f802c
251	251	0	GBIF France	da44cd31-5901-4687-a106-6d1c7734ee3a	388837b0-c065-4a9a-a6d2-16129cee0d91
262	262	0	Participant Node Managers Committee	7f48e0c8-5c96-49ec-b972-30748e339115	39371f82-72b4-449c-b39b-7d5c2c568d48
2	2	0	Plazi	ffb07bec-2d10-492d-9c37-361fe0b79427	3aa325f2-3f96-4380-8145-ee552b0bd9c9
11640	11640	0	GBIF Benin	efb9c00e-f802-45dd-8826-a52ec45b89ff	3d6d0a53-8d72-4271-8bf4-ce272caa8d83
3	3	0	Plazi	ffb07bec-2d10-492d-9c37-361fe0b79427	406c68ec-e596-4010-bdef-be6f9767894a
63582	63582	0	GBIF France	da44cd31-5901-4687-a106-6d1c7734ee3a	41e8840e-57eb-40d4-a1ac-cfda408bc871
16	16	0	Plazi	ffb07bec-2d10-492d-9c37-361fe0b79427	429cf011-ec4c-4a61-b894-2bd32b2ffc9b
14	14	0	Plazi	ffb07bec-2d10-492d-9c37-361fe0b79427	4819f2c3-d142-4e3d-a381-86873734a333
603	603	0	GBIF France	da44cd31-5901-4687-a106-6d1c7734ee3a	4e2cf91d-1299-49e3-8962-bfea8cd61dcf
3002	3002	0	Colombian Biodiversity Information System	7e865cba-7c46-417b-ade5-97f2cf5b7be0	5099e00c-b9bc-41eb-8bc1-8bffda8878fe
0	4	4	Plazi	ffb07bec-2d10-492d-9c37-361fe0b79427	5348a0bc-a04f-4fc6-83d9-0ca19592e6b5
73	73	0	Plazi	ffb07bec-2d10-492d-9c37-361fe0b79427	5b354da7-c255-4580-b8b3-05890e334796
3059	5036	1977	Atlas of Living Australia	4a6f1b71-969e-4fc5-a693-282b05e1220c	5c88c333-373d-46bb-8e22-5a2f50913ed0
85	85	0	Plazi	ffb07bec-2d10-492d-9c37-361fe0b79427	5d5d90e2-75db-46bd-b979-7c2dfaab10dc
3	3	0	GBIF Kenya	2a44d626-9f7a-4120-8a7a-4ab5ac15ff2a	5e6cb766-df56-44ac-9512-8ccca8d6dacf
0	1560	1560	GBIF Spain	1f94b3ca-9345-4d65-afe2-4bace93aa0fe	5efce611-2582-4954-bcd1-ae97493b3ed7
0	5	5	Ocean Biodiversity Information System	ba0670b9-4186-41e6-8e70-f9cb3065551a	5f329b6a-0ba4-4960-ab24-658e67bc74b6
1976	1976	0	Belgian Biodiversity Platform	fb11cfe1-ebc3-45af-9159-17d9fddbcdac	603e2671-2e7f-4173-a887-26feef188096
1	1	0	Plazi	ffb07bec-2d10-492d-9c37-361fe0b79427	61eebd95-16f5-4dab-9eac-674b467718f0
1	1	0	Plazi	ffb07bec-2d10-492d-9c37-361fe0b79427	621c2691-b9b0-460c-8772-851ef352c749
66	66	0	GBIF Germany	4f6826f2-4ff6-443d-b966-e6913bd24013	62d243cc-f762-11e1-a439-00145eb45e9a
366	366	0	GBIF Germany	4f6826f2-4ff6-443d-b966-e6913bd24013	638b97dc-f762-11e1-a439-00145eb45e9a
27	27	0	GBIF Germany	4f6826f2-4ff6-443d-b966-e6913bd24013	645e706c-f762-11e1-a439-00145eb45e9a
17	17	0	Plazi	ffb07bec-2d10-492d-9c37-361fe0b79427	6523d35c-0309-4bea-bf9f-9fc6f7b563ca
2	2	0	Plazi	ffb07bec-2d10-492d-9c37-361fe0b79427	6567904b-77d9-4d6f-b708-b96a162904a5
102	102	0	GBIF Germany	4f6826f2-4ff6-443d-b966-e6913bd24013	678a25ec-f762-11e1-a439-00145eb45e9a
17	17	0	Plazi	ffb07bec-2d10-492d-9c37-361fe0b79427	6a60a6f0-097b-4db7-b6e4-eef760e397c9
18	18	0	GBIF Germany	4f6826f2-4ff6-443d-b966-e6913bd24013	6a906602-f762-11e1-a439-00145eb45e9a
98	98	0	GBIF Germany	4f6826f2-4ff6-443d-b966-e6913bd24013	6aa00396-f762-11e1-a439-00145eb45e9a
0	2	2	Plazi	ffb07bec-2d10-492d-9c37-361fe0b79427	6ab68701-ac96-48f6-9ec0-7b6ead497f69
0	109	109	Plazi	ffb07bec-2d10-492d-9c37-361fe0b79427	6c11804f-a747-4514-b764-8e068ddf0f16
0	122416	122416	Ocean Biodiversity Information System	ba0670b9-4186-41e6-8e70-f9cb3065551a	6cb6ab2b-b5ac-4134-9b25-574dcfcbef09
66	66	0	GBIF Germany	4f6826f2-4ff6-443d-b966-e6913bd24013	6ce57e88-f762-11e1-a439-00145eb45e9a
182	182	0	GBIF Germany	4f6826f2-4ff6-443d-b966-e6913bd24013	6d17ee18-f762-11e1-a439-00145eb45e9a
16332	16332	0	National Biodiversity Network	d897a5b9-35ee-4232-94bd-b0bcaac003c2	6f2d76b8-230d-4cc3-9016-6aa446f44f95
3428	3428	0	Colombian Biodiversity Information System	7e865cba-7c46-417b-ade5-97f2cf5b7be0	70790a0d-6cb3-4127-9bf9-8e8c55a1e1b9
8	8	0	Plazi	ffb07bec-2d10-492d-9c37-361fe0b79427	709d6fc5-fd51-4b49-b8b6-be3228e14873
140	140	0	GBIF Germany	4f6826f2-4ff6-443d-b966-e6913bd24013	70bf2702-f762-11e1-a439-00145eb45e9a
149	149	0	GBIF Germany	4f6826f2-4ff6-443d-b966-e6913bd24013	71b4e106-f762-11e1-a439-00145eb45e9a
140	140	0	GBIF Germany	4f6826f2-4ff6-443d-b966-e6913bd24013	746f5ee4-f762-11e1-a439-00145eb45e9a
409	409	0	GBIF Germany	4f6826f2-4ff6-443d-b966-e6913bd24013	748c2e52-f762-11e1-a439-00145eb45e9a
10	10	0	GBIF Germany	4f6826f2-4ff6-443d-b966-e6913bd24013	755809dc-f762-11e1-a439-00145eb45e9a
0	45	45	Participant Node Managers Committee	7f48e0c8-5c96-49ec-b972-30748e339115	76823edf-ec73-4a93-a981-a75946ee06c4
0	1	1	Plazi	ffb07bec-2d10-492d-9c37-361fe0b79427	7693761b-af9e-46dd-a914-704668534e94
1	1	0	Plazi	ffb07bec-2d10-492d-9c37-361fe0b79427	775fe351-8dad-4490-9d4d-34701f62b5c1
33318	33318	0	GBIF Spain	1f94b3ca-9345-4d65-afe2-4bace93aa0fe	77a24e14-534b-4864-bb95-ae0966ce89ce
0	2	2	Plazi	ffb07bec-2d10-492d-9c37-361fe0b79427	77acf90e-0636-41f3-a80d-0a1ac9d1339c
0	56	56	Plazi	ffb07bec-2d10-492d-9c37-361fe0b79427	79245a66-6109-4bed-887c-d1ed2e0950da
0	4	4	Ocean Biodiversity Information System	ba0670b9-4186-41e6-8e70-f9cb3065551a	79e00605-5a93-4576-a710-2e2bfea9111b
2059	1633	-426	GBIF Germany	4f6826f2-4ff6-443d-b966-e6913bd24013	7bd3d62e-f762-11e1-a439-00145eb45e9a
960	960	0	GBIF Germany	4f6826f2-4ff6-443d-b966-e6913bd24013	7c285744-f762-11e1-a439-00145eb45e9a
2	2	0	Plazi	ffb07bec-2d10-492d-9c37-361fe0b79427	7efaca4a-2cc6-4c40-b375-5d05ae98bf52
96	96	0	GBIF Germany	4f6826f2-4ff6-443d-b966-e6913bd24013	7f1f6064-f762-11e1-a439-00145eb45e9a
9734	9736	2	GBIF Brazil	cdc9736d-5ff7-4ece-9959-3c744360cdb3	7fde5656-64fd-4442-ae89-60becebc29a6
8	8	0	Plazi	ffb07bec-2d10-492d-9c37-361fe0b79427	804d0767-6c32-404a-b125-80f95ee8429e
8862	8862	0	GBIF France	da44cd31-5901-4687-a106-6d1c7734ee3a	818b61fe-8c37-4c49-83f8-fa710cfdbb81
84	84	0	Plazi	ffb07bec-2d10-492d-9c37-361fe0b79427	82826f47-5e43-4c17-a850-2575425f52ad
3761	3761	0	GBIF Switzerland	169eb292-376b-4cc6-8e31-9c2c432de0ad	82a9db1a-f762-11e1-a439-00145eb45e9a
15846	15846	0	Canada Biodiversity Information Facility	8f83fc96-c966-4126-83f7-bf044dc49efa	845bc5c2-f762-11e1-a439-00145eb45e9a
6	6	0	Plazi	ffb07bec-2d10-492d-9c37-361fe0b79427	8727b4e8-bf32-4c30-aa04-1821c0c390c6
1310	1310	0	GBIF Germany	4f6826f2-4ff6-443d-b966-e6913bd24013	87ca0390-f762-11e1-a439-00145eb45e9a
185	164	-21	GBIF Germany	4f6826f2-4ff6-443d-b966-e6913bd24013	884857ea-f762-11e1-a439-00145eb45e9a
568	568	0	GBIF France	da44cd31-5901-4687-a106-6d1c7734ee3a	887a87b7-366c-42bf-a152-2223e6642456
56	56	0	GBIF France	da44cd31-5901-4687-a106-6d1c7734ee3a	890e7e05-bb6d-4520-a31a-dcef3c3fb0b0
92	92	0	GBIF Germany	4f6826f2-4ff6-443d-b966-e6913bd24013	89f13314-f762-11e1-a439-00145eb45e9a
58	58	0	GBIF Germany	4f6826f2-4ff6-443d-b966-e6913bd24013	8bd2b23e-f762-11e1-a439-00145eb45e9a
10	10	0	Plazi	ffb07bec-2d10-492d-9c37-361fe0b79427	8be054d5-36e9-4fd4-a655-ae67d67fac0c
24	14	-10	GBIF Germany	4f6826f2-4ff6-443d-b966-e6913bd24013	8cf6667e-f762-11e1-a439-00145eb45e9a
197	197	0	GBIF Germany	4f6826f2-4ff6-443d-b966-e6913bd24013	8d752644-f762-11e1-a439-00145eb45e9a
1353	1066	-287	GBIF Germany	4f6826f2-4ff6-443d-b966-e6913bd24013	8ea2f80c-f762-11e1-a439-00145eb45e9a
259	259	0	GBIF Germany	4f6826f2-4ff6-443d-b966-e6913bd24013	8f23a358-f762-11e1-a439-00145eb45e9a
215	215	0	GBIF France	da44cd31-5901-4687-a106-6d1c7734ee3a	900b64ec-24fe-4262-b1be-3432665d6e48
140	93	-47	GBIF Germany	4f6826f2-4ff6-443d-b966-e6913bd24013	90c89f06-f762-11e1-a439-00145eb45e9a
1461	4615	3154	Belgian Biodiversity Platform	fb11cfe1-ebc3-45af-9159-17d9fddbcdac	9100f482-848c-42e7-bf7c-19947885ce48
0	271	271	Belgian Biodiversity Platform	fb11cfe1-ebc3-45af-9159-17d9fddbcdac	9113f95f-6b0e-4610-b13d-efb49052fd76
62	52	-10	GBIF Germany	4f6826f2-4ff6-443d-b966-e6913bd24013	917f8cd4-f762-11e1-a439-00145eb45e9a
405	406	1	GBIF Germany	4f6826f2-4ff6-443d-b966-e6913bd24013	92f8f12c-f762-11e1-a439-00145eb45e9a
268	260	-8	GBIF Germany	4f6826f2-4ff6-443d-b966-e6913bd24013	930e8f00-f762-11e1-a439-00145eb45e9a
0	13	13	Ocean Biodiversity Information System	ba0670b9-4186-41e6-8e70-f9cb3065551a	933ee690-397d-41ae-b482-5f2d7d7c9c1c
0	243	243	National Biodiversity Network	d897a5b9-35ee-4232-94bd-b0bcaac003c2	9370db23-4798-44c1-9cff-47f06ef992a9
19	19	0	GBIF Germany	4f6826f2-4ff6-443d-b966-e6913bd24013	93792e32-f762-11e1-a439-00145eb45e9a
2	2	0	Plazi	ffb07bec-2d10-492d-9c37-361fe0b79427	94c2cac9-f7a5-46f6-ae62-a6a93c9009ed
41	44	3	GBIF Germany	4f6826f2-4ff6-443d-b966-e6913bd24013	94f98bee-f762-11e1-a439-00145eb45e9a
1	1	0	Plazi	ffb07bec-2d10-492d-9c37-361fe0b79427	95b0e1a1-4c8f-42ae-9036-94795ead1186
40	40	0	Plazi	ffb07bec-2d10-492d-9c37-361fe0b79427	95d51781-052e-40a2-b488-44808ac0654d
0	5	5	Plazi	ffb07bec-2d10-492d-9c37-361fe0b79427	964f53d7-9062-44f4-85ef-fa84e875fa8f
4544	4544	0	Colombian Biodiversity Information System	7e865cba-7c46-417b-ade5-97f2cf5b7be0	9656fd77-7981-4cc4-916e-0e8bf5a63088
20	20	0	GBIF Germany	4f6826f2-4ff6-443d-b966-e6913bd24013	976d1f76-f762-11e1-a439-00145eb45e9a
2462	2462	0	Observation International	ad048418-7cd8-4070-a151-fe1c1f303129	98e0629a-678b-4bec-98ef-fb097262bf18
60	60	0	GBIF France	da44cd31-5901-4687-a106-6d1c7734ee3a	999cbb54-b0d6-43d9-b86c-8b7bfb8c6fad
5	5	0	Plazi	ffb07bec-2d10-492d-9c37-361fe0b79427	9acc9e56-6009-4c36-942c-764de71dda74
4823	4823	0	GBIF Germany	4f6826f2-4ff6-443d-b966-e6913bd24013	9c4e4a19-fe29-453e-8c66-06238797fb70
0	753	753	Atlas of Living Australia	4a6f1b71-969e-4fc5-a693-282b05e1220c	9c6f2c30-ced7-46e7-b317-694f2808d167
2	2	0	Plazi	ffb07bec-2d10-492d-9c37-361fe0b79427	9c9e9e57-74b0-4d8e-869e-8382594b2f30
196	196	0	GBIF France	da44cd31-5901-4687-a106-6d1c7734ee3a	9d0ed743-7129-4722-a8d0-2804d0b26530
5	5	0	Plazi	ffb07bec-2d10-492d-9c37-361fe0b79427	a0992ffa-00c1-4d7b-8366-e18c9ec1a168
0	283	283	Participant Node Managers Committee	7f48e0c8-5c96-49ec-b972-30748e339115	a14e32aa-6662-4139-b020-8277a7820ee8
1	1	0	Plazi	ffb07bec-2d10-492d-9c37-361fe0b79427	a4b4f815-6b23-4430-8970-056cf3b60b80
31	31	0	Plazi	ffb07bec-2d10-492d-9c37-361fe0b79427	a7e5521f-20e6-4873-916d-264655047fa6
5	5	0	Plazi	ffb07bec-2d10-492d-9c37-361fe0b79427	a9d60e90-e099-411c-9c62-d65d2949825f
3	3	0	Plazi	ffb07bec-2d10-492d-9c37-361fe0b79427	af431176-c0a7-422e-9ed8-d4162dc364ae
0	17	17	Plazi	ffb07bec-2d10-492d-9c37-361fe0b79427	b0234602-f3ca-4c96-b79d-be7d84d41b1f
0	33	33	Plazi	ffb07bec-2d10-492d-9c37-361fe0b79427	b1a9a24a-3669-43ea-890b-7da58b7a96a6
19	19	0	Plazi	ffb07bec-2d10-492d-9c37-361fe0b79427	b2693c8e-1298-4849-9d26-49fadac52e63
0	23	23	Plazi	ffb07bec-2d10-492d-9c37-361fe0b79427	b6e0f4ca-fa35-4f1b-9f50-962800f10708
0	4	4	Plazi	ffb07bec-2d10-492d-9c37-361fe0b79427	b718041a-b95e-4ef9-878f-b11cafb21542
1747	1747	0	GBIF France	da44cd31-5901-4687-a106-6d1c7734ee3a	bb0db175-4205-4062-9897-33545d004e92
258354	258354	0	National Biodiversity Network	d897a5b9-35ee-4232-94bd-b0bcaac003c2	bd48b249-6c59-4868-85b5-caec4ac250fc
0	1478	1478	GBIF Portugal	673f7038-4262-4149-b753-5658a4e912f6	c00d00cf-db3a-4b78-89f1-12dd20abf4c1
38	38	0	GBIF France	da44cd31-5901-4687-a106-6d1c7734ee3a	c03aba0a-1fed-479c-8423-a2c75462fee9
40	40	0	Plazi	ffb07bec-2d10-492d-9c37-361fe0b79427	c1399636-2740-4f86-ac4a-4af03c639737
71	71	0	Belgian Biodiversity Platform	fb11cfe1-ebc3-45af-9159-17d9fddbcdac	c1850d35-2e7d-45a5-be10-02e3132e3b3f
278	278	0	Participant Node Managers Committee	7f48e0c8-5c96-49ec-b972-30748e339115	c28743cc-fcaa-4e80-8c42-ece6a20dea70
743753	743753	0	National Biodiversity Network	d897a5b9-35ee-4232-94bd-b0bcaac003c2	c55cf28c-8ed3-43cd-914c-8a8b7b4b9df0
0	2	2	Plazi	ffb07bec-2d10-492d-9c37-361fe0b79427	c73cd2b0-1ad9-409c-9033-908feb7fdaf3
4	4	0	Plazi	ffb07bec-2d10-492d-9c37-361fe0b79427	c75b0c67-567d-484f-b243-6239c21055c9
14027	14027	0	Colombian Biodiversity Information System	7e865cba-7c46-417b-ade5-97f2cf5b7be0	cb9e84f5-2367-46c9-83cf-7a68695626fb
642	642	0	National Biodiversity Network	d897a5b9-35ee-4232-94bd-b0bcaac003c2	cc8b5931-6a38-4c2d-89a3-3dce3e6dd47f
2	2	0	Plazi	ffb07bec-2d10-492d-9c37-361fe0b79427	cd234896-fea1-4a0a-894c-81c1b30f9403
0	473	473	Colombian Biodiversity Information System	7e865cba-7c46-417b-ade5-97f2cf5b7be0	cfa5ee7c-cc82-4321-a9a3-0358bf03aee6
4038	4038	0	GBIF France	da44cd31-5901-4687-a106-6d1c7734ee3a	cfdc8562-e40a-46a4-85ea-cdb4ab5b8541
26431	26431	0	U.S. Geological Survey	8618c64a-93e0-4300-b546-7249e5148ed2	d0351e80-ae78-46ea-8601-8c458282ae73
62	62	0	GBIF France	da44cd31-5901-4687-a106-6d1c7734ee3a	d16b4b5b-a882-4aa8-b1d8-8aabd0927f90
6	6	0	Plazi	ffb07bec-2d10-492d-9c37-361fe0b79427	d27643b1-cdf9-4c90-8b40-b64bf9be8ee2
60	60	0	GBIF Germany	4f6826f2-4ff6-443d-b966-e6913bd24013	d384b27d-8600-4404-a9ce-22654007aa10
27810	27810	0	Belgian Biodiversity Platform	fb11cfe1-ebc3-45af-9159-17d9fddbcdac	d3d38190-0c13-11df-b8c6-b8a03c50a862
2278	2278	0	GBIF Spain	1f94b3ca-9345-4d65-afe2-4bace93aa0fe	d436cc89-f949-436a-a4c9-4b12552f760d
0	2	2	Plazi	ffb07bec-2d10-492d-9c37-361fe0b79427	d4c45013-40ab-4ec7-a2f5-6a7be6e3f720
57	57	0	GBIF France	da44cd31-5901-4687-a106-6d1c7734ee3a	d783d921-cb89-43ed-ae23-95f00b10b44a
0	10	10	Plazi	ffb07bec-2d10-492d-9c37-361fe0b79427	dbf360e3-f8f0-446e-a50d-c6b9a838063b
151	151	0	Biodiversity Information System of Mexico	b324e8e9-9a4c-44fa-8f1a-7f39ea7ab576	dc658318-8a2e-4faa-87e2-7f6a501ff16d
11	11	0	Plazi	ffb07bec-2d10-492d-9c37-361fe0b79427	dede68a0-5291-4c06-b3f7-4f41cf1295e0
20389	20389	0	Participant Node Managers Committee	7f48e0c8-5c96-49ec-b972-30748e339115	df9dcbc9-f3d1-40e2-9011-02babb0d98f6
0	3312	3312	Colombian Biodiversity Information System	7e865cba-7c46-417b-ade5-97f2cf5b7be0	e0bee920-5c02-4c8d-8ac3-115a95f5a4b1
104	104	0	Plazi	ffb07bec-2d10-492d-9c37-361fe0b79427	e6443eb6-bfcc-44a6-a547-7af9a94d4a7d
29	29	0	Plazi	ffb07bec-2d10-492d-9c37-361fe0b79427	e87a4472-0aeb-49da-9689-e3139e676432
106859	106859	0	U.S. Geological Survey	8618c64a-93e0-4300-b546-7249e5148ed2	ebfe41de-79a4-492c-bd72-5c25e41237be
1	1	0	Plazi	ffb07bec-2d10-492d-9c37-361fe0b79427	f1f6714d-631a-4cc2-bbad-1fa240426fff
4	4	0	Plazi	ffb07bec-2d10-492d-9c37-361fe0b79427	f42d3779-01fb-4c07-812f-068243f5ad23
820	820	0	GBIF France	da44cd31-5901-4687-a106-6d1c7734ee3a	f966888d-61a4-4fab-b2eb-9ce4912b6e40
207	207	0	Canada Biodiversity Information Facility	8f83fc96-c966-4126-83f7-bf044dc49efa	f9c49aed-ba4b-454e-b88a-cbe1fff5b2b6
792	792	0	GBIF Portugal	673f7038-4262-4149-b753-5658a4e912f6	fb221c75-4bf7-4145-8eb5-2c3ffc74ce53
0	38	38	Plazi	ffb07bec-2d10-492d-9c37-361fe0b79427	fe130a2d-f549-425c-9e71-5276deb71714
6	6	0	Plazi	ffb07bec-2d10-492d-9c37-361fe0b79427	fe86d52f-79fc-4642-950a-75341be789f1
65111	66907	1796	Netherlands Biodiversity Information Facility	0909d601-bda2-42df-9e63-a6d51847ebce	009a76f6-0960-4a56-a116-63991e6bb037
19	19	0	Plazi	ffb07bec-2d10-492d-9c37-361fe0b79427	03b915ab-1004-4f9c-872e-12958eb23182
10	10	0	Plazi	ffb07bec-2d10-492d-9c37-361fe0b79427	0480b500-4867-4836-8dc1-e31914367c41
119882	119882	0	National Biodiversity Network	d897a5b9-35ee-4232-94bd-b0bcaac003c2	06fc84c8-f8e2-4ae9-a1ff-2020ad3bae29
3998	4598	600	GBIF Japan	db5705aa-6a6e-42f1-8942-d77b9f4896ea	073e7dab-1c66-4e6c-a75e-dfeee6851290
0	3	3	Ocean Biodiversity Information System	ba0670b9-4186-41e6-8e70-f9cb3065551a	077456cc-b5ca-49b5-84be-e418bbc73fa2
17	17	0	GBIF Germany	4f6826f2-4ff6-443d-b966-e6913bd24013	09eb4cd9-225b-437f-94cc-5e54dc5d3a67
5	5	0	Plazi	ffb07bec-2d10-492d-9c37-361fe0b79427	0b281201-10b2-4758-9cd1-efec708be7af
0	20	20	Plazi	ffb07bec-2d10-492d-9c37-361fe0b79427	0b2b720f-fd63-4d65-b874-5f0b422a6a68
97	97	0	Participant Node Managers Committee	7f48e0c8-5c96-49ec-b972-30748e339115	0b394791-e0c5-4f94-bc8e-bbfe5c32920d
10343	10343	0	GBIF Benin	efb9c00e-f802-45dd-8826-a52ec45b89ff	0ce9ca26-0e89-4f63-94fe-124d47a4451a
0	10	10	Plazi	ffb07bec-2d10-492d-9c37-361fe0b79427	0d0d29eb-b376-4f5d-934d-dd987ff0cbff
0	2	2	Plazi	ffb07bec-2d10-492d-9c37-361fe0b79427	0e4fd5eb-69e5-4ea2-b2e4-7645bfa5f366
1	1	0	Plazi	ffb07bec-2d10-492d-9c37-361fe0b79427	0ee4394b-edea-462e-b43a-c29780cc1abb
15	15	0	Plazi	ffb07bec-2d10-492d-9c37-361fe0b79427	10494c5a-5b6f-49ba-83b7-eddf4a64b35f
1998	1998	0	National Biodiversity Network	d897a5b9-35ee-4232-94bd-b0bcaac003c2	10f00fb9-b3fb-4a14-9d98-2271792d8010
0	1	1	Plazi	ffb07bec-2d10-492d-9c37-361fe0b79427	1199980f-381c-4bd5-b0b0-976ea2c76f2c
0	8147	8147	Participant Node Managers Committee	7f48e0c8-5c96-49ec-b972-30748e339115	126ccf3a-0c99-466d-8aea-95d3e6d30acc
304	304	0	National Biodiversity Network	d897a5b9-35ee-4232-94bd-b0bcaac003c2	13ab2b0e-74b7-46bf-9379-a7a7d838b703
0	2	2	Plazi	ffb07bec-2d10-492d-9c37-361fe0b79427	142d0229-54c9-483c-8f06-063f4d2ee090
2	2	0	Plazi	ffb07bec-2d10-492d-9c37-361fe0b79427	16a57ea3-04b7-46ae-b6f0-6b01dae43398
305	24	-281	Chinese Academy of Sciences	e760dc6f-dd68-474d-ab41-bd3588571793	1b26c417-366a-4eb0-a212-6ee8035d83fb
17256	17256	0	National Biodiversity Network	d897a5b9-35ee-4232-94bd-b0bcaac003c2	20e0b28a-d84f-4ed4-970a-027bdf42555a
386	386	0	GBIF France	da44cd31-5901-4687-a106-6d1c7734ee3a	24a988ee-bcb2-4ea3-99a3-a8994d6e8014
0	2	2	Plazi	ffb07bec-2d10-492d-9c37-361fe0b79427	28ada858-1a00-4375-a3e5-9208c6f45886
12	12	0	Plazi	ffb07bec-2d10-492d-9c37-361fe0b79427	29510c70-d277-45f5-aba5-2a779b460b37
0	2	2	Plazi	ffb07bec-2d10-492d-9c37-361fe0b79427	2b958e8b-df3a-4ba7-8b26-1bf85f5a7549
20	20	0	Plazi	ffb07bec-2d10-492d-9c37-361fe0b79427	2c5b39cf-13ae-4846-a80d-1cbecbda29aa
0	614	614	Ocean Biodiversity Information System	ba0670b9-4186-41e6-8e70-f9cb3065551a	2e17e5f6-9343-4941-abc9-4d5f3de48e5a
4	4	0	Plazi	ffb07bec-2d10-492d-9c37-361fe0b79427	2f717b50-61e1-4e13-9f03-be0a4fe2134d
78	78	0	GBIF Germany	4f6826f2-4ff6-443d-b966-e6913bd24013	303e42f0-a43b-4592-9d28-4864a58e1d64
8	8	0	Plazi	ffb07bec-2d10-492d-9c37-361fe0b79427	30736dc0-0f81-4770-89ee-268c23441052
0	1	1	Plazi	ffb07bec-2d10-492d-9c37-361fe0b79427	30d34716-004f-4fb3-8275-5a36bdfb1637
87	87	0	GBIF Germany	4f6826f2-4ff6-443d-b966-e6913bd24013	32bd9bf7-760f-4174-a590-98d571a9ba95
4	4	0	Plazi	ffb07bec-2d10-492d-9c37-361fe0b79427	3365f71e-b2fa-4b85-a81b-88c8d8bc898a
0	10	10	Plazi	ffb07bec-2d10-492d-9c37-361fe0b79427	35bdbaac-7ad3-4831-b831-4f28a3822418
0	1741	1741	GBIF Japan	db5705aa-6a6e-42f1-8942-d77b9f4896ea	35f77d17-9fa3-487b-9b45-2c3c6cb24c28
3110	3110	0	GBIF Finland	dd514216-5c7c-45f3-910d-797424cb5be6	4352e0b3-2c1f-42a0-a445-eff75e37cd36
4794	4794	0	Participant Node Managers Committee	7f48e0c8-5c96-49ec-b972-30748e339115	45d532d3-ced7-4856-8590-705bc8b244a1
16	16	0	Plazi	ffb07bec-2d10-492d-9c37-361fe0b79427	4b40c54d-fd86-429c-8ca9-a0b5245f7d9a
5216	5216	0	National Biodiversity Network	d897a5b9-35ee-4232-94bd-b0bcaac003c2	4bc303c7-b994-482b-8319-582def27d16c
193	193	0	Plazi	ffb07bec-2d10-492d-9c37-361fe0b79427	4d76ea5b-ee7f-4361-8f18-595631a770e6
245	245	0	Colombian Biodiversity Information System	7e865cba-7c46-417b-ade5-97f2cf5b7be0	4eeb60e1-bf1d-4a4e-889b-595d310d4a58
211	211	0	GBIF France	da44cd31-5901-4687-a106-6d1c7734ee3a	506a416f-f039-46c2-a5e8-8c7ad059337a
2	2	0	Plazi	ffb07bec-2d10-492d-9c37-361fe0b79427	51f2c0dd-1aa1-428a-ad17-3aa8edffa1bc
1376	1376	0	Belgian Biodiversity Platform	fb11cfe1-ebc3-45af-9159-17d9fddbcdac	532d4c0b-9f4b-4828-be17-a402ce9d69b0
0	5	5	Plazi	ffb07bec-2d10-492d-9c37-361fe0b79427	5952fb20-23c6-4cd8-bafb-bc3a5f365fb1
0	2	2	Plazi	ffb07bec-2d10-492d-9c37-361fe0b79427	5a9f6406-2f13-440e-b0ce-a8d3fca81ad0
0	7	7	Plazi	ffb07bec-2d10-492d-9c37-361fe0b79427	5c288d47-3d43-4b4a-8a6d-d9b1a8323aa4
242433	260381	17948	GBIF Brazil	cdc9736d-5ff7-4ece-9959-3c744360cdb3	5c9a924c-8d45-4452-8604-415a118578aa
2	2	0	Plazi	ffb07bec-2d10-492d-9c37-361fe0b79427	60f5cc4d-06f9-4000-a3d7-d91255e6a439
74	74	0	GBIF Germany	4f6826f2-4ff6-443d-b966-e6913bd24013	613dd620-f762-11e1-a439-00145eb45e9a
73221	72449	-772	GBIF Germany	4f6826f2-4ff6-443d-b966-e6913bd24013	61a9ca38-b62f-11e2-afcb-00145eb45e9a
28	28	0	GBIF Germany	4f6826f2-4ff6-443d-b966-e6913bd24013	628aac06-f762-11e1-a439-00145eb45e9a
521	484	-37	GBIF Germany	4f6826f2-4ff6-443d-b966-e6913bd24013	656d296c-f762-11e1-a439-00145eb45e9a
0	62	62	Plazi	ffb07bec-2d10-492d-9c37-361fe0b79427	671e7811-8821-4b23-8837-9013eee3219a
36	36	0	GBIF Germany	4f6826f2-4ff6-443d-b966-e6913bd24013	678282d8-f762-11e1-a439-00145eb45e9a
26	26	0	Plazi	ffb07bec-2d10-492d-9c37-361fe0b79427	6826cb8d-8283-4358-9ae9-f0789f4a9879
106	106	0	GBIF Germany	4f6826f2-4ff6-443d-b966-e6913bd24013	687210d2-f762-11e1-a439-00145eb45e9a
84	84	0	GBIF Finland	dd514216-5c7c-45f3-910d-797424cb5be6	6937281d-4953-48d0-bce2-03debeb48709
5	5	0	Plazi	ffb07bec-2d10-492d-9c37-361fe0b79427	69919cbf-aaaa-4af6-a0df-5ffee85c0b38
16	16	0	GBIF Germany	4f6826f2-4ff6-443d-b966-e6913bd24013	6a1bf254-f762-11e1-a439-00145eb45e9a
297	297	0	GBIF Germany	4f6826f2-4ff6-443d-b966-e6913bd24013	6a205bdc-f762-11e1-a439-00145eb45e9a
109	109	0	GBIF Germany	4f6826f2-4ff6-443d-b966-e6913bd24013	6a9c1cd6-f762-11e1-a439-00145eb45e9a
62	62	0	Plazi	ffb07bec-2d10-492d-9c37-361fe0b79427	6ac2f34f-6521-4e02-b7ba-9151c40fdf61
18	18	0	GBIF Germany	4f6826f2-4ff6-443d-b966-e6913bd24013	6b0ff7a0-f762-11e1-a439-00145eb45e9a
18	18	0	GBIF Germany	4f6826f2-4ff6-443d-b966-e6913bd24013	6b924070-f762-11e1-a439-00145eb45e9a
77	77	0	GBIF Germany	4f6826f2-4ff6-443d-b966-e6913bd24013	6cc7a28c-f762-11e1-a439-00145eb45e9a
39	39	0	GBIF Germany	4f6826f2-4ff6-443d-b966-e6913bd24013	6d3eff26-f762-11e1-a439-00145eb45e9a
8066	8066	0	U.S. Geological Survey	8618c64a-93e0-4300-b546-7249e5148ed2	6ddeb057-4516-4811-8246-45f2bfd08215
2544	2544	0	Society for the Management of Electronic Biodiversity Data	97818ee4-1461-4180-bf1d-b3201050124f	6ec2600f-768a-4240-9575-0972fef6c76f
8	8	0	GBIF Germany	4f6826f2-4ff6-443d-b966-e6913bd24013	6fb18436-f762-11e1-a439-00145eb45e9a
181	181	0	GBIF Germany	4f6826f2-4ff6-443d-b966-e6913bd24013	702c6106-f762-11e1-a439-00145eb45e9a
0	180	180	GBIF Spain	1f94b3ca-9345-4d65-afe2-4bace93aa0fe	71ceedac-4422-44ca-9aae-3162d8f88df0
16	16	0	GBIF Germany	4f6826f2-4ff6-443d-b966-e6913bd24013	72a175ca-f762-11e1-a439-00145eb45e9a
30	30	0	GBIF Germany	4f6826f2-4ff6-443d-b966-e6913bd24013	7377b194-f762-11e1-a439-00145eb45e9a
49	49	0	GBIF Germany	4f6826f2-4ff6-443d-b966-e6913bd24013	75e46ba2-f762-11e1-a439-00145eb45e9a
86	86	0	National Biodiversity Network	d897a5b9-35ee-4232-94bd-b0bcaac003c2	771894e7-583a-4873-8a60-f7610402849f
338	338	0	GBIF Germany	4f6826f2-4ff6-443d-b966-e6913bd24013	7749f804-f762-11e1-a439-00145eb45e9a
119	119	0	U.S. Geological Survey	8618c64a-93e0-4300-b546-7249e5148ed2	780dc52e-ae42-4475-9c42-f35f1de7f3c5
2	2	0	GBIF Germany	4f6826f2-4ff6-443d-b966-e6913bd24013	787f0c28-f762-11e1-a439-00145eb45e9a
11	11	0	GBIF Germany	4f6826f2-4ff6-443d-b966-e6913bd24013	78e59a2e-f762-11e1-a439-00145eb45e9a
505	312	-193	GBIF Germany	4f6826f2-4ff6-443d-b966-e6913bd24013	79f1c49c-f762-11e1-a439-00145eb45e9a
0	6	6	Plazi	ffb07bec-2d10-492d-9c37-361fe0b79427	7c40036f-ad81-4d76-8363-ecfd50652c0b
1184	1184	0	GBIF Germany	4f6826f2-4ff6-443d-b966-e6913bd24013	7e26d8ea-f762-11e1-a439-00145eb45e9a
105	105	0	GBIF Germany	4f6826f2-4ff6-443d-b966-e6913bd24013	7f2209d6-f762-11e1-a439-00145eb45e9a
582	544	-38	Biodiversity Information System of Mexico	b324e8e9-9a4c-44fa-8f1a-7f39ea7ab576	7f6776a6-f762-11e1-a439-00145eb45e9a
2427	2427	0	Biodiversity Information System of Mexico	b324e8e9-9a4c-44fa-8f1a-7f39ea7ab576	7fa0eb8e-f762-11e1-a439-00145eb45e9a
8823	8823	0	Biodiversity Information System of Mexico	b324e8e9-9a4c-44fa-8f1a-7f39ea7ab576	7fdc9242-f762-11e1-a439-00145eb45e9a
681	681	0	GBIF Argentina	2426a871-9feb-40a1-96c6-0c593a76b835	80493a5a-d8d8-4ddc-a38a-d32c5bbabc5f
3259	3258	-1	Biodiversity Information System of Mexico	b324e8e9-9a4c-44fa-8f1a-7f39ea7ab576	80a6238c-f762-11e1-a439-00145eb45e9a
42	42	0	GBIF Germany	4f6826f2-4ff6-443d-b966-e6913bd24013	813ed71c-f762-11e1-a439-00145eb45e9a
118	118	0	Belgian Biodiversity Platform	fb11cfe1-ebc3-45af-9159-17d9fddbcdac	81883418-792e-46ae-bec2-3b8fbd735041
71	71	0	GBIF Germany	4f6826f2-4ff6-443d-b966-e6913bd24013	8255cc32-f762-11e1-a439-00145eb45e9a
14	14	0	Plazi	ffb07bec-2d10-492d-9c37-361fe0b79427	82836d3d-dff9-4020-a8fd-f5b434605e60
81	81	0	GBIF Germany	4f6826f2-4ff6-443d-b966-e6913bd24013	828b6946-f762-11e1-a439-00145eb45e9a
0	6	6	Plazi	ffb07bec-2d10-492d-9c37-361fe0b79427	83557c59-7c82-48bc-8b98-7f03d76f77f8
0	48	48	Plazi	ffb07bec-2d10-492d-9c37-361fe0b79427	83568a53-8604-4676-9942-2e91dd529954
108775	117144	8369	GBIF Japan	db5705aa-6a6e-42f1-8942-d77b9f4896ea	84a1a7e0-f762-11e1-a439-00145eb45e9a
13	13	0	GBIF Germany	4f6826f2-4ff6-443d-b966-e6913bd24013	85d9bfe4-f762-11e1-a439-00145eb45e9a
925	822	-103	GBIF Germany	4f6826f2-4ff6-443d-b966-e6913bd24013	86f36f7e-f762-11e1-a439-00145eb45e9a
49	49	0	Participant Node Managers Committee	7f48e0c8-5c96-49ec-b972-30748e339115	8743becd-77f2-4982-a115-02f167f52cae
4258	4258	0	GBIF Ecuador	2dc472f1-c3d9-486d-b3c1-12ca7ba1ed22	884de5ad-81d2-40e0-a454-171c2d246708
50	50	0	Plazi	ffb07bec-2d10-492d-9c37-361fe0b79427	888c4dda-f962-4373-bde4-910cfedf54eb
0	17	17	Plazi	ffb07bec-2d10-492d-9c37-361fe0b79427	89dc14e9-168a-48e6-9288-76b3795281c4
60	60	0	GBIF Germany	4f6826f2-4ff6-443d-b966-e6913bd24013	8a180930-f762-11e1-a439-00145eb45e9a
626	626	0	National Biodiversity Network	d897a5b9-35ee-4232-94bd-b0bcaac003c2	8a309be4-939e-4874-a6ba-6ebee4ebeaac
228	228	0	Canadensys	4db9cfd2-1191-4b9d-b579-0b68ceabd968	8a4c7a23-7732-4ba2-b51d-c2cc885ec44c
4	4	0	GBIF Germany	4f6826f2-4ff6-443d-b966-e6913bd24013	8b873246-f762-11e1-a439-00145eb45e9a
12	12	0	GBIF Germany	4f6826f2-4ff6-443d-b966-e6913bd24013	8bc665b0-f762-11e1-a439-00145eb45e9a
21	21	0	GBIF Germany	4f6826f2-4ff6-443d-b966-e6913bd24013	8bd799f2-f762-11e1-a439-00145eb45e9a
0	13	13	Plazi	ffb07bec-2d10-492d-9c37-361fe0b79427	8c7b101c-ddac-4dca-9c6c-2c36811a4a94
12	6	-6	GBIF Germany	4f6826f2-4ff6-443d-b966-e6913bd24013	8dbef652-f762-11e1-a439-00145eb45e9a
4389	2156	-2233	GBIF Germany	4f6826f2-4ff6-443d-b966-e6913bd24013	8edbfcf6-f762-11e1-a439-00145eb45e9a
3	3	0	GBIF Germany	4f6826f2-4ff6-443d-b966-e6913bd24013	9003ce7e-f762-11e1-a439-00145eb45e9a
911	638	-273	GBIF Germany	4f6826f2-4ff6-443d-b966-e6913bd24013	901e2e68-f762-11e1-a439-00145eb45e9a
249	171	-78	GBIF Germany	4f6826f2-4ff6-443d-b966-e6913bd24013	9033d70e-f762-11e1-a439-00145eb45e9a
978	524	-454	GBIF Germany	4f6826f2-4ff6-443d-b966-e6913bd24013	918c839e-f762-11e1-a439-00145eb45e9a
385	363	-22	GBIF Germany	4f6826f2-4ff6-443d-b966-e6913bd24013	91bc7f5e-f762-11e1-a439-00145eb45e9a
259	148	-111	GBIF Germany	4f6826f2-4ff6-443d-b966-e6913bd24013	91c2efa6-f762-11e1-a439-00145eb45e9a
40	40	0	Plazi	ffb07bec-2d10-492d-9c37-361fe0b79427	91cdc97e-ac24-4299-a478-ccd02ca8e1b6
656	656	0	GBIF Germany	4f6826f2-4ff6-443d-b966-e6913bd24013	92f0cd9e-f762-11e1-a439-00145eb45e9a
6854	6854	0	Biodiversity Information System of Mexico	b324e8e9-9a4c-44fa-8f1a-7f39ea7ab576	9480864d-911f-4d91-b62c-730dac2fa9ef
5	5	0	Plazi	ffb07bec-2d10-492d-9c37-361fe0b79427	9696fd7a-6800-46ae-bfa9-bdd438ecf87f
0	47	47	Plazi	ffb07bec-2d10-492d-9c37-361fe0b79427	9730d2b0-31d4-421c-8ca9-d7c8cf5b89e4
0	11	11	Plazi	ffb07bec-2d10-492d-9c37-361fe0b79427	985a0e09-5ed8-4596-9047-fc5fe27db488
0	78	78	Ocean Biodiversity Information System	ba0670b9-4186-41e6-8e70-f9cb3065551a	9940956a-a0c5-49ff-a0e9-50130e5fcccf
53	53	0	GBIF France	da44cd31-5901-4687-a106-6d1c7734ee3a	9b9cbcde-e88a-45fd-8e3a-ddc78e09e7a4
28	28	0	Korean Biodiversity Information Facility	e0a1e772-0177-4800-94b4-2d023fe6cdf4	9bdc97e2-27fc-11e2-85e3-00145eb45e9a
0	64	64	Plazi	ffb07bec-2d10-492d-9c37-361fe0b79427	9f61a8f4-e078-438d-83b5-ff81b62e4094
2	2	0	Plazi	ffb07bec-2d10-492d-9c37-361fe0b79427	a195da67-aea6-4d2a-8426-8d48fc002fd5
0	3	3	Plazi	ffb07bec-2d10-492d-9c37-361fe0b79427	a95c1200-7460-4d31-b427-868bad0d8f8d
1929	1929	0	GBIF France	da44cd31-5901-4687-a106-6d1c7734ee3a	aa5da030-081b-4139-aef2-96490461327f
10000	10000	0	GBIF Japan	db5705aa-6a6e-42f1-8942-d77b9f4896ea	b185d466-1a87-41d0-8e75-55a1bbba190e
228	228	0	National Biodiversity Network	d897a5b9-35ee-4232-94bd-b0bcaac003c2	b1eed6c5-304b-41d3-bdbf-fa4052eb341e
24370	24370	0	GBIF France	da44cd31-5901-4687-a106-6d1c7734ee3a	b4b8935c-9ede-43ad-9326-84065b36c927
0	1416	1416	Colombian Biodiversity Information System	7e865cba-7c46-417b-ade5-97f2cf5b7be0	b596f384-6cd7-4a48-92a5-cf8847877262
2116	2116	0	GBIF Norway	4f829580-180d-46a9-9c87-ed8ec959b545	b5a50aa1-ce8b-4e54-ac05-310fa1c01303
0	2	2	Plazi	ffb07bec-2d10-492d-9c37-361fe0b79427	b5a5e5c1-ef26-460e-b1cf-ad938a61ee10
7	7	0	Plazi	ffb07bec-2d10-492d-9c37-361fe0b79427	b6c7a55f-7977-4e23-9e1f-cad76f51a8fa
0	321	321	Ocean Biodiversity Information System	ba0670b9-4186-41e6-8e70-f9cb3065551a	bceba6e4-7951-49f9-b528-30d85cdd8af5
38	38	0	Plazi	ffb07bec-2d10-492d-9c37-361fe0b79427	be296498-498b-4ca0-8ad8-b27efd52bc9d
0	16	16	Plazi	ffb07bec-2d10-492d-9c37-361fe0b79427	c00b4963-601d-4b17-a541-8a00d6bdd51a
64	64	0	National Biodiversity Network	d897a5b9-35ee-4232-94bd-b0bcaac003c2	c10629c3-3b43-4478-8ab7-f2b8a61147a7
0	277	277	Plazi	ffb07bec-2d10-492d-9c37-361fe0b79427	c8549a2b-d586-48a7-95ad-ab9994239cac
12272	12272	0	GBIF France	da44cd31-5901-4687-a106-6d1c7734ee3a	cdb90879-7112-4023-b753-c74d6f39c6ce
1	1	0	Plazi	ffb07bec-2d10-492d-9c37-361fe0b79427	ce4bce0a-8b65-44d4-a020-a0f081e7358e
0	53	53	Colombian Biodiversity Information System	7e865cba-7c46-417b-ade5-97f2cf5b7be0	ce4e902c-128f-455a-9152-5ead20f1d475
17103	17103	0	Belgian Biodiversity Platform	fb11cfe1-ebc3-45af-9159-17d9fddbcdac	d4f4481a-03e0-46d4-a712-610fc721749a
0	3108	3108	National Biodiversity Network	d897a5b9-35ee-4232-94bd-b0bcaac003c2	d53b5a65-b746-4703-9047-74a2ae9848a8
557	557	0	National Biodiversity Network	d897a5b9-35ee-4232-94bd-b0bcaac003c2	d9e024f5-dec1-4b96-abe3-ee29f06100cb
83	83	0	Plazi	ffb07bec-2d10-492d-9c37-361fe0b79427	de8bc64e-676c-49e3-a3b1-8dd1beb72604
55	50	-5	GBIF Brazil	cdc9736d-5ff7-4ece-9959-3c744360cdb3	e01ee351-4941-468b-b0f2-c2c9ba1bcb34
2481	2481	0	National Biodiversity Network	d897a5b9-35ee-4232-94bd-b0bcaac003c2	e53c674a-eedc-4b53-9451-dcad9b9ada86
1	1	0	Plazi	ffb07bec-2d10-492d-9c37-361fe0b79427	e65005e3-88a0-4c50-a410-9390b724c812
22	22	0	Colombian Biodiversity Information System	7e865cba-7c46-417b-ade5-97f2cf5b7be0	ea255153-a572-410d-ab3c-5f862978d873
1244	1244	0	National Biodiversity Network	d897a5b9-35ee-4232-94bd-b0bcaac003c2	ebf5de13-4c38-40a5-98f8-d423e0d12c14
7	7	0	Plazi	ffb07bec-2d10-492d-9c37-361fe0b79427	ec21f908-905e-4e5d-afb5-e9ae7c273553
4527	4527	0	National Biodiversity Network	d897a5b9-35ee-4232-94bd-b0bcaac003c2	ecbd07b1-01be-4429-9731-396d8f2043c6
46	46	0	Plazi	ffb07bec-2d10-492d-9c37-361fe0b79427	f0671b1e-4584-4ec1-9583-fae2d99e4e74
0	230	230	Plazi	ffb07bec-2d10-492d-9c37-361fe0b79427	f366dee6-1d72-489c-a58f-d156f1d2bbc5
166	166	0	GBIF France	da44cd31-5901-4687-a106-6d1c7734ee3a	f76562b9-b2a0-4c48-be20-cbe1db5dabc7
6	6	0	Plazi	ffb07bec-2d10-492d-9c37-361fe0b79427	f98dcb22-fe0e-4b16-ac89-f0106a853bc8
464	464	0	ASEAN Centre for Biodiversity	af2a0fa1-4c8e-4bdc-8954-b1a55e32b0f1	f9f67808-1e18-4175-9ff9-cd4b876ef90b
7703	7703	0	GBIF Benin	efb9c00e-f802-45dd-8826-a52ec45b89ff	fd683b66-1c8c-40d2-b4c4-8996a70f0eb6
4	4	0	Plazi	ffb07bec-2d10-492d-9c37-361fe0b79427	fe6bc733-5663-4259-8519-b8094a60ef6b
4104	4104	0	GBIF France	da44cd31-5901-4687-a106-6d1c7734ee3a	0001480b-76ca-4f30-86bc-f4292481554b
3633	3633	0	U.S. Geological Survey	8618c64a-93e0-4300-b546-7249e5148ed2	0096dfc0-9925-47ef-9700-9b77814295f1
63	63	0	Plazi	ffb07bec-2d10-492d-9c37-361fe0b79427	00c2787c-b305-46c2-8443-d82558ee3603
4	4	0	Plazi	ffb07bec-2d10-492d-9c37-361fe0b79427	02324d79-ea25-42a2-bb7e-93f6c2b0b3b0
114	114	0	Colombian Biodiversity Information System	7e865cba-7c46-417b-ade5-97f2cf5b7be0	029af296-86bb-42a0-b812-ed9c810b0e6f
1013	1547	534	U.S. Geological Survey	8618c64a-93e0-4300-b546-7249e5148ed2	02fbd55d-d574-460b-bccc-d9a2eab564f0
0	7	7	Plazi	ffb07bec-2d10-492d-9c37-361fe0b79427	037e41e2-2ccf-4655-96d6-1b1949c4f1e6
475	295	-180	Colombian Biodiversity Information System	7e865cba-7c46-417b-ade5-97f2cf5b7be0	03a84058-3571-46c8-837f-efd412152734
43	43	0	Plazi	ffb07bec-2d10-492d-9c37-361fe0b79427	04bc4f07-1283-4058-9641-2fce5ee10aca
99	99	0	Plazi	ffb07bec-2d10-492d-9c37-361fe0b79427	05cebf46-ed3d-4b8b-8166-f3d8b14dd53c
0	1	1	Plazi	ffb07bec-2d10-492d-9c37-361fe0b79427	0814409e-31db-4c28-ad47-2b355cd77ee2
4	4	0	Plazi	ffb07bec-2d10-492d-9c37-361fe0b79427	0be43b36-2678-45a5-acfc-bec202ecb14a
4	4	0	Plazi	ffb07bec-2d10-492d-9c37-361fe0b79427	0c063e90-7fb2-43d2-b200-e7c68a9ef57d
603	603	0	Colombian Biodiversity Information System	7e865cba-7c46-417b-ade5-97f2cf5b7be0	0ca21140-f9a0-401b-91bc-54abc153a989
1	1	0	Plazi	ffb07bec-2d10-492d-9c37-361fe0b79427	0e563550-86f8-4247-ad03-a987fb9fb088
24	31	7	Plazi	ffb07bec-2d10-492d-9c37-361fe0b79427	0f0f11d9-27bb-487e-93e0-6c33ec5958b6
54	54	0	Plazi	ffb07bec-2d10-492d-9c37-361fe0b79427	0fd5ecf7-48de-4920-8ef5-93b6537f735e
0	63	63	Plazi	ffb07bec-2d10-492d-9c37-361fe0b79427	1077fd63-c43e-4a3e-a41c-883132e4f22d
255	255	0	GBIF France	da44cd31-5901-4687-a106-6d1c7734ee3a	11c93492-f1f0-43f3-9c22-611e9d439c41
0	4	4	Colombian Biodiversity Information System	7e865cba-7c46-417b-ade5-97f2cf5b7be0	14845aef-0bd0-4634-bd77-574302b7eb8c
1	1	0	National Biodiversity Network	d897a5b9-35ee-4232-94bd-b0bcaac003c2	15f6a1fe-d4d9-4901-9603-3e97a2aa99ff
0	11	11	Plazi	ffb07bec-2d10-492d-9c37-361fe0b79427	184a392f-3fce-4697-b9af-87004f7d3f76
56	56	0	Plazi	ffb07bec-2d10-492d-9c37-361fe0b79427	1900f828-2e5e-41fa-9917-752c41a5315e
0	11	11	Plazi	ffb07bec-2d10-492d-9c37-361fe0b79427	19ae92f8-a0de-483d-8700-181cf194a4af
9	9	0	Plazi	ffb07bec-2d10-492d-9c37-361fe0b79427	1a03f820-c002-412d-b983-927d31228619
25	25	0	Plazi	ffb07bec-2d10-492d-9c37-361fe0b79427	1a8adc12-867c-42d3-9bc5-86bc61c00d8d
9	9	0	Plazi	ffb07bec-2d10-492d-9c37-361fe0b79427	1cad572f-e5f8-4c31-a21f-6454151aae7a
16	16	0	GBIF Brazil	cdc9736d-5ff7-4ece-9959-3c744360cdb3	1d3adc8c-879b-430e-bc4b-515cfaef9147
0	9	9	Plazi	ffb07bec-2d10-492d-9c37-361fe0b79427	1dabe90e-f864-4fad-8c0c-08cb810fd983
268	268	0	ASEAN Centre for Biodiversity	af2a0fa1-4c8e-4bdc-8954-b1a55e32b0f1	1e0b1c77-17a3-458f-9fe7-4de91b6e564b
0	10	10	Plazi	ffb07bec-2d10-492d-9c37-361fe0b79427	1f858329-d759-403a-829c-08f2ba4e1403
10	10	0	Participant Node Managers Committee	7f48e0c8-5c96-49ec-b972-30748e339115	1fb89c2a-2c5c-4084-ae73-28cc753fe206
250	250	0	GBIF France	da44cd31-5901-4687-a106-6d1c7734ee3a	21713d6d-e569-4011-adef-702296230b6a
0	9	9	Colombian Biodiversity Information System	7e865cba-7c46-417b-ade5-97f2cf5b7be0	23543f9c-9213-4d6a-a41e-0651721ba078
5540	5540	0	Belgian Biodiversity Platform	fb11cfe1-ebc3-45af-9159-17d9fddbcdac	23a554c4-a5ba-4600-aa2c-fb44035b7f65
60	60	0	GBIF France	da44cd31-5901-4687-a106-6d1c7734ee3a	23bb3604-2ac1-4c51-a267-efc2b6bd2e9e
19198	19198	0	South African Biodiversity Information Facility	7190b835-4e86-4b6e-85c1-19cc6677c250	2429f28c-dc43-40e7-92f6-49206e0729fb
0	34	34	Plazi	ffb07bec-2d10-492d-9c37-361fe0b79427	25efbb90-245c-4391-8d17-fd75b5c35e86
49152	58257	9105	GBIF Japan	db5705aa-6a6e-42f1-8942-d77b9f4896ea	25f99a40-2327-4c57-9631-1a0825d834fa
130389	134109	3720	GBIF Norway	4f829580-180d-46a9-9c87-ed8ec959b545	264e6a66-9c9e-4115-9aec-29d694c68097
0	270474	270474	Ocean Biodiversity Information System	ba0670b9-4186-41e6-8e70-f9cb3065551a	291e47e6-1cb6-4211-9fbd-4f06accb1c37
0	37	37	Plazi	ffb07bec-2d10-492d-9c37-361fe0b79427	2a05c6d9-5e8a-4ce7-97ad-05fe1bb9d338
0	2	2	Plazi	ffb07bec-2d10-492d-9c37-361fe0b79427	2b7f92c6-3055-451d-bdd1-11fa5283d226
2	2	0	Plazi	ffb07bec-2d10-492d-9c37-361fe0b79427	2e12b6f4-3106-47aa-8332-5ef9efa64219
0	4	4	Plazi	ffb07bec-2d10-492d-9c37-361fe0b79427	2e17f413-c109-4946-88e9-629c67eebb8d
128	128	0	GBIF Brazil	cdc9736d-5ff7-4ece-9959-3c744360cdb3	2e893cc7-9663-4ec6-b565-732b0bf370a6
272652	272652	0	U.S. Geological Survey	8618c64a-93e0-4300-b546-7249e5148ed2	2f1f9ef5-07bf-4ddb-931a-930f251de793
6480	6480	0	GBIF Germany	4f6826f2-4ff6-443d-b966-e6913bd24013	2f391085-e522-4662-afa6-953433267374
0	474	474	Participant Node Managers Committee	7f48e0c8-5c96-49ec-b972-30748e339115	30b05a3a-5657-4c57-ba7c-11f1ffa8617b
0	107	107	Plazi	ffb07bec-2d10-492d-9c37-361fe0b79427	30d744f5-bae6-47ca-a859-50a5059e9a0f
268	268	0	GBIF France	da44cd31-5901-4687-a106-6d1c7734ee3a	324786f2-fc83-42b8-89be-25d23b352997
49726	49726	0	Participant Node Managers Committee	7f48e0c8-5c96-49ec-b972-30748e339115	3412de46-ed80-42c1-9e7b-42a1e040e66e
72	72	0	Biodiversity Information System of Mexico	b324e8e9-9a4c-44fa-8f1a-7f39ea7ab576	37047a44-94fa-4b4d-8d5f-1ab45a25b7d1
0	838	838	East Asia Biodiversity Conservation Network	06139ec9-4933-4f4e-8151-1d36ad9ae171	37663a11-6c27-4b72-a3bc-75c9dab75a83
16	16	0	Plazi	ffb07bec-2d10-492d-9c37-361fe0b79427	386010a0-6da4-4fa3-9d1a-4b3b5427cac5
73	73	0	Participant Node Managers Committee	7f48e0c8-5c96-49ec-b972-30748e339115	3c5f4a3d-7d3b-48f3-8146-0d26f2a65d67
56	56	0	Colombian Biodiversity Information System	7e865cba-7c46-417b-ade5-97f2cf5b7be0	3da2119a-17b2-4998-b49a-93e0bd8ca367
26	26	0	GBIF France	da44cd31-5901-4687-a106-6d1c7734ee3a	3fb5c0d3-9217-4a34-ad58-d55fa71f5320
24	24	0	Plazi	ffb07bec-2d10-492d-9c37-361fe0b79427	402c14ec-eb61-449c-b1fe-0d2c5b131153
3	3	0	Plazi	ffb07bec-2d10-492d-9c37-361fe0b79427	4100222a-e0a7-4170-985c-ef3626ed966a
20	20	0	Plazi	ffb07bec-2d10-492d-9c37-361fe0b79427	418857d6-7aeb-41f1-87f7-ab963fc7f5a1
241	241	0	Ocean Biodiversity Information System	ba0670b9-4186-41e6-8e70-f9cb3065551a	426684ec-6648-4b29-bad5-6af3835d099a
38	38	0	GBIF Germany	4f6826f2-4ff6-443d-b966-e6913bd24013	427b6648-3d7e-4e57-9df4-3741a5cf2122
0	54	54	Plazi	ffb07bec-2d10-492d-9c37-361fe0b79427	43278c49-82a8-40a3-88c8-6e28bfb08a7e
6	6	0	Plazi	ffb07bec-2d10-492d-9c37-361fe0b79427	432e3e3c-a234-4761-9951-7245050598ad
18	18	0	GBIF Spain	1f94b3ca-9345-4d65-afe2-4bace93aa0fe	4506857c-ac05-4d0a-a8ea-3223f60e1c5a
0	775	775	Netherlands Biodiversity Information Facility	0909d601-bda2-42df-9e63-a6d51847ebce	45a43bcf-e3bd-44a0-9c66-72d9c8e4f111
0	8	8	Plazi	ffb07bec-2d10-492d-9c37-361fe0b79427	46154d1c-9cf2-42dd-add3-377772bdced3
1	1	0	Plazi	ffb07bec-2d10-492d-9c37-361fe0b79427	47687c89-da3f-4248-ac8b-03bae2c18e2a
0	1553	1553	Ocean Biodiversity Information System	ba0670b9-4186-41e6-8e70-f9cb3065551a	4cacb0be-46e8-446a-aa83-bb9e5bcc4d48
5198	5198	0	Participant Node Managers Committee	7f48e0c8-5c96-49ec-b972-30748e339115	514dc3dd-4723-48a6-a219-8a9ea062a537
50877	50877	0	U.S. Geological Survey	8618c64a-93e0-4300-b546-7249e5148ed2	5325ba61-44e7-4d92-ac11-868b3294b3bb
0	73	73	Plazi	ffb07bec-2d10-492d-9c37-361fe0b79427	573870ee-8058-46ab-8880-61a2ee49bcb6
636	636	0	Biodiversity Information System of Mexico	b324e8e9-9a4c-44fa-8f1a-7f39ea7ab576	57550900-49f2-4b35-857c-014f175d9d3d
2	2	0	Plazi	ffb07bec-2d10-492d-9c37-361fe0b79427	588d710f-81f2-4e81-b166-f888acf7dc60
0	22	22	Plazi	ffb07bec-2d10-492d-9c37-361fe0b79427	58ea28c2-03f1-4e50-b1f3-596aedd0d4e6
725	725	0	GBIF France	da44cd31-5901-4687-a106-6d1c7734ee3a	5a5e0a14-bb90-4e62-be79-9f5ed7e0b28c
3	3	0	Plazi	ffb07bec-2d10-492d-9c37-361fe0b79427	5a8e4dd1-aaae-4c9b-931a-376bd12ce80b
42	42	0	Plazi	ffb07bec-2d10-492d-9c37-361fe0b79427	5c08332f-013c-4481-b831-b61f4c47f0ee
7	7	0	Plazi	ffb07bec-2d10-492d-9c37-361fe0b79427	5cb7d5d0-e5da-4227-ad4c-f7435f09336d
0	6	6	Plazi	ffb07bec-2d10-492d-9c37-361fe0b79427	5d95b362-d3b6-4770-8cec-6509cccb925f
110	110	0	Plazi	ffb07bec-2d10-492d-9c37-361fe0b79427	5dac3069-b21b-4198-b011-4ec91199dbad
58	58	0	GBIF Germany	4f6826f2-4ff6-443d-b966-e6913bd24013	622d24dc-f762-11e1-a439-00145eb45e9a
23	23	0	GBIF Germany	4f6826f2-4ff6-443d-b966-e6913bd24013	626fab4a-f762-11e1-a439-00145eb45e9a
1	1	0	GBIF Japan	db5705aa-6a6e-42f1-8942-d77b9f4896ea	6297bb5f-e3f0-4fda-90a0-3be740029c5b
4	4	0	Plazi	ffb07bec-2d10-492d-9c37-361fe0b79427	62abaddb-dee2-4539-b3df-b529c94b0909
17	17	0	GBIF Germany	4f6826f2-4ff6-443d-b966-e6913bd24013	646dc490-f762-11e1-a439-00145eb45e9a
103	103	0	GBIF Germany	4f6826f2-4ff6-443d-b966-e6913bd24013	64afa4fa-f762-11e1-a439-00145eb45e9a
143	143	0	GBIF Germany	4f6826f2-4ff6-443d-b966-e6913bd24013	64e16396-f762-11e1-a439-00145eb45e9a
21	21	0	Plazi	ffb07bec-2d10-492d-9c37-361fe0b79427	64e78db8-9b9c-477a-bbc5-aff043ad9b51
5	5	0	Plazi	ffb07bec-2d10-492d-9c37-361fe0b79427	65790c4b-e3b3-49ea-9e04-a1e03638b1de
0	2	2	Plazi	ffb07bec-2d10-492d-9c37-361fe0b79427	66d724df-4ade-462a-bf73-6a53294ff2ba
75	75	0	GBIF Germany	4f6826f2-4ff6-443d-b966-e6913bd24013	6748a98c-f762-11e1-a439-00145eb45e9a
62	62	0	GBIF Germany	4f6826f2-4ff6-443d-b966-e6913bd24013	6775b85a-f762-11e1-a439-00145eb45e9a
214	214	0	GBIF Germany	4f6826f2-4ff6-443d-b966-e6913bd24013	6791d24c-f762-11e1-a439-00145eb45e9a
96	96	0	GBIF Germany	4f6826f2-4ff6-443d-b966-e6913bd24013	6866b494-f762-11e1-a439-00145eb45e9a
134	134	0	GBIF France	da44cd31-5901-4687-a106-6d1c7734ee3a	6a9181f2-6f76-4c08-a6a6-76ec03b5ba98
42	42	0	GBIF Germany	4f6826f2-4ff6-443d-b966-e6913bd24013	6ab9056c-f762-11e1-a439-00145eb45e9a
8	8	0	GBIF Germany	4f6826f2-4ff6-443d-b966-e6913bd24013	6adb395c-f762-11e1-a439-00145eb45e9a
18	18	0	GBIF Germany	4f6826f2-4ff6-443d-b966-e6913bd24013	6be9d858-f762-11e1-a439-00145eb45e9a
483	483	0	GBIF Germany	4f6826f2-4ff6-443d-b966-e6913bd24013	715a876a-f762-11e1-a439-00145eb45e9a
3347	3347	0	GBIF Japan	db5705aa-6a6e-42f1-8942-d77b9f4896ea	71e23034-f762-11e1-a439-00145eb45e9a
77	49	-28	GBIF Germany	4f6826f2-4ff6-443d-b966-e6913bd24013	722a2e98-f762-11e1-a439-00145eb45e9a
10	10	0	GBIF Germany	4f6826f2-4ff6-443d-b966-e6913bd24013	729abc76-f762-11e1-a439-00145eb45e9a
5	5	0	Plazi	ffb07bec-2d10-492d-9c37-361fe0b79427	72e05018-198f-4241-81da-c1d47d9ba394
72	72	0	GBIF Germany	4f6826f2-4ff6-443d-b966-e6913bd24013	74f86fe0-f762-11e1-a439-00145eb45e9a
12	13	1	GBIF Germany	4f6826f2-4ff6-443d-b966-e6913bd24013	79bb2a9d-3d55-47b9-8274-7d481b21d1c0
0	7	7	Plazi	ffb07bec-2d10-492d-9c37-361fe0b79427	7a0e79f9-c181-4609-963a-bc22fadf7705
2398	1518	-880	GBIF Germany	4f6826f2-4ff6-443d-b966-e6913bd24013	7a1bcc88-f762-11e1-a439-00145eb45e9a
0	2130	2130	Ocean Biodiversity Information System	ba0670b9-4186-41e6-8e70-f9cb3065551a	7b897957-9fe2-484c-8ee1-a56dce78ba82
44	44	0	Secretariat of the Pacific Regional Environment Programme	29c6a139-ea7f-41f5-8d9b-c55af8736182	7c04550d-b2f6-4879-9ace-023752f6ad7a
76	76	0	GBIF Germany	4f6826f2-4ff6-443d-b966-e6913bd24013	7c3a6e52-f762-11e1-a439-00145eb45e9a
23	23	0	GBIF Germany	4f6826f2-4ff6-443d-b966-e6913bd24013	7d71d3f0-f762-11e1-a439-00145eb45e9a
27	14	-13	GBIF Germany	4f6826f2-4ff6-443d-b966-e6913bd24013	7e10d28e-f762-11e1-a439-00145eb45e9a
373	186	-187	GBIF Germany	4f6826f2-4ff6-443d-b966-e6913bd24013	7e1e36ae-f762-11e1-a439-00145eb45e9a
2790	2790	0	GBIF Spain	1f94b3ca-9345-4d65-afe2-4bace93aa0fe	7f50181c-f762-11e1-a439-00145eb45e9a
2618	2618	0	GBIF Germany	4f6826f2-4ff6-443d-b966-e6913bd24013	81ede8e2-f762-11e1-a439-00145eb45e9a
1887	1887	0	GBIF Germany	4f6826f2-4ff6-443d-b966-e6913bd24013	81ffa2d0-f762-11e1-a439-00145eb45e9a
18	18	0	Plazi	ffb07bec-2d10-492d-9c37-361fe0b79427	8214b5e5-1f17-4d4b-93eb-e7e0c383ab6e
270	157	-113	GBIF Germany	4f6826f2-4ff6-443d-b966-e6913bd24013	8234a67e-f762-11e1-a439-00145eb45e9a
14	14	0	GBIF Germany	4f6826f2-4ff6-443d-b966-e6913bd24013	82651d0e-f762-11e1-a439-00145eb45e9a
694	694	0	GBIF France	da44cd31-5901-4687-a106-6d1c7734ee3a	827baa21-ab0e-436b-9dd5-5a600d1ffccd
6560	6560	0	GBIF Spain	1f94b3ca-9345-4d65-afe2-4bace93aa0fe	838350b6-f762-11e1-a439-00145eb45e9a
5782	5782	0	Ocean Biodiversity Information System	ba0670b9-4186-41e6-8e70-f9cb3065551a	83a3f29e-f762-11e1-a439-00145eb45e9a
886	886	0	GBIF Finland	dd514216-5c7c-45f3-910d-797424cb5be6	84eb976a-f762-11e1-a439-00145eb45e9a
35406	34707	-699	U.S. Geological Survey	8618c64a-93e0-4300-b546-7249e5148ed2	8539cd0e-f762-11e1-a439-00145eb45e9a
87	87	0	GBIF Japan	db5705aa-6a6e-42f1-8942-d77b9f4896ea	8688dcfe-f762-11e1-a439-00145eb45e9a
544	476	-68	GBIF Germany	4f6826f2-4ff6-443d-b966-e6913bd24013	8806f566-f762-11e1-a439-00145eb45e9a
0	2	2	Plazi	ffb07bec-2d10-492d-9c37-361fe0b79427	889b2f52-c3d4-4671-bdb9-b902cc0e653e
1268	1268	0	Ocean Biodiversity Information System	ba0670b9-4186-41e6-8e70-f9cb3065551a	891bd4ee-f762-11e1-a439-00145eb45e9a
156	156	0	GBIF Germany	4f6826f2-4ff6-443d-b966-e6913bd24013	89d1501c-f762-11e1-a439-00145eb45e9a
176	176	0	Colombian Biodiversity Information System	7e865cba-7c46-417b-ade5-97f2cf5b7be0	8b256ea0-fc76-4712-8a86-ff1f0a2ad3d1
496	496	0	GBIF Germany	4f6826f2-4ff6-443d-b966-e6913bd24013	8be6825a-f762-11e1-a439-00145eb45e9a
0	3	3	Plazi	ffb07bec-2d10-492d-9c37-361fe0b79427	8c6824d6-3cdc-404b-a2aa-35080929454b
2	1	-1	GBIF Germany	4f6826f2-4ff6-443d-b966-e6913bd24013	8d132ffc-f762-11e1-a439-00145eb45e9a
19	16	-3	GBIF Germany	4f6826f2-4ff6-443d-b966-e6913bd24013	8d277bce-f762-11e1-a439-00145eb45e9a
247	247	0	GBIF Germany	4f6826f2-4ff6-443d-b966-e6913bd24013	8d9b3378-c9df-45e8-884b-d2134b8bbe21
11	5	-6	GBIF Germany	4f6826f2-4ff6-443d-b966-e6913bd24013	8e53a8a6-f762-11e1-a439-00145eb45e9a
53	23	-30	GBIF Germany	4f6826f2-4ff6-443d-b966-e6913bd24013	8e6c2e6c-f762-11e1-a439-00145eb45e9a
7	6	-1	GBIF Germany	4f6826f2-4ff6-443d-b966-e6913bd24013	8f3833ae-f762-11e1-a439-00145eb45e9a
4	4	0	Plazi	ffb07bec-2d10-492d-9c37-361fe0b79427	9010e0ee-8975-4446-b752-52bb9bc64eb2
465	285	-180	GBIF Germany	4f6826f2-4ff6-443d-b966-e6913bd24013	90636d20-f762-11e1-a439-00145eb45e9a
1834	1242	-592	GBIF Germany	4f6826f2-4ff6-443d-b966-e6913bd24013	9087a46a-f762-11e1-a439-00145eb45e9a
658082	658082	0	U.S. Geological Survey	8618c64a-93e0-4300-b546-7249e5148ed2	90c853e6-56bd-480b-8e8f-6285c3f8d42b
2340	2340	0	GBIF Germany	4f6826f2-4ff6-443d-b966-e6913bd24013	91b9d966-f762-11e1-a439-00145eb45e9a
278	238	-40	GBIF Germany	4f6826f2-4ff6-443d-b966-e6913bd24013	944f4260-f762-11e1-a439-00145eb45e9a
3	3	0	Plazi	ffb07bec-2d10-492d-9c37-361fe0b79427	94ec31b4-3c46-43de-846d-e209140d4190
2	2	0	Plazi	ffb07bec-2d10-492d-9c37-361fe0b79427	962b04f6-8f8f-4e36-a028-74bfe7d22eac
4946	5377	431	GBIF Germany	4f6826f2-4ff6-443d-b966-e6913bd24013	966b5af2-f762-11e1-a439-00145eb45e9a
259	259	0	GBIF Germany	4f6826f2-4ff6-443d-b966-e6913bd24013	96d59d40-f762-11e1-a439-00145eb45e9a
14	14	0	GBIF Germany	4f6826f2-4ff6-443d-b966-e6913bd24013	979d3f62-f762-11e1-a439-00145eb45e9a
7	7	0	Plazi	ffb07bec-2d10-492d-9c37-361fe0b79427	9cf2f92d-0c60-41da-891a-0452fe205926
98	98	0	Korean Biodiversity Information Facility	e0a1e772-0177-4800-94b4-2d023fe6cdf4	9d392768-27fc-11e2-85e3-00145eb45e9a
15	15	0	Colombian Biodiversity Information System	7e865cba-7c46-417b-ade5-97f2cf5b7be0	9ef17b23-5c90-44b4-8433-d54cf5cb6209
1	1	0	Plazi	ffb07bec-2d10-492d-9c37-361fe0b79427	9f1d6ce5-45e6-4798-acdc-f155716b37c8
108	108	0	Plazi	ffb07bec-2d10-492d-9c37-361fe0b79427	a069bd52-2bf8-45ee-98b7-2a6d1fcf5cac
800	800	0	GBIF Chile	a8b16421-d80b-4ef3-8f22-098b01a89255	a34c0ba4-bf4b-4de2-a037-b13818f67691
0	4	4	Ocean Biodiversity Information System	ba0670b9-4186-41e6-8e70-f9cb3065551a	a7d23414-6898-4b3d-a846-c84c9cf9fe07
0	1	1	Plazi	ffb07bec-2d10-492d-9c37-361fe0b79427	a9d9198b-c216-4a7b-a68a-64b85ee81972
7	7	0	Plazi	ffb07bec-2d10-492d-9c37-361fe0b79427	a9deb3a0-a087-4943-9618-5673c9d6a750
0	105	105	Ocean Biodiversity Information System	ba0670b9-4186-41e6-8e70-f9cb3065551a	aaf09d5e-63be-498e-a969-04b05742fa4d
0	19	19	Plazi	ffb07bec-2d10-492d-9c37-361fe0b79427	b1305c10-d429-4335-aa4b-20786c960972
12924	12924	0	Biodiversity Information System of Mexico	b324e8e9-9a4c-44fa-8f1a-7f39ea7ab576	b2e9b76c-cc2a-4e57-a1cc-f74af7452a4d
0	5	5	Plazi	ffb07bec-2d10-492d-9c37-361fe0b79427	b496729a-abd4-4212-af76-b212cb9c2f88
2	2	0	Plazi	ffb07bec-2d10-492d-9c37-361fe0b79427	b57a5098-dc9f-4615-a3df-c9f4f5aee313
7032	7032	0	GBIF Benin	efb9c00e-f802-45dd-8826-a52ec45b89ff	b6373d58-fcbe-4fed-96cf-d7166131ba8e
671	671	0	Biodiversity Information System of Mexico	b324e8e9-9a4c-44fa-8f1a-7f39ea7ab576	b7bbe158-d96a-4944-93d0-3b3c10463252
0	241	241	GBIF Chile	a8b16421-d80b-4ef3-8f22-098b01a89255	b8df3751-d7ee-409e-ad51-3b63d158624e
32	32	0	National Biodiversity Network	d897a5b9-35ee-4232-94bd-b0bcaac003c2	bb81513d-74ea-4733-b7b9-dc2dc190d367
2128	2128	0	Belgian Biodiversity Platform	fb11cfe1-ebc3-45af-9159-17d9fddbcdac	bbf2e6e6-fc22-4e66-b5e2-c715edadfb42
239	245	6	Colombian Biodiversity Information System	7e865cba-7c46-417b-ade5-97f2cf5b7be0	bc9bb0a4-daa0-4b17-8d0e-bd6d294027fb
3076	3076	0	GBIF Finland	dd514216-5c7c-45f3-910d-797424cb5be6	bdee10a6-b34e-4795-b17a-94c467de28ff
190	190	0	Biodiversity Information System of Mexico	b324e8e9-9a4c-44fa-8f1a-7f39ea7ab576	bec19237-caf3-4e87-96e3-614b4f84f2cb
537	537	0	GBIF Brazil	cdc9736d-5ff7-4ece-9959-3c744360cdb3	bf4641a7-a856-4061-8746-43a9e26db0cb
141	141	0	Ocean Biodiversity Information System	ba0670b9-4186-41e6-8e70-f9cb3065551a	c030569f-86ee-4b01-8c39-8f3c2b4e36c0
0	564	564	Ocean Biodiversity Information System	ba0670b9-4186-41e6-8e70-f9cb3065551a	c80621e4-eb0e-4a42-8125-52840b5db839
0	17	17	Plazi	ffb07bec-2d10-492d-9c37-361fe0b79427	c8c02a66-7a09-4629-ae97-dc01e565f4cf
0	3	3	Plazi	ffb07bec-2d10-492d-9c37-361fe0b79427	c8e0fd9f-00db-464d-8ef5-c7c60610481c
1470	1470	0	Taiwan Biodiversity Information Facility	e1b85abc-61f9-430f-ba79-6813dec53a0f	ca22abc0-98a1-11de-b4da-b8a03c50a862
1078	1078	0	Belgian Biodiversity Platform	fb11cfe1-ebc3-45af-9159-17d9fddbcdac	cca0058d-d593-4c7e-844c-dcc0b8feae86
0	4	4	Plazi	ffb07bec-2d10-492d-9c37-361fe0b79427	d0e30d86-6785-4afc-8196-e741cd89abe6
0	15	15	Plazi	ffb07bec-2d10-492d-9c37-361fe0b79427	d22e3fb7-eaed-40c7-8b5d-d6b3702492cf
0	30	30	Ocean Biodiversity Information System	ba0670b9-4186-41e6-8e70-f9cb3065551a	d3751611-b393-4680-9a6a-d7acb03a00cb
0	2	2	Plazi	ffb07bec-2d10-492d-9c37-361fe0b79427	d6f219b3-482f-4b61-aa5e-b873347f975b
0	2	2	Plazi	ffb07bec-2d10-492d-9c37-361fe0b79427	d977eb12-4e51-4895-acdf-911176226914
1	1	0	Plazi	ffb07bec-2d10-492d-9c37-361fe0b79427	d9964e96-5823-45e8-bc42-210527e70752
20	20	0	GBIF Germany	4f6826f2-4ff6-443d-b966-e6913bd24013	dd000db6-da38-4f26-9169-2c1f0986a47e
0	1	1	Colombian Biodiversity Information System	7e865cba-7c46-417b-ade5-97f2cf5b7be0	dd6297bc-cbad-4996-b3cd-567b6ef71338
14	14	0	Plazi	ffb07bec-2d10-492d-9c37-361fe0b79427	e4ed9868-de79-4041-a79e-86f61ebfc061
0	3	3	Plazi	ffb07bec-2d10-492d-9c37-361fe0b79427	e9daccca-2adf-4427-a8b5-2091d79262bc
2415	2415	0	GBIF France	da44cd31-5901-4687-a106-6d1c7734ee3a	ea94712d-0ac5-465d-a42b-8c600f005241
31	31	0	Plazi	ffb07bec-2d10-492d-9c37-361fe0b79427	eacf640c-9853-4638-8414-18e4337c2a3b
79	79	0	GBIF France	da44cd31-5901-4687-a106-6d1c7734ee3a	ecd40b2a-4bb3-4665-9590-2a3ad24f4864
104	104	0	Taiwan Biodiversity Information Facility	e1b85abc-61f9-430f-ba79-6813dec53a0f	eeba8c4c-f059-4c3a-8f5c-38f1e8622bbb
1	1	0	Plazi	ffb07bec-2d10-492d-9c37-361fe0b79427	efd47c01-0c28-4444-8871-ecf616359b82
1	1	0	Plazi	ffb07bec-2d10-492d-9c37-361fe0b79427	f02345d5-4425-434a-8574-883833ae0b6f
9329	9329	0	GBIF France	da44cd31-5901-4687-a106-6d1c7734ee3a	f03cf033-66d8-4562-bace-f0417532c110
375	375	0	Colombian Biodiversity Information System	7e865cba-7c46-417b-ade5-97f2cf5b7be0	f074862e-ad6a-43da-9e42-c548373ae2a8
0	125	125	Ocean Biodiversity Information System	ba0670b9-4186-41e6-8e70-f9cb3065551a	f2ba136d-fff8-4db4-a389-56289664066d
7	7	0	Plazi	ffb07bec-2d10-492d-9c37-361fe0b79427	f675bc2f-4402-4f94-89da-bf9573c1b6a1
5496	5496	0	Ghana Biodiversity Information Facility	b5633b75-6a86-4fdf-9cfc-506047fb9dc7	f73b742f-69a5-4bb4-9423-53a172d95073
0	4	4	Plazi	ffb07bec-2d10-492d-9c37-361fe0b79427	f8995ba1-80c5-40f0-a243-6ee68bdd4099
1926	1835	-91	Participant Node Managers Committee	7f48e0c8-5c96-49ec-b972-30748e339115	f8b3dfc3-e0d9-4173-a63b-436aedce0469
0	128179	128179	GBIF Sweden	a0b3be64-6525-4387-ac67-a499950f92e1	f8f35535-8c10-43fc-89dc-eb0843f25394
0	81	81	Ocean Biodiversity Information System	ba0670b9-4186-41e6-8e70-f9cb3065551a	fa265552-fbd5-4fc9-b412-4377a31e0b3a
381	381	0	GBIF Japan	db5705aa-6a6e-42f1-8942-d77b9f4896ea	fa48fff5-f29b-4e2f-8b71-d3d4a5a03826
0	12	12	Plazi	ffb07bec-2d10-492d-9c37-361fe0b79427	fb355379-92fc-4f4f-b5d3-f8218065be04
2	2	0	Plazi	ffb07bec-2d10-492d-9c37-361fe0b79427	fd8141e3-acd9-48d3-a787-dfc1dbeca1cf
0	1	1	Participant Node Managers Committee	7f48e0c8-5c96-49ec-b972-30748e339115	ff772d79-bebd-43d1-9a36-55f3db4de1c1
0	20	20	Plazi	ffb07bec-2d10-492d-9c37-361fe0b79427	01b0ed47-b9f0-49ad-aad8-befc0a429765
57218	57218	0	GBIF Uganda	71b40829-6a12-4c3d-8fee-5746f5e9cf8c	026af01f-d227-476f-9e81-d5273eca6a2b
86	86	0	GBIF France	da44cd31-5901-4687-a106-6d1c7734ee3a	038cb34c-a08e-48aa-b09f-e8b386127ec1
266	266	0	GBIF Spain	1f94b3ca-9345-4d65-afe2-4bace93aa0fe	04bcb0c1-be72-4e7f-8170-c73ccf4cb4d0
72	72	0	GBIF Argentina	2426a871-9feb-40a1-96c6-0c593a76b835	0502f8d3-0272-4bf8-ab8e-48cc3847f195
39125	39125	0	GBIF Norway	4f829580-180d-46a9-9c87-ed8ec959b545	08a41903-7411-479a-929d-4a0c9bc40b31
0	31	31	Participant Node Managers Committee	7f48e0c8-5c96-49ec-b972-30748e339115	0b845dbd-d8b8-41f2-aaac-dfb1adcaa36e
44051	44051	0	Netherlands Biodiversity Information Facility	0909d601-bda2-42df-9e63-a6d51847ebce	0b86ff4c-ea2e-4927-850c-5be5bd60cd20
85	85	0	Atlas of Living Australia	4a6f1b71-969e-4fc5-a693-282b05e1220c	0c321862-ceb7-415d-8db0-95db8462b479
6	6	0	Plazi	ffb07bec-2d10-492d-9c37-361fe0b79427	11fda489-d4f7-4efd-8bbf-dad2d8b6c27f
829	829	0	GBIF France	da44cd31-5901-4687-a106-6d1c7734ee3a	1373c357-afef-4b94-a20e-f287ab199378
25631	25633	2	GBIF Brazil	cdc9736d-5ff7-4ece-9959-3c744360cdb3	15e887a4-973c-4b84-b421-ca65584a4c75
25139	25139	0	GBIF France	da44cd31-5901-4687-a106-6d1c7734ee3a	199ab955-e1f7-48df-9024-5f94778966b4
1007	1007	0	GBIF France	da44cd31-5901-4687-a106-6d1c7734ee3a	19d567d9-8d61-409a-9979-969929d4fc77
40135	40135	0	GBIF Spain	1f94b3ca-9345-4d65-afe2-4bace93aa0fe	1aaa6e74-593c-4a7c-a83e-ca8cbb4c6511
638	843	205	GBIF Argentina	2426a871-9feb-40a1-96c6-0c593a76b835	1c53a27c-f9cd-491f-94c1-58fc89e114c7
859	859	0	National Biodiversity Network	d897a5b9-35ee-4232-94bd-b0bcaac003c2	1d3ddd7b-ae90-454a-b2df-5a14ba474a16
33	33	0	Plazi	ffb07bec-2d10-492d-9c37-361fe0b79427	20ab611b-e7f3-4b2d-b87a-1c91e0861597
5	5	0	Plazi	ffb07bec-2d10-492d-9c37-361fe0b79427	2211eb73-7755-4966-b2db-76f89cb30e28
18	18	0	Plazi	ffb07bec-2d10-492d-9c37-361fe0b79427	2373752d-6333-4f9d-9476-6f2e163a67da
20	20	0	Plazi	ffb07bec-2d10-492d-9c37-361fe0b79427	23a22e38-f32b-44da-905b-6b352ff74843
69	69	0	GBIF Chile	a8b16421-d80b-4ef3-8f22-098b01a89255	26774a5e-1d4b-4c35-9c2a-e99ee3e8f693
1284	1284	0	GBIF France	da44cd31-5901-4687-a106-6d1c7734ee3a	2979bd0b-b3aa-41dc-beb2-5a67bdaed1ee
21242	21242	0	National Biodiversity Network	d897a5b9-35ee-4232-94bd-b0bcaac003c2	2b91dc29-e06a-4e2e-a85b-e7781b4f5d0d
11	11	0	Colombian Biodiversity Information System	7e865cba-7c46-417b-ade5-97f2cf5b7be0	2ccba994-11f9-4228-ba30-5a2f53bb7feb
0	23	23	Plazi	ffb07bec-2d10-492d-9c37-361fe0b79427	2ff76d2e-fbff-4f61-a97b-6c2a29dc9c29
0	34	34	Plazi	ffb07bec-2d10-492d-9c37-361fe0b79427	30abf3c7-5d57-410f-98ec-e2fe98173bd1
770	264	-506	GBIF Germany	4f6826f2-4ff6-443d-b966-e6913bd24013	33ba253a-cb30-4c60-adab-d5e24abe206c
0	22	22	Plazi	ffb07bec-2d10-492d-9c37-361fe0b79427	34a8660e-26cc-41c1-bf01-33f071a6765b
48	48	0	Plazi	ffb07bec-2d10-492d-9c37-361fe0b79427	35b6b9f8-84f7-43fd-a024-da339cc61dac
37	37	0	National Biodiversity Network	d897a5b9-35ee-4232-94bd-b0bcaac003c2	36a5c75f-106f-4d92-8574-1966b8a87159
0	4	4	Plazi	ffb07bec-2d10-492d-9c37-361fe0b79427	38ae68d2-16f0-4148-a7e7-d0246ff2469a
0	7	7	Ocean Biodiversity Information System	ba0670b9-4186-41e6-8e70-f9cb3065551a	3a68f6ee-a5c3-4ce6-88aa-0ac71fd0f2ff
0	4	4	Plazi	ffb07bec-2d10-492d-9c37-361fe0b79427	3b1df363-2fe4-4a96-bc0b-f870ad6f1444
0	1	1	Plazi	ffb07bec-2d10-492d-9c37-361fe0b79427	3c747549-b6fd-4a68-a9c0-b20794a62644
466	1759	1293	Belgian Biodiversity Platform	fb11cfe1-ebc3-45af-9159-17d9fddbcdac	3dfbaea0-f5df-4978-b3a1-fb22edcde0de
0	91	91	Plazi	ffb07bec-2d10-492d-9c37-361fe0b79427	3ec281e9-e0b8-4d51-ba2a-327e7d355c6b
33	33	0	Atlas of Living Australia	4a6f1b71-969e-4fc5-a693-282b05e1220c	4002a223-2daf-43e4-ab43-10b2ccfa5988
93914	93914	0	National Biodiversity Network	d897a5b9-35ee-4232-94bd-b0bcaac003c2	402c81b6-8d69-4650-8826-92f91d2728a7
0	16	16	Ocean Biodiversity Information System	ba0670b9-4186-41e6-8e70-f9cb3065551a	4079a79e-f4c3-44af-abf7-14960e81bb92
72185	72185	0	Belgian Biodiversity Platform	fb11cfe1-ebc3-45af-9159-17d9fddbcdac	42319b8f-9b9d-448d-969f-656792a69176
751765	764886	13121	GBIF Brazil	cdc9736d-5ff7-4ece-9959-3c744360cdb3	4300f8d5-1ae5-49e5-a101-63894b005868
15675	15675	0	GBIF Japan	db5705aa-6a6e-42f1-8942-d77b9f4896ea	4407f212-7285-4d59-b3c8-cda206bb4657
6	6	0	Plazi	ffb07bec-2d10-492d-9c37-361fe0b79427	4701b9a5-8b52-41ba-9a8d-818aa2a76193
5	5	0	Plazi	ffb07bec-2d10-492d-9c37-361fe0b79427	4752b60a-c3c5-4d0e-a28f-ccc1024636ad
2	2	0	Plazi	ffb07bec-2d10-492d-9c37-361fe0b79427	47ce3b80-af45-42b5-ac4e-e5a00828dc2d
0	4	4	Plazi	ffb07bec-2d10-492d-9c37-361fe0b79427	47f88e07-b6c5-43b7-aa51-48606a82d9c9
0	1177	1177	Colombian Biodiversity Information System	7e865cba-7c46-417b-ade5-97f2cf5b7be0	4a19a64a-6635-47db-a952-1671e4e2900e
724	724	0	Netherlands Biodiversity Information Facility	0909d601-bda2-42df-9e63-a6d51847ebce	4a837446-cdcd-411b-8d51-5b8184890bcc
0	2	2	Plazi	ffb07bec-2d10-492d-9c37-361fe0b79427	4dc83325-7765-4e96-b75f-cf6f62eff4b3
10	10	0	Participant Node Managers Committee	7f48e0c8-5c96-49ec-b972-30748e339115	4e78f4b4-4844-4e7c-b010-8dfa81d8563c
5859	5859	0	GBIF Brazil	cdc9736d-5ff7-4ece-9959-3c744360cdb3	518eea27-3077-4de8-afc5-880d5414ad8e
9	9	0	Plazi	ffb07bec-2d10-492d-9c37-361fe0b79427	51fe7fed-8c62-4702-9dd1-b034c8cb500f
0	2	2	Plazi	ffb07bec-2d10-492d-9c37-361fe0b79427	5229b2b3-ff60-40cf-878e-d570f65cf83f
1	1	0	Plazi	ffb07bec-2d10-492d-9c37-361fe0b79427	538f2e18-3141-4bf9-9a40-49b153866482
26	26	0	Plazi	ffb07bec-2d10-492d-9c37-361fe0b79427	53bc58e1-f1e6-4bd7-8480-eb5b9ef12da0
1	1	0	Plazi	ffb07bec-2d10-492d-9c37-361fe0b79427	54001a5c-d978-4a0d-8c47-e58b9d9efff7
0	4	4	Plazi	ffb07bec-2d10-492d-9c37-361fe0b79427	5776526d-1fe1-4342-927d-032e8276831e
43	43	0	Plazi	ffb07bec-2d10-492d-9c37-361fe0b79427	58e8ba53-f212-404c-854c-118eff908d2c
0	23	23	Plazi	ffb07bec-2d10-492d-9c37-361fe0b79427	5d9ea063-4db1-49d0-a51c-cd09154a9b6e
0	64	64	Ocean Biodiversity Information System	ba0670b9-4186-41e6-8e70-f9cb3065551a	5e413639-a91c-41ba-aa33-8583c479a3fa
0	7	7	Plazi	ffb07bec-2d10-492d-9c37-361fe0b79427	5ed5de30-c724-4152-a146-0ca638d7ad46
150	150	0	GBIF Germany	4f6826f2-4ff6-443d-b966-e6913bd24013	618e7b34-f762-11e1-a439-00145eb45e9a
27	27	0	GBIF Germany	4f6826f2-4ff6-443d-b966-e6913bd24013	62d3855c-f762-11e1-a439-00145eb45e9a
2	2	0	Plazi	ffb07bec-2d10-492d-9c37-361fe0b79427	635f947d-f5a3-4e05-abc8-5bccbe01f637
85	85	0	GBIF Germany	4f6826f2-4ff6-443d-b966-e6913bd24013	642c898a-f762-11e1-a439-00145eb45e9a
7005170	7017807	12637	GBIF Germany	4f6826f2-4ff6-443d-b966-e6913bd24013	64dabd3c-4f34-4520-b9dd-d227a0bf1582
308	308	0	GBIF Germany	4f6826f2-4ff6-443d-b966-e6913bd24013	656f8022-f762-11e1-a439-00145eb45e9a
162	162	0	GBIF Germany	4f6826f2-4ff6-443d-b966-e6913bd24013	662047cc-f762-11e1-a439-00145eb45e9a
54	54	0	GBIF Germany	4f6826f2-4ff6-443d-b966-e6913bd24013	66bb2828-f762-11e1-a439-00145eb45e9a
2	2	0	Plazi	ffb07bec-2d10-492d-9c37-361fe0b79427	66bc6169-67f1-46ca-ba7d-08326ec09cf3
58	58	0	GBIF Germany	4f6826f2-4ff6-443d-b966-e6913bd24013	6758e626-f762-11e1-a439-00145eb45e9a
1024	1024	0	National Biodiversity Network	d897a5b9-35ee-4232-94bd-b0bcaac003c2	68724de6-4ce3-405e-b76f-f5814712cfb9
29	29	0	GBIF Germany	4f6826f2-4ff6-443d-b966-e6913bd24013	68c5dc80-f762-11e1-a439-00145eb45e9a
2086	2086	0	U.S. Geological Survey	8618c64a-93e0-4300-b546-7249e5148ed2	69cfc2db-6fc5-4fdb-886c-5c393dc252eb
0	65	65	Plazi	ffb07bec-2d10-492d-9c37-361fe0b79427	6a6dd89d-6b74-47ed-ba8e-71b526355b69
14	14	0	GBIF Germany	4f6826f2-4ff6-443d-b966-e6913bd24013	6a89c770-f762-11e1-a439-00145eb45e9a
12	12	0	GBIF Germany	4f6826f2-4ff6-443d-b966-e6913bd24013	6bc07db4-f762-11e1-a439-00145eb45e9a
40	40	0	GBIF Germany	4f6826f2-4ff6-443d-b966-e6913bd24013	6cd91be8-f762-11e1-a439-00145eb45e9a
87	87	0	GBIF Germany	4f6826f2-4ff6-443d-b966-e6913bd24013	6d5e741e-f762-11e1-a439-00145eb45e9a
2	2	0	Plazi	ffb07bec-2d10-492d-9c37-361fe0b79427	6e1dfdff-3bd8-4849-8c86-0808d278ff6c
136	136	0	GBIF Germany	4f6826f2-4ff6-443d-b966-e6913bd24013	6f980178-f762-11e1-a439-00145eb45e9a
13	13	0	GBIF Germany	4f6826f2-4ff6-443d-b966-e6913bd24013	6fdde472-f762-11e1-a439-00145eb45e9a
223	223	0	GBIF Germany	4f6826f2-4ff6-443d-b966-e6913bd24013	71ecc5da-f762-11e1-a439-00145eb45e9a
0	15	15	Plazi	ffb07bec-2d10-492d-9c37-361fe0b79427	73263c08-1dff-4432-86e4-c953b3e74368
64	64	0	GBIF Germany	4f6826f2-4ff6-443d-b966-e6913bd24013	7363f9b0-f762-11e1-a439-00145eb45e9a
43	43	0	GBIF Germany	4f6826f2-4ff6-443d-b966-e6913bd24013	736a4ebe-f762-11e1-a439-00145eb45e9a
16	16	0	Plazi	ffb07bec-2d10-492d-9c37-361fe0b79427	73b4f591-714d-45c7-bb2d-42384cd213da
1055	1055	0	GBIF Germany	4f6826f2-4ff6-443d-b966-e6913bd24013	75327564-f762-11e1-a439-00145eb45e9a
255	255	0	GBIF Germany	4f6826f2-4ff6-443d-b966-e6913bd24013	75d26f9c-f762-11e1-a439-00145eb45e9a
0	2	2	Plazi	ffb07bec-2d10-492d-9c37-361fe0b79427	76b18bd3-439b-40d4-abaa-122137451fe8
22187	22187	0	GBIF France	da44cd31-5901-4687-a106-6d1c7734ee3a	7715f20e-bafd-47eb-a4e0-86dce0e8d567
14	14	0	Plazi	ffb07bec-2d10-492d-9c37-361fe0b79427	77eabb0e-d79d-46a6-bb42-7be067af7f0f
2512	2512	0	GBIF France	da44cd31-5901-4687-a106-6d1c7734ee3a	78e94846-11ec-4098-ba71-251b5582a36f
2	2	0	Plazi	ffb07bec-2d10-492d-9c37-361fe0b79427	7abdc62c-c350-49dd-8060-4ed64da07362
374	374	0	GBIF Germany	4f6826f2-4ff6-443d-b966-e6913bd24013	7c4ce94c-f762-11e1-a439-00145eb45e9a
312	312	0	GBIF Germany	4f6826f2-4ff6-443d-b966-e6913bd24013	7d3f9926-f762-11e1-a439-00145eb45e9a
2000	2000	0	GBIF Germany	4f6826f2-4ff6-443d-b966-e6913bd24013	7da3e732-f762-11e1-a439-00145eb45e9a
563	563	0	GBIF Germany	4f6826f2-4ff6-443d-b966-e6913bd24013	7e712f12-f762-11e1-a439-00145eb45e9a
3393	1248	-2145	GBIF Germany	4f6826f2-4ff6-443d-b966-e6913bd24013	7eee968c-f762-11e1-a439-00145eb45e9a
589	589	0	GBIF Germany	4f6826f2-4ff6-443d-b966-e6913bd24013	7ef14558-f762-11e1-a439-00145eb45e9a
1187	1040	-147	Biodiversity Information System of Mexico	b324e8e9-9a4c-44fa-8f1a-7f39ea7ab576	7f928abc-f762-11e1-a439-00145eb45e9a
3636	3528	-108	Biodiversity Information System of Mexico	b324e8e9-9a4c-44fa-8f1a-7f39ea7ab576	8031a106-f762-11e1-a439-00145eb45e9a
10491	10491	0	Biodiversity Information System of Mexico	b324e8e9-9a4c-44fa-8f1a-7f39ea7ab576	808c9278-f762-11e1-a439-00145eb45e9a
45	45	0	GBIF Germany	4f6826f2-4ff6-443d-b966-e6913bd24013	819a0c68-f762-11e1-a439-00145eb45e9a
15883	15883	0	Canada Biodiversity Information Facility	8f83fc96-c966-4126-83f7-bf044dc49efa	82d32d8a-f762-11e1-a439-00145eb45e9a
44626	44626	0	U.S. Geological Survey	8618c64a-93e0-4300-b546-7249e5148ed2	84c00a71-0735-4a47-bf55-8556dcafa5c2
223245	223245	0	U.S. Geological Survey	8618c64a-93e0-4300-b546-7249e5148ed2	85af82a6-f762-11e1-a439-00145eb45e9a
28324	28977	653	Atlas of Living Australia	4a6f1b71-969e-4fc5-a693-282b05e1220c	8642acf1-68f2-42b2-8ce3-97798e383cb2
10754	11059	305	GBIF Brazil	cdc9736d-5ff7-4ece-9959-3c744360cdb3	86aea6d0-e340-4745-a596-3fc20f90a021
2230	2088	-142	GBIF Germany	4f6826f2-4ff6-443d-b966-e6913bd24013	87260326-f762-11e1-a439-00145eb45e9a
0	13	13	Ocean Biodiversity Information System	ba0670b9-4186-41e6-8e70-f9cb3065551a	874209e6-1049-42e3-bfdc-b5e0913469b4
14	6	-8	GBIF Germany	4f6826f2-4ff6-443d-b966-e6913bd24013	8771097a-f762-11e1-a439-00145eb45e9a
5	5	0	Plazi	ffb07bec-2d10-492d-9c37-361fe0b79427	8841c556-aaf5-487b-a913-2126b523e3ea
17155	17155	0	Biodiversity Information System of Mexico	b324e8e9-9a4c-44fa-8f1a-7f39ea7ab576	890c34ee-f762-11e1-a439-00145eb45e9a
45	45	0	Ocean Biodiversity Information System	ba0670b9-4186-41e6-8e70-f9cb3065551a	8915b910-f762-11e1-a439-00145eb45e9a
13746	13746	0	Biodiversity Information System of Mexico	b324e8e9-9a4c-44fa-8f1a-7f39ea7ab576	896f63a2-f762-11e1-a439-00145eb45e9a
123	123	0	GBIF Germany	4f6826f2-4ff6-443d-b966-e6913bd24013	8ab5f5dc-f762-11e1-a439-00145eb45e9a
52	52	0	GBIF Germany	4f6826f2-4ff6-443d-b966-e6913bd24013	8bb785ea-f762-11e1-a439-00145eb45e9a
56	56	0	GBIF Germany	4f6826f2-4ff6-443d-b966-e6913bd24013	8d9dbe06-f762-11e1-a439-00145eb45e9a
274	174	-100	GBIF Germany	4f6826f2-4ff6-443d-b966-e6913bd24013	8dbc367e-f762-11e1-a439-00145eb45e9a
510	206	-304	GBIF Germany	4f6826f2-4ff6-443d-b966-e6913bd24013	8df19210-f762-11e1-a439-00145eb45e9a
0	37	37	Plazi	ffb07bec-2d10-492d-9c37-361fe0b79427	8f7a492f-1225-4ed5-82cb-ee4592d651a2
662	662	0	GBIF Germany	4f6826f2-4ff6-443d-b966-e6913bd24013	92393418-f762-11e1-a439-00145eb45e9a
527	509	-18	GBIF Germany	4f6826f2-4ff6-443d-b966-e6913bd24013	92ece3b4-f762-11e1-a439-00145eb45e9a
685	526	-159	GBIF Germany	4f6826f2-4ff6-443d-b966-e6913bd24013	93082dfe-f762-11e1-a439-00145eb45e9a
6	6	0	GBIF Germany	4f6826f2-4ff6-443d-b966-e6913bd24013	938e7904-f762-11e1-a439-00145eb45e9a
92	92	0	GBIF Germany	4f6826f2-4ff6-443d-b966-e6913bd24013	93ee8330-f762-11e1-a439-00145eb45e9a
11732	11732	0	GBIF Spain	1f94b3ca-9345-4d65-afe2-4bace93aa0fe	95e9f2dc-f762-11e1-a439-00145eb45e9a
1379	1561	182	GBIF Japan	db5705aa-6a6e-42f1-8942-d77b9f4896ea	95fc4e8c-f762-11e1-a439-00145eb45e9a
23643	23643	0	Biodiversity Information System of Mexico	b324e8e9-9a4c-44fa-8f1a-7f39ea7ab576	96b1aa66-f762-11e1-a439-00145eb45e9a
676	676	0	Plazi	ffb07bec-2d10-492d-9c37-361fe0b79427	97c86898-182a-4e06-a922-58e5057a78ca
187	187	0	GBIF France	da44cd31-5901-4687-a106-6d1c7734ee3a	98450120-08be-4067-94d2-50fd0a0c7417
0	33	33	Plazi	ffb07bec-2d10-492d-9c37-361fe0b79427	a0060b7f-71f9-4f6f-b44a-4612f56a2dfd
155	155	0	Plazi	ffb07bec-2d10-492d-9c37-361fe0b79427	a047bcd9-ab65-4e3f-b07a-c830c7af1072
955	955	0	Biodiversity Information System of Mexico	b324e8e9-9a4c-44fa-8f1a-7f39ea7ab576	a3328ccd-32d8-4d78-af7d-6ed099723a27
21	21	0	Plazi	ffb07bec-2d10-492d-9c37-361fe0b79427	a3fbe31d-fb13-452a-b213-ce4827a3b08e
0	1	1	Plazi	ffb07bec-2d10-492d-9c37-361fe0b79427	a43f87e1-9a2c-4c96-9798-9e0367a0dbce
3	3	0	Plazi	ffb07bec-2d10-492d-9c37-361fe0b79427	a4a83379-21c5-4148-88b0-9a3d359436bc
267	267	0	National Biodiversity Network	d897a5b9-35ee-4232-94bd-b0bcaac003c2	a7243a03-c87b-4983-8957-613c9984af66
0	3464	3464	Participant Node Managers Committee	7f48e0c8-5c96-49ec-b972-30748e339115	a78dcaca-c58f-4525-a0de-76b7763f7a9f
6	6	0	GBIF Argentina	2426a871-9feb-40a1-96c6-0c593a76b835	a96fc7b4-9e94-4881-92b0-a1bb25be9453
0	3	3	Participant Node Managers Committee	7f48e0c8-5c96-49ec-b972-30748e339115	aa33fa89-4749-4284-8978-f43bf84bde0a
405	405	0	National Biodiversity Network	d897a5b9-35ee-4232-94bd-b0bcaac003c2	aa73f2b2-be9d-49fd-869e-75f91ded2494
0	816	816	Ocean Biodiversity Information System	ba0670b9-4186-41e6-8e70-f9cb3065551a	ab382b87-0112-4c23-a6d4-74054ba6e9d8
0	10	10	Plazi	ffb07bec-2d10-492d-9c37-361fe0b79427	ad5e02bc-e95b-48a4-be66-595ca7be07e5
0	2085	2085	Participant Node Managers Committee	7f48e0c8-5c96-49ec-b972-30748e339115	ad68d258-1e57-47b2-8643-1e627caf4f56
1210	1210	0	GBIF Germany	4f6826f2-4ff6-443d-b966-e6913bd24013	af9c6c7a-3e63-4871-92c9-d5df3442c343
2000	2000	0	GBIF Japan	db5705aa-6a6e-42f1-8942-d77b9f4896ea	b0f0d066-c45c-42f7-9297-cfff577b11ab
0	39	39	Ocean Biodiversity Information System	ba0670b9-4186-41e6-8e70-f9cb3065551a	b12179e8-bf2d-426c-9ae5-7efd656cb5be
33	33	0	Plazi	ffb07bec-2d10-492d-9c37-361fe0b79427	b37adfc9-f522-4496-beec-6fb0231e325b
1047	723	-324	GBIF Germany	4f6826f2-4ff6-443d-b966-e6913bd24013	b9155a39-3ca2-400f-9add-f7afbfda72d1
2	2	0	Plazi	ffb07bec-2d10-492d-9c37-361fe0b79427	c0961d63-8578-49dd-872f-a2320b4c39b6
1	1	0	Plazi	ffb07bec-2d10-492d-9c37-361fe0b79427	c2e66d0f-4d17-42e8-8772-f96621decc5f
833	833	0	GBIF France	da44cd31-5901-4687-a106-6d1c7734ee3a	c3020bec-8659-4ecb-b5ad-75445118aec7
201	201	0	Colombian Biodiversity Information System	7e865cba-7c46-417b-ade5-97f2cf5b7be0	c3460628-b6ca-41ce-963d-3d3cc3674877
6354	6354	0	National Biodiversity Network	d897a5b9-35ee-4232-94bd-b0bcaac003c2	c5803c8d-15d4-4dba-bf4e-ecff6078934f
126215	126215	0	National Biodiversity Network	d897a5b9-35ee-4232-94bd-b0bcaac003c2	c6f2c42a-2ac9-442d-81da-aa076771bc39
0	3	3	Plazi	ffb07bec-2d10-492d-9c37-361fe0b79427	c8193670-66ad-4f69-8eb0-a065a99c7982
0	4	4	Plazi	ffb07bec-2d10-492d-9c37-361fe0b79427	cab838a5-160f-4732-919e-8a7d6dc6b118
16458	16458	0	GBIF France	da44cd31-5901-4687-a106-6d1c7734ee3a	d4df21c8-c2cb-4b15-bec3-ec177e1c2455
14	14	0	Plazi	ffb07bec-2d10-492d-9c37-361fe0b79427	d675dd01-bde3-4465-96f1-5ab12a87e002
188	188	0	Plazi	ffb07bec-2d10-492d-9c37-361fe0b79427	d689036e-f453-4296-ad56-c8d60f7e69d5
2088	2088	0	Biodiversity Information System of Mexico	b324e8e9-9a4c-44fa-8f1a-7f39ea7ab576	d74f14ea-0bd6-42e9-b62e-e490b21a9ab4
77	77	0	Plazi	ffb07bec-2d10-492d-9c37-361fe0b79427	de11fbae-19ca-40d0-99a2-eec9855c094c
9	9	0	Plazi	ffb07bec-2d10-492d-9c37-361fe0b79427	de8bae68-74a9-45df-ba8b-aa6c8673f24f
25	25	0	Atlas of Living Australia	4a6f1b71-969e-4fc5-a693-282b05e1220c	e2b51a4e-af48-4d33-b7c3-8c5549cba3ad
22	24	2	U.S. Geological Survey	8618c64a-93e0-4300-b546-7249e5148ed2	e40bb469-811f-4c0c-8a39-fb21994ce62e
13	13	0	GBIF Argentina	2426a871-9feb-40a1-96c6-0c593a76b835	e4243ce7-65f6-4f78-8cf4-84dca9af4b00
11505	11505	0	Atlas of Living Australia	4a6f1b71-969e-4fc5-a693-282b05e1220c	e731a329-1fe3-4497-9e3c-24cb9235b5a1
6	6	0	Plazi	ffb07bec-2d10-492d-9c37-361fe0b79427	e764cc4a-2225-48a4-a288-e01a5724abbc
0	1	1	Plazi	ffb07bec-2d10-492d-9c37-361fe0b79427	eb8793dd-1149-4ce9-9df9-0fae4115d27c
1239	5522	4283	GBIF Kenya	2a44d626-9f7a-4120-8a7a-4ab5ac15ff2a	ebe7091d-8787-420e-871f-cb945e3b5d47
749	749	0	GBIF France	da44cd31-5901-4687-a106-6d1c7734ee3a	ec7324c4-4188-4c2f-a97c-7207b7ebca6f
16261	16261	0	GBIF Germany	4f6826f2-4ff6-443d-b966-e6913bd24013	ec81f6d4-e92f-480c-a73a-a4b71ba435cc
15	15	0	Plazi	ffb07bec-2d10-492d-9c37-361fe0b79427	ed3cece9-7757-4489-9f91-f9e52afbe067
3904	3904	0	National Biodiversity Network	d897a5b9-35ee-4232-94bd-b0bcaac003c2	ee0321a6-9e6d-4501-94aa-f12cef9c5680
2426	2426	0	Biodiversity Information System of Mexico	b324e8e9-9a4c-44fa-8f1a-7f39ea7ab576	f0d7eb48-a312-4643-a1bb-1ba9370497ec
15	15	0	Plazi	ffb07bec-2d10-492d-9c37-361fe0b79427	f16e513e-dc94-4240-8316-f84d19d0ce39
0	18	18	Participant Node Managers Committee	7f48e0c8-5c96-49ec-b972-30748e339115	f4f26f09-319c-4068-9442-f6832df8365c
1598	1598	0	Atlas of Living Australia	4a6f1b71-969e-4fc5-a693-282b05e1220c	f67d4560-51fa-4443-9ce3-acced5515eec
29	29	0	Plazi	ffb07bec-2d10-492d-9c37-361fe0b79427	f8b84a15-2f2b-4eba-b89d-c20a66a7b0f3
0	4	4	Plazi	ffb07bec-2d10-492d-9c37-361fe0b79427	fedf9332-0821-44a4-b16a-e9280ec0dcd0
12	12	0	Plazi	ffb07bec-2d10-492d-9c37-361fe0b79427	03ac9894-84cc-4f44-8d22-bac085689258
562	562	0	GBIF Brazil	cdc9736d-5ff7-4ece-9959-3c744360cdb3	0c4f3226-2848-4a1d-bf79-7382edad5b4e
0	3	3	Plazi	ffb07bec-2d10-492d-9c37-361fe0b79427	0df1cd40-d273-4ddb-9fd7-dca7fc392a8b
87901	87901	0	Atlas of Living Australia	4a6f1b71-969e-4fc5-a693-282b05e1220c	0e5c0373-f957-4ce3-b8d9-a9054df51fc5
31604	31604	0	National Biodiversity Network	d897a5b9-35ee-4232-94bd-b0bcaac003c2	0ec9497e-2c63-48a5-bcc9-e0fa1abb52e4
511	511	0	Polish Biodiversity Information Network	2618bfdf-e194-4911-a241-80db3107bc51	0ff61a20-13c7-11de-b2df-b8a03c50a862
2	2	0	Plazi	ffb07bec-2d10-492d-9c37-361fe0b79427	133114e1-dc8b-49d9-8437-ad32020adbea
0	4	4	Plazi	ffb07bec-2d10-492d-9c37-361fe0b79427	1338921a-4e48-4b52-9d48-72ae85d525a7
2	2	0	Plazi	ffb07bec-2d10-492d-9c37-361fe0b79427	134ac4d9-fdac-43b5-b55c-c2ce10175a01
4	4	0	Plazi	ffb07bec-2d10-492d-9c37-361fe0b79427	164eb057-9bef-44cc-bfb3-9edb59d2dc50
0	6	6	Plazi	ffb07bec-2d10-492d-9c37-361fe0b79427	17658bcc-f573-40cc-bdd5-64bac3defe26
2	2	0	Plazi	ffb07bec-2d10-492d-9c37-361fe0b79427	17ba7d2d-8c6b-41bf-96eb-3452e7afab64
2596	2596	0	GBIF France	da44cd31-5901-4687-a106-6d1c7734ee3a	196e6026-9979-46fa-a260-95a91336d095
0	14	14	Plazi	ffb07bec-2d10-492d-9c37-361fe0b79427	1ca372c1-b16d-4e80-b88b-05ec444115e1
237	237	0	GBIF France	da44cd31-5901-4687-a106-6d1c7734ee3a	1d37b357-d85c-4c9d-97f8-b8abc1295a3f
7	7	0	Plazi	ffb07bec-2d10-492d-9c37-361fe0b79427	1d68ad11-a87c-4ca7-aeb4-e35a3cc844bc
0	20	20	Plazi	ffb07bec-2d10-492d-9c37-361fe0b79427	1f9eaa1b-4aae-491d-a888-1e91eacfbcc7
0	66	66	Ocean Biodiversity Information System	ba0670b9-4186-41e6-8e70-f9cb3065551a	2391fdd1-00ea-4cb2-a841-a103c5de3473
37458	37458	0	National Biodiversity Network	d897a5b9-35ee-4232-94bd-b0bcaac003c2	2d7d2171-29ca-45b1-b98e-c90c813b302d
11265	11265	0	Biodiversity Information System of Mexico	b324e8e9-9a4c-44fa-8f1a-7f39ea7ab576	33751dde-421a-44bc-9f92-aa148276a74a
0	25	25	Ocean Biodiversity Information System	ba0670b9-4186-41e6-8e70-f9cb3065551a	347f911b-0119-4696-991c-c14a87061ef0
471986	471986	0	U.S. Geological Survey	8618c64a-93e0-4300-b546-7249e5148ed2	350f00a7-db1f-4133-bc07-71de716339da
5642	5642	0	Belgian Biodiversity Platform	fb11cfe1-ebc3-45af-9159-17d9fddbcdac	36e71fad-810e-4eb2-8f4f-fa7eda4ed5c6
0	90	90	GBIF Argentina	2426a871-9feb-40a1-96c6-0c593a76b835	36fc65f3-ba8d-4c06-917e-6ffe62b63577
0	76	76	Ocean Biodiversity Information System	ba0670b9-4186-41e6-8e70-f9cb3065551a	37db948e-b149-45ec-a001-787e29e8b5c6
0	675	675	Colombian Biodiversity Information System	7e865cba-7c46-417b-ade5-97f2cf5b7be0	3b45e49b-eca9-47a1-a415-5170da130a2d
9	9	0	Plazi	ffb07bec-2d10-492d-9c37-361fe0b79427	3de64436-3ff2-4d0a-8676-b0504170ec50
39	84	45	U.S. Geological Survey	8618c64a-93e0-4300-b546-7249e5148ed2	3f5df259-243c-4c32-9520-921c89fe689f
4	4	0	Plazi	ffb07bec-2d10-492d-9c37-361fe0b79427	4229b7a6-6459-4eda-9b6f-46da6838eb73
0	752	752	Ocean Biodiversity Information System	ba0670b9-4186-41e6-8e70-f9cb3065551a	46d7865d-2b1f-416b-b2c9-1387721fc879
0	5	5	Plazi	ffb07bec-2d10-492d-9c37-361fe0b79427	49db60e3-3b12-4786-a37a-1f841fc34156
13	13	0	Participant Node Managers Committee	7f48e0c8-5c96-49ec-b972-30748e339115	4b9b785d-bfdc-4151-a424-96facf42b590
2	2	0	Plazi	ffb07bec-2d10-492d-9c37-361fe0b79427	4c50721f-a97d-47bc-8d99-2e4decc89674
88	88	0	GBIF Norway	4f829580-180d-46a9-9c87-ed8ec959b545	4cc8e6da-6caa-4820-8400-9cc2db63920a
7506	7506	0	Biodiversity Information System of Mexico	b324e8e9-9a4c-44fa-8f1a-7f39ea7ab576	4e1bcb9c-d8b1-4bfd-b79c-3c6b8f9cac4d
346	346	0	GBIF France	da44cd31-5901-4687-a106-6d1c7734ee3a	4ff1d6f2-50a7-499e-b264-ccb320aff042
2239	2239	0	National Biodiversity Network	d897a5b9-35ee-4232-94bd-b0bcaac003c2	52922205-6477-4999-9d4a-d38999aa32eb
70	70	0	Plazi	ffb07bec-2d10-492d-9c37-361fe0b79427	57260a7b-0b6d-4a93-a70b-fe3eab272757
2623	2623	0	Participant Node Managers Committee	7f48e0c8-5c96-49ec-b972-30748e339115	57990c52-8b6a-4595-a156-65fd6cf60b18
5	5	0	Plazi	ffb07bec-2d10-492d-9c37-361fe0b79427	5da4b75d-10f8-4d14-9695-f4e6c3c30914
738	738	0	GBIF France	da44cd31-5901-4687-a106-6d1c7734ee3a	5fd8724d-5dfe-42d4-8069-21715a2ca053
40	40	0	GBIF Germany	4f6826f2-4ff6-443d-b966-e6913bd24013	632620aa-f762-11e1-a439-00145eb45e9a
3	3	0	Plazi	ffb07bec-2d10-492d-9c37-361fe0b79427	64662e55-475d-41ac-b04b-02328d37b8bd
55	55	0	GBIF Germany	4f6826f2-4ff6-443d-b966-e6913bd24013	66b3b0ac-f762-11e1-a439-00145eb45e9a
0	5	5	Plazi	ffb07bec-2d10-492d-9c37-361fe0b79427	66e00022-9423-4970-b193-9c6530aa8c95
0	9	9	Ocean Biodiversity Information System	ba0670b9-4186-41e6-8e70-f9cb3065551a	671f6a4f-2b1a-4e02-96b8-ae1fc9be23c9
163	163	0	GBIF Germany	4f6826f2-4ff6-443d-b966-e6913bd24013	67df83c0-f762-11e1-a439-00145eb45e9a
82	82	0	Plazi	ffb07bec-2d10-492d-9c37-361fe0b79427	693cf9af-1aac-42e9-ae28-32800b7301d0
0	1	1	Plazi	ffb07bec-2d10-492d-9c37-361fe0b79427	69a292bb-5799-4d2b-94ee-cbe99e704cb7
17	17	0	GBIF Germany	4f6826f2-4ff6-443d-b966-e6913bd24013	6a1a7960-f762-11e1-a439-00145eb45e9a
68	68	0	Plazi	ffb07bec-2d10-492d-9c37-361fe0b79427	6b72cb95-12be-47aa-abed-a7972fac7dfd
2	2	0	Plazi	ffb07bec-2d10-492d-9c37-361fe0b79427	6cf6ef6c-6044-4da7-94e2-e879248749ba
0	11	11	Participant Node Managers Committee	7f48e0c8-5c96-49ec-b972-30748e339115	6dcac517-be8b-4743-a32f-0c395ccc4685
23	23	0	GBIF Germany	4f6826f2-4ff6-443d-b966-e6913bd24013	6f993dfe-f762-11e1-a439-00145eb45e9a
301	315	14	GBIF Spain	1f94b3ca-9345-4d65-afe2-4bace93aa0fe	6feca810-ad23-4dc9-b96d-28011451ff44
70	70	0	Plazi	ffb07bec-2d10-492d-9c37-361fe0b79427	70aae18d-e6ec-4bb1-abe0-27d1f24fbab8
110	60	-50	GBIF Germany	4f6826f2-4ff6-443d-b966-e6913bd24013	7109922e-f762-11e1-a439-00145eb45e9a
101	101	0	GBIF Germany	4f6826f2-4ff6-443d-b966-e6913bd24013	71b262be-f762-11e1-a439-00145eb45e9a
3	3	0	GBIF Germany	4f6826f2-4ff6-443d-b966-e6913bd24013	74373dfc-f762-11e1-a439-00145eb45e9a
1890	1890	0	GBIF France	da44cd31-5901-4687-a106-6d1c7734ee3a	7545db3b-b0bb-44c9-8ed2-68a49836b342
5	5	0	Plazi	ffb07bec-2d10-492d-9c37-361fe0b79427	754c56b7-edf0-4d37-a06b-2c3f653b29be
147	147	0	GBIF Germany	4f6826f2-4ff6-443d-b966-e6913bd24013	75be878e-f762-11e1-a439-00145eb45e9a
19	19	0	GBIF Germany	4f6826f2-4ff6-443d-b966-e6913bd24013	78b31400-f762-11e1-a439-00145eb45e9a
9	9	0	GBIF Germany	4f6826f2-4ff6-443d-b966-e6913bd24013	78d9e724-f762-11e1-a439-00145eb45e9a
996	996	0	Biodiversity Information System of Mexico	b324e8e9-9a4c-44fa-8f1a-7f39ea7ab576	7a7b425d-b289-4342-9bc1-3f90ca666980
2588	2588	0	GBIF Finland	dd514216-5c7c-45f3-910d-797424cb5be6	7a8be2e6-349b-4ac8-8c58-fde5c046142d
4	4	0	GBIF Germany	4f6826f2-4ff6-443d-b966-e6913bd24013	7aa4e928-f762-11e1-a439-00145eb45e9a
0	9	9	Plazi	ffb07bec-2d10-492d-9c37-361fe0b79427	7ae4f8b2-ca9f-4317-a3af-28e9852d499a
11981	11981	0	GBIF Germany	4f6826f2-4ff6-443d-b966-e6913bd24013	7c7422be-01a3-11e2-ad0f-00145eb45e9a
180	180	0	GBIF Germany	4f6826f2-4ff6-443d-b966-e6913bd24013	7dacca14-f762-11e1-a439-00145eb45e9a
9	9	0	Plazi	ffb07bec-2d10-492d-9c37-361fe0b79427	7e648534-279c-4a44-b4e7-e287f495985e
978	978	0	Biodiversity Information System of Mexico	b324e8e9-9a4c-44fa-8f1a-7f39ea7ab576	8025573e-f762-11e1-a439-00145eb45e9a
29128	29128	0	Biodiversity Information System of Mexico	b324e8e9-9a4c-44fa-8f1a-7f39ea7ab576	804741e6-f762-11e1-a439-00145eb45e9a
0	11671	11671	Ocean Biodiversity Information System	ba0670b9-4186-41e6-8e70-f9cb3065551a	80b4ceff-bef0-4c27-84af-f5e62e55e885
1558	1558	0	GBIF Germany	4f6826f2-4ff6-443d-b966-e6913bd24013	81d06532-70ac-4081-b601-a85b20ec0fee
2262	2262	0	GBIF Germany	4f6826f2-4ff6-443d-b966-e6913bd24013	823376c8-f762-11e1-a439-00145eb45e9a
1176	1176	0	GBIF Germany	4f6826f2-4ff6-443d-b966-e6913bd24013	827dda8c-5240-4e24-a0ee-c2da8c0d7bc9
14971	14971	0	GBIF Spain	1f94b3ca-9345-4d65-afe2-4bace93aa0fe	83504144-f762-11e1-a439-00145eb45e9a
109	109	0	Biodiversity Information System of Mexico	b324e8e9-9a4c-44fa-8f1a-7f39ea7ab576	84fcf410-f762-11e1-a439-00145eb45e9a
23831	23831	0	GBIF France	da44cd31-5901-4687-a106-6d1c7734ee3a	85845a0d-b78a-43c9-961c-3f718ec1e086
21348	21348	0	GBIF Germany	4f6826f2-4ff6-443d-b966-e6913bd24013	858af49a-f762-11e1-a439-00145eb45e9a
478	478	0	GBIF Germany	4f6826f2-4ff6-443d-b966-e6913bd24013	87ab3c12-f762-11e1-a439-00145eb45e9a
121	121	0	GBIF Germany	4f6826f2-4ff6-443d-b966-e6913bd24013	8ac151e8-f762-11e1-a439-00145eb45e9a
282	282	0	GBIF Germany	4f6826f2-4ff6-443d-b966-e6913bd24013	8b4ce6d8-0747-44bc-bd1c-a6d278610470
67725	67725	0	U.S. Geological Survey	8618c64a-93e0-4300-b546-7249e5148ed2	8c04889e-a0ad-4f39-8623-06aa9cf0131d
65	40	-25	GBIF Germany	4f6826f2-4ff6-443d-b966-e6913bd24013	8c53d01c-f762-11e1-a439-00145eb45e9a
2321	2321	0	GBIF Norway	4f829580-180d-46a9-9c87-ed8ec959b545	8d1253fc-30b6-4b4d-a12d-d711391e5382
7	6	-1	GBIF Germany	4f6826f2-4ff6-443d-b966-e6913bd24013	8d350a32-f762-11e1-a439-00145eb45e9a
823	510	-313	GBIF Germany	4f6826f2-4ff6-443d-b966-e6913bd24013	8dfef838-f762-11e1-a439-00145eb45e9a
153	119	-34	GBIF Germany	4f6826f2-4ff6-443d-b966-e6913bd24013	8e63c9ac-f762-11e1-a439-00145eb45e9a
0	428042	428042	GBIF Portugal	673f7038-4262-4149-b753-5658a4e912f6	8ea87d00-f94e-4221-8f2f-2e9150132361
1	1	0	GBIF Germany	4f6826f2-4ff6-443d-b966-e6913bd24013	8eb4d23e-f762-11e1-a439-00145eb45e9a
4	4	0	Plazi	ffb07bec-2d10-492d-9c37-361fe0b79427	8f024a46-0112-4b56-b1ad-83c0aeb620bd
756	463	-293	GBIF Germany	4f6826f2-4ff6-443d-b966-e6913bd24013	8f9e0260-f762-11e1-a439-00145eb45e9a
24	21	-3	GBIF Germany	4f6826f2-4ff6-443d-b966-e6913bd24013	8fd3cb66-f762-11e1-a439-00145eb45e9a
304	258	-46	GBIF Germany	4f6826f2-4ff6-443d-b966-e6913bd24013	8fd8ceea-f762-11e1-a439-00145eb45e9a
1735	1735	0	Polish Biodiversity Information Network	2618bfdf-e194-4911-a241-80db3107bc51	907f77a0-fd52-11db-ace1-b8a03c50a862
4	2	-2	GBIF Germany	4f6826f2-4ff6-443d-b966-e6913bd24013	90850b92-f762-11e1-a439-00145eb45e9a
7	3	-4	GBIF Germany	4f6826f2-4ff6-443d-b966-e6913bd24013	90e11ffe-f762-11e1-a439-00145eb45e9a
61	61	0	Plazi	ffb07bec-2d10-492d-9c37-361fe0b79427	90f99d44-c68c-4602-90f1-2802409db73d
532	532	0	GBIF Germany	4f6826f2-4ff6-443d-b966-e6913bd24013	92557fba-f762-11e1-a439-00145eb45e9a
2	2	0	Plazi	ffb07bec-2d10-492d-9c37-361fe0b79427	939628c7-8768-469d-b88a-d4ddfe9e7a68
0	3	3	Plazi	ffb07bec-2d10-492d-9c37-361fe0b79427	95e7d3b6-2bd1-49bd-9680-431408c330dc
34	34	0	Plazi	ffb07bec-2d10-492d-9c37-361fe0b79427	97abaf7d-9cbe-4a6e-b6f9-df443a44374b
1739	1739	0	National Biodiversity Network	d897a5b9-35ee-4232-94bd-b0bcaac003c2	9cdaa81b-8c5f-4341-9512-735fe21a79d1
530	530	0	GBIF France	da44cd31-5901-4687-a106-6d1c7734ee3a	9f74adb1-3f81-4450-9044-287312899b3d
22	22	0	Plazi	ffb07bec-2d10-492d-9c37-361fe0b79427	a160aa62-40a2-4492-8590-1254f66880b6
2	2	0	Plazi	ffb07bec-2d10-492d-9c37-361fe0b79427	a20f40ae-726b-479d-a6bb-6f3fae293638
2	2	0	Plazi	ffb07bec-2d10-492d-9c37-361fe0b79427	a46518b3-eebf-4623-8cc1-dbd192e7009f
10	10	0	Plazi	ffb07bec-2d10-492d-9c37-361fe0b79427	a9384300-15e4-4e9d-bb6e-efaa402d5ce4
58	58	0	Plazi	ffb07bec-2d10-492d-9c37-361fe0b79427	a9fc1eb5-487b-4f58-9c68-954498dd39a3
2933	2933	0	GBIF France	da44cd31-5901-4687-a106-6d1c7734ee3a	abe19638-cfb5-45e6-ba70-bf045f2b143c
0	88	88	Plazi	ffb07bec-2d10-492d-9c37-361fe0b79427	acf2b7a6-7f3c-443b-a3fe-307fda431e51
3918	3918	0	GBIF France	da44cd31-5901-4687-a106-6d1c7734ee3a	ad7e99e7-1214-4636-a293-0118bbb877b5
235	235	0	Participant Node Managers Committee	7f48e0c8-5c96-49ec-b972-30748e339115	b4ec31b8-8a54-4e10-8e92-179821204ad0
3005	3005	0	Colombian Biodiversity Information System	7e865cba-7c46-417b-ade5-97f2cf5b7be0	b535cc9a-ba95-47b2-8ff1-dd98810c8c02
952	952	0	GBIF Germany	4f6826f2-4ff6-443d-b966-e6913bd24013	ba840c20-637c-4a31-875b-970f2ddea6df
7	7	0	Plazi	ffb07bec-2d10-492d-9c37-361fe0b79427	c18e39bf-dc77-4faa-808e-05b1087711fc
367	367	0	National Biodiversity Network	d897a5b9-35ee-4232-94bd-b0bcaac003c2	c2171c0e-90b4-4d73-98a3-e55d4c5925dc
1	1	0	Plazi	ffb07bec-2d10-492d-9c37-361fe0b79427	c45a1d5b-c86b-4e74-a749-bab03c748788
3975	3975	0	Belgian Biodiversity Platform	fb11cfe1-ebc3-45af-9159-17d9fddbcdac	c47c303d-9ef5-4b02-ba57-cea6e20c580f
6	6	0	Plazi	ffb07bec-2d10-492d-9c37-361fe0b79427	c47f7d47-3dd7-4e9c-a4c6-76c187d1e2cb
1	1	0	Plazi	ffb07bec-2d10-492d-9c37-361fe0b79427	c7b919b0-16b8-4a7c-9d0e-45288ddfb5c4
0	7	7	Plazi	ffb07bec-2d10-492d-9c37-361fe0b79427	ca95180d-948a-4bff-a657-630525a56e4f
775	775	0	Participant Node Managers Committee	7f48e0c8-5c96-49ec-b972-30748e339115	cc2fa2ed-c65c-487f-91c4-e0b34d6d949d
12	12	0	Plazi	ffb07bec-2d10-492d-9c37-361fe0b79427	d03b2682-c58b-4ec6-af45-a944bfe1f414
17	17	0	Plazi	ffb07bec-2d10-492d-9c37-361fe0b79427	d29576b8-ec7a-4de1-a82c-f493611e681a
0	3	3	Plazi	ffb07bec-2d10-492d-9c37-361fe0b79427	d3807b91-f23d-466f-837e-313315db9e05
0	2	2	Plazi	ffb07bec-2d10-492d-9c37-361fe0b79427	d4560222-05a8-41ac-b752-9ff0500b5c6d
1	1	0	Plazi	ffb07bec-2d10-492d-9c37-361fe0b79427	d59f9063-2fe0-49ec-9bf3-449e3e31ddb9
4	4	0	Plazi	ffb07bec-2d10-492d-9c37-361fe0b79427	d65d51d3-dda3-4bad-9d80-8fcb46a782f7
18	18	0	Plazi	ffb07bec-2d10-492d-9c37-361fe0b79427	dca6be44-17a5-4a0b-8e9e-4250c489b0b1
934	934	0	GBIF France	da44cd31-5901-4687-a106-6d1c7734ee3a	dcfa2bf5-d06f-4557-a756-4377d76c7b84
0	5	5	Plazi	ffb07bec-2d10-492d-9c37-361fe0b79427	e013132f-6e60-40eb-8f2c-a11f06df1b89
1309	1309	0	National Biodiversity Network	d897a5b9-35ee-4232-94bd-b0bcaac003c2	e1b4c9d6-dfc6-4e26-b26a-ec312e64d8e0
0	3	3	Plazi	ffb07bec-2d10-492d-9c37-361fe0b79427	e49262e7-fb9f-4725-b49b-e291c5fdbb4c
270	270	0	Colombian Biodiversity Information System	7e865cba-7c46-417b-ade5-97f2cf5b7be0	f0ab2aba-785b-4a9c-829a-103aeaf4c612
915	915	0	National Biodiversity Network	d897a5b9-35ee-4232-94bd-b0bcaac003c2	f2689dda-e975-4312-b41b-d8833a56a771
64	64	0	GBIF France	da44cd31-5901-4687-a106-6d1c7734ee3a	f55d3de6-326e-4ef0-83e2-f64cc0bc38d0
0	121	121	Ocean Biodiversity Information System	ba0670b9-4186-41e6-8e70-f9cb3065551a	f74d575b-cd75-4a6e-aec6-20153a7f9b54
1259	1259	0	National Biodiversity Network	d897a5b9-35ee-4232-94bd-b0bcaac003c2	fd644422-a4fe-4a2d-b023-ee3b07df8c42
607	521	-86	GBIF Germany	4f6826f2-4ff6-443d-b966-e6913bd24013	fefd3ee8-601a-42c8-b250-3c981b259658
556	556	0	Belgian Biodiversity Platform	fb11cfe1-ebc3-45af-9159-17d9fddbcdac	ff2728bc-4c4f-4ec5-9c42-8f440859d804
0	6	6	Plazi	ffb07bec-2d10-492d-9c37-361fe0b79427	00423bac-ed5d-426e-9c93-c78cfa131dae
1786	2083	297	GBIF Portugal	673f7038-4262-4149-b753-5658a4e912f6	004ef655-c4ec-4b45-8c00-23603799af15
0	44	44	Ocean Biodiversity Information System	ba0670b9-4186-41e6-8e70-f9cb3065551a	0255a054-677c-4418-985c-78445d58183c
12019	12019	0	GBIF Argentina	2426a871-9feb-40a1-96c6-0c593a76b835	048d1f67-f86c-441d-b6f9-04b1b464e146
0	72	72	Plazi	ffb07bec-2d10-492d-9c37-361fe0b79427	058b438a-ffe3-452b-a286-9267419b3014
0	16	16	Plazi	ffb07bec-2d10-492d-9c37-361fe0b79427	061dca97-ff4d-4860-bc96-d6b329ff0717
188	188	0	GBIF France	da44cd31-5901-4687-a106-6d1c7734ee3a	06a94895-8b0e-4021-9cdf-3e9476b2bf2f
0	19	19	Plazi	ffb07bec-2d10-492d-9c37-361fe0b79427	0b640a13-bc27-40a4-ad63-ec4b7b2aba9e
0	8	8	Plazi	ffb07bec-2d10-492d-9c37-361fe0b79427	0bef1055-1cca-4a1c-b4cc-50aaa0173a2a
1	1	0	Plazi	ffb07bec-2d10-492d-9c37-361fe0b79427	0f50b518-84b6-4931-be29-80fb5f7ccbc1
1377	1377	0	Biodiversity Information System of Mexico	b324e8e9-9a4c-44fa-8f1a-7f39ea7ab576	0f958fcf-097a-4881-90d0-9321c3dae1a4
0	9	9	Plazi	ffb07bec-2d10-492d-9c37-361fe0b79427	1113230b-71a5-4505-b58f-2f9cbd5556f2
0	40391	40391	DanBIF - Danish Biodiversity Information Facility	4ddd294f-02b7-4359-ac33-0806a9ca9c6b	137fbdbd-3c31-4fba-b6b6-4489ad39a6c4
241	241	0	Plazi	ffb07bec-2d10-492d-9c37-361fe0b79427	1386f25d-9147-4038-8c94-6554c1eb409d
0	499	499	GBIF Portugal	673f7038-4262-4149-b753-5658a4e912f6	13c79ceb-0ceb-424f-b000-7991d7c49834
0	7	7	Plazi	ffb07bec-2d10-492d-9c37-361fe0b79427	14fefec5-7b5c-471e-bdee-71015622b05e
26	26	0	Plazi	ffb07bec-2d10-492d-9c37-361fe0b79427	165330f0-5155-4818-96bf-85465901de03
728	728	0	GBIF Germany	4f6826f2-4ff6-443d-b966-e6913bd24013	171915b4-b32c-403d-b8e7-e7d6bb98a9d8
1	1	0	Plazi	ffb07bec-2d10-492d-9c37-361fe0b79427	1853639b-152a-4c11-b7b3-bf297bc479c4
8529	8529	0	GBIF France	da44cd31-5901-4687-a106-6d1c7734ee3a	1ab3d288-fcbf-4b71-8630-a37c8debdbad
468	468	0	GBIF France	da44cd31-5901-4687-a106-6d1c7734ee3a	1bead174-082f-4065-be44-bb5de7b53868
12	12	0	Participant Node Managers Committee	7f48e0c8-5c96-49ec-b972-30748e339115	1db0b9e6-7d13-47be-ad0f-b59cf4181f17
9	9	0	Plazi	ffb07bec-2d10-492d-9c37-361fe0b79427	20a2e10b-bde2-4ad8-885a-96546a521289
0	496	496	Ocean Biodiversity Information System	ba0670b9-4186-41e6-8e70-f9cb3065551a	2206386c-93c8-49e0-a9b2-5efff0c20536
74854	85417	10563	GBIF Japan	db5705aa-6a6e-42f1-8942-d77b9f4896ea	231c4696-5b2b-4702-b495-2beb86e082e4
391	391	0	Biodiversity Information System of Mexico	b324e8e9-9a4c-44fa-8f1a-7f39ea7ab576	245ba352-b580-46bf-aa17-1ba70ee750fc
1115	1115	0	Biodiversity Information System of Mexico	b324e8e9-9a4c-44fa-8f1a-7f39ea7ab576	255d1027-5e6f-443c-910b-b9f405e2f14d
4	4	0	Plazi	ffb07bec-2d10-492d-9c37-361fe0b79427	295158ed-c627-49b9-adab-9c0c9f46ee7c
193	193	0	South African Biodiversity Information Facility	7190b835-4e86-4b6e-85c1-19cc6677c250	2c511f3c-7055-4056-87e4-90b1a238a623
210	210	0	GBIF France	da44cd31-5901-4687-a106-6d1c7734ee3a	2d05c0d3-cd6d-413b-914e-3ef30bef069e
412	412	0	GBIF Benin	efb9c00e-f802-45dd-8826-a52ec45b89ff	2dc27203-bf58-4477-9c8d-19c4953e1f3b
1	1	0	Plazi	ffb07bec-2d10-492d-9c37-361fe0b79427	3054bebe-7e5d-4fd5-abd0-e5213d404694
0	3	3	Plazi	ffb07bec-2d10-492d-9c37-361fe0b79427	307ccd59-ac34-4545-8092-e5e65bf0fdf5
116	116	0	GBIF France	da44cd31-5901-4687-a106-6d1c7734ee3a	3090a284-5636-4f55-8271-99e6d2afe132
1	1	0	Plazi	ffb07bec-2d10-492d-9c37-361fe0b79427	34fb1035-aa5a-4db3-a54a-de0f1dfad730
52	52	0	BioCASE	d8bbf693-a180-4995-94fe-6130795dcf2f	35a4da7e-413b-4450-bd7a-c74d0e0dff9a
55	55	0	Plazi	ffb07bec-2d10-492d-9c37-361fe0b79427	35faba39-0638-40ea-905c-89894fe62b43
91	91	0	Colombian Biodiversity Information System	7e865cba-7c46-417b-ade5-97f2cf5b7be0	3756117b-2462-4574-9ca8-43bd35f2001e
10984	10984	0	South African Biodiversity Information Facility	7190b835-4e86-4b6e-85c1-19cc6677c250	379156c8-c268-4537-aea4-83d94cc785f5
0	10	10	Plazi	ffb07bec-2d10-492d-9c37-361fe0b79427	3905da12-19aa-4ce8-ae65-2ffddf3ff08e
669	669	0	GBIF France	da44cd31-5901-4687-a106-6d1c7734ee3a	3a76a7f8-264a-4e1d-b80b-7897b5b8e486
0	376	376	Ocean Biodiversity Information System	ba0670b9-4186-41e6-8e70-f9cb3065551a	445c5799-cb09-46b5-89dd-bf739070b430
466	466	0	Colombian Biodiversity Information System	7e865cba-7c46-417b-ade5-97f2cf5b7be0	44bbe879-cf01-430a-bbcd-3bfce4d58ad5
0	1412	1412	Ocean Biodiversity Information System	ba0670b9-4186-41e6-8e70-f9cb3065551a	49b82490-090d-4180-bcd3-ccb7fc5e1447
1669	2056	387	GBIF Norway	4f829580-180d-46a9-9c87-ed8ec959b545	4a832966-48ad-4d83-858c-044705f74cac
6	6	0	Plazi	ffb07bec-2d10-492d-9c37-361fe0b79427	4c5d200d-4c5f-4fc0-aa9c-0d16a11c4c18
326	326	0	GBIF France	da44cd31-5901-4687-a106-6d1c7734ee3a	4f41f47f-a18a-405c-8ee7-befe48a3ee7a
2	2	0	Participant Node Managers Committee	7f48e0c8-5c96-49ec-b972-30748e339115	50f65e6b-81ce-45c6-bf92-216bbf9d136c
7630	7630	0	National Biodiversity Network	d897a5b9-35ee-4232-94bd-b0bcaac003c2	51e92f73-7290-4f9b-abc1-d68d23c339b2
1148	1148	0	National Biodiversity Network	d897a5b9-35ee-4232-94bd-b0bcaac003c2	55f30269-96ec-4800-9960-67fc68eac0d8
504	504	0	Secretariat of the Pacific Regional Environment Programme	29c6a139-ea7f-41f5-8d9b-c55af8736182	57f0df06-ae62-45ac-8a40-f65301f4adfb
0	17	17	Plazi	ffb07bec-2d10-492d-9c37-361fe0b79427	583c2a18-5e1a-4ea4-97f3-063fd5773d08
6	6	0	Plazi	ffb07bec-2d10-492d-9c37-361fe0b79427	5980cd85-915f-4af7-99e6-3ba24bbc1654
1350	1350	0	Atlas of Living Australia	4a6f1b71-969e-4fc5-a693-282b05e1220c	5c9c727b-a04e-430c-9264-01050bee76ea
144	144	0	GBIF Germany	4f6826f2-4ff6-443d-b966-e6913bd24013	5e9b6d49-d73d-4704-9485-65710c81c128
72	72	0	GBIF Kenya	2a44d626-9f7a-4120-8a7a-4ab5ac15ff2a	5ece80e3-73f0-48e0-9125-1cd24a4ecdbd
9861	9861	0	Biodiversity Information System of Mexico	b324e8e9-9a4c-44fa-8f1a-7f39ea7ab576	5fab027d-14b6-4659-9a7e-8a0d4bd3e12b
110	110	0	GBIF Germany	4f6826f2-4ff6-443d-b966-e6913bd24013	61193068-f762-11e1-a439-00145eb45e9a
85	121	36	Plazi	ffb07bec-2d10-492d-9c37-361fe0b79427	6183f557-d88b-466e-81ea-549149b529cb
43	43	0	GBIF Germany	4f6826f2-4ff6-443d-b966-e6913bd24013	61c631dc-f762-11e1-a439-00145eb45e9a
55	55	0	GBIF Germany	4f6826f2-4ff6-443d-b966-e6913bd24013	621d33ce-f762-11e1-a439-00145eb45e9a
1287	1287	0	Participant Node Managers Committee	7f48e0c8-5c96-49ec-b972-30748e339115	62451278-f873-46a5-914e-a25e010a1a37
0	7	7	Ocean Biodiversity Information System	ba0670b9-4186-41e6-8e70-f9cb3065551a	6258b3e6-c6af-4c93-9db1-a610385bccd4
0	485	485	Ocean Biodiversity Information System	ba0670b9-4186-41e6-8e70-f9cb3065551a	62a98f42-67b1-491d-9894-e21675f3e508
4	4	0	GBIF Germany	4f6826f2-4ff6-443d-b966-e6913bd24013	62ef6a6a-f762-11e1-a439-00145eb45e9a
283	283	0	GBIF Germany	4f6826f2-4ff6-443d-b966-e6913bd24013	635a9dfd-d841-4797-a555-e824dd8ae918
99	99	0	GBIF Germany	4f6826f2-4ff6-443d-b966-e6913bd24013	636bdd34-f762-11e1-a439-00145eb45e9a
0	26	26	Plazi	ffb07bec-2d10-492d-9c37-361fe0b79427	64832a0a-3db6-4782-93f8-3b3f58f328d9
1603	1603	0	Participant Node Managers Committee	7f48e0c8-5c96-49ec-b972-30748e339115	6638025e-8f15-45e7-9fc4-2afe55b20d1e
218	218	0	Plazi	ffb07bec-2d10-492d-9c37-361fe0b79427	66a4827c-34cd-46a0-aceb-4bbaf4166a65
116	116	0	GBIF Germany	4f6826f2-4ff6-443d-b966-e6913bd24013	66cce086-f762-11e1-a439-00145eb45e9a
141	141	0	GBIF Germany	4f6826f2-4ff6-443d-b966-e6913bd24013	672d958e-f762-11e1-a439-00145eb45e9a
9391	9391	0	Participant Node Managers Committee	7f48e0c8-5c96-49ec-b972-30748e339115	6770737f-ae99-4b5c-8adf-71b0706daf73
95	95	0	GBIF Germany	4f6826f2-4ff6-443d-b966-e6913bd24013	68c22ab8-f762-11e1-a439-00145eb45e9a
28	28	0	GBIF Germany	4f6826f2-4ff6-443d-b966-e6913bd24013	6920fb1a-f762-11e1-a439-00145eb45e9a
276	251	-25	GBIF Germany	4f6826f2-4ff6-443d-b966-e6913bd24013	694bbf44-f762-11e1-a439-00145eb45e9a
3897	3897	0	Participant Node Managers Committee	7f48e0c8-5c96-49ec-b972-30748e339115	6984bfd1-2483-470d-b92f-19d08d8aa6b5
17	17	0	GBIF Germany	4f6826f2-4ff6-443d-b966-e6913bd24013	6a166a8c-f762-11e1-a439-00145eb45e9a
3006	3006	0	GBIF Germany	4f6826f2-4ff6-443d-b966-e6913bd24013	6a190a6c-f762-11e1-a439-00145eb45e9a
18	18	0	GBIF Germany	4f6826f2-4ff6-443d-b966-e6913bd24013	6b192776-f762-11e1-a439-00145eb45e9a
15964	15964	0	National Biodiversity Network	d897a5b9-35ee-4232-94bd-b0bcaac003c2	6d2c56f6-9643-429c-b4e6-c752f6a2602a
21	21	0	Colombian Biodiversity Information System	7e865cba-7c46-417b-ade5-97f2cf5b7be0	6fba5368-bdd6-4c32-b611-f3489fc8724a
231	231	0	GBIF Germany	4f6826f2-4ff6-443d-b966-e6913bd24013	70a17d9c-f762-11e1-a439-00145eb45e9a
1	1	0	Plazi	ffb07bec-2d10-492d-9c37-361fe0b79427	7112ded3-fa31-4c7b-a093-4d3dedafd571
32	32	0	GBIF Germany	4f6826f2-4ff6-443d-b966-e6913bd24013	715d2f7e-f762-11e1-a439-00145eb45e9a
13	13	0	Plazi	ffb07bec-2d10-492d-9c37-361fe0b79427	719ac0a1-94e1-4f6b-9301-2f88113caa87
1815	1815	0	Atlas of Living Australia	4a6f1b71-969e-4fc5-a693-282b05e1220c	71e95288-f762-11e1-a439-00145eb45e9a
0	13	13	Plazi	ffb07bec-2d10-492d-9c37-361fe0b79427	72f4b355-ff3e-4ca2-b6be-b6ef2b406c6c
14	14	0	GBIF Germany	4f6826f2-4ff6-443d-b966-e6913bd24013	73fa2cb4-f762-11e1-a439-00145eb45e9a
245	245	0	GBIF Germany	4f6826f2-4ff6-443d-b966-e6913bd24013	747b4e98-f762-11e1-a439-00145eb45e9a
20	20	0	Plazi	ffb07bec-2d10-492d-9c37-361fe0b79427	74cef78d-1ad1-428b-bfa4-3bfc095b7660
2242	2242	0	GBIF France	da44cd31-5901-4687-a106-6d1c7734ee3a	76d73b5d-98be-465f-bd78-3ed0909c8fbf
4	4	0	GBIF Germany	4f6826f2-4ff6-443d-b966-e6913bd24013	788cade2-f762-11e1-a439-00145eb45e9a
1	1	0	GBIF Germany	4f6826f2-4ff6-443d-b966-e6913bd24013	789d52b4-f762-11e1-a439-00145eb45e9a
3681	3681	0	Korean Biodiversity Information Facility	e0a1e772-0177-4800-94b4-2d023fe6cdf4	7b18be0c-f762-11e1-a439-00145eb45e9a
80	80	0	GBIF Germany	4f6826f2-4ff6-443d-b966-e6913bd24013	7cbc120e-f762-11e1-a439-00145eb45e9a
0	178	178	Colombian Biodiversity Information System	7e865cba-7c46-417b-ade5-97f2cf5b7be0	7de008fe-cca8-45d3-b1a5-9023a3fa7162
960	452	-508	GBIF Germany	4f6826f2-4ff6-443d-b966-e6913bd24013	7e1ceec0-f762-11e1-a439-00145eb45e9a
143	143	0	GBIF Germany	4f6826f2-4ff6-443d-b966-e6913bd24013	7e59cffc-f762-11e1-a439-00145eb45e9a
1854	501	-1353	GBIF Germany	4f6826f2-4ff6-443d-b966-e6913bd24013	7efc4a84-f762-11e1-a439-00145eb45e9a
9	9	0	Plazi	ffb07bec-2d10-492d-9c37-361fe0b79427	7f5eb64d-5c44-4c7b-bf96-00495bf2f9e0
2	2	0	Plazi	ffb07bec-2d10-492d-9c37-361fe0b79427	7fa4a4ce-5db2-4d06-adeb-db21b0574cef
2002	1989	-13	GBIF Germany	4f6826f2-4ff6-443d-b966-e6913bd24013	820d68e8-f762-11e1-a439-00145eb45e9a
4563	4563	0	Ocean Biodiversity Information System	ba0670b9-4186-41e6-8e70-f9cb3065551a	833a0adc-c1f0-45a2-9970-8cf9bf171d30
1628	1628	0	DanBIF - Danish Biodiversity Information Facility	4ddd294f-02b7-4359-ac33-0806a9ca9c6b	84cf0294-f762-11e1-a439-00145eb45e9a
25535	25535	0	U.S. Geological Survey	8618c64a-93e0-4300-b546-7249e5148ed2	84e94348-f762-11e1-a439-00145eb45e9a
41	41	0	GBIF France	da44cd31-5901-4687-a106-6d1c7734ee3a	859c1463-16e5-492a-a4d6-a0d429aa455b
2586	2586	0	GBIF Japan	db5705aa-6a6e-42f1-8942-d77b9f4896ea	8610e5c8-f762-11e1-a439-00145eb45e9a
40	29	-11	GBIF Germany	4f6826f2-4ff6-443d-b966-e6913bd24013	86fb4154-f762-11e1-a439-00145eb45e9a
445	427	-18	GBIF Germany	4f6826f2-4ff6-443d-b966-e6913bd24013	87048b56-f762-11e1-a439-00145eb45e9a
527	386	-141	GBIF Germany	4f6826f2-4ff6-443d-b966-e6913bd24013	87f8ab78-f762-11e1-a439-00145eb45e9a
17	17	0	GBIF Germany	4f6826f2-4ff6-443d-b966-e6913bd24013	88711ff4-f762-11e1-a439-00145eb45e9a
1	1	0	Plazi	ffb07bec-2d10-492d-9c37-361fe0b79427	88c111bb-7e96-4a7e-b6ee-0f08f179807c
0	12	12	Plazi	ffb07bec-2d10-492d-9c37-361fe0b79427	8b5fc63e-4bcb-48d0-8015-bda6684e7590
4	4	0	GBIF Germany	4f6826f2-4ff6-443d-b966-e6913bd24013	8b8ae1b6-f762-11e1-a439-00145eb45e9a
189	189	0	GBIF Germany	4f6826f2-4ff6-443d-b966-e6913bd24013	8c2b713a-f762-11e1-a439-00145eb45e9a
3	3	0	GBIF Germany	4f6826f2-4ff6-443d-b966-e6913bd24013	8c4364b6-f762-11e1-a439-00145eb45e9a
52	29	-23	GBIF Germany	4f6826f2-4ff6-443d-b966-e6913bd24013	8cfa13b4-f762-11e1-a439-00145eb45e9a
3	1	-2	GBIF Germany	4f6826f2-4ff6-443d-b966-e6913bd24013	8d6173f6-f762-11e1-a439-00145eb45e9a
211	211	0	GBIF Germany	4f6826f2-4ff6-443d-b966-e6913bd24013	8da5b3ae-f762-11e1-a439-00145eb45e9a
667	440	-227	GBIF Germany	4f6826f2-4ff6-443d-b966-e6913bd24013	8e705910-f762-11e1-a439-00145eb45e9a
0	1	1	Plazi	ffb07bec-2d10-492d-9c37-361fe0b79427	8f7f46cf-f03f-4990-9fa2-35bdb4c53822
59	23	-36	GBIF Germany	4f6826f2-4ff6-443d-b966-e6913bd24013	90dad054-f762-11e1-a439-00145eb45e9a
15	10	-5	GBIF Germany	4f6826f2-4ff6-443d-b966-e6913bd24013	91418a88-f762-11e1-a439-00145eb45e9a
1999	1999	0	Colombian Biodiversity Information System	7e865cba-7c46-417b-ade5-97f2cf5b7be0	91b054b6-7198-46fa-9a60-6e0625cc2980
1215	1074	-141	GBIF Germany	4f6826f2-4ff6-443d-b966-e6913bd24013	91b0baa2-f762-11e1-a439-00145eb45e9a
5	5	0	Plazi	ffb07bec-2d10-492d-9c37-361fe0b79427	91b8c218-cc26-4601-991d-abf978069a5a
392	392	0	GBIF Germany	4f6826f2-4ff6-443d-b966-e6913bd24013	91d7b710-f762-11e1-a439-00145eb45e9a
75	75	0	GBIF Germany	4f6826f2-4ff6-443d-b966-e6913bd24013	92059cde-f762-11e1-a439-00145eb45e9a
41	41	0	GBIF Germany	4f6826f2-4ff6-443d-b966-e6913bd24013	9216c284-f762-11e1-a439-00145eb45e9a
393	393	0	GBIF Germany	4f6826f2-4ff6-443d-b966-e6913bd24013	92868f56-f762-11e1-a439-00145eb45e9a
349	349	0	National Biodiversity Network	d897a5b9-35ee-4232-94bd-b0bcaac003c2	93258515-cbcf-450e-932f-8b39443f2ef0
792	792	0	GBIF Germany	4f6826f2-4ff6-443d-b966-e6913bd24013	93f62c52-f762-11e1-a439-00145eb45e9a
0	32	32	Plazi	ffb07bec-2d10-492d-9c37-361fe0b79427	95a757b3-6441-470f-821d-3dbaec156578
7474	22188	14714	GBIF Japan	db5705aa-6a6e-42f1-8942-d77b9f4896ea	97aa5814-7121-4458-93fb-70a9a99da89a
5332	5332	0	South African Biodiversity Information Facility	7190b835-4e86-4b6e-85c1-19cc6677c250	999d8fed-d06d-48d8-87ee-cc36e6c8456c
3	3	0	Plazi	ffb07bec-2d10-492d-9c37-361fe0b79427	9b73ba17-ff61-426c-b49b-96cb78ee163c
0	640	640	Ocean Biodiversity Information System	ba0670b9-4186-41e6-8e70-f9cb3065551a	9bc44547-ec0b-4496-994a-cb950cbfe98b
41	41	0	Plazi	ffb07bec-2d10-492d-9c37-361fe0b79427	9bd8f79a-7f9f-4b4c-9e70-57318f77cfc0
35084	35084	0	GBIF France	da44cd31-5901-4687-a106-6d1c7734ee3a	a3e74d8a-5944-46cb-9ea0-e0fdc37631fe
0	21769	21769	GBIF France	da44cd31-5901-4687-a106-6d1c7734ee3a	a4223067-27cf-472b-b834-e6cdfa9ce030
2	2	0	Plazi	ffb07bec-2d10-492d-9c37-361fe0b79427	a538b032-c5c6-4d11-9bab-489b920243da
92	92	0	Colombian Biodiversity Information System	7e865cba-7c46-417b-ade5-97f2cf5b7be0	a6a41870-6472-4a70-8dc7-c1976665136b
4333	4333	0	GBIF France	da44cd31-5901-4687-a106-6d1c7734ee3a	a837f452-43bc-4c6f-bb2d-db47b931df6d
90	90	0	Colombian Biodiversity Information System	7e865cba-7c46-417b-ade5-97f2cf5b7be0	a96ab213-6a98-46eb-b016-bbff44153785
13	13	0	Plazi	ffb07bec-2d10-492d-9c37-361fe0b79427	a9af11dc-d705-48ed-96fb-3b323accc19e
0	3	3	Plazi	ffb07bec-2d10-492d-9c37-361fe0b79427	a9efdb44-e01d-441c-89de-78b00d0413b6
9	9	0	Plazi	ffb07bec-2d10-492d-9c37-361fe0b79427	abd9b9c2-84e2-4f85-bf1a-e561e41782d4
0	5	5	Plazi	ffb07bec-2d10-492d-9c37-361fe0b79427	ac3499c5-9bb2-4709-ae58-e91806181193
0	220	220	Indonesian Biodiversity Information Facility	2ebd91f6-f14f-4375-b525-c011a3774f03	affbcc64-f91b-4f3e-8456-e91b7c690499
0	5800	5800	Belgian Biodiversity Platform	fb11cfe1-ebc3-45af-9159-17d9fddbcdac	b03da093-afe7-4162-97ea-a7dafb3ca805
5	5	0	Plazi	ffb07bec-2d10-492d-9c37-361fe0b79427	b23a817a-62a0-4d3e-9da2-c364e9708ed6
1490	1490	0	Colombian Biodiversity Information System	7e865cba-7c46-417b-ade5-97f2cf5b7be0	b2b259a4-a7c7-49f5-87a0-d298bddf747a
15	15	0	Plazi	ffb07bec-2d10-492d-9c37-361fe0b79427	b5a26fc1-28bc-4edf-b0fc-9e535ddd9ec6
1	1	0	Plazi	ffb07bec-2d10-492d-9c37-361fe0b79427	b6d04fe1-9712-4a23-8eda-0665c1941a61
575	575	0	GBIF France	da44cd31-5901-4687-a106-6d1c7734ee3a	b99d0a5a-c490-4840-a786-aa27b05cc49b
16	16	0	Tanzania Biodiversity Information Facility	abd95ca6-3959-4db9-aaa6-2de1aeecf514	ba9b66a3-2d11-4193-922e-ace4d5909239
43	43	0	Plazi	ffb07bec-2d10-492d-9c37-361fe0b79427	bb8db045-2674-4e59-ac63-d1f909d1dcfb
633	633	0	GBIF Benin	efb9c00e-f802-45dd-8826-a52ec45b89ff	bdc80cd9-35d8-4b23-9df1-e8b1c50229a5
0	427	427	Indonesian Biodiversity Information Facility	2ebd91f6-f14f-4375-b525-c011a3774f03	bdcc3e75-c66b-4b85-bc37-e82776aec923
437	437	0	GBIF Japan	db5705aa-6a6e-42f1-8942-d77b9f4896ea	be41dbd4-e195-45d7-8d60-985f7eca716b
2512	2512	0	GBIF Germany	4f6826f2-4ff6-443d-b966-e6913bd24013	bebe5e1e-ccdb-43c1-8a0d-018ab2eb746a
11154	11154	0	GBIF France	da44cd31-5901-4687-a106-6d1c7734ee3a	bf0bcb45-22c8-4382-9521-ca7b33e5eb47
112	112	0	Ocean Biodiversity Information System	ba0670b9-4186-41e6-8e70-f9cb3065551a	c1c0f96e-e26b-4146-a675-0837689a687c
4	4	0	Plazi	ffb07bec-2d10-492d-9c37-361fe0b79427	c28abfaa-4012-488d-9c90-a06cc8da589b
3	3	0	Plazi	ffb07bec-2d10-492d-9c37-361fe0b79427	c2af20fb-e5f9-4f23-b847-ec08829d8fe6
26	26	0	Plazi	ffb07bec-2d10-492d-9c37-361fe0b79427	c35077ff-461c-4470-9158-8c096a1b45e0
49586	49586	0	National Biodiversity Network	d897a5b9-35ee-4232-94bd-b0bcaac003c2	c38cea03-d7d8-44c7-9b40-750219df831a
154	154	0	Plazi	ffb07bec-2d10-492d-9c37-361fe0b79427	c5336d61-ecae-4eb6-8592-60f43e587af8
17	17	0	Plazi	ffb07bec-2d10-492d-9c37-361fe0b79427	c6eb5f17-b426-42b0-9221-54e58a96a3a0
0	10799	10799	U.S. Geological Survey	8618c64a-93e0-4300-b546-7249e5148ed2	c8ba2098-74e5-4379-82dc-e83804b59e3f
241	241	0	Ghana Biodiversity Information Facility	b5633b75-6a86-4fdf-9cfc-506047fb9dc7	c8fb4ced-0374-46f7-8c03-5eb5a6b70640
18354	18354	0	GBIF Japan	db5705aa-6a6e-42f1-8942-d77b9f4896ea	c9c4b765-59ed-4e7b-bbb8-9205f66f288c
40	40	0	Plazi	ffb07bec-2d10-492d-9c37-361fe0b79427	ca571051-a81b-44d3-9c71-35c50a927bf5
97	97	0	Colombian Biodiversity Information System	7e865cba-7c46-417b-ade5-97f2cf5b7be0	cabfb5e6-be25-4f43-b0cf-f9aa98050579
47670	47670	0	Canada Biodiversity Information Facility	8f83fc96-c966-4126-83f7-bf044dc49efa	cd875b5a-b3fe-48f2-94c7-371cab1431f3
397	397	0	GBIF Germany	4f6826f2-4ff6-443d-b966-e6913bd24013	cdd13270-de0b-4002-a8a5-049b56805ae1
734	734	0	GBIF Argentina	2426a871-9feb-40a1-96c6-0c593a76b835	cf918a34-1a21-48e8-9879-298c5d37960d
26	26	0	Colombian Biodiversity Information System	7e865cba-7c46-417b-ade5-97f2cf5b7be0	d23f84c8-ff18-4060-b7df-dbef7eaffb3e
57	55	-2	Plazi	ffb07bec-2d10-492d-9c37-361fe0b79427	d2615e10-8703-400b-b571-6c431b0ed9a7
880	880	0	GBIF France	da44cd31-5901-4687-a106-6d1c7734ee3a	d4d77b21-464f-4e05-91ba-f6ebab042655
1957	4368	2411	U.S. Geological Survey	8618c64a-93e0-4300-b546-7249e5148ed2	d6778c10-d853-4a65-af77-e1dd41c2974a
7920	7920	0	GBIF Spain	1f94b3ca-9345-4d65-afe2-4bace93aa0fe	db6cd9d7-7be5-4cd0-8b3c-fb6dd7446472
17	17	0	Plazi	ffb07bec-2d10-492d-9c37-361fe0b79427	dd6d5115-1e53-431a-9b03-5cb2d0ce887e
104	104	0	Colombian Biodiversity Information System	7e865cba-7c46-417b-ade5-97f2cf5b7be0	de10d7a1-a4f7-4aa8-aa1d-72364cecc263
124	124	0	GBIF France	da44cd31-5901-4687-a106-6d1c7734ee3a	de857d67-dc65-4b25-ba04-a72cab57e4aa
0	9	9	Plazi	ffb07bec-2d10-492d-9c37-361fe0b79427	dfad6ad5-1d7c-4793-97ae-e4b6b43ad06f
11	11	0	Plazi	ffb07bec-2d10-492d-9c37-361fe0b79427	e0e834c8-6666-4190-95e7-48e61fe827a5
2364	2364	0	Biodiversity Information System of Mexico	b324e8e9-9a4c-44fa-8f1a-7f39ea7ab576	e728ed76-9424-48e9-8955-82b23ed91e46
0	1	1	Participant Node Managers Committee	7f48e0c8-5c96-49ec-b972-30748e339115	ebd106a2-2545-4f53-902b-98b504d87cee
80	80	0	Belgian Biodiversity Platform	fb11cfe1-ebc3-45af-9159-17d9fddbcdac	ec8064cf-81c1-4e99-9c62-b36ac0d0f1a0
1	1	0	Plazi	ffb07bec-2d10-492d-9c37-361fe0b79427	ee027508-bf7f-4a5b-b092-fb78fbb85952
0	77	77	Plazi	ffb07bec-2d10-492d-9c37-361fe0b79427	ee0b9a1a-cbc5-4d39-bb90-1e770cb8160a
0	3	3	Plazi	ffb07bec-2d10-492d-9c37-361fe0b79427	f2b17705-4261-40b6-9fae-85e65cc54382
0	32	32	Plazi	ffb07bec-2d10-492d-9c37-361fe0b79427	f390cbbb-b214-4be7-85a8-2853c575584a
12972	12972	0	GBIF Japan	db5705aa-6a6e-42f1-8942-d77b9f4896ea	f77c791c-51f8-49f1-ab01-294b7301fadd
18	18	0	National Biodiversity Network	d897a5b9-35ee-4232-94bd-b0bcaac003c2	f784045b-f8d3-48b6-a787-8f1a2a184b68
2	2	0	Plazi	ffb07bec-2d10-492d-9c37-361fe0b79427	f9419681-3305-402a-a1cc-3fbd44356bb3
0	24	24	Participant Node Managers Committee	7f48e0c8-5c96-49ec-b972-30748e339115	f97d9caf-842e-4b4f-a5ef-3bab5192e331
1357	1356	-1	Taiwan Biodiversity Information Facility	e1b85abc-61f9-430f-ba79-6813dec53a0f	fc8160f5-6d79-4fba-b587-fc8885d59471
2	2	0	Plazi	ffb07bec-2d10-492d-9c37-361fe0b79427	fc8ca55e-75cf-4c1e-be46-66a4d7119b1b
6801	6801	0	Biodiversity Information System of Mexico	b324e8e9-9a4c-44fa-8f1a-7f39ea7ab576	fdf166f4-f045-476e-8b16-529b83ced33a
18	18	0	Plazi	ffb07bec-2d10-492d-9c37-361fe0b79427	ff43e450-a201-4f08-8a0f-5e909c4dd43d
17	17	0	Plazi	ffb07bec-2d10-492d-9c37-361fe0b79427	03813b72-37a3-4c92-993e-cd5754eba943
39	39	0	Plazi	ffb07bec-2d10-492d-9c37-361fe0b79427	0415330f-df44-411f-b1f0-342de03a6dad
79	79	0	GBIF Germany	4f6826f2-4ff6-443d-b966-e6913bd24013	043e4354-97ef-4da4-a90f-bbe38b7d0e9c
0	9	9	National Biodiversity Network	d897a5b9-35ee-4232-94bd-b0bcaac003c2	06e9df25-f352-42d5-a753-31035591bfc9
5	5	0	Plazi	ffb07bec-2d10-492d-9c37-361fe0b79427	0742e4ad-a4ff-46e5-b363-a027d7e92505
3737	3737	0	Participant Node Managers Committee	7f48e0c8-5c96-49ec-b972-30748e339115	0963db57-6049-4097-96e4-f94f484f9323
10	10	0	Colombian Biodiversity Information System	7e865cba-7c46-417b-ade5-97f2cf5b7be0	13f4c802-5192-45aa-ba37-4c88bbe983b9
11	11	0	Plazi	ffb07bec-2d10-492d-9c37-361fe0b79427	14b6fcf7-c542-4a97-9579-d61ddddd94bd
265	265	0	GBIF Brazil	cdc9736d-5ff7-4ece-9959-3c744360cdb3	15484cf0-ec61-45cb-bf9c-73b365d998ef
30402	30174	-228	GBIF Germany	4f6826f2-4ff6-443d-b966-e6913bd24013	16a3533d-90cf-4402-95a4-42437e2f9660
4490	4490	0	Ocean Biodiversity Information System	ba0670b9-4186-41e6-8e70-f9cb3065551a	16a62f7b-e52d-49b6-8605-b69d22d0572c
10107	10107	0	GBIF Uganda	71b40829-6a12-4c3d-8fee-5746f5e9cf8c	1882cf98-ecdb-4217-9fb7-7b6a02bc0ebf
4630	4630	0	GBIF France	da44cd31-5901-4687-a106-6d1c7734ee3a	252291cb-dcd5-4b5d-b3c7-7c828ec46f58
0	147026	147026	GBIF Finland	dd514216-5c7c-45f3-910d-797424cb5be6	28b85661-dc35-4dfc-acb3-6f0dc34ee716
0	3	3	Plazi	ffb07bec-2d10-492d-9c37-361fe0b79427	29a90dbf-e59c-4bd0-8801-cf2fca504f76
0	137	137	Plazi	ffb07bec-2d10-492d-9c37-361fe0b79427	2b22dadf-f467-49c8-be34-1362152a881b
4	4	0	Participant Node Managers Committee	7f48e0c8-5c96-49ec-b972-30748e339115	2f0e17e4-c298-4437-a5cc-3f569307ab21
25345	25345	0	Colombian Biodiversity Information System	7e865cba-7c46-417b-ade5-97f2cf5b7be0	2f94ef74-afbe-4039-bfac-881d789672cd
35	35	0	Plazi	ffb07bec-2d10-492d-9c37-361fe0b79427	2ffe9030-0b6d-48d9-88a0-819dc0c8a941
0	14	14	Plazi	ffb07bec-2d10-492d-9c37-361fe0b79427	30e4f763-f98a-4bf0-b310-b09bba0d7c83
0	3030	3030	Canada Biodiversity Information Facility	8f83fc96-c966-4126-83f7-bf044dc49efa	31c8db7d-098d-4339-a77b-901865139f1c
65	65	0	GBIF France	da44cd31-5901-4687-a106-6d1c7734ee3a	333478d2-bb7f-4772-a2bc-ca45e896f3eb
3377	3377	0	U.S. Geological Survey	8618c64a-93e0-4300-b546-7249e5148ed2	34563ec7-d5cc-4e08-972e-83913fa07a9d
0	439	439	Participant Node Managers Committee	7f48e0c8-5c96-49ec-b972-30748e339115	34d83b2e-c5b0-4c6e-907a-58864aa3212c
0	378	378	Ocean Biodiversity Information System	ba0670b9-4186-41e6-8e70-f9cb3065551a	3563c7c2-0173-452e-b282-afe13507fd23
117269	117269	0	GBIF Brazil	cdc9736d-5ff7-4ece-9959-3c744360cdb3	375273af-0137-4d4d-9b0c-3c8b107a808b
84	84	0	GBIF France	da44cd31-5901-4687-a106-6d1c7734ee3a	3b1446e8-5f26-49aa-9d69-29da12940dda
0	304	304	Colombian Biodiversity Information System	7e865cba-7c46-417b-ade5-97f2cf5b7be0	3b928c56-01f6-47d0-95f8-2114d00c1b08
0	1073	1073	GBIF Ecuador	2dc472f1-c3d9-486d-b3c1-12ca7ba1ed22	3ec884f2-a462-405e-8a1f-d55c462a04de
5892	5892	0	GBIF France	da44cd31-5901-4687-a106-6d1c7734ee3a	4126beef-f40e-48c6-9798-41241ca01ea0
400	407	7	GBIF Germany	4f6826f2-4ff6-443d-b966-e6913bd24013	4157034d-e40c-4534-808c-93dbfb579e51
102	102	0	Plazi	ffb07bec-2d10-492d-9c37-361fe0b79427	432b7d8c-8d5b-4f24-ae3e-28484ed728d3
16512	16512	0	GBIF France	da44cd31-5901-4687-a106-6d1c7734ee3a	43785b7f-8bf6-48cc-90ba-cf6821db7637
0	726	726	U.S. Geological Survey	8618c64a-93e0-4300-b546-7249e5148ed2	45a84259-8f6d-4b2a-9fcb-d77d2e3ac668
91	91	0	GBIF France	da44cd31-5901-4687-a106-6d1c7734ee3a	46e1dd22-3061-4cf3-b494-4d1fdcdd5de4
12	12	0	Plazi	ffb07bec-2d10-492d-9c37-361fe0b79427	4960431c-4301-4d44-be12-54fc4975e919
59379	60345	966	Netherlands Biodiversity Information Facility	0909d601-bda2-42df-9e63-a6d51847ebce	4c7c21a8-68d3-49c5-b090-6b26259a291b
2244	2244	0	U.S. Geological Survey	8618c64a-93e0-4300-b546-7249e5148ed2	4c97f57e-69d6-40f8-a310-2a716a02f911
41	41	0	Plazi	ffb07bec-2d10-492d-9c37-361fe0b79427	4fc08779-901b-4adc-9ef3-2d6b39083417
33	33	0	GBIF France	da44cd31-5901-4687-a106-6d1c7734ee3a	516cb419-4608-431a-bdef-6b1ca10df4d2
102476	102476	0	U.S. Geological Survey	8618c64a-93e0-4300-b546-7249e5148ed2	552f282a-92a6-4f41-95ef-c6537026fbeb
0	1	1	Plazi	ffb07bec-2d10-492d-9c37-361fe0b79427	5752f424-c4ba-4160-9988-f8f2424894a3
0	13	13	Ocean Biodiversity Information System	ba0670b9-4186-41e6-8e70-f9cb3065551a	5813c35b-1770-4d3d-b440-0e10899e6dae
4	4	0	Plazi	ffb07bec-2d10-492d-9c37-361fe0b79427	5852ff3a-6278-4b9d-9d27-17b867e37793
5	5	0	Plazi	ffb07bec-2d10-492d-9c37-361fe0b79427	5d75bde8-bbd0-476c-82fa-7f1fa1e14261
0	36	36	Plazi	ffb07bec-2d10-492d-9c37-361fe0b79427	5e022639-1a3f-4283-9384-56fb446c3da6
8	8	0	Plazi	ffb07bec-2d10-492d-9c37-361fe0b79427	5e8d0db0-d3dd-415e-8871-eeb9d2de1f88
0	126	126	Plazi	ffb07bec-2d10-492d-9c37-361fe0b79427	5eb13fed-182f-4e20-9dce-d6ffee55a4f6
48	48	0	GBIF Germany	4f6826f2-4ff6-443d-b966-e6913bd24013	61e7b424-f762-11e1-a439-00145eb45e9a
10	10	0	GBIF Germany	4f6826f2-4ff6-443d-b966-e6913bd24013	624711da-f762-11e1-a439-00145eb45e9a
5	5	0	GBIF Germany	4f6826f2-4ff6-443d-b966-e6913bd24013	63591906-f762-11e1-a439-00145eb45e9a
18	14	-4	GBIF Germany	4f6826f2-4ff6-443d-b966-e6913bd24013	65cdc2fe-f762-11e1-a439-00145eb45e9a
145	142	-3	GBIF Germany	4f6826f2-4ff6-443d-b966-e6913bd24013	65e2eb02-f762-11e1-a439-00145eb45e9a
55826	55826	0	GBIF France	da44cd31-5901-4687-a106-6d1c7734ee3a	663bae95-7134-4cb3-9085-e9c4afbf8fb0
322	322	0	GBIF Finland	dd514216-5c7c-45f3-910d-797424cb5be6	67198231-b814-491e-a1a3-870594f914f5
87	87	0	GBIF Germany	4f6826f2-4ff6-443d-b966-e6913bd24013	672c6a7e-f762-11e1-a439-00145eb45e9a
0	1	1	Plazi	ffb07bec-2d10-492d-9c37-361fe0b79427	6760ac9d-52a2-4bd2-b1f8-4d1adaf97f50
87	87	0	GBIF Germany	4f6826f2-4ff6-443d-b966-e6913bd24013	67ff31a2-f762-11e1-a439-00145eb45e9a
68	68	0	GBIF Germany	4f6826f2-4ff6-443d-b966-e6913bd24013	6873669e-f762-11e1-a439-00145eb45e9a
1	1	0	Plazi	ffb07bec-2d10-492d-9c37-361fe0b79427	69180894-4ad8-4eae-8f5b-d1dcaca4d60d
0	50187	50187	Korean Biodiversity Information Facility	e0a1e772-0177-4800-94b4-2d023fe6cdf4	692904d4-b24f-4603-98f8-d6aa409d07a6
88	88	0	GBIF Germany	4f6826f2-4ff6-443d-b966-e6913bd24013	69cc5b4a-f762-11e1-a439-00145eb45e9a
505	505	0	South African Biodiversity Information Facility	7190b835-4e86-4b6e-85c1-19cc6677c250	69dc3408-7a87-4b40-8800-edba878d04a9
18	18	0	GBIF Germany	4f6826f2-4ff6-443d-b966-e6913bd24013	6b1bdea8-f762-11e1-a439-00145eb45e9a
12	12	0	GBIF Germany	4f6826f2-4ff6-443d-b966-e6913bd24013	6bc8661e-f762-11e1-a439-00145eb45e9a
192	192	0	GBIF Germany	4f6826f2-4ff6-443d-b966-e6913bd24013	6c3cceb4-f762-11e1-a439-00145eb45e9a
0	3	3	Plazi	ffb07bec-2d10-492d-9c37-361fe0b79427	6ca8ed27-df36-4852-957d-06e1539f095c
0	5	5	Plazi	ffb07bec-2d10-492d-9c37-361fe0b79427	6e1d7e6d-1e0e-4628-8ce9-83bf62d5fe90
368	368	0	Colombian Biodiversity Information System	7e865cba-7c46-417b-ade5-97f2cf5b7be0	6f3d180a-4965-4eb2-96e7-ec9b1fb8aea3
6	6	0	GBIF Germany	4f6826f2-4ff6-443d-b966-e6913bd24013	6fda07bc-f762-11e1-a439-00145eb45e9a
273	273	0	Plazi	ffb07bec-2d10-492d-9c37-361fe0b79427	70713ddc-4f67-4f0a-8625-41aa37abb017
0	2	2	Plazi	ffb07bec-2d10-492d-9c37-361fe0b79427	71162ab5-a8df-4e4d-931e-73e5cb92dbff
5425	6956	1531	GBIF Japan	db5705aa-6a6e-42f1-8942-d77b9f4896ea	71bd5407-b775-46c7-ae95-ee3763d54d19
17	17	0	Plazi	ffb07bec-2d10-492d-9c37-361fe0b79427	7413b276-473c-4abc-82ce-0a710b284303
120	512	392	GBIF Japan	db5705aa-6a6e-42f1-8942-d77b9f4896ea	75851f2a-2dd6-4a92-ab55-e5e97ab89209
0	47	47	Plazi	ffb07bec-2d10-492d-9c37-361fe0b79427	781a8ed3-5380-4ae3-aa71-a338c10a782f
209452	267425	57973	GBIF Norway	4f829580-180d-46a9-9c87-ed8ec959b545	7948250c-6958-4a29-a670-ed1015b26252
44	37	-7	GBIF Germany	4f6826f2-4ff6-443d-b966-e6913bd24013	796e1278-f762-11e1-a439-00145eb45e9a
31	31	0	GBIF Germany	4f6826f2-4ff6-443d-b966-e6913bd24013	7aab8e9a-f762-11e1-a439-00145eb45e9a
62382	62382	0	GBIF France	da44cd31-5901-4687-a106-6d1c7734ee3a	7c2b4560-397c-4ad9-b245-3064b999450a
1617	980	-637	GBIF Germany	4f6826f2-4ff6-443d-b966-e6913bd24013	7c522038-f762-11e1-a439-00145eb45e9a
33	33	0	GBIF Germany	4f6826f2-4ff6-443d-b966-e6913bd24013	7c7c8c10-f762-11e1-a439-00145eb45e9a
87	49	-38	GBIF Germany	4f6826f2-4ff6-443d-b966-e6913bd24013	7c8d2b88-f762-11e1-a439-00145eb45e9a
71	71	0	GBIF France	da44cd31-5901-4687-a106-6d1c7734ee3a	7cd8ff65-3ef6-4682-844d-eb00dace81a8
48	48	0	GBIF Germany	4f6826f2-4ff6-443d-b966-e6913bd24013	7e077586-f762-11e1-a439-00145eb45e9a
0	1	1	Plazi	ffb07bec-2d10-492d-9c37-361fe0b79427	7ed18824-e266-4580-8f95-96f0e7b7b1ec
0	1	1	Ocean Biodiversity Information System	ba0670b9-4186-41e6-8e70-f9cb3065551a	7f674f9b-c277-40af-a197-8b1ce7bbbe90
85	85	0	Participant Node Managers Committee	7f48e0c8-5c96-49ec-b972-30748e339115	7fc0891f-9101-4a2e-8f5a-f5d8de9aeea8
430	430	0	Biodiversity Information System of Mexico	b324e8e9-9a4c-44fa-8f1a-7f39ea7ab576	7ffd267e-f762-11e1-a439-00145eb45e9a
2	2	0	Plazi	ffb07bec-2d10-492d-9c37-361fe0b79427	808938d1-ef43-4d70-8c4d-971fb161d51f
14	14	0	Plazi	ffb07bec-2d10-492d-9c37-361fe0b79427	80d90cb1-3b57-463b-896d-f613e25a4e7f
98404	102592	4188	GBIF Japan	db5705aa-6a6e-42f1-8942-d77b9f4896ea	812e7ec6-f762-11e1-a439-00145eb45e9a
18	17	-1	GBIF Germany	4f6826f2-4ff6-443d-b966-e6913bd24013	824e35c6-f762-11e1-a439-00145eb45e9a
8934	8934	0	GBIF Germany	4f6826f2-4ff6-443d-b966-e6913bd24013	8293a994-f762-11e1-a439-00145eb45e9a
38	38	0	GBIF Germany	4f6826f2-4ff6-443d-b966-e6913bd24013	85dc2086-f762-11e1-a439-00145eb45e9a
2215722	2215722	0	GBIF France	da44cd31-5901-4687-a106-6d1c7734ee3a	86306e4b-5ed8-4684-a626-d9b9f439dcce
2504	2504	0	Ocean Biodiversity Information System	ba0670b9-4186-41e6-8e70-f9cb3065551a	892091aa-f762-11e1-a439-00145eb45e9a
14	14	0	GBIF Germany	4f6826f2-4ff6-443d-b966-e6913bd24013	89622a70-f762-11e1-a439-00145eb45e9a
312	312	0	Colombian Biodiversity Information System	7e865cba-7c46-417b-ade5-97f2cf5b7be0	8adfd3fe-4ce7-4157-99b3-daed1dd1eafa
15	8	-7	GBIF Germany	4f6826f2-4ff6-443d-b966-e6913bd24013	8e4361bc-f762-11e1-a439-00145eb45e9a
240	120	-120	GBIF Germany	4f6826f2-4ff6-443d-b966-e6913bd24013	8f965f1a-f762-11e1-a439-00145eb45e9a
0	22	22	Plazi	ffb07bec-2d10-492d-9c37-361fe0b79427	8fbff38d-e777-4f35-ae1d-1a1392e59d90
201	104	-97	GBIF Germany	4f6826f2-4ff6-443d-b966-e6913bd24013	90a5951a-f762-11e1-a439-00145eb45e9a
255	235	-20	GBIF Germany	4f6826f2-4ff6-443d-b966-e6913bd24013	9161f192-f762-11e1-a439-00145eb45e9a
311	180	-131	GBIF Germany	4f6826f2-4ff6-443d-b966-e6913bd24013	91c1a92a-f762-11e1-a439-00145eb45e9a
0	37	37	Plazi	ffb07bec-2d10-492d-9c37-361fe0b79427	920fdd6f-b0e8-4059-8ff8-dd401a03625f
286	261	-25	GBIF Germany	4f6826f2-4ff6-443d-b966-e6913bd24013	9212c13e-f762-11e1-a439-00145eb45e9a
25	8	-17	GBIF Germany	4f6826f2-4ff6-443d-b966-e6913bd24013	9222c480-f762-11e1-a439-00145eb45e9a
131	131	0	GBIF Germany	4f6826f2-4ff6-443d-b966-e6913bd24013	929fd07e-f762-11e1-a439-00145eb45e9a
5	5	0	Participant Node Managers Committee	7f48e0c8-5c96-49ec-b972-30748e339115	93814afc-6a43-435c-bc18-93ed1f2192a8
874	926	52	GBIF Germany	4f6826f2-4ff6-443d-b966-e6913bd24013	952d4ae2-f762-11e1-a439-00145eb45e9a
3153	3153	0	Belgian Biodiversity Platform	fb11cfe1-ebc3-45af-9159-17d9fddbcdac	95b0e787-8508-4247-9e48-18b45fc7d12e
21736	21740	4	GBIF Germany	4f6826f2-4ff6-443d-b966-e6913bd24013	96703220-f762-11e1-a439-00145eb45e9a
463	463	0	GBIF Argentina	2426a871-9feb-40a1-96c6-0c593a76b835	96e30d99-3042-4d07-899f-9f01c3ca3fbf
6	6	0	GBIF Germany	4f6826f2-4ff6-443d-b966-e6913bd24013	977922bc-f762-11e1-a439-00145eb45e9a
5	5	0	Plazi	ffb07bec-2d10-492d-9c37-361fe0b79427	97ebb3a7-1b19-460c-a786-c1a926279b60
0	1355	1355	DanBIF - Danish Biodiversity Information Facility	4ddd294f-02b7-4359-ac33-0806a9ca9c6b	9ac0a090-cefc-4ad6-8443-e865f7754403
18	18	0	Plazi	ffb07bec-2d10-492d-9c37-361fe0b79427	9d2c3889-3cee-4bea-bf50-bd5647462d39
46134	46131	-3	Biodiversity Information System of Mexico	b324e8e9-9a4c-44fa-8f1a-7f39ea7ab576	9d300300-333d-4ac3-abcb-04d4b369e556
0	63	63	GBIF Spain	1f94b3ca-9345-4d65-afe2-4bace93aa0fe	9e31304a-0379-4b8e-8fb2-e0850abb0f0b
271	271	0	Colombian Biodiversity Information System	7e865cba-7c46-417b-ade5-97f2cf5b7be0	9f462a42-8161-4759-9f0f-ffcc7857efec
0	217775	217775	GBIF Chile	a8b16421-d80b-4ef3-8f22-098b01a89255	9f7ed5a4-f73a-4d74-b0be-cef5bd700a37
0	3308	3308	Atlas of Living Australia	4a6f1b71-969e-4fc5-a693-282b05e1220c	a22836bf-32ac-4f41-a860-9f24a7420f85
2	2	0	Plazi	ffb07bec-2d10-492d-9c37-361fe0b79427	a26754ac-cfbd-435e-b239-054bb29341f6
0	44	44	Plazi	ffb07bec-2d10-492d-9c37-361fe0b79427	a342eb67-842d-41ab-a05d-3f010d0038ec
193	193	0	GBIF France	da44cd31-5901-4687-a106-6d1c7734ee3a	a37fd822-f5ad-4a8e-bb89-fb0ff6936e4d
434	434	0	GBIF Brazil	cdc9736d-5ff7-4ece-9959-3c744360cdb3	a722a0e0-ed02-4ea1-b7d1-26f9c56cc536
516	516	0	Plazi	ffb07bec-2d10-492d-9c37-361fe0b79427	abf8082d-c179-4cb2-acc4-3cdef16c4341
3125	3125	0	Netherlands Biodiversity Information Facility	0909d601-bda2-42df-9e63-a6d51847ebce	afac4a15-ae13-42b0-911a-d9ec445e2849
863	863	0	Colombian Biodiversity Information System	7e865cba-7c46-417b-ade5-97f2cf5b7be0	afb1b40e-e1e5-4bea-8b19-fbdeb977737f
0	346	346	GBIF Germany	4f6826f2-4ff6-443d-b966-e6913bd24013	b145ac75-0911-4830-8426-c63efb9f9052
1010	1010	0	GBIF France	da44cd31-5901-4687-a106-6d1c7734ee3a	b5387b45-17c5-4996-8833-fd17d0dd5e09
25723	26039	316	GBIF France	da44cd31-5901-4687-a106-6d1c7734ee3a	b5cdf587-3342-48ec-9130-ba1281d7166f
41400	41400	0	GBIF Brazil	cdc9736d-5ff7-4ece-9959-3c744360cdb3	b66a83bf-cccb-40a9-b643-1f95c9aeda37
17022	17022	0	GBIF France	da44cd31-5901-4687-a106-6d1c7734ee3a	b7777b70-e3c2-4283-ab1e-981313a21f38
0	1	1	Plazi	ffb07bec-2d10-492d-9c37-361fe0b79427	b8122888-0f67-4085-9cee-9bba76a0809d
23	23	0	Plazi	ffb07bec-2d10-492d-9c37-361fe0b79427	b8659502-0b20-4078-93c1-314893e84fda
5	5	0	Plazi	ffb07bec-2d10-492d-9c37-361fe0b79427	bb0af17b-2495-4360-a4bf-b6cd17b7a3af
6960	6960	0	GBIF Slovenia	53e3f6b9-81f8-41e3-9e51-2666a5e0ae6a	bc3b0bf0-e245-11dd-ab80-b8a03c50a862
18490	18490	0	National Biodiversity Network	d897a5b9-35ee-4232-94bd-b0bcaac003c2	bc48c67e-850e-41e6-a4cb-8532f36c63d8
0	14	14	Plazi	ffb07bec-2d10-492d-9c37-361fe0b79427	bcfc6dcd-587a-4f56-9ffd-7c846804c627
0	4	4	Plazi	ffb07bec-2d10-492d-9c37-361fe0b79427	bf9e642f-07fa-42ce-8c3f-8366a1195ff3
8	8	0	Plazi	ffb07bec-2d10-492d-9c37-361fe0b79427	c099b7cc-9634-4455-b59e-d5a597998ee7
124	124	0	Ocean Biodiversity Information System	ba0670b9-4186-41e6-8e70-f9cb3065551a	c4891c50-e94b-4f8d-bd34-8c20981617c1
3947	3947	0	GBIF Spain	1f94b3ca-9345-4d65-afe2-4bace93aa0fe	cd47c589-73a4-4a89-b478-e6a2568f397a
551	551	0	GBIF France	da44cd31-5901-4687-a106-6d1c7734ee3a	cf21493d-18f6-47df-8bf2-d7f6982003d2
21	21	0	Plazi	ffb07bec-2d10-492d-9c37-361fe0b79427	d1259a6a-e31f-404a-84e9-39ba5a1f2d8a
0	3001	3001	GBIF Estonia	2c11b821-d22b-4c64-8cd3-c1578173b129	d170e622-d64d-4828-ad75-efea76dc1a71
344	344	0	GBIF Germany	4f6826f2-4ff6-443d-b966-e6913bd24013	d1a44596-da71-4de8-b429-8b229b24158a
0	2	2	Plazi	ffb07bec-2d10-492d-9c37-361fe0b79427	d3374b62-c45b-4466-b4db-b6ecd3d11d89
12	12	0	Plazi	ffb07bec-2d10-492d-9c37-361fe0b79427	d36f07f6-28ac-493d-8f4c-eff204e067ff
0	44	44	Plazi	ffb07bec-2d10-492d-9c37-361fe0b79427	d3b6651e-e29b-4926-96e6-d3a3d0250b07
0	21940	21940	National Biodiversity Network	d897a5b9-35ee-4232-94bd-b0bcaac003c2	da5f7bf0-c72a-4087-b116-885fbdd10c03
26	26	0	National Biodiversity Network	d897a5b9-35ee-4232-94bd-b0bcaac003c2	dbe7a6d3-b852-4d0d-a91a-caf495556d3a
0	31	31	Plazi	ffb07bec-2d10-492d-9c37-361fe0b79427	de1fd569-a2c2-46aa-a2f2-25fb5a9747ea
1172	1172	0	Ocean Biodiversity Information System	ba0670b9-4186-41e6-8e70-f9cb3065551a	df450926-5a21-468d-b1ec-6d29053f613f
0	1	1	Plazi	ffb07bec-2d10-492d-9c37-361fe0b79427	e0b04539-13ac-4dc7-bf5e-f2a6dce07ace
0	3	3	Plazi	ffb07bec-2d10-492d-9c37-361fe0b79427	e35dd153-1ec6-4f1c-bf52-e1c2ffc58d34
20	20	0	Plazi	ffb07bec-2d10-492d-9c37-361fe0b79427	e60b6728-1b28-45bb-9bdd-d06476d29a18
3	3	0	Plazi	ffb07bec-2d10-492d-9c37-361fe0b79427	e60f0994-fd5e-4082-9f8f-fe4a19b91808
2	2	0	Plazi	ffb07bec-2d10-492d-9c37-361fe0b79427	e654d215-a892-4225-8ca4-3336f0beefda
0	291126	291126	GBIF Switzerland	169eb292-376b-4cc6-8e31-9c2c432de0ad	e6d98b01-d4bf-4afc-89db-29dffdbd4d5b
0	81	81	Ocean Biodiversity Information System	ba0670b9-4186-41e6-8e70-f9cb3065551a	e905c8b5-a437-429a-ba2a-991a1b758309
83	83	0	GBIF Germany	4f6826f2-4ff6-443d-b966-e6913bd24013	ebb2fd85-a214-49ff-a34c-9e81342152a2
3009	3009	0	Biodiversity Information System of Mexico	b324e8e9-9a4c-44fa-8f1a-7f39ea7ab576	ebc70f17-2ae6-4f59-ad23-cba07d77b2a4
70	70	0	Scientific Committee on Antarctic Research	51e4e8ff-bff0-4996-8b27-9107d61b3478	ebe73e19-11eb-48d2-9263-fb0caa3b7b5a
19660	19660	0	U.S. Geological Survey	8618c64a-93e0-4300-b546-7249e5148ed2	ebf061ab-5f8a-4958-ad37-0f55e2a953e7
48	48	0	GBIF Germany	4f6826f2-4ff6-443d-b966-e6913bd24013	ece79a30-dc30-4117-bf36-80e8c30c0918
0	1	1	Plazi	ffb07bec-2d10-492d-9c37-361fe0b79427	eeed7f0f-14a2-41f4-9b02-27cadddf5db1
9459	9459	0	GBIF Israel	8cb55387-7802-40e8-86d6-d357a583c596	efb9eac6-38c2-4c49-a4a3-598fd2a9f982
0	6	6	Plazi	ffb07bec-2d10-492d-9c37-361fe0b79427	f08bfa4e-271a-4459-88bc-e846bcf4a0d2
8	8	0	Plazi	ffb07bec-2d10-492d-9c37-361fe0b79427	f150b6b7-25d8-49b5-bea4-5c21899fc48c
1	1	0	Plazi	ffb07bec-2d10-492d-9c37-361fe0b79427	f3187ddd-f79a-43d2-9692-e101210783bf
2	2	0	Plazi	ffb07bec-2d10-492d-9c37-361fe0b79427	f3515b34-1248-4795-8f7b-7bd68d585187
4488	4488	0	Participant Node Managers Committee	7f48e0c8-5c96-49ec-b972-30748e339115	f64810a1-cfa6-440e-8cb1-8241453d3336
4	4	0	Plazi	ffb07bec-2d10-492d-9c37-361fe0b79427	f8cc580b-9034-41e9-8f2b-2f985acbb017
8896	8896	0	Participant Node Managers Committee	7f48e0c8-5c96-49ec-b972-30748e339115	fa4e2235-778f-4ca9-bb54-6f50da39a79e
0	3	3	Plazi	ffb07bec-2d10-492d-9c37-361fe0b79427	fcee606b-4be3-4ed9-a99b-c2dcc2ef4137
1	1	0	Plazi	ffb07bec-2d10-492d-9c37-361fe0b79427	fedc42d6-b2ad-4773-9caa-3676ce318bec
5	5	0	Plazi	ffb07bec-2d10-492d-9c37-361fe0b79427	fee1b74b-1313-4e9e-9ed0-8c232e67588f
396	396	0	GBIF Malawi	2a42e4d7-ad4a-41b3-84c4-de4aa7b74d35	ffec564a-cc7a-41c7-8287-df0c705ded30
488	488	0	GBIF France	da44cd31-5901-4687-a106-6d1c7734ee3a	01f5d83c-91b1-4473-a67c-c86b35705d4d
18351	18351	0	GBIF France	da44cd31-5901-4687-a106-6d1c7734ee3a	03c127a4-ac74-42fa-8254-9fa7fdf09d5d
31	31	0	National Biodiversity Network	d897a5b9-35ee-4232-94bd-b0bcaac003c2	04234973-a68a-4c56-a786-c6c7da0efe21
9569	9569	0	GBIF Brazil	cdc9736d-5ff7-4ece-9959-3c744360cdb3	066497bc-d5ba-4faf-a37a-09730d436acf
0	29	29	Plazi	ffb07bec-2d10-492d-9c37-361fe0b79427	0a5a3ae1-0000-412c-a28e-657995b0621d
0	39	39	Plazi	ffb07bec-2d10-492d-9c37-361fe0b79427	0cb6b605-6e04-453d-bcaa-837efcb1e75c
0	1	1	Plazi	ffb07bec-2d10-492d-9c37-361fe0b79427	0e5f7293-2a3e-44cb-b937-92a8580b64fc
41133	41133	0	GBIF Brazil	cdc9736d-5ff7-4ece-9959-3c744360cdb3	0ec0337f-05dc-4f2e-8480-d8d03e23670d
0	30173	30173	Korean Biodiversity Information Facility	e0a1e772-0177-4800-94b4-2d023fe6cdf4	10c412e8-c464-496f-bb17-cc545f59ef62
5	5	0	Plazi	ffb07bec-2d10-492d-9c37-361fe0b79427	1113cb35-3bdb-482b-babd-a58f7caea92c
740	740	0	GBIF Togo	c9659a3e-07e9-4fcb-83c6-de8b9009a02e	11c00ed9-1c1b-47d1-9eb4-66a491c7d7b3
10	10	0	Plazi	ffb07bec-2d10-492d-9c37-361fe0b79427	1350f53e-7270-41d5-85de-e9ba8b232c23
32	35	3	Plazi	ffb07bec-2d10-492d-9c37-361fe0b79427	13768a43-2509-4113-8b9a-70f87ac541a8
35	35	0	GBIF Argentina	2426a871-9feb-40a1-96c6-0c593a76b835	15a39f1d-9641-460c-8493-45a2a07a0353
2	2	0	Plazi	ffb07bec-2d10-492d-9c37-361fe0b79427	15e6fa39-f626-4be1-9e50-2af9994e9eda
0	47	47	Plazi	ffb07bec-2d10-492d-9c37-361fe0b79427	165d5532-c06a-4c7a-8b60-6b29e6702ff7
244	244	0	Belgian Biodiversity Platform	fb11cfe1-ebc3-45af-9159-17d9fddbcdac	172c03d8-0a83-4a08-a5af-9dd53ec851c7
41	41	0	Plazi	ffb07bec-2d10-492d-9c37-361fe0b79427	175ef2e7-06f6-4404-a6be-224dac1a06ec
0	12	12	Plazi	ffb07bec-2d10-492d-9c37-361fe0b79427	17fb1fda-4996-4ad0-8769-300441236dba
112	112	0	GBIF France	da44cd31-5901-4687-a106-6d1c7734ee3a	1a2a4ab6-6718-4688-834c-119c7064bbed
164732	164732	0	National Biodiversity Network	d897a5b9-35ee-4232-94bd-b0bcaac003c2	1c771a70-78ac-44d6-8ff6-2efaa2078a96
931	931	0	GBIF France	da44cd31-5901-4687-a106-6d1c7734ee3a	1f285f71-26db-452a-a499-fb6657c4ed0e
23	19	-4	GBIF Germany	4f6826f2-4ff6-443d-b966-e6913bd24013	204a6b90-be54-400c-8280-d5bb9dce3f9b
461	461	0	Colombian Biodiversity Information System	7e865cba-7c46-417b-ade5-97f2cf5b7be0	22449b1e-8894-4ca1-b14a-d71a569b277b
0	10	10	Plazi	ffb07bec-2d10-492d-9c37-361fe0b79427	22eaa483-476a-40cd-ad35-7ad9228ef89f
22	22	0	Plazi	ffb07bec-2d10-492d-9c37-361fe0b79427	239efb70-4dd1-4030-9e7e-9f30c4182a87
41	41	0	Plazi	ffb07bec-2d10-492d-9c37-361fe0b79427	240b1dcc-e098-47b1-912f-720dfec493b9
253	253	0	GBIF Madagascar	2dbfc5c5-51b5-4494-9dfc-4d3f013a3b64	269348c6-8dd2-4d59-84ae-27c82b47c2c0
2	2	0	Plazi	ffb07bec-2d10-492d-9c37-361fe0b79427	26f86dff-e681-401b-b17b-e0c7f2302c40
5061	5061	0	National Biodiversity Network	d897a5b9-35ee-4232-94bd-b0bcaac003c2	2824937b-c819-461e-951c-2dbb9b4fe5ee
1	1	0	Plazi	ffb07bec-2d10-492d-9c37-361fe0b79427	2825e55a-a7df-4dfc-b620-02bca1154d24
6	6	0	Plazi	ffb07bec-2d10-492d-9c37-361fe0b79427	29625cd4-d123-445c-b768-eada82dfd348
1163	1163	0	Biodiversity Information System of Mexico	b324e8e9-9a4c-44fa-8f1a-7f39ea7ab576	29c3153f-6e0e-418e-ad4b-0c754d93acba
5	5	0	Plazi	ffb07bec-2d10-492d-9c37-361fe0b79427	29f8f8f6-83e1-407e-b47f-ab2aa53c13ba
3	3	0	Plazi	ffb07bec-2d10-492d-9c37-361fe0b79427	2a020626-f41a-45d7-aba5-b5ebfed8cec9
14	14	0	Plazi	ffb07bec-2d10-492d-9c37-361fe0b79427	2bd2cec3-b699-4d26-8d1a-b08d374fe14d
16	16	0	Plazi	ffb07bec-2d10-492d-9c37-361fe0b79427	3027d0d6-1b19-4811-9ee9-b87c07d2b896
2	2	0	Plazi	ffb07bec-2d10-492d-9c37-361fe0b79427	31916211-eba3-4739-8f9e-1e1edc47153d
0	2	2	Plazi	ffb07bec-2d10-492d-9c37-361fe0b79427	33ac15ab-586e-4c99-bf8e-f1c629a9aa35
745	745	0	Colombian Biodiversity Information System	7e865cba-7c46-417b-ade5-97f2cf5b7be0	33e5163b-2cb6-46ff-8c2f-2d67b28459ae
30	30	0	Plazi	ffb07bec-2d10-492d-9c37-361fe0b79427	34cd9b88-7009-4f73-b17b-141ce1e42d1d
0	328	328	Biodiversity Information System of Mexico	b324e8e9-9a4c-44fa-8f1a-7f39ea7ab576	3537b2cd-59a5-4b2e-9552-2ad9c64dc353
0	9	9	Plazi	ffb07bec-2d10-492d-9c37-361fe0b79427	35c11603-3013-4807-9fd8-2c6692f25d8f
97	97	0	Plazi	ffb07bec-2d10-492d-9c37-361fe0b79427	39b1b95c-093f-4a81-8c08-216f8ecb572b
95	95	0	GBIF France	da44cd31-5901-4687-a106-6d1c7734ee3a	3c0ee8ff-b30e-4e6e-be6d-ca922a20062c
25	25	0	Biodiversity Information System of Mexico	b324e8e9-9a4c-44fa-8f1a-7f39ea7ab576	4206d4eb-b6a5-4e25-9063-ee55e4007d81
25	25	0	Plazi	ffb07bec-2d10-492d-9c37-361fe0b79427	42c8afb3-c160-49a0-b05e-9bba1a383962
0	5790	5790	Ocean Biodiversity Information System	ba0670b9-4186-41e6-8e70-f9cb3065551a	432c6c7c-45e0-43d1-b1d6-a8d2a3a527db
0	93	93	Ocean Biodiversity Information System	ba0670b9-4186-41e6-8e70-f9cb3065551a	4400b3fd-8446-4da8-8aa7-80313e1275d3
11	11	0	Plazi	ffb07bec-2d10-492d-9c37-361fe0b79427	445810c6-4c4b-4e5e-a720-8516b75b05e8
264	264	0	GBIF Germany	4f6826f2-4ff6-443d-b966-e6913bd24013	4aba733e-c667-44f8-8e3e-a72cec3bb522
5364	5364	0	GBIF Portugal	673f7038-4262-4149-b753-5658a4e912f6	4d028294-7e88-4bed-8519-176af6a4b78f
17	17	0	Plazi	ffb07bec-2d10-492d-9c37-361fe0b79427	4db9cc14-9463-4a62-b4a4-582e866328ae
705008469	872206403	167197934	U.S. Geological Survey	8618c64a-93e0-4300-b546-7249e5148ed2	4fa7b334-ce0d-4e88-aaae-2e0c138d049e
3	3	0	Plazi	ffb07bec-2d10-492d-9c37-361fe0b79427	4fdf0291-fa18-48b5-a687-61f087324d5f
172098	172098	0	U.S. Geological Survey	8618c64a-93e0-4300-b546-7249e5148ed2	5288946d-5fcf-4b53-8fd3-74f4cc6b53fc
2	2	0	Plazi	ffb07bec-2d10-492d-9c37-361fe0b79427	56491860-54ef-4375-9f28-1eb09e36c9fd
0	16	16	Plazi	ffb07bec-2d10-492d-9c37-361fe0b79427	56511824-3b2e-447d-97cf-c8d3f72528e1
2	2	0	Plazi	ffb07bec-2d10-492d-9c37-361fe0b79427	575bbba4-d0b8-4459-9530-ac308b18121f
0	7	7	Plazi	ffb07bec-2d10-492d-9c37-361fe0b79427	58431abd-c212-43d8-91b4-82fc3ab160d1
0	30	30	Participant Node Managers Committee	7f48e0c8-5c96-49ec-b972-30748e339115	5b38d2d1-4aca-46ba-889e-e6e4fe4c39f4
8	8	0	Plazi	ffb07bec-2d10-492d-9c37-361fe0b79427	5b729d4e-afc0-4cfc-9783-07f9662bae4a
28	28	0	GBIF Germany	4f6826f2-4ff6-443d-b966-e6913bd24013	5ba108d6-6740-4dc4-bc4c-f2328ece6110
77	77	0	Plazi	ffb07bec-2d10-492d-9c37-361fe0b79427	5d468b82-fbe7-4ba7-8434-b74b264f5f87
0	14	14	Ocean Biodiversity Information System	ba0670b9-4186-41e6-8e70-f9cb3065551a	5ddfe3f9-fda0-4337-a9a1-26b0441aa296
8	8	0	GBIF France	da44cd31-5901-4687-a106-6d1c7734ee3a	604ea128-3385-4958-83eb-524fa3d605f5
101	101	0	GBIF Germany	4f6826f2-4ff6-443d-b966-e6913bd24013	622aa1f8-f762-11e1-a439-00145eb45e9a
22	22	0	GBIF Germany	4f6826f2-4ff6-443d-b966-e6913bd24013	631fb1ca-f762-11e1-a439-00145eb45e9a
10143	10143	0	GBIF Brazil	cdc9736d-5ff7-4ece-9959-3c744360cdb3	63b61a77-920b-4b08-9b31-1fa6f41587eb
120	120	0	GBIF Germany	4f6826f2-4ff6-443d-b966-e6913bd24013	641dbefa-f762-11e1-a439-00145eb45e9a
61	61	0	GBIF Germany	4f6826f2-4ff6-443d-b966-e6913bd24013	64b1d19e-f762-11e1-a439-00145eb45e9a
760	50	-710	GBIF Germany	4f6826f2-4ff6-443d-b966-e6913bd24013	660949b4-f762-11e1-a439-00145eb45e9a
40	40	0	GBIF Germany	4f6826f2-4ff6-443d-b966-e6913bd24013	669e0d92-f762-11e1-a439-00145eb45e9a
44	44	0	GBIF Germany	4f6826f2-4ff6-443d-b966-e6913bd24013	66a446b2-f762-11e1-a439-00145eb45e9a
38	38	0	GBIF Germany	4f6826f2-4ff6-443d-b966-e6913bd24013	66c304c6-f762-11e1-a439-00145eb45e9a
102	102	0	GBIF Germany	4f6826f2-4ff6-443d-b966-e6913bd24013	6757b4c2-f762-11e1-a439-00145eb45e9a
12	12	0	Participant Node Managers Committee	7f48e0c8-5c96-49ec-b972-30748e339115	676d3a4e-9193-4ac7-a614-5ac6b166c9b6
23	23	0	GBIF Finland	dd514216-5c7c-45f3-910d-797424cb5be6	677421cf-7213-4f50-a2a0-f47921fb18ca
1717	1717	0	Belgian Biodiversity Platform	fb11cfe1-ebc3-45af-9159-17d9fddbcdac	67caab70-ec4b-11dc-b73f-b8a03c50a862
2276	2276	0	U.S. Geological Survey	8618c64a-93e0-4300-b546-7249e5148ed2	6a24bbed-dbf7-4784-9ee7-a4f7b5479572
14	14	0	GBIF Germany	4f6826f2-4ff6-443d-b966-e6913bd24013	6a930bc8-f762-11e1-a439-00145eb45e9a
92	92	0	National Biodiversity Network	d897a5b9-35ee-4232-94bd-b0bcaac003c2	6ab5774b-6906-4120-a923-30ba01a0de70
16	16	0	GBIF Germany	4f6826f2-4ff6-443d-b966-e6913bd24013	6b002032-f762-11e1-a439-00145eb45e9a
5	5	0	Plazi	ffb07bec-2d10-492d-9c37-361fe0b79427	6df8a60c-105c-4653-bbf5-8417c86c7375
142	142	0	BioCASE	d8bbf693-a180-4995-94fe-6130795dcf2f	6ef03bd2-3aa4-4fa1-9da6-27d631bbc446
20	20	0	Plazi	ffb07bec-2d10-492d-9c37-361fe0b79427	6fff09bd-cf2b-4365-ac49-cc02dc409d65
12	12	0	GBIF Germany	4f6826f2-4ff6-443d-b966-e6913bd24013	70006b78-f762-11e1-a439-00145eb45e9a
24	24	0	Korean Biodiversity Information Facility	e0a1e772-0177-4800-94b4-2d023fe6cdf4	707e70ed-d2bd-48cf-801a-c6f6fa77f0b8
1	1	0	GBIF Germany	4f6826f2-4ff6-443d-b966-e6913bd24013	733df3fa-f762-11e1-a439-00145eb45e9a
29	29	0	GBIF Germany	4f6826f2-4ff6-443d-b966-e6913bd24013	73d004a2-f762-11e1-a439-00145eb45e9a
26	26	0	GBIF Germany	4f6826f2-4ff6-443d-b966-e6913bd24013	74ef25ac-f762-11e1-a439-00145eb45e9a
138	138	0	GBIF Germany	4f6826f2-4ff6-443d-b966-e6913bd24013	750e3f50-f762-11e1-a439-00145eb45e9a
1	1	0	Plazi	ffb07bec-2d10-492d-9c37-361fe0b79427	762114a7-e97f-488a-816d-cc8c801c1ec4
4	4	0	GBIF Germany	4f6826f2-4ff6-443d-b966-e6913bd24013	787dba1c-f762-11e1-a439-00145eb45e9a
8	8	0	GBIF Germany	4f6826f2-4ff6-443d-b966-e6913bd24013	78f94178-f762-11e1-a439-00145eb45e9a
271	245	-26	GBIF Germany	4f6826f2-4ff6-443d-b966-e6913bd24013	79695044-f762-11e1-a439-00145eb45e9a
39	34	-5	GBIF Germany	4f6826f2-4ff6-443d-b966-e6913bd24013	7992d70c-f762-11e1-a439-00145eb45e9a
603	460	-143	GBIF Germany	4f6826f2-4ff6-443d-b966-e6913bd24013	79a583fc-f762-11e1-a439-00145eb45e9a
2	2	0	GBIF Germany	4f6826f2-4ff6-443d-b966-e6913bd24013	7a746852-f762-11e1-a439-00145eb45e9a
1	1	0	GBIF Norway	4f829580-180d-46a9-9c87-ed8ec959b545	7c44411b-0296-4634-9538-0ae43b10a38a
85	85	0	Plazi	ffb07bec-2d10-492d-9c37-361fe0b79427	7e33ec7d-211b-4042-8d07-344364ee805d
46	36	-10	GBIF Germany	4f6826f2-4ff6-443d-b966-e6913bd24013	7ea75394-f762-11e1-a439-00145eb45e9a
244	187	-57	GBIF Germany	4f6826f2-4ff6-443d-b966-e6913bd24013	7ed910a0-f762-11e1-a439-00145eb45e9a
2033	1533	-500	GBIF Germany	4f6826f2-4ff6-443d-b966-e6913bd24013	7f351ce2-f762-11e1-a439-00145eb45e9a
18	18	0	Plazi	ffb07bec-2d10-492d-9c37-361fe0b79427	7fbae291-93dd-4f4d-8f37-099844617aaf
6630	6630	0	Biodiversity Information System of Mexico	b324e8e9-9a4c-44fa-8f1a-7f39ea7ab576	80342ed0-f762-11e1-a439-00145eb45e9a
660	660	0	GBIF Germany	4f6826f2-4ff6-443d-b966-e6913bd24013	81f6bbf2-f762-11e1-a439-00145eb45e9a
0	14	14	Plazi	ffb07bec-2d10-492d-9c37-361fe0b79427	828a61a7-1da5-4596-be7a-32c8e4b922b2
0	65	65	Plazi	ffb07bec-2d10-492d-9c37-361fe0b79427	83e17fa6-60f9-48c0-925c-3863a29ac2ec
15	15	0	National Biodiversity Network	d897a5b9-35ee-4232-94bd-b0bcaac003c2	84c38307-3a7e-4f7d-a401-0b10fc16c130
1474	1474	0	World Federation for Culture Collections	a6bdc523-5368-4e0f-9d2e-de1c262ac092	8553e1c6-f762-11e1-a439-00145eb45e9a
9102	9110	8	GBIF Germany	4f6826f2-4ff6-443d-b966-e6913bd24013	858c1c6c-f762-11e1-a439-00145eb45e9a
0	4904	4904	Ocean Biodiversity Information System	ba0670b9-4186-41e6-8e70-f9cb3065551a	85bb9817-fe01-4f6d-8ad1-3b861a7cec61
2902	2019	-883	GBIF Germany	4f6826f2-4ff6-443d-b966-e6913bd24013	8798c41a-f762-11e1-a439-00145eb45e9a
2	2	0	GBIF Germany	4f6826f2-4ff6-443d-b966-e6913bd24013	87a0a81a-f762-11e1-a439-00145eb45e9a
29	29	0	GBIF Germany	4f6826f2-4ff6-443d-b966-e6913bd24013	89d97116-f762-11e1-a439-00145eb45e9a
5122	5122	0	Participant Node Managers Committee	7f48e0c8-5c96-49ec-b972-30748e339115	8a2ba058-6ca8-4f8a-a54a-b79bb225be66
229	229	0	GBIF New Zealand	4f9fd726-20dd-445e-89a1-8ed93792276f	8a756d0f-ed04-4855-bb67-e421e06ef2e9
248	248	0	GBIF Germany	4f6826f2-4ff6-443d-b966-e6913bd24013	8aaaf95c-f762-11e1-a439-00145eb45e9a
12980	12980	0	GBIF France	da44cd31-5901-4687-a106-6d1c7734ee3a	8add8b19-782a-4029-b2d9-1806cd9d9aa1
69	69	0	GBIF France	da44cd31-5901-4687-a106-6d1c7734ee3a	8b6bda87-2993-4fd5-bcb7-bcde22403134
4	4	0	GBIF Germany	4f6826f2-4ff6-443d-b966-e6913bd24013	8ba26930-f762-11e1-a439-00145eb45e9a
42	35	-7	GBIF Germany	4f6826f2-4ff6-443d-b966-e6913bd24013	8cc93546-f762-11e1-a439-00145eb45e9a
16	14	-2	GBIF Germany	4f6826f2-4ff6-443d-b966-e6913bd24013	8d10ae94-f762-11e1-a439-00145eb45e9a
6	4	-2	GBIF Germany	4f6826f2-4ff6-443d-b966-e6913bd24013	8d42580e-f762-11e1-a439-00145eb45e9a
40	20	-20	GBIF Germany	4f6826f2-4ff6-443d-b966-e6913bd24013	8deeeccc-f762-11e1-a439-00145eb45e9a
0	2	2	Plazi	ffb07bec-2d10-492d-9c37-361fe0b79427	8e4cd8ea-ef69-4cfc-b75e-4de808a84c25
166	104	-62	GBIF Germany	4f6826f2-4ff6-443d-b966-e6913bd24013	8e4cec3c-f762-11e1-a439-00145eb45e9a
440	440	0	GBIF Germany	4f6826f2-4ff6-443d-b966-e6913bd24013	8ef78516-f762-11e1-a439-00145eb45e9a
152	152	0	Atlas of Living Australia	4a6f1b71-969e-4fc5-a693-282b05e1220c	8f44aaa6-e2b0-4f8b-bae6-61b485f9f37f
654	564	-90	GBIF Germany	4f6826f2-4ff6-443d-b966-e6913bd24013	8fa6bf86-f762-11e1-a439-00145eb45e9a
601	426	-175	GBIF Germany	4f6826f2-4ff6-443d-b966-e6913bd24013	8fd00616-f762-11e1-a439-00145eb45e9a
31	25	-6	GBIF Germany	4f6826f2-4ff6-443d-b966-e6913bd24013	8ff0d648-f762-11e1-a439-00145eb45e9a
42	42	0	GBIF France	da44cd31-5901-4687-a106-6d1c7734ee3a	91a226f1-d340-423f-a892-e895088dd640
188	188	0	GBIF Germany	4f6826f2-4ff6-443d-b966-e6913bd24013	91f71a24-f762-11e1-a439-00145eb45e9a
808	810	2	GBIF Germany	4f6826f2-4ff6-443d-b966-e6913bd24013	9237efc2-f762-11e1-a439-00145eb45e9a
9	9	0	Plazi	ffb07bec-2d10-492d-9c37-361fe0b79427	927a5af6-9fa0-48b3-be7e-611d529b4669
102	102	0	GBIF Germany	4f6826f2-4ff6-443d-b966-e6913bd24013	92c1c026-f762-11e1-a439-00145eb45e9a
247	247	0	GBIF Germany	4f6826f2-4ff6-443d-b966-e6913bd24013	936c068c-57e4-481c-bf83-66571827c828
2	2	0	Plazi	ffb07bec-2d10-492d-9c37-361fe0b79427	93806ea9-3fff-4376-8d8e-062e5ece35bf
1	1	0	GBIF Germany	4f6826f2-4ff6-443d-b966-e6913bd24013	938bf044-f762-11e1-a439-00145eb45e9a
696	696	0	GBIF Germany	4f6826f2-4ff6-443d-b966-e6913bd24013	941c1002-f762-11e1-a439-00145eb45e9a
455	455	0	GBIF Germany	4f6826f2-4ff6-443d-b966-e6913bd24013	943fb53e-f762-11e1-a439-00145eb45e9a
1186	1114	-72	GBIF Germany	4f6826f2-4ff6-443d-b966-e6913bd24013	944dec4e-f762-11e1-a439-00145eb45e9a
3887	4297	410	GBIF Japan	db5705aa-6a6e-42f1-8942-d77b9f4896ea	95f883c4-f762-11e1-a439-00145eb45e9a
19610	19610	0	GBIF Spain	1f94b3ca-9345-4d65-afe2-4bace93aa0fe	96209bd4-f762-11e1-a439-00145eb45e9a
3	3	0	Plazi	ffb07bec-2d10-492d-9c37-361fe0b79427	963f190f-906a-474b-91d9-552749be23dc
173856	180132	6276	National Biodiversity Network	d897a5b9-35ee-4232-94bd-b0bcaac003c2	990e845f-836b-4467-bc5f-46c8495259ec
69185	69185	0	GBIF Israel	8cb55387-7802-40e8-86d6-d357a583c596	994cbd5e-0515-4d7e-9fcd-7838afd36018
10	10	0	Plazi	ffb07bec-2d10-492d-9c37-361fe0b79427	9c3fecf1-4e11-4c79-a908-e0a5abbaf3ca
2929	2424	-505	GBIF Germany	4f6826f2-4ff6-443d-b966-e6913bd24013	9f45a961-95f4-4eba-bde8-c48964280874
5379	5379	0	National Biodiversity Network	d897a5b9-35ee-4232-94bd-b0bcaac003c2	a48486a9-0461-4936-a151-b16ab76b6e05
22	22	0	Plazi	ffb07bec-2d10-492d-9c37-361fe0b79427	a54afff8-9d76-4a96-8f1b-06e26c1167bc
55343	55343	0	GBIF France	da44cd31-5901-4687-a106-6d1c7734ee3a	a7624b58-657f-444a-a2a8-6fdda79b9aea
9814	9814	0	Polish Biodiversity Information Network	2618bfdf-e194-4911-a241-80db3107bc51	a9980010-2fe9-11de-816f-b8a03c50a862
7	7	0	Plazi	ffb07bec-2d10-492d-9c37-361fe0b79427	aa0db59c-6499-4c99-b77f-47e3d34ac03c
0	9831	9831	Belgian Biodiversity Platform	fb11cfe1-ebc3-45af-9159-17d9fddbcdac	aa0eee05-8fb0-4dcb-8f20-41b7e4e7fca5
120	120	0	Plazi	ffb07bec-2d10-492d-9c37-361fe0b79427	aebff7a2-6d62-4b2c-850e-90c203eb690b
73	73	0	National Biodiversity Network	d897a5b9-35ee-4232-94bd-b0bcaac003c2	af58126d-fd6a-49d0-ab80-893c0e7c6b4a
9	9	0	GBIF Brazil	cdc9736d-5ff7-4ece-9959-3c744360cdb3	b0de1d7c-1481-4f24-96cd-3ac07155fc34
66	66	0	GBIF Finland	dd514216-5c7c-45f3-910d-797424cb5be6	b21606a6-5baa-4997-ab67-f7ebdab09306
3795	3795	0	Ocean Biodiversity Information System	ba0670b9-4186-41e6-8e70-f9cb3065551a	b49ee669-efe2-448e-9f97-7df7ef2060a7
0	8	8	Plazi	ffb07bec-2d10-492d-9c37-361fe0b79427	b503583c-082a-4265-ad44-8e633c96cf0a
1101	1101	0	Participant Node Managers Committee	7f48e0c8-5c96-49ec-b972-30748e339115	b55aa7c5-26af-49d7-8a4c-c3f3d2e8b993
2	2	0	Plazi	ffb07bec-2d10-492d-9c37-361fe0b79427	b86b0680-d96a-42e5-8bdf-0c53b3b71234
5661	5661	0	Biodiversity Information System of Mexico	b324e8e9-9a4c-44fa-8f1a-7f39ea7ab576	bcb25bd1-c5f9-46c6-b869-4830e196b5f8
2	2	0	Plazi	ffb07bec-2d10-492d-9c37-361fe0b79427	c39fa21a-e93a-4801-ad52-4399fba9d85d
1	1	0	Plazi	ffb07bec-2d10-492d-9c37-361fe0b79427	c3fef6f2-8790-420b-afd1-a371acc5594d
1	1	0	Participant Node Managers Committee	7f48e0c8-5c96-49ec-b972-30748e339115	c6c78bc5-1b16-40b5-98ba-4d326c67264d
5	5	0	Plazi	ffb07bec-2d10-492d-9c37-361fe0b79427	c7bbbd6c-ce6f-4be4-8b67-6f05f84794e0
144	144	0	Plazi	ffb07bec-2d10-492d-9c37-361fe0b79427	c7db5cdc-51c3-4c2d-be5d-a8c11f59c09a
0	1914	1914	GBIF France	da44cd31-5901-4687-a106-6d1c7734ee3a	c8943b91-5e87-4b4f-8b08-1b874444b4d3
380	380	0	GBIF France	da44cd31-5901-4687-a106-6d1c7734ee3a	c8f1d7ae-023a-4150-b89a-5db555b8e9f9
0	30	30	Plazi	ffb07bec-2d10-492d-9c37-361fe0b79427	cc893fb7-6f40-416b-a848-d08c15421546
270	270	0	Plazi	ffb07bec-2d10-492d-9c37-361fe0b79427	d15ba707-bee0-4d4d-a76d-52e5d488763c
0	11	11	Plazi	ffb07bec-2d10-492d-9c37-361fe0b79427	d34b8f31-cd8a-43d6-bc9f-17658c731658
4	4	0	Plazi	ffb07bec-2d10-492d-9c37-361fe0b79427	d4a6ec98-72eb-4fdc-89fc-032036981e51
5	5	0	Plazi	ffb07bec-2d10-492d-9c37-361fe0b79427	d583faf3-4509-420e-82a2-a0fd31783302
6707	6707	0	Biodiversity Information System of Mexico	b324e8e9-9a4c-44fa-8f1a-7f39ea7ab576	d986d84a-d0cb-4739-bb48-021457ef7317
4	4	0	Plazi	ffb07bec-2d10-492d-9c37-361fe0b79427	daf38dcd-3d1a-482a-a0fe-f781d96632fc
0	22	22	Plazi	ffb07bec-2d10-492d-9c37-361fe0b79427	db44bc90-2960-490c-8ddb-f16633c03929
0	44	44	Plazi	ffb07bec-2d10-492d-9c37-361fe0b79427	de1aec98-4095-4dbf-8271-edf9e595181a
4	4	0	Plazi	ffb07bec-2d10-492d-9c37-361fe0b79427	de20b639-5800-47da-9214-99a33a9c13cc
0	31854	31854	GBIF Portugal	673f7038-4262-4149-b753-5658a4e912f6	dff56954-d92b-4d83-b165-17c07e233b79
1477	1477	0	GBIF Germany	4f6826f2-4ff6-443d-b966-e6913bd24013	e08ff715-4d56-4c13-8563-86142a78c666
316	316	0	Plazi	ffb07bec-2d10-492d-9c37-361fe0b79427	e10e53f2-0e1b-46f6-8b0f-af19d5529711
2	2	0	Plazi	ffb07bec-2d10-492d-9c37-361fe0b79427	e42d108a-3042-485e-9bd3-6225c1bd14ce
771	771	0	Participant Node Managers Committee	7f48e0c8-5c96-49ec-b972-30748e339115	e6a1e051-ec45-474b-94c3-937bb480c9d5
102	102	0	GBIF France	da44cd31-5901-4687-a106-6d1c7734ee3a	eb1c04ca-7402-440b-ae1b-a8c0a09c316e
20	20	0	Plazi	ffb07bec-2d10-492d-9c37-361fe0b79427	f0c7a46c-42f3-48c5-8c7d-d39da269d9df
47	47	0	Plazi	ffb07bec-2d10-492d-9c37-361fe0b79427	f1f5d7f4-d946-4b3e-913c-48054bd05d37
1648	1648	0	National Biodiversity Network	d897a5b9-35ee-4232-94bd-b0bcaac003c2	f2f8f3f7-312f-46e0-8dde-333069b99627
0	5918	5918	Belgian Biodiversity Platform	fb11cfe1-ebc3-45af-9159-17d9fddbcdac	f3823f80-cd2d-4bbb-b9de-b27ac275ea7e
4185	4185	0	Polish Biodiversity Information Network	2618bfdf-e194-4911-a241-80db3107bc51	f4ae0140-9fcc-11da-a90c-b8a03c50a862
0	38	38	Plazi	ffb07bec-2d10-492d-9c37-361fe0b79427	f725a409-be04-4f11-b538-092af4454641
2540	2540	0	GBIF Germany	4f6826f2-4ff6-443d-b966-e6913bd24013	f84f8598-630b-4c07-82f8-25bc3685873d
568	568	0	Biodiversity Information System of Mexico	b324e8e9-9a4c-44fa-8f1a-7f39ea7ab576	f8a42ec9-98c5-46bf-a1f5-20f070f7b367
0	4	4	Plazi	ffb07bec-2d10-492d-9c37-361fe0b79427	f8b056ee-69fb-4585-8e6f-ec8a90f937b8
0	3	3	Plazi	ffb07bec-2d10-492d-9c37-361fe0b79427	f8c8d721-75ac-4a95-9c65-dcdbffe60192
1025670	1306392	280722	GBIF France	da44cd31-5901-4687-a106-6d1c7734ee3a	f946666e-67dc-4848-9fa8-2162f3559e33
1	1	0	GBIF France	da44cd31-5901-4687-a106-6d1c7734ee3a	f9775fa0-90b3-4e94-8911-40ccd543f4dd
0	1560	1560	Ocean Biodiversity Information System	ba0670b9-4186-41e6-8e70-f9cb3065551a	fd51eef3-35da-44b1-8f5a-fdcfd5ec1b64
198	198	0	GBIF France	da44cd31-5901-4687-a106-6d1c7734ee3a	fff8dd17-0bff-4854-88d1-098b6a64766b
1	1	0	Plazi	ffb07bec-2d10-492d-9c37-361fe0b79427	001e3a91-4ea0-4bb3-9ec8-9d3697554a85
1	1	0	Plazi	ffb07bec-2d10-492d-9c37-361fe0b79427	0483c2c6-b39d-40a6-becb-29e625af0b97
2029	2029	0	Biodiversity Information System of Mexico	b324e8e9-9a4c-44fa-8f1a-7f39ea7ab576	05c7a097-a70b-4a6f-abaa-02bc58d980f0
817	817	0	National Biodiversity Network	d897a5b9-35ee-4232-94bd-b0bcaac003c2	0624e78a-c618-466d-b1d8-e3a0a2d07f3b
9	9	0	Plazi	ffb07bec-2d10-492d-9c37-361fe0b79427	0a4fd93c-e2a3-4777-b14b-2f85a86d2cf3
142	142	0	GBIF France	da44cd31-5901-4687-a106-6d1c7734ee3a	0ce63308-8e68-43e1-b081-fabcf78e65fa
1	1	0	Plazi	ffb07bec-2d10-492d-9c37-361fe0b79427	0e21d3ca-b6db-4e12-a8e3-40b9a02df9af
231	231	0	GBIF Brazil	cdc9736d-5ff7-4ece-9959-3c744360cdb3	0fcd3a78-f2c2-42de-910f-bcc306d63504
825	855	30	GBIF Germany	4f6826f2-4ff6-443d-b966-e6913bd24013	115c48b5-b2c4-481c-b7c5-3c52ceb12bb0
1	1	0	Plazi	ffb07bec-2d10-492d-9c37-361fe0b79427	1298e1c4-791d-4e60-ba75-e0caa2646f67
0	13	13	Ocean Biodiversity Information System	ba0670b9-4186-41e6-8e70-f9cb3065551a	158424fe-b6f8-40a6-ba67-9789b4676271
116	116	0	GBIF Germany	4f6826f2-4ff6-443d-b966-e6913bd24013	15adde64-5344-4852-b0ec-cbca74ec0d3c
0	6	6	Plazi	ffb07bec-2d10-492d-9c37-361fe0b79427	1ad0b2e4-deae-43fe-b685-e4aec10b042f
24	1018	994	GBIF Germany	4f6826f2-4ff6-443d-b966-e6913bd24013	2555c0f8-c476-4fc3-9dbe-1b704deaf10b
0	1	1	Plazi	ffb07bec-2d10-492d-9c37-361fe0b79427	27e3a5c6-6d4d-42ce-bcef-71b3d098bf04
96	96	0	Plazi	ffb07bec-2d10-492d-9c37-361fe0b79427	2ba86023-6d9d-4e4c-93dd-9f9ae644f504
0	1	1	Plazi	ffb07bec-2d10-492d-9c37-361fe0b79427	2ca8d3e0-8024-461e-931e-060cad1709d1
7	7	0	Plazi	ffb07bec-2d10-492d-9c37-361fe0b79427	2dc3f71e-8ff2-4f6b-a9d0-2ce0477330d9
522598	560635	38037	GBIF Norway	4f829580-180d-46a9-9c87-ed8ec959b545	2e4cc37b-302e-4f1b-bbbb-1f674ff90e14
372	372	0	Colombian Biodiversity Information System	7e865cba-7c46-417b-ade5-97f2cf5b7be0	30b1d0ce-5d16-471e-b33a-66fbfc678e04
51	51	0	Belgian Biodiversity Platform	fb11cfe1-ebc3-45af-9159-17d9fddbcdac	31919c34-623e-4788-8621-bc993d89bd64
1	1	0	Plazi	ffb07bec-2d10-492d-9c37-361fe0b79427	3692529d-0b66-43c4-9039-f1774e260d10
0	7	7	Plazi	ffb07bec-2d10-492d-9c37-361fe0b79427	37956fe2-d2e9-4720-b525-283454c99578
1049	1049	0	National Biodiversity Network	d897a5b9-35ee-4232-94bd-b0bcaac003c2	38c11a67-184a-4a3f-a44a-122f5c7fd5af
6191	6191	0	National Biodiversity Network	d897a5b9-35ee-4232-94bd-b0bcaac003c2	3aa7fc9b-7bd4-4d86-9f3e-582bc0ed087f
11	11	0	GBIF France	da44cd31-5901-4687-a106-6d1c7734ee3a	3ab44a2a-0b76-4c6f-b3df-6ae7ea911810
23772	23772	0	National Biodiversity Network	d897a5b9-35ee-4232-94bd-b0bcaac003c2	3e11380c-f8bb-48c8-95c4-041d60eb1e46
0	2050	2050	Biodiversity Information System of Mexico	b324e8e9-9a4c-44fa-8f1a-7f39ea7ab576	3e13b5c5-29e7-420c-99b9-7372f681b1b2
40	40	0	Participant Node Managers Committee	7f48e0c8-5c96-49ec-b972-30748e339115	470e1d03-9b02-4743-8291-936632f21439
811	811	0	GBIF France	da44cd31-5901-4687-a106-6d1c7734ee3a	48218c51-80aa-4a5b-87da-ff2080212d4f
0	169	169	Plazi	ffb07bec-2d10-492d-9c37-361fe0b79427	4b7a838b-1449-4ae4-90ff-5a7f113868e0
8026	8026	0	Colombian Biodiversity Information System	7e865cba-7c46-417b-ade5-97f2cf5b7be0	5060bce6-8155-46e2-b1dd-20c2041f2a2a
4	4	0	Plazi	ffb07bec-2d10-492d-9c37-361fe0b79427	51c6f104-a069-4906-990f-923fb51605b5
2392	2392	0	U.S. Geological Survey	8618c64a-93e0-4300-b546-7249e5148ed2	51fa0155-a545-4154-ac20-b89dbb2c312b
9	9	0	Plazi	ffb07bec-2d10-492d-9c37-361fe0b79427	52385bf0-9f3e-4c15-a113-68a200fcb20e
0	59	59	Ocean Biodiversity Information System	ba0670b9-4186-41e6-8e70-f9cb3065551a	53c6cfb6-e440-4521-9efe-1a473e7bff28
3	3	0	Plazi	ffb07bec-2d10-492d-9c37-361fe0b79427	5567712b-2d25-4128-bc28-b84823b3a3ad
49	49	0	Colombian Biodiversity Information System	7e865cba-7c46-417b-ade5-97f2cf5b7be0	560539d5-7f71-4fd8-998b-ba5b16a55568
132	132	0	Plazi	ffb07bec-2d10-492d-9c37-361fe0b79427	56172c62-3e7c-4ab7-83d4-1dd9f5c57eb5
442	442	0	National Biodiversity Network	d897a5b9-35ee-4232-94bd-b0bcaac003c2	576ccf88-57d9-480f-bd89-60267bf08e84
782	782	0	National Biodiversity Network	d897a5b9-35ee-4232-94bd-b0bcaac003c2	5819973a-017f-475a-9e82-17cee91ccbf7
0	10000	10000	Korean Biodiversity Information Facility	e0a1e772-0177-4800-94b4-2d023fe6cdf4	58360347-6ffe-4ab0-a716-b0b53d772a02
0	23	23	Plazi	ffb07bec-2d10-492d-9c37-361fe0b79427	5d04f950-b33e-4111-9c20-859f3e53f3f2
3	3	0	Plazi	ffb07bec-2d10-492d-9c37-361fe0b79427	5e8fa47b-bfdc-4703-977e-a27c4f92f258
355	355	0	Colombian Biodiversity Information System	7e865cba-7c46-417b-ade5-97f2cf5b7be0	6246f26c-aec8-492c-b8a1-ac7f327445ae
4663	4665	2	U.S. Geological Survey	8618c64a-93e0-4300-b546-7249e5148ed2	62ad511d-d298-4fd7-80e7-f5d5bd32299e
13	13	0	GBIF Germany	4f6826f2-4ff6-443d-b966-e6913bd24013	62fecce4-f762-11e1-a439-00145eb45e9a
163	163	0	GBIF Germany	4f6826f2-4ff6-443d-b966-e6913bd24013	6353f11a-f762-11e1-a439-00145eb45e9a
91	91	0	GBIF Germany	4f6826f2-4ff6-443d-b966-e6913bd24013	63ba50ae-f762-11e1-a439-00145eb45e9a
3	3	0	Plazi	ffb07bec-2d10-492d-9c37-361fe0b79427	63d7683e-fb7f-4685-8db4-8183b21e8746
184	184	0	Participant Node Managers Committee	7f48e0c8-5c96-49ec-b972-30748e339115	646dac25-158c-4b60-9410-df03b00d61cd
31	31	0	GBIF Germany	4f6826f2-4ff6-443d-b966-e6913bd24013	66887c3e-f762-11e1-a439-00145eb45e9a
56	56	0	GBIF Germany	4f6826f2-4ff6-443d-b966-e6913bd24013	67bfc53a-f762-11e1-a439-00145eb45e9a
198	198	0	GBIF France	da44cd31-5901-4687-a106-6d1c7734ee3a	67f476e6-e50f-4976-9283-b2dd2aa1e556
109	109	0	GBIF Germany	4f6826f2-4ff6-443d-b966-e6913bd24013	6800d30e-f762-11e1-a439-00145eb45e9a
90	90	0	GBIF Germany	4f6826f2-4ff6-443d-b966-e6913bd24013	6811a0d0-f762-11e1-a439-00145eb45e9a
72	72	0	GBIF Germany	4f6826f2-4ff6-443d-b966-e6913bd24013	6875f58a-f762-11e1-a439-00145eb45e9a
139	139	0	GBIF Germany	4f6826f2-4ff6-443d-b966-e6913bd24013	687d6a04-f762-11e1-a439-00145eb45e9a
4335	4335	0	National Biodiversity Network	d897a5b9-35ee-4232-94bd-b0bcaac003c2	693a8de3-6968-4e2f-a7c3-7107d1699cdf
4423	4423	0	GBIF France	da44cd31-5901-4687-a106-6d1c7734ee3a	6978dbb1-a726-4ad9-b064-1e1cad3bc889
170	170	0	GBIF Germany	4f6826f2-4ff6-443d-b966-e6913bd24013	6a21b022-f762-11e1-a439-00145eb45e9a
1892	1892	0	National Biodiversity Network	d897a5b9-35ee-4232-94bd-b0bcaac003c2	6b3902aa-7819-47d2-83b2-bb021611b900
7	7	0	Plazi	ffb07bec-2d10-492d-9c37-361fe0b79427	6bce4300-9c23-425b-accb-41cc3a78926f
38	38	0	Plazi	ffb07bec-2d10-492d-9c37-361fe0b79427	6dc55986-74fa-4ac0-bca6-b301f3831180
1071	1071	0	GBIF Germany	4f6826f2-4ff6-443d-b966-e6913bd24013	7051491c-f762-11e1-a439-00145eb45e9a
84	84	0	GBIF Germany	4f6826f2-4ff6-443d-b966-e6913bd24013	73f8cdc4-f762-11e1-a439-00145eb45e9a
5	5	0	GBIF Germany	4f6826f2-4ff6-443d-b966-e6913bd24013	7428e6ee-f762-11e1-a439-00145eb45e9a
725	676	-49	GBIF Germany	4f6826f2-4ff6-443d-b966-e6913bd24013	79919932-f762-11e1-a439-00145eb45e9a
1195	1195	0	GBIF Germany	4f6826f2-4ff6-443d-b966-e6913bd24013	7c57685e-f762-11e1-a439-00145eb45e9a
70	70	0	GBIF Germany	4f6826f2-4ff6-443d-b966-e6913bd24013	7d4361c8-f762-11e1-a439-00145eb45e9a
5298	5298	0	Colombian Biodiversity Information System	7e865cba-7c46-417b-ade5-97f2cf5b7be0	7d5a76b9-819f-4fb8-aab0-664d4089aa54
1798	1798	0	GBIF Germany	4f6826f2-4ff6-443d-b966-e6913bd24013	7d68b25c-f762-11e1-a439-00145eb45e9a
144	144	0	National Biodiversity Network	d897a5b9-35ee-4232-94bd-b0bcaac003c2	7dcd2156-75af-4772-bf1b-db606d534977
1294	1294	0	GBIF Germany	4f6826f2-4ff6-443d-b966-e6913bd24013	7dd8fb20-f762-11e1-a439-00145eb45e9a
184	184	0	GBIF Germany	4f6826f2-4ff6-443d-b966-e6913bd24013	7e0cd31e-f762-11e1-a439-00145eb45e9a
1547	1547	0	Netherlands Biodiversity Information Facility	0909d601-bda2-42df-9e63-a6d51847ebce	7e1d9b3b-a73c-465a-aa55-a70bfa3138f3
3	3	0	Plazi	ffb07bec-2d10-492d-9c37-361fe0b79427	7ea36563-56be-4bd5-8076-ee30bef7a724
0	83	83	Participant Node Managers Committee	7f48e0c8-5c96-49ec-b972-30748e339115	7eb747dc-a542-41dc-b937-f3df81b77c49
504	210	-294	GBIF Germany	4f6826f2-4ff6-443d-b966-e6913bd24013	7eceb6f0-f762-11e1-a439-00145eb45e9a
755	755	0	GBIF Germany	4f6826f2-4ff6-443d-b966-e6913bd24013	7ed742ca-f762-11e1-a439-00145eb45e9a
4417	4417	0	Biodiversity Information System of Mexico	b324e8e9-9a4c-44fa-8f1a-7f39ea7ab576	7fae65ca-f762-11e1-a439-00145eb45e9a
2425	2425	0	Biodiversity Information System of Mexico	b324e8e9-9a4c-44fa-8f1a-7f39ea7ab576	807d1c6c-f762-11e1-a439-00145eb45e9a
1092	1092	0	Biodiversity Information System of Mexico	b324e8e9-9a4c-44fa-8f1a-7f39ea7ab576	809fc7c6-f762-11e1-a439-00145eb45e9a
7447	7447	0	GBIF France	da44cd31-5901-4687-a106-6d1c7734ee3a	816f3aa0-d44b-4785-b920-457693d8451d
6418	6426	8	GBIF Norway	4f829580-180d-46a9-9c87-ed8ec959b545	81ccd65e-1832-4d4c-aaaa-56541b71ae1b
10997	11982	985	GBIF Germany	4f6826f2-4ff6-443d-b966-e6913bd24013	828210a8-f762-11e1-a439-00145eb45e9a
144	144	0	GBIF France	da44cd31-5901-4687-a106-6d1c7734ee3a	828eeb63-7d98-4ded-9889-a77cb45fea0d
470	470	0	GBIF Germany	4f6826f2-4ff6-443d-b966-e6913bd24013	82b34c9a-f762-11e1-a439-00145eb45e9a
0	5	5	Plazi	ffb07bec-2d10-492d-9c37-361fe0b79427	82f8211d-03ed-43c3-bd48-343b58748bef
7047	7046	-1	National Biodiversity Network	d897a5b9-35ee-4232-94bd-b0bcaac003c2	83501c7f-a413-45c7-a5d5-c9bf94fa37ef
0	1371	1371	Belgian Biodiversity Platform	fb11cfe1-ebc3-45af-9159-17d9fddbcdac	835364c6-0020-44c7-8deb-f3397adc9575
8	8	0	Plazi	ffb07bec-2d10-492d-9c37-361fe0b79427	845aab4b-f295-4c65-814e-b5e4520429c8
365	365	0	GBIF Japan	db5705aa-6a6e-42f1-8942-d77b9f4896ea	86a3cf6e-f762-11e1-a439-00145eb45e9a
96	48	-48	GBIF Germany	4f6826f2-4ff6-443d-b966-e6913bd24013	86e37e84-f762-11e1-a439-00145eb45e9a
57	23	-34	GBIF Germany	4f6826f2-4ff6-443d-b966-e6913bd24013	871e3164-f762-11e1-a439-00145eb45e9a
422	314	-108	GBIF Germany	4f6826f2-4ff6-443d-b966-e6913bd24013	87d7306a-f762-11e1-a439-00145eb45e9a
68988	69004	16	Canada Biodiversity Information Facility	8f83fc96-c966-4126-83f7-bf044dc49efa	87f42a91-8dfd-44f1-aabb-8b6ef14aba82
271	271	0	GBIF Germany	4f6826f2-4ff6-443d-b966-e6913bd24013	882e5264-f762-11e1-a439-00145eb45e9a
174	98	-76	GBIF Germany	4f6826f2-4ff6-443d-b966-e6913bd24013	88ba7c4e-f762-11e1-a439-00145eb45e9a
112	32	-80	GBIF Germany	4f6826f2-4ff6-443d-b966-e6913bd24013	88bd3c90-f762-11e1-a439-00145eb45e9a
342170	342289	119	Canada Biodiversity Information Facility	8f83fc96-c966-4126-83f7-bf044dc49efa	8971dfba-f762-11e1-a439-00145eb45e9a
94	94	0	GBIF Germany	4f6826f2-4ff6-443d-b966-e6913bd24013	8ac6ef36-f762-11e1-a439-00145eb45e9a
532	472	-60	GBIF Germany	4f6826f2-4ff6-443d-b966-e6913bd24013	8aee6695-30b0-4572-a816-482cf50f3140
63	63	0	GBIF Germany	4f6826f2-4ff6-443d-b966-e6913bd24013	8b939248-f762-11e1-a439-00145eb45e9a
82	82	0	GBIF Germany	4f6826f2-4ff6-443d-b966-e6913bd24013	8b94dacc-f762-11e1-a439-00145eb45e9a
3	2	-1	GBIF Germany	4f6826f2-4ff6-443d-b966-e6913bd24013	8c803742-f762-11e1-a439-00145eb45e9a
2	2	0	Plazi	ffb07bec-2d10-492d-9c37-361fe0b79427	8d88cb51-0461-4d09-80cf-1af818a591fe
20	9	-11	GBIF Germany	4f6826f2-4ff6-443d-b966-e6913bd24013	8dd8557a-f762-11e1-a439-00145eb45e9a
24	3	-21	GBIF Germany	4f6826f2-4ff6-443d-b966-e6913bd24013	8ed93a52-f762-11e1-a439-00145eb45e9a
486	432	-54	GBIF Germany	4f6826f2-4ff6-443d-b966-e6913bd24013	8f0ec42e-f762-11e1-a439-00145eb45e9a
445	322	-123	GBIF Germany	4f6826f2-4ff6-443d-b966-e6913bd24013	8fcedaac-f762-11e1-a439-00145eb45e9a
0	3822	3822	Ocean Biodiversity Information System	ba0670b9-4186-41e6-8e70-f9cb3065551a	90159e39-efd9-440d-b365-d6ff78337662
18	8	-10	GBIF Germany	4f6826f2-4ff6-443d-b966-e6913bd24013	9015f54a-f762-11e1-a439-00145eb45e9a
8156	4287	-3869	GBIF Germany	4f6826f2-4ff6-443d-b966-e6913bd24013	9053dc66-f762-11e1-a439-00145eb45e9a
241	241	0	Colombian Biodiversity Information System	7e865cba-7c46-417b-ade5-97f2cf5b7be0	90680918-41b6-459e-bfe7-2891005bb469
151	146	-5	GBIF Germany	4f6826f2-4ff6-443d-b966-e6913bd24013	91d51988-f762-11e1-a439-00145eb45e9a
837	837	0	GBIF Germany	4f6826f2-4ff6-443d-b966-e6913bd24013	92672cec-f762-11e1-a439-00145eb45e9a
14	14	0	Plazi	ffb07bec-2d10-492d-9c37-361fe0b79427	92d2405f-68eb-4b38-ae95-34f307af641e
494	494	0	GBIF Germany	4f6826f2-4ff6-443d-b966-e6913bd24013	94423b6a-f762-11e1-a439-00145eb45e9a
0	2	2	Plazi	ffb07bec-2d10-492d-9c37-361fe0b79427	94c11416-323b-4f73-8d70-a57dcf48fcd8
2914	2914	0	GBIF Germany	4f6826f2-4ff6-443d-b966-e6913bd24013	95252f0e-4d06-4511-8558-aab369c8215a
768	767	-1	Biodiversity Information System of Mexico	b324e8e9-9a4c-44fa-8f1a-7f39ea7ab576	95e0540e-aead-4402-b77d-738b846dafc5
10	10	0	Plazi	ffb07bec-2d10-492d-9c37-361fe0b79427	9816a8c4-f37a-4832-8a66-9080db542c76
10720	10720	0	GBIF Japan	db5705aa-6a6e-42f1-8942-d77b9f4896ea	985e6485-14c9-4555-9c63-bb1b79c29da7
0	8	8	Plazi	ffb07bec-2d10-492d-9c37-361fe0b79427	987621b4-c823-484c-9346-9e218e86b26b
0	1	1	Plazi	ffb07bec-2d10-492d-9c37-361fe0b79427	9dc8ffcd-ba19-4325-8608-9a34f0455bb6
0	835	835	Ocean Biodiversity Information System	ba0670b9-4186-41e6-8e70-f9cb3065551a	9f09318c-fa80-4e15-9408-abf38556a0cc
25	25	0	Colombian Biodiversity Information System	7e865cba-7c46-417b-ade5-97f2cf5b7be0	a3a24344-5bc9-44dd-9b5f-a3ae991c4810
83	83	0	GBIF France	da44cd31-5901-4687-a106-6d1c7734ee3a	a40a3f1d-8248-491f-a7c4-757d8a47ec9d
0	7	7	Plazi	ffb07bec-2d10-492d-9c37-361fe0b79427	a433f198-6f2a-47eb-976c-a1943663aee7
39	39	0	Plazi	ffb07bec-2d10-492d-9c37-361fe0b79427	a614f1d9-bda9-4df0-a486-aef5af7813fa
5	5	0	Plazi	ffb07bec-2d10-492d-9c37-361fe0b79427	a9228bfa-3781-4c60-b06c-af3e12a20234
0	36	36	Plazi	ffb07bec-2d10-492d-9c37-361fe0b79427	a9790c0f-631a-4e4e-8560-31a386518dba
745	1021	276	Participant Node Managers Committee	7f48e0c8-5c96-49ec-b972-30748e339115	a9d21eba-49ae-47a4-adb3-b5733742935e
311	311	0	Nordic Genetic Resource Centre	fa6bdac4-51e2-4334-940c-ba6cdf6e1257	ab48f1c2-7964-40ce-9274-b5ed65060424
12	12	0	Colombian Biodiversity Information System	7e865cba-7c46-417b-ade5-97f2cf5b7be0	ab555988-8f25-416c-896a-136e1aae03bf
19	19	0	Plazi	ffb07bec-2d10-492d-9c37-361fe0b79427	abe1e9ac-622d-4d50-a4b4-6de6baf77f32
63	63	0	Colombian Biodiversity Information System	7e865cba-7c46-417b-ade5-97f2cf5b7be0	abed9805-7ca3-456f-a641-b65b6de52ef9
17	17	0	Plazi	ffb07bec-2d10-492d-9c37-361fe0b79427	acfb3118-aaf0-4a55-ad3a-6264724330e2
139	139	0	Canada Biodiversity Information Facility	8f83fc96-c966-4126-83f7-bf044dc49efa	ad4c9413-95bc-4b3c-a1e9-b7cf16f391a2
27	27	0	GBIF Germany	4f6826f2-4ff6-443d-b966-e6913bd24013	af079095-7438-4bc4-9f1d-b328e948969f
11	11	0	Plazi	ffb07bec-2d10-492d-9c37-361fe0b79427	b1b2f690-49a6-4b05-ba83-feb9e4de1bcf
245	245	0	GBIF France	da44cd31-5901-4687-a106-6d1c7734ee3a	b5bfafdc-9e66-4898-8d3c-040406ed032e
35	35	0	GBIF France	da44cd31-5901-4687-a106-6d1c7734ee3a	b61f8655-37d0-46f5-b8c2-379b945fc9ed
7561	7561	0	GBIF France	da44cd31-5901-4687-a106-6d1c7734ee3a	b6776c43-0f49-4018-8a96-22b28a3dd907
0	12	12	Ocean Biodiversity Information System	ba0670b9-4186-41e6-8e70-f9cb3065551a	b8f14f3c-e9ab-49dc-b83e-c39523f0e9b9
0	1	1	Plazi	ffb07bec-2d10-492d-9c37-361fe0b79427	ba73857c-96df-4976-b4c3-3fade45b94d7
0	8	8	Plazi	ffb07bec-2d10-492d-9c37-361fe0b79427	bc28e8d7-56ea-4318-86bc-834a0fdb87c8
147	147	0	Belgian Biodiversity Platform	fb11cfe1-ebc3-45af-9159-17d9fddbcdac	bced6c7a-c7e0-40f7-b009-5f0478104716
0	5	5	Plazi	ffb07bec-2d10-492d-9c37-361fe0b79427	c03ce5c7-7805-4f32-95db-d4ce50995274
467	467	0	GBIF Brazil	cdc9736d-5ff7-4ece-9959-3c744360cdb3	c1442cb5-7a32-415e-b459-f6719a01e733
0	10	10	Plazi	ffb07bec-2d10-492d-9c37-361fe0b79427	c2d3daf3-bfed-41ae-a1ae-41c341f8d8e8
28214	75548	47334	GBIF India	59d15a9b-ba51-43c3-a53f-304fe6732c04	c6b86c40-ff71-4e5e-902c-111f400d0d56
15	15	0	Plazi	ffb07bec-2d10-492d-9c37-361fe0b79427	c9d54684-8640-4540-b2d0-7861e267c697
401	401	0	GBIF France	da44cd31-5901-4687-a106-6d1c7734ee3a	cb5e8603-a7f3-43d0-8534-233ec0e535d7
31	31	0	Plazi	ffb07bec-2d10-492d-9c37-361fe0b79427	cbb9f357-1fa8-4fc8-b625-2967e21d8973
1	1	0	Participant Node Managers Committee	7f48e0c8-5c96-49ec-b972-30748e339115	cc2cbf14-b5b0-414a-8f7f-7648e9e1bb2f
16924	16924	0	GBIF Spain	1f94b3ca-9345-4d65-afe2-4bace93aa0fe	cd53c947-f81a-485e-92fa-cbc4aa123160
590404	590404	0	National Biodiversity Network	d897a5b9-35ee-4232-94bd-b0bcaac003c2	ce8530a2-cd4b-4e51-9927-76bf49b5a9a6
168	101	-67	GBIF Germany	4f6826f2-4ff6-443d-b966-e6913bd24013	d29e2e4d-0b0f-4259-bbcb-af90a1b79232
0	254	254	Colombian Biodiversity Information System	7e865cba-7c46-417b-ade5-97f2cf5b7be0	d4f862ff-3fc3-4f5d-9332-a653801ed6da
0	65	65	Plazi	ffb07bec-2d10-492d-9c37-361fe0b79427	d640faf0-b3db-4fad-baaf-9eeaef7350e4
0	8	8	Plazi	ffb07bec-2d10-492d-9c37-361fe0b79427	d66f1b27-5891-4fa5-96e0-f75cb3ec2445
3	3	0	Plazi	ffb07bec-2d10-492d-9c37-361fe0b79427	d678bbe0-683c-4861-ae22-166d258dca20
0	749	749	Ocean Biodiversity Information System	ba0670b9-4186-41e6-8e70-f9cb3065551a	d803fb46-e353-4a95-9bd7-49c19ebf7911
26185	26185	0	GBIF France	da44cd31-5901-4687-a106-6d1c7734ee3a	d8c540f5-bb74-4748-9634-034ccd8ec52b
17	17	0	GBIF Argentina	2426a871-9feb-40a1-96c6-0c593a76b835	d9cb17db-7183-47d8-b0d9-b79448e48a71
0	1269	1269	National Biodiversity Data Centre	422b00b2-6c94-4bb6-976b-c359916efdb8	dcbb4725-7c05-47a1-a878-067da61dca3f
4	4	0	Plazi	ffb07bec-2d10-492d-9c37-361fe0b79427	dd60820c-b490-421e-ae45-c447a804cb64
55	55	0	Plazi	ffb07bec-2d10-492d-9c37-361fe0b79427	dd944d67-5196-4c44-8497-416acd882bb0
3580	3580	0	Atlas of Living Australia	4a6f1b71-969e-4fc5-a693-282b05e1220c	de077267-677e-4b3e-a40e-753a2d1c7b6a
0	4	4	Plazi	ffb07bec-2d10-492d-9c37-361fe0b79427	de3228cf-39db-41aa-b84a-c8e95511dded
42	42	0	GBIF France	da44cd31-5901-4687-a106-6d1c7734ee3a	de6938a6-1204-4bdb-8666-12fb6de82707
192	192	0	GBIF France	da44cd31-5901-4687-a106-6d1c7734ee3a	df14b969-829f-42ad-afe5-50d5c9ed28a6
14	27	13	Chinese Academy of Sciences	e760dc6f-dd68-474d-ab41-bd3588571793	dfa36691-529b-43b6-9e61-b76275d94ffc
34724	34724	0	GBIF France	da44cd31-5901-4687-a106-6d1c7734ee3a	e0ebf2a1-3656-468a-b0b6-1aa93ff43fef
0	1	1	Plazi	ffb07bec-2d10-492d-9c37-361fe0b79427	e19994e4-c0e7-484b-b48b-8e733ca4a9b7
0	461	461	Belgian Biodiversity Platform	fb11cfe1-ebc3-45af-9159-17d9fddbcdac	e3992de2-60bf-4cdf-9bc5-3e4525d017d6
959	959	0	GBIF France	da44cd31-5901-4687-a106-6d1c7734ee3a	e6e71bc6-6194-4259-9438-fc1ff325335a
3187	3187	0	National Biodiversity Network	d897a5b9-35ee-4232-94bd-b0bcaac003c2	e7b8353a-0d1b-4457-96c1-b3a72b4d01a5
0	1	1	Participant Node Managers Committee	7f48e0c8-5c96-49ec-b972-30748e339115	e80278a9-8386-48b5-9e11-1a55ed1b30c0
1836	1836	0	GBIF Portugal	673f7038-4262-4149-b753-5658a4e912f6	e94838e6-ded0-498e-abc0-df89809999d1
97	97	0	Participant Node Managers Committee	7f48e0c8-5c96-49ec-b972-30748e339115	eaa11a47-8015-4c21-8362-c13938b65745
549	549	0	National Biodiversity Network	d897a5b9-35ee-4232-94bd-b0bcaac003c2	eda0e170-a39f-44fc-9c03-cce4f7417df7
2557	2557	0	Biodiversity Information System of Mexico	b324e8e9-9a4c-44fa-8f1a-7f39ea7ab576	ee188aa6-45e3-433d-b867-5c72e572c681
435	435	0	GBIF France	da44cd31-5901-4687-a106-6d1c7734ee3a	ee601209-8e4f-4781-9aa7-65e9fc3698ff
7053	7053	0	Participant Node Managers Committee	7f48e0c8-5c96-49ec-b972-30748e339115	ef3bacd0-faf7-452c-9461-da9684fe662f
122	122	0	GBIF France	da44cd31-5901-4687-a106-6d1c7734ee3a	f298961a-460f-4251-8491-46512793f135
9	9	0	GBIF France	da44cd31-5901-4687-a106-6d1c7734ee3a	f32381af-5b6f-477f-8a55-c8cdd5e91882
0	5	5	Plazi	ffb07bec-2d10-492d-9c37-361fe0b79427	f3b0c37f-bbd1-43d3-865c-802210828c99
42656	42656	0	GBIF Germany	4f6826f2-4ff6-443d-b966-e6913bd24013	f4419c70-614f-11e2-897a-00145eb45e9a
139	139	0	Atlas of Living Australia	4a6f1b71-969e-4fc5-a693-282b05e1220c	f4f88357-7e88-4cab-b3df-848dfcf07e0e
0	292	292	Ocean Biodiversity Information System	ba0670b9-4186-41e6-8e70-f9cb3065551a	f8656dce-5abd-43ed-8d2f-ffb8fd935a2e
0	70	70	Plazi	ffb07bec-2d10-492d-9c37-361fe0b79427	fe7e9c0d-0cf6-4ddf-bae8-f30775ff0dc3
0	299	299	Botanic Gardens Conservation International	844f7db8-d78e-4f9a-98ba-2008b1f1461e	0064f3b0-e3f0-4ff6-bb7d-f0bb93cff2ee
16	16	0	Plazi	ffb07bec-2d10-492d-9c37-361fe0b79427	02c11e5e-32c9-4316-80c8-084d87826982
3	3	0	Plazi	ffb07bec-2d10-492d-9c37-361fe0b79427	02def5ee-ac5d-4adc-b204-d22209c2b63c
15	15	0	Participant Node Managers Committee	7f48e0c8-5c96-49ec-b972-30748e339115	0510e56a-0f4a-4b5c-82f6-c85f6df3e8a8
70	70	0	Plazi	ffb07bec-2d10-492d-9c37-361fe0b79427	0539e3ec-e2d6-4ed3-9f5e-22677babf264
222	248	26	GBIF Japan	db5705aa-6a6e-42f1-8942-d77b9f4896ea	086ab94d-4c5a-45dd-9651-d7cd337d9f49
11	11	0	Plazi	ffb07bec-2d10-492d-9c37-361fe0b79427	094c42ec-da3a-45cf-a48d-079d7b86c5b6
40	40	0	GBIF Brazil	cdc9736d-5ff7-4ece-9959-3c744360cdb3	09b49a0c-ebcb-4d58-9baf-3e1f93e8ace3
0	178	178	Plazi	ffb07bec-2d10-492d-9c37-361fe0b79427	0aee75cf-6abf-4f6d-9fa1-ae8d320bc0eb
11	11	0	Plazi	ffb07bec-2d10-492d-9c37-361fe0b79427	0bdadccc-2790-4c0d-9e04-93845c37e703
320	320	0	GBIF France	da44cd31-5901-4687-a106-6d1c7734ee3a	0c7380ff-07b7-4542-859f-164a6af5bf45
7	7	0	Plazi	ffb07bec-2d10-492d-9c37-361fe0b79427	0e06c542-08b9-4f44-81b5-a36a6c0561fe
1	1	0	Plazi	ffb07bec-2d10-492d-9c37-361fe0b79427	0e6180e6-1e6a-4aef-9b1a-298c451a7207
0	2	2	Plazi	ffb07bec-2d10-492d-9c37-361fe0b79427	0ed6eca0-fbbb-41ea-bd68-bb0d0f34edf1
3	3	0	GBIF France	da44cd31-5901-4687-a106-6d1c7734ee3a	11a3c7e5-c620-4478-af89-542b8cd3c540
0	46424	46424	Colombian Biodiversity Information System	7e865cba-7c46-417b-ade5-97f2cf5b7be0	1280c87e-dad9-4dcf-82da-9823a3f5b679
0	22	22	Plazi	ffb07bec-2d10-492d-9c37-361fe0b79427	12ce6c7e-25b2-4af8-bb72-f9f86c1b5edf
598	598	0	BioCASE	d8bbf693-a180-4995-94fe-6130795dcf2f	167acd5c-9459-4e2d-86a1-ee9d6f5e5893
4	4	0	Plazi	ffb07bec-2d10-492d-9c37-361fe0b79427	171aaecb-3d2b-4f17-8bf7-2c78c42c8296
0	5	5	Colombian Biodiversity Information System	7e865cba-7c46-417b-ade5-97f2cf5b7be0	195948dc-5242-4d63-a844-5373dff482f9
2	2	0	Plazi	ffb07bec-2d10-492d-9c37-361fe0b79427	199b16ba-c264-4d83-8f92-50c04654a146
94696	94696	0	Netherlands Biodiversity Information Facility	0909d601-bda2-42df-9e63-a6d51847ebce	19c50cd5-d538-43ce-a794-467da1130330
0	63	63	Ocean Biodiversity Information System	ba0670b9-4186-41e6-8e70-f9cb3065551a	1a19ac19-a5c1-4ba2-bd69-dfe53c7f8099
741	741	0	Biodiversity Information System of Mexico	b324e8e9-9a4c-44fa-8f1a-7f39ea7ab576	1c38e2cb-77fc-4bd0-87b9-f312c8a9e2c9
1	1	0	Plazi	ffb07bec-2d10-492d-9c37-361fe0b79427	1c8ce81a-64f0-4aba-af14-162462187b92
282	282	0	GBIF Uganda	71b40829-6a12-4c3d-8fee-5746f5e9cf8c	1fab2240-32cd-4a71-8a48-bbe8d1e73ef2
0	2	2	Plazi	ffb07bec-2d10-492d-9c37-361fe0b79427	1fbd5e30-fbd7-434e-a2c9-51b35e20b31f
0	1284	1284	Biodiversity Information System of Mexico	b324e8e9-9a4c-44fa-8f1a-7f39ea7ab576	204dbff9-74a8-4655-9adf-d3a6578ad0ef
2	2	0	Plazi	ffb07bec-2d10-492d-9c37-361fe0b79427	22a109e7-7d0f-41d4-adf0-6f5be8a7374e
187583	187583	0	U.S. Geological Survey	8618c64a-93e0-4300-b546-7249e5148ed2	29f71768-50ac-4a9d-8985-86638b0b30e4
613	613	0	GBIF France	da44cd31-5901-4687-a106-6d1c7734ee3a	2d9fe775-9d88-444f-8ddc-199e27fb00a6
1601	1601	0	U.S. Geological Survey	8618c64a-93e0-4300-b546-7249e5148ed2	30595b72-0016-42cf-a1b5-afa6a2474cba
1343	1343	0	Biodiversity Information System of Mexico	b324e8e9-9a4c-44fa-8f1a-7f39ea7ab576	30e62381-69e4-423a-9f98-446b9d485b2e
39114	39114	0	Canadensys	4db9cfd2-1191-4b9d-b579-0b68ceabd968	3484c814-c0f1-453c-8501-50d4846c4ba6
778	778	0	Biodiversity Information System of Mexico	b324e8e9-9a4c-44fa-8f1a-7f39ea7ab576	371b5b03-59a5-43d7-9393-68a725797a31
52382	52382	0	Korean Biodiversity Information Facility	e0a1e772-0177-4800-94b4-2d023fe6cdf4	379d0b81-c0b0-418c-8c12-ff48618508a2
0	2336	2336	GBIF Norway	4f829580-180d-46a9-9c87-ed8ec959b545	39df870d-a03d-434a-a30f-c21f82f2bcba
10	10	0	Plazi	ffb07bec-2d10-492d-9c37-361fe0b79427	39e361ca-6e59-4b39-adb5-da590d80d7b9
3	3	0	Plazi	ffb07bec-2d10-492d-9c37-361fe0b79427	3a1f57d6-6cad-4bb9-8fdd-6b2b471bce0c
624	624	0	GBIF Germany	4f6826f2-4ff6-443d-b966-e6913bd24013	3a7d0a6f-e525-4ccc-892e-47008d0e88d2
0	385	385	Ocean Biodiversity Information System	ba0670b9-4186-41e6-8e70-f9cb3065551a	3bf20497-8a22-42ac-ab23-2f87a73422e0
0	2	2	Plazi	ffb07bec-2d10-492d-9c37-361fe0b79427	3c0da4cc-b25b-4140-ab37-fe55d2e958dc
2016	2016	0	National Biodiversity Network	d897a5b9-35ee-4232-94bd-b0bcaac003c2	4122d469-dcf1-4dc3-a71e-d744c03faa4f
531	513	-18	GBIF Germany	4f6826f2-4ff6-443d-b966-e6913bd24013	421ac503-3e1c-40c1-a2e9-329dc4640384
1	1	0	GBIF Germany	4f6826f2-4ff6-443d-b966-e6913bd24013	42f1ad6c-3a0c-11e2-b0ce-00145eb45e9a
2	2	0	Plazi	ffb07bec-2d10-492d-9c37-361fe0b79427	43348302-d8b4-4d64-9d84-037eb7a8dab7
1	1	0	Plazi	ffb07bec-2d10-492d-9c37-361fe0b79427	47c84174-dcf0-4e83-ac17-d3ef70ffb89d
402	402	0	GBIF Germany	4f6826f2-4ff6-443d-b966-e6913bd24013	48b5737f-3be1-4cfd-887e-218070a737f0
3	3	0	Plazi	ffb07bec-2d10-492d-9c37-361fe0b79427	490790ef-a54a-41e7-baed-dfe48ef31f0e
6827	6827	0	GBIF France	da44cd31-5901-4687-a106-6d1c7734ee3a	492b7f54-a7b7-4231-b88e-049f1821c172
0	1	1	Plazi	ffb07bec-2d10-492d-9c37-361fe0b79427	4ac477dd-cf26-46e9-b9fe-207a941b9fb6
0	72	72	Ocean Biodiversity Information System	ba0670b9-4186-41e6-8e70-f9cb3065551a	4b18a2dc-018e-4072-8b68-e47e56e00300
0	2	2	Ocean Biodiversity Information System	ba0670b9-4186-41e6-8e70-f9cb3065551a	4ba4adec-4781-400a-b90d-d1aca39f4bd2
32	32	0	Plazi	ffb07bec-2d10-492d-9c37-361fe0b79427	4bcc184b-3c3c-451a-9eb0-b5df8dfdc1e7
2	2	0	Plazi	ffb07bec-2d10-492d-9c37-361fe0b79427	4fe46134-148e-4e2c-8d2d-88a44c9389cd
5913	5913	0	National Biodiversity Data Centre	422b00b2-6c94-4bb6-976b-c359916efdb8	51e25910-c7b5-11de-b279-e8b0507c4765
48	48	0	Plazi	ffb07bec-2d10-492d-9c37-361fe0b79427	52afca80-dcca-48d9-8094-ef9f9a287dd8
4223	4223	0	GBIF France	da44cd31-5901-4687-a106-6d1c7734ee3a	54ac835c-0259-4ac5-b91b-b5cbc5ac1b08
270	270	0	Atlas of Living Australia	4a6f1b71-969e-4fc5-a693-282b05e1220c	557146f2-4f90-43ad-a2eb-c4f9ace7a2df
4	4	0	Plazi	ffb07bec-2d10-492d-9c37-361fe0b79427	55b135f8-fc32-444b-9b14-796f453ab829
0	15	15	Plazi	ffb07bec-2d10-492d-9c37-361fe0b79427	5ad3ab76-f128-4dd2-af84-04263886518a
1494	1494	0	National Biodiversity Network	d897a5b9-35ee-4232-94bd-b0bcaac003c2	5bef00c7-ccb1-4866-aee0-0d0532538190
0	30	30	Colombian Biodiversity Information System	7e865cba-7c46-417b-ade5-97f2cf5b7be0	5c975aee-7a5a-41ba-8ed1-df019120e1b3
9	9	0	Plazi	ffb07bec-2d10-492d-9c37-361fe0b79427	5f27baf9-51d6-4f07-aee5-4ef450ae3418
5396	5396	0	GBIF Spain	1f94b3ca-9345-4d65-afe2-4bace93aa0fe	5fe81b76-6d2f-4f09-a9e3-301e8e1eb918
342	342	0	GBIF Germany	4f6826f2-4ff6-443d-b966-e6913bd24013	61490c2a-f762-11e1-a439-00145eb45e9a
499	499	0	GBIF France	da44cd31-5901-4687-a106-6d1c7734ee3a	61b49f17-8b36-4fe5-a0fb-f6034a8ee8f7
15	15	0	GBIF Germany	4f6826f2-4ff6-443d-b966-e6913bd24013	623d9de4-f762-11e1-a439-00145eb45e9a
1629	1629	0	GBIF France	da44cd31-5901-4687-a106-6d1c7734ee3a	62a52b1b-42ca-476f-84a0-56a6c0cd5a69
23	23	0	GBIF Germany	4f6826f2-4ff6-443d-b966-e6913bd24013	62ded72c-f762-11e1-a439-00145eb45e9a
18	18	0	GBIF Germany	4f6826f2-4ff6-443d-b966-e6913bd24013	62fc2976-f762-11e1-a439-00145eb45e9a
5	5	0	GBIF Germany	4f6826f2-4ff6-443d-b966-e6913bd24013	6312ae08-f762-11e1-a439-00145eb45e9a
296	296	0	Plazi	ffb07bec-2d10-492d-9c37-361fe0b79427	65d2201e-d125-43e7-8b9a-2c3dcb161bc2
0	288	288	Ocean Biodiversity Information System	ba0670b9-4186-41e6-8e70-f9cb3065551a	65e64799-85e3-4467-af5b-ee4812d5cfc3
222	222	0	GBIF Germany	4f6826f2-4ff6-443d-b966-e6913bd24013	664c1d70-f762-11e1-a439-00145eb45e9a
0	2	2	Plazi	ffb07bec-2d10-492d-9c37-361fe0b79427	66eb0eba-a658-44ef-bbd1-cf4f059ee716
23	23	0	GBIF Togo	c9659a3e-07e9-4fcb-83c6-de8b9009a02e	66fa7f6e-6969-4288-a57c-be68c1c9a87c
58	58	0	GBIF Germany	4f6826f2-4ff6-443d-b966-e6913bd24013	676cf1fc-f762-11e1-a439-00145eb45e9a
165	165	0	GBIF Germany	4f6826f2-4ff6-443d-b966-e6913bd24013	67a4e846-f762-11e1-a439-00145eb45e9a
1468	1468	0	Atlas of Living Australia	4a6f1b71-969e-4fc5-a693-282b05e1220c	6aebb29a-4dcd-41cb-be99-e08865e422d8
18	18	0	GBIF Germany	4f6826f2-4ff6-443d-b966-e6913bd24013	6b17c796-f762-11e1-a439-00145eb45e9a
26	26	0	Plazi	ffb07bec-2d10-492d-9c37-361fe0b79427	6c280343-607d-4ff5-b2ba-1ed24db90c36
40	40	0	GBIF Germany	4f6826f2-4ff6-443d-b966-e6913bd24013	6c821bcc-f762-11e1-a439-00145eb45e9a
35	35	0	GBIF Germany	4f6826f2-4ff6-443d-b966-e6913bd24013	6cd08672-f762-11e1-a439-00145eb45e9a
15899	15899	0	Belgian Biodiversity Platform	fb11cfe1-ebc3-45af-9159-17d9fddbcdac	6d06a6cc-dcb8-49dd-a216-ec79c27a600e
5910	5910	0	GBIF Germany	4f6826f2-4ff6-443d-b966-e6913bd24013	6f7b4128-f762-11e1-a439-00145eb45e9a
2	2	0	Plazi	ffb07bec-2d10-492d-9c37-361fe0b79427	6fa22f8a-2288-414a-b473-16e416b20440
0	2333	2333	Ocean Biodiversity Information System	ba0670b9-4186-41e6-8e70-f9cb3065551a	6fefc72b-8d92-41a9-91bc-8499124521cf
6702	6702	0	National Biodiversity Network	d897a5b9-35ee-4232-94bd-b0bcaac003c2	708d2e20-5349-4912-acc6-001413cce733
601	601	0	GBIF Germany	4f6826f2-4ff6-443d-b966-e6913bd24013	714f5cd2-f762-11e1-a439-00145eb45e9a
4	4	0	Plazi	ffb07bec-2d10-492d-9c37-361fe0b79427	716afd95-102f-4e64-b2ba-b320501eeae6
50	50	0	GBIF Germany	4f6826f2-4ff6-443d-b966-e6913bd24013	71c10620-f762-11e1-a439-00145eb45e9a
0	100	100	GBIF Japan	db5705aa-6a6e-42f1-8942-d77b9f4896ea	71ca29e1-c6fb-4cc2-bb3a-46c522480068
365	365	0	Plazi	ffb07bec-2d10-492d-9c37-361fe0b79427	73cc6f7d-b3ec-40c5-adc7-52b9e0cbf236
74	74	0	GBIF Germany	4f6826f2-4ff6-443d-b966-e6913bd24013	74cfc022-f762-11e1-a439-00145eb45e9a
118	118	0	GBIF Germany	4f6826f2-4ff6-443d-b966-e6913bd24013	75668534-f762-11e1-a439-00145eb45e9a
881	881	0	Colombian Biodiversity Information System	7e865cba-7c46-417b-ade5-97f2cf5b7be0	75f91e24-9d1a-4514-9418-cb6589131121
147	147	0	Plazi	ffb07bec-2d10-492d-9c37-361fe0b79427	76694b74-35c0-4ea8-bd55-e147908fc238
0	415	415	GBIF France	da44cd31-5901-4687-a106-6d1c7734ee3a	77588508-2730-4da5-a448-dbd5d47ba768
118	211	93	Symbiota Support Hub	612b5a0b-908b-4b4e-b9bf-ca15dfdc94fa	78a151c6-19aa-4840-86a7-6fbd84acccce
35	35	0	Plazi	ffb07bec-2d10-492d-9c37-361fe0b79427	79de0a38-76ac-40cf-8103-0cbd49cdbf60
469	469	0	U.S. Geological Survey	8618c64a-93e0-4300-b546-7249e5148ed2	7a61d089-4616-4006-8c4b-f698a9fcb7a6
5	5	0	Plazi	ffb07bec-2d10-492d-9c37-361fe0b79427	7af2903a-662f-47d7-92d8-e2830594aec0
1222	1222	0	Biodiversity Information System of Mexico	b324e8e9-9a4c-44fa-8f1a-7f39ea7ab576	7f72d65e-f762-11e1-a439-00145eb45e9a
762	762	0	Biodiversity Information System of Mexico	b324e8e9-9a4c-44fa-8f1a-7f39ea7ab576	7ff5d9a0-f762-11e1-a439-00145eb45e9a
16933	16933	0	GBIF Sweden	a0b3be64-6525-4387-ac67-a499950f92e1	8049ee40-0c62-11dd-84cf-b8a03c50a862
1451	1451	0	GBIF Germany	4f6826f2-4ff6-443d-b966-e6913bd24013	81a024c2-f762-11e1-a439-00145eb45e9a
4561	4569	8	GBIF Germany	4f6826f2-4ff6-443d-b966-e6913bd24013	829bd402-f762-11e1-a439-00145eb45e9a
485668	485667	-1	GBIF Switzerland	169eb292-376b-4cc6-8e31-9c2c432de0ad	82afb86e-f762-11e1-a439-00145eb45e9a
190	190	0	GBIF Argentina	2426a871-9feb-40a1-96c6-0c593a76b835	83216388-f762-11e1-a439-00145eb45e9a
333	333	0	GBIF Germany	4f6826f2-4ff6-443d-b966-e6913bd24013	89b2276e-f762-11e1-a439-00145eb45e9a
1067	677	-390	GBIF Germany	4f6826f2-4ff6-443d-b966-e6913bd24013	89cce202-9468-4dcd-9b30-f699d19df671
1786	1786	0	GBIF France	da44cd31-5901-4687-a106-6d1c7734ee3a	89fc269f-ace2-455b-8d3e-7bcb5cbc8d26
356	356	0	GBIF Germany	4f6826f2-4ff6-443d-b966-e6913bd24013	8be2e3b6-f762-11e1-a439-00145eb45e9a
12	8	-4	GBIF Germany	4f6826f2-4ff6-443d-b966-e6913bd24013	8cc56a24-f762-11e1-a439-00145eb45e9a
117	117	0	Participant Node Managers Committee	7f48e0c8-5c96-49ec-b972-30748e339115	8d0f3ad4-df7e-4e7c-9a48-6c275fea3d28
1	1	0	GBIF France	da44cd31-5901-4687-a106-6d1c7734ee3a	8db1b657-1b01-4a50-8d01-9d00516afb19
46	5	-41	GBIF Germany	4f6826f2-4ff6-443d-b966-e6913bd24013	8dc82c36-f762-11e1-a439-00145eb45e9a
750	750	0	GBIF Brazil	cdc9736d-5ff7-4ece-9959-3c744360cdb3	8e0e9330-e1b2-475a-9891-4fa8e5c6f57f
209	138	-71	GBIF Germany	4f6826f2-4ff6-443d-b966-e6913bd24013	8e612774-f762-11e1-a439-00145eb45e9a
2	2	0	GBIF Germany	4f6826f2-4ff6-443d-b966-e6913bd24013	8ee17b86-f762-11e1-a439-00145eb45e9a
139	91	-48	GBIF Germany	4f6826f2-4ff6-443d-b966-e6913bd24013	8f85f10c-f762-11e1-a439-00145eb45e9a
4	4	0	Plazi	ffb07bec-2d10-492d-9c37-361fe0b79427	902380c3-f622-4107-82fc-28f5e081b3d6
1792	1757	-35	GBIF Germany	4f6826f2-4ff6-443d-b966-e6913bd24013	92fd332c-f762-11e1-a439-00145eb45e9a
69736	69736	0	National Biodiversity Network	d897a5b9-35ee-4232-94bd-b0bcaac003c2	93c02d72-d8ac-4396-8522-bd7c8dbbd62d
0	271	271	Belgian Biodiversity Platform	fb11cfe1-ebc3-45af-9159-17d9fddbcdac	93cbeda1-2940-4b68-b003-b6f3850de284
0	5	5	Plazi	ffb07bec-2d10-492d-9c37-361fe0b79427	93e3f459-e385-4090-885f-10a2599643b0
42	42	0	Atlas of Living Australia	4a6f1b71-969e-4fc5-a693-282b05e1220c	94e857d3-74a7-44a3-ab0a-e033aba3986a
26	26	0	Plazi	ffb07bec-2d10-492d-9c37-361fe0b79427	95d9643a-ed68-42cf-a00c-fbaaa113c71f
0	20122	20122	U.S. Geological Survey	8618c64a-93e0-4300-b546-7249e5148ed2	9608a10c-092d-4885-ac17-fa07d4c7cd8d
16818	28299	11481	U.S. Geological Survey	8618c64a-93e0-4300-b546-7249e5148ed2	968dfa3e-3614-4bab-a3b5-e9209bdd6078
3	3	0	Plazi	ffb07bec-2d10-492d-9c37-361fe0b79427	96ee279e-6611-4b0e-9fd4-23ca3e63ecb7
0	23	23	Plazi	ffb07bec-2d10-492d-9c37-361fe0b79427	979eb438-a6b7-4019-93dd-d4c8f50c578d
1272	1272	0	DanBIF - Danish Biodiversity Information Facility	4ddd294f-02b7-4359-ac33-0806a9ca9c6b	97ecd32a-2b5c-408f-8f7d-cae9effaa172
192	192	0	Plazi	ffb07bec-2d10-492d-9c37-361fe0b79427	98c3ec1f-1711-4f1d-acb6-1702ad46ddfb
58	126	68	U.S. Geological Survey	8618c64a-93e0-4300-b546-7249e5148ed2	997fd207-009e-4387-a4ed-967a01637a72
0	2	2	Plazi	ffb07bec-2d10-492d-9c37-361fe0b79427	9987668e-bf8a-427e-a5af-d2b9d73a0536
232	232	0	GBIF France	da44cd31-5901-4687-a106-6d1c7734ee3a	9d076bc7-b1d9-45af-ac6a-65a8f29eaf01
123	123	0	Plazi	ffb07bec-2d10-492d-9c37-361fe0b79427	9d39c188-a6d7-4958-996d-d1da123e0bca
0	61	61	Participant Node Managers Committee	7f48e0c8-5c96-49ec-b972-30748e339115	9dc693fc-969b-405c-98ef-cb75cc547816
4909	4931	22	GBIF Brazil	cdc9736d-5ff7-4ece-9959-3c744360cdb3	a08cd2a4-5458-4d08-a820-23db24e2219d
1012	1012	0	GBIF France	da44cd31-5901-4687-a106-6d1c7734ee3a	a2e707d2-bbbe-4a06-8e02-732d0b070694
0	626	626	Plazi	ffb07bec-2d10-492d-9c37-361fe0b79427	a4126ee5-4b17-474c-b96a-fa4662e0c653
0	2	2	Plazi	ffb07bec-2d10-492d-9c37-361fe0b79427	a469e82f-9507-4f13-8589-a79a675dd59a
0	55	55	Plazi	ffb07bec-2d10-492d-9c37-361fe0b79427	a611c37d-168e-4488-9a85-046906f7f128
100	100	0	Belgian Biodiversity Platform	fb11cfe1-ebc3-45af-9159-17d9fddbcdac	a6192000-74f3-47d5-89cf-ac39cc6eac00
6518294	6518294	0	National Biodiversity Network	d897a5b9-35ee-4232-94bd-b0bcaac003c2	a86201a4-fa20-44e5-ade2-68ea3563cfa8
43	35	-8	GBIF Germany	4f6826f2-4ff6-443d-b966-e6913bd24013	aa418f96-a023-4b79-9d1f-bdab67f85725
120	120	0	GBIF Malawi	2a42e4d7-ad4a-41b3-84c4-de4aa7b74d35	aafc612c-53f0-4b74-ac06-5c5b96fcb342
21346	21346	0	U.S. Geological Survey	8618c64a-93e0-4300-b546-7249e5148ed2	ab8c6591-2993-4bc5-85a4-1d106897b036
0	11	11	Plazi	ffb07bec-2d10-492d-9c37-361fe0b79427	ad638f80-6074-4f35-8ab9-a0a4d3c0223b
25585	25585	0	GBIF Brazil	cdc9736d-5ff7-4ece-9959-3c744360cdb3	aeb4640c-e649-43b9-bf5c-dc9c6ec7540e
1	1	0	Plazi	ffb07bec-2d10-492d-9c37-361fe0b79427	afdf3bcc-1e1b-47dc-8fb2-45f5977425a7
0	6	6	Plazi	ffb07bec-2d10-492d-9c37-361fe0b79427	b0ce3753-6c1f-4853-b5da-99f9e5880de8
4379	4379	0	Participant Node Managers Committee	7f48e0c8-5c96-49ec-b972-30748e339115	b4a598ea-a13c-4250-bd0f-9d60ab5ada21
2	2	0	Plazi	ffb07bec-2d10-492d-9c37-361fe0b79427	b5bf56bd-4838-4677-9e33-15e6ad2208e8
2	2	0	Plazi	ffb07bec-2d10-492d-9c37-361fe0b79427	b84b1794-e082-40ba-9378-67ba33bf6e7a
8	8	0	Plazi	ffb07bec-2d10-492d-9c37-361fe0b79427	b8546f1e-9186-421c-a535-5342fd7fe0d4
110	110	0	Plazi	ffb07bec-2d10-492d-9c37-361fe0b79427	bcac9edf-0811-4d26-88d5-b4210f137fa4
13	13	0	GBIF Argentina	2426a871-9feb-40a1-96c6-0c593a76b835	bd5f5dae-4d31-4333-9076-0624cf817f47
29	29	0	Plazi	ffb07bec-2d10-492d-9c37-361fe0b79427	bd955858-6456-46a9-b072-77b30dedcedf
16	16	0	Plazi	ffb07bec-2d10-492d-9c37-361fe0b79427	bf2a3d0f-783b-446c-9664-5622f7d98e58
142	142	0	Biodiversity Information System of Mexico	b324e8e9-9a4c-44fa-8f1a-7f39ea7ab576	c043cf3a-abb9-4039-bf5d-e2ae3a22e245
368	252	-116	GBIF Germany	4f6826f2-4ff6-443d-b966-e6913bd24013	c23ea333-aeea-43ab-a897-ed9a50ee2404
0	5	5	Plazi	ffb07bec-2d10-492d-9c37-361fe0b79427	c4abaeeb-2508-4cf7-b4c1-622438529cc8
31492	31492	0	National Biodiversity Network	d897a5b9-35ee-4232-94bd-b0bcaac003c2	c5093f9a-42c3-4723-bf19-a1ac9b6b43fd
236	236	0	GBIF France	da44cd31-5901-4687-a106-6d1c7734ee3a	c6bd3559-6b1e-41d5-b981-890124094ba3
0	13	13	Plazi	ffb07bec-2d10-492d-9c37-361fe0b79427	c737189c-925e-4820-9f4b-e0f323fdb88d
10	10	0	Plazi	ffb07bec-2d10-492d-9c37-361fe0b79427	c7579c32-46c4-4a34-86ee-cd06de94a790
8	8	0	Plazi	ffb07bec-2d10-492d-9c37-361fe0b79427	cb8a8038-f5a4-4803-a5fa-dba5f11f15d2
0	1	1	Plazi	ffb07bec-2d10-492d-9c37-361fe0b79427	cf11f1e1-6f4f-4039-8870-e4ae135be4c7
0	10	10	Plazi	ffb07bec-2d10-492d-9c37-361fe0b79427	cf98fdf3-084f-4c51-97ce-3e24b03214e3
15	15	0	Colombian Biodiversity Information System	7e865cba-7c46-417b-ade5-97f2cf5b7be0	d091e226-b051-4539-a7b7-b452a996d8ea
84	84	0	Plazi	ffb07bec-2d10-492d-9c37-361fe0b79427	d20f0d8c-0592-40d4-94dd-6d9ec60dfe49
5	5	0	Plazi	ffb07bec-2d10-492d-9c37-361fe0b79427	d42122ff-34b6-4674-8e54-a201d9416d31
7	7	0	Plazi	ffb07bec-2d10-492d-9c37-361fe0b79427	d93b19d0-7f75-4fee-8cd3-6bb668651d09
70	70	0	GBIF Malawi	2a42e4d7-ad4a-41b3-84c4-de4aa7b74d35	da39fadf-94c9-4d9d-ba65-64750b58cfe7
1476	1476	0	GBIF France	da44cd31-5901-4687-a106-6d1c7734ee3a	db352498-98f4-4bc2-8bd9-26234ac48659
94	94	0	GBIF France	da44cd31-5901-4687-a106-6d1c7734ee3a	db912644-7599-46dd-813c-313b1280e1c7
77	77	0	Plazi	ffb07bec-2d10-492d-9c37-361fe0b79427	dc4bff3d-fef9-4fe7-83b1-e6bdee157171
96212	140212	44000	GBIF Japan	db5705aa-6a6e-42f1-8942-d77b9f4896ea	ddc02a7f-f5f1-4477-a23a-bc430a919d96
8	8	0	Plazi	ffb07bec-2d10-492d-9c37-361fe0b79427	ddcd964a-2f70-429f-a40d-b101be25258f
6954	6954	0	Korean Biodiversity Information Facility	e0a1e772-0177-4800-94b4-2d023fe6cdf4	dde7e62b-68eb-4a3c-b3d4-f7e4c1cf094a
0	1	1	Plazi	ffb07bec-2d10-492d-9c37-361fe0b79427	de86726c-229f-4a3e-bbb1-666cbf31369c
9176	9176	0	GBIF France	da44cd31-5901-4687-a106-6d1c7734ee3a	e01e80c4-840d-4e9f-827d-93aee429a124
0	3	3	Participant Node Managers Committee	7f48e0c8-5c96-49ec-b972-30748e339115	e2a43116-ac47-4999-bd7f-bfcbf0adeeab
964535	976027	11492	GBIF Norway	4f829580-180d-46a9-9c87-ed8ec959b545	e45c7d91-81c6-4455-86e3-2965a5739b1f
112	112	0	GBIF France	da44cd31-5901-4687-a106-6d1c7734ee3a	e749d175-4316-401b-9ab9-dff532a75152
0	28	28	Plazi	ffb07bec-2d10-492d-9c37-361fe0b79427	e9209457-8375-4bf1-91bb-266a8f267d76
1009	1009	0	National Biodiversity Network	d897a5b9-35ee-4232-94bd-b0bcaac003c2	eae38629-36a2-4e42-9b56-4aacfe550e8a
1	1	0	Plazi	ffb07bec-2d10-492d-9c37-361fe0b79427	eb71817d-d7af-46d3-a093-1ef1cac43d39
90	90	0	Belgian Biodiversity Platform	fb11cfe1-ebc3-45af-9159-17d9fddbcdac	eb97c199-0555-4da2-94e4-e9d6182d3944
0	7	7	Ocean Biodiversity Information System	ba0670b9-4186-41e6-8e70-f9cb3065551a	ed225424-f520-4e58-9ff9-a09edb601e78
1860	1860	0	GBIF France	da44cd31-5901-4687-a106-6d1c7734ee3a	ed524224-4cd7-4310-8f46-e434ae8d3b32
11	11	0	Plazi	ffb07bec-2d10-492d-9c37-361fe0b79427	ede321ae-5659-48a5-884e-4e54249d9250
6021	6021	0	Colombian Biodiversity Information System	7e865cba-7c46-417b-ade5-97f2cf5b7be0	eeb5c147-8c1d-491f-b1a8-e94491b571e4
5	5	0	Plazi	ffb07bec-2d10-492d-9c37-361fe0b79427	ef5dd783-13c1-4c93-94bb-7450c208a901
717	717	0	Netherlands Biodiversity Information Facility	0909d601-bda2-42df-9e63-a6d51847ebce	f4ac246f-8185-4b57-90e3-307d8962103c
174	174	0	Plazi	ffb07bec-2d10-492d-9c37-361fe0b79427	f530d842-6e03-4335-941c-f14930921041
16445	16443	-2	Netherlands Biodiversity Information Facility	0909d601-bda2-42df-9e63-a6d51847ebce	f598ca19-7c37-47e4-9a64-bcfe526847c1
3133	3133	0	Colombian Biodiversity Information System	7e865cba-7c46-417b-ade5-97f2cf5b7be0	f66b4f25-909e-4b1e-a030-f7f2dba764ae
4	4	0	Plazi	ffb07bec-2d10-492d-9c37-361fe0b79427	f6ab5d22-42cb-4453-a2ec-a2719ebe2805
3	3	0	Plazi	ffb07bec-2d10-492d-9c37-361fe0b79427	f998a746-73a0-42cf-8d27-c747bacd94ce
0	1	1	Plazi	ffb07bec-2d10-492d-9c37-361fe0b79427	f9c1ecb6-dab8-4cdd-b628-ca01a0d4bed7
15	15	0	Participant Node Managers Committee	7f48e0c8-5c96-49ec-b972-30748e339115	fab310e8-fe27-454c-803c-ead56c22849f
0	38	38	Plazi	ffb07bec-2d10-492d-9c37-361fe0b79427	fc5e1c06-bd6a-4219-b0f8-7db7c7150625
472036	472036	0	U.S. Geological Survey	8618c64a-93e0-4300-b546-7249e5148ed2	fe388907-e2b6-44be-a9cb-a80b3924284c
15	15	0	Plazi	ffb07bec-2d10-492d-9c37-361fe0b79427	fe944f68-7821-4adb-a603-9397b2cb8b68
1242	1242	0	U.S. Geological Survey	8618c64a-93e0-4300-b546-7249e5148ed2	ff2e788b-963a-4be8-8f96-d432d397ecbd
8367	8559	192	GBIF Brazil	cdc9736d-5ff7-4ece-9959-3c744360cdb3	03929cfc-82e3-4f21-97e3-7be4de285584
0	5	5	Plazi	ffb07bec-2d10-492d-9c37-361fe0b79427	07abd153-3d09-4820-82dd-6991f1d14ced
144	144	0	GBIF Benin	efb9c00e-f802-45dd-8826-a52ec45b89ff	0a6b5466-6d9c-4b9b-a8d4-0c4fb3a14a0f
1	1	0	GBIF France	da44cd31-5901-4687-a106-6d1c7734ee3a	0b60bb85-a79a-4c02-bc74-ea0521f18b81
8	8	0	Plazi	ffb07bec-2d10-492d-9c37-361fe0b79427	0e85d75b-0ca8-448d-8e6b-6a2f18dbf415
212	212	0	Colombian Biodiversity Information System	7e865cba-7c46-417b-ade5-97f2cf5b7be0	0fca9cb2-caaa-499d-bf3d-8920c69a3a35
9	9	0	Plazi	ffb07bec-2d10-492d-9c37-361fe0b79427	0fea0081-d093-4611-89c2-316f9baf6ca4
4028	4028	0	GBIF France	da44cd31-5901-4687-a106-6d1c7734ee3a	124129be-8d5e-4694-b1ae-32e84976f6d2
6	6	0	Plazi	ffb07bec-2d10-492d-9c37-361fe0b79427	1393a7bd-6860-4916-96f0-593ecbe197f7
105	105	0	Plazi	ffb07bec-2d10-492d-9c37-361fe0b79427	15125516-1daf-45a8-a9d1-0aa68e83b762
25	25	0	GBIF France	da44cd31-5901-4687-a106-6d1c7734ee3a	1540f680-ea7e-42ca-bf28-d64728969efa
0	371	371	Ocean Biodiversity Information System	ba0670b9-4186-41e6-8e70-f9cb3065551a	17b9db0a-2f7e-4511-b6ec-ea04894fd75e
0	351	351	Plazi	ffb07bec-2d10-492d-9c37-361fe0b79427	18306272-d3ad-494e-a630-cf9f40132d2f
207976	207974	-2	South African Biodiversity Information Facility	7190b835-4e86-4b6e-85c1-19cc6677c250	1aaec653-c71c-4695-9b6e-0e26214dd817
5	5	0	Plazi	ffb07bec-2d10-492d-9c37-361fe0b79427	1b0d1341-ec3e-41b5-ad09-ab3cc33f0a4e
3446	3446	0	Colombian Biodiversity Information System	7e865cba-7c46-417b-ade5-97f2cf5b7be0	1e28ee35-6fd8-4b6d-b7cf-6b01272c212f
2599	2599	0	Belgian Biodiversity Platform	fb11cfe1-ebc3-45af-9159-17d9fddbcdac	21537d4b-c5cb-46f2-ad1e-3247ade79cc4
28859	28859	0	Colombian Biodiversity Information System	7e865cba-7c46-417b-ade5-97f2cf5b7be0	224bb9c2-4426-4d4d-ac9c-38758b5d938f
292	292	0	Plazi	ffb07bec-2d10-492d-9c37-361fe0b79427	22ec14b4-267f-49d1-817a-48cef762eec7
37445	37445	0	National Biodiversity Network	d897a5b9-35ee-4232-94bd-b0bcaac003c2	26d3025e-9b4a-4245-958f-116bb89718c0
0	1	1	Plazi	ffb07bec-2d10-492d-9c37-361fe0b79427	26dab9d0-3310-4971-9e47-ee32eb2431e0
1962	1962	0	GBIF France	da44cd31-5901-4687-a106-6d1c7734ee3a	285a83aa-7b54-4da5-be2b-66eba069b8a1
3605	3605	0	GBIF Finland	dd514216-5c7c-45f3-910d-797424cb5be6	307ddcff-6195-4f43-8f49-515ccca112a7
10	10	0	GBIF France	da44cd31-5901-4687-a106-6d1c7734ee3a	32288bee-fc04-4d05-b1c5-68bf46f04e99
1207	1207	0	National Biodiversity Network	d897a5b9-35ee-4232-94bd-b0bcaac003c2	32d69eb3-7b83-4e9e-bfc7-60d0fdaec7d5
0	2	2	Taiwan Biodiversity Information Facility	e1b85abc-61f9-430f-ba79-6813dec53a0f	36b9cb37-ff9b-4fe4-971c-04ee151ff8ab
22127	22127	0	GBIF France	da44cd31-5901-4687-a106-6d1c7734ee3a	374645a1-0980-46bd-b7ef-a23b767c0f72
169	169	0	GBIF Norway	4f829580-180d-46a9-9c87-ed8ec959b545	3857eeba-8504-412f-a3f1-79a76b2fb472
0	1	1	Plazi	ffb07bec-2d10-492d-9c37-361fe0b79427	3983e3ad-7d0b-4566-9466-f843f945c85b
20374	20374	0	GBIF New Zealand	4f9fd726-20dd-445e-89a1-8ed93792276f	3b63eb62-1080-49f1-bf60-8beb6fa16994
0	3	3	Plazi	ffb07bec-2d10-492d-9c37-361fe0b79427	3bf87428-0476-429e-821f-ff1e342ccc8b
724093	724144	51	National Biodiversity Network	d897a5b9-35ee-4232-94bd-b0bcaac003c2	3dc2a7f6-8d3a-4228-a69c-ec795028fe2f
384	384	0	GBIF Germany	4f6826f2-4ff6-443d-b966-e6913bd24013	3f82e94e-641c-498b-9bbb-81edd6d00668
2096	2096	0	GBIF France	da44cd31-5901-4687-a106-6d1c7734ee3a	44d1aea2-0b02-4077-91e2-6f85a8f0e382
14	14	0	National Biodiversity Network	d897a5b9-35ee-4232-94bd-b0bcaac003c2	451c805c-ca8a-479b-848d-172db959510f
34	34	0	National Biodiversity Network	d897a5b9-35ee-4232-94bd-b0bcaac003c2	4586e967-161c-4c50-b6fe-ff877203ddab
385	385	0	GBIF Argentina	2426a871-9feb-40a1-96c6-0c593a76b835	481959b6-d8c2-4b8c-8f40-853d24fe1a04
45	45	0	Colombian Biodiversity Information System	7e865cba-7c46-417b-ade5-97f2cf5b7be0	48b67072-8da1-4ad1-b187-5eb62acc91fe
479864	479864	0	National Biodiversity Network	d897a5b9-35ee-4232-94bd-b0bcaac003c2	4a2b864b-f3b8-4964-8147-c28e7f73499e
46736	46736	0	Atlas of Living Australia	4a6f1b71-969e-4fc5-a693-282b05e1220c	4a649a98-1fb7-4b5a-8d4d-bb16e4a181f4
111	111	0	Participant Node Managers Committee	7f48e0c8-5c96-49ec-b972-30748e339115	4aab2c9b-f6cf-48bd-9e0d-fa3d53a33d1b
68	68	0	Plazi	ffb07bec-2d10-492d-9c37-361fe0b79427	4ca96835-76d5-4786-a3b6-7481d57e2144
147524	147524	0	GBIF New Zealand	4f9fd726-20dd-445e-89a1-8ed93792276f	4d0b1b2a-3209-49ce-bb93-7503e4868019
15806	15806	0	GBIF Japan	db5705aa-6a6e-42f1-8942-d77b9f4896ea	4e287c72-c3f3-492c-ba43-d0fe8a97bba1
8170	8170	0	Biodiversity Information System of Mexico	b324e8e9-9a4c-44fa-8f1a-7f39ea7ab576	4ec633b0-8b1f-405e-86cf-7f782a3ced53
5383	5428	45	Taiwan Biodiversity Information Facility	e1b85abc-61f9-430f-ba79-6813dec53a0f	52440bd0-bd7a-419f-b244-2531dc1bedba
51651	51651	0	National Biodiversity Network	d897a5b9-35ee-4232-94bd-b0bcaac003c2	5354a456-bb38-44ea-a8af-e46652440d5c
40007	40007	0	U.S. Geological Survey	8618c64a-93e0-4300-b546-7249e5148ed2	54d3923a-0c5a-43c5-998d-149412e41ed1
0	3	3	Plazi	ffb07bec-2d10-492d-9c37-361fe0b79427	56cfe255-4cdb-4bfc-9da9-b14c1ce2cfc3
5	5	0	Plazi	ffb07bec-2d10-492d-9c37-361fe0b79427	5715bd15-7192-40f2-8248-109345e5519c
0	2	2	Plazi	ffb07bec-2d10-492d-9c37-361fe0b79427	577de983-52ae-477a-a4bf-ee8315db6d83
4	4	0	Plazi	ffb07bec-2d10-492d-9c37-361fe0b79427	59741896-2be9-4bf8-9d81-b5621375357b
172	172	0	GBIF Germany	4f6826f2-4ff6-443d-b966-e6913bd24013	62553bfc-f762-11e1-a439-00145eb45e9a
1493	1342	-151	GBIF Germany	4f6826f2-4ff6-443d-b966-e6913bd24013	6378a613-8eaa-4f06-9110-19124298575b
4396	4396	0	National Biodiversity Network	d897a5b9-35ee-4232-94bd-b0bcaac003c2	63d72d96-6252-45fb-a213-db04c499103d
54	54	0	GBIF Germany	4f6826f2-4ff6-443d-b966-e6913bd24013	6416f084-f762-11e1-a439-00145eb45e9a
3	3	0	Plazi	ffb07bec-2d10-492d-9c37-361fe0b79427	643cdd97-805c-4dec-82c2-83d0047c7248
28	28	0	GBIF Germany	4f6826f2-4ff6-443d-b966-e6913bd24013	64dbfbe0-f762-11e1-a439-00145eb45e9a
17	12	-5	GBIF Germany	4f6826f2-4ff6-443d-b966-e6913bd24013	64ea3a02-f762-11e1-a439-00145eb45e9a
0	3	3	Plazi	ffb07bec-2d10-492d-9c37-361fe0b79427	665f7174-0aac-4a32-89b0-de865e2f42ae
1	1	0	Canada Biodiversity Information Facility	8f83fc96-c966-4126-83f7-bf044dc49efa	66a446cd-2808-4a66-8b2a-a7697b0331dc
1	1	0	Plazi	ffb07bec-2d10-492d-9c37-361fe0b79427	66a62f49-5e0c-4b7a-a503-0f1456b33174
126	126	0	GBIF Germany	4f6826f2-4ff6-443d-b966-e6913bd24013	67996854-f762-11e1-a439-00145eb45e9a
38	38	0	GBIF Germany	4f6826f2-4ff6-443d-b966-e6913bd24013	67d2821a-f762-11e1-a439-00145eb45e9a
122	122	0	GBIF Germany	4f6826f2-4ff6-443d-b966-e6913bd24013	683ea72e-f762-11e1-a439-00145eb45e9a
65535	65535	0	Canada Biodiversity Information Facility	8f83fc96-c966-4126-83f7-bf044dc49efa	68829f71-56b1-4015-a363-ef8f0e1d6e4f
122	122	0	GBIF Germany	4f6826f2-4ff6-443d-b966-e6913bd24013	68904f52-f762-11e1-a439-00145eb45e9a
25	25	0	GBIF Germany	4f6826f2-4ff6-443d-b966-e6913bd24013	68ec02ca-f762-11e1-a439-00145eb45e9a
123599	123599	0	National Biodiversity Network	d897a5b9-35ee-4232-94bd-b0bcaac003c2	68fa8801-0b3e-400e-afa6-5ad08e0f1e4c
222	222	0	GBIF Germany	4f6826f2-4ff6-443d-b966-e6913bd24013	6966acf0-f762-11e1-a439-00145eb45e9a
16	16	0	GBIF Germany	4f6826f2-4ff6-443d-b966-e6913bd24013	6af434ca-f762-11e1-a439-00145eb45e9a
18	18	0	GBIF Germany	4f6826f2-4ff6-443d-b966-e6913bd24013	6b8235a4-f762-11e1-a439-00145eb45e9a
0	63	63	Ocean Biodiversity Information System	ba0670b9-4186-41e6-8e70-f9cb3065551a	6d1603da-e93a-4165-ba0a-34fe6ec131ca
49	49	0	GBIF Germany	4f6826f2-4ff6-443d-b966-e6913bd24013	6d4817aa-f762-11e1-a439-00145eb45e9a
11	11	0	Plazi	ffb07bec-2d10-492d-9c37-361fe0b79427	6e5cb38f-f9df-4bcf-864f-c198be591396
42	42	0	GBIF France	da44cd31-5901-4687-a106-6d1c7734ee3a	6e728fd8-7a02-4b1b-b49b-c6a9902be98c
3	3	0	Plazi	ffb07bec-2d10-492d-9c37-361fe0b79427	6ef78c36-6f83-41ab-90ab-a1ce368ca7bb
7	7	0	GBIF Germany	4f6826f2-4ff6-443d-b966-e6913bd24013	6f8e0510-f762-11e1-a439-00145eb45e9a
6	6	0	Plazi	ffb07bec-2d10-492d-9c37-361fe0b79427	6ffbbdb0-5acc-4333-a3f1-50129a629849
126	126	0	GBIF Germany	4f6826f2-4ff6-443d-b966-e6913bd24013	70ed5cd0-f762-11e1-a439-00145eb45e9a
258	258	0	GBIF Germany	4f6826f2-4ff6-443d-b966-e6913bd24013	72737814-f762-11e1-a439-00145eb45e9a
3	3	0	GBIF Germany	4f6826f2-4ff6-443d-b966-e6913bd24013	737640a2-f762-11e1-a439-00145eb45e9a
360	360	0	GBIF Germany	4f6826f2-4ff6-443d-b966-e6913bd24013	75ab5d76-f762-11e1-a439-00145eb45e9a
0	7	7	Plazi	ffb07bec-2d10-492d-9c37-361fe0b79427	784cadb6-9971-4d92-beed-92e6413a5080
0	66	66	Plazi	ffb07bec-2d10-492d-9c37-361fe0b79427	78e78beb-b1ed-43a4-84c7-8180e61463c5
543	430	-113	GBIF Germany	4f6826f2-4ff6-443d-b966-e6913bd24013	79b6d990-f762-11e1-a439-00145eb45e9a
13459	13459	0	Korean Biodiversity Information Facility	e0a1e772-0177-4800-94b4-2d023fe6cdf4	7af960d4-f762-11e1-a439-00145eb45e9a
405	405	0	GBIF Germany	4f6826f2-4ff6-443d-b966-e6913bd24013	7bcff0b8-f762-11e1-a439-00145eb45e9a
1000	1000	0	GBIF Sweden	a0b3be64-6525-4387-ac67-a499950f92e1	7c2d6468-1baf-4a23-8c89-09819291290b
260	257	-3	GBIF Germany	4f6826f2-4ff6-443d-b966-e6913bd24013	7d4dcbe0-f762-11e1-a439-00145eb45e9a
68	68	0	GBIF Germany	4f6826f2-4ff6-443d-b966-e6913bd24013	7da90b90-f762-11e1-a439-00145eb45e9a
2775	2775	0	GBIF Spain	1f94b3ca-9345-4d65-afe2-4bace93aa0fe	7e2c0bb2-f762-11e1-a439-00145eb45e9a
0	19	19	Plazi	ffb07bec-2d10-492d-9c37-361fe0b79427	7ef89490-4bc5-4f28-ab75-f2da7ae1f9c9
10026	10026	0	GBIF Spain	1f94b3ca-9345-4d65-afe2-4bace93aa0fe	7f2889e6-f762-11e1-a439-00145eb45e9a
500	500	0	Biodiversity Information System of Mexico	b324e8e9-9a4c-44fa-8f1a-7f39ea7ab576	7ff98104-f762-11e1-a439-00145eb45e9a
1	1	0	Plazi	ffb07bec-2d10-492d-9c37-361fe0b79427	81596dbf-2206-41f5-849e-0963b320ec18
156	156	0	GBIF Brazil	cdc9736d-5ff7-4ece-9959-3c744360cdb3	828eb535-5ef8-4934-86b5-57600efb874c
12	12	0	Plazi	ffb07bec-2d10-492d-9c37-361fe0b79427	834234e8-ac96-4b19-a30e-3edc31fe4897
15886	15886	0	GBIF Japan	db5705aa-6a6e-42f1-8942-d77b9f4896ea	84968040-f762-11e1-a439-00145eb45e9a
52	52	0	Participant Node Managers Committee	7f48e0c8-5c96-49ec-b972-30748e339115	84cb41cc-5045-4f65-be0f-b5500c5cf56a
17	17	0	Plazi	ffb07bec-2d10-492d-9c37-361fe0b79427	850f37bf-277f-4458-9f2a-e486d999d8e5
3	3	0	Plazi	ffb07bec-2d10-492d-9c37-361fe0b79427	858c18ba-7102-45f6-8d80-6b3f8f157171
83376	83376	0	GBIF Spain	1f94b3ca-9345-4d65-afe2-4bace93aa0fe	85b2fcd8-f762-11e1-a439-00145eb45e9a
1070	1070	0	Biodiversity Information System of Mexico	b324e8e9-9a4c-44fa-8f1a-7f39ea7ab576	85ba34ee-f762-11e1-a439-00145eb45e9a
269	229	-40	GBIF Germany	4f6826f2-4ff6-443d-b966-e6913bd24013	86e0c360-f762-11e1-a439-00145eb45e9a
178	81	-97	GBIF Germany	4f6826f2-4ff6-443d-b966-e6913bd24013	87387d4e-f762-11e1-a439-00145eb45e9a
2	2	0	GBIF Germany	4f6826f2-4ff6-443d-b966-e6913bd24013	87a354a2-f762-11e1-a439-00145eb45e9a
3948	3508	-440	GBIF Germany	4f6826f2-4ff6-443d-b966-e6913bd24013	88c6d58e-f762-11e1-a439-00145eb45e9a
40	40	0	Plazi	ffb07bec-2d10-492d-9c37-361fe0b79427	892b6dcb-f01c-4e8f-95a9-4362f5a4533f
7	7	0	Plazi	ffb07bec-2d10-492d-9c37-361fe0b79427	89a4a893-4099-4440-a980-1b0956caf4e5
452	452	0	GBIF Germany	4f6826f2-4ff6-443d-b966-e6913bd24013	89b3724a-f762-11e1-a439-00145eb45e9a
176	176	0	GBIF Germany	4f6826f2-4ff6-443d-b966-e6913bd24013	8a5b9556-f762-11e1-a439-00145eb45e9a
10	10	0	GBIF Germany	4f6826f2-4ff6-443d-b966-e6913bd24013	8bc8da8e-f762-11e1-a439-00145eb45e9a
1	1	0	Plazi	ffb07bec-2d10-492d-9c37-361fe0b79427	8bf31043-3ab9-421f-97cf-509db7a16c0a
0	7	7	Plazi	ffb07bec-2d10-492d-9c37-361fe0b79427	917a7b0c-caa8-4708-9984-bdb3a552eb74
729	729	0	GBIF France	da44cd31-5901-4687-a106-6d1c7734ee3a	9308a3a3-3c37-4e1a-9b2e-e39ec100cf17
5	5	0	Plazi	ffb07bec-2d10-492d-9c37-361fe0b79427	933ff258-131c-48ad-a199-9943c2c15726
432	432	0	GBIF Germany	4f6826f2-4ff6-443d-b966-e6913bd24013	940fbd20-f762-11e1-a439-00145eb45e9a
120	120	0	GBIF Germany	4f6826f2-4ff6-443d-b966-e6913bd24013	9522a542-f762-11e1-a439-00145eb45e9a
374	374	0	GBIF Germany	4f6826f2-4ff6-443d-b966-e6913bd24013	9546e70e-f762-11e1-a439-00145eb45e9a
302	302	0	GBIF Germany	4f6826f2-4ff6-443d-b966-e6913bd24013	95c27b3a-f762-11e1-a439-00145eb45e9a
2	2	0	Plazi	ffb07bec-2d10-492d-9c37-361fe0b79427	95eae491-0dbc-4934-ba7a-c1dbde815411
7	7	0	GBIF Germany	4f6826f2-4ff6-443d-b966-e6913bd24013	97a80db6-f762-11e1-a439-00145eb45e9a
2826	2590	-236	GBIF Germany	4f6826f2-4ff6-443d-b966-e6913bd24013	97d629a8-f762-11e1-a439-00145eb45e9a
413272	413272	0	Colombian Biodiversity Information System	7e865cba-7c46-417b-ade5-97f2cf5b7be0	9850b85a-793f-429d-a437-2d5b46282acf
0	90	90	Plazi	ffb07bec-2d10-492d-9c37-361fe0b79427	99f6713d-6ef6-4bee-905b-b987df8832d4
26125	26125	0	National Biodiversity Network	d897a5b9-35ee-4232-94bd-b0bcaac003c2	9bbb6370-912b-44bb-a0b3-379e6b69536f
0	3	3	Plazi	ffb07bec-2d10-492d-9c37-361fe0b79427	9bd4bdef-bf8e-4197-8906-ff4aa5b4c427
1000	1000	0	National Biodiversity Data Centre	422b00b2-6c94-4bb6-976b-c359916efdb8	9bd520e3-00fa-4955-a554-924ea440862c
0	2	2	Plazi	ffb07bec-2d10-492d-9c37-361fe0b79427	a01640fc-c795-4927-a632-92b854997dfb
0	32	32	Plazi	ffb07bec-2d10-492d-9c37-361fe0b79427	a0f7d28f-528d-4ba3-b449-6b3a263a3db7
0	84	84	Colombian Biodiversity Information System	7e865cba-7c46-417b-ade5-97f2cf5b7be0	a3876104-196e-46ab-89d9-b666e61a9e66
2324	2316	-8	Biodiversity Information System of Mexico	b324e8e9-9a4c-44fa-8f1a-7f39ea7ab576	a3b38536-39ae-4a63-bc14-54322b03508e
0	7	7	Plazi	ffb07bec-2d10-492d-9c37-361fe0b79427	a6e43a18-39e0-47b3-b003-00d9aa617f1f
43	43	0	GBIF France	da44cd31-5901-4687-a106-6d1c7734ee3a	aab648d1-6910-41db-a074-f768f4d5d408
630	630	0	Indonesian Biodiversity Information Facility	2ebd91f6-f14f-4375-b525-c011a3774f03	ab67e429-389c-43a7-8799-36c67ece82d6
89	89	0	Participant Node Managers Committee	7f48e0c8-5c96-49ec-b972-30748e339115	abd43557-5afd-448a-86cb-8502b368d51b
19039	19039	0	Ocean Biodiversity Information System	ba0670b9-4186-41e6-8e70-f9cb3065551a	ac9bd1d1-4f15-48c3-b259-236930f5f409
2402	2402	0	Biodiversity Information System of Mexico	b324e8e9-9a4c-44fa-8f1a-7f39ea7ab576	ad9da392-a0ae-492f-ad51-24bf0fe1264c
3	3	0	Plazi	ffb07bec-2d10-492d-9c37-361fe0b79427	aead3866-8651-4773-9221-4806a4a0180d
61291	61291	0	GBIF France	da44cd31-5901-4687-a106-6d1c7734ee3a	aec85dc0-9807-4bad-aa4e-aa1e8f0bfeeb
1	1	0	Plazi	ffb07bec-2d10-492d-9c37-361fe0b79427	b04b3a68-19dc-4890-bb54-801afd953f2d
0	2	2	Plazi	ffb07bec-2d10-492d-9c37-361fe0b79427	b2e4e166-7297-45a5-82eb-84937eb7233a
0	1	1	Plazi	ffb07bec-2d10-492d-9c37-361fe0b79427	b78011b1-fffb-478a-b8a7-e3828eaca1f6
20	20	0	GBIF Togo	c9659a3e-07e9-4fcb-83c6-de8b9009a02e	b819f41c-c05b-4b85-8096-c0b76e9b0fef
0	3	3	Plazi	ffb07bec-2d10-492d-9c37-361fe0b79427	b8ff132c-0c49-4bc3-8e80-55d7235036b2
2118	2118	0	Biodiversity Information System of Mexico	b324e8e9-9a4c-44fa-8f1a-7f39ea7ab576	b9e41077-cedf-4371-9c4e-71094880e362
0	111	111	Plazi	ffb07bec-2d10-492d-9c37-361fe0b79427	be63ad31-1163-496b-adc5-4d3d21288fa5
74	74	0	GBIF France	da44cd31-5901-4687-a106-6d1c7734ee3a	bf0444bd-fca1-4988-b5a6-c9fa9f8d6946
0	7	7	Plazi	ffb07bec-2d10-492d-9c37-361fe0b79427	c5eef0b4-efba-40c3-9d16-60736cb07d8d
170192	170192	0	Ocean Biodiversity Information System	ba0670b9-4186-41e6-8e70-f9cb3065551a	c8dd9ab2-7b78-4eac-9958-b7ff958545fe
6	6	0	Plazi	ffb07bec-2d10-492d-9c37-361fe0b79427	c8de0de0-c27b-421c-99c8-59192b077396
0	2	2	Ocean Biodiversity Information System	ba0670b9-4186-41e6-8e70-f9cb3065551a	d2a17a4d-164f-4bf2-95f6-054d5566d545
0	3	3	Plazi	ffb07bec-2d10-492d-9c37-361fe0b79427	d3024194-97e9-4756-982a-b1c22c68a531
6686	6686	0	GBIF Chile	a8b16421-d80b-4ef3-8f22-098b01a89255	d40e93a3-63fe-4c2f-be30-af21d4b66a95
356	356	0	Plazi	ffb07bec-2d10-492d-9c37-361fe0b79427	d7085e10-1649-4f16-94c8-bd15cc188be6
4544	4544	0	National Biodiversity Network	d897a5b9-35ee-4232-94bd-b0bcaac003c2	d734bf6d-1206-4969-bc62-389a6b9bd91f
2445	2445	0	GBIF France	da44cd31-5901-4687-a106-6d1c7734ee3a	d8dbe442-093d-4fea-9fbb-d92cd12202f8
251	2537	2286	Colombian Biodiversity Information System	7e865cba-7c46-417b-ade5-97f2cf5b7be0	dc68ef79-97f5-4984-9dc4-c463c7be5870
0	32	32	Ocean Biodiversity Information System	ba0670b9-4186-41e6-8e70-f9cb3065551a	dcbae7c9-d0a8-4fc5-9243-7c0bd292dd77
38	42	4	U.S. Geological Survey	8618c64a-93e0-4300-b546-7249e5148ed2	dd1b2dbc-1a38-4212-a3d9-893a160da252
237	237	0	National Biodiversity Network	d897a5b9-35ee-4232-94bd-b0bcaac003c2	dd946360-820d-4959-a752-77ed01cdc661
24	24	0	Plazi	ffb07bec-2d10-492d-9c37-361fe0b79427	df828994-5835-4fdc-94e0-dc91decae536
0	4	4	Plazi	ffb07bec-2d10-492d-9c37-361fe0b79427	e12ede0d-6b37-44c2-adcd-dfcaeaf47c99
225	225	0	Albertine Rift Conservation Society	90a939d3-e99c-4f6d-915f-2616423b3735	e2ad3813-19df-4440-b757-e2f861770ae5
4	4	0	Plazi	ffb07bec-2d10-492d-9c37-361fe0b79427	e2b95cee-befa-4185-83ba-6ec3a9be90fb
5	5	0	Plazi	ffb07bec-2d10-492d-9c37-361fe0b79427	e514311d-7b1f-4dbd-8ce3-427a75c4c1e5
15	15	0	Plazi	ffb07bec-2d10-492d-9c37-361fe0b79427	e7c55171-03d5-4714-a0c2-b7e70ab80fce
90	90	0	GBIF France	da44cd31-5901-4687-a106-6d1c7734ee3a	e87404ca-8d9b-4e13-9cf6-8fb0408bb3cf
7	7	0	Plazi	ffb07bec-2d10-492d-9c37-361fe0b79427	e901e52f-3189-4226-bb52-3ffed859d5a5
8066	8066	0	U.S. Geological Survey	8618c64a-93e0-4300-b546-7249e5148ed2	eb6d9c8c-337f-465c-a23e-ef36a1c294ff
0	14750	14750	Belgian Biodiversity Platform	fb11cfe1-ebc3-45af-9159-17d9fddbcdac	ed7234e3-52e2-4b24-a4ad-b806b50d004a
0	11	11	Plazi	ffb07bec-2d10-492d-9c37-361fe0b79427	ede2ef87-5522-4e98-97e5-9b689b99ac73
564	564	0	Ghana Biodiversity Information Facility	b5633b75-6a86-4fdf-9cfc-506047fb9dc7	eeb765d6-8e53-40d7-abe0-bd6c1df83943
14010	14010	0	Atlas of Living Australia	4a6f1b71-969e-4fc5-a693-282b05e1220c	eebc1080-cec1-4d28-a5d3-ba8694114d12
12	12	0	Plazi	ffb07bec-2d10-492d-9c37-361fe0b79427	f1e0543c-796e-4d4c-beeb-97b178149afb
43	43	0	GBIF Germany	4f6826f2-4ff6-443d-b966-e6913bd24013	f2f22654-5bdd-4d10-9965-8844d1323144
1272	1272	0	GBIF New Zealand	4f9fd726-20dd-445e-89a1-8ed93792276f	f31ff742-af4f-45d6-83a4-2eb6302ad5fb
10	10	0	Plazi	ffb07bec-2d10-492d-9c37-361fe0b79427	f34e8838-1bd9-4e29-bca0-93803b036c6b
169	169	0	Ocean Biodiversity Information System	ba0670b9-4186-41e6-8e70-f9cb3065551a	f6637736-f04e-4361-87a0-541e08a8a8d3
2000	2000	0	Colombian Biodiversity Information System	7e865cba-7c46-417b-ade5-97f2cf5b7be0	f8dca385-db58-4887-97e2-690fcfbdf83d
2778	2778	0	Participant Node Managers Committee	7f48e0c8-5c96-49ec-b972-30748e339115	fbb002cb-23a3-45c4-8e07-76f07a385085
0	2	2	Plazi	ffb07bec-2d10-492d-9c37-361fe0b79427	fc241e61-0b2e-46c7-a38d-9063f06f1619
0	11	11	Plazi	ffb07bec-2d10-492d-9c37-361fe0b79427	fe076526-b526-4196-9d05-87bc2cd36688
371	283	-88	GBIF Germany	4f6826f2-4ff6-443d-b966-e6913bd24013	fefcc9a5-003a-438d-8c20-da07b7572fe9
0	1	1	Plazi	ffb07bec-2d10-492d-9c37-361fe0b79427	04f237ad-c518-4e54-8b24-debfdc20c7d3
115	115	0	U.S. Geological Survey	8618c64a-93e0-4300-b546-7249e5148ed2	06e71d9d-52b6-4ac1-b51a-e5833f967ead
34	34	0	Plazi	ffb07bec-2d10-492d-9c37-361fe0b79427	07d6f722-2745-4973-b0ec-6a0007463103
6	6	0	Plazi	ffb07bec-2d10-492d-9c37-361fe0b79427	080ae825-3d28-4911-a718-e961381e7fc9
1533	1533	0	National Biodiversity Network	d897a5b9-35ee-4232-94bd-b0bcaac003c2	0c956a2f-9849-4a12-adcf-afc5dd17eae8
0	160	160	DanBIF - Danish Biodiversity Information Facility	4ddd294f-02b7-4359-ac33-0806a9ca9c6b	10084c96-2a38-4734-9d50-f1e7ef546d0c
1	1	0	Plazi	ffb07bec-2d10-492d-9c37-361fe0b79427	12e2a571-e95e-4e69-8987-b9ce4fdc3b6b
9	9	0	Plazi	ffb07bec-2d10-492d-9c37-361fe0b79427	1853eb76-c3dd-4849-b76d-53d416397efe
4	4	0	Plazi	ffb07bec-2d10-492d-9c37-361fe0b79427	192e8f24-1707-4f0a-851a-4e736c78292d
0	3	3	Plazi	ffb07bec-2d10-492d-9c37-361fe0b79427	1bd8ff5c-3eb0-47ba-8ed5-dc3deca76c18
0	3	3	Plazi	ffb07bec-2d10-492d-9c37-361fe0b79427	1c3b88e8-5b57-422e-b030-ebbe65c9b246
0	29	29	Plazi	ffb07bec-2d10-492d-9c37-361fe0b79427	1f030224-441b-494e-8a85-4cc4335d3ce6
9221	9221	0	Biodiversity Information System of Mexico	b324e8e9-9a4c-44fa-8f1a-7f39ea7ab576	1f031b8b-839f-42a6-a745-08952a4782a2
0	1	1	Plazi	ffb07bec-2d10-492d-9c37-361fe0b79427	1f12fbab-fad7-42ac-9ada-90817226a39c
63	63	0	GBIF France	da44cd31-5901-4687-a106-6d1c7734ee3a	1f839433-15c1-4c8e-be27-edb7b74340b9
0	12	12	Plazi	ffb07bec-2d10-492d-9c37-361fe0b79427	21e17d7f-23fe-4244-bb55-736a89096f28
2	2	0	Plazi	ffb07bec-2d10-492d-9c37-361fe0b79427	25b9e4f9-f713-41c4-a515-8725328db6b7
5917	5917	0	National Biodiversity Network	d897a5b9-35ee-4232-94bd-b0bcaac003c2	29ca636d-af3a-4413-a7c8-ed7fd3f4645e
887	887	0	Colombian Biodiversity Information System	7e865cba-7c46-417b-ade5-97f2cf5b7be0	2bb4362e-167a-4169-a680-d0d6a547df3a
100	100	0	DanBIF - Danish Biodiversity Information Facility	4ddd294f-02b7-4359-ac33-0806a9ca9c6b	2bfb03a5-02e7-43bc-aaee-0bb82e5d9fbd
78575	78575	0	South African Biodiversity Information Facility	7190b835-4e86-4b6e-85c1-19cc6677c250	2ca312ee-40cf-49e0-b864-31531b7eba81
0	548	548	Ocean Biodiversity Information System	ba0670b9-4186-41e6-8e70-f9cb3065551a	2f87fc54-c036-4b6f-94f4-4ee8da995989
77	77	0	Colombian Biodiversity Information System	7e865cba-7c46-417b-ade5-97f2cf5b7be0	34cf03b8-194d-4e84-ab6e-30e080eb4dc6
141	141	0	Colombian Biodiversity Information System	7e865cba-7c46-417b-ade5-97f2cf5b7be0	35161ff4-7a8d-492b-a20f-c8fec43d8283
0	343	343	GBIF Benin	efb9c00e-f802-45dd-8826-a52ec45b89ff	369a102d-26f3-4bef-8443-064873f50091
15	3749	3734	National Biodiversity Network	d897a5b9-35ee-4232-94bd-b0bcaac003c2	380a3068-382a-4435-af14-951a8051ea7a
98	98	0	Colombian Biodiversity Information System	7e865cba-7c46-417b-ade5-97f2cf5b7be0	3a568ff2-a082-48b1-a2f3-08c225f03b0f
0	11	11	Plazi	ffb07bec-2d10-492d-9c37-361fe0b79427	3a9a4caf-96e9-47d4-b4cd-940cf235c85f
11	11	0	Plazi	ffb07bec-2d10-492d-9c37-361fe0b79427	3e00ef13-3995-4f38-b69b-6df75b6ee2e5
11023	11023	0	Atlas of Living Australia	4a6f1b71-969e-4fc5-a693-282b05e1220c	3eba6cae-ac76-457f-a9c7-76bb7ca0e989
9	9	0	Plazi	ffb07bec-2d10-492d-9c37-361fe0b79427	4026086a-9659-492a-808e-bc4465a028aa
19	19	0	GBIF France	da44cd31-5901-4687-a106-6d1c7734ee3a	40c0603e-299c-41e9-96d9-2a5cacadfe00
0	81	81	Plazi	ffb07bec-2d10-492d-9c37-361fe0b79427	465ec546-64e0-4ba3-84bb-b485feab12ab
3312	3312	0	GBIF Portugal	673f7038-4262-4149-b753-5658a4e912f6	46a4c0be-8d32-4dae-8d66-fac6e6231434
0	3376	3376	Taiwan Biodiversity Information Facility	e1b85abc-61f9-430f-ba79-6813dec53a0f	47edae41-a30c-4a6c-ac87-dbf1e24dc130
0	4	4	Plazi	ffb07bec-2d10-492d-9c37-361fe0b79427	48f3100c-4fa8-4999-ba62-9e617d83edf4
318	318	0	Plazi	ffb07bec-2d10-492d-9c37-361fe0b79427	4a3d31ca-e16b-4ccf-8407-231aa27702f1
352	352	0	GBIF France	da44cd31-5901-4687-a106-6d1c7734ee3a	4e3743c9-e591-4a27-be46-0fd526da81d3
4	4	0	Plazi	ffb07bec-2d10-492d-9c37-361fe0b79427	4ef7236a-1a55-47d0-98e6-5f9272df0681
10631	10631	0	National Biodiversity Network	d897a5b9-35ee-4232-94bd-b0bcaac003c2	5417ebe1-8328-45f9-9c4c-72a1c5e9c8dc
35	35	0	Plazi	ffb07bec-2d10-492d-9c37-361fe0b79427	57c7ab87-1ca3-4430-9621-c1d3734d881e
262	559	297	U.S. Geological Survey	8618c64a-93e0-4300-b546-7249e5148ed2	591c4da7-967c-4cad-ad60-b276e60fb4d2
89	89	0	Colombian Biodiversity Information System	7e865cba-7c46-417b-ade5-97f2cf5b7be0	5a6e540f-db9b-4d68-9bef-a7b5d1e344ef
0	2	2	Plazi	ffb07bec-2d10-492d-9c37-361fe0b79427	617a0e17-b4c7-4ac5-b371-73293b34d738
26	26	0	GBIF Germany	4f6826f2-4ff6-443d-b966-e6913bd24013	62bb7b60-f762-11e1-a439-00145eb45e9a
68	68	0	GBIF Germany	4f6826f2-4ff6-443d-b966-e6913bd24013	62d9ddbc-f762-11e1-a439-00145eb45e9a
107	107	0	GBIF Germany	4f6826f2-4ff6-443d-b966-e6913bd24013	63fb834e-f762-11e1-a439-00145eb45e9a
9	9	0	GBIF Germany	4f6826f2-4ff6-443d-b966-e6913bd24013	64ec823a-f762-11e1-a439-00145eb45e9a
8	8	0	GBIF Germany	4f6826f2-4ff6-443d-b966-e6913bd24013	65e30dbc-b31b-416a-b582-d24de699b538
0	11	11	Ocean Biodiversity Information System	ba0670b9-4186-41e6-8e70-f9cb3065551a	66f480c1-c118-46ee-b28f-4384ffc3d1f2
68	68	0	GBIF Germany	4f6826f2-4ff6-443d-b966-e6913bd24013	676a77e2-f762-11e1-a439-00145eb45e9a
141	141	0	GBIF Germany	4f6826f2-4ff6-443d-b966-e6913bd24013	679e50da-f762-11e1-a439-00145eb45e9a
128	128	0	GBIF Germany	4f6826f2-4ff6-443d-b966-e6913bd24013	679fa552-f762-11e1-a439-00145eb45e9a
2	2	0	Plazi	ffb07bec-2d10-492d-9c37-361fe0b79427	67b7d296-0468-4081-93c8-893e4e13e076
970	970	0	Inter American Biodiversity Information Network	69f8ea9e-b2a6-4e5a-896f-3bf8fc23cc8d	686f1b6c-7d0e-41be-945a-3798a8234cd3
79	79	0	GBIF Germany	4f6826f2-4ff6-443d-b966-e6913bd24013	6897d9a2-f762-11e1-a439-00145eb45e9a
147	147	0	GBIF Germany	4f6826f2-4ff6-443d-b966-e6913bd24013	6907b79a-f762-11e1-a439-00145eb45e9a
1	1	0	Plazi	ffb07bec-2d10-492d-9c37-361fe0b79427	6b52aa26-9992-438d-b948-9d4236ff8733
16	16	0	Plazi	ffb07bec-2d10-492d-9c37-361fe0b79427	6d350404-6f84-4fdc-83ef-65a70583acf8
0	1	1	Plazi	ffb07bec-2d10-492d-9c37-361fe0b79427	6f7d2cb9-f256-435a-8327-af6c9e3201d6
6	6	0	GBIF Germany	4f6826f2-4ff6-443d-b966-e6913bd24013	6fccac0c-f762-11e1-a439-00145eb45e9a
192	192	0	Atlas of Living Australia	4a6f1b71-969e-4fc5-a693-282b05e1220c	70501d5b-609e-4d11-a8c5-88960b40ae10
8	8	0	GBIF Germany	4f6826f2-4ff6-443d-b966-e6913bd24013	714b3be8-f762-11e1-a439-00145eb45e9a
0	1	1	Plazi	ffb07bec-2d10-492d-9c37-361fe0b79427	73b191ac-03d4-4467-915e-6c275b1d39d9
129	129	0	GBIF Germany	4f6826f2-4ff6-443d-b966-e6913bd24013	7417fcb2-f762-11e1-a439-00145eb45e9a
120	120	0	GBIF Germany	4f6826f2-4ff6-443d-b966-e6913bd24013	75440cc0-f762-11e1-a439-00145eb45e9a
0	57	57	Plazi	ffb07bec-2d10-492d-9c37-361fe0b79427	76aa06a8-f646-4c5a-b596-54bfd8875223
8	8	0	GBIF Germany	4f6826f2-4ff6-443d-b966-e6913bd24013	78dd6a48-f762-11e1-a439-00145eb45e9a
285	285	0	GBIF Germany	4f6826f2-4ff6-443d-b966-e6913bd24013	79f831b0-f762-11e1-a439-00145eb45e9a
1212	1212	0	Atlas of Living Australia	4a6f1b71-969e-4fc5-a693-282b05e1220c	7b7393c2-f762-11e1-a439-00145eb45e9a
45	45	0	Plazi	ffb07bec-2d10-492d-9c37-361fe0b79427	7c3672bd-ab30-45ea-8619-7b1f98443ed3
144	36	-108	GBIF Germany	4f6826f2-4ff6-443d-b966-e6913bd24013	7cad7f1e-f762-11e1-a439-00145eb45e9a
279	187	-92	GBIF Germany	4f6826f2-4ff6-443d-b966-e6913bd24013	7ce536ca-f762-11e1-a439-00145eb45e9a
98	98	0	Plazi	ffb07bec-2d10-492d-9c37-361fe0b79427	7d852af3-8081-473d-98d3-4ab4e09d3c0f
119	119	0	GBIF Germany	4f6826f2-4ff6-443d-b966-e6913bd24013	7e49a6b8-f762-11e1-a439-00145eb45e9a
3293	3291	-2	Biodiversity Information System of Mexico	b324e8e9-9a4c-44fa-8f1a-7f39ea7ab576	7f6f33a0-f762-11e1-a439-00145eb45e9a
228	228	0	Biodiversity Information System of Mexico	b324e8e9-9a4c-44fa-8f1a-7f39ea7ab576	7f8b4f86-f762-11e1-a439-00145eb45e9a
55	55	0	GBIF Germany	4f6826f2-4ff6-443d-b966-e6913bd24013	8198d1a4-f762-11e1-a439-00145eb45e9a
700	700	0	GBIF Germany	4f6826f2-4ff6-443d-b966-e6913bd24013	81d07b0e-f762-11e1-a439-00145eb45e9a
27	27	0	Plazi	ffb07bec-2d10-492d-9c37-361fe0b79427	8306e53f-cbe8-4c39-b2cf-6c647c4e9a13
0	5	5	Canada Biodiversity Information Facility	8f83fc96-c966-4126-83f7-bf044dc49efa	8430fcd6-85f7-4daf-931f-91a035277c17
1678	1678	0	Canada Biodiversity Information Facility	8f83fc96-c966-4126-83f7-bf044dc49efa	84428b0c-f762-11e1-a439-00145eb45e9a
1359	1359	0	GBIF Germany	4f6826f2-4ff6-443d-b966-e6913bd24013	85703434-f762-11e1-a439-00145eb45e9a
339685	339685	0	GBIF Spain	1f94b3ca-9345-4d65-afe2-4bace93aa0fe	85877766-f762-11e1-a439-00145eb45e9a
21792	21792	0	GBIF Portugal	673f7038-4262-4149-b753-5658a4e912f6	85bb8376-f762-11e1-a439-00145eb45e9a
0	4	4	Plazi	ffb07bec-2d10-492d-9c37-361fe0b79427	85bd36ca-e0aa-4a5c-b37e-dc74e6e440dc
9006	9006	0	GBIF Japan	db5705aa-6a6e-42f1-8942-d77b9f4896ea	86939734-f762-11e1-a439-00145eb45e9a
2192	2192	0	National Biodiversity Network	d897a5b9-35ee-4232-94bd-b0bcaac003c2	869d4966-782a-4929-be4b-56399446b711
65	65	0	GBIF France	da44cd31-5901-4687-a106-6d1c7734ee3a	86a0ff00-9a14-43e8-9122-6d234052ad75
1	1	0	Plazi	ffb07bec-2d10-492d-9c37-361fe0b79427	86c45dad-589f-4b4d-8682-d56f0e24f49a
18805	19484	679	National Biodiversity Network	d897a5b9-35ee-4232-94bd-b0bcaac003c2	8806aad1-215d-47bb-868b-02ea8fbffde4
242	235	-7	GBIF Germany	4f6826f2-4ff6-443d-b966-e6913bd24013	8862a6f4-f762-11e1-a439-00145eb45e9a
2899	2899	0	Participant Node Managers Committee	7f48e0c8-5c96-49ec-b972-30748e339115	898fcbd3-f5e9-48c8-a725-a681cb6bcf2d
355	355	0	GBIF Germany	4f6826f2-4ff6-443d-b966-e6913bd24013	8ab8d9c8-f762-11e1-a439-00145eb45e9a
3	3	0	GBIF Germany	4f6826f2-4ff6-443d-b966-e6913bd24013	8c3f9160-f762-11e1-a439-00145eb45e9a
140	140	0	National Biodiversity Network	d897a5b9-35ee-4232-94bd-b0bcaac003c2	8c94136f-6274-4ca9-b05d-562871277f99
16	14	-2	GBIF Germany	4f6826f2-4ff6-443d-b966-e6913bd24013	8c982956-f762-11e1-a439-00145eb45e9a
45	45	0	GBIF Germany	4f6826f2-4ff6-443d-b966-e6913bd24013	8ef8eee2-f762-11e1-a439-00145eb45e9a
191	136	-55	GBIF Germany	4f6826f2-4ff6-443d-b966-e6913bd24013	8fd792b4-f762-11e1-a439-00145eb45e9a
10124	10124	0	GBIF France	da44cd31-5901-4687-a106-6d1c7734ee3a	90029a6a-bd05-4eda-914d-574e0c953537
88	150	62	Colombian Biodiversity Information System	7e865cba-7c46-417b-ade5-97f2cf5b7be0	901f4a85-edb9-44d6-b9ab-65414894b602
14	6	-8	GBIF Germany	4f6826f2-4ff6-443d-b966-e6913bd24013	908a5160-f762-11e1-a439-00145eb45e9a
9	8	-1	GBIF Germany	4f6826f2-4ff6-443d-b966-e6913bd24013	9121e21e-f762-11e1-a439-00145eb45e9a
564	564	0	National Biodiversity Network	d897a5b9-35ee-4232-94bd-b0bcaac003c2	91a7ba5f-1090-45f6-9e71-48b0bce5ab63
0	69	69	GBIF Norway	4f829580-180d-46a9-9c87-ed8ec959b545	91ed9272-492c-4d4d-8070-f9dd24c5f9f3
115	80	-35	GBIF Germany	4f6826f2-4ff6-443d-b966-e6913bd24013	92ffe522-f762-11e1-a439-00145eb45e9a
7	7	0	Plazi	ffb07bec-2d10-492d-9c37-361fe0b79427	93187ae3-6c95-492c-96c3-2d52a0576441
3	3	0	National Biodiversity Network	d897a5b9-35ee-4232-94bd-b0bcaac003c2	93e21069-4db2-4494-b9d7-4c67b5255741
1829	1829	0	GBIF Germany	4f6826f2-4ff6-443d-b966-e6913bd24013	9526dad7-21e6-4136-bb3c-d0ce7a901528
110	110	0	GBIF Germany	4f6826f2-4ff6-443d-b966-e6913bd24013	956bfce2-f762-11e1-a439-00145eb45e9a
41503	41503	0	GBIF France	da44cd31-5901-4687-a106-6d1c7734ee3a	9ddfbe78-e30c-43b8-85a8-6952d88c8009
0	29	29	Plazi	ffb07bec-2d10-492d-9c37-361fe0b79427	9ed37c70-0d85-41bf-809f-58349df9a4a7
240	240	0	Biodiversity Information System of Mexico	b324e8e9-9a4c-44fa-8f1a-7f39ea7ab576	9fc5eae1-5a82-4f14-a1b4-254ed18d95d3
7	7	0	Plazi	ffb07bec-2d10-492d-9c37-361fe0b79427	a07982e1-e524-4403-babf-986531f28a80
4368	13368	9000	GBIF Japan	db5705aa-6a6e-42f1-8942-d77b9f4896ea	a3824989-1fbc-4a9a-bf41-322c74230c82
14	14	0	Secretariat of the Pacific Regional Environment Programme	29c6a139-ea7f-41f5-8d9b-c55af8736182	a461071a-2058-4fbc-804d-bb436c6fa56a
8	8	0	Plazi	ffb07bec-2d10-492d-9c37-361fe0b79427	a5acf934-0e1a-4f2a-a87a-e91ea907dee4
1	1	0	Plazi	ffb07bec-2d10-492d-9c37-361fe0b79427	a7e06f14-dd95-4c3a-bbf6-eda7e97bd236
324	324	0	National Biodiversity Network	d897a5b9-35ee-4232-94bd-b0bcaac003c2	abb2b9eb-f1b5-4ee6-9f29-b805556e7571
6	6	0	Plazi	ffb07bec-2d10-492d-9c37-361fe0b79427	ae9474b4-61e2-4eb5-8bd6-d11d33f07b4b
2	2	0	Plazi	ffb07bec-2d10-492d-9c37-361fe0b79427	ae97aaaa-94f9-4ec7-9d78-491de03c5fe6
9	9	0	Plazi	ffb07bec-2d10-492d-9c37-361fe0b79427	af8ed96e-b4ae-4ff8-8922-8b3750a8997c
9	9	0	Plazi	ffb07bec-2d10-492d-9c37-361fe0b79427	b0fd0742-ddaf-42c0-bab2-2b6c502aa7b7
0	18	18	Plazi	ffb07bec-2d10-492d-9c37-361fe0b79427	b11fbee1-5468-4391-9aad-8685ff02bab1
0	6054	6054	National Biodiversity Data Centre	422b00b2-6c94-4bb6-976b-c359916efdb8	b18eba44-3193-4436-a6b0-75ee3ea54875
38	38	0	Plazi	ffb07bec-2d10-492d-9c37-361fe0b79427	b1c6c497-8ba5-48a0-a555-645bd1e96a47
0	1	1	Plazi	ffb07bec-2d10-492d-9c37-361fe0b79427	b1c6f40f-8623-49e8-ab43-21fba2b07c25
8	8	0	Plazi	ffb07bec-2d10-492d-9c37-361fe0b79427	b2ba6675-f6f1-4ace-a151-a385e3142ee0
24971	24971	0	GBIF Argentina	2426a871-9feb-40a1-96c6-0c593a76b835	b4a37621-7556-4705-9349-ede261feebe4
111991	111991	0	Society for the Management of Electronic Biodiversity Data	97818ee4-1461-4180-bf1d-b3201050124f	b5192815-5e90-45b4-a17d-62856a3ead51
3367	3367	0	Participant Node Managers Committee	7f48e0c8-5c96-49ec-b972-30748e339115	b5441d39-7564-4c70-bd9d-b90236808892
146	146	0	Colombian Biodiversity Information System	7e865cba-7c46-417b-ade5-97f2cf5b7be0	badf78ac-32c7-4afa-a729-9f9ddb6d82fe
47	47	0	Participant Node Managers Committee	7f48e0c8-5c96-49ec-b972-30748e339115	bb6113e0-9d52-4828-b9a8-4a37c2d6e95d
819	168	-651	GBIF Germany	4f6826f2-4ff6-443d-b966-e6913bd24013	bdab9578-92c8-4d3e-b119-663c9306f39e
326	326	0	National Biodiversity Network	d897a5b9-35ee-4232-94bd-b0bcaac003c2	c12bdb32-d166-4464-af86-db8e9bb6f4e7
29	29	0	Plazi	ffb07bec-2d10-492d-9c37-361fe0b79427	c3a4486e-bb74-4f26-9f53-2e918d10d8d2
208	208	0	GBIF Germany	4f6826f2-4ff6-443d-b966-e6913bd24013	c6724474-5a38-4ef5-b0c8-ed54ccc74950
0	23975	23975	Ocean Biodiversity Information System	ba0670b9-4186-41e6-8e70-f9cb3065551a	c81921d1-a61b-4c38-a7bc-66476d7de2ec
11	11	0	Plazi	ffb07bec-2d10-492d-9c37-361fe0b79427	c82eeefe-3290-4551-b975-ad1056f339ba
0	16	16	Plazi	ffb07bec-2d10-492d-9c37-361fe0b79427	c9681212-cc5c-44ac-bab7-655b5217083b
939	939	0	GBIF France	da44cd31-5901-4687-a106-6d1c7734ee3a	cbaa5e0f-189c-49e2-81a3-33f06a516079
0	1034886	1034886	U.S. Geological Survey	8618c64a-93e0-4300-b546-7249e5148ed2	ce9d17f0-de7f-4518-83a6-690c615dd8d9
433	433	0	Colombian Biodiversity Information System	7e865cba-7c46-417b-ade5-97f2cf5b7be0	cfa64a64-45e3-4717-8fe5-9f707cc362fa
2	2	0	Plazi	ffb07bec-2d10-492d-9c37-361fe0b79427	d0a3226b-1b79-48fa-97f4-9c81619c67f9
4	4	0	Plazi	ffb07bec-2d10-492d-9c37-361fe0b79427	d102335f-07a9-405b-a71e-13dda21b149b
107	107	0	GBIF Norway	4f829580-180d-46a9-9c87-ed8ec959b545	d1f1209b-b689-4f32-999f-330f3ecd4df2
0	5	5	Plazi	ffb07bec-2d10-492d-9c37-361fe0b79427	d3b8188f-cbf5-4420-b0a7-416610730865
0	5	5	Plazi	ffb07bec-2d10-492d-9c37-361fe0b79427	d453d9d0-7b59-4ef1-9a70-34061c0a3179
22	22	0	Colombian Biodiversity Information System	7e865cba-7c46-417b-ade5-97f2cf5b7be0	d5943bb3-99ef-4ebb-a187-1f45c162b127
9	9	0	Plazi	ffb07bec-2d10-492d-9c37-361fe0b79427	d5aea0b3-3e4f-4d57-93fa-5d5d56c39d2e
2	2	0	Plazi	ffb07bec-2d10-492d-9c37-361fe0b79427	d94845ff-31dd-4965-a5c6-e22141dc8fb8
1421	1421	0	Polish Biodiversity Information Network	2618bfdf-e194-4911-a241-80db3107bc51	dda71480-30b2-11de-b171-b8a03c50a862
1453	1453	0	Colombian Biodiversity Information System	7e865cba-7c46-417b-ade5-97f2cf5b7be0	ddce7f9a-3b1b-460f-ba50-99344281fc60
0	1	1	Plazi	ffb07bec-2d10-492d-9c37-361fe0b79427	e1039c3d-4389-41f9-afff-2010fe5c74ad
7	7	0	Plazi	ffb07bec-2d10-492d-9c37-361fe0b79427	e2d87630-51e4-4589-9c4d-7f9a74ff9a77
0	118	118	GBIF Ecuador	2dc472f1-c3d9-486d-b3c1-12ca7ba1ed22	e36b1b46-7b49-49eb-ac01-2c41eb0dcbaf
17	17	0	Biodiversity Information System of Mexico	b324e8e9-9a4c-44fa-8f1a-7f39ea7ab576	e3b42f0a-2922-428e-ad36-cd61a7ff881a
0	3	3	Plazi	ffb07bec-2d10-492d-9c37-361fe0b79427	e42ae5e8-64fd-4ba2-942e-35d39cf739d4
15255	15255	0	GBIF Germany	4f6826f2-4ff6-443d-b966-e6913bd24013	e6c97f6e-e952-11e2-961f-00145eb45e9a
133650	133637	-13	National Biodiversity Network	d897a5b9-35ee-4232-94bd-b0bcaac003c2	e6d9a4a4-dbf0-4a3e-87c2-91b6af1f9771
2	2	0	Plazi	ffb07bec-2d10-492d-9c37-361fe0b79427	e8a4de57-4e3e-47f6-93f2-20f4426cfe0d
0	1	1	Plazi	ffb07bec-2d10-492d-9c37-361fe0b79427	e9b9784d-8155-4745-a795-069fc0120390
2204	2204	0	National Biodiversity Network	d897a5b9-35ee-4232-94bd-b0bcaac003c2	eba7a4e3-2829-4e88-b578-3f752935a5bf
120	120	0	GBIF Finland	dd514216-5c7c-45f3-910d-797424cb5be6	ee7c2f66-60d2-4503-80d2-97d65eba01eb
1	1	0	Plazi	ffb07bec-2d10-492d-9c37-361fe0b79427	f0654d75-991f-4785-a6e0-b2c43bc8a4ca
6	6	0	Plazi	ffb07bec-2d10-492d-9c37-361fe0b79427	f0944c74-d625-4ae0-b63d-059b93466e44
0	3	3	Plazi	ffb07bec-2d10-492d-9c37-361fe0b79427	f151242f-8afc-4d9f-920d-7445e3225d9e
199	199	0	National Biodiversity Network	d897a5b9-35ee-4232-94bd-b0bcaac003c2	f3959683-28a7-42d9-aedd-8c994917729d
32	33	1	U.S. Geological Survey	8618c64a-93e0-4300-b546-7249e5148ed2	f3e4b261-00c5-4f3a-a5b7-d66075b7f3e1
240	240	0	GBIF France	da44cd31-5901-4687-a106-6d1c7734ee3a	f67742e5-8643-4c5e-9c77-950e4ec16241
21298	21298	0	Colombian Biodiversity Information System	7e865cba-7c46-417b-ade5-97f2cf5b7be0	f6c4b312-6a86-4fb1-a210-b861f8d1c899
0	328521	328521	National Biodiversity Network	d897a5b9-35ee-4232-94bd-b0bcaac003c2	fd7cda6d-0bdb-44ed-9319-010c286d4633
19	19	0	Plazi	ffb07bec-2d10-492d-9c37-361fe0b79427	fdbd433f-74c6-4a58-95aa-2b7b91b9fa37
8	8	0	GBIF France	da44cd31-5901-4687-a106-6d1c7734ee3a	02d536bb-d119-41d7-bfaa-7b9472cdd6ca
1	1	0	Plazi	ffb07bec-2d10-492d-9c37-361fe0b79427	03584cef-aa44-471a-a887-539b9a4e868a
0	62	62	Ocean Biodiversity Information System	ba0670b9-4186-41e6-8e70-f9cb3065551a	03960fc1-f3d6-48c8-8be4-2787111538c2
0	7	7	Plazi	ffb07bec-2d10-492d-9c37-361fe0b79427	063789e8-69e4-427e-adc9-fffa973b9160
0	450	450	Korean Biodiversity Information Facility	e0a1e772-0177-4800-94b4-2d023fe6cdf4	07527ec0-e9e5-4994-8f8c-09c55323ce8d
2316	2316	0	Colombian Biodiversity Information System	7e865cba-7c46-417b-ade5-97f2cf5b7be0	080338cd-dffb-4baa-9764-79a9903b35b0
215	215	0	Scientific Committee on Antarctic Research	51e4e8ff-bff0-4996-8b27-9107d61b3478	08668664-5f23-4cdf-91f4-6835ab30118f
99	99	0	GBIF Germany	4f6826f2-4ff6-443d-b966-e6913bd24013	08e49176-901f-4314-9d63-bb6323aa766b
32	32	0	Plazi	ffb07bec-2d10-492d-9c37-361fe0b79427	0a5eaf77-8aa5-4527-9341-0afe6d0f62a3
0	27	27	Plazi	ffb07bec-2d10-492d-9c37-361fe0b79427	0a98a7e5-af6f-40b6-821e-c56567584422
50869	50872	3	Canada Biodiversity Information Facility	8f83fc96-c966-4126-83f7-bf044dc49efa	0b94e07b-898e-47fc-b95f-31a5538f326b
584	584	0	Colombian Biodiversity Information System	7e865cba-7c46-417b-ade5-97f2cf5b7be0	0bd0f5f0-c661-4ed0-a53f-eb3319d83c87
17221	17221	0	National Biodiversity Network	d897a5b9-35ee-4232-94bd-b0bcaac003c2	0bd77f91-ba5d-4e68-868d-354717121c25
187	187	0	Colombian Biodiversity Information System	7e865cba-7c46-417b-ade5-97f2cf5b7be0	0f5a8ec5-e12b-415a-9f03-3d3ea14774e5
0	51475	51475	GBIF Portugal	673f7038-4262-4149-b753-5658a4e912f6	0f7c7942-c5d2-435e-afba-97df549dbc19
0	4	4	Plazi	ffb07bec-2d10-492d-9c37-361fe0b79427	0f92f929-9cbc-4faf-9b5e-403818f6c626
6	6	0	Plazi	ffb07bec-2d10-492d-9c37-361fe0b79427	115d0c3a-bc71-4ed0-baa1-ef4e16fafb45
29	29	0	Plazi	ffb07bec-2d10-492d-9c37-361fe0b79427	11c87853-9767-4d85-bbfd-1d2116aa3ea5
8	8	0	Plazi	ffb07bec-2d10-492d-9c37-361fe0b79427	1320c88d-0b17-433b-ac7b-0c7002855497
4	4	0	Plazi	ffb07bec-2d10-492d-9c37-361fe0b79427	13c82d54-64db-490a-835b-8843475c353e
0	1440	1440	Ocean Biodiversity Information System	ba0670b9-4186-41e6-8e70-f9cb3065551a	178153ae-4c80-4741-99eb-b5c6a6bb877d
2	2	0	Plazi	ffb07bec-2d10-492d-9c37-361fe0b79427	188c916f-80cc-46b1-9d58-48a8d3463102
280	280	0	Belgian Biodiversity Platform	fb11cfe1-ebc3-45af-9159-17d9fddbcdac	19fb027b-710b-4f56-858f-d04a13275f2a
4	4	0	Plazi	ffb07bec-2d10-492d-9c37-361fe0b79427	1bd88485-d24a-465a-ad8e-0aca77dba9d0
1011	1011	0	GBIF France	da44cd31-5901-4687-a106-6d1c7734ee3a	1bf8b4ee-04bd-481a-a3df-67fc40291e97
0	245	245	Plazi	ffb07bec-2d10-492d-9c37-361fe0b79427	1e6b9c6c-c1ae-43ed-8417-70324a727566
3	3	0	Plazi	ffb07bec-2d10-492d-9c37-361fe0b79427	21de1436-bd5c-45d5-bc6f-b13a5383a306
411	411	0	Plazi	ffb07bec-2d10-492d-9c37-361fe0b79427	243064a9-76d7-48c8-b378-31b5aacf9ad7
0	2	2	Plazi	ffb07bec-2d10-492d-9c37-361fe0b79427	27a89df7-e493-4654-be36-741bfc0aa016
6014	6014	0	Ocean Biodiversity Information System	ba0670b9-4186-41e6-8e70-f9cb3065551a	2b151ccd-eb45-4f73-8baa-24c24ce87165
26159	26224	65	Belgian Biodiversity Platform	fb11cfe1-ebc3-45af-9159-17d9fddbcdac	2b2bf993-fc91-4d29-ae0b-9940b97e3232
0	34	34	Participant Node Managers Committee	7f48e0c8-5c96-49ec-b972-30748e339115	2b7a9822-f352-4b54-a67c-b6d3bda6d0e0
1689	1689	0	DanBIF - Danish Biodiversity Information Facility	4ddd294f-02b7-4359-ac33-0806a9ca9c6b	2c0dce8b-efd6-4076-a0a6-ca6915dd3dbc
1	1	0	Plazi	ffb07bec-2d10-492d-9c37-361fe0b79427	2e05bff1-b04e-4edd-b15a-58ec942925da
193	193	0	GBIF Germany	4f6826f2-4ff6-443d-b966-e6913bd24013	2f6b5b22-279e-46c3-952a-5eb5c937f94e
2	2	0	Plazi	ffb07bec-2d10-492d-9c37-361fe0b79427	2f71fd59-b78c-42b6-bd4d-99c85de97cf5
0	1	1	Plazi	ffb07bec-2d10-492d-9c37-361fe0b79427	2f8102fd-6d74-4f09-b5f9-79ac7112fbe5
0	6	6	Plazi	ffb07bec-2d10-492d-9c37-361fe0b79427	31966ce9-2658-4f41-8b84-7299c6280cfa
0	497	497	Plazi	ffb07bec-2d10-492d-9c37-361fe0b79427	31f73be9-4a90-4c0a-937e-784437eff4bd
397	397	0	DanBIF - Danish Biodiversity Information Facility	4ddd294f-02b7-4359-ac33-0806a9ca9c6b	32602fc5-0850-4c4e-ba69-1f63ef98b2e0
754	754	0	GBIF France	da44cd31-5901-4687-a106-6d1c7734ee3a	32682088-8a29-487e-89dd-96a250e94393
89	89	0	Plazi	ffb07bec-2d10-492d-9c37-361fe0b79427	328c4344-2529-4aae-9c38-a3f9cb576c35
947	947	0	GBIF Finland	dd514216-5c7c-45f3-910d-797424cb5be6	35cfb386-7bd4-40a8-ba95-813b5f827671
0	7	7	Plazi	ffb07bec-2d10-492d-9c37-361fe0b79427	374788cd-1ff8-4c2b-abe1-4d3f0da49c9e
1	1	0	Plazi	ffb07bec-2d10-492d-9c37-361fe0b79427	3924721e-d86c-4857-80dc-970647b247a3
971	971	0	Biodiversity Information System of Mexico	b324e8e9-9a4c-44fa-8f1a-7f39ea7ab576	3b3b2b62-97c3-419e-9a0a-959af7e85841
0	12	12	Ocean Biodiversity Information System	ba0670b9-4186-41e6-8e70-f9cb3065551a	3cce1271-f3b9-49b7-aac3-297318a0cbe6
3930	3930	0	GBIF France	da44cd31-5901-4687-a106-6d1c7734ee3a	3cfbe8d0-76f1-41d5-b606-b8f63abeee8c
1	1	0	Plazi	ffb07bec-2d10-492d-9c37-361fe0b79427	3f363c5e-1984-4720-8e5e-d2ed2bb05534
41057	41057	0	GBIF France	da44cd31-5901-4687-a106-6d1c7734ee3a	43408d27-f127-490c-a15f-477acd24714e
7302	7385	83	GBIF Brazil	cdc9736d-5ff7-4ece-9959-3c744360cdb3	43e4b07b-f31d-4ab9-82c5-e87048a138ee
68604	74604	6000	GBIF Japan	db5705aa-6a6e-42f1-8942-d77b9f4896ea	44191d2e-e05c-46fd-a167-3e97bcccf915
0	1	1	Plazi	ffb07bec-2d10-492d-9c37-361fe0b79427	44dd765b-ee51-467a-a919-2b43106a4d61
8	8	0	Plazi	ffb07bec-2d10-492d-9c37-361fe0b79427	4733a421-f25b-4e27-9951-e2b5e46b1594
32706	32709	3	U.S. Geological Survey	8618c64a-93e0-4300-b546-7249e5148ed2	4852540d-afd1-4678-bd20-4aac28f65e2d
10	10	0	Plazi	ffb07bec-2d10-492d-9c37-361fe0b79427	4d2f2e69-90f7-49cd-bee2-11014e42d918
15	15	0	Atlas of Living Australia	4a6f1b71-969e-4fc5-a693-282b05e1220c	4e302fbd-7437-4f2a-ae19-2525f090a4e7
0	3355	3355	Ocean Biodiversity Information System	ba0670b9-4186-41e6-8e70-f9cb3065551a	4ef9d605-b08f-4f29-8d37-0536ffd2938e
2	2	0	Plazi	ffb07bec-2d10-492d-9c37-361fe0b79427	504ef360-676f-411a-9f0e-3fec97f5896f
42	42	0	Plazi	ffb07bec-2d10-492d-9c37-361fe0b79427	52356089-4633-4477-99c9-45f18606f5b9
1023	1023	0	GBIF Germany	4f6826f2-4ff6-443d-b966-e6913bd24013	528cd97f-f715-467a-94fa-35381a27751d
17252	17252	0	GBIF Israel	8cb55387-7802-40e8-86d6-d357a583c596	52e0fe59-6da4-4707-ab31-c8873f415dc9
1	1	0	Plazi	ffb07bec-2d10-492d-9c37-361fe0b79427	5557b5dc-6064-4574-b7cb-08b1398a4789
5	5	0	Plazi	ffb07bec-2d10-492d-9c37-361fe0b79427	5635cce7-0195-420e-8d72-fe797c934aa6
0	33	33	Plazi	ffb07bec-2d10-492d-9c37-361fe0b79427	56cbcb48-21f4-4d16-9353-c09aea15e092
0	6	6	Plazi	ffb07bec-2d10-492d-9c37-361fe0b79427	56df3320-823e-4b78-b713-34efb7e6dd08
7425	7425	0	National Biodiversity Network	d897a5b9-35ee-4232-94bd-b0bcaac003c2	57a5f0ac-c65b-4757-9875-bf6b8d7e1f35
31	31	0	National Biodiversity Network	d897a5b9-35ee-4232-94bd-b0bcaac003c2	589320b5-b046-4883-a485-2dc5e10e2ab8
0	214	214	Colombian Biodiversity Information System	7e865cba-7c46-417b-ade5-97f2cf5b7be0	59c68690-c4cc-41f5-ad89-11a23118e2c3
0	10	10	Plazi	ffb07bec-2d10-492d-9c37-361fe0b79427	59ee2447-2085-4b2b-a0f0-91b9efe7b3cd
1	1	0	Plazi	ffb07bec-2d10-492d-9c37-361fe0b79427	5b0dfb7c-9e7e-4e3e-b438-5e25073759ba
43143	48548	5405	GBIF Germany	4f6826f2-4ff6-443d-b966-e6913bd24013	5d47cb09-3ef2-477d-a539-dd7f6955aefd
340	557	217	Colombian Biodiversity Information System	7e865cba-7c46-417b-ade5-97f2cf5b7be0	5fb6974e-55f0-43ce-b5e9-26e6cd1f4b12
4	4	0	Plazi	ffb07bec-2d10-492d-9c37-361fe0b79427	5fec9f1d-58e3-4e8b-ae9b-3346c6a17b4c
6	6	0	GBIF Germany	4f6826f2-4ff6-443d-b966-e6913bd24013	617bef6e-f762-11e1-a439-00145eb45e9a
17	17	0	GBIF Germany	4f6826f2-4ff6-443d-b966-e6913bd24013	61f6b230-f762-11e1-a439-00145eb45e9a
0	29015	29015	Ocean Biodiversity Information System	ba0670b9-4186-41e6-8e70-f9cb3065551a	6202c5e9-9211-4788-a30e-58b810fcbbbb
0	23	23	Plazi	ffb07bec-2d10-492d-9c37-361fe0b79427	64639217-c52a-453d-a6b3-382db4402257
61	56	-5	GBIF Germany	4f6826f2-4ff6-443d-b966-e6913bd24013	64aa0234-f762-11e1-a439-00145eb45e9a
22	22	0	GBIF Germany	4f6826f2-4ff6-443d-b966-e6913bd24013	64e5c094-f762-11e1-a439-00145eb45e9a
325	325	0	Ocean Biodiversity Information System	ba0670b9-4186-41e6-8e70-f9cb3065551a	650e3948-a217-4eca-b5c4-169f98601d08
46	46	0	GBIF Germany	4f6826f2-4ff6-443d-b966-e6913bd24013	65b947de-f762-11e1-a439-00145eb45e9a
12	12	0	GBIF Germany	4f6826f2-4ff6-443d-b966-e6913bd24013	66706ad6-f762-11e1-a439-00145eb45e9a
159	159	0	GBIF Germany	4f6826f2-4ff6-443d-b966-e6913bd24013	67a10456-f762-11e1-a439-00145eb45e9a
40	40	0	GBIF Germany	4f6826f2-4ff6-443d-b966-e6913bd24013	67c9b8ba-f762-11e1-a439-00145eb45e9a
988	988	0	GBIF Germany	4f6826f2-4ff6-443d-b966-e6913bd24013	687f6708-cd67-4544-9f02-89e8ebfa85e6
103	103	0	GBIF Germany	4f6826f2-4ff6-443d-b966-e6913bd24013	689534ae-f762-11e1-a439-00145eb45e9a
51	51	0	Plazi	ffb07bec-2d10-492d-9c37-361fe0b79427	68d7cf72-3a99-4b8d-a9e5-244aed4e3b9e
191	191	0	GBIF Germany	4f6826f2-4ff6-443d-b966-e6913bd24013	6967f614-f762-11e1-a439-00145eb45e9a
88	88	0	GBIF Germany	4f6826f2-4ff6-443d-b966-e6913bd24013	69930570-f762-11e1-a439-00145eb45e9a
55	55	0	Plazi	ffb07bec-2d10-492d-9c37-361fe0b79427	69e88778-6ab9-44ad-bce0-bb84eb35391b
18	18	0	GBIF Germany	4f6826f2-4ff6-443d-b966-e6913bd24013	6b83a4ac-f762-11e1-a439-00145eb45e9a
181	181	0	GBIF Germany	4f6826f2-4ff6-443d-b966-e6913bd24013	6c3a2312-f762-11e1-a439-00145eb45e9a
0	2	2	Plazi	ffb07bec-2d10-492d-9c37-361fe0b79427	6cee74d5-d5f9-4ee7-9bd3-413d5ba4000b
7	7	0	Plazi	ffb07bec-2d10-492d-9c37-361fe0b79427	6d100dd4-9303-4aab-a7bb-92b43a058494
1382	1382	0	GBIF Germany	4f6826f2-4ff6-443d-b966-e6913bd24013	72170412-f762-11e1-a439-00145eb45e9a
36	36	0	GBIF Germany	4f6826f2-4ff6-443d-b966-e6913bd24013	72c52736-f762-11e1-a439-00145eb45e9a
56	56	0	GBIF Germany	4f6826f2-4ff6-443d-b966-e6913bd24013	7430b2fc-f762-11e1-a439-00145eb45e9a
814	814	0	GBIF Germany	4f6826f2-4ff6-443d-b966-e6913bd24013	748d7992-f762-11e1-a439-00145eb45e9a
175	175	0	GBIF Germany	4f6826f2-4ff6-443d-b966-e6913bd24013	74de20ae-f762-11e1-a439-00145eb45e9a
534	554	20	GBIF Germany	4f6826f2-4ff6-443d-b966-e6913bd24013	74e0d6dc-f762-11e1-a439-00145eb45e9a
37666	37667	1	Canada Biodiversity Information Facility	8f83fc96-c966-4126-83f7-bf044dc49efa	74f92761-3a24-4d85-9bfb-00b1fee0119d
529	464	-65	GBIF Germany	4f6826f2-4ff6-443d-b966-e6913bd24013	7640d8a7-3b69-40fb-b4ba-c3c40255885e
342	342	0	GBIF Germany	4f6826f2-4ff6-443d-b966-e6913bd24013	77476bfc-f762-11e1-a439-00145eb45e9a
633	633	0	National Biodiversity Network	d897a5b9-35ee-4232-94bd-b0bcaac003c2	783641d5-9984-4d2d-b6f3-f42bfaf4a3e7
5	6	1	Plazi	ffb07bec-2d10-492d-9c37-361fe0b79427	78a04ea6-232f-4d21-a5be-eac12686c9f1
18	18	0	GBIF Germany	4f6826f2-4ff6-443d-b966-e6913bd24013	78a30bbe-f762-11e1-a439-00145eb45e9a
1	1	0	Plazi	ffb07bec-2d10-492d-9c37-361fe0b79427	78c8f10e-2034-47dd-b518-7ae7a74df5ec
1643	1643	0	Korean Biodiversity Information Facility	e0a1e772-0177-4800-94b4-2d023fe6cdf4	7aea7d3a-f762-11e1-a439-00145eb45e9a
0	19	19	Plazi	ffb07bec-2d10-492d-9c37-361fe0b79427	7b1e785d-d470-447e-93bf-04d73db39130
198240	198240	0	GBIF Germany	4f6826f2-4ff6-443d-b966-e6913bd24013	7b9b21da-f762-11e1-a439-00145eb45e9a
918	918	0	GBIF Germany	4f6826f2-4ff6-443d-b966-e6913bd24013	7c893dd4-f762-11e1-a439-00145eb45e9a
199	199	0	Biodiversity Information System of Mexico	b324e8e9-9a4c-44fa-8f1a-7f39ea7ab576	8027ea3a-f762-11e1-a439-00145eb45e9a
200	198	-2	GBIF Germany	4f6826f2-4ff6-443d-b966-e6913bd24013	82732728-f762-11e1-a439-00145eb45e9a
190257	190257	0	Canada Biodiversity Information Facility	8f83fc96-c966-4126-83f7-bf044dc49efa	82d54d68-f762-11e1-a439-00145eb45e9a
243	243	0	Ocean Biodiversity Information System	ba0670b9-4186-41e6-8e70-f9cb3065551a	83b0cc08-f762-11e1-a439-00145eb45e9a
64010	64010	0	GBIF Japan	db5705aa-6a6e-42f1-8942-d77b9f4896ea	848ae956-f762-11e1-a439-00145eb45e9a
143467	145042	1575	U.S. Geological Survey	8618c64a-93e0-4300-b546-7249e5148ed2	854e35e6-f762-11e1-a439-00145eb45e9a
98	98	0	GBIF France	da44cd31-5901-4687-a106-6d1c7734ee3a	85a42837-4e16-4edf-8435-3a152fda9846
3	3	0	GBIF Germany	4f6826f2-4ff6-443d-b966-e6913bd24013	85e549a4-f762-11e1-a439-00145eb45e9a
2174	2174	0	DanBIF - Danish Biodiversity Information Facility	4ddd294f-02b7-4359-ac33-0806a9ca9c6b	85e79b82-f762-11e1-a439-00145eb45e9a
14285	14285	0	Belgian Biodiversity Platform	fb11cfe1-ebc3-45af-9159-17d9fddbcdac	85e8c69c-f762-11e1-a439-00145eb45e9a
125777	120629	-5148	GBIF Japan	db5705aa-6a6e-42f1-8942-d77b9f4896ea	86986958-f762-11e1-a439-00145eb45e9a
36	36	0	Plazi	ffb07bec-2d10-492d-9c37-361fe0b79427	86b76f24-0a25-4767-9088-7399181809dd
0	21	21	Plazi	ffb07bec-2d10-492d-9c37-361fe0b79427	87140979-d528-49e4-a460-96f59911d270
329	250	-79	GBIF Germany	4f6826f2-4ff6-443d-b966-e6913bd24013	87d88776-f762-11e1-a439-00145eb45e9a
194	194	0	GBIF Germany	4f6826f2-4ff6-443d-b966-e6913bd24013	8856af20-f762-11e1-a439-00145eb45e9a
201	62	-139	GBIF Germany	4f6826f2-4ff6-443d-b966-e6913bd24013	894f74a2-f762-11e1-a439-00145eb45e9a
4	4	0	GBIF Germany	4f6826f2-4ff6-443d-b966-e6913bd24013	8b88608a-f762-11e1-a439-00145eb45e9a
4	4	0	GBIF Germany	4f6826f2-4ff6-443d-b966-e6913bd24013	8c357dba-f762-11e1-a439-00145eb45e9a
2	2	0	Plazi	ffb07bec-2d10-492d-9c37-361fe0b79427	8cd9d74c-2aac-43b8-be04-c649f9300b1d
14	7	-7	GBIF Germany	4f6826f2-4ff6-443d-b966-e6913bd24013	8ced6434-f762-11e1-a439-00145eb45e9a
0	6	6	Plazi	ffb07bec-2d10-492d-9c37-361fe0b79427	8df5f352-df3c-47d4-a9e6-619cabc5a4dd
773	773	0	GBIF Germany	4f6826f2-4ff6-443d-b966-e6913bd24013	8ee01b60-f762-11e1-a439-00145eb45e9a
77	72	-5	GBIF Germany	4f6826f2-4ff6-443d-b966-e6913bd24013	8f561ec8-f762-11e1-a439-00145eb45e9a
9120	9120	0	GBIF Iceland	4dbdcae6-9ac9-4005-ac15-4a95a3eb7701	902dd5f6-d3a0-4ef0-b2f8-8e3f96229ec9
424	424	0	National Biodiversity Network	d897a5b9-35ee-4232-94bd-b0bcaac003c2	904a6010-d502-43a6-bcd7-4b017c6f8725
1854	1854	0	GBIF Germany	4f6826f2-4ff6-443d-b966-e6913bd24013	91ec768c-f762-11e1-a439-00145eb45e9a
46	46	0	Plazi	ffb07bec-2d10-492d-9c37-361fe0b79427	92005c51-bac6-4193-acc5-5a6b56c0b5cd
1424	1269	-155	GBIF Germany	4f6826f2-4ff6-443d-b966-e6913bd24013	922e138a-f762-11e1-a439-00145eb45e9a
0	2	2	Plazi	ffb07bec-2d10-492d-9c37-361fe0b79427	9269513a-e577-4560-9fa7-f2de73a3ede8
2013	1288	-725	GBIF Germany	4f6826f2-4ff6-443d-b966-e6913bd24013	92c73b64-f762-11e1-a439-00145eb45e9a
3	3	0	Plazi	ffb07bec-2d10-492d-9c37-361fe0b79427	92cac4e0-5905-4dd6-8818-8b36f1d2e7a1
18525	18525	0	GBIF Brazil	cdc9736d-5ff7-4ece-9959-3c744360cdb3	92de65b8-dd15-4477-a147-94aebcee03c3
215	215	0	GBIF Germany	4f6826f2-4ff6-443d-b966-e6913bd24013	92f63036-f762-11e1-a439-00145eb45e9a
15917	15917	0	GBIF Argentina	2426a871-9feb-40a1-96c6-0c593a76b835	94adad5f-fb11-426f-93e0-3dd02f3ccd1d
262	268	6	GBIF Germany	4f6826f2-4ff6-443d-b966-e6913bd24013	94ed8fba-f762-11e1-a439-00145eb45e9a
31212	31212	0	Society for the Management of Electronic Biodiversity Data	97818ee4-1461-4180-bf1d-b3201050124f	9575ab07-e816-4cd6-aa99-483343a825e6
498	506	8	National Biodiversity Network	d897a5b9-35ee-4232-94bd-b0bcaac003c2	95f5b4eb-e696-48a9-8f00-7d1b0b4ed516
11	11	0	Plazi	ffb07bec-2d10-492d-9c37-361fe0b79427	963d164b-8a5a-4e06-bdae-aec07aac9572
144	144	0	Atlas of Living Australia	4a6f1b71-969e-4fc5-a693-282b05e1220c	964dd900-f762-11e1-a439-00145eb45e9a
7	7	0	Plazi	ffb07bec-2d10-492d-9c37-361fe0b79427	96c2cdf3-edfa-4002-9c45-a2ce86275628
0	20829	20829	GBIF Norway	4f829580-180d-46a9-9c87-ed8ec959b545	9807df89-7446-4aab-8ec8-fd837085c1a1
9	9	0	Plazi	ffb07bec-2d10-492d-9c37-361fe0b79427	9928fd83-71d1-464a-bad8-f7293353784d
6	6	0	Plazi	ffb07bec-2d10-492d-9c37-361fe0b79427	9a05acd9-01ce-491f-8af8-8c1576be7d8f
1	1	0	Plazi	ffb07bec-2d10-492d-9c37-361fe0b79427	9c03136d-c43b-4cde-b7e4-28008bef3f18
702	702	0	Korean Biodiversity Information Facility	e0a1e772-0177-4800-94b4-2d023fe6cdf4	9c622eac-27fc-11e2-85e3-00145eb45e9a
4	4	0	Plazi	ffb07bec-2d10-492d-9c37-361fe0b79427	9d667866-47c7-4e0c-9fa9-22a0e202f36c
398	398	0	Colombian Biodiversity Information System	7e865cba-7c46-417b-ade5-97f2cf5b7be0	a12fddfc-61be-4559-8481-de8bd56a434b
50	50	0	Plazi	ffb07bec-2d10-492d-9c37-361fe0b79427	a1c40b73-0c11-4863-a188-412c33523e02
0	20	20	Plazi	ffb07bec-2d10-492d-9c37-361fe0b79427	a3d37dde-cd1c-46a3-8727-b3140740562e
14551	14551	0	Ghana Biodiversity Information Facility	b5633b75-6a86-4fdf-9cfc-506047fb9dc7	a720d91c-36d6-45a2-a163-e7145ebb30dd
40794	40794	0	Atlas of Living Australia	4a6f1b71-969e-4fc5-a693-282b05e1220c	a855a185-cf36-4b06-89f6-bbbce2e2805d
48	48	0	Taiwan Biodiversity Information Facility	e1b85abc-61f9-430f-ba79-6813dec53a0f	a9d518d1-f0f3-477b-a7a3-aa9f61eb1e54
0	22	22	Ocean Biodiversity Information System	ba0670b9-4186-41e6-8e70-f9cb3065551a	aa27719c-0f9c-47ef-8f01-7e504b2162fc
4	4	0	Plazi	ffb07bec-2d10-492d-9c37-361fe0b79427	aae08bae-cd9b-4efd-979b-b66832a28840
173	173	0	GBIF Nigeria	6529bcb5-a542-4fda-be87-54a624515335	ac01c46e-d422-4f9d-8fb5-b19debd281f8
57	57	0	Plazi	ffb07bec-2d10-492d-9c37-361fe0b79427	ae90fc53-1eca-4c6b-a0e8-49355821c947
118	118	0	Colombian Biodiversity Information System	7e865cba-7c46-417b-ade5-97f2cf5b7be0	afb7dcd1-6d83-4e46-8aa7-64694e375733
55	55	0	Plazi	ffb07bec-2d10-492d-9c37-361fe0b79427	afb880b8-a3a6-4ade-8dcf-ac47bbd00bb5
2	2	0	Plazi	ffb07bec-2d10-492d-9c37-361fe0b79427	b10b0c67-d6cc-48b2-b053-d71d0f78bdb4
28	28	0	Plazi	ffb07bec-2d10-492d-9c37-361fe0b79427	b5cbb023-caa7-4784-b5d4-21686e00957f
4976	7332	2356	GBIF Japan	db5705aa-6a6e-42f1-8942-d77b9f4896ea	b68d2bce-9cc5-4a65-b150-1e4de5df7cb5
0	1352	1352	Taiwan Biodiversity Information Facility	e1b85abc-61f9-430f-ba79-6813dec53a0f	b6fccb11-dc9a-4cf6-9994-b46fbac5759f
9	9	0	Plazi	ffb07bec-2d10-492d-9c37-361fe0b79427	bad9080b-242a-4ff4-8709-9739f9246b94
55	55	0	GBIF Malawi	2a42e4d7-ad4a-41b3-84c4-de4aa7b74d35	bd7a358b-f7af-416a-be49-c1e55a9fbf46
0	2	2	Plazi	ffb07bec-2d10-492d-9c37-361fe0b79427	bdd4f4c9-c177-45e2-bb20-fea5f5d5df26
4522	4522	0	GBIF France	da44cd31-5901-4687-a106-6d1c7734ee3a	be6c20ca-ea5c-4bb6-9fc0-c153b386f5ce
1	1	0	Plazi	ffb07bec-2d10-492d-9c37-361fe0b79427	be99f3d2-4525-4bd1-8693-be00d1eb28db
646	646	0	GBIF France	da44cd31-5901-4687-a106-6d1c7734ee3a	c02e6c8a-192f-4673-8db6-2f861e22005b
1234	1234	0	Belgian Biodiversity Platform	fb11cfe1-ebc3-45af-9159-17d9fddbcdac	c09eb4a4-0df1-4be5-bda7-d1f7e6063a57
2	2	0	Plazi	ffb07bec-2d10-492d-9c37-361fe0b79427	c0b05870-a4b6-41a1-ad52-30fa31904e7f
0	3	3	Ocean Biodiversity Information System	ba0670b9-4186-41e6-8e70-f9cb3065551a	c1f4420c-4807-4c3d-8dc2-1703996f09e2
4	4	0	Plazi	ffb07bec-2d10-492d-9c37-361fe0b79427	c5469a18-ddd3-41ba-af3d-391d0ade9366
1	1	0	GBIF France	da44cd31-5901-4687-a106-6d1c7734ee3a	c6282a20-b4a3-4ecb-ba98-0ab59ebeb509
21631	21631	0	Atlas of Living Australia	4a6f1b71-969e-4fc5-a693-282b05e1220c	c7fcf26c-bd16-4b8e-9903-f871a03f424b
0	4	4	Plazi	ffb07bec-2d10-492d-9c37-361fe0b79427	c8d2dc5e-a69d-40db-90b2-41a8c20f0310
349	349	0	GBIF France	da44cd31-5901-4687-a106-6d1c7734ee3a	c8feb590-e324-4792-8c1a-1befe3af87a7
1	1	0	Plazi	ffb07bec-2d10-492d-9c37-361fe0b79427	caae3f18-dc46-4627-a1e4-a58409ce476f
8	8	0	Plazi	ffb07bec-2d10-492d-9c37-361fe0b79427	cd82a776-32fb-4b3e-83cd-0be940fa83f1
1181	1181	0	GBIF France	da44cd31-5901-4687-a106-6d1c7734ee3a	cdf16217-d5f1-4e95-84fb-ff2bafff291b
25	25	0	Plazi	ffb07bec-2d10-492d-9c37-361fe0b79427	ce9dce22-b6da-45f6-8b50-25a2aeb3ddcc
0	2	2	Plazi	ffb07bec-2d10-492d-9c37-361fe0b79427	cec973b7-30eb-4570-afc1-159895cffa7c
2	2	0	Plazi	ffb07bec-2d10-492d-9c37-361fe0b79427	d37b958b-b8e2-4ba1-b4ef-836e6b7fa757
20462	20462	0	GBIF France	da44cd31-5901-4687-a106-6d1c7734ee3a	d4f0993a-0f72-445e-8d5c-1b685e5268b1
882	882	0	Colombian Biodiversity Information System	7e865cba-7c46-417b-ade5-97f2cf5b7be0	d628bc9c-af63-49af-91b3-1a63c603feb2
22056	22135	79	National Biodiversity Network	d897a5b9-35ee-4232-94bd-b0bcaac003c2	d75b0b4c-8f43-4bc2-8bcd-65f9e5419cd1
115816	116647	831	U.S. Geological Survey	8618c64a-93e0-4300-b546-7249e5148ed2	d883d764-4522-4928-bdf7-4d6f0aae2ebd
7819	7819	0	National Biodiversity Network	d897a5b9-35ee-4232-94bd-b0bcaac003c2	d982bcd7-6300-43e7-9405-fa9335b8734b
10	10	0	GBIF France	da44cd31-5901-4687-a106-6d1c7734ee3a	db464f25-7ef9-4443-bf8b-397b8cda9a5b
0	56	56	Plazi	ffb07bec-2d10-492d-9c37-361fe0b79427	de3f1cea-8299-48d1-9fde-59b5288ae133
5934	6020	86	GBIF Germany	4f6826f2-4ff6-443d-b966-e6913bd24013	e0944feb-399e-4f96-b2da-9ad951940319
147	147	0	Participant Node Managers Committee	7f48e0c8-5c96-49ec-b972-30748e339115	e0b0e8e5-9be5-4639-b7b2-04d35f4c8d7a
79	79	0	Participant Node Managers Committee	7f48e0c8-5c96-49ec-b972-30748e339115	e2627a73-eaf8-41b9-9b0b-32e3127c8b24
1195	1195	0	Participant Node Managers Committee	7f48e0c8-5c96-49ec-b972-30748e339115	e386d77e-4713-4289-bd01-6d0115c718ed
0	39	39	Plazi	ffb07bec-2d10-492d-9c37-361fe0b79427	e6fe093f-6002-4668-ae64-b656f2f7acfc
0	9	9	Plazi	ffb07bec-2d10-492d-9c37-361fe0b79427	e73279a5-890a-4d06-8ffd-0aace8c00699
149	149	0	Plazi	ffb07bec-2d10-492d-9c37-361fe0b79427	eadd473a-210b-4c1f-a99d-0eb373d15b12
481	481	0	GBIF Norway	4f829580-180d-46a9-9c87-ed8ec959b545	ef2ce669-2030-40a9-95a8-5dc0b6e991ad
11	11	0	Plazi	ffb07bec-2d10-492d-9c37-361fe0b79427	f033f07a-e903-4e39-81d4-2e9a157ac80d
0	423	423	Colombian Biodiversity Information System	7e865cba-7c46-417b-ade5-97f2cf5b7be0	f149579d-5d5a-4555-8076-8193b55e7622
2036	2036	0	GBIF France	da44cd31-5901-4687-a106-6d1c7734ee3a	f1dad6ba-2804-4bac-bdb2-6fa99bff3438
330	330	0	GBIF France	da44cd31-5901-4687-a106-6d1c7734ee3a	f20748c6-79ca-4960-94ae-7794724184b3
690	690	0	Colombian Biodiversity Information System	7e865cba-7c46-417b-ade5-97f2cf5b7be0	f96de520-5afe-456b-bf62-781a9aca5b62
0	24	24	Plazi	ffb07bec-2d10-492d-9c37-361fe0b79427	fbc38e16-4a9a-45f7-979f-6dc20164cfe1
29002	29002	0	GBIF France	da44cd31-5901-4687-a106-6d1c7734ee3a	fbf2c8a9-1f63-4a48-a85e-96e5641f3cc8
98	98	0	National Biodiversity Network	d897a5b9-35ee-4232-94bd-b0bcaac003c2	fc8c35b2-cf16-48c0-98cb-472c02452d4c
58	58	0	GBIF France	da44cd31-5901-4687-a106-6d1c7734ee3a	fca94eef-fe48-4d02-ac0e-f5d1952ed585
12557	12557	0	GBIF Brazil	cdc9736d-5ff7-4ece-9959-3c744360cdb3	fd99455d-f6e9-4421-930a-5d8e23ac8895
3275	3275	0	Belgian Biodiversity Platform	fb11cfe1-ebc3-45af-9159-17d9fddbcdac	ffc954a1-37af-4e01-a27b-2b4eb962b8d6
213	213	0	Plazi	ffb07bec-2d10-492d-9c37-361fe0b79427	0338721f-219b-4d7b-a594-428411e71a4b
7	61	54	Plazi	ffb07bec-2d10-492d-9c37-361fe0b79427	03e88831-a213-4bc4-bc1b-e6a88922a07a
0	2	2	Plazi	ffb07bec-2d10-492d-9c37-361fe0b79427	0bf4d7bf-57b7-459c-afa6-5781e3e40b19
21040	21040	0	Atlas of Living Australia	4a6f1b71-969e-4fc5-a693-282b05e1220c	0c56af33-2b10-48af-a87b-f67b6881f036
15	15	0	Colombian Biodiversity Information System	7e865cba-7c46-417b-ade5-97f2cf5b7be0	0d0493f6-4594-48eb-b5b8-1a94da5774d7
0	889	889	Ocean Biodiversity Information System	ba0670b9-4186-41e6-8e70-f9cb3065551a	0e448783-fb63-4086-b02f-9d1ff4938999
5539	5539	0	Biodiversity Information System of Mexico	b324e8e9-9a4c-44fa-8f1a-7f39ea7ab576	11ba17b8-e67f-4f1e-b515-e042c77c975a
6	6	0	Plazi	ffb07bec-2d10-492d-9c37-361fe0b79427	12425c73-75f8-47da-ad1d-72ccbdc74a06
2	2	0	Plazi	ffb07bec-2d10-492d-9c37-361fe0b79427	1286a634-cdea-4d61-819c-42412405e464
579543	579542	-1	National Biodiversity Network	d897a5b9-35ee-4232-94bd-b0bcaac003c2	139a966c-22d5-486b-bff2-cfcbccd6fdfc
4578	4578	0	Polish Biodiversity Information Network	2618bfdf-e194-4911-a241-80db3107bc51	139c8540-af9e-11db-ad75-b8a03c50a862
0	592	592	Colombian Biodiversity Information System	7e865cba-7c46-417b-ade5-97f2cf5b7be0	1501f034-2ca9-448a-8af1-ecaa2bd9c5af
1	1	0	Plazi	ffb07bec-2d10-492d-9c37-361fe0b79427	165ea80b-8e54-4f9d-a9c5-3dc78113ef06
0	279	279	Ocean Biodiversity Information System	ba0670b9-4186-41e6-8e70-f9cb3065551a	17aaf1d7-cc78-4a60-a60c-9d219e883ee7
5149	5149	0	GBIF France	da44cd31-5901-4687-a106-6d1c7734ee3a	1a5dcdf5-099e-4997-a2c4-f4d758dcaf86
4	4	0	Plazi	ffb07bec-2d10-492d-9c37-361fe0b79427	1b212615-715f-4bad-9944-a99f8236968a
0	3	3	Plazi	ffb07bec-2d10-492d-9c37-361fe0b79427	1b44ba27-cdae-4f1d-a468-41d64273cfe6
0	7	7	Plazi	ffb07bec-2d10-492d-9c37-361fe0b79427	1d13c817-eda1-4754-a5ab-fb676c04f44f
1298346	1298346	0	Belgian Biodiversity Platform	fb11cfe1-ebc3-45af-9159-17d9fddbcdac	1f968e89-ca96-4065-91a5-4858e736b5aa
0	46	46	Plazi	ffb07bec-2d10-492d-9c37-361fe0b79427	20b63e1c-aaa6-4477-9a94-d7acd27c44ed
7	7	0	GBIF France	da44cd31-5901-4687-a106-6d1c7734ee3a	220f93b6-7807-4641-aaaf-12cf27f908d5
0	46157	46157	Ocean Biodiversity Information System	ba0670b9-4186-41e6-8e70-f9cb3065551a	234705c5-8f3a-4245-a614-b326e7fa1160
0	8	8	Plazi	ffb07bec-2d10-492d-9c37-361fe0b79427	2418bda1-eab8-477d-bb83-cd700f3e8968
1004	1004	0	Taiwan Biodiversity Information Facility	e1b85abc-61f9-430f-ba79-6813dec53a0f	26ae0930-98a1-11de-b4da-b8a03c50a862
6	6	0	Plazi	ffb07bec-2d10-492d-9c37-361fe0b79427	29129c4b-dafa-4253-ae11-ccaf34c157fb
9723	9723	0	Belgian Biodiversity Platform	fb11cfe1-ebc3-45af-9159-17d9fddbcdac	29719761-2d0e-4fef-bfcb-764b20c07d40
0	4	4	Plazi	ffb07bec-2d10-492d-9c37-361fe0b79427	2aa2e5db-10d4-498c-9ea4-ccec394460fd
4	4	0	Plazi	ffb07bec-2d10-492d-9c37-361fe0b79427	2be87c77-f417-48ed-bb1c-3fe9fca4d1e5
0	17	17	Plazi	ffb07bec-2d10-492d-9c37-361fe0b79427	2bf4f379-5024-4616-b7b7-a48103cb63bf
111	111	0	GBIF Germany	4f6826f2-4ff6-443d-b966-e6913bd24013	3157c070-61c6-4b04-ae61-c6357ce56bc0
0	1	1	Plazi	ffb07bec-2d10-492d-9c37-361fe0b79427	31872afa-34e2-48c8-800a-43acaeaf071c
210	210	0	Belgian Biodiversity Platform	fb11cfe1-ebc3-45af-9159-17d9fddbcdac	322f41ce-1e12-494a-98ea-af94241b09ed
0	3	3	Plazi	ffb07bec-2d10-492d-9c37-361fe0b79427	33068f08-e0ae-4faf-98ff-4c0c27a72323
2061	2061	0	GBIF France	da44cd31-5901-4687-a106-6d1c7734ee3a	33c95d96-d331-45c7-9134-42f0c5b3f128
13	13	0	Plazi	ffb07bec-2d10-492d-9c37-361fe0b79427	34454274-40ad-4ffe-a9eb-2fff726cba19
124	124	0	Participant Node Managers Committee	7f48e0c8-5c96-49ec-b972-30748e339115	34f447ee-6521-4e05-b7d5-f18540a9648d
8	8	0	Plazi	ffb07bec-2d10-492d-9c37-361fe0b79427	375c7e7b-e311-47c3-9599-f0e16d227889
262	262	0	Plazi	ffb07bec-2d10-492d-9c37-361fe0b79427	3b74fc4d-1008-4903-90df-59d68431dee1
31	31	0	GBIF Brazil	cdc9736d-5ff7-4ece-9959-3c744360cdb3	3c696c65-7e28-4d7f-a4e0-5710940e218c
27976	27976	0	GBIF France	da44cd31-5901-4687-a106-6d1c7734ee3a	3c8e9d07-5b4b-4859-928f-a607e3b4c1a6
905	905	0	Participant Node Managers Committee	7f48e0c8-5c96-49ec-b972-30748e339115	41094690-06f2-482d-a9e3-a1791295e6ed
0	1608	1608	Ocean Biodiversity Information System	ba0670b9-4186-41e6-8e70-f9cb3065551a	464d44ef-4a87-4bd2-a7bd-8b42f30efb79
375	375	0	GBIF Germany	4f6826f2-4ff6-443d-b966-e6913bd24013	46c9d9a2-f8f8-48fd-b90c-412fc635dd61
38398	38398	0	Ghana Biodiversity Information Facility	b5633b75-6a86-4fdf-9cfc-506047fb9dc7	480d9ab0-c682-4cd6-ba78-38cf9ef91087
1597	1773	176	Participant Node Managers Committee	7f48e0c8-5c96-49ec-b972-30748e339115	4aaea622-6d97-44e9-841f-f7733df3008e
2	2	0	Plazi	ffb07bec-2d10-492d-9c37-361fe0b79427	4dceabff-2359-4742-a2ee-b8986cbb848f
0	7	7	Plazi	ffb07bec-2d10-492d-9c37-361fe0b79427	5005f199-6b71-47db-b042-dfb81c9ae255
0	4	4	Plazi	ffb07bec-2d10-492d-9c37-361fe0b79427	506046e6-8d7d-4b62-bae6-8df164bc5c92
25	25	0	Plazi	ffb07bec-2d10-492d-9c37-361fe0b79427	5101dbd6-06ac-4b6e-991e-b66eec55ca52
265	265	0	Belgian Biodiversity Platform	fb11cfe1-ebc3-45af-9159-17d9fddbcdac	519b48ff-7fcc-40d1-9ae0-28e11c8b13ad
0	26	26	Plazi	ffb07bec-2d10-492d-9c37-361fe0b79427	52e55c02-45c3-498b-9537-3d93c79153fc
6000	6000	0	GBIF Japan	db5705aa-6a6e-42f1-8942-d77b9f4896ea	53cdf22c-18f5-11e2-98fb-00145eb45e9a
3951	3951	0	GBIF Brazil	cdc9736d-5ff7-4ece-9959-3c744360cdb3	56b468fd-055c-4610-b605-09d8a54fdf4b
3	3	0	Plazi	ffb07bec-2d10-492d-9c37-361fe0b79427	59f281d4-3cb7-435e-872d-9150d7063a12
20	20	0	Plazi	ffb07bec-2d10-492d-9c37-361fe0b79427	5aec6dee-083f-4370-94d0-5d2933d80efb
66	66	0	GBIF Germany	4f6826f2-4ff6-443d-b966-e6913bd24013	6189355c-f762-11e1-a439-00145eb45e9a
48	48	0	GBIF Germany	4f6826f2-4ff6-443d-b966-e6913bd24013	62863dd2-21ad-4969-877c-5a73739446c9
37014	37014	0	GBIF Spain	1f94b3ca-9345-4d65-afe2-4bace93aa0fe	63656de6-f762-11e1-a439-00145eb45e9a
1	1	0	Plazi	ffb07bec-2d10-492d-9c37-361fe0b79427	63e22a0c-a433-4d6a-97fc-d16d175fb3fd
36	36	0	GBIF Germany	4f6826f2-4ff6-443d-b966-e6913bd24013	64efede4-f762-11e1-a439-00145eb45e9a
123	119	-4	GBIF Germany	4f6826f2-4ff6-443d-b966-e6913bd24013	64fc0ae8-f762-11e1-a439-00145eb45e9a
23	21	-2	GBIF Germany	4f6826f2-4ff6-443d-b966-e6913bd24013	65d3a8b8-f762-11e1-a439-00145eb45e9a
21	21	0	GBIF Germany	4f6826f2-4ff6-443d-b966-e6913bd24013	6689acb2-f762-11e1-a439-00145eb45e9a
362	399	37	National Biodiversity Network	d897a5b9-35ee-4232-94bd-b0bcaac003c2	67d09fb3-c92e-45c2-ba85-fa3b3fa5d225
18589	18589	0	National Biodiversity Network	d897a5b9-35ee-4232-94bd-b0bcaac003c2	69661202-fd09-450f-9261-0ca585c08b18
321	321	0	GBIF Germany	4f6826f2-4ff6-443d-b966-e6913bd24013	6a743e14-f762-11e1-a439-00145eb45e9a
18	18	0	GBIF Germany	4f6826f2-4ff6-443d-b966-e6913bd24013	6b8fa428-f762-11e1-a439-00145eb45e9a
8	8	0	GBIF Germany	4f6826f2-4ff6-443d-b966-e6913bd24013	6bc9bd16-f762-11e1-a439-00145eb45e9a
202	202	0	GBIF Germany	4f6826f2-4ff6-443d-b966-e6913bd24013	6c15366a-f762-11e1-a439-00145eb45e9a
0	6	6	Ocean Biodiversity Information System	ba0670b9-4186-41e6-8e70-f9cb3065551a	6f8a53c0-1c1d-4f94-b4c7-58003fa1c73d
4050	4050	0	U.S. Geological Survey	8618c64a-93e0-4300-b546-7249e5148ed2	71315e6b-727f-4e71-91db-8823fe06ba22
123745	123745	0	Polish Biodiversity Information Network	2618bfdf-e194-4911-a241-80db3107bc51	72453ca0-328a-11df-855a-b8a03c50a862
1170	1170	0	GBIF Germany	4f6826f2-4ff6-443d-b966-e6913bd24013	73b4e3e9-30e7-4e7c-bde1-9382d5fae314
5406	5406	0	Biodiversity Information System of Mexico	b324e8e9-9a4c-44fa-8f1a-7f39ea7ab576	76b037ce-a73f-4bff-856d-ad605f9539e1
265	265	0	GBIF Germany	4f6826f2-4ff6-443d-b966-e6913bd24013	79d5e34e-f762-11e1-a439-00145eb45e9a
4292	1450	-2842	GBIF Germany	4f6826f2-4ff6-443d-b966-e6913bd24013	79ef2cf0-f762-11e1-a439-00145eb45e9a
21	21	0	Plazi	ffb07bec-2d10-492d-9c37-361fe0b79427	7aefcfef-1683-4ec4-999c-653125272f1e
206	206	0	GBIF Germany	4f6826f2-4ff6-443d-b966-e6913bd24013	7bec1a68-f762-11e1-a439-00145eb45e9a
0	2	2	Plazi	ffb07bec-2d10-492d-9c37-361fe0b79427	7c173c23-22cf-44c9-936c-7f9aedbb9a87
764	764	0	GBIF Germany	4f6826f2-4ff6-443d-b966-e6913bd24013	7c29bf1c-f762-11e1-a439-00145eb45e9a
12663	3402	-9261	GBIF Germany	4f6826f2-4ff6-443d-b966-e6913bd24013	7cea7040-f762-11e1-a439-00145eb45e9a
1418	1418	0	GBIF Germany	4f6826f2-4ff6-443d-b966-e6913bd24013	7d147138-f762-11e1-a439-00145eb45e9a
2572	2572	0	GBIF Germany	4f6826f2-4ff6-443d-b966-e6913bd24013	7ead8c28-f762-11e1-a439-00145eb45e9a
246	246	0	Biodiversity Information System of Mexico	b324e8e9-9a4c-44fa-8f1a-7f39ea7ab576	7f6b3fe8-f762-11e1-a439-00145eb45e9a
37971	37971	0	Biodiversity Information System of Mexico	b324e8e9-9a4c-44fa-8f1a-7f39ea7ab576	804a818f-c1e8-4347-a2f2-02a5f22e1a82
62	62	0	GBIF Germany	4f6826f2-4ff6-443d-b966-e6913bd24013	81800e08-f762-11e1-a439-00145eb45e9a
2783	2783	0	GBIF Germany	4f6826f2-4ff6-443d-b966-e6913bd24013	81ef4b4c-f762-11e1-a439-00145eb45e9a
282	282	0	GBIF Germany	4f6826f2-4ff6-443d-b966-e6913bd24013	8287e6a4-f762-11e1-a439-00145eb45e9a
0	29	29	Plazi	ffb07bec-2d10-492d-9c37-361fe0b79427	8389bc68-68da-4a1e-b8ed-b2b65f252a5e
1158	1158	0	National Biodiversity Network	d897a5b9-35ee-4232-94bd-b0bcaac003c2	85e38c14-c3d4-4f16-b1dc-5cf0f5b601c8
212	212	0	GBIF Germany	4f6826f2-4ff6-443d-b966-e6913bd24013	88361aee-f762-11e1-a439-00145eb45e9a
0	32272	32272	National Biodiversity Network	d897a5b9-35ee-4232-94bd-b0bcaac003c2	8898e990-9d39-4871-9e6e-d1031c19e24b
6702	6702	0	Ocean Biodiversity Information System	ba0670b9-4186-41e6-8e70-f9cb3065551a	891e34fa-f762-11e1-a439-00145eb45e9a
298	298	0	GBIF Germany	4f6826f2-4ff6-443d-b966-e6913bd24013	89b4d964-f762-11e1-a439-00145eb45e9a
21901	21901	0	National Biodiversity Network	d897a5b9-35ee-4232-94bd-b0bcaac003c2	89cc7735-d79d-4540-a1e9-f5f863bc741b
369	369	0	GBIF Spain	1f94b3ca-9345-4d65-afe2-4bace93aa0fe	8bc91053-37d2-4e60-a0b3-33253ad77be8
42	31	-11	GBIF Germany	4f6826f2-4ff6-443d-b966-e6913bd24013	8ccf69ca-f762-11e1-a439-00145eb45e9a
0	17	17	Plazi	ffb07bec-2d10-492d-9c37-361fe0b79427	8d95b5c7-593d-47cb-bb21-2dac07f364dc
650	594	-56	GBIF Germany	4f6826f2-4ff6-443d-b966-e6913bd24013	8d970dc2-f762-11e1-a439-00145eb45e9a
0	13709	13709	Participant Node Managers Committee	7f48e0c8-5c96-49ec-b972-30748e339115	8ee10704-0472-4b5b-aa95-99748552c09c
104	104	0	GBIF Germany	4f6826f2-4ff6-443d-b966-e6913bd24013	8f7fc03e-f762-11e1-a439-00145eb45e9a
142	40	-102	GBIF Germany	4f6826f2-4ff6-443d-b966-e6913bd24013	908f8586-f762-11e1-a439-00145eb45e9a
219	170	-49	GBIF Germany	4f6826f2-4ff6-443d-b966-e6913bd24013	90be411e-f762-11e1-a439-00145eb45e9a
7	7	0	GBIF Germany	4f6826f2-4ff6-443d-b966-e6913bd24013	928acb2a-f762-11e1-a439-00145eb45e9a
0	315	315	Plazi	ffb07bec-2d10-492d-9c37-361fe0b79427	9293a8f6-632e-45b7-a93e-901d352136e2
56	58	2	GBIF Germany	4f6826f2-4ff6-443d-b966-e6913bd24013	9337348c-f762-11e1-a439-00145eb45e9a
132	132	0	GBIF Germany	4f6826f2-4ff6-443d-b966-e6913bd24013	9466f762-b822-4244-8df1-250675ffdb42
22127	22127	0	Colombian Biodiversity Information System	7e865cba-7c46-417b-ade5-97f2cf5b7be0	94687f6b-6723-46a3-90d8-5a06b843291c
1285	1285	0	GBIF Germany	4f6826f2-4ff6-443d-b966-e6913bd24013	9589146c-f762-11e1-a439-00145eb45e9a
32916	32916	0	GBIF Japan	db5705aa-6a6e-42f1-8942-d77b9f4896ea	95f3ad86-f762-11e1-a439-00145eb45e9a
429	429	0	GBIF Germany	4f6826f2-4ff6-443d-b966-e6913bd24013	967d2f7a-f762-11e1-a439-00145eb45e9a
514	514	0	GBIF Germany	4f6826f2-4ff6-443d-b966-e6913bd24013	979bd8fc-f762-11e1-a439-00145eb45e9a
15839	23220	7381	National Biodiversity Network	d897a5b9-35ee-4232-94bd-b0bcaac003c2	97f3592b-08ab-4adb-85df-1fb3bee7e2d3
2	2	0	Plazi	ffb07bec-2d10-492d-9c37-361fe0b79427	988f5dba-ba7a-469a-8f4c-1070894ca744
0	43	43	Plazi	ffb07bec-2d10-492d-9c37-361fe0b79427	9d5d9cb4-e64f-4402-981a-7844a361f562
39975	39975	0	Polish Biodiversity Information Network	2618bfdf-e194-4911-a241-80db3107bc51	9df23d30-2fe8-11de-816f-b8a03c50a862
1	1	0	Plazi	ffb07bec-2d10-492d-9c37-361fe0b79427	9f2d3df4-4e93-492d-ba3f-ebf1e510fb9c
201	201	0	GBIF France	da44cd31-5901-4687-a106-6d1c7734ee3a	9f99cb9b-236c-49e3-a7a1-6bc23bc4e951
2	2	0	Plazi	ffb07bec-2d10-492d-9c37-361fe0b79427	9fa831b1-03e8-4a51-90c6-106a36c7b577
0	3	3	Ocean Biodiversity Information System	ba0670b9-4186-41e6-8e70-f9cb3065551a	a10a5abc-a591-426f-a810-bd080ce82492
7	7	0	Plazi	ffb07bec-2d10-492d-9c37-361fe0b79427	a2ee1617-c0db-4c1d-9c75-728dabad2570
0	5774	5774	Korean Biodiversity Information Facility	e0a1e772-0177-4800-94b4-2d023fe6cdf4	a332915e-9950-4747-ab3b-b7eeafaf46d8
0	3	3	Plazi	ffb07bec-2d10-492d-9c37-361fe0b79427	a4edc281-0cb2-4c24-b652-aa6157ac84af
13	13	0	Plazi	ffb07bec-2d10-492d-9c37-361fe0b79427	a67ce252-db1c-4820-82f4-efeb6dcc4986
15132	15132	0	South African Biodiversity Information Facility	7190b835-4e86-4b6e-85c1-19cc6677c250	a7a2e528-e053-484d-9e2f-41bb3ea02c70
282	282	0	Biodiversity Information System of Mexico	b324e8e9-9a4c-44fa-8f1a-7f39ea7ab576	a7b1561d-9de4-49b2-bbf6-5e9fbf93ec8f
139	139	0	Plazi	ffb07bec-2d10-492d-9c37-361fe0b79427	a7bd64b9-5e3b-413f-afba-182b6918ea52
126	126	0	GBIF France	da44cd31-5901-4687-a106-6d1c7734ee3a	aabe45aa-8827-4450-b5ca-db92acb7d420
5	5	0	GBIF France	da44cd31-5901-4687-a106-6d1c7734ee3a	ac9d53a1-2f03-4c53-a7ac-5366e0c77ae8
0	1	1	Plazi	ffb07bec-2d10-492d-9c37-361fe0b79427	acfb2b8b-e63c-4a3f-9405-058f5f59e8c1
899	899	0	Biodiversity Information System of Mexico	b324e8e9-9a4c-44fa-8f1a-7f39ea7ab576	adac482f-a6d8-4873-94fe-acec052b92b7
75	75	0	Plazi	ffb07bec-2d10-492d-9c37-361fe0b79427	adb481c6-818e-4b30-9f1b-a87253bac7de
1632	1632	0	Colombian Biodiversity Information System	7e865cba-7c46-417b-ade5-97f2cf5b7be0	aeae59af-613f-444a-ae46-5a6de1374ed8
0	2	2	Plazi	ffb07bec-2d10-492d-9c37-361fe0b79427	b357bcc3-b5dd-4dd6-820d-85f57ca0e322
91131	91470	339	Netherlands Biodiversity Information Facility	0909d601-bda2-42df-9e63-a6d51847ebce	b4aad9c3-518b-4550-82de-c70a7ead1b64
46456	47340	884	GBIF Japan	db5705aa-6a6e-42f1-8942-d77b9f4896ea	b63a7193-0c48-4648-a728-086157f26373
1003	1003	0	GBIF France	da44cd31-5901-4687-a106-6d1c7734ee3a	b6e40b0d-69c0-4cb0-aabc-0a74fe2a06cf
0	26	26	Plazi	ffb07bec-2d10-492d-9c37-361fe0b79427	b747ea78-172a-4a23-9de5-af6ff3a03949
26	26	0	Plazi	ffb07bec-2d10-492d-9c37-361fe0b79427	baa2e115-a82b-41d6-adf0-23c47aaa7a0c
0	20	20	Plazi	ffb07bec-2d10-492d-9c37-361fe0b79427	be0a349a-c2bc-47fc-84ce-c08167b3d91c
1314	1314	0	National Biodiversity Network	d897a5b9-35ee-4232-94bd-b0bcaac003c2	c2482d47-0d65-4ce7-80af-1d4bb2aa2e63
4454	4454	0	GBIF France	da44cd31-5901-4687-a106-6d1c7734ee3a	c29ce28f-e45f-41b0-bb75-5961a3c013cf
1	1	0	Plazi	ffb07bec-2d10-492d-9c37-361fe0b79427	c53b46bf-c613-464b-ac44-e90d23c53de0
7	7	0	Plazi	ffb07bec-2d10-492d-9c37-361fe0b79427	c8ee1c0b-5b75-4ec3-9567-4e4f51ce0f93
36	36	0	Participant Node Managers Committee	7f48e0c8-5c96-49ec-b972-30748e339115	c9c0bc17-9def-4413-bcd0-2aaf7f6bfe2d
776	776	0	GBIF France	da44cd31-5901-4687-a106-6d1c7734ee3a	cac1073a-b151-48d7-968c-107a70018e50
186	186	0	GBIF Germany	4f6826f2-4ff6-443d-b966-e6913bd24013	d22d631a-70fa-471c-a78d-557ad5fcfcee
7	7	0	Plazi	ffb07bec-2d10-492d-9c37-361fe0b79427	d2f92698-5e17-472a-b73b-90c76705b4ce
513	513	0	GBIF France	da44cd31-5901-4687-a106-6d1c7734ee3a	d369c0de-0e0d-48c0-8c96-d4374b7c6e8b
105	105	0	GBIF France	da44cd31-5901-4687-a106-6d1c7734ee3a	d3d28a3d-b154-48f1-8f76-4ffdf80dce79
1	1	0	Plazi	ffb07bec-2d10-492d-9c37-361fe0b79427	d60d75c7-b209-4f2d-af2c-ca36ea241d0a
1	1	0	Plazi	ffb07bec-2d10-492d-9c37-361fe0b79427	d7bc2a71-cb55-464e-af0b-533efae08e61
9	9	0	Plazi	ffb07bec-2d10-492d-9c37-361fe0b79427	d7db31d3-66e4-455f-af22-f3b94aedcd02
0	200	200	GBIF Japan	db5705aa-6a6e-42f1-8942-d77b9f4896ea	d9bcb743-50b0-4329-9ac2-6dd0ca90a81c
0	4166	4166	Colombian Biodiversity Information System	7e865cba-7c46-417b-ade5-97f2cf5b7be0	d9bdb14b-ca90-413e-a8a4-d30fcba7a8ac
14	14	0	Plazi	ffb07bec-2d10-492d-9c37-361fe0b79427	db6c6c7c-c002-46d7-96ea-4abb7a092d94
0	189	189	Ocean Biodiversity Information System	ba0670b9-4186-41e6-8e70-f9cb3065551a	dbc1e610-6cbc-493c-9aa9-e703acdda569
0	31	31	Plazi	ffb07bec-2d10-492d-9c37-361fe0b79427	dec5a3ea-456f-48d8-afd1-0df0a71cab5f
292	292	0	Plazi	ffb07bec-2d10-492d-9c37-361fe0b79427	e08d29be-bf57-4679-9597-664602793878
13	13	0	Plazi	ffb07bec-2d10-492d-9c37-361fe0b79427	e5bdc7a9-35fd-48ea-bcf6-3ffb57f3bf6e
33	33	0	Plazi	ffb07bec-2d10-492d-9c37-361fe0b79427	e5e50995-178e-4a41-b636-7f54f566d5a3
0	2	2	Plazi	ffb07bec-2d10-492d-9c37-361fe0b79427	e7a61917-af46-4d25-923e-612303ca8146
0	1	1	Ocean Biodiversity Information System	ba0670b9-4186-41e6-8e70-f9cb3065551a	eaa2a20e-5aa0-4706-a095-8f85872fc12d
2	2	0	Plazi	ffb07bec-2d10-492d-9c37-361fe0b79427	ee206430-d008-4be3-b200-5aa1cb894d12
0	9	9	Plazi	ffb07bec-2d10-492d-9c37-361fe0b79427	ef652e8a-cac3-4340-b7cd-24bd70881d36
280	280	0	Plazi	ffb07bec-2d10-492d-9c37-361fe0b79427	f3128a32-5f0b-413e-a755-c859bdd7cac4
71	71	0	Plazi	ffb07bec-2d10-492d-9c37-361fe0b79427	f3540a81-fcbe-4ed4-84cf-7947a37b4a0d
8009	8009	0	U.S. Geological Survey	8618c64a-93e0-4300-b546-7249e5148ed2	f3af5cc9-4d39-4125-8739-2bbe5cf9d9cc
5361	5361	0	National Biodiversity Network	d897a5b9-35ee-4232-94bd-b0bcaac003c2	f4f5a6d7-38a5-463b-b017-64dfdd996703
0	1725	1725	Ocean Biodiversity Information System	ba0670b9-4186-41e6-8e70-f9cb3065551a	f5037e6b-b9d8-41a1-a6d3-57bf8731c410
2	2	0	Plazi	ffb07bec-2d10-492d-9c37-361fe0b79427	f5a15d8e-628b-4021-bf53-f50ff9c29471
0	1039	1039	Participant Node Managers Committee	7f48e0c8-5c96-49ec-b972-30748e339115	f6ae547f-2dc3-44be-973d-5839b3de38ff
136	136	0	Participant Node Managers Committee	7f48e0c8-5c96-49ec-b972-30748e339115	f80e23f1-0a5f-47b7-bdd3-f3418fcb978a
34	34	0	Secretariat of the Pacific Regional Environment Programme	29c6a139-ea7f-41f5-8d9b-c55af8736182	ffa7390a-800c-4b37-8081-e5352e0310c7
9461	9461	0	GBIF Japan	db5705aa-6a6e-42f1-8942-d77b9f4896ea	01981814-35ca-4637-bba8-90ab22f2b68e
70	70	0	GBIF Germany	4f6826f2-4ff6-443d-b966-e6913bd24013	036ef194-2c63-4c6a-817e-da7724fe7737
0	5869	5869	Participant Node Managers Committee	7f48e0c8-5c96-49ec-b972-30748e339115	04209a70-813b-421a-a250-e893b8836cdc
80	80	0	GBIF France	da44cd31-5901-4687-a106-6d1c7734ee3a	0528ea89-25f6-4a00-9377-8adf7dee85c9
41	41	0	Plazi	ffb07bec-2d10-492d-9c37-361fe0b79427	054f8a30-6b79-4405-a8a7-88b845b49810
0	145	145	Participant Node Managers Committee	7f48e0c8-5c96-49ec-b972-30748e339115	062b1492-5e8a-4b56-89f9-300bc06bba5d
4	4	0	Plazi	ffb07bec-2d10-492d-9c37-361fe0b79427	072201b8-a4ea-48e3-8ea1-5d64551dc1ca
0	19	19	Plazi	ffb07bec-2d10-492d-9c37-361fe0b79427	0c254d68-ecca-4d6b-8e01-1df4ca45067b
69	69	0	GBIF Guinea	b1cd2e84-c4ba-47bd-b72a-dfd1f92dce0a	0c9d91f6-3a2a-4165-9156-1351cbb80ffd
7166	7166	0	National Biodiversity Network	d897a5b9-35ee-4232-94bd-b0bcaac003c2	14bd39f8-5aa6-436a-bd2d-3c5d22d85ba0
0	338	338	Participant Node Managers Committee	7f48e0c8-5c96-49ec-b972-30748e339115	157e04c8-56da-40f1-8b7e-e80c22847fe9
12	12	0	Plazi	ffb07bec-2d10-492d-9c37-361fe0b79427	1b1b7974-aec6-43ee-bc48-466801d65d87
0	13	13	Ocean Biodiversity Information System	ba0670b9-4186-41e6-8e70-f9cb3065551a	1d5d4dac-6c75-45ad-9f7b-6d9baf9b01a4
31	31	0	Plazi	ffb07bec-2d10-492d-9c37-361fe0b79427	1ee5bf08-e1a1-4944-894f-d0f45a4de58f
106	106	0	Plazi	ffb07bec-2d10-492d-9c37-361fe0b79427	1f6411fd-3533-4020-9ee4-f9fbee09fccf
226	226	0	Colombian Biodiversity Information System	7e865cba-7c46-417b-ade5-97f2cf5b7be0	1fce980b-33fd-4fd6-b07c-3cf2557bf6aa
15	16	1	Plazi	ffb07bec-2d10-492d-9c37-361fe0b79427	21448e82-1f58-4c25-b0a0-9de956b3730c
0	130	130	Plazi	ffb07bec-2d10-492d-9c37-361fe0b79427	2185a8cf-c15c-448b-b8c0-6055976408ed
15324	15324	0	GBIF Brazil	cdc9736d-5ff7-4ece-9959-3c744360cdb3	22331d58-4a7e-40da-b7db-652a4d4d85ed
0	218	218	GBIF Portugal	673f7038-4262-4149-b753-5658a4e912f6	2292e622-129e-4c66-9ad6-fccaa377ff58
50317	50317	0	U.S. Geological Survey	8618c64a-93e0-4300-b546-7249e5148ed2	22a66350-7947-4a49-84a3-39c7c1b0881f
14	14	0	Plazi	ffb07bec-2d10-492d-9c37-361fe0b79427	241b13c8-b7d2-4c2b-872d-19565f9e0a98
0	2	2	Plazi	ffb07bec-2d10-492d-9c37-361fe0b79427	24409d90-4351-4189-a4f1-d8c5af49b3a1
5	5	0	Plazi	ffb07bec-2d10-492d-9c37-361fe0b79427	2449fffb-a3de-4c10-8e38-b01781cff14f
1197	1197	0	National Biodiversity Network	d897a5b9-35ee-4232-94bd-b0bcaac003c2	25d08a6f-2e51-4d1c-a318-d8c84b712a39
110	110	0	U.S. Geological Survey	8618c64a-93e0-4300-b546-7249e5148ed2	271b9b36-b060-4f97-b438-81edb970a1a0
445	445	0	Participant Node Managers Committee	7f48e0c8-5c96-49ec-b972-30748e339115	28638176-0c51-47a2-acf1-babd5bf37d4a
0	780	780	National Biodiversity Network	d897a5b9-35ee-4232-94bd-b0bcaac003c2	29c713af-3f97-4c0a-bb6d-c09c1cef5f72
4	4	0	Plazi	ffb07bec-2d10-492d-9c37-361fe0b79427	2bc5e28e-c045-49d7-aaf2-5f5be028eb21
102	102	0	Plazi	ffb07bec-2d10-492d-9c37-361fe0b79427	2d63505a-0e4b-43c6-b53f-ebcf2a34acaa
3131	3131	0	GBIF Norway	4f829580-180d-46a9-9c87-ed8ec959b545	2d6e90e5-b171-48d9-8487-4bdbcf57f81b
51	51	0	Plazi	ffb07bec-2d10-492d-9c37-361fe0b79427	2ecdbe19-cc16-45c9-894d-18a4d10d4bf6
155	155	0	Participant Node Managers Committee	7f48e0c8-5c96-49ec-b972-30748e339115	33fdde8c-6db5-452a-8e98-c7673f73312e
7	7	0	Plazi	ffb07bec-2d10-492d-9c37-361fe0b79427	345b45cf-7669-44b7-94a3-fe4e18e95fe8
0	12	12	Plazi	ffb07bec-2d10-492d-9c37-361fe0b79427	34c0b6e4-12a3-4470-8aa2-e632c4e8854f
1305	2194	889	GBIF Brazil	cdc9736d-5ff7-4ece-9959-3c744360cdb3	355179f1-4631-4ebc-b50d-d55361f8c465
0	28	28	Plazi	ffb07bec-2d10-492d-9c37-361fe0b79427	35ed0485-c0a7-41c0-b371-7a48d12a7463
0	5	5	Plazi	ffb07bec-2d10-492d-9c37-361fe0b79427	36dff7cf-f090-4af6-b63b-04b5dfa191e7
19339	19339	0	GBIF France	da44cd31-5901-4687-a106-6d1c7734ee3a	37e09252-7afd-43fa-825a-9eef15614ad7
0	7	7	Plazi	ffb07bec-2d10-492d-9c37-361fe0b79427	3bb32f83-5659-4a46-a4ef-5ead6bf9e689
329	329	0	Colombian Biodiversity Information System	7e865cba-7c46-417b-ade5-97f2cf5b7be0	3eddefab-b0f5-4d68-83a6-ccc0d42c38ca
11392	7093	-4299	DanBIF - Danish Biodiversity Information Facility	4ddd294f-02b7-4359-ac33-0806a9ca9c6b	3ee7917c-6ef9-4cdf-8cc3-59e9407a07f4
6	6	0	Plazi	ffb07bec-2d10-492d-9c37-361fe0b79427	40f510ba-def0-4ae8-b66e-3946792fb874
1103	1103	0	Polish Biodiversity Information Network	2618bfdf-e194-4911-a241-80db3107bc51	421b56c0-925e-11da-8900-b8a03c50a862
3	3	0	Plazi	ffb07bec-2d10-492d-9c37-361fe0b79427	489a63e3-d128-47d3-9d7a-82a9abb9b1ac
57	57	0	GBIF Germany	4f6826f2-4ff6-443d-b966-e6913bd24013	49f98c46-d160-4279-9ca3-563dc2b04f45
12	12	0	Plazi	ffb07bec-2d10-492d-9c37-361fe0b79427	4dbd509c-9666-4c6c-b5f5-0cf6ad10d69d
2060	2060	0	Colombian Biodiversity Information System	7e865cba-7c46-417b-ade5-97f2cf5b7be0	4dd6694a-2b15-464e-ae46-3cfb683e821e
2000	2000	0	Colombian Biodiversity Information System	7e865cba-7c46-417b-ade5-97f2cf5b7be0	5065080a-77d9-4a2d-a3f8-e65da9add067
253	253	0	Colombian Biodiversity Information System	7e865cba-7c46-417b-ade5-97f2cf5b7be0	51dffaee-0316-4ca6-9afb-f27556d8990c
0	7	7	Plazi	ffb07bec-2d10-492d-9c37-361fe0b79427	54fa3a2c-717b-43fd-9867-502f84dc150c
0	5	5	Plazi	ffb07bec-2d10-492d-9c37-361fe0b79427	564a55c0-34ad-4397-9572-ac2aa896a26c
3	3	0	Participant Node Managers Committee	7f48e0c8-5c96-49ec-b972-30748e339115	5aa68ed2-0a6e-4498-97fc-928ffe0987a7
1	1	0	Plazi	ffb07bec-2d10-492d-9c37-361fe0b79427	5c7ac685-cee2-4349-b56f-bb16ea34bc8c
1	1	0	Plazi	ffb07bec-2d10-492d-9c37-361fe0b79427	61730d0a-43cf-4f74-9cd0-a037335f78f8
149	149	0	GBIF Germany	4f6826f2-4ff6-443d-b966-e6913bd24013	61aa3630-f762-11e1-a439-00145eb45e9a
0	7	7	Plazi	ffb07bec-2d10-492d-9c37-361fe0b79427	62e6c705-96fd-46a0-a409-c7efe8b8d6b9
1	1	0	Plazi	ffb07bec-2d10-492d-9c37-361fe0b79427	634b6578-935c-4a0c-8e91-4640c79dd7eb
11	11	0	Participant Node Managers Committee	7f48e0c8-5c96-49ec-b972-30748e339115	643d14c4-29be-4357-bbc6-ff2e5f88d55a
587	559	-28	GBIF Germany	4f6826f2-4ff6-443d-b966-e6913bd24013	656bf74a-f762-11e1-a439-00145eb45e9a
4	4	0	Plazi	ffb07bec-2d10-492d-9c37-361fe0b79427	6733bbfc-67f0-43f1-b308-49a15b68a6ab
7157	7157	0	GBIF France	da44cd31-5901-4687-a106-6d1c7734ee3a	673b73ba-6a6b-4d84-8b58-50d198bbc684
0	2	2	Plazi	ffb07bec-2d10-492d-9c37-361fe0b79427	67420812-8c80-46fa-892c-a4ba6d5af42a
3858	3858	0	GBIF France	da44cd31-5901-4687-a106-6d1c7734ee3a	6791fdf5-e9c4-430e-ac48-a5791462a969
171	171	0	GBIF Germany	4f6826f2-4ff6-443d-b966-e6913bd24013	6796ed22-f762-11e1-a439-00145eb45e9a
10386	10386	0	National Biodiversity Network	d897a5b9-35ee-4232-94bd-b0bcaac003c2	68675735-6211-4dbd-bc38-693d3d0b8051
123	123	0	GBIF Germany	4f6826f2-4ff6-443d-b966-e6913bd24013	6891837c-f762-11e1-a439-00145eb45e9a
355	355	0	GBIF Germany	4f6826f2-4ff6-443d-b966-e6913bd24013	6a3096f0-f762-11e1-a439-00145eb45e9a
24	24	0	GBIF Germany	4f6826f2-4ff6-443d-b966-e6913bd24013	6c0a860c-f762-11e1-a439-00145eb45e9a
1386	1386	0	Colombian Biodiversity Information System	7e865cba-7c46-417b-ade5-97f2cf5b7be0	6c59699b-4c6f-402a-b174-0c318c104e31
24	24	0	GBIF Germany	4f6826f2-4ff6-443d-b966-e6913bd24013	6c9163fc-f762-11e1-a439-00145eb45e9a
54	54	0	GBIF Germany	4f6826f2-4ff6-443d-b966-e6913bd24013	6cbd97a6-f762-11e1-a439-00145eb45e9a
176	176	0	GBIF Germany	4f6826f2-4ff6-443d-b966-e6913bd24013	6d233994-f762-11e1-a439-00145eb45e9a
50	50	0	GBIF Germany	4f6826f2-4ff6-443d-b966-e6913bd24013	6d33a6c6-f762-11e1-a439-00145eb45e9a
36	36	0	GBIF Germany	4f6826f2-4ff6-443d-b966-e6913bd24013	6d403c10-f762-11e1-a439-00145eb45e9a
0	4	4	Plazi	ffb07bec-2d10-492d-9c37-361fe0b79427	6ed20c9f-22ea-440d-bad9-2db6fe0527f3
85	85	0	GBIF Germany	4f6826f2-4ff6-443d-b966-e6913bd24013	7027757e-f762-11e1-a439-00145eb45e9a
1741	1648	-93	GBIF Germany	4f6826f2-4ff6-443d-b966-e6913bd24013	7100cd3c-4907-4d33-91dd-939e589d150b
61	61	0	GBIF Germany	4f6826f2-4ff6-443d-b966-e6913bd24013	72375dde-f762-11e1-a439-00145eb45e9a
452	452	0	GBIF Germany	4f6826f2-4ff6-443d-b966-e6913bd24013	7328e974-f762-11e1-a439-00145eb45e9a
9	9	0	GBIF Germany	4f6826f2-4ff6-443d-b966-e6913bd24013	7387b2e2-f762-11e1-a439-00145eb45e9a
67	67	0	Plazi	ffb07bec-2d10-492d-9c37-361fe0b79427	74c51265-8034-4952-ba33-b65a9d996897
1028	1028	0	GBIF Germany	4f6826f2-4ff6-443d-b966-e6913bd24013	752fc210-f762-11e1-a439-00145eb45e9a
13	13	0	GBIF Germany	4f6826f2-4ff6-443d-b966-e6913bd24013	75885b3c-f762-11e1-a439-00145eb45e9a
249	249	0	GBIF Germany	4f6826f2-4ff6-443d-b966-e6913bd24013	75c4ba8c-f762-11e1-a439-00145eb45e9a
124	124	0	Atlas of Living Australia	4a6f1b71-969e-4fc5-a693-282b05e1220c	76519c98-fdc6-4ed1-9355-0725f2f40793
307	307	0	GBIF Germany	4f6826f2-4ff6-443d-b966-e6913bd24013	7742601c-f762-11e1-a439-00145eb45e9a
2	2	0	GBIF Germany	4f6826f2-4ff6-443d-b966-e6913bd24013	787af174-f762-11e1-a439-00145eb45e9a
3	3	0	GBIF France	da44cd31-5901-4687-a106-6d1c7734ee3a	79266357-23f4-439c-96f0-a501a5ec2f67
88	88	0	GBIF Germany	4f6826f2-4ff6-443d-b966-e6913bd24013	794adb00-f762-11e1-a439-00145eb45e9a
793	608	-185	GBIF Germany	4f6826f2-4ff6-443d-b966-e6913bd24013	79a4550e-f762-11e1-a439-00145eb45e9a
26896	26896	0	GBIF Japan	db5705aa-6a6e-42f1-8942-d77b9f4896ea	7a58712e-f762-11e1-a439-00145eb45e9a
58	58	0	GBIF Germany	4f6826f2-4ff6-443d-b966-e6913bd24013	7b7a91a4-f762-11e1-a439-00145eb45e9a
583	583	0	GBIF Germany	4f6826f2-4ff6-443d-b966-e6913bd24013	7bb20cd8-f762-11e1-a439-00145eb45e9a
0	2	2	Plazi	ffb07bec-2d10-492d-9c37-361fe0b79427	7d64f10b-205f-4051-bdae-bfbc9f432201
168	168	0	GBIF Germany	4f6826f2-4ff6-443d-b966-e6913bd24013	7d79bdb8-f762-11e1-a439-00145eb45e9a
1	1	0	Plazi	ffb07bec-2d10-492d-9c37-361fe0b79427	7e32cdfa-1a01-4a80-8b35-3c3e6d946e38
0	1	1	Plazi	ffb07bec-2d10-492d-9c37-361fe0b79427	7e42d8a0-aa57-4dee-a4d3-b29f0aafefba
1152	352	-800	GBIF Germany	4f6826f2-4ff6-443d-b966-e6913bd24013	7e7d411c-f762-11e1-a439-00145eb45e9a
392	392	0	GBIF Germany	4f6826f2-4ff6-443d-b966-e6913bd24013	7ea24fac-f762-11e1-a439-00145eb45e9a
717006	797621	80615	Belgian Biodiversity Platform	fb11cfe1-ebc3-45af-9159-17d9fddbcdac	7f9eb622-c036-44c6-8be9-5793eaa1fa1e
107	107	0	Biodiversity Information System of Mexico	b324e8e9-9a4c-44fa-8f1a-7f39ea7ab576	7ff706e0-f762-11e1-a439-00145eb45e9a
0	11	11	Plazi	ffb07bec-2d10-492d-9c37-361fe0b79427	80447e1e-70ee-48b9-8f72-4d177fddf5eb
18	18	0	Plazi	ffb07bec-2d10-492d-9c37-361fe0b79427	80727749-a5c8-4623-8464-04a41110faf1
0	23	23	Colombian Biodiversity Information System	7e865cba-7c46-417b-ade5-97f2cf5b7be0	81a019e1-6f28-4154-bb23-e42500257362
60566	60566	0	GBIF Spain	1f94b3ca-9345-4d65-afe2-4bace93aa0fe	837c0162-f762-11e1-a439-00145eb45e9a
181	181	0	U.S. Geological Survey	8618c64a-93e0-4300-b546-7249e5148ed2	851d09f8-f762-11e1-a439-00145eb45e9a
1197	1011	-186	GBIF Germany	4f6826f2-4ff6-443d-b966-e6913bd24013	87c60f9c-f762-11e1-a439-00145eb45e9a
168	133	-35	GBIF Germany	4f6826f2-4ff6-443d-b966-e6913bd24013	88155476-f762-11e1-a439-00145eb45e9a
174	174	0	GBIF Germany	4f6826f2-4ff6-443d-b966-e6913bd24013	8a87ab64-f762-11e1-a439-00145eb45e9a
131	131	0	GBIF Germany	4f6826f2-4ff6-443d-b966-e6913bd24013	8aba36e2-f762-11e1-a439-00145eb45e9a
404	404	0	GBIF France	da44cd31-5901-4687-a106-6d1c7734ee3a	8ca574fd-94dd-4673-9895-3560534784fe
3951	3951	0	National Biodiversity Network	d897a5b9-35ee-4232-94bd-b0bcaac003c2	8eb482b3-be5a-4361-bfd0-bcd3f22738d3
3456	1682	-1774	GBIF Germany	4f6826f2-4ff6-443d-b966-e6913bd24013	8f7446fa-f762-11e1-a439-00145eb45e9a
753	383	-370	GBIF Germany	4f6826f2-4ff6-443d-b966-e6913bd24013	8fbac62a-f762-11e1-a439-00145eb45e9a
91	47	-44	GBIF Germany	4f6826f2-4ff6-443d-b966-e6913bd24013	902756dc-f762-11e1-a439-00145eb45e9a
12	12	0	Plazi	ffb07bec-2d10-492d-9c37-361fe0b79427	90327333-dbf7-4a3e-9a7e-7c2fd259d963
1	1	0	Plazi	ffb07bec-2d10-492d-9c37-361fe0b79427	907ec56a-2d57-49be-af4f-9408a8aa719b
506	297	-209	GBIF Germany	4f6826f2-4ff6-443d-b966-e6913bd24013	919b5aae-f762-11e1-a439-00145eb45e9a
268	163	-105	GBIF Germany	4f6826f2-4ff6-443d-b966-e6913bd24013	91aa13fa-f762-11e1-a439-00145eb45e9a
671	671	0	GBIF Germany	4f6826f2-4ff6-443d-b966-e6913bd24013	91d8f53a-f762-11e1-a439-00145eb45e9a
5	5	0	Plazi	ffb07bec-2d10-492d-9c37-361fe0b79427	91f1d11d-9971-42de-ad80-6dbf22a265ff
317	317	0	GBIF Germany	4f6826f2-4ff6-443d-b966-e6913bd24013	92202540-f762-11e1-a439-00145eb45e9a
52	49	-3	GBIF Germany	4f6826f2-4ff6-443d-b966-e6913bd24013	9312831c-f762-11e1-a439-00145eb45e9a
693	294	-399	GBIF Germany	4f6826f2-4ff6-443d-b966-e6913bd24013	935dc610-f762-11e1-a439-00145eb45e9a
4064	4064	0	National Biodiversity Network	d897a5b9-35ee-4232-94bd-b0bcaac003c2	9501194c-ad89-4dd5-9cc7-04d74f9ea819
0	112	112	Ocean Biodiversity Information System	ba0670b9-4186-41e6-8e70-f9cb3065551a	95a418cd-0ed4-45fa-87b3-9c80b30e7317
16469	16469	0	GBIF Austria	1e789bc9-79fc-4e60-a49e-89dfc45a7188	95dc889a-f762-11e1-a439-00145eb45e9a
13433	13433	0	National Biodiversity Network	d897a5b9-35ee-4232-94bd-b0bcaac003c2	96a76ab6-5bd5-4316-8ef1-b6de25322e9e
430	430	0	GBIF France	da44cd31-5901-4687-a106-6d1c7734ee3a	972deef6-a004-4753-9e8c-c08b92959a6c
16	16	0	National Biodiversity Network	d897a5b9-35ee-4232-94bd-b0bcaac003c2	991b2a15-f13f-4bd8-97bc-f2cafc90bfc4
8	8	0	Plazi	ffb07bec-2d10-492d-9c37-361fe0b79427	9956099a-5e4b-4b2e-b24e-d347a707f5f9
416	416	0	Belgian Biodiversity Platform	fb11cfe1-ebc3-45af-9159-17d9fddbcdac	9a546219-a51e-446d-8ed9-b356df938fed
0	628	628	Ocean Biodiversity Information System	ba0670b9-4186-41e6-8e70-f9cb3065551a	a0df8396-be50-41da-bf78-b82fc9d3ff6b
0	66	66	Ocean Biodiversity Information System	ba0670b9-4186-41e6-8e70-f9cb3065551a	a1d12fec-c4d0-48bd-9737-07dbe86ea40f
0	93	93	National Biodiversity Network	d897a5b9-35ee-4232-94bd-b0bcaac003c2	a276f5da-12fc-4532-902b-1c5fd5945b44
5420	5420	0	Scientific Committee on Antarctic Research	51e4e8ff-bff0-4996-8b27-9107d61b3478	a2e308bf-e9ec-4651-906e-956c963df0ca
2517	2517	0	GBIF France	da44cd31-5901-4687-a106-6d1c7734ee3a	a58c0643-bb1c-4778-b55f-fcb83f2d5b06
0	2	2	Plazi	ffb07bec-2d10-492d-9c37-361fe0b79427	a6a2e3ef-e00f-4477-93de-3a02c1f8f34a
389	438	49	U.S. Geological Survey	8618c64a-93e0-4300-b546-7249e5148ed2	a9a7265f-e634-4a98-8351-755c9d819e0e
0	2	2	Plazi	ffb07bec-2d10-492d-9c37-361fe0b79427	ae77fd6a-128c-4c44-9b84-63a0970b6be7
25	25	0	Plazi	ffb07bec-2d10-492d-9c37-361fe0b79427	afb60108-82be-4cff-9898-088349da5006
23136	23136	0	National Biodiversity Network	d897a5b9-35ee-4232-94bd-b0bcaac003c2	b2aabe0c-a8bd-48af-8596-57977e20bda6
3	3	0	Plazi	ffb07bec-2d10-492d-9c37-361fe0b79427	b2e1df95-f553-4f99-af3c-c3c89fac1234
0	6	6	Plazi	ffb07bec-2d10-492d-9c37-361fe0b79427	b4c2af58-5d10-4fef-8f6a-302d7ce970d5
13	13	0	Participant Node Managers Committee	7f48e0c8-5c96-49ec-b972-30748e339115	b4eeaf30-2b9d-499d-8fb1-17ef3fdf7bac
51	51	0	Plazi	ffb07bec-2d10-492d-9c37-361fe0b79427	b5ce0b5c-16f2-4527-a23b-1cfbde3de873
7	7	0	Taiwan Biodiversity Information Facility	e1b85abc-61f9-430f-ba79-6813dec53a0f	b752c2ec-2395-4132-a7eb-9ffe7d8eb0f3
0	2	2	Plazi	ffb07bec-2d10-492d-9c37-361fe0b79427	b8965a84-547b-4855-ac3d-2a9286b327d5
16348	16348	0	GBIF France	da44cd31-5901-4687-a106-6d1c7734ee3a	bcb2d5d0-693b-48da-a35e-f6beb246ced2
2	2	0	Plazi	ffb07bec-2d10-492d-9c37-361fe0b79427	bd3ea6f2-dfb7-4301-aae4-c2335d92ae49
6	6	0	Plazi	ffb07bec-2d10-492d-9c37-361fe0b79427	c0436abf-e859-4129-a512-03f64c8e3001
1547	1728	181	U.S. Geological Survey	8618c64a-93e0-4300-b546-7249e5148ed2	c113d947-5dcf-4a52-aaa2-735dba1089b7
10	10	0	Plazi	ffb07bec-2d10-492d-9c37-361fe0b79427	c1392784-8900-46a7-aa5d-07c5d240a7d9
2756	2756	0	GBIF France	da44cd31-5901-4687-a106-6d1c7734ee3a	c4abf9ca-0cdf-4b68-9c48-f5e63983c4af
916	691	-225	GBIF Germany	4f6826f2-4ff6-443d-b966-e6913bd24013	c540dc2d-81d7-4e42-8342-a5f107165f69
0	272	272	Ocean Biodiversity Information System	ba0670b9-4186-41e6-8e70-f9cb3065551a	c565806b-e323-4fe8-ad7f-7506510a825c
2	2	0	Plazi	ffb07bec-2d10-492d-9c37-361fe0b79427	c6997856-1dd8-4f2a-8207-b0605f3e4392
0	144	144	Participant Node Managers Committee	7f48e0c8-5c96-49ec-b972-30748e339115	c7da3dcb-2b70-4995-918d-2da6e87ff662
11	11	0	Plazi	ffb07bec-2d10-492d-9c37-361fe0b79427	c81e7663-6625-4b69-a345-a86ff312a35e
43	43	0	GBIF Argentina	2426a871-9feb-40a1-96c6-0c593a76b835	c8fe60d6-26e2-40ea-8757-ffe997810c15
359	359	0	National Biodiversity Network	d897a5b9-35ee-4232-94bd-b0bcaac003c2	cc46e675-d1ce-4286-b702-f5d71381e79d
1	1	0	Plazi	ffb07bec-2d10-492d-9c37-361fe0b79427	cd4743f3-9853-41f5-9073-bda5e094f291
112	112	0	Biodiversity Information System of Mexico	b324e8e9-9a4c-44fa-8f1a-7f39ea7ab576	d3c2030c-3017-4652-a718-24a40fbb0137
0	9	9	Plazi	ffb07bec-2d10-492d-9c37-361fe0b79427	d665d9ec-6453-4e64-939b-5dfac9e7c68e
9	9	0	Plazi	ffb07bec-2d10-492d-9c37-361fe0b79427	d7838eb7-9c46-414e-85bf-418245de7ca9
0	3003	3003	Ocean Biodiversity Information System	ba0670b9-4186-41e6-8e70-f9cb3065551a	dc274911-6d14-4aa7-9c27-d17833d51a5d
38	38	0	Plazi	ffb07bec-2d10-492d-9c37-361fe0b79427	dc91aa5e-ab23-4599-8df9-56ebda03c098
371	371	0	Plazi	ffb07bec-2d10-492d-9c37-361fe0b79427	e0c51a8a-3803-4bab-bf2b-5f607902f0d1
253	253	0	GBIF France	da44cd31-5901-4687-a106-6d1c7734ee3a	e1ae2cbd-3eb0-48a1-aef6-014d677e0829
0	1084	1084	Participant Node Managers Committee	7f48e0c8-5c96-49ec-b972-30748e339115	e1c67ddd-1027-4ed0-9835-bd7480c24aee
94513	94513	0	GBIF France	da44cd31-5901-4687-a106-6d1c7734ee3a	e5850855-df3d-4209-a71f-0fa852619638
98939	90300	-8639	GBIF Norway	4f829580-180d-46a9-9c87-ed8ec959b545	e73369d9-fa93-47f9-932c-e101b6dd8507
15	15	0	Plazi	ffb07bec-2d10-492d-9c37-361fe0b79427	e86e0a02-f2f1-4975-a4c4-58f87926b471
27	27	0	Plazi	ffb07bec-2d10-492d-9c37-361fe0b79427	e96d939b-bb38-4b67-8cca-414b3126795d
9	8	-1	Plazi	ffb07bec-2d10-492d-9c37-361fe0b79427	ea35b561-bca4-4ee0-8954-9c97b480e6bf
22	22	0	Plazi	ffb07bec-2d10-492d-9c37-361fe0b79427	eab7f5e2-fead-415f-98c1-0e26d8fcade9
9	9	0	Plazi	ffb07bec-2d10-492d-9c37-361fe0b79427	eb75e8f5-6d30-4886-a0ee-a08d99880b1b
10060	10060	0	GBIF Norway	4f829580-180d-46a9-9c87-ed8ec959b545	f0f63002-020d-4bbc-9503-423eca3ab4a3
0	8	8	Plazi	ffb07bec-2d10-492d-9c37-361fe0b79427	f1a528c7-0efd-48d5-abde-15199aa465ec
3990	3990	0	GBIF France	da44cd31-5901-4687-a106-6d1c7734ee3a	f36b54b3-fedd-4191-8a49-9f3d9d85d58b
30	30	0	Plazi	ffb07bec-2d10-492d-9c37-361fe0b79427	f512e049-ac78-4a6e-839e-256d2f059bae
135748	136556	808	GBIF France	da44cd31-5901-4687-a106-6d1c7734ee3a	f58922e2-93ed-4703-ba22-12a0674d1b54
0	24	24	Plazi	ffb07bec-2d10-492d-9c37-361fe0b79427	f617a8f6-316d-435a-a861-ef7bcfbc21e9
3	3	0	Plazi	ffb07bec-2d10-492d-9c37-361fe0b79427	f6787fad-ed07-429d-abc4-bcee238fb7b9
4567	4567	0	Polish Biodiversity Information Network	2618bfdf-e194-4911-a241-80db3107bc51	f76bfff0-17a0-11de-9d16-b8a03c50a862
0	2	2	Plazi	ffb07bec-2d10-492d-9c37-361fe0b79427	faa2a7b6-8a57-4656-bfe2-b2b0ab73126d
15	15	0	Plazi	ffb07bec-2d10-492d-9c37-361fe0b79427	01c65866-d144-48f2-a2bc-4a6d40a4ec58
0	10429	10429	Participant Node Managers Committee	7f48e0c8-5c96-49ec-b972-30748e339115	01f33154-d6f7-4079-a9e2-f0a9ca8e8630
50	50	0	Plazi	ffb07bec-2d10-492d-9c37-361fe0b79427	026482e5-b6b7-4ba0-a46f-6b57c1a6a620
8	8	0	Plazi	ffb07bec-2d10-492d-9c37-361fe0b79427	068e4b51-c726-434f-8799-742b1b61ea9c
336	336	0	Participant Node Managers Committee	7f48e0c8-5c96-49ec-b972-30748e339115	06a9f1b6-cadc-4617-adb4-32ce7800775b
16495	16495	0	National Biodiversity Network	d897a5b9-35ee-4232-94bd-b0bcaac003c2	06e9b0e7-a112-4448-9eba-896a9bc69f07
97	97	0	Colombian Biodiversity Information System	7e865cba-7c46-417b-ade5-97f2cf5b7be0	0aa51ae3-1648-4640-8ad9-e4818b26b823
319	319	0	Colombian Biodiversity Information System	7e865cba-7c46-417b-ade5-97f2cf5b7be0	0ba8ab97-21bd-4438-9fee-0817c06a2645
27	27	0	Plazi	ffb07bec-2d10-492d-9c37-361fe0b79427	0e2c20a3-3c34-4a6f-bbbe-3b8a30e27036
0	92	92	Plazi	ffb07bec-2d10-492d-9c37-361fe0b79427	0efa800a-ee0f-48a7-881b-910b67f170c1
62	62	0	Plazi	ffb07bec-2d10-492d-9c37-361fe0b79427	136ad297-7685-455e-bfdd-d8b6e2c7c942
44616	44616	0	Atlas of Living Australia	4a6f1b71-969e-4fc5-a693-282b05e1220c	170fd706-23a1-4036-b29e-57f4b2cb7bed
4926	2557	-2369	GBIF Germany	4f6826f2-4ff6-443d-b966-e6913bd24013	18b6ee1c-3b49-4af4-808d-0d662fb43e0e
0	4979	4979	Participant Node Managers Committee	7f48e0c8-5c96-49ec-b972-30748e339115	18d99191-3386-4787-ab1d-95a2e5126558
23	23	0	Biodiversity Information System of Mexico	b324e8e9-9a4c-44fa-8f1a-7f39ea7ab576	1c4b605b-618d-4769-ba6c-854978a3c91e
312	312	0	Atlas of Living Australia	4a6f1b71-969e-4fc5-a693-282b05e1220c	1cfb1900-5735-4f47-9f97-cb99a1aa7211
4	4	0	Plazi	ffb07bec-2d10-492d-9c37-361fe0b79427	2153e409-f93c-49f1-af25-7960c68181b1
23	23	0	Plazi	ffb07bec-2d10-492d-9c37-361fe0b79427	267c9f21-1fe0-4797-bcde-d673f67b5fa9
9304	13010	3706	GBIF Japan	db5705aa-6a6e-42f1-8942-d77b9f4896ea	27acb6cf-a30b-4cc9-8953-95435c7dc727
374	374	0	Belgian Biodiversity Platform	fb11cfe1-ebc3-45af-9159-17d9fddbcdac	28ac18b4-8c7e-4873-89af-86fcf35b118b
4	4	0	GBIF Germany	4f6826f2-4ff6-443d-b966-e6913bd24013	29cb4233-6332-4a91-9fad-b77765c4bbb7
146	146	0	Colombian Biodiversity Information System	7e865cba-7c46-417b-ade5-97f2cf5b7be0	29e92c92-eee8-49f6-a43d-907cc37027d1
1	1	0	Plazi	ffb07bec-2d10-492d-9c37-361fe0b79427	2b8d9c95-6a86-4b09-bf6e-06965827cf87
8	8	0	Plazi	ffb07bec-2d10-492d-9c37-361fe0b79427	2cfa159c-a591-41f5-bc3a-281d39721344
358	358	0	GBIF France	da44cd31-5901-4687-a106-6d1c7734ee3a	30ceac7b-3452-4ab1-a2fd-c6460ac7d1d3
0	13	13	Plazi	ffb07bec-2d10-492d-9c37-361fe0b79427	33ceca02-6e94-44c6-9c20-2c7e8d4ef8ed
3	3	0	GBIF France	da44cd31-5901-4687-a106-6d1c7734ee3a	34af15c8-c5e1-4e5f-95b1-1b04687bfe6e
79	79	0	Plazi	ffb07bec-2d10-492d-9c37-361fe0b79427	35de4e63-710e-4014-9579-722d697304b4
0	118	118	Ghana Biodiversity Information Facility	b5633b75-6a86-4fdf-9cfc-506047fb9dc7	37c108e8-a67d-4b2f-8cf7-d9a53a7eb8bb
948	948	0	Netherlands Biodiversity Information Facility	0909d601-bda2-42df-9e63-a6d51847ebce	38f97143-922d-4ec0-a6e5-75e51a77890a
6476	6476	0	National Biodiversity Network	d897a5b9-35ee-4232-94bd-b0bcaac003c2	39676c5a-7f9a-4fa7-971f-7cef77cdc723
906	906	0	Costa Rica Biodiversity Facility	3379bb09-1a58-41e7-9c57-e3b66c3eb5a0	3fb3dcc1-46cc-4b34-9ea9-342ed7dfd8f2
6472	15037	8565	GBIF France	da44cd31-5901-4687-a106-6d1c7734ee3a	42da6224-6935-4b36-9d58-7728064f6fe8
213	213	0	GBIF France	da44cd31-5901-4687-a106-6d1c7734ee3a	45da0008-5259-468a-b540-393ebd974b0d
57	57	0	Plazi	ffb07bec-2d10-492d-9c37-361fe0b79427	46406a0c-b950-4c80-a7a8-4645edf7c312
2	2	0	Plazi	ffb07bec-2d10-492d-9c37-361fe0b79427	46baebd3-e84f-459b-90f2-0f6ab9703ab4
418	418	0	GBIF Germany	4f6826f2-4ff6-443d-b966-e6913bd24013	47d1829a-e78e-4171-91c5-d1f5ae6403fe
0	3	3	Plazi	ffb07bec-2d10-492d-9c37-361fe0b79427	48533c3c-94b9-4a69-b22e-777e80319a30
0	8	8	Plazi	ffb07bec-2d10-492d-9c37-361fe0b79427	49960699-495a-4910-bdf5-ce616eea71bc
145	145	0	GBIF France	da44cd31-5901-4687-a106-6d1c7734ee3a	4a70e8e0-c196-483b-97ad-4c9e65f590f0
0	528	528	Ocean Biodiversity Information System	ba0670b9-4186-41e6-8e70-f9cb3065551a	4accddef-2b52-4898-a5dc-38cb224f0140
814	814	0	GBIF Germany	4f6826f2-4ff6-443d-b966-e6913bd24013	4ad98db5-92cf-4b3e-98ed-22de84a856fe
0	263	263	Colombian Biodiversity Information System	7e865cba-7c46-417b-ade5-97f2cf5b7be0	4e66069d-60cf-445e-bdc7-276c5073642a
540	540	0	GBIF France	da44cd31-5901-4687-a106-6d1c7734ee3a	4f1dc07c-b86a-4626-ab8a-dd9264dde7ae
9	9	0	Plazi	ffb07bec-2d10-492d-9c37-361fe0b79427	5192b5ee-10df-4094-8b21-346e48b4a475
166	166	0	GBIF Germany	4f6826f2-4ff6-443d-b966-e6913bd24013	51d5d3b7-56d1-4b0e-a11b-9e999388a49e
153	153	0	GBIF Germany	4f6826f2-4ff6-443d-b966-e6913bd24013	561de081-9df3-4798-8896-802181b679ff
2	2	0	Plazi	ffb07bec-2d10-492d-9c37-361fe0b79427	5882d26c-95d0-4b67-87d4-6e91cfdbf789
81	81	0	Plazi	ffb07bec-2d10-492d-9c37-361fe0b79427	5cad0e06-2a49-4dc6-bfac-9f00391b5d9b
4	4	0	Plazi	ffb07bec-2d10-492d-9c37-361fe0b79427	5d65c809-e2ef-4928-9134-3fbdd2a8d0e7
1386	1386	0	Biodiversity Information System of Mexico	b324e8e9-9a4c-44fa-8f1a-7f39ea7ab576	5d6c2985-c6b0-4f4a-a703-85822e238825
20534	21093	559	U.S. Geological Survey	8618c64a-93e0-4300-b546-7249e5148ed2	5f3463d2-51b6-4a8a-b252-9bab4388934e
27988	27988	0	National Biodiversity Network	d897a5b9-35ee-4232-94bd-b0bcaac003c2	60773d5b-30e5-48ac-9d63-a2b81ffe5cfa
15	15	0	GBIF Germany	4f6826f2-4ff6-443d-b966-e6913bd24013	62c43d18-f762-11e1-a439-00145eb45e9a
24	24	0	GBIF Germany	4f6826f2-4ff6-443d-b966-e6913bd24013	62e913cc-f762-11e1-a439-00145eb45e9a
2910	2910	0	Participant Node Managers Committee	7f48e0c8-5c96-49ec-b972-30748e339115	640142cc-ff7e-49f3-902a-a0fd5a7a3560
1156	1156	0	Plazi	ffb07bec-2d10-492d-9c37-361fe0b79427	64c13fcf-4aa5-4887-ad05-67aba877d58e
567	375	-192	GBIF Germany	4f6826f2-4ff6-443d-b966-e6913bd24013	654843fe-f762-11e1-a439-00145eb45e9a
0	38	38	Ocean Biodiversity Information System	ba0670b9-4186-41e6-8e70-f9cb3065551a	655150a1-87a4-4e07-b51b-536d52187fb3
121	114	-7	GBIF Germany	4f6826f2-4ff6-443d-b966-e6913bd24013	657b08de-f762-11e1-a439-00145eb45e9a
14	14	0	Plazi	ffb07bec-2d10-492d-9c37-361fe0b79427	65c91f46-0c62-416d-a382-d1b3b4aff52e
918	918	0	GBIF Germany	4f6826f2-4ff6-443d-b966-e6913bd24013	66040d38-e0fb-4bd0-ad1e-dfd55ca5a9d6
0	3	3	Plazi	ffb07bec-2d10-492d-9c37-361fe0b79427	664d09a5-5132-4e20-9b3c-2183b700844d
14	14	0	Plazi	ffb07bec-2d10-492d-9c37-361fe0b79427	668a790d-eb9c-4c43-b9ce-5defca7764c9
52	52	0	GBIF Germany	4f6826f2-4ff6-443d-b966-e6913bd24013	6693268e-f762-11e1-a439-00145eb45e9a
69	69	0	GBIF Germany	4f6826f2-4ff6-443d-b966-e6913bd24013	67b552d0-f762-11e1-a439-00145eb45e9a
387	387	0	GBIF Germany	4f6826f2-4ff6-443d-b966-e6913bd24013	6a2be27c-f762-11e1-a439-00145eb45e9a
109	109	0	GBIF Germany	4f6826f2-4ff6-443d-b966-e6913bd24013	6a9d6bf4-f762-11e1-a439-00145eb45e9a
3399	3399	0	Biodiversity Information System of Mexico	b324e8e9-9a4c-44fa-8f1a-7f39ea7ab576	6b44b322-e9b8-4a1b-ba7e-7ef7f84e44b1
18	18	0	GBIF Germany	4f6826f2-4ff6-443d-b966-e6913bd24013	6b9b50b6-f762-11e1-a439-00145eb45e9a
906	906	0	GBIF Germany	4f6826f2-4ff6-443d-b966-e6913bd24013	6ba46dfe-f762-11e1-a439-00145eb45e9a
43	43	0	Plazi	ffb07bec-2d10-492d-9c37-361fe0b79427	6c263a25-844c-46f3-8954-6fd01361de19
2	2	0	Plazi	ffb07bec-2d10-492d-9c37-361fe0b79427	6c329220-e7a5-480b-82eb-3a994b86df61
0	4	4	Plazi	ffb07bec-2d10-492d-9c37-361fe0b79427	6d7bc4cf-15f5-4b7a-bc4e-4c2cec0235fe
32	32	0	Plazi	ffb07bec-2d10-492d-9c37-361fe0b79427	6e0d4b0b-a1d0-4c5a-ae69-da28134ea3c5
4	4	0	GBIF Germany	4f6826f2-4ff6-443d-b966-e6913bd24013	6f958c5e-f762-11e1-a439-00145eb45e9a
12	12	0	GBIF Germany	4f6826f2-4ff6-443d-b966-e6913bd24013	6fb2c918-f762-11e1-a439-00145eb45e9a
81	81	0	GBIF Germany	4f6826f2-4ff6-443d-b966-e6913bd24013	70824382-f762-11e1-a439-00145eb45e9a
0	1	1	Plazi	ffb07bec-2d10-492d-9c37-361fe0b79427	709a9aef-c221-47b1-9072-5f345d51ec4c
109	109	0	GBIF Germany	4f6826f2-4ff6-443d-b966-e6913bd24013	70f119f6-f762-11e1-a439-00145eb45e9a
174	174	0	GBIF Germany	4f6826f2-4ff6-443d-b966-e6913bd24013	71a3ccea-f762-11e1-a439-00145eb45e9a
2409	1329	-1080	GBIF Germany	4f6826f2-4ff6-443d-b966-e6913bd24013	71f95d0e-f762-11e1-a439-00145eb45e9a
169	169	0	GBIF Germany	4f6826f2-4ff6-443d-b966-e6913bd24013	720801a6-f762-11e1-a439-00145eb45e9a
29	29	0	Plazi	ffb07bec-2d10-492d-9c37-361fe0b79427	72296a80-b5f7-4c66-af26-ce83485e461c
5	5	0	Plazi	ffb07bec-2d10-492d-9c37-361fe0b79427	7278d5cf-7c63-44b1-a2a0-4fd53a42c218
141	141	0	GBIF Norway	4f829580-180d-46a9-9c87-ed8ec959b545	73e2db01-1a15-4b66-95b9-a909ab0f69aa
7	7	0	GBIF Germany	4f6826f2-4ff6-443d-b966-e6913bd24013	742a437c-f762-11e1-a439-00145eb45e9a
349	349	0	GBIF Germany	4f6826f2-4ff6-443d-b966-e6913bd24013	75a8c2f0-f762-11e1-a439-00145eb45e9a
5	5	0	Plazi	ffb07bec-2d10-492d-9c37-361fe0b79427	77629bd4-502c-45a7-bf08-59b29d5bced5
4	4	0	GBIF Germany	4f6826f2-4ff6-443d-b966-e6913bd24013	78983342-f762-11e1-a439-00145eb45e9a
135	135	0	GBIF Germany	4f6826f2-4ff6-443d-b966-e6913bd24013	7917fde8-f762-11e1-a439-00145eb45e9a
85	85	0	GBIF Germany	4f6826f2-4ff6-443d-b966-e6913bd24013	7937cce0-f762-11e1-a439-00145eb45e9a
1150	893	-257	GBIF Germany	4f6826f2-4ff6-443d-b966-e6913bd24013	79520862-f762-11e1-a439-00145eb45e9a
0	24	24	Plazi	ffb07bec-2d10-492d-9c37-361fe0b79427	79e0ebb9-6412-4821-879a-9ec760579681
481	481	0	GBIF Germany	4f6826f2-4ff6-443d-b966-e6913bd24013	7aa04b12-1e97-40e3-a9e2-d68082619cdf
5327	5327	0	GBIF Japan	db5705aa-6a6e-42f1-8942-d77b9f4896ea	7ae6ce92-f762-11e1-a439-00145eb45e9a
278	278	0	Ocean Biodiversity Information System	ba0670b9-4186-41e6-8e70-f9cb3065551a	7b461e60-f762-11e1-a439-00145eb45e9a
931	931	0	Ocean Biodiversity Information System	ba0670b9-4186-41e6-8e70-f9cb3065551a	7b67c51a-f762-11e1-a439-00145eb45e9a
39	39	0	Colombian Biodiversity Information System	7e865cba-7c46-417b-ade5-97f2cf5b7be0	7bf83227-142e-42c9-8748-342a48ef7659
250	250	0	GBIF Germany	4f6826f2-4ff6-443d-b966-e6913bd24013	7c631046-f762-11e1-a439-00145eb45e9a
0	4	4	Plazi	ffb07bec-2d10-492d-9c37-361fe0b79427	7e925546-ee72-463d-a9bf-09ba55ffa2bf
3	3	0	Plazi	ffb07bec-2d10-492d-9c37-361fe0b79427	7ee7849b-b7d8-429f-a8a6-1f3787ce7262
720	720	0	GBIF France	da44cd31-5901-4687-a106-6d1c7734ee3a	7f8020f2-9650-436c-924f-b179629610b5
391	391	0	Participant Node Managers Committee	7f48e0c8-5c96-49ec-b972-30748e339115	8047c58c-c53a-4c05-b1a0-6d36f7dd1886
8784	8784	0	GBIF Japan	db5705aa-6a6e-42f1-8942-d77b9f4896ea	810128a4-f762-11e1-a439-00145eb45e9a
0	3903	3903	GBIF Portugal	673f7038-4262-4149-b753-5658a4e912f6	81df7e48-1f76-4125-901b-140bd96dfa49
230	230	0	DanBIF - Danish Biodiversity Information Facility	4ddd294f-02b7-4359-ac33-0806a9ca9c6b	84d6fd32-f762-11e1-a439-00145eb45e9a
1911	1911	0	GBIF Germany	4f6826f2-4ff6-443d-b966-e6913bd24013	859445c2-f762-11e1-a439-00145eb45e9a
29876	29876	0	GBIF Finland	dd514216-5c7c-45f3-910d-797424cb5be6	867b3fb8-f762-11e1-a439-00145eb45e9a
2108	2108	0	GBIF Japan	db5705aa-6a6e-42f1-8942-d77b9f4896ea	86940f03-6d8b-401d-a1f2-3175a46d5406
1850	1850	0	Tanzania Biodiversity Information Facility	abd95ca6-3959-4db9-aaa6-2de1aeecf514	872e998a-7ff6-4384-9b25-a4bb6c0d71f1
0	55	55	Plazi	ffb07bec-2d10-492d-9c37-361fe0b79427	877bdc9a-24e9-4b3d-a4f6-3de97398630d
249	249	0	GBIF Germany	4f6826f2-4ff6-443d-b966-e6913bd24013	87ac8662-f762-11e1-a439-00145eb45e9a
152	152	0	GBIF Germany	4f6826f2-4ff6-443d-b966-e6913bd24013	89c65af4-f762-11e1-a439-00145eb45e9a
1072	1072	0	GBIF Germany	4f6826f2-4ff6-443d-b966-e6913bd24013	8aa9a002-f762-11e1-a439-00145eb45e9a
19	19	0	Plazi	ffb07bec-2d10-492d-9c37-361fe0b79427	8b8d3d31-4988-436c-854d-2ce9730d0429
112	112	0	GBIF Germany	4f6826f2-4ff6-443d-b966-e6913bd24013	8c22ba5e-f762-11e1-a439-00145eb45e9a
78	61	-17	GBIF Germany	4f6826f2-4ff6-443d-b966-e6913bd24013	8da9a874-f762-11e1-a439-00145eb45e9a
631	413	-218	GBIF Germany	4f6826f2-4ff6-443d-b966-e6913bd24013	8e5bcb6c-f762-11e1-a439-00145eb45e9a
88	74	-14	GBIF Germany	4f6826f2-4ff6-443d-b966-e6913bd24013	8f5b0438-f762-11e1-a439-00145eb45e9a
2	2	0	National Biodiversity Network	d897a5b9-35ee-4232-94bd-b0bcaac003c2	8fa22298-d075-4b95-b5f4-bcbe792e981b
103	80	-23	GBIF Germany	4f6826f2-4ff6-443d-b966-e6913bd24013	9142fdb4-f762-11e1-a439-00145eb45e9a
645	645	0	GBIF Germany	4f6826f2-4ff6-443d-b966-e6913bd24013	9252b938-f762-11e1-a439-00145eb45e9a
4579	4579	0	GBIF France	da44cd31-5901-4687-a106-6d1c7734ee3a	92c07a5b-5223-4175-ae1a-77b26bb1ba0a
528	528	0	GBIF Germany	4f6826f2-4ff6-443d-b966-e6913bd24013	93f78a84-f762-11e1-a439-00145eb45e9a
840	840	0	GBIF Germany	4f6826f2-4ff6-443d-b966-e6913bd24013	940bbdc4-f762-11e1-a439-00145eb45e9a
56	56	0	GBIF Germany	4f6826f2-4ff6-443d-b966-e6913bd24013	94e854e6-f762-11e1-a439-00145eb45e9a
9	9	0	Plazi	ffb07bec-2d10-492d-9c37-361fe0b79427	96807e95-89bd-4f9c-8e64-dd44cf0ca98a
3	3	0	Plazi	ffb07bec-2d10-492d-9c37-361fe0b79427	97211781-a6c7-4ff6-9033-c31354f32dea
15	15	0	GBIF Germany	4f6826f2-4ff6-443d-b966-e6913bd24013	9783d11c-f762-11e1-a439-00145eb45e9a
121440	123400	1960	Symbiota Support Hub	612b5a0b-908b-4b4e-b9bf-ca15dfdc94fa	98bceab6-3c3e-4163-945d-6ca10576ebf1
48	48	0	Participant Node Managers Committee	7f48e0c8-5c96-49ec-b972-30748e339115	99181403-b9a8-48d1-b1f2-67562999c396
0	3	3	Plazi	ffb07bec-2d10-492d-9c37-361fe0b79427	9b1f59da-0045-401d-85d6-2a2158fce156
53744	53744	0	Atlas of Living Australia	4a6f1b71-969e-4fc5-a693-282b05e1220c	a3d3150a-6a85-4e42-885f-c273509a808e
67	67	0	Colombian Biodiversity Information System	7e865cba-7c46-417b-ade5-97f2cf5b7be0	a40ef31c-3847-4d6b-b921-d7da9c743c09
174	174	0	GBIF Brazil	cdc9736d-5ff7-4ece-9959-3c744360cdb3	a71ae102-f65d-4bd5-9915-bb1a96d86c16
0	108	108	GBIF Japan	db5705aa-6a6e-42f1-8942-d77b9f4896ea	a89b6db4-a3bb-46f5-8f50-46ff0d376542
1	1	0	Plazi	ffb07bec-2d10-492d-9c37-361fe0b79427	a8eca2e8-2e0e-4c46-b776-110c59427ac6
3	3	0	Plazi	ffb07bec-2d10-492d-9c37-361fe0b79427	ac1edda5-d774-40f0-b282-3c7fb133d898
730	730	0	GBIF Norway	4f829580-180d-46a9-9c87-ed8ec959b545	ad739ed0-ab30-4ca1-83ae-7c6ce228cafb
123195	123195	0	U.S. Geological Survey	8618c64a-93e0-4300-b546-7249e5148ed2	afc30a94-6107-488a-b9c0-ba9c4fa68b7c
0	1	1	Plazi	ffb07bec-2d10-492d-9c37-361fe0b79427	b1ed418d-47ca-4f91-b81d-39ac4dfbfb01
35	35	0	GBIF France	da44cd31-5901-4687-a106-6d1c7734ee3a	b20f847a-197b-4a54-b087-9e21429bfc8f
67	67	0	Plazi	ffb07bec-2d10-492d-9c37-361fe0b79427	b2b77bad-cf88-43e1-9300-69d35afd2d0a
124	124	0	GBIF New Zealand	4f9fd726-20dd-445e-89a1-8ed93792276f	b2ba584b-41c8-4cc1-b891-888506e12d62
22	22	0	GBIF Germany	4f6826f2-4ff6-443d-b966-e6913bd24013	b3f4d18e-e7e4-46b2-af68-c4dedc769ce0
0	4	4	Plazi	ffb07bec-2d10-492d-9c37-361fe0b79427	b4675f38-e743-4eb8-b5ae-f92b60367f05
626	626	0	GBIF Kenya	2a44d626-9f7a-4120-8a7a-4ab5ac15ff2a	b599e4ee-884e-45f6-ae2e-6823db051693
9	9	0	Plazi	ffb07bec-2d10-492d-9c37-361fe0b79427	b811dd22-2c06-4bb4-b8ba-53ae47f2b684
19	19	0	Participant Node Managers Committee	7f48e0c8-5c96-49ec-b972-30748e339115	b8a6baa2-7ff2-456d-8c21-38ec802e0a5e
47	47	0	Plazi	ffb07bec-2d10-492d-9c37-361fe0b79427	b9788cf8-a04b-4c8f-87ee-ca3b1e1720e6
15	15	0	Plazi	ffb07bec-2d10-492d-9c37-361fe0b79427	bb72e906-c382-481e-b5ef-0fd361f38777
0	372	372	Ocean Biodiversity Information System	ba0670b9-4186-41e6-8e70-f9cb3065551a	bcedd9b9-eebf-4b5d-881b-0abf4dfdc420
2454	2454	0	National Biodiversity Network	d897a5b9-35ee-4232-94bd-b0bcaac003c2	bd23b14d-20a2-4cfe-b55a-8e7553516784
267	267	0	Plazi	ffb07bec-2d10-492d-9c37-361fe0b79427	bedafe83-1cab-4329-8c1d-0152874f3907
5	5	0	Plazi	ffb07bec-2d10-492d-9c37-361fe0b79427	bee3dfe9-1fc5-4126-a232-13399cc60df0
0	4	4	Plazi	ffb07bec-2d10-492d-9c37-361fe0b79427	bef91f2c-a330-4875-bbc8-c5a37edf2e17
9	9	0	Plazi	ffb07bec-2d10-492d-9c37-361fe0b79427	bfcf998b-e88e-4e0a-b3ab-94354604b29b
6379	6379	0	National Biodiversity Network	d897a5b9-35ee-4232-94bd-b0bcaac003c2	c246b4ed-c74f-4ecd-86ab-163f080a51d1
217	217	0	GBIF France	da44cd31-5901-4687-a106-6d1c7734ee3a	c50ac1f3-4772-4cea-904f-14ce34b21a97
1	1	0	Plazi	ffb07bec-2d10-492d-9c37-361fe0b79427	c5f59fb3-2a72-4d62-bfe4-6a8be11a7006
0	85	85	Plazi	ffb07bec-2d10-492d-9c37-361fe0b79427	c66d7415-6743-496d-a518-e5fbd4b71a22
2457	2457	0	National Biodiversity Network	d897a5b9-35ee-4232-94bd-b0bcaac003c2	c6951371-fbed-41b6-a1dc-dbbd1d2723d9
2	2	0	Plazi	ffb07bec-2d10-492d-9c37-361fe0b79427	c74b6c1b-3efc-4630-9825-adf109a8fa37
25	25	0	Plazi	ffb07bec-2d10-492d-9c37-361fe0b79427	c970d1ac-486d-4ba0-92dd-4d01f7eb9213
0	2	2	Plazi	ffb07bec-2d10-492d-9c37-361fe0b79427	cc4c4f2a-8ef5-4d6d-94c2-fad08c9352b3
0	23	23	Plazi	ffb07bec-2d10-492d-9c37-361fe0b79427	cdde4106-d3d5-4294-9f6c-1e82afd8d580
150	150	0	GBIF Sweden	a0b3be64-6525-4387-ac67-a499950f92e1	cf67cf66-de6f-40dc-9865-814c9551049b
2039	2039	0	GBIF France	da44cd31-5901-4687-a106-6d1c7734ee3a	cf7fbc99-de82-41a5-aa01-4461a33e9b55
2	2	0	Plazi	ffb07bec-2d10-492d-9c37-361fe0b79427	d20506c8-4213-440f-92a2-d58e9e23f39f
9	9	0	Plazi	ffb07bec-2d10-492d-9c37-361fe0b79427	d220884f-93a2-4b83-ad8a-1c7e7493b1de
361	361	0	GBIF France	da44cd31-5901-4687-a106-6d1c7734ee3a	d5ba4b26-8af9-4c4f-9ff2-514e76683fb4
2	2	0	Plazi	ffb07bec-2d10-492d-9c37-361fe0b79427	d76f32cb-0b3c-4c2e-b8f9-a500ebfdd6ab
1	1	0	Plazi	ffb07bec-2d10-492d-9c37-361fe0b79427	d8e560aa-04ae-4e95-9f39-57c784c0212d
2	2	0	Plazi	ffb07bec-2d10-492d-9c37-361fe0b79427	dab3a0ae-1f60-459a-8666-9c3f1182ab65
4	4	0	Plazi	ffb07bec-2d10-492d-9c37-361fe0b79427	daea5848-ead1-4fb4-b96f-5ce4106ddd58
6	6	0	Plazi	ffb07bec-2d10-492d-9c37-361fe0b79427	ddc061dd-56d2-44ff-a83f-334f14ec8981
3	3	0	Plazi	ffb07bec-2d10-492d-9c37-361fe0b79427	de90345e-9ff8-4208-8e29-ff651b044475
7	7	0	Plazi	ffb07bec-2d10-492d-9c37-361fe0b79427	df72204a-b552-46fb-91b4-002b7c6fbd27
13	13	0	Plazi	ffb07bec-2d10-492d-9c37-361fe0b79427	df910006-d2a2-4df8-a294-b013209def87
139	139	0	GBIF Germany	4f6826f2-4ff6-443d-b966-e6913bd24013	e59a285e-4afc-4b62-894f-fb40d9e63b07
5428	5428	0	GBIF Japan	db5705aa-6a6e-42f1-8942-d77b9f4896ea	e9ef15ac-1078-44c1-bc86-f1ecc4115a68
67833	92498	24665	GBIF Slovenia	53e3f6b9-81f8-41e3-9e51-2666a5e0ae6a	ebf3c079-f88e-4b85-bcc5-f568229e68f3
0	20	20	Plazi	ffb07bec-2d10-492d-9c37-361fe0b79427	ed98a754-c3ac-49ff-9973-b8d9839993ff
27	27	0	Plazi	ffb07bec-2d10-492d-9c37-361fe0b79427	f179bd5c-50e0-41d5-8688-5ab014f5d014
1	1	0	Plazi	ffb07bec-2d10-492d-9c37-361fe0b79427	f2640939-9124-4583-b1dd-121e60de0ef2
0	41	41	Plazi	ffb07bec-2d10-492d-9c37-361fe0b79427	f584e63f-9368-4547-926b-c2c76dfc599e
120	120	0	U.S. Geological Survey	8618c64a-93e0-4300-b546-7249e5148ed2	f5964d19-412b-4952-80fd-58429b2ce1bb
488	488	0	GBIF Germany	4f6826f2-4ff6-443d-b966-e6913bd24013	f5d17934-2902-4c92-af26-2b0be7eff6d3
2073	2073	0	National Biodiversity Network	d897a5b9-35ee-4232-94bd-b0bcaac003c2	f700451d-39a8-4db9-a753-5dc293bcd60b
1341	1341	0	GBIF Japan	db5705aa-6a6e-42f1-8942-d77b9f4896ea	f8b2c677-b40d-4c0b-9a5b-15c362d9e063
3	3	0	Plazi	ffb07bec-2d10-492d-9c37-361fe0b79427	fc86c84c-4991-4993-960a-a84ace3f5a0f
5	5	0	Plazi	ffb07bec-2d10-492d-9c37-361fe0b79427	fd6bcd5a-9d51-450a-8d94-bb88763a4a0d
1125	1125	0	Biodiversity Information System of Mexico	b324e8e9-9a4c-44fa-8f1a-7f39ea7ab576	fec1c4bf-f8f3-4a8b-bd1e-ab5d31f9834e
40	40	0	GBIF Germany	4f6826f2-4ff6-443d-b966-e6913bd24013	ffa4c7a7-dc22-482a-af23-435898db67c6
0	18	18	Plazi	ffb07bec-2d10-492d-9c37-361fe0b79427	00610fbd-da35-4cd4-8d4f-455e67461ea1
158	158	0	Plazi	ffb07bec-2d10-492d-9c37-361fe0b79427	01351e5b-e27f-4b12-aa0f-ab91055f8af7
0	20	20	Plazi	ffb07bec-2d10-492d-9c37-361fe0b79427	048de9b3-27ce-4938-9f67-afa8b1bc2143
2	2	0	Plazi	ffb07bec-2d10-492d-9c37-361fe0b79427	058770dc-39b9-4402-ada2-5db845c4521e
0	17	17	Plazi	ffb07bec-2d10-492d-9c37-361fe0b79427	06952036-ba66-46f2-a903-6b4242092a27
1702	1702	0	GBIF Israel	8cb55387-7802-40e8-86d6-d357a583c596	0bf5686d-46dc-4470-8e3e-00904eb15e1e
0	1715	1715	GBIF Portugal	673f7038-4262-4149-b753-5658a4e912f6	0c25b706-bfd2-454b-bf14-b4d46f69e1ee
0	5938	5938	Ocean Biodiversity Information System	ba0670b9-4186-41e6-8e70-f9cb3065551a	0d165705-cce7-40b4-ba0e-9442cf777675
4571	4571	0	National Biodiversity Network	d897a5b9-35ee-4232-94bd-b0bcaac003c2	0dabdef4-7061-4883-92f7-1a7e8b5c6524
10511	10511	0	GBIF Spain	1f94b3ca-9345-4d65-afe2-4bace93aa0fe	10734a60-7ed1-11df-8c4a-0800200c9a66
61258	61258	0	Canada Biodiversity Information Facility	8f83fc96-c966-4126-83f7-bf044dc49efa	136560fa-9eb9-492f-866e-5bd110c52f74
0	1	1	Plazi	ffb07bec-2d10-492d-9c37-361fe0b79427	15a25c09-1379-4a6e-af9e-23e347dbed10
2340	2340	0	Polish Biodiversity Information Network	2618bfdf-e194-4911-a241-80db3107bc51	1757e800-9fcd-11da-a90d-b8a03c50a862
18	18	0	Plazi	ffb07bec-2d10-492d-9c37-361fe0b79427	1a2f5891-98ee-49b6-b469-635e78a1b15d
216	216	0	GBIF Germany	4f6826f2-4ff6-443d-b966-e6913bd24013	1a851dee-f854-49cf-815e-11c2147f4342
17	17	0	Plazi	ffb07bec-2d10-492d-9c37-361fe0b79427	1dd566b6-ef14-497a-92ce-e7481e3ade98
0	41	41	Ocean Biodiversity Information System	ba0670b9-4186-41e6-8e70-f9cb3065551a	23bad15b-3e67-46fb-a783-d333369e5da4
2	2	0	Plazi	ffb07bec-2d10-492d-9c37-361fe0b79427	24091335-c320-468c-93cc-9667c275c35b
7646	7646	0	Participant Node Managers Committee	7f48e0c8-5c96-49ec-b972-30748e339115	25852bb3-3f94-48ee-9be5-f86544133813
1006	1006	0	GBIF France	da44cd31-5901-4687-a106-6d1c7734ee3a	278725c5-9eec-40a4-a487-a5086906ecbc
0	3	3	Plazi	ffb07bec-2d10-492d-9c37-361fe0b79427	28ab6753-b1b2-4df5-a311-ab4f57bb81e3
0	18	18	Colombian Biodiversity Information System	7e865cba-7c46-417b-ade5-97f2cf5b7be0	2b311035-88a1-4bcf-8995-5d3313a115b6
445	445	0	Biodiversity Information System of Mexico	b324e8e9-9a4c-44fa-8f1a-7f39ea7ab576	2da4d785-ad98-40bd-9cd9-2285c19285e9
91356	91356	0	Taiwan Biodiversity Information Facility	e1b85abc-61f9-430f-ba79-6813dec53a0f	2de58bfe-1bf1-4318-97a3-d97efc269a4f
1690	1690	0	GBIF Uruguay	a3ceb6dd-0a65-4f30-a385-30f6937c2096	32487dda-3868-4723-aa77-98245206f466
35	35	0	GBIF Germany	4f6826f2-4ff6-443d-b966-e6913bd24013	325421a0-9030-49fa-b680-6856449e6288
3	3	0	Plazi	ffb07bec-2d10-492d-9c37-361fe0b79427	32ea7fc0-e75a-47e7-8c96-d7974bf56185
562	562	0	Participant Node Managers Committee	7f48e0c8-5c96-49ec-b972-30748e339115	344129e7-9017-4afc-a70a-77a069e7e094
990	990	0	Colombian Biodiversity Information System	7e865cba-7c46-417b-ade5-97f2cf5b7be0	3546c1aa-a3e2-4888-870f-b246cd0971ed
36	36	0	Plazi	ffb07bec-2d10-492d-9c37-361fe0b79427	37cfc20d-4811-4093-a53c-bc46789c08c3
8	8	0	Plazi	ffb07bec-2d10-492d-9c37-361fe0b79427	3835b1c0-ee9d-4a2a-bbcf-9454d050636f
0	734	734	Ocean Biodiversity Information System	ba0670b9-4186-41e6-8e70-f9cb3065551a	38767dd8-68c3-4c48-a328-385ea93cf466
61	61	0	Plazi	ffb07bec-2d10-492d-9c37-361fe0b79427	38da213d-7ad2-4afe-bc41-a9087c9e6555
1	1	0	Plazi	ffb07bec-2d10-492d-9c37-361fe0b79427	3961237c-615d-4bc3-8306-6107282629bd
17	17	0	Plazi	ffb07bec-2d10-492d-9c37-361fe0b79427	3aae814a-d9cd-4ccb-a548-75872c00e1b9
0	2	2	Plazi	ffb07bec-2d10-492d-9c37-361fe0b79427	3b93dec7-c387-40df-80c4-5988b37d8436
0	2	2	Ocean Biodiversity Information System	ba0670b9-4186-41e6-8e70-f9cb3065551a	3bb224ae-b3b6-4840-9631-654d3ae42594
586	586	0	Ocean Biodiversity Information System	ba0670b9-4186-41e6-8e70-f9cb3065551a	3c381293-9b33-477d-84ed-c7da7302f384
5	5	0	Plazi	ffb07bec-2d10-492d-9c37-361fe0b79427	3d70e9dc-3040-486d-8389-ba76f32d8886
0	17	17	Plazi	ffb07bec-2d10-492d-9c37-361fe0b79427	3f496909-8748-4e84-840d-951b3e442c9b
0	3	3	Plazi	ffb07bec-2d10-492d-9c37-361fe0b79427	3f9f1bfd-4da1-46f0-a1e8-e9e57320bcb3
129127	130754	1627	U.S. Geological Survey	8618c64a-93e0-4300-b546-7249e5148ed2	417f4d21-959b-4773-90a2-c38d1822d873
1	1	0	Plazi	ffb07bec-2d10-492d-9c37-361fe0b79427	43fbd3b8-9934-4986-b4c6-d39725751fa4
13	13	0	Plazi	ffb07bec-2d10-492d-9c37-361fe0b79427	44a73c43-0528-43c8-a1df-dff6458eee3e
0	12	12	Plazi	ffb07bec-2d10-492d-9c37-361fe0b79427	44d8be1c-8a36-4ab9-a354-4efb82694d31
0	3	3	Plazi	ffb07bec-2d10-492d-9c37-361fe0b79427	465c6ec7-642c-463c-9dca-a9cfe37b3c96
53	53	0	GBIF France	da44cd31-5901-4687-a106-6d1c7734ee3a	48093983-3de8-4634-915f-dfff22a69b5a
0	1	1	Plazi	ffb07bec-2d10-492d-9c37-361fe0b79427	48249a3d-036b-4e20-896b-92042f714cff
7	7	0	Plazi	ffb07bec-2d10-492d-9c37-361fe0b79427	48a8020a-38b8-4f44-a5c7-70af2fa9655e
9	9	0	Participant Node Managers Committee	7f48e0c8-5c96-49ec-b972-30748e339115	4ad58f82-6f64-4c95-9471-6ed136668cb6
25674	25674	0	Colombian Biodiversity Information System	7e865cba-7c46-417b-ade5-97f2cf5b7be0	4b04f487-712e-4ade-80fb-14e45f32e5f4
0	2	2	Plazi	ffb07bec-2d10-492d-9c37-361fe0b79427	4e1afe42-af9b-4295-b0c5-83376f9183ea
20	20	0	Plazi	ffb07bec-2d10-492d-9c37-361fe0b79427	4ef654c0-9c9e-46c4-9e1a-ac58220a14ff
0	1	1	Ocean Biodiversity Information System	ba0670b9-4186-41e6-8e70-f9cb3065551a	50d45c9f-ae74-42a7-a5f4-26e66bfe9aa2
855	855	0	Colombian Biodiversity Information System	7e865cba-7c46-417b-ade5-97f2cf5b7be0	516d98b1-9862-43e7-b402-ed2fc6b8f312
21041	45935	24894	National Biodiversity Network	d897a5b9-35ee-4232-94bd-b0bcaac003c2	547f2b71-ba25-4254-aaf1-4823600e7784
18	18	0	Plazi	ffb07bec-2d10-492d-9c37-361fe0b79427	56f8a697-33e1-4ece-8e49-e8bf44fb34ef
0	9	9	Plazi	ffb07bec-2d10-492d-9c37-361fe0b79427	57af7ea1-7b7e-4d57-9a87-074c5f97a079
498	498	0	National Biodiversity Network	d897a5b9-35ee-4232-94bd-b0bcaac003c2	5b2c8e94-06a4-4f0a-8065-cdd3c885fe03
150	150	0	GBIF Brazil	cdc9736d-5ff7-4ece-9959-3c744360cdb3	5c205e70-07ae-4937-be8f-43c7fe102571
26	26	0	Colombian Biodiversity Information System	7e865cba-7c46-417b-ade5-97f2cf5b7be0	5d483d17-b283-4e1f-a9b8-91759c28120a
50564	50564	0	National Biodiversity Network	d897a5b9-35ee-4232-94bd-b0bcaac003c2	5e5ddab0-ffad-4dc1-b095-7d43c6b36bb6
27	27	0	GBIF Germany	4f6826f2-4ff6-443d-b966-e6913bd24013	6174d7a6-f762-11e1-a439-00145eb45e9a
80	80	0	GBIF Germany	4f6826f2-4ff6-443d-b966-e6913bd24013	62343344-f762-11e1-a439-00145eb45e9a
50	50	0	Biodiversity Information System of Mexico	b324e8e9-9a4c-44fa-8f1a-7f39ea7ab576	623cb501-8772-46a4-8035-ae41c1e6f934
0	2	2	Plazi	ffb07bec-2d10-492d-9c37-361fe0b79427	63b2acfd-0811-45cf-bb48-ca4cee0708a6
0	4	4	Plazi	ffb07bec-2d10-492d-9c37-361fe0b79427	63caa02d-0997-437c-aecf-2fcb515818c4
83	83	0	GBIF Germany	4f6826f2-4ff6-443d-b966-e6913bd24013	644428c4-f762-11e1-a439-00145eb45e9a
4956	4956	0	GBIF Sweden	a0b3be64-6525-4387-ac67-a499950f92e1	64be02e0-0c64-11dd-84d1-b8a03c50a862
83	83	0	GBIF Germany	4f6826f2-4ff6-443d-b966-e6913bd24013	65423784-f762-11e1-a439-00145eb45e9a
305	305	0	GBIF Germany	4f6826f2-4ff6-443d-b966-e6913bd24013	65603f4a-f762-11e1-a439-00145eb45e9a
106	106	0	GBIF Germany	4f6826f2-4ff6-443d-b966-e6913bd24013	6629d77e-f762-11e1-a439-00145eb45e9a
18	18	0	Plazi	ffb07bec-2d10-492d-9c37-361fe0b79427	665e0df2-212d-400f-83a5-a0490bb993b1
109	109	0	GBIF Germany	4f6826f2-4ff6-443d-b966-e6913bd24013	67dba4a8-f762-11e1-a439-00145eb45e9a
50	10	-40	GBIF Germany	4f6826f2-4ff6-443d-b966-e6913bd24013	68e5de90-f762-11e1-a439-00145eb45e9a
1096	1096	0	Colombian Biodiversity Information System	7e865cba-7c46-417b-ade5-97f2cf5b7be0	6ac1d55a-ac4e-455b-b438-befaabe1d8fc
18	18	0	GBIF Germany	4f6826f2-4ff6-443d-b966-e6913bd24013	6b8a2462-f762-11e1-a439-00145eb45e9a
20	20	0	GBIF Germany	4f6826f2-4ff6-443d-b966-e6913bd24013	6bc32b4a-f762-11e1-a439-00145eb45e9a
35	35	0	GBIF Germany	4f6826f2-4ff6-443d-b966-e6913bd24013	6c8d71e8-f762-11e1-a439-00145eb45e9a
75	75	0	Plazi	ffb07bec-2d10-492d-9c37-361fe0b79427	6ce51259-bc48-46de-a80b-2884f52aa1bb
294	294	0	GBIF France	da44cd31-5901-4687-a106-6d1c7734ee3a	6d904ab3-aaff-434a-91e7-4f920a495402
2263	2263	0	GBIF France	da44cd31-5901-4687-a106-6d1c7734ee3a	6eda8bc2-7256-4949-8fd8-3d4cae3ca0f5
0	26	26	Ocean Biodiversity Information System	ba0670b9-4186-41e6-8e70-f9cb3065551a	6fd6b17a-5941-4a45-be83-6d7855801b65
3708	3708	0	Ocean Biodiversity Information System	ba0670b9-4186-41e6-8e70-f9cb3065551a	70825b58-e23f-41ce-9de1-1f472278a2fd
40	40	0	GBIF Germany	4f6826f2-4ff6-443d-b966-e6913bd24013	7091930a-f762-11e1-a439-00145eb45e9a
69	52	-17	GBIF Germany	4f6826f2-4ff6-443d-b966-e6913bd24013	70d4b662-f762-11e1-a439-00145eb45e9a
2905	1862	-1043	GBIF Germany	4f6826f2-4ff6-443d-b966-e6913bd24013	710d4f2c-f762-11e1-a439-00145eb45e9a
85972	85972	0	GBIF Japan	db5705aa-6a6e-42f1-8942-d77b9f4896ea	71d7bac8-f762-11e1-a439-00145eb45e9a
8261	8543	282	GBIF Germany	4f6826f2-4ff6-443d-b966-e6913bd24013	71f159ce-f762-11e1-a439-00145eb45e9a
82855	82855	0	GBIF Brazil	cdc9736d-5ff7-4ece-9959-3c744360cdb3	72116eb4-ca86-48a6-a280-232a3eebcb1d
1	1	0	Plazi	ffb07bec-2d10-492d-9c37-361fe0b79427	72a08de7-a7f9-4c7c-90e2-1fe1e7e6dd32
2	2	0	Plazi	ffb07bec-2d10-492d-9c37-361fe0b79427	747fe5b0-94de-4cc0-abf5-52790e35fbbf
8880	8880	0	GBIF Germany	4f6826f2-4ff6-443d-b966-e6913bd24013	7489daf3-cce0-43bd-b34a-e562702c909b
2	2	0	Plazi	ffb07bec-2d10-492d-9c37-361fe0b79427	74d249cc-80b8-4b89-8545-062344f6f9e6
135	135	0	GBIF France	da44cd31-5901-4687-a106-6d1c7734ee3a	779b8e90-9434-4c09-acc7-c709e898f93a
4	4	0	GBIF Germany	4f6826f2-4ff6-443d-b966-e6913bd24013	788f4a48-f762-11e1-a439-00145eb45e9a
7	7	0	Plazi	ffb07bec-2d10-492d-9c37-361fe0b79427	78a85ed8-73a5-46f5-9726-5b84f9542331
16	16	0	Plazi	ffb07bec-2d10-492d-9c37-361fe0b79427	7920f4c8-415e-46cb-a9d9-1939ddedaa80
278	278	0	GBIF Germany	4f6826f2-4ff6-443d-b966-e6913bd24013	792bf820-f762-11e1-a439-00145eb45e9a
819	649	-170	GBIF Germany	4f6826f2-4ff6-443d-b966-e6913bd24013	798dac6e-f762-11e1-a439-00145eb45e9a
588345	592153	3808	U.S. Geological Survey	8618c64a-93e0-4300-b546-7249e5148ed2	7a25f7aa-03fb-4322-aaeb-66719e1a9527
2	2	0	Plazi	ffb07bec-2d10-492d-9c37-361fe0b79427	7a90bcc3-912f-4af4-9a4e-088a6f380b3a
852	852	0	GBIF Japan	db5705aa-6a6e-42f1-8942-d77b9f4896ea	7ae36c8e-f762-11e1-a439-00145eb45e9a
80	80	0	GBIF Germany	4f6826f2-4ff6-443d-b966-e6913bd24013	7cbad22c-f762-11e1-a439-00145eb45e9a
8	8	0	Plazi	ffb07bec-2d10-492d-9c37-361fe0b79427	7cc0ff1b-fcc1-4309-8e3f-24a227855cd0
33	37	4	GBIF Germany	4f6826f2-4ff6-443d-b966-e6913bd24013	7d0cbe70-f762-11e1-a439-00145eb45e9a
1044	350	-694	GBIF Germany	4f6826f2-4ff6-443d-b966-e6913bd24013	7e3f369c-f762-11e1-a439-00145eb45e9a
0	97	97	Ocean Biodiversity Information System	ba0670b9-4186-41e6-8e70-f9cb3065551a	7e509005-a78e-47d8-8bc3-f59f147904ac
18471	5217	-13254	GBIF Germany	4f6826f2-4ff6-443d-b966-e6913bd24013	7e642a60-f762-11e1-a439-00145eb45e9a
570	234	-336	GBIF Germany	4f6826f2-4ff6-443d-b966-e6913bd24013	7ec36476-f762-11e1-a439-00145eb45e9a
2076	2076	0	Biodiversity Information System of Mexico	b324e8e9-9a4c-44fa-8f1a-7f39ea7ab576	8032ee3a-f762-11e1-a439-00145eb45e9a
4926	1450	-3476	Biodiversity Information System of Mexico	b324e8e9-9a4c-44fa-8f1a-7f39ea7ab576	80c4befa-f762-11e1-a439-00145eb45e9a
3984	3984	0	GBIF Japan	db5705aa-6a6e-42f1-8942-d77b9f4896ea	80df7e5c-f762-11e1-a439-00145eb45e9a
0	3659	3659	Canada Biodiversity Information Facility	8f83fc96-c966-4126-83f7-bf044dc49efa	8119b8d9-d054-4fa5-8f2c-6865aea709b5
100	105	5	GBIF Germany	4f6826f2-4ff6-443d-b966-e6913bd24013	81a890f8-f762-11e1-a439-00145eb45e9a
26	26	0	Colombian Biodiversity Information System	7e865cba-7c46-417b-ade5-97f2cf5b7be0	83360422-923e-442c-ba8d-662dd81d429e
31	31	0	Participant Node Managers Committee	7f48e0c8-5c96-49ec-b972-30748e339115	835bfa72-c1cf-4caf-9a38-e64508739f6b
1229	1229	0	Participant Node Managers Committee	7f48e0c8-5c96-49ec-b972-30748e339115	8497849e-773d-4d4b-b89c-221166879406
323	323	0	Biodiversity Information System of Mexico	b324e8e9-9a4c-44fa-8f1a-7f39ea7ab576	8513ad2c-f762-11e1-a439-00145eb45e9a
542357	545833	3476	U.S. Geological Survey	8618c64a-93e0-4300-b546-7249e5148ed2	854bc2fc-f762-11e1-a439-00145eb45e9a
422	315	-107	GBIF Germany	4f6826f2-4ff6-443d-b966-e6913bd24013	8714e8fc-f762-11e1-a439-00145eb45e9a
254	254	0	GBIF Germany	4f6826f2-4ff6-443d-b966-e6913bd24013	8756f56c-f762-11e1-a439-00145eb45e9a
8038	8486	448	GBIF Spain	1f94b3ca-9345-4d65-afe2-4bace93aa0fe	87903da9-cd4e-4d72-9518-e9b6f5b0a0fb
380	380	0	GBIF Germany	4f6826f2-4ff6-443d-b966-e6913bd24013	89c8f44e-f762-11e1-a439-00145eb45e9a
494	494	0	GBIF Germany	4f6826f2-4ff6-443d-b966-e6913bd24013	89dd9c32-f762-11e1-a439-00145eb45e9a
1291	1291	0	GBIF Germany	4f6826f2-4ff6-443d-b966-e6913bd24013	89ece39a-f762-11e1-a439-00145eb45e9a
126	126	0	GBIF Germany	4f6826f2-4ff6-443d-b966-e6913bd24013	8a222244-f762-11e1-a439-00145eb45e9a
244	244	0	GBIF Germany	4f6826f2-4ff6-443d-b966-e6913bd24013	8a449342-f762-11e1-a439-00145eb45e9a
129	129	0	GBIF Germany	4f6826f2-4ff6-443d-b966-e6913bd24013	8b364aac-f762-11e1-a439-00145eb45e9a
134	134	0	GBIF Germany	4f6826f2-4ff6-443d-b966-e6913bd24013	8b9ea11a-f762-11e1-a439-00145eb45e9a
21	21	0	GBIF Germany	4f6826f2-4ff6-443d-b966-e6913bd24013	8bd8e604-f762-11e1-a439-00145eb45e9a
1	1	0	Plazi	ffb07bec-2d10-492d-9c37-361fe0b79427	8d1eb512-bb27-4f06-8e1d-95d8d3aebe0c
6202	6202	0	Polish Biodiversity Information Network	2618bfdf-e194-4911-a241-80db3107bc51	8e93fad0-a705-11dc-80be-b8a03c50a862
290	290	0	GBIF France	da44cd31-5901-4687-a106-6d1c7734ee3a	8f96a629-355e-4459-b27b-fbab0b0550a0
291	248	-43	GBIF Germany	4f6826f2-4ff6-443d-b966-e6913bd24013	911a1674-f762-11e1-a439-00145eb45e9a
1386	1386	0	GBIF Benin	efb9c00e-f802-45dd-8826-a52ec45b89ff	917c7634-da2d-46ad-8914-83ca9c1784f8
782	530	-252	GBIF Germany	4f6826f2-4ff6-443d-b966-e6913bd24013	91a8ca54-f762-11e1-a439-00145eb45e9a
1335	1335	0	U.S. Geological Survey	8618c64a-93e0-4300-b546-7249e5148ed2	91b322c7-1007-448d-be03-6db86cf3d869
523	523	0	GBIF Germany	4f6826f2-4ff6-443d-b966-e6913bd24013	929ba6ca-f762-11e1-a439-00145eb45e9a
8	8	0	Plazi	ffb07bec-2d10-492d-9c37-361fe0b79427	93d3ab00-6496-442a-953f-700aaa938c5d
1	1	0	GBIF Germany	4f6826f2-4ff6-443d-b966-e6913bd24013	93fdd57e-f762-11e1-a439-00145eb45e9a
35	35	0	GBIF Germany	4f6826f2-4ff6-443d-b966-e6913bd24013	95043c42-f762-11e1-a439-00145eb45e9a
49	49	0	GBIF Germany	4f6826f2-4ff6-443d-b966-e6913bd24013	97a2b65e-f762-11e1-a439-00145eb45e9a
0	3	3	Plazi	ffb07bec-2d10-492d-9c37-361fe0b79427	9b3e082e-c829-4e3f-9d95-2327ac7e6cef
100	100	0	Plazi	ffb07bec-2d10-492d-9c37-361fe0b79427	9b92322c-8063-439b-87f1-4c2b2d55742f
1460	1460	0	GBIF Norway	4f829580-180d-46a9-9c87-ed8ec959b545	9cc6fab1-4652-47ec-b89b-db2950629372
219	146	-73	GBIF Germany	4f6826f2-4ff6-443d-b966-e6913bd24013	9ff5fc19-e2cd-47cb-8074-4074c34680af
1996	1996	0	GBIF France	da44cd31-5901-4687-a106-6d1c7734ee3a	a1077e55-120b-4c31-9a6b-ca7c210f5b04
30	30	0	Plazi	ffb07bec-2d10-492d-9c37-361fe0b79427	a16d2f00-0d1a-474e-b2bb-b987fed9894e
0	7	7	Plazi	ffb07bec-2d10-492d-9c37-361fe0b79427	a2842d55-9f37-461a-aef3-f18c9e25ae5f
4	4	0	Plazi	ffb07bec-2d10-492d-9c37-361fe0b79427	a3687cbb-73a6-49ff-ab1a-b2e8d0b54dfb
0	3	3	Plazi	ffb07bec-2d10-492d-9c37-361fe0b79427	a40bf690-5741-485b-acd3-558a7580bba1
155	155	0	Plazi	ffb07bec-2d10-492d-9c37-361fe0b79427	a72a13f8-f366-41db-835b-4b42169fd25b
0	245	245	GBIF Spain	1f94b3ca-9345-4d65-afe2-4bace93aa0fe	ab1abc7c-cf9b-4965-a945-14c4c05dd09c
100	869	769	GBIF Argentina	2426a871-9feb-40a1-96c6-0c593a76b835	aca403c6-2e69-4cf4-b7da-bc2ef1089419
375	375	0	GBIF France	da44cd31-5901-4687-a106-6d1c7734ee3a	add14f0a-c6f5-45db-b958-64350c98c15a
302769	302769	0	GBIF France	da44cd31-5901-4687-a106-6d1c7734ee3a	ae89759c-c8f0-436f-bcc9-ef67874e2e30
281250	281250	0	GBIF France	da44cd31-5901-4687-a106-6d1c7734ee3a	aeeff4d1-a1e0-454e-ae87-2748138279d3
21	21	0	Participant Node Managers Committee	7f48e0c8-5c96-49ec-b972-30748e339115	aff0c909-a2f0-46c2-963f-a720c0225c0b
1704	1704	0	GBIF France	da44cd31-5901-4687-a106-6d1c7734ee3a	aff9a2e1-24a0-4e32-9a90-d61c98be0ef3
0	305	305	Ocean Biodiversity Information System	ba0670b9-4186-41e6-8e70-f9cb3065551a	b3c493d1-9f93-454a-bccd-32b35bd0a70a
36	36	0	Plazi	ffb07bec-2d10-492d-9c37-361fe0b79427	b3e435ef-67d4-40dc-a7f8-cfd8c520f28f
0	1	1	Participant Node Managers Committee	7f48e0c8-5c96-49ec-b972-30748e339115	b4b0df05-4141-4479-a5a2-49adf2107c27
20422	20422	0	GBIF France	da44cd31-5901-4687-a106-6d1c7734ee3a	b4ce6585-15df-4f64-8253-a428fd7f99b5
6	6	0	Participant Node Managers Committee	7f48e0c8-5c96-49ec-b972-30748e339115	b57862a1-4aa0-4b0c-8bdb-e8ab6f361078
0	2	2	Plazi	ffb07bec-2d10-492d-9c37-361fe0b79427	b6c3e51a-360f-45f6-905e-cff5a9f306ac
0	21	21	Plazi	ffb07bec-2d10-492d-9c37-361fe0b79427	b8866544-2d1c-412c-be3c-5f497c7c98f6
14	14	0	GBIF France	da44cd31-5901-4687-a106-6d1c7734ee3a	b9a8e9d7-bc3d-4c23-829b-6f04f7643af0
1029	1029	0	Participant Node Managers Committee	7f48e0c8-5c96-49ec-b972-30748e339115	b9d89ed1-6502-4d32-94af-a828c11048f0
81	81	0	Colombian Biodiversity Information System	7e865cba-7c46-417b-ade5-97f2cf5b7be0	ba828254-92eb-4d0d-bd94-5752597639ba
0	13	13	Plazi	ffb07bec-2d10-492d-9c37-361fe0b79427	bb69ed40-0261-4e0d-8264-ef27d3064148
0	1	1	Plazi	ffb07bec-2d10-492d-9c37-361fe0b79427	bc66c846-53a3-46db-bf1f-cb37ef82281e
225	225	0	National Biodiversity Network	d897a5b9-35ee-4232-94bd-b0bcaac003c2	becd96c5-e731-4636-8b29-97f8f2fe7ed3
102701	102701	0	GBIF France	da44cd31-5901-4687-a106-6d1c7734ee3a	bff23119-69aa-4127-9710-08cccd0d6fa3
12	12	0	Plazi	ffb07bec-2d10-492d-9c37-361fe0b79427	c09c8f15-cfb2-42c9-861b-fc823ba28ae4
2784	1740	-1044	GBIF Germany	4f6826f2-4ff6-443d-b966-e6913bd24013	c130956e-3511-4dff-a396-f0aa2a7cc173
359	359	0	GBIF Germany	4f6826f2-4ff6-443d-b966-e6913bd24013	c18ebb72-6c7c-11e2-90ce-00145eb45e9a
10494	33092	22598	U.S. Geological Survey	8618c64a-93e0-4300-b546-7249e5148ed2	c4dec041-3704-4788-abd8-b4064d25442e
2	2	0	Plazi	ffb07bec-2d10-492d-9c37-361fe0b79427	c5b0ba87-19dd-4ff9-990b-a478373f2282
3982	3982	0	National Biodiversity Network	d897a5b9-35ee-4232-94bd-b0bcaac003c2	c6239022-084e-4b39-8825-fc8beb61eb4c
13	13	0	Plazi	ffb07bec-2d10-492d-9c37-361fe0b79427	c7b9429a-8520-49c7-b8f0-f62ccac35ad9
0	4	4	Plazi	ffb07bec-2d10-492d-9c37-361fe0b79427	cac02302-4b57-4e1b-8106-c5e389db269d
0	2	2	Plazi	ffb07bec-2d10-492d-9c37-361fe0b79427	cbd7fe36-0b58-4389-9dd0-0a27b5bb7398
0	10	10	Plazi	ffb07bec-2d10-492d-9c37-361fe0b79427	cc0592d1-cf60-451e-9a38-798c281a103b
256	256	0	National Biodiversity Network	d897a5b9-35ee-4232-94bd-b0bcaac003c2	cee51d87-9d84-465a-9eed-47a469e3e9d0
6	6	0	Plazi	ffb07bec-2d10-492d-9c37-361fe0b79427	cf6a94b5-1ee9-4b1e-9594-777d5200ae72
11	11	0	Plazi	ffb07bec-2d10-492d-9c37-361fe0b79427	d4bcde34-1a74-42bf-a7f6-bccdc7664fc0
118	118	0	GBIF France	da44cd31-5901-4687-a106-6d1c7734ee3a	d5bfc162-8621-4f3c-85b3-0965b475c81b
59	59	0	GBIF France	da44cd31-5901-4687-a106-6d1c7734ee3a	d75d1dc6-a42b-49a2-bb6a-2b1515f20eb2
61810	61810	0	GBIF France	da44cd31-5901-4687-a106-6d1c7734ee3a	d7bc133c-6427-4e66-a1aa-1132abb28e4c
1296	1296	0	GBIF France	da44cd31-5901-4687-a106-6d1c7734ee3a	d9025656-474a-493a-a2e1-010071fe2070
83	83	0	GBIF Germany	4f6826f2-4ff6-443d-b966-e6913bd24013	d9bc1c75-9868-4625-86f4-a1987a2b3e6d
0	1475	1475	GBIF Benin	efb9c00e-f802-45dd-8826-a52ec45b89ff	da671aae-032d-499f-bf54-3472330947e6
7	7	0	Plazi	ffb07bec-2d10-492d-9c37-361fe0b79427	daef5b52-c8e8-4dcf-8c73-2ba9c4f2b72f
54	54	0	GBIF Germany	4f6826f2-4ff6-443d-b966-e6913bd24013	dce9d059-20e7-40c2-9dc0-2c5707d3db3b
2423	2423	0	GBIF Spain	1f94b3ca-9345-4d65-afe2-4bace93aa0fe	df3eab30-0837-11d9-acb2-b8a03c50a862
0	1934	1934	GBIF Argentina	2426a871-9feb-40a1-96c6-0c593a76b835	df59f7f3-bcb9-4401-b65a-58fd4f46dc2a
0	10	10	Plazi	ffb07bec-2d10-492d-9c37-361fe0b79427	e21f2539-887c-4f8a-97bf-41cbfbdd64e4
429	429	0	Atlas of Living Australia	4a6f1b71-969e-4fc5-a693-282b05e1220c	e5464dc8-3361-476f-b415-d4a3a7dda8e7
2	2	0	Plazi	ffb07bec-2d10-492d-9c37-361fe0b79427	e62219d2-9e17-47c5-a182-4d39e35f1b49
546	546	0	GBIF Germany	4f6826f2-4ff6-443d-b966-e6913bd24013	e62251c2-9e11-4acb-a97c-75998f856289
2573318	2573315	-3	National Biodiversity Network	d897a5b9-35ee-4232-94bd-b0bcaac003c2	e707e6da-e143-445d-b41d-529c4a777e8b
2	2	0	Plazi	ffb07bec-2d10-492d-9c37-361fe0b79427	e765e640-9fd0-4d80-b1e2-ec459ebd62d0
1835	1835	0	GBIF Norway	4f829580-180d-46a9-9c87-ed8ec959b545	e81deebe-fff1-44d7-b15e-207a859f0e2f
223	223	0	U.S. Geological Survey	8618c64a-93e0-4300-b546-7249e5148ed2	edcfac76-5c00-4338-9b06-a07d14a0d567
0	388	388	Participant Node Managers Committee	7f48e0c8-5c96-49ec-b972-30748e339115	eddd4649-f6e6-4c26-82d9-10367bb26dc9
7	7	0	Plazi	ffb07bec-2d10-492d-9c37-361fe0b79427	eecc0eab-145e-4e3a-bab2-533c76466860
0	555	555	National Biodiversity Network	d897a5b9-35ee-4232-94bd-b0bcaac003c2	efb5e82d-477a-4a2e-a944-712963559db4
6	6	0	GBIF France	da44cd31-5901-4687-a106-6d1c7734ee3a	f3acb7e6-3291-47d7-b61f-162f7abd811e
2	2	0	Plazi	ffb07bec-2d10-492d-9c37-361fe0b79427	f53f4319-10c7-4617-a52d-75c46e8cc1dc
0	25	25	Ocean Biodiversity Information System	ba0670b9-4186-41e6-8e70-f9cb3065551a	f56c51d4-9af5-4433-ad0f-476aa77cc0fd
12	12	0	Plazi	ffb07bec-2d10-492d-9c37-361fe0b79427	f60073f7-dc2b-4b97-a211-bddcaac6bd3e
38	38	0	Plazi	ffb07bec-2d10-492d-9c37-361fe0b79427	f64da46d-1717-4f28-8454-1ffb53a21e49
0	8	8	Plazi	ffb07bec-2d10-492d-9c37-361fe0b79427	f6c00943-7c34-4a52-b2a1-b0fbeb9c5458
11	11	0	Plazi	ffb07bec-2d10-492d-9c37-361fe0b79427	f7db4449-427e-4173-8f58-e5d49fc0e034
461	461	0	Colombian Biodiversity Information System	7e865cba-7c46-417b-ade5-97f2cf5b7be0	fd38f642-c580-42af-8ef3-1ce72c92e2a8
1	1	0	Plazi	ffb07bec-2d10-492d-9c37-361fe0b79427	0259325a-f32c-440b-8356-b5e70abbbaee
0	1	1	Plazi	ffb07bec-2d10-492d-9c37-361fe0b79427	03094c25-9057-4f2e-8f1a-296aadfca17d
28385	28385	0	GBIF Argentina	2426a871-9feb-40a1-96c6-0c593a76b835	0409a304-cc5d-4af6-b509-5b6667905117
190	190	0	Participant Node Managers Committee	7f48e0c8-5c96-49ec-b972-30748e339115	07246b3c-69f9-4ad9-b952-8b8eb20cc4df
432	432	0	GBIF Spain	1f94b3ca-9345-4d65-afe2-4bace93aa0fe	07a5000b-6dde-49c3-9c05-881b855244c6
1510	1510	0	Biodiversity Information System of Mexico	b324e8e9-9a4c-44fa-8f1a-7f39ea7ab576	0c70b4de-b7af-4cda-b9de-b59d4be45879
0	5	5	Plazi	ffb07bec-2d10-492d-9c37-361fe0b79427	0cb899e5-5d69-4903-a2ff-a888ae1b1ece
412	412	0	GBIF Argentina	2426a871-9feb-40a1-96c6-0c593a76b835	0e865f17-2189-405f-ae2d-fd8b81a1668b
10098	10098	0	GBIF Portugal	673f7038-4262-4149-b753-5658a4e912f6	17545684-9082-43ad-a666-8b1913fa47c5
9	9	0	Plazi	ffb07bec-2d10-492d-9c37-361fe0b79427	19755ebe-ef94-473b-b7bc-5f8a7422e73f
2	2	0	Plazi	ffb07bec-2d10-492d-9c37-361fe0b79427	1e5e56b3-a499-4578-a185-4e4418157e8e
5053	5053	0	National Biodiversity Network	d897a5b9-35ee-4232-94bd-b0bcaac003c2	206aefee-0e5f-427b-9710-08028123f964
0	5	5	Plazi	ffb07bec-2d10-492d-9c37-361fe0b79427	223b29da-f62b-4e77-b872-71678b2a624f
7009	7009	0	GBIF France	da44cd31-5901-4687-a106-6d1c7734ee3a	29f4379a-6f76-4fef-bad7-bea550af9e16
540	540	0	GBIF France	da44cd31-5901-4687-a106-6d1c7734ee3a	2b107698-cbd1-486b-8e96-bfe63cb212a7
1637	1637	0	GBIF Germany	4f6826f2-4ff6-443d-b966-e6913bd24013	2b5a4824-aa72-488b-9c13-118436f0d969
884	884	0	GBIF France	da44cd31-5901-4687-a106-6d1c7734ee3a	2c0a7d66-d198-40d3-8f5c-f44c87737ecc
1154	1154	0	GBIF Japan	db5705aa-6a6e-42f1-8942-d77b9f4896ea	2e37d484-5ab6-4ae2-9e48-104af0e7123e
5	5	0	Plazi	ffb07bec-2d10-492d-9c37-361fe0b79427	316e3c50-28c0-42cc-944a-12a61c60123c
9088	9088	0	Polish Biodiversity Information Network	2618bfdf-e194-4911-a241-80db3107bc51	39648a70-b461-11dc-bc42-b8a03c50a862
0	7738	7738	Participant Node Managers Committee	7f48e0c8-5c96-49ec-b972-30748e339115	39d71489-2029-4272-95ce-eec6fb8bb5fb
0	327	327	Plazi	ffb07bec-2d10-492d-9c37-361fe0b79427	3b88b7a2-5e1f-4e54-b426-6686fbd10883
19	19	0	Plazi	ffb07bec-2d10-492d-9c37-361fe0b79427	3f5c3a3c-815d-4676-968b-0fdec03cfd0b
526	526	0	Biodiversity Information System of Mexico	b324e8e9-9a4c-44fa-8f1a-7f39ea7ab576	42a04aa8-4e0c-4855-ac71-e64972b22aad
5	5	0	Plazi	ffb07bec-2d10-492d-9c37-361fe0b79427	4403e1a5-a44d-4b18-8052-c4c68a4ec770
23043	23937	894	U.S. Geological Survey	8618c64a-93e0-4300-b546-7249e5148ed2	44525bc9-4412-441a-9890-1df3d289e3f6
541	541	0	GBIF Chile	a8b16421-d80b-4ef3-8f22-098b01a89255	474ee54a-9eae-4b67-b79b-d8fc2d9ec884
116	116	0	GBIF France	da44cd31-5901-4687-a106-6d1c7734ee3a	4787b375-f6a0-4fa5-a62c-3341d79dc471
0	271440	271440	GBIF Portugal	673f7038-4262-4149-b753-5658a4e912f6	4f6de508-f3f6-4be7-a184-1abee52cac1b
326	326	0	GBIF France	da44cd31-5901-4687-a106-6d1c7734ee3a	4fe9b986-5fca-4fe3-9c82-d798a59116bb
0	3	3	Plazi	ffb07bec-2d10-492d-9c37-361fe0b79427	51426c63-a3a3-49dd-9eaf-9c7d75ea19ab
125	125	0	Atlas of Living Australia	4a6f1b71-969e-4fc5-a693-282b05e1220c	53334055-d64e-48cd-8c83-2295d3891782
475	475	0	GBIF France	da44cd31-5901-4687-a106-6d1c7734ee3a	54f94614-67b6-4d51-bd17-495de067a357
134	134	0	U.S. Geological Survey	8618c64a-93e0-4300-b546-7249e5148ed2	55a052c5-3cea-49f6-a525-d06d9f02dba8
13	13	0	Plazi	ffb07bec-2d10-492d-9c37-361fe0b79427	55df350b-41c6-4f2e-9a18-c0be6d47498b
6	6	0	Plazi	ffb07bec-2d10-492d-9c37-361fe0b79427	56159775-7e23-4025-98ee-22d5a91986ef
1811	1811	0	Atlas of Living Australia	4a6f1b71-969e-4fc5-a693-282b05e1220c	56572b2e-64b3-489b-b4b8-e07f810e9491
1486	1486	0	Biodiversity Information System of Mexico	b324e8e9-9a4c-44fa-8f1a-7f39ea7ab576	56909c72-685a-4ba2-892f-a0e474bbcfaa
1727	1727	0	National Biodiversity Network	d897a5b9-35ee-4232-94bd-b0bcaac003c2	577ef136-972f-41f6-bdba-713a9b97ccab
3	3	0	Plazi	ffb07bec-2d10-492d-9c37-361fe0b79427	586d0df0-d8b0-4479-a391-9ba99a387cdb
0	3	3	Ocean Biodiversity Information System	ba0670b9-4186-41e6-8e70-f9cb3065551a	5a351e76-79e5-4b72-93d8-c6ef9aa76d63
981	981	0	GBIF France	da44cd31-5901-4687-a106-6d1c7734ee3a	5ad417f4-8c36-49c7-afc5-99bdc69973da
12564	12564	0	GBIF France	da44cd31-5901-4687-a106-6d1c7734ee3a	5bb4bd79-be45-4618-bee9-3355dc1feb51
26	26	0	Plazi	ffb07bec-2d10-492d-9c37-361fe0b79427	5c2ea8f4-6c5d-49ad-bcc6-8946b4eb632b
36	36	0	Plazi	ffb07bec-2d10-492d-9c37-361fe0b79427	5eacc4c2-0f72-4ac8-8ba6-66814d99ba96
13	13	0	Plazi	ffb07bec-2d10-492d-9c37-361fe0b79427	5f395d87-2318-4700-bbf7-62e4476e9669
11	11	0	Plazi	ffb07bec-2d10-492d-9c37-361fe0b79427	5f3f6c5c-3d87-41ce-91ac-9f434883f245
72	72	0	Plazi	ffb07bec-2d10-492d-9c37-361fe0b79427	6249293e-8b46-4228-8d36-b3fae7d7013b
26	26	0	GBIF Germany	4f6826f2-4ff6-443d-b966-e6913bd24013	6280ba7a-f762-11e1-a439-00145eb45e9a
23	23	0	GBIF Germany	4f6826f2-4ff6-443d-b966-e6913bd24013	62db1876-f762-11e1-a439-00145eb45e9a
95	95	0	GBIF Germany	4f6826f2-4ff6-443d-b966-e6913bd24013	63bbb03e-f762-11e1-a439-00145eb45e9a
30	30	0	GBIF Germany	4f6826f2-4ff6-443d-b966-e6913bd24013	64817468-f762-11e1-a439-00145eb45e9a
14	14	0	GBIF Germany	4f6826f2-4ff6-443d-b966-e6913bd24013	64bce732-f762-11e1-a439-00145eb45e9a
3325	3325	0	GBIF Benin	efb9c00e-f802-45dd-8826-a52ec45b89ff	64c316c6-3de1-4d3d-9fa1-84c5a19f2342
135	126	-9	GBIF Germany	4f6826f2-4ff6-443d-b966-e6913bd24013	656870c0-f762-11e1-a439-00145eb45e9a
14	11	-3	GBIF Germany	4f6826f2-4ff6-443d-b966-e6913bd24013	65b4adb4-f762-11e1-a439-00145eb45e9a
18	17	-1	GBIF Germany	4f6826f2-4ff6-443d-b966-e6913bd24013	65b5dd24-f762-11e1-a439-00145eb45e9a
24	24	0	GBIF Germany	4f6826f2-4ff6-443d-b966-e6913bd24013	66bc6b2a-f762-11e1-a439-00145eb45e9a
1667	1667	0	GBIF Malawi	2a42e4d7-ad4a-41b3-84c4-de4aa7b74d35	68998c38-2d26-48b4-af53-d64dc4f7dee2
0	458	458	GBIF Benin	efb9c00e-f802-45dd-8826-a52ec45b89ff	6961c44a-5856-465e-8196-2f626c82f41f
1353	1255	-98	Biodiversity Information System of Mexico	b324e8e9-9a4c-44fa-8f1a-7f39ea7ab576	698bcafa-eb8e-4262-a0db-f0be58042f05
4929	6495	1566	GBIF Spain	1f94b3ca-9345-4d65-afe2-4bace93aa0fe	6aeebd1a-c3ad-4bc5-bdfe-24de0e2e9052
0	35504	35504	VertNet	d205def7-82c3-472a-be4b-31d11dcd51fd	6ce307d0-0456-4b74-b647-db0ace930b26
0	469	469	Ocean Biodiversity Information System	ba0670b9-4186-41e6-8e70-f9cb3065551a	703443b8-0df1-4f67-aab8-9b9fece36cd1
4	4	0	Plazi	ffb07bec-2d10-492d-9c37-361fe0b79427	70ca91b0-8acb-474d-a84e-429c2d6934cc
99	99	0	GBIF Germany	4f6826f2-4ff6-443d-b966-e6913bd24013	70f88c4a-f762-11e1-a439-00145eb45e9a
70	70	0	GBIF Germany	4f6826f2-4ff6-443d-b966-e6913bd24013	717c7d20-f762-11e1-a439-00145eb45e9a
102	102	0	GBIF Germany	4f6826f2-4ff6-443d-b966-e6913bd24013	74f5c9b6-f762-11e1-a439-00145eb45e9a
137	137	0	GBIF Germany	4f6826f2-4ff6-443d-b966-e6913bd24013	75b20cca-f762-11e1-a439-00145eb45e9a
360	360	0	GBIF Germany	4f6826f2-4ff6-443d-b966-e6913bd24013	77666f98-f762-11e1-a439-00145eb45e9a
37	37	0	GBIF Germany	4f6826f2-4ff6-443d-b966-e6913bd24013	7924acbe-f762-11e1-a439-00145eb45e9a
66	60	-6	GBIF Germany	4f6826f2-4ff6-443d-b966-e6913bd24013	7996a486-f762-11e1-a439-00145eb45e9a
0	4	4	Plazi	ffb07bec-2d10-492d-9c37-361fe0b79427	79b5f561-6e10-4c16-b956-c4d80c78b8f7
339	321	-18	GBIF Germany	4f6826f2-4ff6-443d-b966-e6913bd24013	79be5170-f762-11e1-a439-00145eb45e9a
8	8	0	Plazi	ffb07bec-2d10-492d-9c37-361fe0b79427	7a2c282e-0c7d-4f0b-879e-96c35e89e419
603	603	0	Korean Biodiversity Information Facility	e0a1e772-0177-4800-94b4-2d023fe6cdf4	7af4c074-f762-11e1-a439-00145eb45e9a
216	216	0	Ocean Biodiversity Information System	ba0670b9-4186-41e6-8e70-f9cb3065551a	7b43dfec-f762-11e1-a439-00145eb45e9a
119	119	0	GBIF Germany	4f6826f2-4ff6-443d-b966-e6913bd24013	7bf005ec-f762-11e1-a439-00145eb45e9a
0	14	14	Plazi	ffb07bec-2d10-492d-9c37-361fe0b79427	7c0977b7-61d4-4a11-a457-dfae853fdb65
256	256	0	GBIF Germany	4f6826f2-4ff6-443d-b966-e6913bd24013	7c54cd7e-f762-11e1-a439-00145eb45e9a
0	2237	2237	Atlas of Living Australia	4a6f1b71-969e-4fc5-a693-282b05e1220c	7e358b5a-bddb-4f8d-992a-09886d6ca3ef
530	530	0	GBIF Germany	4f6826f2-4ff6-443d-b966-e6913bd24013	7e91b354-f762-11e1-a439-00145eb45e9a
720	715	-5	Biodiversity Information System of Mexico	b324e8e9-9a4c-44fa-8f1a-7f39ea7ab576	7f7f1342-f762-11e1-a439-00145eb45e9a
79	79	0	GBIF France	da44cd31-5901-4687-a106-6d1c7734ee3a	7fdf9c45-d86f-409a-be04-f982217087e2
3000	3000	0	Biodiversity Information System of Mexico	b324e8e9-9a4c-44fa-8f1a-7f39ea7ab576	8091cd10-f762-11e1-a439-00145eb45e9a
98	98	0	GBIF Germany	4f6826f2-4ff6-443d-b966-e6913bd24013	81951ff0-f762-11e1-a439-00145eb45e9a
1773	1773	0	GBIF Germany	4f6826f2-4ff6-443d-b966-e6913bd24013	821e0798-f762-11e1-a439-00145eb45e9a
7	7	0	GBIF Germany	4f6826f2-4ff6-443d-b966-e6913bd24013	825c3630-f762-11e1-a439-00145eb45e9a
3	3	0	Plazi	ffb07bec-2d10-492d-9c37-361fe0b79427	83bb6fb8-8669-45c7-8029-cd568095aada
32097	32097	0	GBIF Japan	db5705aa-6a6e-42f1-8942-d77b9f4896ea	849f0a76-f762-11e1-a439-00145eb45e9a
0	16894	16894	Participant Node Managers Committee	7f48e0c8-5c96-49ec-b972-30748e339115	8586a4c3-1f1c-403c-91e9-020f9dc300d8
4722	4722	0	GBIF Japan	db5705aa-6a6e-42f1-8942-d77b9f4896ea	868ac4b0-f762-11e1-a439-00145eb45e9a
1	1	0	Plazi	ffb07bec-2d10-492d-9c37-361fe0b79427	86992fd3-f313-4874-b184-5e57e930a8fd
1248	915	-333	GBIF Germany	4f6826f2-4ff6-443d-b966-e6913bd24013	86e8ba3e-f762-11e1-a439-00145eb45e9a
2	3	1	Plazi	ffb07bec-2d10-492d-9c37-361fe0b79427	8942cb41-8781-4bd3-9d71-0050e088ff9f
0	9	9	Plazi	ffb07bec-2d10-492d-9c37-361fe0b79427	8999f160-cb30-4d0c-9091-664cdcd0ced7
961	961	0	GBIF Germany	4f6826f2-4ff6-443d-b966-e6913bd24013	89b797e4-f762-11e1-a439-00145eb45e9a
247	247	0	GBIF Germany	4f6826f2-4ff6-443d-b966-e6913bd24013	89dc2b86-f762-11e1-a439-00145eb45e9a
42	42	0	GBIF Germany	4f6826f2-4ff6-443d-b966-e6913bd24013	8bd3f518-f762-11e1-a439-00145eb45e9a
25	25	0	Plazi	ffb07bec-2d10-492d-9c37-361fe0b79427	8e6838a9-2473-49f1-b4ad-65f099f1576a
1344	1302	-42	GBIF Germany	4f6826f2-4ff6-443d-b966-e6913bd24013	8f0ff844-f762-11e1-a439-00145eb45e9a
639	639	0	GBIF France	da44cd31-5901-4687-a106-6d1c7734ee3a	8f6c0996-30aa-42d3-9331-d2e319e01554
6441	6441	0	Participant Node Managers Committee	7f48e0c8-5c96-49ec-b972-30748e339115	90c3e206-75fa-4527-9e8f-9406af78452f
272	100	-172	GBIF Germany	4f6826f2-4ff6-443d-b966-e6913bd24013	90fc2ee8-f762-11e1-a439-00145eb45e9a
76	49	-27	GBIF Germany	4f6826f2-4ff6-443d-b966-e6913bd24013	9103c5fe-f762-11e1-a439-00145eb45e9a
4	4	0	GBIF Germany	4f6826f2-4ff6-443d-b966-e6913bd24013	91136770-f762-11e1-a439-00145eb45e9a
1444	1444	0	GBIF Germany	4f6826f2-4ff6-443d-b966-e6913bd24013	92101146-f762-11e1-a439-00145eb45e9a
45003	45003	0	GBIF Argentina	2426a871-9feb-40a1-96c6-0c593a76b835	92d4b180-a103-11de-88ae-b8a03c50a862
73	73	0	GBIF Germany	4f6826f2-4ff6-443d-b966-e6913bd24013	930d5900-f762-11e1-a439-00145eb45e9a
6	6	0	Participant Node Managers Committee	7f48e0c8-5c96-49ec-b972-30748e339115	932e5fce-3e7d-4b29-9275-d0ea5a84e4b9
74	74	0	GBIF Germany	4f6826f2-4ff6-443d-b966-e6913bd24013	936a3382-f762-11e1-a439-00145eb45e9a
0	34	34	Participant Node Managers Committee	7f48e0c8-5c96-49ec-b972-30748e339115	93a83e6e-ffa7-4477-b8cf-aa1abe3d82f8
0	6	6	Plazi	ffb07bec-2d10-492d-9c37-361fe0b79427	943d42cd-b90b-4656-95ff-8c969639880a
7	7	0	Plazi	ffb07bec-2d10-492d-9c37-361fe0b79427	96b050ce-9408-4411-b7dc-51a171d4792e
22	22	0	Plazi	ffb07bec-2d10-492d-9c37-361fe0b79427	9a038753-d004-4647-9f2e-5c7872c35985
5	5	0	Plazi	ffb07bec-2d10-492d-9c37-361fe0b79427	9bc9c91b-601b-4203-8fbe-ac6805825de1
0	80	80	Ocean Biodiversity Information System	ba0670b9-4186-41e6-8e70-f9cb3065551a	9d81db90-78fb-46f9-9460-7ffd956ea10a
13	13	0	Plazi	ffb07bec-2d10-492d-9c37-361fe0b79427	9dd2550d-7a36-41a9-91a7-b7088097992f
0	8	8	Plazi	ffb07bec-2d10-492d-9c37-361fe0b79427	9f439c04-e64a-457d-b01f-dc028907f6c6
104	104	0	Plazi	ffb07bec-2d10-492d-9c37-361fe0b79427	a0525610-166a-4a90-97cb-6cd78d98a706
0	2	2	Plazi	ffb07bec-2d10-492d-9c37-361fe0b79427	a0ed7687-ca00-4a28-818d-35043a0a5aff
272	272	0	GBIF France	da44cd31-5901-4687-a106-6d1c7734ee3a	a179f08e-b4c6-43e0-ba23-17b0f5240933
8	8	0	Plazi	ffb07bec-2d10-492d-9c37-361fe0b79427	a30b0cfb-72ef-49cf-b982-d1a7f7be5027
242	242	0	Participant Node Managers Committee	7f48e0c8-5c96-49ec-b972-30748e339115	a42dad7a-09ce-414d-8c9d-c1ad1d8410a1
0	18	18	Plazi	ffb07bec-2d10-492d-9c37-361fe0b79427	a68a5856-c519-423d-a2bb-473c471a8dd5
0	301361	301361	Belgian Biodiversity Platform	fb11cfe1-ebc3-45af-9159-17d9fddbcdac	a76f8527-23e8-4ba5-bdff-f9821bdac187
14	14	0	Plazi	ffb07bec-2d10-492d-9c37-361fe0b79427	a816c380-3db4-4a65-a74e-83a794dd51ee
20	1157	1137	GBIF Germany	4f6826f2-4ff6-443d-b966-e6913bd24013	a8ba4023-1921-4ffa-a297-4a3bc484cf9c
1313	1313	0	Plazi	ffb07bec-2d10-492d-9c37-361fe0b79427	aac1a00b-ceaf-4b69-ad0c-ddb61c09151b
1	1	0	Plazi	ffb07bec-2d10-492d-9c37-361fe0b79427	acafc0a2-9629-4543-a86e-87e3bf3a8b3f
0	882	882	Ocean Biodiversity Information System	ba0670b9-4186-41e6-8e70-f9cb3065551a	aef12051-4ce4-454f-98be-c25f6e9b0af1
1	1	0	Plazi	ffb07bec-2d10-492d-9c37-361fe0b79427	b50d45e7-565d-4ab1-b360-1c4e30579b3d
10909	10909	0	National Biodiversity Data Centre	422b00b2-6c94-4bb6-976b-c359916efdb8	b5345830-c7b8-11de-b279-99d156ba6477
4378	4378	0	Belgian Biodiversity Platform	fb11cfe1-ebc3-45af-9159-17d9fddbcdac	b848583a-a47b-4d09-a58b-46d3236b3d10
1	1	0	Plazi	ffb07bec-2d10-492d-9c37-361fe0b79427	b8ab4269-f3e2-4528-935c-50c8c443ba72
47	47	0	Plazi	ffb07bec-2d10-492d-9c37-361fe0b79427	bace504a-09db-4a62-a010-f903f2d92d22
76380	76380	0	U.S. Geological Survey	8618c64a-93e0-4300-b546-7249e5148ed2	c21cd435-718a-4069-b503-776bf0e22b96
5444	5444	0	Atlas of Living Australia	4a6f1b71-969e-4fc5-a693-282b05e1220c	c2295938-45f9-473f-bfcc-453dfc590acf
0	4	4	Plazi	ffb07bec-2d10-492d-9c37-361fe0b79427	c2d7d81b-bddb-4eb6-979c-7935d2797cf5
11	11	0	Plazi	ffb07bec-2d10-492d-9c37-361fe0b79427	c355a1c1-9042-4b5a-ba7a-b3dbe3231997
39644	39643	-1	National Biodiversity Network	d897a5b9-35ee-4232-94bd-b0bcaac003c2	c358edb6-9b46-45eb-a173-b854910500a9
1610069	1610069	0	GBIF France	da44cd31-5901-4687-a106-6d1c7734ee3a	c4e76595-b467-4f88-8067-b8de661b99c5
3	6	3	Plazi	ffb07bec-2d10-492d-9c37-361fe0b79427	c6024463-4266-4109-b1db-b08b6538fdf6
3664	3664	0	Colombian Biodiversity Information System	7e865cba-7c46-417b-ade5-97f2cf5b7be0	c7ecf786-d4ab-4708-87da-bc34e542be44
10	10	0	Plazi	ffb07bec-2d10-492d-9c37-361fe0b79427	c8b172f7-4405-4432-8af6-d31cfa1766a0
6	6	0	Plazi	ffb07bec-2d10-492d-9c37-361fe0b79427	ca30ab4c-ed45-4da1-8eec-b872dfe62fae
0	40134	40134	U.S. Geological Survey	8618c64a-93e0-4300-b546-7249e5148ed2	cbd0e918-f98b-41e4-b91f-007dd2ac7414
0	15	15	Plazi	ffb07bec-2d10-492d-9c37-361fe0b79427	cbd813c3-228e-4bce-b30a-1a150d778c5b
2	2	0	Participant Node Managers Committee	7f48e0c8-5c96-49ec-b972-30748e339115	cd19892b-3d23-4af3-8ef6-b30e5dc41a7b
733	733	0	GBIF France	da44cd31-5901-4687-a106-6d1c7734ee3a	cd74cd6e-0378-4c90-baa9-9e1091eee686
8272	8272	0	GBIF France	da44cd31-5901-4687-a106-6d1c7734ee3a	cfd3d799-f92e-4549-8fa1-6f4265a0ad78
0	9	9	Ocean Biodiversity Information System	ba0670b9-4186-41e6-8e70-f9cb3065551a	d021ecf4-ba32-4e60-b6bb-75deb3b6b2ab
188	188	0	National Biodiversity Network	d897a5b9-35ee-4232-94bd-b0bcaac003c2	d40a541d-00ad-41e6-af0a-2c5fa6e87c1a
10	10	0	Plazi	ffb07bec-2d10-492d-9c37-361fe0b79427	d7c23b6e-a4cd-4921-97eb-a8b1c4e0a75b
9	9	0	Plazi	ffb07bec-2d10-492d-9c37-361fe0b79427	d7ec1b67-286b-45a9-920b-8c2e9238ca0a
1	1	0	Plazi	ffb07bec-2d10-492d-9c37-361fe0b79427	da3d32f7-982b-4a5e-a5e6-41cd13f5f790
106	106	0	Plazi	ffb07bec-2d10-492d-9c37-361fe0b79427	da624f19-30c7-4a4e-bf79-4626c7d83b02
1834	1834	0	Atlas of Living Australia	4a6f1b71-969e-4fc5-a693-282b05e1220c	dad84e72-95f7-4709-b564-72a4429942b1
1995	1995	0	Colombian Biodiversity Information System	7e865cba-7c46-417b-ade5-97f2cf5b7be0	dcfda747-f43d-430c-aa48-94bf6fa32095
14391	14391	0	GBIF France	da44cd31-5901-4687-a106-6d1c7734ee3a	df87d47a-6580-4417-8c4c-7e1a504ed4a7
7	7	0	Plazi	ffb07bec-2d10-492d-9c37-361fe0b79427	e1cd1863-f16c-4eab-9553-5d6bd4abb899
6862	6862	0	Colombian Biodiversity Information System	7e865cba-7c46-417b-ade5-97f2cf5b7be0	e2ef0827-8780-4bf2-b234-15911aebc641
0	64	64	Plazi	ffb07bec-2d10-492d-9c37-361fe0b79427	e5d1920d-c769-4aea-a8cb-237a0e58ae4c
17	17	0	Colombian Biodiversity Information System	7e865cba-7c46-417b-ade5-97f2cf5b7be0	e637287b-9fd4-4576-956a-17de569f8c8e
0	36	36	Ocean Biodiversity Information System	ba0670b9-4186-41e6-8e70-f9cb3065551a	e69d3360-6a96-45c7-9758-88ad50df5428
5	5	0	Plazi	ffb07bec-2d10-492d-9c37-361fe0b79427	e7f572ca-aedb-447c-a92a-eea3d3798d8c
26	26	0	Plazi	ffb07bec-2d10-492d-9c37-361fe0b79427	eae2652b-e985-466c-acbb-c5dbf7964914
2377	2377	0	Netherlands Biodiversity Information Facility	0909d601-bda2-42df-9e63-a6d51847ebce	ebdc9eed-2673-43fc-a4e9-f80de9a68bcb
50	50	0	GBIF France	da44cd31-5901-4687-a106-6d1c7734ee3a	ec253cf8-bb93-4ec8-b477-4b7cadad78c4
0	3	3	Plazi	ffb07bec-2d10-492d-9c37-361fe0b79427	ed0b58c1-86de-4cbe-8651-dff74f4410f9
1	1	0	Plazi	ffb07bec-2d10-492d-9c37-361fe0b79427	ee971253-26e8-4eba-9763-76599c9e43ac
0	325	325	Plazi	ffb07bec-2d10-492d-9c37-361fe0b79427	ef663e33-b442-492e-8d5c-a373429ef059
0	48	48	Plazi	ffb07bec-2d10-492d-9c37-361fe0b79427	efffbbf9-8fdd-484c-a9c2-933659495b1a
5	5	0	Plazi	ffb07bec-2d10-492d-9c37-361fe0b79427	f4c97e0e-fc3f-41a8-8ab5-b07a304f1848
1	1	0	Plazi	ffb07bec-2d10-492d-9c37-361fe0b79427	f9dcd5b8-e298-4bb2-aef0-e78c09e4c6d0
0	6	6	Plazi	ffb07bec-2d10-492d-9c37-361fe0b79427	fbabf01c-1cfc-4095-a120-58a1a64b1c09
2006	2006	0	GBIF France	da44cd31-5901-4687-a106-6d1c7734ee3a	fea7a729-94f7-4a03-82ba-dabbf5ab00a5
0	3	3	Plazi	ffb07bec-2d10-492d-9c37-361fe0b79427	ffd3fac2-00e4-4ea2-8b93-7c11093d5731
11252	11252	0	U.S. Geological Survey	8618c64a-93e0-4300-b546-7249e5148ed2	0108bdc9-3d7f-459a-a92e-a40c3ed07c93
0	1920	1920	Atlas of Living Australia	4a6f1b71-969e-4fc5-a693-282b05e1220c	0238226f-76d2-4e85-8f83-a62426226233
12	12	0	Plazi	ffb07bec-2d10-492d-9c37-361fe0b79427	0329fbf7-0543-45d2-8c4b-e6510028beef
385	385	0	GBIF Germany	4f6826f2-4ff6-443d-b966-e6913bd24013	046dd35b-bdf9-4041-8801-3fa90690b3b5
0	90	90	Ocean Biodiversity Information System	ba0670b9-4186-41e6-8e70-f9cb3065551a	0639265c-2d39-4a04-8245-f61ef20a821e
250	250	0	GBIF France	da44cd31-5901-4687-a106-6d1c7734ee3a	0685a6fd-ff3b-4ca5-b960-7e0e4c235e4d
713	713	0	GBIF France	da44cd31-5901-4687-a106-6d1c7734ee3a	08002039-1617-4350-a17b-7a07ba1ca483
0	3	3	Ocean Biodiversity Information System	ba0670b9-4186-41e6-8e70-f9cb3065551a	0b9897fc-911d-4cd2-a09f-494c21416dc4
1596	988	-608	GBIF Germany	4f6826f2-4ff6-443d-b966-e6913bd24013	0c32f395-fd7e-4238-b16e-c1b9e0c40483
339833	414214	74381	National Biodiversity Network	d897a5b9-35ee-4232-94bd-b0bcaac003c2	0e7ec47d-6247-4fdd-bfb7-96281e0b5ebe
0	6	6	Plazi	ffb07bec-2d10-492d-9c37-361fe0b79427	0fcbcbdb-9161-4a01-a6bd-6fc785cbe8ad
359	318	-41	Biodiversity Information System of Mexico	b324e8e9-9a4c-44fa-8f1a-7f39ea7ab576	115927c2-12e1-49df-b162-d55ea28eefaf
2116	2116	0	GBIF France	da44cd31-5901-4687-a106-6d1c7734ee3a	153e9f31-04c3-40d3-a99e-6150e38111a8
22804	22804	0	U.S. Geological Survey	8618c64a-93e0-4300-b546-7249e5148ed2	16b0aa56-90aa-436c-bfe8-b5af83f84575
46	46	0	Plazi	ffb07bec-2d10-492d-9c37-361fe0b79427	16d9ff47-9a8c-48fc-93be-078030e0ece8
16	16	0	Plazi	ffb07bec-2d10-492d-9c37-361fe0b79427	181c0463-aa56-4f6e-bb0d-e2b7df59e317
31	31	0	Plazi	ffb07bec-2d10-492d-9c37-361fe0b79427	19a23a7c-4113-4ab0-a548-2092e2216069
377	364	-13	GBIF Germany	4f6826f2-4ff6-443d-b966-e6913bd24013	1af2035a-14f7-4dfc-903c-ba5218e4da32
0	224419	224419	Canada Biodiversity Information Facility	8f83fc96-c966-4126-83f7-bf044dc49efa	1cde1ee9-bf4d-4028-a238-b214d770d4a4
1464	912	-552	GBIF Germany	4f6826f2-4ff6-443d-b966-e6913bd24013	1de7c7ff-023b-4a87-84f9-e6eebf22fd4a
38	38	0	Colombian Biodiversity Information System	7e865cba-7c46-417b-ade5-97f2cf5b7be0	1f1e484e-0ed8-4b2a-9f24-48b8287fd097
72	72	0	Plazi	ffb07bec-2d10-492d-9c37-361fe0b79427	1fbcced0-ec5a-4afe-bcb1-496990e850c9
0	263	263	National Biodiversity Network	d897a5b9-35ee-4232-94bd-b0bcaac003c2	261a16eb-1cd2-4b6b-85c7-ef9a36421bf4
0	6	6	Plazi	ffb07bec-2d10-492d-9c37-361fe0b79427	280b385e-c15a-4f01-8306-919d8f0101c4
25098	25098	0	U.S. Geological Survey	8618c64a-93e0-4300-b546-7249e5148ed2	28573c0a-b833-41b1-9999-56c6b9bce519
5	5	0	GBIF Portugal	673f7038-4262-4149-b753-5658a4e912f6	2b127a7e-c6c7-4036-9784-b454fc404cb9
77333	77333	0	Biodiversity Information System of Mexico	b324e8e9-9a4c-44fa-8f1a-7f39ea7ab576	2c77f896-e068-4837-8a55-d6b7d94c3b0d
0	1	1	Plazi	ffb07bec-2d10-492d-9c37-361fe0b79427	2d1d014b-71ee-4791-8339-aa1cd21eeec8
11	11	0	GBIF France	da44cd31-5901-4687-a106-6d1c7734ee3a	2d301f08-e98a-4c08-8aa3-0be4126ad3e5
98	98	0	Colombian Biodiversity Information System	7e865cba-7c46-417b-ade5-97f2cf5b7be0	30606619-8e8a-4e2f-abcf-7385818e7550
0	12781	12781	GBIF Portugal	673f7038-4262-4149-b753-5658a4e912f6	322b5629-997c-4986-ada9-7d9d078d8648
1287	1287	0	Netherlands Biodiversity Information Facility	0909d601-bda2-42df-9e63-a6d51847ebce	32ab1d81-9131-45e3-ae74-69dd696341ea
499	499	0	Colombian Biodiversity Information System	7e865cba-7c46-417b-ade5-97f2cf5b7be0	336137d9-a446-4033-90d8-11bfad870e32
5880	5880	0	Biodiversity Information System of Mexico	b324e8e9-9a4c-44fa-8f1a-7f39ea7ab576	3509d20f-3c92-4edd-9a9c-cf21d804af44
0	12	12	Plazi	ffb07bec-2d10-492d-9c37-361fe0b79427	3591d588-5700-4bfe-a805-57486be6721b
173	173	0	GBIF France	da44cd31-5901-4687-a106-6d1c7734ee3a	36cbcb77-ac64-46b8-a560-15f8386ba30b
0	11	11	Plazi	ffb07bec-2d10-492d-9c37-361fe0b79427	3ddc7c1b-c631-4011-ae67-378db2584a2c
434	434	0	GBIF Portugal	673f7038-4262-4149-b753-5658a4e912f6	3e5cf15a-5069-43f4-b50a-317203916d9d
1888	1888	0	GBIF Brazil	cdc9736d-5ff7-4ece-9959-3c744360cdb3	3f611197-87ee-4c2a-b562-7f3426e25cf9
0	58	58	Plazi	ffb07bec-2d10-492d-9c37-361fe0b79427	40f89bbe-7f7b-4abd-aa02-a45e410da232
6	6	0	Plazi	ffb07bec-2d10-492d-9c37-361fe0b79427	41a5f519-bef0-4001-b429-6b8adef3bcf7
52	52	0	Colombian Biodiversity Information System	7e865cba-7c46-417b-ade5-97f2cf5b7be0	41c255a7-8335-4f46-ba1e-258f313b9af0
0	3	3	Plazi	ffb07bec-2d10-492d-9c37-361fe0b79427	425b6eae-018a-44bc-9dfa-faf01be9ebbb
0	1	1	Plazi	ffb07bec-2d10-492d-9c37-361fe0b79427	44d1fdfd-3eec-4f39-b3d6-b294fd37d140
5100	5100	0	GBIF France	da44cd31-5901-4687-a106-6d1c7734ee3a	467aa349-720b-44d0-93b6-0d3b2d7058f2
4	4	0	Plazi	ffb07bec-2d10-492d-9c37-361fe0b79427	4958a805-21f8-430b-a1c3-d848dfe5d90e
5082	5082	0	Atlas of Living Australia	4a6f1b71-969e-4fc5-a693-282b05e1220c	4a1fb401-3186-4e60-bbd4-f61de71a0c76
0	2	2	Plazi	ffb07bec-2d10-492d-9c37-361fe0b79427	4b3773c0-ca74-4971-a186-1aec0439b4c0
5919	5919	0	Biodiversity Information System of Mexico	b324e8e9-9a4c-44fa-8f1a-7f39ea7ab576	4e0c5d73-5dd6-4e90-a686-a9db9f1f6e4b
2497	2497	0	GBIF France	da44cd31-5901-4687-a106-6d1c7734ee3a	532010ab-cea5-4ef2-8ebc-464aed211aa9
20	20	0	GBIF Germany	4f6826f2-4ff6-443d-b966-e6913bd24013	54853adf-7939-4b1d-8507-893c76cabe2e
138	138	0	GBIF France	da44cd31-5901-4687-a106-6d1c7734ee3a	595a92d2-6ab3-4168-a794-c9465ec4eee5
340	340	0	Plazi	ffb07bec-2d10-492d-9c37-361fe0b79427	5ab1c651-825a-43bc-af00-11b77a792de3
0	5	5	Plazi	ffb07bec-2d10-492d-9c37-361fe0b79427	5ab55f8b-3da2-43c5-86e6-5ac1ee2d127c
11	11	0	GBIF France	da44cd31-5901-4687-a106-6d1c7734ee3a	5dc118c8-ed2e-44b3-b2ef-ddfbdaa486b4
0	3001	3001	National Biodiversity Network	d897a5b9-35ee-4232-94bd-b0bcaac003c2	60202510-efd9-4f3c-95cc-56a950b2e033
8	8	0	Plazi	ffb07bec-2d10-492d-9c37-361fe0b79427	60961eab-9bfd-4655-a2d9-fbea577e716e
55	55	0	GBIF Germany	4f6826f2-4ff6-443d-b966-e6913bd24013	61569c14-f762-11e1-a439-00145eb45e9a
161	161	0	GBIF Germany	4f6826f2-4ff6-443d-b966-e6913bd24013	61b2264c-f762-11e1-a439-00145eb45e9a
1174	1174	0	GBIF Germany	4f6826f2-4ff6-443d-b966-e6913bd24013	62d8988a-f762-11e1-a439-00145eb45e9a
22	22	0	GBIF Germany	4f6826f2-4ff6-443d-b966-e6913bd24013	64bdfbea-f762-11e1-a439-00145eb45e9a
3704	3704	0	GBIF France	da44cd31-5901-4687-a106-6d1c7734ee3a	65d08ad7-7969-4041-b2d2-fdf50742e4d6
0	12	12	Plazi	ffb07bec-2d10-492d-9c37-361fe0b79427	673e368f-06c4-465a-b40d-68dbedd81138
12127	13149	1022	U.S. Geological Survey	8618c64a-93e0-4300-b546-7249e5148ed2	685a86cc-2cd8-4fd6-92b7-c3661dd43dad
29	29	0	GBIF Germany	4f6826f2-4ff6-443d-b966-e6913bd24013	6941bac6-f762-11e1-a439-00145eb45e9a
15	15	0	GBIF Germany	4f6826f2-4ff6-443d-b966-e6913bd24013	6b043e60-f762-11e1-a439-00145eb45e9a
12	12	0	GBIF Germany	4f6826f2-4ff6-443d-b966-e6913bd24013	6bd73ec8-f762-11e1-a439-00145eb45e9a
3839	3839	0	GBIF Spain	1f94b3ca-9345-4d65-afe2-4bace93aa0fe	6c6a9003-ecea-4f3a-9f2f-414107da65c1
1129	768	-361	GBIF Germany	4f6826f2-4ff6-443d-b966-e6913bd24013	704d609a-f762-11e1-a439-00145eb45e9a
444795	454398	9603	GBIF Sweden	a0b3be64-6525-4387-ac67-a499950f92e1	7059595f-0e00-4bd6-bfa9-8869dd6b6096
121	121	0	GBIF Germany	4f6826f2-4ff6-443d-b966-e6913bd24013	71f3aac6-f762-11e1-a439-00145eb45e9a
456	456	0	GBIF Norway	4f829580-180d-46a9-9c87-ed8ec959b545	7221810e-52b1-459d-a6a4-02160c67feef
10138	10138	0	GBIF Benin	efb9c00e-f802-45dd-8826-a52ec45b89ff	72ae38f9-e9d0-4da6-bd29-cb76e41e5bcb
91	91	0	GBIF Germany	4f6826f2-4ff6-443d-b966-e6913bd24013	732dbf26-f762-11e1-a439-00145eb45e9a
86	86	0	GBIF Germany	4f6826f2-4ff6-443d-b966-e6913bd24013	73c05570-f762-11e1-a439-00145eb45e9a
5	5	0	GBIF Germany	4f6826f2-4ff6-443d-b966-e6913bd24013	74129ace-f762-11e1-a439-00145eb45e9a
198	198	0	GBIF Germany	4f6826f2-4ff6-443d-b966-e6913bd24013	74ec7e24-f762-11e1-a439-00145eb45e9a
0	35	35	Plazi	ffb07bec-2d10-492d-9c37-361fe0b79427	74f3ce16-7e8f-420a-b76e-d306ea2a42ad
4	4	0	GBIF Germany	4f6826f2-4ff6-443d-b966-e6913bd24013	7589a6c2-f762-11e1-a439-00145eb45e9a
0	1	1	Plazi	ffb07bec-2d10-492d-9c37-361fe0b79427	787d2050-4c27-476f-840a-556a51f051f4
9	9	0	GBIF Germany	4f6826f2-4ff6-443d-b966-e6913bd24013	78d6f5b4-f762-11e1-a439-00145eb45e9a
15	15	0	GBIF Germany	4f6826f2-4ff6-443d-b966-e6913bd24013	79069c60-f762-11e1-a439-00145eb45e9a
284	262	-22	GBIF Germany	4f6826f2-4ff6-443d-b966-e6913bd24013	799036fa-f762-11e1-a439-00145eb45e9a
731	568	-163	GBIF Germany	4f6826f2-4ff6-443d-b966-e6913bd24013	79a94780-f762-11e1-a439-00145eb45e9a
6909	6909	0	GBIF Spain	1f94b3ca-9345-4d65-afe2-4bace93aa0fe	7a2c29fc-f762-11e1-a439-00145eb45e9a
2610	2610	0	Colombian Biodiversity Information System	7e865cba-7c46-417b-ade5-97f2cf5b7be0	7a449fb6-436d-40ab-8826-d65e6bef43fa
3012	3012	0	GBIF Germany	4f6826f2-4ff6-443d-b966-e6913bd24013	7a5bf4e8-f762-11e1-a439-00145eb45e9a
1990	1990	0	Korean Biodiversity Information Facility	e0a1e772-0177-4800-94b4-2d023fe6cdf4	7b1c360e-f762-11e1-a439-00145eb45e9a
2568	2568	0	Korean Biodiversity Information Facility	e0a1e772-0177-4800-94b4-2d023fe6cdf4	7b2b4536-f762-11e1-a439-00145eb45e9a
1186	1186	0	GBIF France	da44cd31-5901-4687-a106-6d1c7734ee3a	7bfe9217-9fac-4a24-a865-7cb0d244752d
403	403	0	GBIF Germany	4f6826f2-4ff6-443d-b966-e6913bd24013	7d9882c0-f762-11e1-a439-00145eb45e9a
48	48	0	Plazi	ffb07bec-2d10-492d-9c37-361fe0b79427	7dd05ba6-0591-47a1-9f5e-65d2a11782de
76	76	0	GBIF Germany	4f6826f2-4ff6-443d-b966-e6913bd24013	7ebbf9fc-f762-11e1-a439-00145eb45e9a
21	21	0	Plazi	ffb07bec-2d10-492d-9c37-361fe0b79427	7f26c905-d546-41f4-8eeb-cd1ef9b6c11b
14	14	0	Plazi	ffb07bec-2d10-492d-9c37-361fe0b79427	7fb178ac-6afc-4f2e-a3b3-c1e74e44edb1
871	834	-37	Biodiversity Information System of Mexico	b324e8e9-9a4c-44fa-8f1a-7f39ea7ab576	7fd0950a-f762-11e1-a439-00145eb45e9a
1057	1057	0	Biodiversity Information System of Mexico	b324e8e9-9a4c-44fa-8f1a-7f39ea7ab576	80517a3a-f762-11e1-a439-00145eb45e9a
4791	4791	0	GBIF France	da44cd31-5901-4687-a106-6d1c7734ee3a	8226fe1c-2f7e-49f7-835c-ec01fc7e988b
13570	13570	0	Canada Biodiversity Information Facility	8f83fc96-c966-4126-83f7-bf044dc49efa	8465fd6c-f762-11e1-a439-00145eb45e9a
1	1	0	Plazi	ffb07bec-2d10-492d-9c37-361fe0b79427	84e7e70b-bf6d-425f-948d-381523fb028e
101	101	0	Biodiversity Information System of Mexico	b324e8e9-9a4c-44fa-8f1a-7f39ea7ab576	85127fa6-f762-11e1-a439-00145eb45e9a
408	408	0	GBIF Germany	4f6826f2-4ff6-443d-b966-e6913bd24013	85cf474e-f762-11e1-a439-00145eb45e9a
517	474	-43	GBIF Germany	4f6826f2-4ff6-443d-b966-e6913bd24013	8708f7d6-f762-11e1-a439-00145eb45e9a
5127	4126	-1001	GBIF Germany	4f6826f2-4ff6-443d-b966-e6913bd24013	874d9742-f762-11e1-a439-00145eb45e9a
461	461	0	GBIF Germany	4f6826f2-4ff6-443d-b966-e6913bd24013	89d81bcc-f762-11e1-a439-00145eb45e9a
340	340	0	GBIF Germany	4f6826f2-4ff6-443d-b966-e6913bd24013	8a2c019c-f762-11e1-a439-00145eb45e9a
73	73	0	GBIF Sweden	a0b3be64-6525-4387-ac67-a499950f92e1	8be6ba59-d8bb-4dae-8e67-1224be7af505
83	83	0	GBIF Germany	4f6826f2-4ff6-443d-b966-e6913bd24013	8c26501a-f762-11e1-a439-00145eb45e9a
35	35	0	GBIF Germany	4f6826f2-4ff6-443d-b966-e6913bd24013	8c9abfb8-f762-11e1-a439-00145eb45e9a
11	5	-6	GBIF Germany	4f6826f2-4ff6-443d-b966-e6913bd24013	8cf7a3b8-f762-11e1-a439-00145eb45e9a
68	57	-11	GBIF Germany	4f6826f2-4ff6-443d-b966-e6913bd24013	8d5508b4-f762-11e1-a439-00145eb45e9a
106	106	0	Plazi	ffb07bec-2d10-492d-9c37-361fe0b79427	8d8a4dea-169c-44c3-aa70-0afcaf6e8731
0	44	44	Plazi	ffb07bec-2d10-492d-9c37-361fe0b79427	8d8c1ff6-4422-428a-9f44-5c0d16451c25
0	7950	7950	Ocean Biodiversity Information System	ba0670b9-4186-41e6-8e70-f9cb3065551a	8d940719-c890-49ee-b3d5-423a34a1c238
10	10	0	Plazi	ffb07bec-2d10-492d-9c37-361fe0b79427	8e3d9e51-a799-4cc0-8196-04064b2efb21
104	97	-7	GBIF Germany	4f6826f2-4ff6-443d-b966-e6913bd24013	8f63ca32-f762-11e1-a439-00145eb45e9a
63	45	-18	GBIF Germany	4f6826f2-4ff6-443d-b966-e6913bd24013	8f663ff6-f762-11e1-a439-00145eb45e9a
123	96	-27	GBIF Germany	4f6826f2-4ff6-443d-b966-e6913bd24013	90bf8380-f762-11e1-a439-00145eb45e9a
29	29	0	GBIF Germany	4f6826f2-4ff6-443d-b966-e6913bd24013	937f76f2-f762-11e1-a439-00145eb45e9a
1734	1734	0	GBIF Germany	4f6826f2-4ff6-443d-b966-e6913bd24013	94138c3e-f762-11e1-a439-00145eb45e9a
38	38	0	Plazi	ffb07bec-2d10-492d-9c37-361fe0b79427	9691adc1-a0fc-4374-a6f6-83b4ac36d10a
28420	28420	0	U.S. Geological Survey	8618c64a-93e0-4300-b546-7249e5148ed2	96ce10e8-f762-11e1-a439-00145eb45e9a
39	39	0	GBIF France	da44cd31-5901-4687-a106-6d1c7734ee3a	98af6c79-2d9a-46f6-a4b7-6ad276acf657
2	2	0	Plazi	ffb07bec-2d10-492d-9c37-361fe0b79427	98b23e71-77e6-4e9f-838b-00c619d3a9f7
71	71	0	GBIF France	da44cd31-5901-4687-a106-6d1c7734ee3a	99fa1bbd-1386-4b86-9a63-50b14a2ed64a
4	4	0	Plazi	ffb07bec-2d10-492d-9c37-361fe0b79427	9a3cb769-b9a2-436d-98f9-e02647d9956b
3951	3951	0	GBIF Norway	4f829580-180d-46a9-9c87-ed8ec959b545	9c689543-6bf1-42e1-b280-b61d739e18c3
50	50	0	National Biodiversity Network	d897a5b9-35ee-4232-94bd-b0bcaac003c2	9e5d2eea-3fe1-49d4-af27-090be96f1864
4	4	0	GBIF France	da44cd31-5901-4687-a106-6d1c7734ee3a	a1c11083-604f-4f66-b20f-e1a6fd967e10
0	2	2	Plazi	ffb07bec-2d10-492d-9c37-361fe0b79427	a661752e-351e-492c-ba99-498cc34e21a1
15	15	0	Plazi	ffb07bec-2d10-492d-9c37-361fe0b79427	a6fd692d-f32d-476a-8ce9-d946f852c08e
1229	1229	0	GBIF Cameroon	cfe0cad9-2bf4-4d16-ae33-c3dfb0da1ed9	a719e79b-d9c6-435b-bade-01b8fff20dc1
0	33	33	GBIF Spain	1f94b3ca-9345-4d65-afe2-4bace93aa0fe	a75f003c-36bf-4428-80d3-897d452160a4
1604502	1604502	0	National Biodiversity Network	d897a5b9-35ee-4232-94bd-b0bcaac003c2	a99ca3c9-7448-4bf6-aba5-0ef61b01232c
0	7	7	Plazi	ffb07bec-2d10-492d-9c37-361fe0b79427	aa58abe2-e651-4d1c-b8e4-b4f8ac89458f
1552	1552	0	GBIF France	da44cd31-5901-4687-a106-6d1c7734ee3a	aacca855-36bb-4c66-991a-802d11532bb6
515	515	0	GBIF France	da44cd31-5901-4687-a106-6d1c7734ee3a	ab9aa239-8c68-4fc1-b0f0-5a93d5eb9b65
2324	2324	0	Polish Biodiversity Information Network	2618bfdf-e194-4911-a241-80db3107bc51	ac7352e0-0516-11db-a8cf-b8a03c50a862
2	2	0	Plazi	ffb07bec-2d10-492d-9c37-361fe0b79427	ad7e6390-0b99-4c70-bfb5-e86f1b325bfc
23	23	0	Colombian Biodiversity Information System	7e865cba-7c46-417b-ade5-97f2cf5b7be0	af35d052-e4dc-4268-9c14-583f941cf7c4
65	65	0	Plazi	ffb07bec-2d10-492d-9c37-361fe0b79427	b0627074-6043-4f60-ba8f-2108b0512635
0	20	20	Ocean Biodiversity Information System	ba0670b9-4186-41e6-8e70-f9cb3065551a	b12abd4c-41e6-4f42-8a80-ab7c3964be77
240	240	0	GBIF Germany	4f6826f2-4ff6-443d-b966-e6913bd24013	b1649b11-bf18-44ca-b8d2-b6b83958ee64
0	65	65	Ocean Biodiversity Information System	ba0670b9-4186-41e6-8e70-f9cb3065551a	b19a9a7a-51a6-4f41-a053-a016a711585c
0	306387	306387	GBIF Sweden	a0b3be64-6525-4387-ac67-a499950f92e1	b1e452b1-afa0-44d9-b20e-a432e933db63
5872	5872	0	GBIF Argentina	2426a871-9feb-40a1-96c6-0c593a76b835	b3c4e139-2305-4679-9379-cc898866ae65
0	703	703	Ocean Biodiversity Information System	ba0670b9-4186-41e6-8e70-f9cb3065551a	b7a7223f-f445-4501-b8ac-0f369dff96ba
222	222	0	Plazi	ffb07bec-2d10-492d-9c37-361fe0b79427	b9d039b4-fce1-4dce-b297-a35f74b0eeac
0	758	758	Ocean Biodiversity Information System	ba0670b9-4186-41e6-8e70-f9cb3065551a	bb810ecd-20be-4bf3-8def-db09fb465a58
1	1	0	Plazi	ffb07bec-2d10-492d-9c37-361fe0b79427	bd64eb9c-5f2f-47cf-bc79-4575d5ace119
31	31	0	Plazi	ffb07bec-2d10-492d-9c37-361fe0b79427	c2600308-106b-49d6-a3fb-beebf8c08840
23	23	0	Plazi	ffb07bec-2d10-492d-9c37-361fe0b79427	c3370dbd-320c-40f4-9708-389231e1a1f8
936	936	0	Netherlands Biodiversity Information Facility	0909d601-bda2-42df-9e63-a6d51847ebce	c3ef6404-277e-4b8b-93a0-588e9eab643a
0	3	3	Plazi	ffb07bec-2d10-492d-9c37-361fe0b79427	c5c799bd-47b3-412d-8f63-d7d291e635fc
4687	4687	0	National Biodiversity Network	d897a5b9-35ee-4232-94bd-b0bcaac003c2	c647a06c-2e85-4bc5-bc41-68ac4760440f
257	257	0	GBIF France	da44cd31-5901-4687-a106-6d1c7734ee3a	c7f02187-94bf-49b4-a530-73cccbea2dbc
0	6	6	Plazi	ffb07bec-2d10-492d-9c37-361fe0b79427	c9542df0-bde1-4d32-afcb-4695a7b91045
487	487	0	GBIF France	da44cd31-5901-4687-a106-6d1c7734ee3a	ca07912a-cc4f-4031-b197-8d8423c7ea5c
18889	18889	0	National Biodiversity Network	d897a5b9-35ee-4232-94bd-b0bcaac003c2	cc380a38-100a-408f-84c3-864de932d52c
1	1	0	Plazi	ffb07bec-2d10-492d-9c37-361fe0b79427	cee977ff-1011-4121-882d-775b50e41957
4	4	0	Plazi	ffb07bec-2d10-492d-9c37-361fe0b79427	cfda01b2-44cd-40fa-b04c-0ae835b9ef86
277	276	-1	GBIF Germany	4f6826f2-4ff6-443d-b966-e6913bd24013	d0884974-ada2-11e2-8fbc-00145eb45e9a
0	1404	1404	Symbiota Support Hub	612b5a0b-908b-4b4e-b9bf-ca15dfdc94fa	d1302b60-c820-4f68-a1bd-8bb0c167c44c
0	11	11	Plazi	ffb07bec-2d10-492d-9c37-361fe0b79427	d339ff8c-b7d0-4769-b6f3-7657475a71df
2	2	0	Plazi	ffb07bec-2d10-492d-9c37-361fe0b79427	d38ecfdf-8e60-4b6a-95db-0bb1a16eb91f
290	290	0	GBIF France	da44cd31-5901-4687-a106-6d1c7734ee3a	d3d0e794-a295-44bb-b251-f63688ea1dcc
0	18	18	Plazi	ffb07bec-2d10-492d-9c37-361fe0b79427	d45654bd-dc95-496a-972b-7a758a3d5738
3215	3215	0	U.S. Geological Survey	8618c64a-93e0-4300-b546-7249e5148ed2	d68dd1e3-60be-4ef0-89a0-7fc85241f6cc
0	2	2	Ocean Biodiversity Information System	ba0670b9-4186-41e6-8e70-f9cb3065551a	d6f446b4-c970-44ac-8d73-ac01c20bf126
23717	23717	0	U.S. Geological Survey	8618c64a-93e0-4300-b546-7249e5148ed2	dab57200-c600-4f26-b657-cf217443034e
3	3	0	Plazi	ffb07bec-2d10-492d-9c37-361fe0b79427	daf51a6a-153a-4906-a478-da4df86eee11
43	43	0	Plazi	ffb07bec-2d10-492d-9c37-361fe0b79427	db23a775-d25c-4253-abda-b5a007110f6d
51	51	0	GBIF France	da44cd31-5901-4687-a106-6d1c7734ee3a	db950479-def4-4f4f-80ca-2f3fd10eaf8e
127	127	0	GBIF Germany	4f6826f2-4ff6-443d-b966-e6913bd24013	dbd1a21c-b09f-11e2-a01d-00145eb45e9a
1	1	0	GBIF France	da44cd31-5901-4687-a106-6d1c7734ee3a	dc499842-8150-4019-afd4-3aa2f30baf2a
70944	70944	0	GBIF Brazil	cdc9736d-5ff7-4ece-9959-3c744360cdb3	df815212-bca8-45c8-b006-ba7bded25217
29	29	0	Plazi	ffb07bec-2d10-492d-9c37-361fe0b79427	dfa20658-1c54-4403-ba2d-4e1322108e6f
581	581	0	National Biodiversity Network	d897a5b9-35ee-4232-94bd-b0bcaac003c2	e33d26b2-47ac-4045-ac11-c2b946204254
2000	2000	0	Biodiversity Information System of Mexico	b324e8e9-9a4c-44fa-8f1a-7f39ea7ab576	e59a7a7c-7f08-4f97-a541-e823c399761f
163	163	0	National Biodiversity Network	d897a5b9-35ee-4232-94bd-b0bcaac003c2	e745e64b-b274-4e93-83a1-afaf0b934328
6210	6674	464	GBIF France	da44cd31-5901-4687-a106-6d1c7734ee3a	e96db990-bd86-4a79-89a2-446844a27811
28	28	0	Plazi	ffb07bec-2d10-492d-9c37-361fe0b79427	eb539cb9-039f-4b0b-8df6-c88db267683c
8928	8928	0	Netherlands Biodiversity Information Facility	0909d601-bda2-42df-9e63-a6d51847ebce	ebbe25bd-c0ce-4c14-9608-3a55fed82620
0	10	10	Plazi	ffb07bec-2d10-492d-9c37-361fe0b79427	ec5ab0d0-05d0-493b-9359-2fbe1265656f
0	15	15	Plazi	ffb07bec-2d10-492d-9c37-361fe0b79427	ed3bb20b-3919-4b03-a67d-a9d18d3e02e2
439	439	0	Plazi	ffb07bec-2d10-492d-9c37-361fe0b79427	ee4333ce-4fde-4a61-85e9-effa3d1b5999
0	9	9	Plazi	ffb07bec-2d10-492d-9c37-361fe0b79427	ef5589e1-c5c5-44bf-abcc-bbe785598089
1	1	0	Plazi	ffb07bec-2d10-492d-9c37-361fe0b79427	ef73e6aa-5cff-4746-b67f-624fda5b73ee
958	958	0	Colombian Biodiversity Information System	7e865cba-7c46-417b-ade5-97f2cf5b7be0	efd6472e-6377-494f-9731-31ed47f488c3
17966	17966	0	GBIF France	da44cd31-5901-4687-a106-6d1c7734ee3a	f0b79a2a-9a14-45ec-9826-11ce77ac2078
0	96	96	Plazi	ffb07bec-2d10-492d-9c37-361fe0b79427	f0f8f265-10f1-448f-8b15-6c56fc140166
29	29	0	Plazi	ffb07bec-2d10-492d-9c37-361fe0b79427	f2702db4-8622-4075-9475-4ce46331bd1c
7512	7512	0	Belgian Biodiversity Platform	fb11cfe1-ebc3-45af-9159-17d9fddbcdac	f3a5b919-9eec-48fe-b96e-ef7fb9c7e822
150	335	185	Colombian Biodiversity Information System	7e865cba-7c46-417b-ade5-97f2cf5b7be0	f463605b-9149-4cca-990b-1a5a17340b46
4	4	0	Ocean Biodiversity Information System	ba0670b9-4186-41e6-8e70-f9cb3065551a	f850b6b8-a9fb-41d7-a944-0f1ed507411d
16738	16738	0	GBIF France	da44cd31-5901-4687-a106-6d1c7734ee3a	f88f9c5b-9097-4bfe-877a-8917b08f75e3
21915	21915	0	GBIF Brazil	cdc9736d-5ff7-4ece-9959-3c744360cdb3	f9e1895f-4f52-45e7-aa4f-4dea366b7d2d
595	595	0	National Biodiversity Network	d897a5b9-35ee-4232-94bd-b0bcaac003c2	fcc07720-a1c3-4e74-aee6-f9ca2593087f
0	17	17	Plazi	ffb07bec-2d10-492d-9c37-361fe0b79427	fd68d7ae-8158-45aa-89b4-519d34f26d9d
1	7	6	GBIF Japan	db5705aa-6a6e-42f1-8942-d77b9f4896ea	011f5525-bc47-4418-8377-2edcd7eb883e
49	49	0	Plazi	ffb07bec-2d10-492d-9c37-361fe0b79427	0351a42c-4cf5-412b-b229-3708f32cbb85
9	9	0	Plazi	ffb07bec-2d10-492d-9c37-361fe0b79427	0370fa42-32e2-4cac-a8f5-7ca26b86a9c1
14	14	0	Plazi	ffb07bec-2d10-492d-9c37-361fe0b79427	048e2d3a-089b-48d4-b12b-db7ccdfd41d6
31	31	0	GBIF Germany	4f6826f2-4ff6-443d-b966-e6913bd24013	05ebc824-3a3b-4f64-ab22-99b0e2c3aa48
1301	1301	0	Plazi	ffb07bec-2d10-492d-9c37-361fe0b79427	06748f67-18d9-4c3e-a14c-77de1664d81b
0	42	42	Plazi	ffb07bec-2d10-492d-9c37-361fe0b79427	08e1a467-c7d1-4aa4-a63b-1e5d6e83bd17
1655	1655	0	GBIF Germany	4f6826f2-4ff6-443d-b966-e6913bd24013	0942f921-ab86-4856-a98e-f230133365e5
878	878	0	U.S. Geological Survey	8618c64a-93e0-4300-b546-7249e5148ed2	09f3badb-e196-4cea-bc97-b3174b38253b
12	12	0	Plazi	ffb07bec-2d10-492d-9c37-361fe0b79427	0b1b168f-93cc-4ca7-8a40-bb6cbbe0ae24
6	6	0	Plazi	ffb07bec-2d10-492d-9c37-361fe0b79427	0e5f3767-4204-4ef4-bc99-5e947f63e263
21	21	0	Plazi	ffb07bec-2d10-492d-9c37-361fe0b79427	0f26b1ea-8fb2-4ef4-ba99-ccc81dc1ad50
0	1	1	Plazi	ffb07bec-2d10-492d-9c37-361fe0b79427	11426cbb-3e36-41c1-bea0-44aa01ca5889
1	1	0	Plazi	ffb07bec-2d10-492d-9c37-361fe0b79427	175f115f-a52b-4b98-b183-5f3054a9ba64
1	1	0	Plazi	ffb07bec-2d10-492d-9c37-361fe0b79427	19fb92db-ed84-4dd2-9fab-1c41994f7b53
8	8	0	Plazi	ffb07bec-2d10-492d-9c37-361fe0b79427	1a75a03c-3b98-4f41-821d-10da4406d93e
0	3	3	Plazi	ffb07bec-2d10-492d-9c37-361fe0b79427	1c90d4b4-fc98-4ffb-8d4f-6b33472c3a55
10	10	0	Plazi	ffb07bec-2d10-492d-9c37-361fe0b79427	1d427a64-f8f0-48b6-a963-a652a5af4d2e
9	9	0	Plazi	ffb07bec-2d10-492d-9c37-361fe0b79427	201233cc-119c-498f-8227-8bb8111bb352
6491	6491	0	Participant Node Managers Committee	7f48e0c8-5c96-49ec-b972-30748e339115	20749d89-7a35-4d64-b57f-a4ed5065f193
5194	5194	0	GBIF Brazil	cdc9736d-5ff7-4ece-9959-3c744360cdb3	20cfe5fa-8e4e-4f18-92df-7add93a55de7
0	115	115	Ocean Biodiversity Information System	ba0670b9-4186-41e6-8e70-f9cb3065551a	224fcac8-53c4-48bf-a4e4-2526cde2d23d
2	2	0	Plazi	ffb07bec-2d10-492d-9c37-361fe0b79427	2370f519-6f22-4b1c-a780-1c90a1c7250b
71	71	0	Participant Node Managers Committee	7f48e0c8-5c96-49ec-b972-30748e339115	2594f389-fb9f-4825-abbe-5678bab70cf4
0	52	52	Plazi	ffb07bec-2d10-492d-9c37-361fe0b79427	264cb207-2e7c-4f10-a3c4-999e00738310
2	2	0	Plazi	ffb07bec-2d10-492d-9c37-361fe0b79427	29dfa55e-83f6-4729-b052-29d611274d52
9178	9178	0	GBIF Spain	1f94b3ca-9345-4d65-afe2-4bace93aa0fe	2a89fac8-e079-419e-8883-70a4cd9c25e1
6	6	0	Plazi	ffb07bec-2d10-492d-9c37-361fe0b79427	2ae433c1-1148-4221-b59c-e840084cd567
521	521	0	GBIF France	da44cd31-5901-4687-a106-6d1c7734ee3a	300184f6-9998-4689-a153-7c83984def36
35	35	0	Plazi	ffb07bec-2d10-492d-9c37-361fe0b79427	303e775d-9bca-4cf0-a0ec-e5a319b6f7dc
0	1947065	1947065	Canada Biodiversity Information Facility	8f83fc96-c966-4126-83f7-bf044dc49efa	310dbb60-e369-4ec2-a6d8-8e4de843b208
26624	26624	0	Society for the Management of Electronic Biodiversity Data	97818ee4-1461-4180-bf1d-b3201050124f	3186cd3f-a7d0-4e64-bb60-630e20a47fa6
0	40	40	Plazi	ffb07bec-2d10-492d-9c37-361fe0b79427	3194b560-fc7a-43ab-b285-3d087b5cbbd0
84	84	0	Society for the Management of Electronic Biodiversity Data	97818ee4-1461-4180-bf1d-b3201050124f	31f8727c-debb-4c38-bb89-0eb2594537a9
5	5	0	GBIF France	da44cd31-5901-4687-a106-6d1c7734ee3a	330f4812-4acd-414f-afdc-5c449c0ed61d
84	84	0	Plazi	ffb07bec-2d10-492d-9c37-361fe0b79427	34f04919-3bf7-46df-9e1f-2de103371e7c
4372	4372	0	National Biodiversity Network	d897a5b9-35ee-4232-94bd-b0bcaac003c2	34f8683a-dfc0-46b8-acf6-390fe5ca6b92
0	1	1	Plazi	ffb07bec-2d10-492d-9c37-361fe0b79427	37b6973f-7f66-49ae-8583-d07ee5e6ca8e
16	16	0	National Biodiversity Network	d897a5b9-35ee-4232-94bd-b0bcaac003c2	38f24312-9525-46bd-871f-99ca09dea5d3
621	622	1	U.S. Geological Survey	8618c64a-93e0-4300-b546-7249e5148ed2	3abe0ed3-371f-49ab-bc4f-ac1887e04983
3	3	0	Plazi	ffb07bec-2d10-492d-9c37-361fe0b79427	3ad91afc-d278-46b7-acf3-2df2f9f71f1d
2955	2955	0	GBIF Norway	4f829580-180d-46a9-9c87-ed8ec959b545	3ae1285c-1cdf-4bf6-bb97-0af43a81cb1b
24	24	0	Plazi	ffb07bec-2d10-492d-9c37-361fe0b79427	3dad7d04-f7c6-4300-9240-8f2e44d0c257
43	43	0	Plazi	ffb07bec-2d10-492d-9c37-361fe0b79427	3e3068c1-c158-4d97-9aec-31fc80551edb
66	66	0	Plazi	ffb07bec-2d10-492d-9c37-361fe0b79427	3f237dc8-8744-46a9-bedd-5da74022ca2d
0	11	11	Plazi	ffb07bec-2d10-492d-9c37-361fe0b79427	41dd2703-d6ec-4d78-9b3d-c06ff2ddc23f
11	11	0	Plazi	ffb07bec-2d10-492d-9c37-361fe0b79427	4c9ede5c-44e0-49b0-8a3c-9f176c8935bc
0	3	3	Plazi	ffb07bec-2d10-492d-9c37-361fe0b79427	50ed734c-2b1e-4792-a56b-289d70b967ce
4304	4304	0	GBIF France	da44cd31-5901-4687-a106-6d1c7734ee3a	514c7772-7282-4162-8ebb-f42846398980
22	22	0	GBIF Japan	db5705aa-6a6e-42f1-8942-d77b9f4896ea	53767aa6-18f5-11e2-98fb-00145eb45e9a
922	922	0	GBIF France	da44cd31-5901-4687-a106-6d1c7734ee3a	54ec89c0-ad08-4a9a-a907-1539e7e7e44b
4745	4745	0	GBIF France	da44cd31-5901-4687-a106-6d1c7734ee3a	579e870e-ddf2-4d40-9404-3073b5efe726
0	8720	8720	Participant Node Managers Committee	7f48e0c8-5c96-49ec-b972-30748e339115	5a6c4b09-bd03-4a8a-b673-4a5d5430eea2
683	683	0	GBIF Germany	4f6826f2-4ff6-443d-b966-e6913bd24013	5abc13bf-36fc-418c-8659-55b4e7f43a1b
0	79	79	Plazi	ffb07bec-2d10-492d-9c37-361fe0b79427	5da34b6e-c009-4ea1-8721-bd42451669c5
9515	9515	0	National Biodiversity Network	d897a5b9-35ee-4232-94bd-b0bcaac003c2	600c4445-563b-4e4a-a086-f7b5ba564e09
233	233	0	GBIF Germany	4f6826f2-4ff6-443d-b966-e6913bd24013	616eaa0c-f762-11e1-a439-00145eb45e9a
53	53	0	GBIF France	da44cd31-5901-4687-a106-6d1c7734ee3a	620e40d2-60aa-405e-b7e1-d632b0aa928e
40	40	0	GBIF Germany	4f6826f2-4ff6-443d-b966-e6913bd24013	629fe5c6-f762-11e1-a439-00145eb45e9a
19	19	0	GBIF Germany	4f6826f2-4ff6-443d-b966-e6913bd24013	62e025aa-f762-11e1-a439-00145eb45e9a
0	1819	1819	Ocean Biodiversity Information System	ba0670b9-4186-41e6-8e70-f9cb3065551a	63b61bb0-685d-4c57-bfb2-85ed48fdd3d1
102	102	0	GBIF Germany	4f6826f2-4ff6-443d-b966-e6913bd24013	63cbe9ae-f762-11e1-a439-00145eb45e9a
151	151	0	GBIF Germany	4f6826f2-4ff6-443d-b966-e6913bd24013	63e448a0-f762-11e1-a439-00145eb45e9a
127	127	0	GBIF Germany	4f6826f2-4ff6-443d-b966-e6913bd24013	64d34ea0-f762-11e1-a439-00145eb45e9a
25	40	15	GBIF Norway	4f829580-180d-46a9-9c87-ed8ec959b545	64e8f985-9a89-4b82-86aa-47a9adb1e5b6
5	4	-1	GBIF Germany	4f6826f2-4ff6-443d-b966-e6913bd24013	65aa1d90-f762-11e1-a439-00145eb45e9a
3	3	0	Plazi	ffb07bec-2d10-492d-9c37-361fe0b79427	674df513-ce5b-4baa-83f0-f523778521c3
0	1	1	Plazi	ffb07bec-2d10-492d-9c37-361fe0b79427	681bad03-36d5-4b49-ac99-b97100deba5b
265	145	-120	GBIF Germany	4f6826f2-4ff6-443d-b966-e6913bd24013	68e05196-f762-11e1-a439-00145eb45e9a
214	117	-97	GBIF Germany	4f6826f2-4ff6-443d-b966-e6913bd24013	68e350bc-f762-11e1-a439-00145eb45e9a
2153	2152	-1	Atlas of Living Australia	4a6f1b71-969e-4fc5-a693-282b05e1220c	694b8003-0ee9-4360-982e-cb7dfb0cafe5
8	8	0	Plazi	ffb07bec-2d10-492d-9c37-361fe0b79427	69cb9f00-661e-441f-bc9a-47daaa8bf17e
61	61	0	GBIF Germany	4f6826f2-4ff6-443d-b966-e6913bd24013	6a7ca9dc-f762-11e1-a439-00145eb45e9a
0	2	2	Plazi	ffb07bec-2d10-492d-9c37-361fe0b79427	6a932280-55e0-4308-845f-611572d93316
34	34	0	GBIF Germany	4f6826f2-4ff6-443d-b966-e6913bd24013	6ab3a6ee-f762-11e1-a439-00145eb45e9a
9	9	0	Plazi	ffb07bec-2d10-492d-9c37-361fe0b79427	6ac34a7a-5610-46f7-b291-46633a61a3c6
2	2	0	GBIF Germany	4f6826f2-4ff6-443d-b966-e6913bd24013	6aeade52-f762-11e1-a439-00145eb45e9a
2	2	0	GBIF Germany	4f6826f2-4ff6-443d-b966-e6913bd24013	6b4e0cb6-f762-11e1-a439-00145eb45e9a
18	18	0	GBIF Germany	4f6826f2-4ff6-443d-b966-e6913bd24013	6b7b5d4c-f762-11e1-a439-00145eb45e9a
1	1	0	Plazi	ffb07bec-2d10-492d-9c37-361fe0b79427	6d1ae1e9-fd43-4421-9770-7062f3525dd7
2302	2302	0	GBIF Germany	4f6826f2-4ff6-443d-b966-e6913bd24013	6f12b158-f762-11e1-a439-00145eb45e9a
1	1	0	Plazi	ffb07bec-2d10-492d-9c37-361fe0b79427	703b2190-3e07-40c9-a217-e8f75cd0cc40
3948	3157	-791	GBIF Germany	4f6826f2-4ff6-443d-b966-e6913bd24013	709b02fa-f762-11e1-a439-00145eb45e9a
149	137	-12	GBIF Germany	4f6826f2-4ff6-443d-b966-e6913bd24013	710fbb40-f762-11e1-a439-00145eb45e9a
1	1	0	GBIF Germany	4f6826f2-4ff6-443d-b966-e6913bd24013	71bfd26e-f762-11e1-a439-00145eb45e9a
29109	29109	0	GBIF France	da44cd31-5901-4687-a106-6d1c7734ee3a	720e07f4-d1a8-48cb-a6d2-f90968f34549
475	475	0	National Biodiversity Network	d897a5b9-35ee-4232-94bd-b0bcaac003c2	734aa3b5-e35f-40fe-9442-6935b003682b
140	140	0	GBIF Germany	4f6826f2-4ff6-443d-b966-e6913bd24013	73d67580-f762-11e1-a439-00145eb45e9a
183	183	0	GBIF Germany	4f6826f2-4ff6-443d-b966-e6913bd24013	74b3ef32-f762-11e1-a439-00145eb45e9a
531	531	0	GBIF Germany	4f6826f2-4ff6-443d-b966-e6913bd24013	74d25184-f762-11e1-a439-00145eb45e9a
42	42	0	GBIF Germany	4f6826f2-4ff6-443d-b966-e6913bd24013	793ec86a-f762-11e1-a439-00145eb45e9a
1805	1455	-350	GBIF Germany	4f6826f2-4ff6-443d-b966-e6913bd24013	79ecb27c-f762-11e1-a439-00145eb45e9a
102	102	0	GBIF Germany	4f6826f2-4ff6-443d-b966-e6913bd24013	7a7850ac-f762-11e1-a439-00145eb45e9a
45	45	0	GBIF Germany	4f6826f2-4ff6-443d-b966-e6913bd24013	7acc5972-f762-11e1-a439-00145eb45e9a
14040	14080	40	GBIF Germany	4f6826f2-4ff6-443d-b966-e6913bd24013	7ba21c92-f762-11e1-a439-00145eb45e9a
98	98	0	GBIF Germany	4f6826f2-4ff6-443d-b966-e6913bd24013	7cb17510-f762-11e1-a439-00145eb45e9a
77	77	0	Plazi	ffb07bec-2d10-492d-9c37-361fe0b79427	7cf1fed4-397f-4cdc-8720-5fdf220ebf63
100	100	0	GBIF Germany	4f6826f2-4ff6-443d-b966-e6913bd24013	7e5fc0ce-f762-11e1-a439-00145eb45e9a
479	479	0	GBIF Germany	4f6826f2-4ff6-443d-b966-e6913bd24013	7eb2bdd8-f762-11e1-a439-00145eb45e9a
1404	1404	0	Society for the Management of Electronic Biodiversity Data	97818ee4-1461-4180-bf1d-b3201050124f	7f747121-a7c3-4da1-9bc2-7b1ee63112d9
604	604	0	Biodiversity Information System of Mexico	b324e8e9-9a4c-44fa-8f1a-7f39ea7ab576	7fc7f94a-f762-11e1-a439-00145eb45e9a
196	193	-3	Biodiversity Information System of Mexico	b324e8e9-9a4c-44fa-8f1a-7f39ea7ab576	7ff1e76e-f762-11e1-a439-00145eb45e9a
13	13	0	Plazi	ffb07bec-2d10-492d-9c37-361fe0b79427	8073b36e-d12c-4687-8f4d-02a6ddcb5d98
2553	1095	-1458	Biodiversity Information System of Mexico	b324e8e9-9a4c-44fa-8f1a-7f39ea7ab576	80c88d00-f762-11e1-a439-00145eb45e9a
692	692	0	GBIF Germany	4f6826f2-4ff6-443d-b966-e6913bd24013	80edd150-f762-11e1-a439-00145eb45e9a
330046	330046	0	Belgian Biodiversity Platform	fb11cfe1-ebc3-45af-9159-17d9fddbcdac	81c5a091-6e94-40db-a2a4-48f4de42d410
9	9	0	GBIF Germany	4f6826f2-4ff6-443d-b966-e6913bd24013	824f9466-f762-11e1-a439-00145eb45e9a
19289	19289	0	GBIF Spain	1f94b3ca-9345-4d65-afe2-4bace93aa0fe	835f8992-f762-11e1-a439-00145eb45e9a
2007	2007	0	Ocean Biodiversity Information System	ba0670b9-4186-41e6-8e70-f9cb3065551a	83cbb4fa-f762-11e1-a439-00145eb45e9a
41	41	0	Plazi	ffb07bec-2d10-492d-9c37-361fe0b79427	83f49512-987b-40e7-8686-f664b4a8c178
21	21	0	GBIF Germany	4f6826f2-4ff6-443d-b966-e6913bd24013	85e0d400-f762-11e1-a439-00145eb45e9a
7127	7127	0	Biodiversity Information System of Mexico	b324e8e9-9a4c-44fa-8f1a-7f39ea7ab576	861bff1c-f762-11e1-a439-00145eb45e9a
0	2	2	Plazi	ffb07bec-2d10-492d-9c37-361fe0b79427	872f4341-d361-44ce-b6bb-39c9486192f4
5564	3635	-1929	GBIF Germany	4f6826f2-4ff6-443d-b966-e6913bd24013	873c5a18-f762-11e1-a439-00145eb45e9a
706	681	-25	GBIF Germany	4f6826f2-4ff6-443d-b966-e6913bd24013	88c352ce-f762-11e1-a439-00145eb45e9a
0	3532	3532	Korean Biodiversity Information Facility	e0a1e772-0177-4800-94b4-2d023fe6cdf4	8a10929f-9729-408b-ad1a-2a86d56fa9e0
4	4	0	Plazi	ffb07bec-2d10-492d-9c37-361fe0b79427	8b71f4e1-9f23-4aef-9bf9-a510c282a5bf
21	21	0	GBIF Germany	4f6826f2-4ff6-443d-b966-e6913bd24013	8c307cc0-f762-11e1-a439-00145eb45e9a
54	47	-7	GBIF Germany	4f6826f2-4ff6-443d-b966-e6913bd24013	8caddfda-f762-11e1-a439-00145eb45e9a
420	420	0	Biodiversity Information System of Mexico	b324e8e9-9a4c-44fa-8f1a-7f39ea7ab576	8db0dcbd-6e07-48ca-aa37-8dd88be757fa
25042	25042	0	Atlas of Living Australia	4a6f1b71-969e-4fc5-a693-282b05e1220c	8db49bef-d87e-403d-ae19-32db175ab91e
450	194	-256	GBIF Germany	4f6826f2-4ff6-443d-b966-e6913bd24013	8dbda590-f762-11e1-a439-00145eb45e9a
58	46	-12	GBIF Germany	4f6826f2-4ff6-443d-b966-e6913bd24013	8f98e83e-f762-11e1-a439-00145eb45e9a
3	3	0	GBIF Germany	4f6826f2-4ff6-443d-b966-e6913bd24013	8ff9a4b2-f762-11e1-a439-00145eb45e9a
36	24	-12	GBIF Germany	4f6826f2-4ff6-443d-b966-e6913bd24013	9024b3e6-f762-11e1-a439-00145eb45e9a
23	22	-1	GBIF Germany	4f6826f2-4ff6-443d-b966-e6913bd24013	911f432e-f762-11e1-a439-00145eb45e9a
2241	2241	0	GBIF Germany	4f6826f2-4ff6-443d-b966-e6913bd24013	91f1b804-f762-11e1-a439-00145eb45e9a
1265	1265	0	GBIF Germany	4f6826f2-4ff6-443d-b966-e6913bd24013	9201a34a-f762-11e1-a439-00145eb45e9a
2	2	0	GBIF Germany	4f6826f2-4ff6-443d-b966-e6913bd24013	92427a28-f762-11e1-a439-00145eb45e9a
724	724	0	Polish Biodiversity Information Network	2618bfdf-e194-4911-a241-80db3107bc51	92c883e0-30b2-11de-b171-b8a03c50a862
0	2	2	Participant Node Managers Committee	7f48e0c8-5c96-49ec-b972-30748e339115	936e31e7-82a2-47d6-9240-634aeb5e02f1
1	1	0	GBIF Germany	4f6826f2-4ff6-443d-b966-e6913bd24013	937cd988-f762-11e1-a439-00145eb45e9a
199	199	0	GBIF Germany	4f6826f2-4ff6-443d-b966-e6913bd24013	93a66a3c-f762-11e1-a439-00145eb45e9a
693	693	0	GBIF Germany	4f6826f2-4ff6-443d-b966-e6913bd24013	94318338-f762-11e1-a439-00145eb45e9a
0	7	7	Plazi	ffb07bec-2d10-492d-9c37-361fe0b79427	94445f56-b983-4229-8080-5cc4179e94bf
432	432	0	GBIF Germany	4f6826f2-4ff6-443d-b966-e6913bd24013	95606346-f762-11e1-a439-00145eb45e9a
0	6	6	Plazi	ffb07bec-2d10-492d-9c37-361fe0b79427	959bbee9-5cc5-47b7-936b-9346ebfb55b1
76	76	0	Plazi	ffb07bec-2d10-492d-9c37-361fe0b79427	95ecca34-c5f8-48d0-b1a3-af6cb7457754
5961	6832	871	GBIF Germany	4f6826f2-4ff6-443d-b966-e6913bd24013	966dbf18-f762-11e1-a439-00145eb45e9a
0	69457	69457	Korean Biodiversity Information Facility	e0a1e772-0177-4800-94b4-2d023fe6cdf4	96866224-1d21-4007-98a5-d36259e80e90
0	2	2	Plazi	ffb07bec-2d10-492d-9c37-361fe0b79427	970faa7a-925b-4fd1-85c5-215e05605b2b
30	30	0	GBIF Germany	4f6826f2-4ff6-443d-b966-e6913bd24013	977d48ec-f762-11e1-a439-00145eb45e9a
11	11	0	Plazi	ffb07bec-2d10-492d-9c37-361fe0b79427	983953d9-e7f1-48e8-b24d-b004ada2d986
73	73	0	Colombian Biodiversity Information System	7e865cba-7c46-417b-ade5-97f2cf5b7be0	997a8a71-6daa-461c-9ff1-183d5dd8871f
0	251	251	Ocean Biodiversity Information System	ba0670b9-4186-41e6-8e70-f9cb3065551a	9ad9750a-e1ec-4764-99a5-3694e9cbaff9
23	23	0	Plazi	ffb07bec-2d10-492d-9c37-361fe0b79427	9b96a2c1-4fae-40de-9850-eac945c44c0c
54120	54120	0	GBIF Finland	dd514216-5c7c-45f3-910d-797424cb5be6	9beef55a-b4a4-4031-a1e0-0d2bdeea2c21
2070	2070	0	Biodiversity Information System of Mexico	b324e8e9-9a4c-44fa-8f1a-7f39ea7ab576	9ce536e8-6b65-40aa-b6c0-6d2a9090439a
0	3	3	Plazi	ffb07bec-2d10-492d-9c37-361fe0b79427	9ef44358-db5b-4d04-a08a-0d44711ce040
70972	70972	0	GBIF Norway	4f829580-180d-46a9-9c87-ed8ec959b545	a21d0640-32e6-4040-8948-c0601fcdee17
8353	8353	0	National Biodiversity Network	d897a5b9-35ee-4232-94bd-b0bcaac003c2	a2edc33d-dc8f-45dc-a448-aadc830bd6fb
1805	2090	285	U.S. Geological Survey	8618c64a-93e0-4300-b546-7249e5148ed2	a391ecd7-b4ca-4145-929a-04744ccc5779
832	832	0	GBIF France	da44cd31-5901-4687-a106-6d1c7734ee3a	a740652c-0dc3-475a-9034-3f4358831e59
24	24	0	Plazi	ffb07bec-2d10-492d-9c37-361fe0b79427	a8676fdb-3191-4bff-8e11-f06503953ec5
53	54	1	U.S. Geological Survey	8618c64a-93e0-4300-b546-7249e5148ed2	aec797d2-0dcc-4944-a1b2-05aa383d88b7
10	10	0	Plazi	ffb07bec-2d10-492d-9c37-361fe0b79427	b27b3abc-b65c-4578-ad4b-4cfba3a50fbf
1933	1933	0	Participant Node Managers Committee	7f48e0c8-5c96-49ec-b972-30748e339115	b2b5f706-2758-4b90-90a1-c62764786cdf
84	84	0	Plazi	ffb07bec-2d10-492d-9c37-361fe0b79427	b389e1f3-82be-4258-9b09-b7ef9d839f99
0	4	4	Plazi	ffb07bec-2d10-492d-9c37-361fe0b79427	b3f3286d-a18d-44d9-aa9f-3a21e0813fc3
498	498	0	GBIF France	da44cd31-5901-4687-a106-6d1c7734ee3a	b5c64f4a-5fcb-40c6-abb4-5e22a44fe5a2
0	281930	281930	Netherlands Biodiversity Information Facility	0909d601-bda2-42df-9e63-a6d51847ebce	b76c6126-e1c2-4bc6-9394-2fabb8584a85
20627	21716	1089	Canada Biodiversity Information Facility	8f83fc96-c966-4126-83f7-bf044dc49efa	b7a76dbc-3407-467b-96f4-01daae0a6e38
1296	1296	0	Colombian Biodiversity Information System	7e865cba-7c46-417b-ade5-97f2cf5b7be0	b83b93b8-4b97-4cd2-b979-3801c622bc52
0	19	19	Plazi	ffb07bec-2d10-492d-9c37-361fe0b79427	ba971905-395d-4182-9f93-64869f1b55a9
1904	1904	0	Colombian Biodiversity Information System	7e865cba-7c46-417b-ade5-97f2cf5b7be0	bada53d0-6a74-45a6-9bfb-c038698e4b0f
1	1	0	Plazi	ffb07bec-2d10-492d-9c37-361fe0b79427	bbc2d4cf-e6c0-443e-b5e4-feeebd7a501e
2021	2021	0	National Biodiversity Network	d897a5b9-35ee-4232-94bd-b0bcaac003c2	c031f445-f0b2-4ad4-891e-45bf11730243
118898	118898	0	Atlas of Living Australia	4a6f1b71-969e-4fc5-a693-282b05e1220c	c1fc2df7-223b-4472-8998-70afb3b749ab
4	4	0	Participant Node Managers Committee	7f48e0c8-5c96-49ec-b972-30748e339115	c23c13a2-8159-4f83-be5e-cf08845b2dc1
0	17	17	Plazi	ffb07bec-2d10-492d-9c37-361fe0b79427	c544c122-c211-4594-b479-514523bb93f9
49540	49540	0	GBIF France	da44cd31-5901-4687-a106-6d1c7734ee3a	c7521912-d688-4863-857b-6d78fe4f80e1
899	899	0	GBIF Portugal	673f7038-4262-4149-b753-5658a4e912f6	c82f8f11-a30c-4351-9fe0-ac8a4d30f450
29	29	0	GBIF Germany	4f6826f2-4ff6-443d-b966-e6913bd24013	c9e2c75f-5172-44ac-9e2a-8e8b4bc8c69a
0	932	932	Colombian Biodiversity Information System	7e865cba-7c46-417b-ade5-97f2cf5b7be0	cb06f9df-eb05-40e6-9920-cf9544266244
5427	5427	0	Biodiversity Information System of Mexico	b324e8e9-9a4c-44fa-8f1a-7f39ea7ab576	cb1a521c-29f7-4751-8661-898d16d0caa6
2555	2555	0	GBIF Benin	efb9c00e-f802-45dd-8826-a52ec45b89ff	cb79b39a-b1ad-46b2-bb71-a0d14815dc67
0	2	2	Participant Node Managers Committee	7f48e0c8-5c96-49ec-b972-30748e339115	ccdf9fd2-f0a5-4dcd-a669-4ba33fd8f816
6531	6531	0	National Biodiversity Network	d897a5b9-35ee-4232-94bd-b0bcaac003c2	cdeba034-29d1-4625-a6ea-36289b2826b8
920	920	0	GBIF France	da44cd31-5901-4687-a106-6d1c7734ee3a	d02072fa-b7ea-4e04-bec6-d3b225a73083
4	4	0	Plazi	ffb07bec-2d10-492d-9c37-361fe0b79427	d44d1429-fb70-49cf-8652-0d09cc406bad
0	173	173	Ocean Biodiversity Information System	ba0670b9-4186-41e6-8e70-f9cb3065551a	d4baf2c5-090d-417b-9c29-d14d762d2ce1
669	669	0	GBIF Brazil	cdc9736d-5ff7-4ece-9959-3c744360cdb3	d546af34-1ce3-4ceb-a535-f88692357f2f
79745	79745	0	GBIF Japan	db5705aa-6a6e-42f1-8942-d77b9f4896ea	db3ec909-ba40-40f6-af20-8b0b00750f71
12	12	0	Plazi	ffb07bec-2d10-492d-9c37-361fe0b79427	dc2fdad8-8baa-451f-9ae3-07d5e0e8ab35
0	2	2	Participant Node Managers Committee	7f48e0c8-5c96-49ec-b972-30748e339115	e06ebf05-9228-4516-926d-5d491e81664d
16	16	0	Plazi	ffb07bec-2d10-492d-9c37-361fe0b79427	e09022e2-1d7e-4620-a4e6-6e92e4867bbe
189	189	0	Plazi	ffb07bec-2d10-492d-9c37-361fe0b79427	e2c6a7ae-f2f7-45cb-a9c0-e885dd74927c
0	5	5	Plazi	ffb07bec-2d10-492d-9c37-361fe0b79427	e497033b-39af-49c0-a768-c7d16c247ab0
0	3	3	Plazi	ffb07bec-2d10-492d-9c37-361fe0b79427	e8132b6d-c545-476c-8c68-3b1035e0c6e1
67	67	0	GBIF France	da44cd31-5901-4687-a106-6d1c7734ee3a	e913571b-6bf8-46e4-80a9-ba80fb191501
5	5	0	Plazi	ffb07bec-2d10-492d-9c37-361fe0b79427	e9fb53be-c235-4070-986a-33faea0919e5
16	16	0	Plazi	ffb07bec-2d10-492d-9c37-361fe0b79427	ecc87927-07e5-408a-a69a-786703f443ce
144	144	0	GBIF France	da44cd31-5901-4687-a106-6d1c7734ee3a	ed3227fb-a11a-4502-8196-283f7d3c2e24
3139	3139	0	GBIF Japan	db5705aa-6a6e-42f1-8942-d77b9f4896ea	ed32afa1-8e49-4129-876e-aeabf305641d
0	38757	38757	GBIF Germany	4f6826f2-4ff6-443d-b966-e6913bd24013	ee0e7875-8fbc-4cd8-a6a8-65f4a871e2ea
0	265	265	Ocean Biodiversity Information System	ba0670b9-4186-41e6-8e70-f9cb3065551a	eeb3338c-0343-4763-a641-d45d37cc7909
2320	2320	0	National Biodiversity Network	d897a5b9-35ee-4232-94bd-b0bcaac003c2	f03ae1bb-de27-45ea-bc58-4911e17d308f
0	3	3	Ocean Biodiversity Information System	ba0670b9-4186-41e6-8e70-f9cb3065551a	f111fae5-3e71-46ee-abe6-4be5ea31bf5e
697	696	-1	Biodiversity Information System of Mexico	b324e8e9-9a4c-44fa-8f1a-7f39ea7ab576	f3e004e1-92a6-4245-8726-eb6214c770a6
180	180	0	Ocean Biodiversity Information System	ba0670b9-4186-41e6-8e70-f9cb3065551a	f40d63cd-1315-4653-a318-076b5fee7867
209	209	0	GBIF Germany	4f6826f2-4ff6-443d-b966-e6913bd24013	f4d54717-969b-43b4-954f-323be1956fae
698970	698970	0	U.S. Geological Survey	8618c64a-93e0-4300-b546-7249e5148ed2	f56fb306-32e4-4b96-a381-6b87c186ad0f
95	95	0	Colombian Biodiversity Information System	7e865cba-7c46-417b-ade5-97f2cf5b7be0	f5a8eab6-320c-4a6d-8124-663b9b354362
125599	125599	0	GBIF Brazil	cdc9736d-5ff7-4ece-9959-3c744360cdb3	f5d836d5-cb15-4178-8f57-68ef1d6551e9
0	108	108	Ocean Biodiversity Information System	ba0670b9-4186-41e6-8e70-f9cb3065551a	f7b4ae6c-d791-4ef2-a49a-4d1893d7451f
0	17	17	Plazi	ffb07bec-2d10-492d-9c37-361fe0b79427	f8abea37-7992-482c-8a49-982d08cf9f66
985	985	0	Participant Node Managers Committee	7f48e0c8-5c96-49ec-b972-30748e339115	fa2cbea9-b277-4254-9743-bac694582106
0	1966	1966	Ocean Biodiversity Information System	ba0670b9-4186-41e6-8e70-f9cb3065551a	fa7b810c-ce8b-4c74-8790-cafd4cf9cbec
2	2	0	Plazi	ffb07bec-2d10-492d-9c37-361fe0b79427	fadab859-5a32-4eed-a6e6-97975941df2e
1	1	0	Plazi	ffb07bec-2d10-492d-9c37-361fe0b79427	fafa1676-96ba-4dec-84e7-0287058d0bc7
136572	136572	0	National Biodiversity Network	d897a5b9-35ee-4232-94bd-b0bcaac003c2	fcfe8243-b388-4199-9e07-012512f42cc8
540494	540493	-1	National Biodiversity Network	d897a5b9-35ee-4232-94bd-b0bcaac003c2	fd7d3a3d-7f94-495f-9df6-842d12e2e4b7
0	85	85	Colombian Biodiversity Information System	7e865cba-7c46-417b-ade5-97f2cf5b7be0	fe42b21c-3ba4-407d-ac4a-55e539bbcbbb
33	33	0	National Biodiversity Network	d897a5b9-35ee-4232-94bd-b0bcaac003c2	0091fe20-aa11-4973-9586-2da1803b1937
839	839	0	Biodiversity Information System of Mexico	b324e8e9-9a4c-44fa-8f1a-7f39ea7ab576	03a03292-e179-4c62-86ee-4756aea3b7e4
0	21	21	Plazi	ffb07bec-2d10-492d-9c37-361fe0b79427	0498cbab-ba3e-4866-9061-ad026264a358
2225	2225	0	GBIF France	da44cd31-5901-4687-a106-6d1c7734ee3a	0501b072-05db-4744-a8c4-4fa407f7e034
3	3	0	Plazi	ffb07bec-2d10-492d-9c37-361fe0b79427	0843338a-8718-4a20-93f0-d297e53a4750
0	94	94	GBIF France	da44cd31-5901-4687-a106-6d1c7734ee3a	0898ccec-0330-4c55-8ec2-5a50cd9f8f88
0	78	78	Symbiota Support Hub	612b5a0b-908b-4b4e-b9bf-ca15dfdc94fa	0a24d08e-be47-4042-b8da-3e800c3eb5f9
0	245	245	Ocean Biodiversity Information System	ba0670b9-4186-41e6-8e70-f9cb3065551a	0af246c6-47a1-4995-bbdb-6278ed9452d2
16	16	0	Colombian Biodiversity Information System	7e865cba-7c46-417b-ade5-97f2cf5b7be0	0ccecda9-8b2a-46d1-90dd-56e4c4b5bcd1
4	4	0	Plazi	ffb07bec-2d10-492d-9c37-361fe0b79427	0e8e83dc-0745-41ad-a372-0fc5cdc03749
223	223	0	GBIF Japan	db5705aa-6a6e-42f1-8942-d77b9f4896ea	10d4ea8d-9feb-44ba-961c-ddbb8732fa8f
666	666	0	Atlas of Living Australia	4a6f1b71-969e-4fc5-a693-282b05e1220c	11ba0f8a-b084-47f6-b711-9f995c6f8e79
0	23	23	Plazi	ffb07bec-2d10-492d-9c37-361fe0b79427	1220ec60-4526-4480-84ef-c6ffbcfe6250
5665	5665	0	Atlas of Living Australia	4a6f1b71-969e-4fc5-a693-282b05e1220c	138cc86a-61be-4e89-86a7-737086398cbf
18	18	0	Plazi	ffb07bec-2d10-492d-9c37-361fe0b79427	16297a69-d824-49e4-932f-7425e9a387a8
0	4215	4215	Ocean Biodiversity Information System	ba0670b9-4186-41e6-8e70-f9cb3065551a	17b03aff-a13b-4b7b-998a-1cf8789d72aa
48	48	0	Plazi	ffb07bec-2d10-492d-9c37-361fe0b79427	17f8e584-b4c7-4586-9dbc-c682b3ffcd62
0	6	6	Plazi	ffb07bec-2d10-492d-9c37-361fe0b79427	18ae97b8-f8b7-4b76-a228-ff2696ea332e
3326	3326	0	GBIF Japan	db5705aa-6a6e-42f1-8942-d77b9f4896ea	1acfb9aa-0620-4213-bfe3-94c6415d603b
163199	163199	0	Chinese Academy of Sciences	e760dc6f-dd68-474d-ab41-bd3588571793	1b412457-43cf-4a6f-b5c2-7acf01be5977
17618	17618	0	GBIF Israel	8cb55387-7802-40e8-86d6-d357a583c596	1b7d40be-de9e-4338-a702-92c87367f14b
0	4	4	Plazi	ffb07bec-2d10-492d-9c37-361fe0b79427	2037ce52-e1b2-435b-8932-5e140fbbd49f
0	150	150	Plazi	ffb07bec-2d10-492d-9c37-361fe0b79427	2224cc31-78f3-4db3-9a52-2ce9fd357571
7696	7696	0	U.S. Geological Survey	8618c64a-93e0-4300-b546-7249e5148ed2	25975eb0-d7b0-4662-bd60-a80164850d59
3	3	0	Plazi	ffb07bec-2d10-492d-9c37-361fe0b79427	2a05f92b-5125-41c8-ba0d-df4afd5c8e3d
904	904	0	National Biodiversity Network	d897a5b9-35ee-4232-94bd-b0bcaac003c2	2b22377d-f7ca-487c-9ad0-a63bc4849414
0	48	48	Plazi	ffb07bec-2d10-492d-9c37-361fe0b79427	33b954d6-7939-47da-9776-6b079002355a
82	82	0	Plazi	ffb07bec-2d10-492d-9c37-361fe0b79427	33c0b2ac-f010-4b11-a819-0796497a6928
3927	3927	0	Biodiversity Information System of Mexico	b324e8e9-9a4c-44fa-8f1a-7f39ea7ab576	36a96c9f-7f75-49df-abd8-c07d8262f91f
203	203	0	GBIF France	da44cd31-5901-4687-a106-6d1c7734ee3a	38637c59-74bd-435d-a924-77f17c4f4e60
5	5	0	Plazi	ffb07bec-2d10-492d-9c37-361fe0b79427	3fa51c2d-88f0-4ae8-9ebf-f765e7257ff3
62	62	0	Plazi	ffb07bec-2d10-492d-9c37-361fe0b79427	41a13689-dcc3-463c-941b-1f0ac97625aa
53	53	0	Plazi	ffb07bec-2d10-492d-9c37-361fe0b79427	41b7a62e-6738-4aaa-84c4-e5ad95c0dd63
94	94	0	National Biodiversity Network	d897a5b9-35ee-4232-94bd-b0bcaac003c2	494ba938-4fbe-4771-99ac-57f7eafd7c66
24	24	0	Plazi	ffb07bec-2d10-492d-9c37-361fe0b79427	49d45069-6150-4b6e-873c-fc8058025a39
125	125	0	Colombian Biodiversity Information System	7e865cba-7c46-417b-ade5-97f2cf5b7be0	4ab8c58e-2cfe-4d71-9354-84f739b9f6b8
0	57801	57801	U.S. Geological Survey	8618c64a-93e0-4300-b546-7249e5148ed2	4c122e6f-b2a4-4f91-aff5-449e9afb57b3
50	50	0	Colombian Biodiversity Information System	7e865cba-7c46-417b-ade5-97f2cf5b7be0	4ca6a8d2-a45c-44cb-bd28-9a709d375038
0	7	7	Plazi	ffb07bec-2d10-492d-9c37-361fe0b79427	4caaf0c8-bd51-4d80-86ba-5544792d65ce
16	16	0	National Biodiversity Data Centre	422b00b2-6c94-4bb6-976b-c359916efdb8	4df73f18-1279-40d5-8931-f9ff0033ac26
105124	105124	0	GBIF France	da44cd31-5901-4687-a106-6d1c7734ee3a	4e3e00d6-6a60-401d-af5a-1a4816755f72
110	110	0	GBIF Portugal	673f7038-4262-4149-b753-5658a4e912f6	4eeb051c-b866-4fe5-aac6-65a6cfd3af3d
20	20	0	GBIF Germany	4f6826f2-4ff6-443d-b966-e6913bd24013	4f546e51-1449-4f5a-a927-3c6fdc505b9b
134540	134540	0	VertNet	d205def7-82c3-472a-be4b-31d11dcd51fd	4f64e2fc-a84b-49f6-802f-e48f725717d7
354	354	0	Colombian Biodiversity Information System	7e865cba-7c46-417b-ade5-97f2cf5b7be0	5308b8f5-e4c1-4695-bb12-baccedc94ae3
4724	5246	522	Belgian Biodiversity Platform	fb11cfe1-ebc3-45af-9159-17d9fddbcdac	53b55f0b-eace-46da-b414-351f092e1223
55	55	0	Plazi	ffb07bec-2d10-492d-9c37-361fe0b79427	5453a473-5256-4488-8f49-c96f3ab791ea
81532	81532	0	National Biodiversity Network	d897a5b9-35ee-4232-94bd-b0bcaac003c2	559204c2-814a-4756-92b5-9dec6f0a1936
233	233	0	National Biodiversity Data Centre	422b00b2-6c94-4bb6-976b-c359916efdb8	57c72665-0203-45b5-b645-20d7c4d922c2
6083	6083	0	National Biodiversity Network	d897a5b9-35ee-4232-94bd-b0bcaac003c2	5a87124d-d619-430f-9148-d1be7db73a31
0	3	3	Plazi	ffb07bec-2d10-492d-9c37-361fe0b79427	5fd5e5f7-9b81-4d5b-9341-4fe5b9d67af4
2913	2913	0	GBIF France	da44cd31-5901-4687-a106-6d1c7734ee3a	60e0dbbd-b3cc-4164-a601-896e111b54d5
100	100	0	GBIF Germany	4f6826f2-4ff6-443d-b966-e6913bd24013	61522f58-f762-11e1-a439-00145eb45e9a
7	7	0	GBIF Germany	4f6826f2-4ff6-443d-b966-e6913bd24013	62f6ff14-f762-11e1-a439-00145eb45e9a
15	15	0	GBIF Germany	4f6826f2-4ff6-443d-b966-e6913bd24013	6329f84c-f762-11e1-a439-00145eb45e9a
144	144	0	GBIF Germany	4f6826f2-4ff6-443d-b966-e6913bd24013	6398e144-f762-11e1-a439-00145eb45e9a
64	64	0	GBIF Germany	4f6826f2-4ff6-443d-b966-e6913bd24013	6485b12c-f762-11e1-a439-00145eb45e9a
102	102	0	GBIF Germany	4f6826f2-4ff6-443d-b966-e6913bd24013	662fa8b6-f762-11e1-a439-00145eb45e9a
166	166	0	GBIF Germany	4f6826f2-4ff6-443d-b966-e6913bd24013	67a7863c-f762-11e1-a439-00145eb45e9a
0	616	616	GBIF Spain	1f94b3ca-9345-4d65-afe2-4bace93aa0fe	680f0b85-4c51-40c1-bddb-50d00a217076
0	3	3	Plazi	ffb07bec-2d10-492d-9c37-361fe0b79427	6a7185e0-f1e6-4a27-9e05-ff8f6d218ea1
40	40	0	GBIF Germany	4f6826f2-4ff6-443d-b966-e6913bd24013	6ac224f8-f762-11e1-a439-00145eb45e9a
13	13	0	GBIF Argentina	2426a871-9feb-40a1-96c6-0c593a76b835	6b255fbd-6f1f-46de-9d70-b883d6890477
30	30	0	GBIF Germany	4f6826f2-4ff6-443d-b966-e6913bd24013	6b78b27c-f762-11e1-a439-00145eb45e9a
0	17	17	Plazi	ffb07bec-2d10-492d-9c37-361fe0b79427	6b91b992-27a5-425b-843f-8431f81ec0c3
0	2	2	Plazi	ffb07bec-2d10-492d-9c37-361fe0b79427	6bfa5fcd-4169-4681-8537-4ce19b20b7e7
0	20	20	Plazi	ffb07bec-2d10-492d-9c37-361fe0b79427	6d7b4e8c-9086-45b7-87f2-eee086af0c5a
3	3	0	Plazi	ffb07bec-2d10-492d-9c37-361fe0b79427	6e488318-ae07-45f4-80b6-a77595ee7151
19	19	0	Plazi	ffb07bec-2d10-492d-9c37-361fe0b79427	6f275527-6328-4650-9f81-ebd636f364e1
0	14	14	Plazi	ffb07bec-2d10-492d-9c37-361fe0b79427	6fce3374-f119-4abd-9740-02d4595201f9
1254	1018	-236	GBIF Germany	4f6826f2-4ff6-443d-b966-e6913bd24013	70e03a00-2d90-4800-b13a-d434db442889
0	9	9	Ocean Biodiversity Information System	ba0670b9-4186-41e6-8e70-f9cb3065551a	71435c60-2503-4ac4-b632-289c395ec3b9
0	46	46	Colombian Biodiversity Information System	7e865cba-7c46-417b-ade5-97f2cf5b7be0	73cf20cd-72cc-4013-9f7f-33d373927049
220	220	0	GBIF Germany	4f6826f2-4ff6-443d-b966-e6913bd24013	74b54738-f762-11e1-a439-00145eb45e9a
124	124	0	GBIF Germany	4f6826f2-4ff6-443d-b966-e6913bd24013	75755b7c-f762-11e1-a439-00145eb45e9a
400	400	0	GBIF Germany	4f6826f2-4ff6-443d-b966-e6913bd24013	75994762-f762-11e1-a439-00145eb45e9a
11	11	0	Participant Node Managers Committee	7f48e0c8-5c96-49ec-b972-30748e339115	76ea8695-11af-415b-ac34-d3537b2a0d12
2	2	0	Plazi	ffb07bec-2d10-492d-9c37-361fe0b79427	783851de-cb9e-4917-872c-66634f7e2a7e
1356	1356	0	GBIF France	da44cd31-5901-4687-a106-6d1c7734ee3a	78fbe592-7ce6-4778-b5d6-572687de652a
0	1	1	Plazi	ffb07bec-2d10-492d-9c37-361fe0b79427	78ff6989-7bc3-4ac9-b00e-521ed0c896b8
0	3	3	Plazi	ffb07bec-2d10-492d-9c37-361fe0b79427	7a27a474-0008-45eb-88c6-75b2746e58cc
134	134	0	GBIF France	da44cd31-5901-4687-a106-6d1c7734ee3a	7b352c77-6d0f-4dbc-831d-e4e21fd5ee98
194339	194339	0	GBIF Austria	1e789bc9-79fc-4e60-a49e-89dfc45a7188	7b904404-f762-11e1-a439-00145eb45e9a
242	242	0	GBIF Germany	4f6826f2-4ff6-443d-b966-e6913bd24013	7c104c4e-f762-11e1-a439-00145eb45e9a
99	99	0	GBIF Germany	4f6826f2-4ff6-443d-b966-e6913bd24013	7c950c40-f762-11e1-a439-00145eb45e9a
230	180	-50	GBIF Germany	4f6826f2-4ff6-443d-b966-e6913bd24013	7ca2454a-f762-11e1-a439-00145eb45e9a
732	352	-380	GBIF Germany	4f6826f2-4ff6-443d-b966-e6913bd24013	7daf5d56-f762-11e1-a439-00145eb45e9a
6669	6735	66	GBIF Germany	4f6826f2-4ff6-443d-b966-e6913bd24013	816113c2-f762-11e1-a439-00145eb45e9a
2713	2713	0	GBIF Germany	4f6826f2-4ff6-443d-b966-e6913bd24013	81b52746-f762-11e1-a439-00145eb45e9a
40379	41528	1149	GBIF Brazil	cdc9736d-5ff7-4ece-9959-3c744360cdb3	81c2706e-d91a-41d8-b7d9-1553f53b7117
247	247	0	GBIF Germany	4f6826f2-4ff6-443d-b966-e6913bd24013	826e1d6e-f762-11e1-a439-00145eb45e9a
14219	14219	0	GBIF Spain	1f94b3ca-9345-4d65-afe2-4bace93aa0fe	834dcb62-f762-11e1-a439-00145eb45e9a
14824	14824	0	GBIF Japan	db5705aa-6a6e-42f1-8942-d77b9f4896ea	849b20aa-f762-11e1-a439-00145eb45e9a
455	455	0	GBIF Portugal	673f7038-4262-4149-b753-5658a4e912f6	853b7260-585d-4638-bb59-3dc714b85517
27108	27108	0	GBIF Brazil	cdc9736d-5ff7-4ece-9959-3c744360cdb3	85bce05a-fce5-4918-a8f0-ab4b82718c25
0	864	864	Plazi	ffb07bec-2d10-492d-9c37-361fe0b79427	85bd2c66-f9f0-4172-8d82-2e8841cd354a
17073	17073	0	GBIF France	da44cd31-5901-4687-a106-6d1c7734ee3a	863348e4-cf7d-449e-bc4e-dd7f5ba687fd
1955	1513	-442	GBIF Germany	4f6826f2-4ff6-443d-b966-e6913bd24013	86d5f818-f762-11e1-a439-00145eb45e9a
36	36	0	Participant Node Managers Committee	7f48e0c8-5c96-49ec-b972-30748e339115	881aaeb5-caa3-4fe1-ac3f-6595e1dc230a
178	110	-68	GBIF Germany	4f6826f2-4ff6-443d-b966-e6913bd24013	88b2808e-f762-11e1-a439-00145eb45e9a
425	425	0	Atlas of Living Australia	4a6f1b71-969e-4fc5-a693-282b05e1220c	88e24a94-f762-11e1-a439-00145eb45e9a
1464	1464	0	Biodiversity Information System of Mexico	b324e8e9-9a4c-44fa-8f1a-7f39ea7ab576	89709268-f762-11e1-a439-00145eb45e9a
55	55	0	Colombian Biodiversity Information System	7e865cba-7c46-417b-ade5-97f2cf5b7be0	89e0e3d8-80d4-4410-a8c7-a0a3e688fe39
3	3	0	Plazi	ffb07bec-2d10-492d-9c37-361fe0b79427	8a5928b7-eefc-4fb8-bdc0-f7204f8b15f9
107	107	0	GBIF Germany	4f6826f2-4ff6-443d-b966-e6913bd24013	8bbc7f64-f762-11e1-a439-00145eb45e9a
115	115	0	National Biodiversity Network	d897a5b9-35ee-4232-94bd-b0bcaac003c2	8c602115-50f4-4a79-8b07-46c9545c0837
44	44	0	GBIF Germany	4f6826f2-4ff6-443d-b966-e6913bd24013	8d1fe6e8-f762-11e1-a439-00145eb45e9a
198	198	0	GBIF Finland	dd514216-5c7c-45f3-910d-797424cb5be6	8dbc2707-eae6-40de-85bf-0625f9f0a10b
1	1	0	GBIF Germany	4f6826f2-4ff6-443d-b966-e6913bd24013	8eeae4be-f762-11e1-a439-00145eb45e9a
17584	14448	-3136	GBIF Germany	4f6826f2-4ff6-443d-b966-e6913bd24013	8f114118-f762-11e1-a439-00145eb45e9a
35	27	-8	GBIF Germany	4f6826f2-4ff6-443d-b966-e6913bd24013	8f9a36bc-f762-11e1-a439-00145eb45e9a
150	125	-25	GBIF Germany	4f6826f2-4ff6-443d-b966-e6913bd24013	912c6d60-f762-11e1-a439-00145eb45e9a
134	140	6	GBIF Germany	4f6826f2-4ff6-443d-b966-e6913bd24013	921811c0-f762-11e1-a439-00145eb45e9a
1270	1270	0	GBIF France	da44cd31-5901-4687-a106-6d1c7734ee3a	92ce067c-0c47-41f2-bb1b-d0a3084aaa12
17	17	0	Plazi	ffb07bec-2d10-492d-9c37-361fe0b79427	938edb14-1541-42c3-a05e-7484ddcdad01
1	1	0	Atlas of Living Australia	4a6f1b71-969e-4fc5-a693-282b05e1220c	96a2390b-6137-4cf8-8323-aac518faab2b
465	465	0	Atlas of Living Australia	4a6f1b71-969e-4fc5-a693-282b05e1220c	96a2b704-f762-11e1-a439-00145eb45e9a
165	165	0	GBIF France	da44cd31-5901-4687-a106-6d1c7734ee3a	97ca9cb9-7940-444a-a54f-da5569d6197a
173	254	81	GBIF Argentina	2426a871-9feb-40a1-96c6-0c593a76b835	97e0aad8-f746-4925-be9f-c9961ec8d3f2
0	1	1	Plazi	ffb07bec-2d10-492d-9c37-361fe0b79427	99f7227b-8ffb-45cc-88b2-cb14f4beda94
26	26	0	Plazi	ffb07bec-2d10-492d-9c37-361fe0b79427	9bb21e49-9809-47cf-8a01-77ecee28fa9d
267556	267556	0	DanBIF - Danish Biodiversity Information Facility	4ddd294f-02b7-4359-ac33-0806a9ca9c6b	9beef4fb-e3dd-475a-be95-45d2105b32bd
7971	7971	0	GBIF Japan	db5705aa-6a6e-42f1-8942-d77b9f4896ea	9dbb55ce-0b38-4468-9172-40c8481edd2a
98	98	0	GBIF France	da44cd31-5901-4687-a106-6d1c7734ee3a	9e612b22-1d54-4158-98c8-5a469751262e
424	450	26	Colombian Biodiversity Information System	7e865cba-7c46-417b-ade5-97f2cf5b7be0	9ea3418b-790c-4932-acd1-90656498cae5
18	18	0	GBIF France	da44cd31-5901-4687-a106-6d1c7734ee3a	9f397788-61fe-4f31-be45-9cf7112530b4
17	17	0	GBIF Germany	4f6826f2-4ff6-443d-b966-e6913bd24013	9f3ce7ad-dccb-42a0-8b5f-194890cc7e35
0	2269	2269	Ocean Biodiversity Information System	ba0670b9-4186-41e6-8e70-f9cb3065551a	a0c41c55-4f00-43a1-adaf-9f6a07d4fff6
4	4	0	Plazi	ffb07bec-2d10-492d-9c37-361fe0b79427	a18506ae-da47-4ffe-a21f-995397e961f7
495	495	0	Netherlands Biodiversity Information Facility	0909d601-bda2-42df-9e63-a6d51847ebce	aaebba56-769a-4564-9b66-a7f4b566e25b
351778	351778	0	GBIF Finland	dd514216-5c7c-45f3-910d-797424cb5be6	acf24ccc-cea1-4f90-aa1b-4089d80fa856
449	449	0	Plazi	ffb07bec-2d10-492d-9c37-361fe0b79427	b15f5f11-6a00-4158-8ec8-3d0004605c28
4	4	0	Plazi	ffb07bec-2d10-492d-9c37-361fe0b79427	ba055cef-f55e-47dd-b1c9-00db492149ca
0	6	6	Ocean Biodiversity Information System	ba0670b9-4186-41e6-8e70-f9cb3065551a	bc2f807d-ea29-4705-aca7-a2796ebf9c98
9	9	0	Plazi	ffb07bec-2d10-492d-9c37-361fe0b79427	bf5712f1-5a02-4755-8d56-be690a7e616a
0	2	2	Plazi	ffb07bec-2d10-492d-9c37-361fe0b79427	c08dd8ae-6f1e-4522-a4a2-ced89fdd3530
1	1	0	Plazi	ffb07bec-2d10-492d-9c37-361fe0b79427	c164a746-877a-4fcd-a3b7-4134bc96a606
222	222	0	National Biodiversity Network	d897a5b9-35ee-4232-94bd-b0bcaac003c2	c293d351-7a9b-4963-b81b-b8dfa96fae1b
2467	2467	0	National Biodiversity Network	d897a5b9-35ee-4232-94bd-b0bcaac003c2	c4a764e4-8455-425b-b553-253f9f9dfbac
60378	75243	14865	GBIF Japan	db5705aa-6a6e-42f1-8942-d77b9f4896ea	c4e75650-1220-4166-9151-6dcddd465bb2
0	29195	29195	Participant Node Managers Committee	7f48e0c8-5c96-49ec-b972-30748e339115	c7fb31e7-cefe-40a4-92b6-4cf37e9510a2
1	1	0	Plazi	ffb07bec-2d10-492d-9c37-361fe0b79427	cc535367-f8ea-412d-9c79-e9f1624ceba0
139	139	0	South African Biodiversity Information Facility	7190b835-4e86-4b6e-85c1-19cc6677c250	cc7bb6e1-3b7e-4b22-a73a-d52fa3a94202
4	4	0	Plazi	ffb07bec-2d10-492d-9c37-361fe0b79427	cf4799e8-030b-43a6-a445-5953b29b98d3
2247	2247	0	National Biodiversity Network	d897a5b9-35ee-4232-94bd-b0bcaac003c2	d24b29ba-8f3b-4c41-be21-b615882e54c6
20	20	0	Plazi	ffb07bec-2d10-492d-9c37-361fe0b79427	d5ab12ff-9d22-4027-9235-dcc2ddcd79c9
8	8	0	Plazi	ffb07bec-2d10-492d-9c37-361fe0b79427	d631c6be-9348-417d-abf9-2b26a8db8a4b
0	1	1	Participant Node Managers Committee	7f48e0c8-5c96-49ec-b972-30748e339115	d715eead-9c34-4a48-8e5a-769db9a5e1d8
1	1	0	Plazi	ffb07bec-2d10-492d-9c37-361fe0b79427	d8be473a-53c9-4ce6-8bd4-ec818d87adc0
6	6	0	Plazi	ffb07bec-2d10-492d-9c37-361fe0b79427	dccc66ae-685c-4944-81ed-d0be51d7f702
177	177	0	GBIF France	da44cd31-5901-4687-a106-6d1c7734ee3a	dcf889ca-c279-40e1-b69a-4d9d98f2d318
1551	1551	0	GBIF Guinea	b1cd2e84-c4ba-47bd-b72a-dfd1f92dce0a	e12ef904-03f0-4921-8da1-fc3fa87fcde8
2	2	0	Plazi	ffb07bec-2d10-492d-9c37-361fe0b79427	e2523490-1c71-4e99-ba9c-5e3f6c3989dc
334	334	0	GBIF France	da44cd31-5901-4687-a106-6d1c7734ee3a	e2eb9af3-9b07-48ec-9ff2-32620ed094b8
33	33	0	Plazi	ffb07bec-2d10-492d-9c37-361fe0b79427	e328534b-83b9-4320-8af8-2b3d88e43fa0
1661	1661	0	GBIF France	da44cd31-5901-4687-a106-6d1c7734ee3a	e67c686b-c880-4a82-887c-d8d85f94d6c8
872	872	0	Participant Node Managers Committee	7f48e0c8-5c96-49ec-b972-30748e339115	e7a2f416-fea5-41bb-8f17-5217fcaa74d7
280	280	0	Atlas of Living Australia	4a6f1b71-969e-4fc5-a693-282b05e1220c	e7facd4a-7108-4506-b446-e7d69612d9f7
0	1	1	Plazi	ffb07bec-2d10-492d-9c37-361fe0b79427	e99f0883-07e7-4453-9102-75f176de688b
0	10	10	Plazi	ffb07bec-2d10-492d-9c37-361fe0b79427	ea3d363e-d34c-4daf-b649-8e218aea7757
506	506	0	GBIF Germany	4f6826f2-4ff6-443d-b966-e6913bd24013	ee5ef7e5-c315-4265-8c03-19ca281f8064
10	10	0	Plazi	ffb07bec-2d10-492d-9c37-361fe0b79427	eede3b53-5787-4111-ac0c-4442e45b9da5
0	17	17	Plazi	ffb07bec-2d10-492d-9c37-361fe0b79427	efd9c157-9791-48ae-8eb6-1fff2ff1861f
0	2	2	Plazi	ffb07bec-2d10-492d-9c37-361fe0b79427	f028b3c7-5bd1-47da-aad3-10c2e2df0b21
6	6	0	Canada Biodiversity Information Facility	8f83fc96-c966-4126-83f7-bf044dc49efa	f2bd24f9-2d07-42ed-be52-fbf1b52982c1
9014	9014	0	National Biodiversity Network	d897a5b9-35ee-4232-94bd-b0bcaac003c2	f4cbec57-f028-48de-a6d1-405d8a447bb4
6	6	0	Plazi	ffb07bec-2d10-492d-9c37-361fe0b79427	f624810f-eb6f-46d4-83a9-c0e8303b81fc
0	1	1	Plazi	ffb07bec-2d10-492d-9c37-361fe0b79427	f9806da2-d60b-4c06-8043-b5b6a2acd19b
0	1960	1960	Ocean Biodiversity Information System	ba0670b9-4186-41e6-8e70-f9cb3065551a	fb52bfa2-817a-49cd-9ef5-426ac06dc9e4
4	4	0	Plazi	ffb07bec-2d10-492d-9c37-361fe0b79427	fcb40b61-77e8-4d89-bb8a-ad06b7fe4b46
1	1	0	Plazi	ffb07bec-2d10-492d-9c37-361fe0b79427	fce5589e-aabd-46be-8912-dd154636b834
12	12	0	Plazi	ffb07bec-2d10-492d-9c37-361fe0b79427	00ad1537-4dda-475f-8007-991dc1f0eac8
15	15	0	Plazi	ffb07bec-2d10-492d-9c37-361fe0b79427	01816227-cd8c-4f5f-904f-e78a7c90c64c
920	920	0	GBIF Benin	efb9c00e-f802-45dd-8826-a52ec45b89ff	025769ee-df28-40de-bead-69fe1259bbad
0	2	2	Plazi	ffb07bec-2d10-492d-9c37-361fe0b79427	02a67792-77c4-4e89-8efb-98525776bd7e
18	18	0	Plazi	ffb07bec-2d10-492d-9c37-361fe0b79427	03292dc5-d6b1-499b-b737-89fa84ac5de8
94	94	0	Colombian Biodiversity Information System	7e865cba-7c46-417b-ade5-97f2cf5b7be0	0360ffaf-8506-4de8-a392-f1d3d0233b36
0	12	12	Plazi	ffb07bec-2d10-492d-9c37-361fe0b79427	03db00f3-d8c6-4ac6-8efc-9f6d23b10156
331	331	0	Participant Node Managers Committee	7f48e0c8-5c96-49ec-b972-30748e339115	053c9206-c1ed-4777-896e-9936b7758048
43	43	0	Plazi	ffb07bec-2d10-492d-9c37-361fe0b79427	0754157d-d8d3-4076-b8bf-0d932c7dc5ec
110	110	0	Plazi	ffb07bec-2d10-492d-9c37-361fe0b79427	10af4964-439d-4779-8b95-d6f695f6c018
0	820	820	GBIF Ecuador	2dc472f1-c3d9-486d-b3c1-12ca7ba1ed22	112716aa-0f53-483d-9089-fd21494ecb66
14	14	0	Plazi	ffb07bec-2d10-492d-9c37-361fe0b79427	1169bb13-1171-4038-9723-8bda0f93cbd0
17	17	0	Plazi	ffb07bec-2d10-492d-9c37-361fe0b79427	1317c2b5-b6cc-4603-947f-170fa4068fb9
0	3	3	Plazi	ffb07bec-2d10-492d-9c37-361fe0b79427	1363c785-b3e0-4322-9283-a6d272748735
0	169	169	Plazi	ffb07bec-2d10-492d-9c37-361fe0b79427	14903b53-e0b4-4811-a2c8-5b33259d4dac
11	11	0	GBIF Finland	dd514216-5c7c-45f3-910d-797424cb5be6	14ce1096-aca6-4342-b31c-bb7056a00382
0	1	1	Plazi	ffb07bec-2d10-492d-9c37-361fe0b79427	1694bae6-36b6-43dd-b533-b40f545aa291
6977	6977	0	Korean Biodiversity Information Facility	e0a1e772-0177-4800-94b4-2d023fe6cdf4	19120737-4e1e-4efd-87ee-b92fdc5c8576
19336	19336	0	South African Biodiversity Information Facility	7190b835-4e86-4b6e-85c1-19cc6677c250	1b18bab9-abdb-41b4-83c8-368ca2e6d391
34	34	0	GBIF Finland	dd514216-5c7c-45f3-910d-797424cb5be6	1b2b7fb8-f28b-4335-bdb5-bfb431d68729
103	103	0	Plazi	ffb07bec-2d10-492d-9c37-361fe0b79427	1bef571c-e1cb-4103-be88-1bd0c16e6692
1	1	0	Plazi	ffb07bec-2d10-492d-9c37-361fe0b79427	2b629bb4-b2e2-43ba-aff9-2327452d30f6
1	1	0	National Biodiversity Network	d897a5b9-35ee-4232-94bd-b0bcaac003c2	2bdbed37-139a-401d-ba7d-d6064002a5e2
971	971	0	GBIF France	da44cd31-5901-4687-a106-6d1c7734ee3a	2df01b92-5610-4c12-94f3-04bdff43e234
2	2	0	Plazi	ffb07bec-2d10-492d-9c37-361fe0b79427	2e5b0268-f46c-40cf-aa11-e042fe160a53
857	857	0	Netherlands Biodiversity Information Facility	0909d601-bda2-42df-9e63-a6d51847ebce	30ac77b7-9434-4eec-84c3-52b507ee9b8b
399	399	0	Participant Node Managers Committee	7f48e0c8-5c96-49ec-b972-30748e339115	3187332f-77d0-4d34-9840-f26bcdb98a82
3606	3606	0	GBIF Brazil	cdc9736d-5ff7-4ece-9959-3c744360cdb3	3256fc62-d671-434d-8ca0-e6b277f48ce1
455	455	0	GBIF Japan	db5705aa-6a6e-42f1-8942-d77b9f4896ea	33faa86f-70af-4d16-ab3d-838c0da61266
5	5	0	Plazi	ffb07bec-2d10-492d-9c37-361fe0b79427	35f24dee-2f29-470d-9359-f6d509b39837
0	49	49	Ocean Biodiversity Information System	ba0670b9-4186-41e6-8e70-f9cb3065551a	366075de-36c8-4ae9-b483-deb6cab266e3
203	203	0	Colombian Biodiversity Information System	7e865cba-7c46-417b-ade5-97f2cf5b7be0	36ea8aa2-08dc-46c0-a03d-e38fb48df9d6
2385	2385	0	GBIF Norway	4f829580-180d-46a9-9c87-ed8ec959b545	37dddcd2-ed51-4ada-86df-37449162f404
98	98	0	Plazi	ffb07bec-2d10-492d-9c37-361fe0b79427	3c8b5724-cd27-487f-a775-3e48c4013474
0	23	23	Ocean Biodiversity Information System	ba0670b9-4186-41e6-8e70-f9cb3065551a	4312b12b-267c-482c-a826-77eb1ee8aa10
0	13	13	Plazi	ffb07bec-2d10-492d-9c37-361fe0b79427	4518cc4b-27bb-4244-9385-852fa3ba1ea3
2	2	0	Plazi	ffb07bec-2d10-492d-9c37-361fe0b79427	46e205e3-6eed-4022-aa42-f1286069df26
27	27	0	GBIF Germany	4f6826f2-4ff6-443d-b966-e6913bd24013	483ba22f-312f-4c4c-a536-fce29f5a22ed
0	436	436	GBIF Portugal	673f7038-4262-4149-b753-5658a4e912f6	4c7fe8ad-42db-4ebb-a51f-62ceea85989a
1804	1804	0	U.S. Geological Survey	8618c64a-93e0-4300-b546-7249e5148ed2	4da5c45a-54be-4de3-bf51-9d1bbe1f43b6
5	5	0	Plazi	ffb07bec-2d10-492d-9c37-361fe0b79427	4e8156a4-20ef-4643-ae15-89ed6e02f867
724871	724871	0	U.S. Geological Survey	8618c64a-93e0-4300-b546-7249e5148ed2	4ef2bed0-d40f-49c9-bb64-c46a301a5a72
0	167	167	Participant Node Managers Committee	7f48e0c8-5c96-49ec-b972-30748e339115	5147bb2c-6cc0-425d-98a5-d01bb909fd59
1	1	0	Plazi	ffb07bec-2d10-492d-9c37-361fe0b79427	53ba9de0-08ad-4334-a66d-bfaa6a68dd32
91	91	0	National Biodiversity Network	d897a5b9-35ee-4232-94bd-b0bcaac003c2	59e2aba8-3faf-49c1-a5c9-9fbe246c1dd5
642	642	0	GBIF France	da44cd31-5901-4687-a106-6d1c7734ee3a	5b96aeff-50f8-4af9-9ccf-e88201fe1205
79	79	0	GBIF New Zealand	4f9fd726-20dd-445e-89a1-8ed93792276f	5c1606d4-5608-46f0-8bf0-44385cebfbc2
2	2	0	Plazi	ffb07bec-2d10-492d-9c37-361fe0b79427	5f1387e1-51dd-4de1-a833-a3597506912f
0	38	38	Plazi	ffb07bec-2d10-492d-9c37-361fe0b79427	604af154-8d8e-4fa4-8492-44181607a659
0	107635	107635	GBIF Switzerland	169eb292-376b-4cc6-8e31-9c2c432de0ad	62345ff7-1662-45f1-b6fa-daa5c48a0ae2
85	85	0	GBIF Germany	4f6826f2-4ff6-443d-b966-e6913bd24013	62699516-f762-11e1-a439-00145eb45e9a
13	13	0	GBIF Germany	4f6826f2-4ff6-443d-b966-e6913bd24013	630ed8fa-f762-11e1-a439-00145eb45e9a
370	370	0	GBIF Germany	4f6826f2-4ff6-443d-b966-e6913bd24013	631aacbf-2f3d-4247-87d2-2fba6d0e293a
2	2	0	Plazi	ffb07bec-2d10-492d-9c37-361fe0b79427	634ff6ac-9e07-4b5f-952d-21e8033e6baa
69216	69216	0	GBIF Brazil	cdc9736d-5ff7-4ece-9959-3c744360cdb3	63e45351-3595-48df-900e-b9972e5cc264
48	48	0	GBIF Germany	4f6826f2-4ff6-443d-b966-e6913bd24013	64708fe0-f762-11e1-a439-00145eb45e9a
52	52	0	GBIF Germany	4f6826f2-4ff6-443d-b966-e6913bd24013	64b2edfe-f762-11e1-a439-00145eb45e9a
61	60	-1	GBIF Germany	4f6826f2-4ff6-443d-b966-e6913bd24013	6500de60-f762-11e1-a439-00145eb45e9a
8	8	0	Plazi	ffb07bec-2d10-492d-9c37-361fe0b79427	65625ae6-a976-464c-b83a-46fd44874fae
189	189	0	GBIF Germany	4f6826f2-4ff6-443d-b966-e6913bd24013	6638f614-f762-11e1-a439-00145eb45e9a
186	186	0	GBIF Germany	4f6826f2-4ff6-443d-b966-e6913bd24013	66486d92-f762-11e1-a439-00145eb45e9a
49	49	0	GBIF Germany	4f6826f2-4ff6-443d-b966-e6913bd24013	67228c52-f762-11e1-a439-00145eb45e9a
114	114	0	GBIF France	da44cd31-5901-4687-a106-6d1c7734ee3a	679ad77b-f317-4a1a-b26a-bdbc601a7e64
132	132	0	GBIF Germany	4f6826f2-4ff6-443d-b966-e6913bd24013	67de1fd0-f762-11e1-a439-00145eb45e9a
11	11	0	Plazi	ffb07bec-2d10-492d-9c37-361fe0b79427	67fca378-2599-4654-9807-d6899659010a
22	22	0	GBIF France	da44cd31-5901-4687-a106-6d1c7734ee3a	68de352d-2c3f-4822-8734-b74d67721aa6
144	144	0	Participant Node Managers Committee	7f48e0c8-5c96-49ec-b972-30748e339115	6baf50f9-5cc6-4c81-be68-0405da8d1620
5112	5112	0	Colombian Biodiversity Information System	7e865cba-7c46-417b-ade5-97f2cf5b7be0	6bc3865d-62b3-48b8-91be-dd885437df9e
208	208	0	GBIF Germany	4f6826f2-4ff6-443d-b966-e6913bd24013	6c361fd8-f762-11e1-a439-00145eb45e9a
68	68	0	GBIF Germany	4f6826f2-4ff6-443d-b966-e6913bd24013	6cad896a-f762-11e1-a439-00145eb45e9a
1	1	0	Plazi	ffb07bec-2d10-492d-9c37-361fe0b79427	6d5c6a73-5675-46cf-98a4-ece6ddc8e121
34	33	-1	GBIF Germany	4f6826f2-4ff6-443d-b966-e6913bd24013	6f83f868-f762-11e1-a439-00145eb45e9a
1	1	0	Tanzania Biodiversity Information Facility	abd95ca6-3959-4db9-aaa6-2de1aeecf514	71cd955c-f762-11e1-a439-00145eb45e9a
98	89	-9	GBIF Germany	4f6826f2-4ff6-443d-b966-e6913bd24013	7215b90e-f762-11e1-a439-00145eb45e9a
39	39	0	GBIF Japan	db5705aa-6a6e-42f1-8942-d77b9f4896ea	72bcb444-be07-4597-80e1-65c41c72498d
54	54	0	GBIF Germany	4f6826f2-4ff6-443d-b966-e6913bd24013	7425540b-e663-4cc0-abec-536ec1e6d68d
125	125	0	GBIF Germany	4f6826f2-4ff6-443d-b966-e6913bd24013	7433b269-fab2-408d-8fd8-4512eb8e95d7
37	37	0	Plazi	ffb07bec-2d10-492d-9c37-361fe0b79427	74de468c-e89d-4a19-a8aa-e1e5634a753f
499	499	0	GBIF Germany	4f6826f2-4ff6-443d-b966-e6913bd24013	751a6a5a-f762-11e1-a439-00145eb45e9a
375	375	0	GBIF Germany	4f6826f2-4ff6-443d-b966-e6913bd24013	759d1b12-f762-11e1-a439-00145eb45e9a
6	6	0	GBIF Germany	4f6826f2-4ff6-443d-b966-e6913bd24013	75e1d9c8-f762-11e1-a439-00145eb45e9a
272	272	0	GBIF Germany	4f6826f2-4ff6-443d-b966-e6913bd24013	7748be58-f762-11e1-a439-00145eb45e9a
360	360	0	GBIF Germany	4f6826f2-4ff6-443d-b966-e6913bd24013	7861aca0-f762-11e1-a439-00145eb45e9a
769271	655929	-113342	Belgian Biodiversity Platform	fb11cfe1-ebc3-45af-9159-17d9fddbcdac	7888f666-f59e-4534-8478-3a10a3bfee45
65	65	0	GBIF Germany	4f6826f2-4ff6-443d-b966-e6913bd24013	791cd2dc-f762-11e1-a439-00145eb45e9a
3	3	0	GBIF Germany	4f6826f2-4ff6-443d-b966-e6913bd24013	7a8a1904-f762-11e1-a439-00145eb45e9a
300	300	0	Korean Biodiversity Information Facility	e0a1e772-0177-4800-94b4-2d023fe6cdf4	7b05ecdc-f762-11e1-a439-00145eb45e9a
9	9	0	GBIF Germany	4f6826f2-4ff6-443d-b966-e6913bd24013	7bc973be-f762-11e1-a439-00145eb45e9a
0	10	10	Plazi	ffb07bec-2d10-492d-9c37-361fe0b79427	7bf37798-7886-4f3a-a043-d35b52ffaa20
0	960	960	National Biodiversity Network	d897a5b9-35ee-4232-94bd-b0bcaac003c2	7bfd05a1-2e21-48d4-b49f-e338ad524ecf
0	4	4	Plazi	ffb07bec-2d10-492d-9c37-361fe0b79427	7c276a03-e1d4-4340-89fe-dd27f1eaf6e9
2187	1696	-491	GBIF Germany	4f6826f2-4ff6-443d-b966-e6913bd24013	7df1b6b0-f762-11e1-a439-00145eb45e9a
1066	902	-164	GBIF Germany	4f6826f2-4ff6-443d-b966-e6913bd24013	7e80648c-f762-11e1-a439-00145eb45e9a
0	5824	5824	Ocean Biodiversity Information System	ba0670b9-4186-41e6-8e70-f9cb3065551a	7ebcd868-be21-4d78-90c0-ab61bf7ede89
12404	12404	0	Biodiversity Information System of Mexico	b324e8e9-9a4c-44fa-8f1a-7f39ea7ab576	80633a90-f762-11e1-a439-00145eb45e9a
54	54	0	Colombian Biodiversity Information System	7e865cba-7c46-417b-ade5-97f2cf5b7be0	837b26a5-1837-4ad8-9e5a-ce72ac8b000b
23315	23315	0	Ocean Biodiversity Information System	ba0670b9-4186-41e6-8e70-f9cb3065551a	83c964d4-f762-11e1-a439-00145eb45e9a
0	53	53	Participant Node Managers Committee	7f48e0c8-5c96-49ec-b972-30748e339115	840f1504-5a31-429b-a6ae-92485e7f5d7d
3920	3920	0	Colombian Biodiversity Information System	7e865cba-7c46-417b-ade5-97f2cf5b7be0	8469143a-92d1-4434-8d2d-d94520d4a22c
0	120	120	Plazi	ffb07bec-2d10-492d-9c37-361fe0b79427	85ff6002-c514-44a2-997b-aae68c249ba3
232	232	0	Plazi	ffb07bec-2d10-492d-9c37-361fe0b79427	86ce0689-de24-418b-835a-f04f9cc10d45
940	722	-218	GBIF Germany	4f6826f2-4ff6-443d-b966-e6913bd24013	87f62a24-f762-11e1-a439-00145eb45e9a
14	14	0	GBIF Germany	4f6826f2-4ff6-443d-b966-e6913bd24013	88967ed4-f762-11e1-a439-00145eb45e9a
1165	1165	0	GBIF Germany	4f6826f2-4ff6-443d-b966-e6913bd24013	8956518c-f762-11e1-a439-00145eb45e9a
257	257	0	GBIF Germany	4f6826f2-4ff6-443d-b966-e6913bd24013	8991abd8-f762-11e1-a439-00145eb45e9a
495	495	0	Plazi	ffb07bec-2d10-492d-9c37-361fe0b79427	8bee84d8-4a01-4e53-8eb3-af176ce1feb9
30	26	-4	GBIF Germany	4f6826f2-4ff6-443d-b966-e6913bd24013	8c619cec-f762-11e1-a439-00145eb45e9a
0	6	6	Plazi	ffb07bec-2d10-492d-9c37-361fe0b79427	8c7a90dc-a88c-4ae7-9981-9ba0e02b9dce
63	47	-16	GBIF Germany	4f6826f2-4ff6-443d-b966-e6913bd24013	8d11ed5e-f762-11e1-a439-00145eb45e9a
29	29	0	Plazi	ffb07bec-2d10-492d-9c37-361fe0b79427	8d6b5e65-3938-406f-8b69-abe1a76b4f58
75	75	0	Plazi	ffb07bec-2d10-492d-9c37-361fe0b79427	8d92cf24-b58e-41fb-86f2-aa9678af28c6
209	146	-63	GBIF Germany	4f6826f2-4ff6-443d-b966-e6913bd24013	8eb94896-f762-11e1-a439-00145eb45e9a
68	45	-23	GBIF Germany	4f6826f2-4ff6-443d-b966-e6913bd24013	900dfbba-f762-11e1-a439-00145eb45e9a
55	1534	1479	GBIF Germany	4f6826f2-4ff6-443d-b966-e6913bd24013	902a6306-1f1b-4760-8c1a-28d44394155d
170	170	0	GBIF Germany	4f6826f2-4ff6-443d-b966-e6913bd24013	914706d4-f762-11e1-a439-00145eb45e9a
15	9	-6	GBIF Germany	4f6826f2-4ff6-443d-b966-e6913bd24013	934b13f8-f762-11e1-a439-00145eb45e9a
1	1	0	GBIF Germany	4f6826f2-4ff6-443d-b966-e6913bd24013	938fc764-f762-11e1-a439-00145eb45e9a
246	246	0	GBIF Germany	4f6826f2-4ff6-443d-b966-e6913bd24013	9594d9e6-f762-11e1-a439-00145eb45e9a
93	92	-1	GBIF Germany	4f6826f2-4ff6-443d-b966-e6913bd24013	967be548-f762-11e1-a439-00145eb45e9a
70	70	0	GBIF Germany	4f6826f2-4ff6-443d-b966-e6913bd24013	97d4d15c-f762-11e1-a439-00145eb45e9a
3	3	0	Plazi	ffb07bec-2d10-492d-9c37-361fe0b79427	98985225-ac64-4257-ba1a-851b5116d1db
10	10	0	Plazi	ffb07bec-2d10-492d-9c37-361fe0b79427	99c9eb85-21bc-470b-beda-e3f5fd023404
0	37	37	Plazi	ffb07bec-2d10-492d-9c37-361fe0b79427	9e4030d6-1154-422f-bb13-afd31181028f
0	37	37	Plazi	ffb07bec-2d10-492d-9c37-361fe0b79427	a0d8967c-4cec-46d9-a47a-cadebc137be3
0	7	7	Plazi	ffb07bec-2d10-492d-9c37-361fe0b79427	a16d6ae8-5cee-404d-9818-fd7c9b546c0a
22	22	0	Plazi	ffb07bec-2d10-492d-9c37-361fe0b79427	a45c618d-f858-47a5-8c02-2ecfcd64191d
1	1	0	Plazi	ffb07bec-2d10-492d-9c37-361fe0b79427	a82e98e4-bca1-4284-9838-b300b2e19b5d
0	913	913	Plazi	ffb07bec-2d10-492d-9c37-361fe0b79427	a865b1e8-4533-4dfb-815d-cd31a97d34d7
0	48	48	Ocean Biodiversity Information System	ba0670b9-4186-41e6-8e70-f9cb3065551a	a980e1d1-1733-481e-9288-45f106d187a5
408	408	0	GBIF Sweden	a0b3be64-6525-4387-ac67-a499950f92e1	ae4b0b88-b872-483f-8fe3-e441bac3243c
79186	79186	0	GBIF Portugal	673f7038-4262-4149-b753-5658a4e912f6	aec47af5-7214-4b38-a236-eb6e68cdd844
2311	2311	0	GBIF New Zealand	4f9fd726-20dd-445e-89a1-8ed93792276f	b228734a-8952-48cd-94c3-241e06a2e421
46	46	0	Plazi	ffb07bec-2d10-492d-9c37-361fe0b79427	b3fb460f-20b4-4c62-98ea-a07d901bbfc0
116772	116772	0	Chinese Academy of Sciences	e760dc6f-dd68-474d-ab41-bd3588571793	b54a3b16-b648-41ab-bd6f-d3881895daac
2	2	0	Plazi	ffb07bec-2d10-492d-9c37-361fe0b79427	b9efaff4-bbd1-4ec9-8b04-0de36affa967
24694	34727	10033	U.S. Geological Survey	8618c64a-93e0-4300-b546-7249e5148ed2	ba9984d8-d982-4fe6-b81c-a7585790034a
63	63	0	Plazi	ffb07bec-2d10-492d-9c37-361fe0b79427	c1129e00-0019-4411-9efb-a9d6c83fcf9d
6	6	0	Plazi	ffb07bec-2d10-492d-9c37-361fe0b79427	c29e5fec-dd85-4dc0-9582-12e7fd501124
2	2	0	GBIF France	da44cd31-5901-4687-a106-6d1c7734ee3a	c412c815-a6ec-4ed6-9332-23574ecd0730
35	35	0	Plazi	ffb07bec-2d10-492d-9c37-361fe0b79427	c906d9cd-cfcb-43db-a24c-b57b39d9184b
95	95	0	GBIF Germany	4f6826f2-4ff6-443d-b966-e6913bd24013	c963bbdd-72f3-4474-a7d0-cd18336ca724
1916	1916	0	Ghana Biodiversity Information Facility	b5633b75-6a86-4fdf-9cfc-506047fb9dc7	cd67c18a-98e2-4b8b-ad07-358b02b7812c
1655345	1655345	0	Atlas of Living Australia	4a6f1b71-969e-4fc5-a693-282b05e1220c	ce58b7bb-fed6-46b9-9424-135499c7afdf
300	300	0	National Biodiversity Network	d897a5b9-35ee-4232-94bd-b0bcaac003c2	ce97cd46-0b0d-4b98-9ebd-a3ab036f0392
42	42	0	Plazi	ffb07bec-2d10-492d-9c37-361fe0b79427	d08524b6-1aac-443c-b6f3-dad1c62d9473
1	1	0	Plazi	ffb07bec-2d10-492d-9c37-361fe0b79427	d2ec4943-75fe-4de4-8f48-76559d389d95
1	1	0	Plazi	ffb07bec-2d10-492d-9c37-361fe0b79427	d4afa5b0-3309-4a1c-83ba-bd71fa899aa6
157	157	0	Colombian Biodiversity Information System	7e865cba-7c46-417b-ade5-97f2cf5b7be0	d842fe12-004c-4081-8620-c1de000b1e28
72	72	0	Tanzania Biodiversity Information Facility	abd95ca6-3959-4db9-aaa6-2de1aeecf514	dab43f30-58ba-11dd-89f0-b8a03c50a862
440	440	0	GBIF Brazil	cdc9736d-5ff7-4ece-9959-3c744360cdb3	daf616f8-404e-44f8-9967-2895a8c9f633
5658	5658	0	GBIF France	da44cd31-5901-4687-a106-6d1c7734ee3a	dd39faa3-a9c0-45e5-8497-41b40e9a2a67
0	2	2	Plazi	ffb07bec-2d10-492d-9c37-361fe0b79427	ddc7730f-a4ab-49c4-af78-86ab2a21d40b
0	2	2	Plazi	ffb07bec-2d10-492d-9c37-361fe0b79427	dfd148cb-b41f-4529-9759-ff09f0d4b0b8
6238	6238	0	GBIF France	da44cd31-5901-4687-a106-6d1c7734ee3a	e08f0546-0224-4b0d-886d-4ab05f0c87e6
1	1	0	Plazi	ffb07bec-2d10-492d-9c37-361fe0b79427	e0e5dac1-d3c8-4caa-a516-7da54410ae9b
20	20	0	Plazi	ffb07bec-2d10-492d-9c37-361fe0b79427	e1aa7494-63bf-4abd-9117-47f93fafd6bc
1986	1986	0	GBIF France	da44cd31-5901-4687-a106-6d1c7734ee3a	e1d4def9-b584-4792-85fe-89e5ae5db3ac
1	1	0	Plazi	ffb07bec-2d10-492d-9c37-361fe0b79427	e33fdbd9-205b-4974-b178-9c88d254a8af
6	6	0	Plazi	ffb07bec-2d10-492d-9c37-361fe0b79427	e4504732-6d90-4e03-87cd-2c509bece173
157694	155092	-2602	National Biodiversity Network	d897a5b9-35ee-4232-94bd-b0bcaac003c2	e45ea07f-d054-4129-9552-f0c9e6af4019
2326	2326	0	Belgian Biodiversity Platform	fb11cfe1-ebc3-45af-9159-17d9fddbcdac	e544c55b-ead2-4311-8f57-50ab5907d8dc
11	11	0	Plazi	ffb07bec-2d10-492d-9c37-361fe0b79427	e87ff7fb-7b80-4e0c-bdf1-384a2ec7bd25
432	432	0	GBIF France	da44cd31-5901-4687-a106-6d1c7734ee3a	e8e36c69-e3c1-4b15-b1f3-678cc5e096ad
94	94	0	Plazi	ffb07bec-2d10-492d-9c37-361fe0b79427	e96ae80b-2946-4418-8940-07dd60d7728e
100	100	0	National Biodiversity Network	d897a5b9-35ee-4232-94bd-b0bcaac003c2	ea2642d2-1623-491e-b186-d693994b9a2c
4	4	0	Plazi	ffb07bec-2d10-492d-9c37-361fe0b79427	ea95be08-bf84-4549-8c7d-3e3d6d25165e
86	86	0	Ghana Biodiversity Information Facility	b5633b75-6a86-4fdf-9cfc-506047fb9dc7	eb19e3c6-c8b2-4ccf-960c-5db4825f5842
9450	9450	0	Participant Node Managers Committee	7f48e0c8-5c96-49ec-b972-30748e339115	ebc62d60-afa9-4396-9e93-a0354d448b83
0	21	21	Plazi	ffb07bec-2d10-492d-9c37-361fe0b79427	f0b761e8-abaf-4479-a368-8720f627f672
60	60	0	Plazi	ffb07bec-2d10-492d-9c37-361fe0b79427	f19265a9-3645-43eb-8969-529c91ba0338
1	1	0	Plazi	ffb07bec-2d10-492d-9c37-361fe0b79427	f5b3cddd-8711-417a-b2c4-28f65359b7b8
462	399	-63	GBIF Germany	4f6826f2-4ff6-443d-b966-e6913bd24013	f6eb0647-62b3-427b-baf1-e6d7e8fa7aaf
2441	2441	0	National Biodiversity Network	d897a5b9-35ee-4232-94bd-b0bcaac003c2	f6eda3e8-f553-42e1-953f-e84efcf190c1
2699	2699	0	Biodiversity Information System of Mexico	b324e8e9-9a4c-44fa-8f1a-7f39ea7ab576	f892708d-b36d-4635-8a85-3d85a1897396
6	6	0	Plazi	ffb07bec-2d10-492d-9c37-361fe0b79427	f94475ab-499b-43cb-8f68-aa61a90e52bc
1	1	0	Plazi	ffb07bec-2d10-492d-9c37-361fe0b79427	fd87dd96-c51f-4181-969c-791d72a2e990
82	82	0	Plazi	ffb07bec-2d10-492d-9c37-361fe0b79427	fd8ba24f-4d68-431c-81f5-e924906aed5d
19	19	0	Plazi	ffb07bec-2d10-492d-9c37-361fe0b79427	038de93d-841e-4ad0-a59f-0c93b378d502
0	3	3	Plazi	ffb07bec-2d10-492d-9c37-361fe0b79427	0420e2c2-2025-486d-96a2-c661dc998d66
0	10237	10237	Korean Biodiversity Information Facility	e0a1e772-0177-4800-94b4-2d023fe6cdf4	0559bfbc-1619-42f3-8198-8ffb2b12f32d
425	425	0	Colombian Biodiversity Information System	7e865cba-7c46-417b-ade5-97f2cf5b7be0	0768b875-fc9c-4ee5-a91b-298963c1df71
750439	769847	19408	Atlas of Living Australia	4a6f1b71-969e-4fc5-a693-282b05e1220c	07a54454-87c7-4e1e-b2ba-88a9d98d534b
0	15	15	Plazi	ffb07bec-2d10-492d-9c37-361fe0b79427	093acec3-d185-42a5-a896-adae375a706e
106	106	0	GBIF France	da44cd31-5901-4687-a106-6d1c7734ee3a	093d0388-6bcb-4ec9-8254-5e643910537e
92	92	0	Colombian Biodiversity Information System	7e865cba-7c46-417b-ade5-97f2cf5b7be0	0b33678f-0bfa-457c-bec9-d1c219e2ed0a
199	199	0	GBIF France	da44cd31-5901-4687-a106-6d1c7734ee3a	0cb77b1e-369b-4782-8f70-e4218fae462e
0	8	8	Plazi	ffb07bec-2d10-492d-9c37-361fe0b79427	0eea33ca-1f95-4da6-9cee-239291922331
0	36	36	Colombian Biodiversity Information System	7e865cba-7c46-417b-ade5-97f2cf5b7be0	13845f9e-f556-4f62-a9a1-3a60895b58da
18	18	0	Plazi	ffb07bec-2d10-492d-9c37-361fe0b79427	1445ab9f-f210-4f20-9163-ee875a213214
752	752	0	GBIF Germany	4f6826f2-4ff6-443d-b966-e6913bd24013	1453b7e2-b821-45dc-8310-64c5b20b5de9
2	2	0	Plazi	ffb07bec-2d10-492d-9c37-361fe0b79427	204c806b-d1b6-4b76-8c17-ab06ebcdf266
0	3	3	Plazi	ffb07bec-2d10-492d-9c37-361fe0b79427	233fd2f7-aed5-4971-8238-4e68b166dc0b
100	100	0	U.S. Geological Survey	8618c64a-93e0-4300-b546-7249e5148ed2	25f6a909-ec19-4cfa-9133-de8d7917535a
18185	18185	0	GBIF Germany	4f6826f2-4ff6-443d-b966-e6913bd24013	263bbfe7-f643-43bb-b448-f0705d1c0e18
4540366	4738399	198033	Belgian Biodiversity Platform	fb11cfe1-ebc3-45af-9159-17d9fddbcdac	271c444f-f8d8-4986-b748-e7367755c0c1
5456	5456	0	National Biodiversity Network	d897a5b9-35ee-4232-94bd-b0bcaac003c2	29e20ae7-53a6-41f8-bab0-f826d344c360
415	415	0	Colombian Biodiversity Information System	7e865cba-7c46-417b-ade5-97f2cf5b7be0	2b7fa478-bc11-4404-9ab5-93c23bbd9e0b
236	236	0	Plazi	ffb07bec-2d10-492d-9c37-361fe0b79427	2b92b4bd-51dc-4c77-b64c-8e6f65225558
0	65038	65038	GBIF Japan	db5705aa-6a6e-42f1-8942-d77b9f4896ea	2fbd1257-2606-46a8-89db-a30e7a980474
4739	4739	0	National Biodiversity Network	d897a5b9-35ee-4232-94bd-b0bcaac003c2	305c982f-8e6a-46e0-ac95-ecb744711b2f
0	1	1	Plazi	ffb07bec-2d10-492d-9c37-361fe0b79427	31384cd5-a985-4fc0-9a6e-becdfc77e6fa
56	56	0	Plazi	ffb07bec-2d10-492d-9c37-361fe0b79427	345b55b1-b841-487a-91de-70b41266caf0
7	7	0	Plazi	ffb07bec-2d10-492d-9c37-361fe0b79427	363f3d76-f265-4279-bfc9-266bd2616a33
70	70	0	Plazi	ffb07bec-2d10-492d-9c37-361fe0b79427	36f21b7b-0ca4-49ea-8928-07d502a8ee54
272	272	0	Belgian Biodiversity Platform	fb11cfe1-ebc3-45af-9159-17d9fddbcdac	387e98a0-16fa-11df-b5b3-b8a03c50a862
1550	1550	0	GBIF Portugal	673f7038-4262-4149-b753-5658a4e912f6	3c0a3d64-341d-4a13-8e15-3054592789f9
7059	7059	0	Ocean Biodiversity Information System	ba0670b9-4186-41e6-8e70-f9cb3065551a	3c3020b4-6113-43db-b702-94b76aa5ed71
2	2	0	Plazi	ffb07bec-2d10-492d-9c37-361fe0b79427	40effc56-2cc7-40ae-9592-c7baafeccef1
0	199	199	Ocean Biodiversity Information System	ba0670b9-4186-41e6-8e70-f9cb3065551a	41419ee9-ef8d-4f80-8dd3-dc7716c7f82c
106	106	0	GBIF Malawi	2a42e4d7-ad4a-41b3-84c4-de4aa7b74d35	43287d76-0833-4785-9c0f-48b041327c7c
3	3	0	Plazi	ffb07bec-2d10-492d-9c37-361fe0b79427	4378e48e-2229-4c99-9915-007e8ed26407
18770	18770	0	GBIF France	da44cd31-5901-4687-a106-6d1c7734ee3a	43eb9aad-9db1-4691-b1e2-ec57bfbbea22
197	197	0	GBIF France	da44cd31-5901-4687-a106-6d1c7734ee3a	449ae494-44ef-4dc4-b0c8-c1d25ab13c92
0	3	3	Plazi	ffb07bec-2d10-492d-9c37-361fe0b79427	44b0e201-9a8a-4742-a1d0-48fd6ba0c921
5	5	0	Plazi	ffb07bec-2d10-492d-9c37-361fe0b79427	4528d4c4-8cf8-4d04-93d1-40265959ea5d
25	25	0	Participant Node Managers Committee	7f48e0c8-5c96-49ec-b972-30748e339115	45b032fa-620b-4c33-ac85-c72521c0a41e
47473	411382	363909	Netherlands Biodiversity Information Facility	0909d601-bda2-42df-9e63-a6d51847ebce	45f54678-54ac-4468-8aac-bc83722fc768
15	15	0	Plazi	ffb07bec-2d10-492d-9c37-361fe0b79427	477f6617-fd0f-49d5-a82c-09a4f6a7b076
4	4	0	Plazi	ffb07bec-2d10-492d-9c37-361fe0b79427	47a73c12-f159-4bee-a4b6-a7e4b1f6b431
1650	1650	0	Ocean Biodiversity Information System	ba0670b9-4186-41e6-8e70-f9cb3065551a	4bce5a53-c1d9-4e06-a773-cfd18ccd198f
0	89	89	Ocean Biodiversity Information System	ba0670b9-4186-41e6-8e70-f9cb3065551a	4e240ac6-9dfa-4f94-aa85-84b35f90624a
1709	1709	0	National Biodiversity Network	d897a5b9-35ee-4232-94bd-b0bcaac003c2	516ff45f-f873-40af-bb0a-ee400776a0a6
0	6188	6188	GBIF Benin	efb9c00e-f802-45dd-8826-a52ec45b89ff	584803d5-93d5-4f48-8296-75da8659bc59
2620	2620	0	Ocean Biodiversity Information System	ba0670b9-4186-41e6-8e70-f9cb3065551a	5934563f-c28e-408a-9cbb-0b1cfaf9de35
0	2	2	Plazi	ffb07bec-2d10-492d-9c37-361fe0b79427	59ffa8bd-a7cc-4553-8bab-7a2b696751c9
200308	200316	8	U.S. Geological Survey	8618c64a-93e0-4300-b546-7249e5148ed2	5c1fdaf6-4a18-4c5d-a84b-a4ba41f077c9
1	1	0	Plazi	ffb07bec-2d10-492d-9c37-361fe0b79427	5e4d3324-5144-4a0f-99ab-da9806bc1fc7
29	29	0	GBIF France	da44cd31-5901-4687-a106-6d1c7734ee3a	5ee3ab24-e3cd-40b2-8289-cb363785f9e6
103	103	0	National Biodiversity Network	d897a5b9-35ee-4232-94bd-b0bcaac003c2	60920f60-eff7-409d-884b-fba96b3c7fe6
0	11080	11080	Ocean Biodiversity Information System	ba0670b9-4186-41e6-8e70-f9cb3065551a	60a5f026-42a9-4534-a6a2-4f47656f643c
306	306	0	GBIF Germany	4f6826f2-4ff6-443d-b966-e6913bd24013	61c9b3d4-f762-11e1-a439-00145eb45e9a
0	4	4	Plazi	ffb07bec-2d10-492d-9c37-361fe0b79427	61e5b3b5-abd4-406d-af43-37801634ce41
5	5	0	GBIF Germany	4f6826f2-4ff6-443d-b966-e6913bd24013	62d5fd96-f762-11e1-a439-00145eb45e9a
91329	91329	0	GBIF Spain	1f94b3ca-9345-4d65-afe2-4bace93aa0fe	636308c6-f762-11e1-a439-00145eb45e9a
1475	1475	0	Participant Node Managers Committee	7f48e0c8-5c96-49ec-b972-30748e339115	63f758ec-cb11-4292-881c-be3a0d11f93b
76	76	0	GBIF Germany	4f6826f2-4ff6-443d-b966-e6913bd24013	6476088a-f762-11e1-a439-00145eb45e9a
55847	55847	0	GBIF France	da44cd31-5901-4687-a106-6d1c7734ee3a	662a5899-42ba-4ca3-b075-c51d45516ba1
135	135	0	GBIF Germany	4f6826f2-4ff6-443d-b966-e6913bd24013	672b2ce0-f762-11e1-a439-00145eb45e9a
145	145	0	GBIF Germany	4f6826f2-4ff6-443d-b966-e6913bd24013	6761761a-f762-11e1-a439-00145eb45e9a
171	171	0	GBIF Germany	4f6826f2-4ff6-443d-b966-e6913bd24013	67e36832-f762-11e1-a439-00145eb45e9a
2	2	0	GBIF Germany	4f6826f2-4ff6-443d-b966-e6913bd24013	68cd5280-f762-11e1-a439-00145eb45e9a
58	58	0	GBIF Germany	4f6826f2-4ff6-443d-b966-e6913bd24013	69b2c9dc-f762-11e1-a439-00145eb45e9a
215	215	0	GBIF Germany	4f6826f2-4ff6-443d-b966-e6913bd24013	69f079f8-f762-11e1-a439-00145eb45e9a
1313	1313	0	GBIF Germany	4f6826f2-4ff6-443d-b966-e6913bd24013	6a2750f4-f762-11e1-a439-00145eb45e9a
368	368	0	GBIF Germany	4f6826f2-4ff6-443d-b966-e6913bd24013	6a66498a-f762-11e1-a439-00145eb45e9a
61	61	0	Participant Node Managers Committee	7f48e0c8-5c96-49ec-b972-30748e339115	6a6ba4bc-194e-47e0-a5d0-00d83b57109d
4000	8000	4000	GBIF Japan	db5705aa-6a6e-42f1-8942-d77b9f4896ea	6a9821e5-2442-4b93-a040-152aecf95d83
15	15	0	GBIF Germany	4f6826f2-4ff6-443d-b966-e6913bd24013	6b3438ae-f762-11e1-a439-00145eb45e9a
11	11	0	Plazi	ffb07bec-2d10-492d-9c37-361fe0b79427	6b9d550d-7128-4552-a573-61de5ff683c1
0	11	11	Participant Node Managers Committee	7f48e0c8-5c96-49ec-b972-30748e339115	6d0e6d3d-4e05-402f-8116-a6a2e93b3532
4	4	0	GBIF Germany	4f6826f2-4ff6-443d-b966-e6913bd24013	6f94492a-f762-11e1-a439-00145eb45e9a
148	148	0	GBIF Germany	4f6826f2-4ff6-443d-b966-e6913bd24013	718e47da-f762-11e1-a439-00145eb45e9a
41	41	0	Plazi	ffb07bec-2d10-492d-9c37-361fe0b79427	73ea530b-1a79-4692-96fd-05c2754864ac
600	600	0	GBIF Germany	4f6826f2-4ff6-443d-b966-e6913bd24013	74996702-f762-11e1-a439-00145eb45e9a
263	263	0	GBIF Germany	4f6826f2-4ff6-443d-b966-e6913bd24013	752e6fa0-f762-11e1-a439-00145eb45e9a
31	31	0	GBIF Germany	4f6826f2-4ff6-443d-b966-e6913bd24013	7562b68e-f762-11e1-a439-00145eb45e9a
0	7	7	Plazi	ffb07bec-2d10-492d-9c37-361fe0b79427	76aefc88-e6f0-403e-9917-80d94974c8cd
1	1	0	Plazi	ffb07bec-2d10-492d-9c37-361fe0b79427	7a4d11d0-f4de-453e-8457-49ae72b545d7
77	77	0	GBIF Finland	dd514216-5c7c-45f3-910d-797424cb5be6	7b8ef914-da91-4ea9-a974-57a03144c7f7
659	659	0	GBIF Germany	4f6826f2-4ff6-443d-b966-e6913bd24013	7d0642c0-f762-11e1-a439-00145eb45e9a
789	789	0	GBIF Germany	4f6826f2-4ff6-443d-b966-e6913bd24013	7d77023a-f762-11e1-a439-00145eb45e9a
577	577	0	GBIF Germany	4f6826f2-4ff6-443d-b966-e6913bd24013	7dc2bc66-f762-11e1-a439-00145eb45e9a
8	8	0	GBIF Germany	4f6826f2-4ff6-443d-b966-e6913bd24013	7df09334-1387-11e2-bb2e-00145eb45e9a
69	61	-8	GBIF Germany	4f6826f2-4ff6-443d-b966-e6913bd24013	7e84bfc8-f762-11e1-a439-00145eb45e9a
476	108	-368	Biodiversity Information System of Mexico	b324e8e9-9a4c-44fa-8f1a-7f39ea7ab576	7ff33858-f762-11e1-a439-00145eb45e9a
27	27	0	GBIF Germany	4f6826f2-4ff6-443d-b966-e6913bd24013	8014082f-20c9-451d-9d1e-1f8bc02560ac
79	79	0	GBIF Norway	4f829580-180d-46a9-9c87-ed8ec959b545	804eb748-b92a-4017-9c2a-92995328b4e8
117	117	0	GBIF Spain	1f94b3ca-9345-4d65-afe2-4bace93aa0fe	81119a40-f762-11e1-a439-00145eb45e9a
116106	123705	7599	GBIF Estonia	2c11b821-d22b-4c64-8cd3-c1578173b129	8130e5c6-f762-11e1-a439-00145eb45e9a
7	6	-1	Plazi	ffb07bec-2d10-492d-9c37-361fe0b79427	81916ce2-72cd-41a4-ab77-90301f5a88f8
39	39	0	Plazi	ffb07bec-2d10-492d-9c37-361fe0b79427	819b234f-6385-4412-a51b-d7a82f490ac4
343	317	-26	GBIF Germany	4f6826f2-4ff6-443d-b966-e6913bd24013	82100bf2-f762-11e1-a439-00145eb45e9a
0	15	15	Participant Node Managers Committee	7f48e0c8-5c96-49ec-b972-30748e339115	82ae5cdc-bcd6-4a17-b789-86a748c3d646
17369	17369	0	GBIF Germany	4f6826f2-4ff6-443d-b966-e6913bd24013	82b9101c-f762-11e1-a439-00145eb45e9a
5205	5205	0	Polish Biodiversity Information Network	2618bfdf-e194-4911-a241-80db3107bc51	82d66fc2-f762-11e1-a439-00145eb45e9a
510	510	0	Canada Biodiversity Information Facility	8f83fc96-c966-4126-83f7-bf044dc49efa	8469ab38-f762-11e1-a439-00145eb45e9a
180013	180013	0	Ocean Biodiversity Information System	ba0670b9-4186-41e6-8e70-f9cb3065551a	84b72ee4-f762-11e1-a439-00145eb45e9a
14	14	0	Plazi	ffb07bec-2d10-492d-9c37-361fe0b79427	864e2b8d-c2da-4a20-9fbf-02bcb20be24a
24	24	0	DanBIF - Danish Biodiversity Information Facility	4ddd294f-02b7-4359-ac33-0806a9ca9c6b	86523cda-f762-11e1-a439-00145eb45e9a
91	91	0	GBIF Portugal	673f7038-4262-4149-b753-5658a4e912f6	8918109e-0d4a-4cc9-af7b-8e49d31df942
172	172	0	GBIF Germany	4f6826f2-4ff6-443d-b966-e6913bd24013	89c0ef1a-f762-11e1-a439-00145eb45e9a
224	224	0	GBIF Germany	4f6826f2-4ff6-443d-b966-e6913bd24013	8a92c8dc-f762-11e1-a439-00145eb45e9a
46	27	-19	GBIF Germany	4f6826f2-4ff6-443d-b966-e6913bd24013	8dc04bc4-f762-11e1-a439-00145eb45e9a
32	13	-19	GBIF Germany	4f6826f2-4ff6-443d-b966-e6913bd24013	8dd2cff6-f762-11e1-a439-00145eb45e9a
0	1	1	Plazi	ffb07bec-2d10-492d-9c37-361fe0b79427	8f347dae-b3e0-4e22-9289-c75434145a92
25	25	0	GBIF Germany	4f6826f2-4ff6-443d-b966-e6913bd24013	8f45d23e-f762-11e1-a439-00145eb45e9a
356	335	-21	GBIF Germany	4f6826f2-4ff6-443d-b966-e6913bd24013	8f5750ea-f762-11e1-a439-00145eb45e9a
102	74	-28	GBIF Germany	4f6826f2-4ff6-443d-b966-e6913bd24013	8f8c3472-f762-11e1-a439-00145eb45e9a
93712	93712	0	GBIF Sweden	a0b3be64-6525-4387-ac67-a499950f92e1	905daf20-04fd-11df-8c28-b8a03c50a862
16	9	-7	GBIF Germany	4f6826f2-4ff6-443d-b966-e6913bd24013	90865614-f762-11e1-a439-00145eb45e9a
43	29	-14	GBIF Germany	4f6826f2-4ff6-443d-b966-e6913bd24013	917520aa-f762-11e1-a439-00145eb45e9a
236	236	0	GBIF France	da44cd31-5901-4687-a106-6d1c7734ee3a	91e89adf-a9e2-4385-a3c4-f16a3fcf264f
752	752	0	GBIF Germany	4f6826f2-4ff6-443d-b966-e6913bd24013	93258b9c-f762-11e1-a439-00145eb45e9a
2056	1825	-231	GBIF Germany	4f6826f2-4ff6-443d-b966-e6913bd24013	954414b6-f762-11e1-a439-00145eb45e9a
796	796	0	GBIF Germany	4f6826f2-4ff6-443d-b966-e6913bd24013	956799d6-f762-11e1-a439-00145eb45e9a
89	89	0	National Biodiversity Data Centre	422b00b2-6c94-4bb6-976b-c359916efdb8	97a77ea0-c7b8-11de-b279-a451a75750a2
43	43	0	GBIF France	da44cd31-5901-4687-a106-6d1c7734ee3a	992fde0f-851f-46e3-9e9c-9f6d9b812b76
12	12	0	Plazi	ffb07bec-2d10-492d-9c37-361fe0b79427	9a3b8011-ac75-4365-9e69-05874a351e61
8	8	0	Plazi	ffb07bec-2d10-492d-9c37-361fe0b79427	9a69324f-0dfb-463a-a399-070b030037af
606	606	0	Belgian Biodiversity Platform	fb11cfe1-ebc3-45af-9159-17d9fddbcdac	9ee09033-8aab-4813-8c2b-db6d54d9817b
0	66	66	Plazi	ffb07bec-2d10-492d-9c37-361fe0b79427	9ef846db-1215-46f8-aa03-829a63e02f53
3935	3935	0	National Biodiversity Network	d897a5b9-35ee-4232-94bd-b0bcaac003c2	a06441d0-52e5-45ba-a6d3-396dc38cc47c
0	2	2	Plazi	ffb07bec-2d10-492d-9c37-361fe0b79427	a095aab7-4968-41d7-a21d-a1eedf11f8c0
93801	94946	1145	GBIF Brazil	cdc9736d-5ff7-4ece-9959-3c744360cdb3	a51fa32f-831d-49d6-8b8a-c7b52ae65b3b
2	2	0	Participant Node Managers Committee	7f48e0c8-5c96-49ec-b972-30748e339115	a9177c1c-7d49-4bd3-b323-9a4b0c9494e6
20084	20084	0	GBIF Argentina	2426a871-9feb-40a1-96c6-0c593a76b835	ab61ad8f-953f-4c7c-80b2-e1fb50fd8187
0	4	4	Plazi	ffb07bec-2d10-492d-9c37-361fe0b79427	b121937a-8d53-4315-a3aa-18cd2d44dac8
7	7	0	Plazi	ffb07bec-2d10-492d-9c37-361fe0b79427	b4dd274b-044e-4c5c-b51b-e7b45af064bb
61	284	223	GBIF Norway	4f829580-180d-46a9-9c87-ed8ec959b545	b5390d05-5699-4c46-a8a4-1b12aa2aac5b
1	1	0	Plazi	ffb07bec-2d10-492d-9c37-361fe0b79427	b5947b0a-22ce-44ee-b7cb-c7efb9ec4301
14	14	0	Plazi	ffb07bec-2d10-492d-9c37-361fe0b79427	b68120bc-52ea-4eff-bc48-a0631512e1cd
3	3	0	Plazi	ffb07bec-2d10-492d-9c37-361fe0b79427	b9d558ba-c967-4d3f-96fc-0714d2e9869b
0	364	364	Ocean Biodiversity Information System	ba0670b9-4186-41e6-8e70-f9cb3065551a	ba8d2e09-f6cb-49db-aaa5-bd38c38ddc8c
1	1	0	Plazi	ffb07bec-2d10-492d-9c37-361fe0b79427	ba92b30a-e7cd-4faf-821b-4db96fc6d054
4821	4821	0	GBIF France	da44cd31-5901-4687-a106-6d1c7734ee3a	c249ca5e-ef81-4687-a6fb-80520a048293
428	428	0	GBIF France	da44cd31-5901-4687-a106-6d1c7734ee3a	c2c48578-dc0c-4125-a6da-1f18f42caf9d
0	349	349	GBIF Portugal	673f7038-4262-4149-b753-5658a4e912f6	c36b11e3-8fd3-435d-84aa-bdd3a780bcac
134	134	0	Plazi	ffb07bec-2d10-492d-9c37-361fe0b79427	c5cf0da1-13e3-4bf4-844c-9b5a9d4f6d5b
25	25	0	Plazi	ffb07bec-2d10-492d-9c37-361fe0b79427	c9530452-3087-42e5-98e2-22b314d6380f
0	1389	1389	GBIF Norway	4f829580-180d-46a9-9c87-ed8ec959b545	c9acbca5-075b-45bf-bbbc-71736683983a
5649	5649	0	U.S. Geological Survey	8618c64a-93e0-4300-b546-7249e5148ed2	cc09f619-bd73-4e5d-8e4d-95e994f87246
2	2	0	Plazi	ffb07bec-2d10-492d-9c37-361fe0b79427	cfd8ff1f-9f4c-40c1-84d7-9c5dd52912ec
1856	1856	0	GBIF France	da44cd31-5901-4687-a106-6d1c7734ee3a	d08ea09c-6403-4a2f-bd63-c6906bec5e50
0	18	18	Plazi	ffb07bec-2d10-492d-9c37-361fe0b79427	d1796c95-98bf-4e35-a881-6179e2d9a2cc
126	126	0	Participant Node Managers Committee	7f48e0c8-5c96-49ec-b972-30748e339115	d1c7d4a8-8494-427d-a3d7-c2ac3251635c
0	12	12	Plazi	ffb07bec-2d10-492d-9c37-361fe0b79427	d4d6dd9c-1906-4d04-9299-7dbbb5eacf11
35	35	0	Plazi	ffb07bec-2d10-492d-9c37-361fe0b79427	d55c3fa0-0734-4c41-9557-779dd3cc5ae1
10	10	0	Plazi	ffb07bec-2d10-492d-9c37-361fe0b79427	d688d9bc-ea31-4e99-9dcb-e65416752eed
37135	37135	0	National Biodiversity Network	d897a5b9-35ee-4232-94bd-b0bcaac003c2	da7627ca-3a28-4792-a015-3b23f5babe52
111	111	0	Colombian Biodiversity Information System	7e865cba-7c46-417b-ade5-97f2cf5b7be0	db24f597-07b4-4721-92cd-7edbfd34d7f7
0	43	43	Plazi	ffb07bec-2d10-492d-9c37-361fe0b79427	dc31f2a4-e078-435e-a047-4bf2dca2111a
0	235	235	Colombian Biodiversity Information System	7e865cba-7c46-417b-ade5-97f2cf5b7be0	dc52e717-53a2-477d-bce6-c3feb76b2634
9	9	0	Plazi	ffb07bec-2d10-492d-9c37-361fe0b79427	ddba4686-218a-415c-b37f-0509435a8d52
1672	1672	0	GBIF Japan	db5705aa-6a6e-42f1-8942-d77b9f4896ea	ddd87e59-4457-4f8b-950a-0a42c7ae5226
178	178	0	GBIF France	da44cd31-5901-4687-a106-6d1c7734ee3a	ddfc1cc6-69ae-400c-ab97-7898dc84d31c
1183	1183	0	GBIF Germany	4f6826f2-4ff6-443d-b966-e6913bd24013	e39455da-c81b-4f82-9f92-3d78049cd264
21	21	0	Plazi	ffb07bec-2d10-492d-9c37-361fe0b79427	e5261c36-de54-4d78-a7b9-d7074a714514
3	3	0	Plazi	ffb07bec-2d10-492d-9c37-361fe0b79427	e5c05ca4-0707-4426-b5a5-e2f950de386e
186	186	0	GBIF Argentina	2426a871-9feb-40a1-96c6-0c593a76b835	e90b1513-504d-41d6-94f7-52743fdabe0b
6	6	0	Plazi	ffb07bec-2d10-492d-9c37-361fe0b79427	ed35d9a8-8d9f-4c2a-a43e-cd1f5ca7e064
0	19	19	Plazi	ffb07bec-2d10-492d-9c37-361fe0b79427	ee8e66ff-2f2c-47e2-978b-be52996d5b0f
40	40	0	GBIF Germany	4f6826f2-4ff6-443d-b966-e6913bd24013	eecc6fc3-99db-47d5-8cca-cfa983ae3598
0	15	15	Plazi	ffb07bec-2d10-492d-9c37-361fe0b79427	ef7c103d-43ea-4929-8ceb-401a3053d901
15	15	0	Secretariat of the Pacific Regional Environment Programme	29c6a139-ea7f-41f5-8d9b-c55af8736182	efd8e007-c9ae-4a60-abfc-060c2d760821
0	2	2	Ocean Biodiversity Information System	ba0670b9-4186-41e6-8e70-f9cb3065551a	f205978d-a7e6-424b-8122-45115c717690
1	1	0	Plazi	ffb07bec-2d10-492d-9c37-361fe0b79427	f248e89f-ca42-421b-aab5-334a2281af89
5	5	0	Plazi	ffb07bec-2d10-492d-9c37-361fe0b79427	f26e889e-9471-402c-808a-883f6ba3e6c8
325	325	0	Plazi	ffb07bec-2d10-492d-9c37-361fe0b79427	f2ad3cb1-0bad-4be1-9e36-2170a6a08aaf
59995	59995	0	GBIF France	da44cd31-5901-4687-a106-6d1c7734ee3a	f2e0d85b-8f0e-4045-b97e-66e5a837696c
960	960	0	GBIF Germany	4f6826f2-4ff6-443d-b966-e6913bd24013	f445e1e2-e964-443e-82f9-56ac957abd23
122	122	0	Plazi	ffb07bec-2d10-492d-9c37-361fe0b79427	f7a0ae29-1590-4ad1-84a3-0acb2453092e
2	2	0	Plazi	ffb07bec-2d10-492d-9c37-361fe0b79427	f7bbfdb8-89b8-4468-8abc-0b704e82d0eb
0	3	3	Plazi	ffb07bec-2d10-492d-9c37-361fe0b79427	f8365c16-4cea-4ef4-b0e0-67131847f714
0	6	6	Plazi	ffb07bec-2d10-492d-9c37-361fe0b79427	f84b77cc-13b7-4251-8ef9-7c74e749a351
0	4	4	Plazi	ffb07bec-2d10-492d-9c37-361fe0b79427	f8dd6cb5-25a6-4ef3-8de6-3fd63ec9f098
7	7	0	Plazi	ffb07bec-2d10-492d-9c37-361fe0b79427	f996956f-8b23-4b0d-b24c-01cec1f335db
0	581	581	Colombian Biodiversity Information System	7e865cba-7c46-417b-ade5-97f2cf5b7be0	fbba90a5-dde1-4411-8d07-c88094279815
0	2	2	Ocean Biodiversity Information System	ba0670b9-4186-41e6-8e70-f9cb3065551a	fd9b375d-f0b3-42e7-8edb-7e08f299ad59
1186	1186	0	Colombian Biodiversity Information System	7e865cba-7c46-417b-ade5-97f2cf5b7be0	fdbbb939-ee0b-4c6e-8eb3-15ed92177306
5549	5549	0	Korean Biodiversity Information Facility	e0a1e772-0177-4800-94b4-2d023fe6cdf4	014f4ebe-c9f3-40dc-beb1-45f4e365dbd2
2812	518	-2294	GBIF Germany	4f6826f2-4ff6-443d-b966-e6913bd24013	027f2ec1-07a5-4a2c-9965-190932fb7868
0	58	58	Plazi	ffb07bec-2d10-492d-9c37-361fe0b79427	03cdf81b-341b-41ab-bce4-ad99c6d84c4f
0	1815	1815	Biodiversity Information System of Mexico	b324e8e9-9a4c-44fa-8f1a-7f39ea7ab576	067d2431-e946-439f-86ea-1faa86ba3fe3
77	77	0	Plazi	ffb07bec-2d10-492d-9c37-361fe0b79427	0a8cd841-1a6b-47f8-ac93-b62501254189
22	22	0	Plazi	ffb07bec-2d10-492d-9c37-361fe0b79427	0e9d9c2b-c867-4538-8dc9-8e4622fdbcdf
2	2	0	Plazi	ffb07bec-2d10-492d-9c37-361fe0b79427	1126ca50-610b-42ba-96e1-2b02949d6dba
366	366	0	Atlas of Living Australia	4a6f1b71-969e-4fc5-a693-282b05e1220c	118796ad-498c-41fc-a8c1-eb4bec1006ba
1683	1683	0	GBIF France	da44cd31-5901-4687-a106-6d1c7734ee3a	11c9d55c-957f-4a6a-8323-d003f82956a2
18	18	0	Plazi	ffb07bec-2d10-492d-9c37-361fe0b79427	1204a022-65db-4386-a024-3eb4aebf6b35
81745	81745	0	Biodiversity Information System of Mexico	b324e8e9-9a4c-44fa-8f1a-7f39ea7ab576	13b81e69-7c05-42ad-89e7-04bfdb21e707
11	11	0	Plazi	ffb07bec-2d10-492d-9c37-361fe0b79427	149cb8b5-9f53-4117-95c9-1f8d16c5b625
0	30	30	Ocean Biodiversity Information System	ba0670b9-4186-41e6-8e70-f9cb3065551a	178869e4-2ef9-403d-9d29-3a443e85b181
8	8	0	Plazi	ffb07bec-2d10-492d-9c37-361fe0b79427	17cc3e70-8dcf-4c8b-8059-a5df17610afb
4361	4361	0	GBIF France	da44cd31-5901-4687-a106-6d1c7734ee3a	18ce0004-0301-4b4b-86f2-9144000226c3
18	18	0	Plazi	ffb07bec-2d10-492d-9c37-361fe0b79427	1a395b3c-4d5d-4b3b-b6e1-2e03784b3fcc
77586	79632	2046	GBIF Spain	1f94b3ca-9345-4d65-afe2-4bace93aa0fe	1c334170-7ed1-11df-8c4a-0800200c9a66
66	66	0	GBIF Spain	1f94b3ca-9345-4d65-afe2-4bace93aa0fe	201259b6-74ab-45c1-b723-78fe4fb81e5d
1	1	0	GBIF France	da44cd31-5901-4687-a106-6d1c7734ee3a	212d6efa-3809-4a8d-a3da-c005e60349c9
1	1	0	Plazi	ffb07bec-2d10-492d-9c37-361fe0b79427	22ea29f7-981d-4151-aea9-4368dd306c09
0	1	1	Plazi	ffb07bec-2d10-492d-9c37-361fe0b79427	2aac38fd-671d-4805-b487-1b90486e31bb
16	16	0	Plazi	ffb07bec-2d10-492d-9c37-361fe0b79427	2b586be0-301e-4337-90ca-f02d8ed3b1e6
0	1824	1824	Ocean Biodiversity Information System	ba0670b9-4186-41e6-8e70-f9cb3065551a	2d0b9e5f-0aa5-44e0-8fe0-1fee2c3e5a23
0	22	22	Plazi	ffb07bec-2d10-492d-9c37-361fe0b79427	2dab8ae0-06e3-4e51-87e0-4c00922b0766
1087	1087	0	National Biodiversity Network	d897a5b9-35ee-4232-94bd-b0bcaac003c2	2f17fba4-4915-47cc-9045-f8c7c8ea181e
0	1	1	Plazi	ffb07bec-2d10-492d-9c37-361fe0b79427	2fdfde54-54bc-457a-a55e-ddb575a3240f
52	52	0	Plazi	ffb07bec-2d10-492d-9c37-361fe0b79427	3071d3d1-dc4a-4ae5-813c-67b6774ee74b
0	17484	17484	Atlas of Living Australia	4a6f1b71-969e-4fc5-a693-282b05e1220c	354bd015-cfb1-42ac-8416-5c84f6e819e2
4544	4544	0	Atlas of Living Australia	4a6f1b71-969e-4fc5-a693-282b05e1220c	368caf55-2fda-4005-aa53-6a4a1c9f6465
35	35	0	Plazi	ffb07bec-2d10-492d-9c37-361fe0b79427	36afc129-759b-4054-a708-6d42a813d155
4	4	0	Plazi	ffb07bec-2d10-492d-9c37-361fe0b79427	36ff223c-c571-4a0c-a937-4c0ac32fb5b5
0	166	166	Plazi	ffb07bec-2d10-492d-9c37-361fe0b79427	3b4aca20-a36d-4230-a1a4-64818bded252
2412	2412	0	U.S. Geological Survey	8618c64a-93e0-4300-b546-7249e5148ed2	3c001217-eea8-4f59-8b28-885699f8cd6c
12	12	0	Plazi	ffb07bec-2d10-492d-9c37-361fe0b79427	3c1c0bd6-6689-4b6a-9eba-6eb9fcccb870
86	86	0	GBIF France	da44cd31-5901-4687-a106-6d1c7734ee3a	3c6774e1-83c0-4cd8-b1f8-86d0867a9463
5	5	0	Plazi	ffb07bec-2d10-492d-9c37-361fe0b79427	3d9c7c7e-1cb9-4035-bc5a-5e26e2108d02
148	124	-24	GBIF Germany	4f6826f2-4ff6-443d-b966-e6913bd24013	416431a6-1589-42ba-97b1-963f5a45585f
65	65	0	GBIF Sweden	a0b3be64-6525-4387-ac67-a499950f92e1	46c0278b-b6fb-4b6e-aa26-107f29da25d6
54918	54918	0	Participant Node Managers Committee	7f48e0c8-5c96-49ec-b972-30748e339115	488416a3-50f1-43a0-a1ce-daf1cdbf84dd
272	272	0	Biodiversity Information System of Mexico	b324e8e9-9a4c-44fa-8f1a-7f39ea7ab576	4d6522d2-3188-4d4e-af7a-c70c002076e4
5	5	0	Plazi	ffb07bec-2d10-492d-9c37-361fe0b79427	4eed1c79-edcb-4a6c-81ae-feeb8cc10ba3
353	353	0	GBIF France	da44cd31-5901-4687-a106-6d1c7734ee3a	4f99dd61-b6ce-4da3-a164-08f97ec89ebf
13504	13504	0	Netherlands Biodiversity Information Facility	0909d601-bda2-42df-9e63-a6d51847ebce	530febaa-b914-416c-b3bf-f49a1dd821f0
0	154	154	Plazi	ffb07bec-2d10-492d-9c37-361fe0b79427	5444e27e-3e2a-429b-931b-823a2086e3c5
701	682	-19	Biodiversity Information System of Mexico	b324e8e9-9a4c-44fa-8f1a-7f39ea7ab576	54b9569e-94b0-4da2-88f4-fa5baae7445c
3	3	0	Plazi	ffb07bec-2d10-492d-9c37-361fe0b79427	5550d635-7aac-4fa9-b521-b4c8a166f6eb
1	1	0	Plazi	ffb07bec-2d10-492d-9c37-361fe0b79427	5585bd88-5225-4b01-937a-7545143bece2
9	9	0	Plazi	ffb07bec-2d10-492d-9c37-361fe0b79427	58c8ea16-8534-406d-942b-fc45d469139d
26	26	0	Plazi	ffb07bec-2d10-492d-9c37-361fe0b79427	58d31bf6-f0f2-49f0-a076-07c256db65d5
10736	11108	372	GBIF Brazil	cdc9736d-5ff7-4ece-9959-3c744360cdb3	5c48df96-034b-40f2-837e-077ed82dfd6b
4	4	0	Plazi	ffb07bec-2d10-492d-9c37-361fe0b79427	5d0e6c32-2326-4b5e-9a3b-45b10ac69e4a
0	4	4	Plazi	ffb07bec-2d10-492d-9c37-361fe0b79427	5ee6dad2-6170-4ba6-bc00-6bd14e6c1f21
70	70	0	GBIF Germany	4f6826f2-4ff6-443d-b966-e6913bd24013	61534758-f762-11e1-a439-00145eb45e9a
6	6	0	Plazi	ffb07bec-2d10-492d-9c37-361fe0b79427	62b3abe6-7168-4719-8dc7-71d4a132a5a5
64	64	0	Plazi	ffb07bec-2d10-492d-9c37-361fe0b79427	634e23da-84c4-46a4-8bb8-94fcf1637160
102	102	0	GBIF Germany	4f6826f2-4ff6-443d-b966-e6913bd24013	63c94474-f762-11e1-a439-00145eb45e9a
2	2	0	Plazi	ffb07bec-2d10-492d-9c37-361fe0b79427	640801bb-3429-4b7a-8e70-c00a07da66cd
11	11	0	Plazi	ffb07bec-2d10-492d-9c37-361fe0b79427	649e6ec7-5c86-4403-9956-1054769aaa9c
77865	77865	0	U.S. Geological Survey	8618c64a-93e0-4300-b546-7249e5148ed2	6595e04b-13d2-4eac-933f-73786627b5a2
38324	38648	324	GBIF France	da44cd31-5901-4687-a106-6d1c7734ee3a	66f6192f-6cc0-45fd-a2d1-e76f5ae3eab2
6989	6989	0	Colombian Biodiversity Information System	7e865cba-7c46-417b-ade5-97f2cf5b7be0	67d3bce7-cf89-49d4-bacb-4e5c32bd8eca
269	151	-118	GBIF Germany	4f6826f2-4ff6-443d-b966-e6913bd24013	68d60e0c-f762-11e1-a439-00145eb45e9a
719	719	0	GBIF France	da44cd31-5901-4687-a106-6d1c7734ee3a	68f165b5-9403-4992-be43-59da399a764d
531	531	0	GBIF Germany	4f6826f2-4ff6-443d-b966-e6913bd24013	6a636a08-f762-11e1-a439-00145eb45e9a
2	2	0	GBIF Germany	4f6826f2-4ff6-443d-b966-e6913bd24013	6ae5befe-f762-11e1-a439-00145eb45e9a
50	50	0	Plazi	ffb07bec-2d10-492d-9c37-361fe0b79427	6b201dfe-5a6c-4f3d-a08b-d149b0595eaf
0	1901	1901	Participant Node Managers Committee	7f48e0c8-5c96-49ec-b972-30748e339115	6b5003f4-5ede-4dae-becb-c3c9094cd57d
12	12	0	GBIF Germany	4f6826f2-4ff6-443d-b966-e6913bd24013	6bd478d2-f762-11e1-a439-00145eb45e9a
322	322	0	GBIF Germany	4f6826f2-4ff6-443d-b966-e6913bd24013	6c0ea4b2-f762-11e1-a439-00145eb45e9a
52	52	0	Plazi	ffb07bec-2d10-492d-9c37-361fe0b79427	6c479acc-8b18-4f0b-a6e5-85bcd6d7b6b7
21	21	0	Plazi	ffb07bec-2d10-492d-9c37-361fe0b79427	6e2e251a-000f-45b5-9b55-1b1a3b8e3f89
150014	150014	0	National Biodiversity Network	d897a5b9-35ee-4232-94bd-b0bcaac003c2	71577ce3-32ea-4cf7-8046-b8ed4e098ffc
130	130	0	GBIF Germany	4f6826f2-4ff6-443d-b966-e6913bd24013	7174ee16-f762-11e1-a439-00145eb45e9a
19	16	-3	GBIF Germany	4f6826f2-4ff6-443d-b966-e6913bd24013	7227aab0-f762-11e1-a439-00145eb45e9a
15	15	0	GBIF Germany	4f6826f2-4ff6-443d-b966-e6913bd24013	73a4ca6c-f762-11e1-a439-00145eb45e9a
10	10	0	GBIF Germany	4f6826f2-4ff6-443d-b966-e6913bd24013	73b00486-f762-11e1-a439-00145eb45e9a
40	40	0	GBIF Germany	4f6826f2-4ff6-443d-b966-e6913bd24013	756cb01c-f762-11e1-a439-00145eb45e9a
0	4	4	Plazi	ffb07bec-2d10-492d-9c37-361fe0b79427	7595ffe3-ed56-47f1-8885-810cfc481cc9
57245	57245	0	Taiwan Biodiversity Information Facility	e1b85abc-61f9-430f-ba79-6813dec53a0f	76819780-989f-11de-b4d9-b8a03c50a862
70	54	-16	GBIF Germany	4f6826f2-4ff6-443d-b966-e6913bd24013	776539d4-f762-11e1-a439-00145eb45e9a
10633	10633	0	National Biodiversity Network	d897a5b9-35ee-4232-94bd-b0bcaac003c2	78c6423b-29e0-4bbb-a854-64f82b951f9e
69	69	0	GBIF Germany	4f6826f2-4ff6-443d-b966-e6913bd24013	791b77a2-f762-11e1-a439-00145eb45e9a
1	1	0	GBIF Germany	4f6826f2-4ff6-443d-b966-e6913bd24013	7a709d94-f762-11e1-a439-00145eb45e9a
144	144	0	GBIF Germany	4f6826f2-4ff6-443d-b966-e6913bd24013	7a8266a0-f762-11e1-a439-00145eb45e9a
24	24	0	GBIF Germany	4f6826f2-4ff6-443d-b966-e6913bd24013	7ab4d752-f762-11e1-a439-00145eb45e9a
2651	2653	2	GBIF Germany	4f6826f2-4ff6-443d-b966-e6913bd24013	7b8ccc66-f762-11e1-a439-00145eb45e9a
445	445	0	GBIF Germany	4f6826f2-4ff6-443d-b966-e6913bd24013	7cfe4458-f762-11e1-a439-00145eb45e9a
930	930	0	GBIF Germany	4f6826f2-4ff6-443d-b966-e6913bd24013	7df95ee2-f762-11e1-a439-00145eb45e9a
3	3	0	Plazi	ffb07bec-2d10-492d-9c37-361fe0b79427	7ee19eef-62f7-4b8a-9a82-4595e704e5b2
1	1	0	Plazi	ffb07bec-2d10-492d-9c37-361fe0b79427	7f4f590b-9b15-48bc-9852-0a9be280511f
4565	4565	0	Biodiversity Information System of Mexico	b324e8e9-9a4c-44fa-8f1a-7f39ea7ab576	7fb0cd38-f762-11e1-a439-00145eb45e9a
975046	975046	0	NatureServe	6aff31ce-8410-4118-ac61-c7571d228dc3	7fd12114-9010-4c13-8f46-990fe04ca882
3044	3044	0	Biodiversity Information System of Mexico	b324e8e9-9a4c-44fa-8f1a-7f39ea7ab576	80696fb4-f762-11e1-a439-00145eb45e9a
2406	2406	0	Biodiversity Information System of Mexico	b324e8e9-9a4c-44fa-8f1a-7f39ea7ab576	80756e72-f762-11e1-a439-00145eb45e9a
0	473	473	Symbiota Support Hub	612b5a0b-908b-4b4e-b9bf-ca15dfdc94fa	80bce133-cc17-4d5f-866b-435f1ac60fe7
284	284	0	Participant Node Managers Committee	7f48e0c8-5c96-49ec-b972-30748e339115	8119093b-edeb-416e-b15f-6ae94fbe07d5
43	43	0	GBIF Germany	4f6826f2-4ff6-443d-b966-e6913bd24013	828ca1f8-f762-11e1-a439-00145eb45e9a
0	21	21	Plazi	ffb07bec-2d10-492d-9c37-361fe0b79427	83add229-ac67-4077-80d6-b9e47e69a0fc
0	2	2	Plazi	ffb07bec-2d10-492d-9c37-361fe0b79427	84301d1c-15da-46ae-b8dd-6aeb47fa98e8
4	4	0	Plazi	ffb07bec-2d10-492d-9c37-361fe0b79427	84ed5b1e-c6e7-44ac-a94a-ab2c38bec880
16	12	-4	GBIF Germany	4f6826f2-4ff6-443d-b966-e6913bd24013	876fc682-f762-11e1-a439-00145eb45e9a
502	371	-131	GBIF Germany	4f6826f2-4ff6-443d-b966-e6913bd24013	87d0ac0e-f762-11e1-a439-00145eb45e9a
30	30	0	Participant Node Managers Committee	7f48e0c8-5c96-49ec-b972-30748e339115	87dd5588-18e1-437f-a291-cf7ef9f7db17
477	401	-76	GBIF Germany	4f6826f2-4ff6-443d-b966-e6913bd24013	884c3d56-f762-11e1-a439-00145eb45e9a
346	346	0	Ocean Biodiversity Information System	ba0670b9-4186-41e6-8e70-f9cb3065551a	8910e49e-f762-11e1-a439-00145eb45e9a
87	87	0	Ocean Biodiversity Information System	ba0670b9-4186-41e6-8e70-f9cb3065551a	891a7d88-f762-11e1-a439-00145eb45e9a
89918	89918	0	GBIF Slovenia	53e3f6b9-81f8-41e3-9e51-2666a5e0ae6a	89579e3e-f762-11e1-a439-00145eb45e9a
2076	1752	-324	GBIF Germany	4f6826f2-4ff6-443d-b966-e6913bd24013	8967bbb6-f762-11e1-a439-00145eb45e9a
0	45125	45125	GBIF Japan	db5705aa-6a6e-42f1-8942-d77b9f4896ea	898cb768-c996-4578-bfff-014f644d5c03
249	249	0	GBIF Germany	4f6826f2-4ff6-443d-b966-e6913bd24013	89ba4dfe-f762-11e1-a439-00145eb45e9a
194	194	0	GBIF Germany	4f6826f2-4ff6-443d-b966-e6913bd24013	8a2ec59e-f762-11e1-a439-00145eb45e9a
207	207	0	GBIF Germany	4f6826f2-4ff6-443d-b966-e6913bd24013	8a4b5236-f762-11e1-a439-00145eb45e9a
595	595	0	GBIF Germany	4f6826f2-4ff6-443d-b966-e6913bd24013	8aa2023e-f762-11e1-a439-00145eb45e9a
7669	7669	0	GBIF France	da44cd31-5901-4687-a106-6d1c7734ee3a	8bb7a55d-2f61-46fc-b419-20156e161cfe
30	30	0	Plazi	ffb07bec-2d10-492d-9c37-361fe0b79427	8c6c97a7-1c63-41ba-b75a-217ce1a3411d
17	15	-2	GBIF Germany	4f6826f2-4ff6-443d-b966-e6913bd24013	8d50f1c0-f762-11e1-a439-00145eb45e9a
253	253	0	GBIF Germany	4f6826f2-4ff6-443d-b966-e6913bd24013	8ef32fca-f762-11e1-a439-00145eb45e9a
143	143	0	GBIF Germany	4f6826f2-4ff6-443d-b966-e6913bd24013	8f42229c-f762-11e1-a439-00145eb45e9a
271	105	-166	GBIF Germany	4f6826f2-4ff6-443d-b966-e6913bd24013	8f4fe602-f762-11e1-a439-00145eb45e9a
27	17	-10	GBIF Germany	4f6826f2-4ff6-443d-b966-e6913bd24013	8fdcaf42-f762-11e1-a439-00145eb45e9a
288	73	-215	GBIF Germany	4f6826f2-4ff6-443d-b966-e6913bd24013	905a6158-f762-11e1-a439-00145eb45e9a
37	21	-16	GBIF Germany	4f6826f2-4ff6-443d-b966-e6913bd24013	91836066-f762-11e1-a439-00145eb45e9a
767	767	0	Society for the Management of Electronic Biodiversity Data	97818ee4-1461-4180-bf1d-b3201050124f	9343010e-8261-4bd9-9314-bf2faf34f4e7
672	672	0	GBIF Germany	4f6826f2-4ff6-443d-b966-e6913bd24013	940e7b36-f762-11e1-a439-00145eb45e9a
67	67	0	Plazi	ffb07bec-2d10-492d-9c37-361fe0b79427	97280c77-638b-4edc-a09a-e45f2806e02e
5	5	0	Plazi	ffb07bec-2d10-492d-9c37-361fe0b79427	98247436-820b-480f-9488-86b44184cfd6
1	1	0	Plazi	ffb07bec-2d10-492d-9c37-361fe0b79427	990b5f3a-d077-43ad-8595-50c14c116fce
28	28	0	Plazi	ffb07bec-2d10-492d-9c37-361fe0b79427	9982f7c4-45dd-4d57-a339-52f9b4f3bf0f
95	95	0	GBIF Norway	4f829580-180d-46a9-9c87-ed8ec959b545	9a2879b9-0640-4248-bb15-8404367b531d
562	562	0	GBIF Brazil	cdc9736d-5ff7-4ece-9959-3c744360cdb3	9b8ed240-8ecd-443d-8987-f59b53510777
2500	3500	1000	GBIF Japan	db5705aa-6a6e-42f1-8942-d77b9f4896ea	9bb62957-a16f-4be4-8b5f-06b6a3bd04ab
8704	8704	0	U.S. Geological Survey	8618c64a-93e0-4300-b546-7249e5148ed2	9c007868-b667-4c07-9a1a-96b796066f64
0	146	146	Plazi	ffb07bec-2d10-492d-9c37-361fe0b79427	9d9b7b6b-e194-4d7b-94ae-21f439800be8
36	36	0	Plazi	ffb07bec-2d10-492d-9c37-361fe0b79427	9f5dabb1-84a2-4f84-ad70-7441e8cdb674
0	19	19	Plazi	ffb07bec-2d10-492d-9c37-361fe0b79427	a026e0b2-ad8a-45ec-ae17-b3494bd22e28
1422	1422	0	GBIF France	da44cd31-5901-4687-a106-6d1c7734ee3a	a1a46543-438e-4ffc-9436-4a99bc1a541f
510	510	0	GBIF Finland	dd514216-5c7c-45f3-910d-797424cb5be6	a1c36973-1f88-414c-84f3-6e67069b98eb
2	2	0	Plazi	ffb07bec-2d10-492d-9c37-361fe0b79427	a22f3ed4-0125-4a61-aaab-3cad7a6d0628
174	175	1	GBIF Japan	db5705aa-6a6e-42f1-8942-d77b9f4896ea	a49c6fa2-7e0d-4350-945c-cec9635f3920
4682	4682	0	National Biodiversity Network	d897a5b9-35ee-4232-94bd-b0bcaac003c2	a5a78e16-e28f-4d91-b3e9-645b7bf45d2d
28203	28203	0	National Biodiversity Network	d897a5b9-35ee-4232-94bd-b0bcaac003c2	a5af4353-d10a-4038-9e26-687f19225996
141	141	0	Biodiversity Information System of Mexico	b324e8e9-9a4c-44fa-8f1a-7f39ea7ab576	a630ef16-132e-46d2-9e30-872d56437c63
828	828	0	U.S. Geological Survey	8618c64a-93e0-4300-b546-7249e5148ed2	a75ff355-1278-4eb3-aec2-4bc71130fdbe
28040	29071	1031	National Biodiversity Network	d897a5b9-35ee-4232-94bd-b0bcaac003c2	a899709f-9a73-4cac-84d8-a7dcc7b70280
0	2	2	Plazi	ffb07bec-2d10-492d-9c37-361fe0b79427	abf4b49e-f45e-48f3-8aa9-6e72cbcbfbde
5188	5188	0	Biodiversity Information System of Mexico	b324e8e9-9a4c-44fa-8f1a-7f39ea7ab576	aebc1e1c-89a0-443e-81cf-32a5d71c26c0
159	159	0	Colombian Biodiversity Information System	7e865cba-7c46-417b-ade5-97f2cf5b7be0	afba5e0f-7635-453c-a260-b6b41fc66055
7086	7086	0	Colombian Biodiversity Information System	7e865cba-7c46-417b-ade5-97f2cf5b7be0	b0e624a5-b78f-49c4-90a6-108724588459
2	2	0	Plazi	ffb07bec-2d10-492d-9c37-361fe0b79427	b1ae8a16-79a9-4da6-b8dd-af2e673d79ff
41	31	-10	GBIF Germany	4f6826f2-4ff6-443d-b966-e6913bd24013	b208da04-2fc6-41af-a369-894efd7e8001
103	103	0	Plazi	ffb07bec-2d10-492d-9c37-361fe0b79427	b20ecce6-c5fa-4dd9-9a1d-9d22fae2826a
51	51	0	Netherlands Biodiversity Information Facility	0909d601-bda2-42df-9e63-a6d51847ebce	b5fcea14-86cc-4b97-a0d1-eb604d56ad84
2	2	0	Plazi	ffb07bec-2d10-492d-9c37-361fe0b79427	b665f78e-1451-41d4-92a2-e4b7946746f6
8	8	0	Plazi	ffb07bec-2d10-492d-9c37-361fe0b79427	bc652b35-b409-4038-bb1b-655dfccf146b
3944	3749	-195	Biodiversity Information System of Mexico	b324e8e9-9a4c-44fa-8f1a-7f39ea7ab576	c129df8f-15a5-4e03-94be-f3c8979ead58
0	101	101	Colombian Biodiversity Information System	7e865cba-7c46-417b-ade5-97f2cf5b7be0	c157670a-1964-4907-9048-67882984e6e4
0	4	4	Plazi	ffb07bec-2d10-492d-9c37-361fe0b79427	c35feaa1-2b5c-4fa6-98b8-b70660d36f37
11	11	0	Participant Node Managers Committee	7f48e0c8-5c96-49ec-b972-30748e339115	c48b060b-5473-480a-9790-3cc0e0c10f55
0	63	63	Ocean Biodiversity Information System	ba0670b9-4186-41e6-8e70-f9cb3065551a	c855ce7c-6186-43d8-9dde-a5a10398a733
0	31	31	Ocean Biodiversity Information System	ba0670b9-4186-41e6-8e70-f9cb3065551a	cb3519eb-a249-48e6-ae62-0633c24f0786
81	81	0	Plazi	ffb07bec-2d10-492d-9c37-361fe0b79427	cb51c358-75b1-4e8c-bccc-6c6f309f9e0d
14	14	0	GBIF Niger	dc9041d6-a5ae-4217-92ea-f7674794d760	cbe4cdda-2045-415c-8968-039e389b7fc7
0	26	26	Ocean Biodiversity Information System	ba0670b9-4186-41e6-8e70-f9cb3065551a	cd502ac8-d505-439b-8f86-330c60d605a1
0	2	2	Plazi	ffb07bec-2d10-492d-9c37-361fe0b79427	cfaf4f6e-d6dd-42b1-b365-346af894b435
0	1069	1069	Taiwan Biodiversity Information Facility	e1b85abc-61f9-430f-ba79-6813dec53a0f	d291ea9d-0813-4df2-bdb5-74209a704ba8
18	18	0	Plazi	ffb07bec-2d10-492d-9c37-361fe0b79427	d538f9cb-411f-4c48-9d89-0d3a467a85b7
497	497	0	Atlas of Living Australia	4a6f1b71-969e-4fc5-a693-282b05e1220c	d59a4e92-9528-49a9-9b9e-ae776543339b
7	7	0	Plazi	ffb07bec-2d10-492d-9c37-361fe0b79427	da672c83-e552-4115-bccb-144bdea41b05
37073	37713	640	GBIF Brazil	cdc9736d-5ff7-4ece-9959-3c744360cdb3	da8a0dd0-85c7-4d7a-8a5a-e66b1deaebaa
233	233	0	Atlas of Living Australia	4a6f1b71-969e-4fc5-a693-282b05e1220c	dca145de-af79-41c4-9dbb-9c61d4fb92b2
284	284	0	Participant Node Managers Committee	7f48e0c8-5c96-49ec-b972-30748e339115	defc9e20-1f30-4149-ac05-bf9fd3a06e9c
0	2	2	Plazi	ffb07bec-2d10-492d-9c37-361fe0b79427	e4acaee3-462b-4e73-a806-2c912a5f1762
24	24	0	Plazi	ffb07bec-2d10-492d-9c37-361fe0b79427	e56e205e-2c0e-478b-bc6c-049ef0111457
4	4	0	Plazi	ffb07bec-2d10-492d-9c37-361fe0b79427	e6adf8aa-2261-4e79-8107-92083d9712e3
0	8	8	Plazi	ffb07bec-2d10-492d-9c37-361fe0b79427	e7b3f8f5-b4e6-492e-87f3-edeb216d34b7
1	1	0	Plazi	ffb07bec-2d10-492d-9c37-361fe0b79427	eebd4c13-986d-48d4-859e-569f6a82af5e
360	360	0	GBIF France	da44cd31-5901-4687-a106-6d1c7734ee3a	eefcf23d-88c2-41d5-9d86-2a5c3c342809
0	3	3	Plazi	ffb07bec-2d10-492d-9c37-361fe0b79427	ef376ab7-345b-4c60-aaf0-4b9e22acdeff
9	9	0	Plazi	ffb07bec-2d10-492d-9c37-361fe0b79427	ef715142-92dd-4141-adc5-20f4d3f84e11
4431	4555	124	National Biodiversity Network	d897a5b9-35ee-4232-94bd-b0bcaac003c2	f154e12c-b2f4-4654-9a79-822fedc7b094
329	329	0	National Biodiversity Network	d897a5b9-35ee-4232-94bd-b0bcaac003c2	f2c5dd2c-44fd-49dd-b17e-ac2c1c3aebf3
8330	8330	0	Netherlands Biodiversity Information Facility	0909d601-bda2-42df-9e63-a6d51847ebce	f6f1d320-d9cd-11de-b793-b8a03c50a862
67	67	0	Plazi	ffb07bec-2d10-492d-9c37-361fe0b79427	fb8c670e-e341-4236-9b05-402c7f92b8f1
8	8	0	Plazi	ffb07bec-2d10-492d-9c37-361fe0b79427	fc24ef31-3be5-4517-8621-874b942bbef9
3254	3254	0	GBIF Brazil	cdc9736d-5ff7-4ece-9959-3c744360cdb3	fc57589d-4b5b-4457-bb29-19b66d877bb5
110	110	0	Colombian Biodiversity Information System	7e865cba-7c46-417b-ade5-97f2cf5b7be0	fe128e26-ffde-4048-801a-e74250d4d2e1
2	2	0	Plazi	ffb07bec-2d10-492d-9c37-361fe0b79427	fea7df51-2039-4c6a-9d10-9c50e3013a0f
71135	71135	0	GBIF France	da44cd31-5901-4687-a106-6d1c7734ee3a	00b3dec8-a7f4-4aa2-b8d5-feb936368e64
13318	13318	0	National Biodiversity Network	d897a5b9-35ee-4232-94bd-b0bcaac003c2	04883d31-9c89-4f63-b9f6-578b775c55cc
0	1790	1790	National Biodiversity Network	d897a5b9-35ee-4232-94bd-b0bcaac003c2	05452a3d-913a-4e62-b575-76c8c6b99010
0	346	346	Colombian Biodiversity Information System	7e865cba-7c46-417b-ade5-97f2cf5b7be0	0739fdd0-5866-4e81-a8aa-2012bde08347
1	1	0	Plazi	ffb07bec-2d10-492d-9c37-361fe0b79427	075198c4-4dd0-419c-b924-389ab2013d6e
0	185	185	Ocean Biodiversity Information System	ba0670b9-4186-41e6-8e70-f9cb3065551a	0a3a5547-9370-41e9-9ad4-2919ac5d40d1
0	3	3	Plazi	ffb07bec-2d10-492d-9c37-361fe0b79427	0b568350-6ace-45e9-86be-d282eeb0fbda
9	9	0	Plazi	ffb07bec-2d10-492d-9c37-361fe0b79427	0b9df035-0ebc-4682-bd9a-83b187b53612
2	2	0	Plazi	ffb07bec-2d10-492d-9c37-361fe0b79427	0cb1e7af-78b7-4813-a61e-7c38b93cdfd6
40	40	0	Plazi	ffb07bec-2d10-492d-9c37-361fe0b79427	0e26fd95-f93b-4045-b176-7208b23376aa
57	57	0	GBIF France	da44cd31-5901-4687-a106-6d1c7734ee3a	102fb97b-c7b0-402c-a726-282bf7a63d0a
129368	129368	0	National Biodiversity Network	d897a5b9-35ee-4232-94bd-b0bcaac003c2	1218ac4d-966d-48a9-8368-981aa4f7a907
268	268	0	Plazi	ffb07bec-2d10-492d-9c37-361fe0b79427	15336699-cd74-44f7-a956-8ef5df4c3402
0	19783	19783	Participant Node Managers Committee	7f48e0c8-5c96-49ec-b972-30748e339115	155290ea-0ac1-4da6-bb37-f7cde3a7363e
327	327	0	GBIF France	da44cd31-5901-4687-a106-6d1c7734ee3a	1884215f-5360-44fc-ba44-16766e07a980
7	7	0	Taiwan Biodiversity Information Facility	e1b85abc-61f9-430f-ba79-6813dec53a0f	19236b5a-5462-41af-a851-9dbc2eed47f2
0	1768	1768	Colombian Biodiversity Information System	7e865cba-7c46-417b-ade5-97f2cf5b7be0	1a88a4b4-e3b8-4ff0-89a0-c0bbb179a298
6	6	0	Plazi	ffb07bec-2d10-492d-9c37-361fe0b79427	1c05cb51-81d0-4234-a961-7b4dcd4fd2f0
192	192	0	Participant Node Managers Committee	7f48e0c8-5c96-49ec-b972-30748e339115	1c87010c-d73c-4b45-a7e2-ee0b6e923663
5	5	0	Plazi	ffb07bec-2d10-492d-9c37-361fe0b79427	1f60655e-f7df-4862-9d6c-7ca7d91833b6
26	26	0	Plazi	ffb07bec-2d10-492d-9c37-361fe0b79427	1f99571f-2d4f-471c-b329-121c877e46bd
9	9	0	Plazi	ffb07bec-2d10-492d-9c37-361fe0b79427	201a9906-0012-4e5e-a79b-c92fc9ddbfe4
9	9	0	GBIF France	da44cd31-5901-4687-a106-6d1c7734ee3a	2081e696-4856-4ad6-845e-415397799489
164027	169214	5187	National Biodiversity Network	d897a5b9-35ee-4232-94bd-b0bcaac003c2	20fa3e49-f75c-4aad-adcd-6b3882caf6db
45	45	0	Plazi	ffb07bec-2d10-492d-9c37-361fe0b79427	2164a0b8-da51-44d1-9f83-8f65276c7385
0	21	21	Plazi	ffb07bec-2d10-492d-9c37-361fe0b79427	2495e55e-efac-495d-afa2-c8c3f51bb78b
1	1	0	Plazi	ffb07bec-2d10-492d-9c37-361fe0b79427	25402b49-ac0b-4370-925e-d2d7b6438e9b
26	26	0	GBIF Norway	4f829580-180d-46a9-9c87-ed8ec959b545	27707a6d-3320-4e85-be33-aafaf7f321f3
2	2	0	Plazi	ffb07bec-2d10-492d-9c37-361fe0b79427	27cbe469-a6fd-43c1-a663-4367786bf528
17	17	0	GBIF France	da44cd31-5901-4687-a106-6d1c7734ee3a	2961c3f5-ee52-47c9-87a3-2bc9aa0be4a1
55100	55100	0	GBIF Portugal	673f7038-4262-4149-b753-5658a4e912f6	2bf7b2c0-34dc-4458-8ee4-4f99fac03b33
75	75	0	GBIF France	da44cd31-5901-4687-a106-6d1c7734ee3a	300e615a-6fb8-4fca-9584-fdc7e792d198
1374	1374	0	Belgian Biodiversity Platform	fb11cfe1-ebc3-45af-9159-17d9fddbcdac	3331bcd4-f85e-4252-8e92-3aaa6fdc3eca
9	9	0	Plazi	ffb07bec-2d10-492d-9c37-361fe0b79427	350c62d2-023a-49db-9031-737523862d4a
5	5	0	Plazi	ffb07bec-2d10-492d-9c37-361fe0b79427	36946efb-b06c-45a0-a3aa-15642749dd99
12	12	0	Plazi	ffb07bec-2d10-492d-9c37-361fe0b79427	372103b1-fefc-48bf-bf27-b14f9249454b
1525	1525	0	GBIF Uganda	71b40829-6a12-4c3d-8fee-5746f5e9cf8c	3d514dad-76ed-43d3-893c-915910ce638c
0	4	4	Plazi	ffb07bec-2d10-492d-9c37-361fe0b79427	3dab0d02-d6ed-45ef-8589-5cb984fec302
0	7	7	Plazi	ffb07bec-2d10-492d-9c37-361fe0b79427	3decb63e-3df3-4be6-954e-3a93b9cd4738
6001	6001	0	National Biodiversity Network	d897a5b9-35ee-4232-94bd-b0bcaac003c2	3ed72b18-8398-4445-9032-8a35003d8dfb
1510	1510	0	GBIF France	da44cd31-5901-4687-a106-6d1c7734ee3a	4062295b-4a45-4cd1-b532-cceba62a0cf2
8	8	0	Plazi	ffb07bec-2d10-492d-9c37-361fe0b79427	407f0772-182b-45da-bd20-40da56f96867
13	13	0	GBIF France	da44cd31-5901-4687-a106-6d1c7734ee3a	40f62505-9ffc-4c90-83ce-a624f5dd1b93
1	1	0	Plazi	ffb07bec-2d10-492d-9c37-361fe0b79427	416e1f96-dc30-416e-8ce2-60534f8194d5
150	150	0	Biodiversity Information System of Mexico	b324e8e9-9a4c-44fa-8f1a-7f39ea7ab576	48a3c54a-ae15-4d87-b615-76d4d9141e8c
0	4	4	Plazi	ffb07bec-2d10-492d-9c37-361fe0b79427	49326ee5-a67b-492e-b229-6f25dcd61f0e
0	3763	3763	Ocean Biodiversity Information System	ba0670b9-4186-41e6-8e70-f9cb3065551a	4a391c5e-47aa-4e30-9374-4c3e143c4eca
23	23	0	Colombian Biodiversity Information System	7e865cba-7c46-417b-ade5-97f2cf5b7be0	4ab88bf3-a442-47b5-a0f1-bd58f2fd41b9
1	1	0	Plazi	ffb07bec-2d10-492d-9c37-361fe0b79427	4b16a20a-6466-4455-b810-488ba9f21bf2
1018	1018	0	GBIF Germany	4f6826f2-4ff6-443d-b966-e6913bd24013	4b7506a8-e2ab-4285-9aa3-dab14a75d12e
302	302	0	GBIF Malawi	2a42e4d7-ad4a-41b3-84c4-de4aa7b74d35	4c39bca8-5d52-4efa-9bb0-72cf38456bfc
0	3	3	Plazi	ffb07bec-2d10-492d-9c37-361fe0b79427	4d92dcb4-5d56-413c-ba7e-92291e75e200
0	30	30	Plazi	ffb07bec-2d10-492d-9c37-361fe0b79427	4f3d0560-a128-404c-a543-c2e6044af21e
0	136	136	GBIF France	da44cd31-5901-4687-a106-6d1c7734ee3a	50dd4b44-7245-4afd-a9b4-d1cf54f969f2
163	163	0	Biodiversity Information System of Mexico	b324e8e9-9a4c-44fa-8f1a-7f39ea7ab576	5178a9d0-50de-4583-aee5-322b6c3f5b35
326	326	0	Plazi	ffb07bec-2d10-492d-9c37-361fe0b79427	551e8bfc-56cf-4646-8170-7a83a1837443
3	3	0	Plazi	ffb07bec-2d10-492d-9c37-361fe0b79427	55dbf55a-f438-463d-b68a-8b48dba366ab
1159	1159	0	Atlas of Living Australia	4a6f1b71-969e-4fc5-a693-282b05e1220c	599ba2ea-f3c1-4885-934a-7f5cad372c43
258	258	0	GBIF France	da44cd31-5901-4687-a106-6d1c7734ee3a	5e6b1784-7ade-4542-a61f-8adf9bfb0b7b
18	18	0	Ocean Biodiversity Information System	ba0670b9-4186-41e6-8e70-f9cb3065551a	5fb22be6-e8e5-4e85-a701-223958eb7f3d
0	240	240	Colombian Biodiversity Information System	7e865cba-7c46-417b-ade5-97f2cf5b7be0	60e410ed-897a-475c-b772-6abaf229ed9e
1	1	0	GBIF Germany	4f6826f2-4ff6-443d-b966-e6913bd24013	635a6a2c-f762-11e1-a439-00145eb45e9a
114	114	0	GBIF Germany	4f6826f2-4ff6-443d-b966-e6913bd24013	63edf670-f762-11e1-a439-00145eb45e9a
0	3196	3196	Ocean Biodiversity Information System	ba0670b9-4186-41e6-8e70-f9cb3065551a	65bdcbf8-076c-4231-a6ec-3760d55c6d79
151	151	0	GBIF Germany	4f6826f2-4ff6-443d-b966-e6913bd24013	67fc5b30-f762-11e1-a439-00145eb45e9a
40	40	0	GBIF Germany	4f6826f2-4ff6-443d-b966-e6913bd24013	681329aa-f762-11e1-a439-00145eb45e9a
1521	1521	0	GBIF France	da44cd31-5901-4687-a106-6d1c7734ee3a	68199ea2-0dfe-4e82-9439-7b13dd6840b6
22	22	0	Plazi	ffb07bec-2d10-492d-9c37-361fe0b79427	68d52e7b-b7eb-40f9-b12a-37bce3eca4ff
16	16	0	GBIF Germany	4f6826f2-4ff6-443d-b966-e6913bd24013	6af6c6d6-f762-11e1-a439-00145eb45e9a
18	18	0	GBIF Germany	4f6826f2-4ff6-443d-b966-e6913bd24013	6b1e8932-f762-11e1-a439-00145eb45e9a
18	18	0	GBIF Germany	4f6826f2-4ff6-443d-b966-e6913bd24013	6b2da25a-f762-11e1-a439-00145eb45e9a
10	10	0	Plazi	ffb07bec-2d10-492d-9c37-361fe0b79427	6bce7dcc-3a47-461a-8ba8-63311c439c8d
5313	5313	0	GBIF Finland	dd514216-5c7c-45f3-910d-797424cb5be6	6c781d5f-a189-497b-a78d-5c2d7b41cb6a
1039	1039	0	National Biodiversity Network	d897a5b9-35ee-4232-94bd-b0bcaac003c2	6c825d1d-e99e-4084-bdd9-460b778991d8
33	33	0	GBIF Germany	4f6826f2-4ff6-443d-b966-e6913bd24013	6c99cc36-f762-11e1-a439-00145eb45e9a
64	64	0	GBIF Germany	4f6826f2-4ff6-443d-b966-e6913bd24013	6cac5338-f762-11e1-a439-00145eb45e9a
254	254	0	GBIF Norway	4f829580-180d-46a9-9c87-ed8ec959b545	6f09416a-7540-420a-ab66-d3223ff3af48
6	6	0	GBIF Germany	4f6826f2-4ff6-443d-b966-e6913bd24013	6fa5b732-f762-11e1-a439-00145eb45e9a
6	6	0	GBIF Germany	4f6826f2-4ff6-443d-b966-e6913bd24013	6fbcbf68-f762-11e1-a439-00145eb45e9a
112	112	0	GBIF Germany	4f6826f2-4ff6-443d-b966-e6913bd24013	7173a89e-f762-11e1-a439-00145eb45e9a
1720	1720	0	GBIF Germany	4f6826f2-4ff6-443d-b966-e6913bd24013	73e9eb1e-d65c-4ab3-9964-9922a62c01bb
79	79	0	GBIF Germany	4f6826f2-4ff6-443d-b966-e6913bd24013	74114df4-f762-11e1-a439-00145eb45e9a
134	134	0	GBIF France	da44cd31-5901-4687-a106-6d1c7734ee3a	745f4f4d-cefb-48eb-ad26-7146181aa70e
170	170	0	GBIF Germany	4f6826f2-4ff6-443d-b966-e6913bd24013	746a0bba-f762-11e1-a439-00145eb45e9a
0	1	1	Plazi	ffb07bec-2d10-492d-9c37-361fe0b79427	74d05919-70e4-4a9f-b08b-24752e372338
7	7	0	GBIF France	da44cd31-5901-4687-a106-6d1c7734ee3a	75e44317-a43c-4743-8d88-47535904f64b
3544	3544	0	National Biodiversity Network	d897a5b9-35ee-4232-94bd-b0bcaac003c2	76a40eff-90d3-4df3-a410-9fdeb08227b7
0	1593	1593	GBIF Portugal	673f7038-4262-4149-b753-5658a4e912f6	7795d854-baeb-4a5d-953e-5dd5cb318133
140	140	0	GBIF Germany	4f6826f2-4ff6-443d-b966-e6913bd24013	783b880e-f762-11e1-a439-00145eb45e9a
111	111	0	GBIF Germany	4f6826f2-4ff6-443d-b966-e6913bd24013	7855c11a-f762-11e1-a439-00145eb45e9a
2418	2418	0	GBIF Germany	4f6826f2-4ff6-443d-b966-e6913bd24013	79423ca2-f762-11e1-a439-00145eb45e9a
0	14	14	Plazi	ffb07bec-2d10-492d-9c37-361fe0b79427	797184fa-5b39-4a0e-8810-fb8e630838fd
702	557	-145	GBIF Germany	4f6826f2-4ff6-443d-b966-e6913bd24013	797f423c-f762-11e1-a439-00145eb45e9a
12	12	0	Plazi	ffb07bec-2d10-492d-9c37-361fe0b79427	79b3b66d-f3be-4564-a7f8-2ecd1f891c4e
1598	850	-748	GBIF Germany	4f6826f2-4ff6-443d-b966-e6913bd24013	7a08ec58-f762-11e1-a439-00145eb45e9a
254	254	0	GBIF Germany	4f6826f2-4ff6-443d-b966-e6913bd24013	7a96ecf6-f762-11e1-a439-00145eb45e9a
94	94	0	GBIF Germany	4f6826f2-4ff6-443d-b966-e6913bd24013	7b826f3c-f762-11e1-a439-00145eb45e9a
20	20	0	GBIF Germany	4f6826f2-4ff6-443d-b966-e6913bd24013	7cc3d4a8-f762-11e1-a439-00145eb45e9a
23	23	0	GBIF France	da44cd31-5901-4687-a106-6d1c7734ee3a	7d0cc1b9-71b1-4dee-b3f4-19441cb28b9a
1326	1326	0	GBIF Germany	4f6826f2-4ff6-443d-b966-e6913bd24013	7d8fa614-f762-11e1-a439-00145eb45e9a
0	7	7	Plazi	ffb07bec-2d10-492d-9c37-361fe0b79427	7d95aa71-9c56-49a9-bbe3-e80a5ac843f0
306	306	0	GBIF France	da44cd31-5901-4687-a106-6d1c7734ee3a	7dc565cb-9a8d-41d9-b1e2-52099bbcad12
2380	2380	0	GBIF Germany	4f6826f2-4ff6-443d-b966-e6913bd24013	7de33e8c-f762-11e1-a439-00145eb45e9a
199	154	-45	GBIF Germany	4f6826f2-4ff6-443d-b966-e6913bd24013	7df06364-f762-11e1-a439-00145eb45e9a
618	618	0	GBIF Germany	4f6826f2-4ff6-443d-b966-e6913bd24013	7e50e75c-f762-11e1-a439-00145eb45e9a
6181	4909	-1272	GBIF Germany	4f6826f2-4ff6-443d-b966-e6913bd24013	7f3a14b8-f762-11e1-a439-00145eb45e9a
742	742	0	Biodiversity Information System of Mexico	b324e8e9-9a4c-44fa-8f1a-7f39ea7ab576	7f7543ee-f762-11e1-a439-00145eb45e9a
1	1	0	Plazi	ffb07bec-2d10-492d-9c37-361fe0b79427	7fa0297c-3296-4d76-a6b4-db78862b142d
3822	3822	0	GBIF Germany	4f6826f2-4ff6-443d-b966-e6913bd24013	7fb9bf5b-4126-4b51-b92d-c181bc34e766
19733	19733	0	U.S. Geological Survey	8618c64a-93e0-4300-b546-7249e5148ed2	807747cb-d128-4029-af64-9f4ba53c4285
1311	1311	0	Biodiversity Information System of Mexico	b324e8e9-9a4c-44fa-8f1a-7f39ea7ab576	807e6f90-f762-11e1-a439-00145eb45e9a
5	5	0	GBIF Japan	db5705aa-6a6e-42f1-8942-d77b9f4896ea	810251a2-f762-11e1-a439-00145eb45e9a
52030	53550	1520	GBIF Japan	db5705aa-6a6e-42f1-8942-d77b9f4896ea	811bed92-f762-11e1-a439-00145eb45e9a
1267	1267	0	GBIF Germany	4f6826f2-4ff6-443d-b966-e6913bd24013	817adc94-f762-11e1-a439-00145eb45e9a
3074	1914	-1160	GBIF Germany	4f6826f2-4ff6-443d-b966-e6913bd24013	81db761c-f762-11e1-a439-00145eb45e9a
1428	1428	0	GBIF Germany	4f6826f2-4ff6-443d-b966-e6913bd24013	825ec12a-f762-11e1-a439-00145eb45e9a
22700	22700	0	Canada Biodiversity Information Facility	8f83fc96-c966-4126-83f7-bf044dc49efa	843cc7a8-f762-11e1-a439-00145eb45e9a
30	30	0	GBIF Germany	4f6826f2-4ff6-443d-b966-e6913bd24013	85d2ae8e-f762-11e1-a439-00145eb45e9a
88	88	0	GBIF Germany	4f6826f2-4ff6-443d-b966-e6913bd24013	882ba352-f762-11e1-a439-00145eb45e9a
0	140695	140695	Canada Biodiversity Information Facility	8f83fc96-c966-4126-83f7-bf044dc49efa	88d13c11-f8ea-4b2f-b819-222cb1732e37
1161	1161	0	Biodiversity Information System of Mexico	b324e8e9-9a4c-44fa-8f1a-7f39ea7ab576	892dc186-f762-11e1-a439-00145eb45e9a
21	21	0	Plazi	ffb07bec-2d10-492d-9c37-361fe0b79427	89812c9a-49e9-492a-bd33-5d981f3b11f1
0	138877	138877	Ocean Biodiversity Information System	ba0670b9-4186-41e6-8e70-f9cb3065551a	898b6c44-2891-45da-84e5-3d8bf6f5d38d
0	636	636	Plazi	ffb07bec-2d10-492d-9c37-361fe0b79427	8a5efe86-cabc-4981-afb4-163791f2530c
622	622	0	GBIF Brazil	cdc9736d-5ff7-4ece-9959-3c744360cdb3	8ab22acf-a3eb-4a67-9eec-5d07631011be
0	1	1	Plazi	ffb07bec-2d10-492d-9c37-361fe0b79427	8c38f5c1-67fd-47b0-9a33-e97aeb272d26
1669	1029	-640	GBIF Germany	4f6826f2-4ff6-443d-b966-e6913bd24013	8e80d704-f762-11e1-a439-00145eb45e9a
24	24	0	GBIF Germany	4f6826f2-4ff6-443d-b966-e6913bd24013	8f7a4b25-2840-4688-ae98-e908a193e13c
3224	3224	0	GBIF France	da44cd31-5901-4687-a106-6d1c7734ee3a	912e4246-9db3-4c5a-be79-31a721ae5ae1
0	32	32	Plazi	ffb07bec-2d10-492d-9c37-361fe0b79427	91546d32-ac3d-45d1-834f-862152266e27
138	82	-56	GBIF Germany	4f6826f2-4ff6-443d-b966-e6913bd24013	92e8d30a-f762-11e1-a439-00145eb45e9a
1127	1127	0	Colombian Biodiversity Information System	7e865cba-7c46-417b-ade5-97f2cf5b7be0	92fe68db-c796-4324-affc-0239dc49dc94
306	278	-28	GBIF Germany	4f6826f2-4ff6-443d-b966-e6913bd24013	932822b2-f762-11e1-a439-00145eb45e9a
629	221	-408	GBIF Germany	4f6826f2-4ff6-443d-b966-e6913bd24013	93476d7a-f762-11e1-a439-00145eb45e9a
27	27	0	Plazi	ffb07bec-2d10-492d-9c37-361fe0b79427	93725046-5244-4fa5-83d5-62bdaa7a917a
64	64	0	GBIF Germany	4f6826f2-4ff6-443d-b966-e6913bd24013	95a06176-f762-11e1-a439-00145eb45e9a
561	561	0	GBIF Germany	4f6826f2-4ff6-443d-b966-e6913bd24013	95d8d7c2-f762-11e1-a439-00145eb45e9a
46	46	0	GBIF Germany	4f6826f2-4ff6-443d-b966-e6913bd24013	9797cd98-f762-11e1-a439-00145eb45e9a
12	12	0	Plazi	ffb07bec-2d10-492d-9c37-361fe0b79427	97ab7886-552e-4bde-8390-75e1c6497fe4
116	116	0	GBIF Germany	4f6826f2-4ff6-443d-b966-e6913bd24013	97c5f1aa-f762-11e1-a439-00145eb45e9a
46	46	0	GBIF Germany	4f6826f2-4ff6-443d-b966-e6913bd24013	97c9d45a-f762-11e1-a439-00145eb45e9a
1315	1315	0	GBIF Japan	db5705aa-6a6e-42f1-8942-d77b9f4896ea	98c27c36-6190-4196-8250-df29faaf1728
13	13	0	Plazi	ffb07bec-2d10-492d-9c37-361fe0b79427	9c82f1d4-29d7-4be3-a3ca-dc0a4e5e2d65
35	59	24	Plazi	ffb07bec-2d10-492d-9c37-361fe0b79427	9d2c1913-225a-4801-aa8c-817ac9c399bb
6	6	0	Plazi	ffb07bec-2d10-492d-9c37-361fe0b79427	9e2df40b-14b5-4333-a904-a1a74cd8c5a3
260	260	0	GBIF Germany	4f6826f2-4ff6-443d-b966-e6913bd24013	9ec06c02-2a45-43a1-b4c8-a78ed3291260
2	2	0	Plazi	ffb07bec-2d10-492d-9c37-361fe0b79427	9fb71775-2354-4d22-9541-a7ac844d2a4d
78	78	0	GBIF Germany	4f6826f2-4ff6-443d-b966-e6913bd24013	a3a2f458-22a1-4f15-8d27-e649cd55ebcc
3	3	0	Plazi	ffb07bec-2d10-492d-9c37-361fe0b79427	a41ab71e-5763-40bc-93fb-b3e61479a598
1272	1272	0	National Biodiversity Network	d897a5b9-35ee-4232-94bd-b0bcaac003c2	a7600079-9586-45aa-8b6e-762cc49d86e2
884	884	0	GBIF Benin	efb9c00e-f802-45dd-8826-a52ec45b89ff	ab81bec0-4da6-40fe-bef3-d21bbb8f3130
3941	3941	0	U.S. Geological Survey	8618c64a-93e0-4300-b546-7249e5148ed2	acede617-a095-4caa-a93e-4a77f5f77935
39	39	0	Plazi	ffb07bec-2d10-492d-9c37-361fe0b79427	add59291-8161-4eae-a6bc-6c61d720dd35
0	121	121	Plazi	ffb07bec-2d10-492d-9c37-361fe0b79427	ae20ec3e-7a6b-4ff0-b9de-e2a846c79efc
2	2	0	Plazi	ffb07bec-2d10-492d-9c37-361fe0b79427	b377e012-7f3c-4605-9803-4aaaf886754c
0	3	3	Plazi	ffb07bec-2d10-492d-9c37-361fe0b79427	b3a98ff5-aeda-4653-ab18-9a842d339d58
19	19	0	Plazi	ffb07bec-2d10-492d-9c37-361fe0b79427	b43888bf-aa97-4427-bcdf-ef94c6d7abee
0	4	4	Plazi	ffb07bec-2d10-492d-9c37-361fe0b79427	b4c76d7f-0dac-4abc-aa7c-eea483ae0861
53	53	0	Biodiversity Information System of Mexico	b324e8e9-9a4c-44fa-8f1a-7f39ea7ab576	b6b0b889-dc0e-4ff2-91df-4e8ef70c14ad
0	34	34	Plazi	ffb07bec-2d10-492d-9c37-361fe0b79427	b72de0fe-ddbf-42b2-95d4-a3ffe8c55c07
246	246	0	Plazi	ffb07bec-2d10-492d-9c37-361fe0b79427	ba2bd1cd-8a6f-4a94-93a2-96b99318a8b4
0	87	87	Plazi	ffb07bec-2d10-492d-9c37-361fe0b79427	c0b3c91a-f100-4743-afcc-d4e77ff11d9e
191560	191560	0	GBIF France	da44cd31-5901-4687-a106-6d1c7734ee3a	c0dd99c3-fa06-499c-949e-aa44d42f2f16
0	68	68	Plazi	ffb07bec-2d10-492d-9c37-361fe0b79427	c3aad537-5702-4cac-9f2d-dd3db172e280
132	132	0	GBIF Brazil	cdc9736d-5ff7-4ece-9959-3c744360cdb3	c76230d9-61a0-4643-a227-bf8e2f78e7b6
7	7	0	Plazi	ffb07bec-2d10-492d-9c37-361fe0b79427	c8ec7393-e187-4230-8dc5-c8f9ef544d3c
0	6	6	Plazi	ffb07bec-2d10-492d-9c37-361fe0b79427	ca555a3d-b787-4691-8ab8-0b0f86e03111
0	8	8	Plazi	ffb07bec-2d10-492d-9c37-361fe0b79427	cc10c087-bec3-4947-81d7-b3e5580a5c94
2	2	0	Plazi	ffb07bec-2d10-492d-9c37-361fe0b79427	cd090496-6d8d-4c92-8ad0-018d0e7ae9f9
8	8	0	Plazi	ffb07bec-2d10-492d-9c37-361fe0b79427	d03d0ec7-995d-40e9-9ecb-a6b3add4097c
6	6	0	Plazi	ffb07bec-2d10-492d-9c37-361fe0b79427	d24c66f3-09ee-4ac2-966a-4fcaef511d9b
0	149	149	Plazi	ffb07bec-2d10-492d-9c37-361fe0b79427	d451f9fb-1a74-43c9-8ba3-cdc5e88b241c
17	17	0	Plazi	ffb07bec-2d10-492d-9c37-361fe0b79427	d5502acf-e5d7-45b6-8298-1432493d677c
2	2	0	Plazi	ffb07bec-2d10-492d-9c37-361fe0b79427	d5e11eab-814f-4057-9bb3-ade20cabd124
2	2	0	Plazi	ffb07bec-2d10-492d-9c37-361fe0b79427	d5e159ae-e097-4c71-b885-0ba32847a8ba
113	113	0	Colombian Biodiversity Information System	7e865cba-7c46-417b-ade5-97f2cf5b7be0	d8269db1-4415-4efd-94e6-a2a7fca78e15
64	64	0	GBIF Germany	4f6826f2-4ff6-443d-b966-e6913bd24013	d8bcc3e8-0d40-47f3-8790-2d3fa3831c54
9189	9289	100	GBIF Japan	db5705aa-6a6e-42f1-8942-d77b9f4896ea	dd7e1d74-8acc-4ef4-8557-d5ccc219fb52
321	319	-2	Plazi	ffb07bec-2d10-492d-9c37-361fe0b79427	de00ca6c-2843-4ae1-a39c-a29603947612
0	3	3	Plazi	ffb07bec-2d10-492d-9c37-361fe0b79427	de2bb0b4-6417-47ba-86bd-3c9d6609328a
0	2	2	Plazi	ffb07bec-2d10-492d-9c37-361fe0b79427	dfc2a569-5289-470c-82b6-08bc235dca50
26	26	0	Plazi	ffb07bec-2d10-492d-9c37-361fe0b79427	e16432db-82d6-4286-9271-5c9902dcc516
3	3	0	Plazi	ffb07bec-2d10-492d-9c37-361fe0b79427	e236912c-296f-4166-8d1f-bc808b70f273
0	5	5	Plazi	ffb07bec-2d10-492d-9c37-361fe0b79427	e29de56d-9fae-42e7-af75-ce62a749d601
5537	5537	0	GBIF France	da44cd31-5901-4687-a106-6d1c7734ee3a	e5d47a25-9e51-40db-9b5c-3f766be5c7b5
147	147	0	Participant Node Managers Committee	7f48e0c8-5c96-49ec-b972-30748e339115	e6839e1e-336f-4474-b8fa-085a3894358c
13	13	0	Plazi	ffb07bec-2d10-492d-9c37-361fe0b79427	e741b139-013c-457b-86e2-f08bc01449aa
0	2	2	Plazi	ffb07bec-2d10-492d-9c37-361fe0b79427	e778a39d-1023-4d1c-9702-19954e59ad4a
70	70	0	Participant Node Managers Committee	7f48e0c8-5c96-49ec-b972-30748e339115	e8e5dd5b-b0ad-461c-981a-ef8ee190a315
2282	2282	0	GBIF Germany	4f6826f2-4ff6-443d-b966-e6913bd24013	e97b9602-301f-4b04-9e26-7f6ce2206761
57	57	0	GBIF Madagascar	2dbfc5c5-51b5-4494-9dfc-4d3f013a3b64	edb039d1-b0f2-460d-98a8-277367a19062
0	4	4	Plazi	ffb07bec-2d10-492d-9c37-361fe0b79427	ef6c8b00-32a8-47a3-bf1a-ff2a5e4452ce
0	27	27	Ocean Biodiversity Information System	ba0670b9-4186-41e6-8e70-f9cb3065551a	f07a0547-fd61-4bef-9350-cd748d671a61
0	648	648	Ocean Biodiversity Information System	ba0670b9-4186-41e6-8e70-f9cb3065551a	f1ad0611-d05c-4b36-b9a0-fb5c618e9f09
1036	1036	0	GBIF Germany	4f6826f2-4ff6-443d-b966-e6913bd24013	f2259a44-c231-436a-a6de-0511e8e12811
0	64	64	Ocean Biodiversity Information System	ba0670b9-4186-41e6-8e70-f9cb3065551a	f7d18456-290f-4039-b3ad-d6190e28f6c1
2	2	0	Plazi	ffb07bec-2d10-492d-9c37-361fe0b79427	fa0832c4-9bfb-409b-90ce-2423d64a1ef4
3434	3434	0	National Biodiversity Network	d897a5b9-35ee-4232-94bd-b0bcaac003c2	fa562ed4-aeb4-4815-90e2-c595e419e134
331	331	0	GBIF France	da44cd31-5901-4687-a106-6d1c7734ee3a	fb83820e-d055-454a-9eee-2898ac5cf7fd
145	145	0	Plazi	ffb07bec-2d10-492d-9c37-361fe0b79427	fbe3031c-52b8-406a-8095-82cb9e53add0
25	25	0	Plazi	ffb07bec-2d10-492d-9c37-361fe0b79427	fc1a0026-e50e-4fe8-b006-4af5f853f9b0
636	636	0	GBIF France	da44cd31-5901-4687-a106-6d1c7734ee3a	fd1c3cce-fe6a-4a0c-b65b-4b7b840e74be
8914	8914	0	GBIF Brazil	cdc9736d-5ff7-4ece-9959-3c744360cdb3	fe7e89d1-8039-43dc-a833-df08f05f36b7
23634	23634	0	National Biodiversity Network	d897a5b9-35ee-4232-94bd-b0bcaac003c2	013f3c01-511e-49ea-9393-a22bebc11423
1	1	0	Plazi	ffb07bec-2d10-492d-9c37-361fe0b79427	05c2ef6c-d2ad-4d95-9a00-685d98540ab4
0	7	7	Plazi	ffb07bec-2d10-492d-9c37-361fe0b79427	0b64ea7f-8991-4da6-a68d-6475baba8fdd
2	2	0	Plazi	ffb07bec-2d10-492d-9c37-361fe0b79427	0b847c75-54cc-4524-9eb3-7a68474b8988
74	74	0	Plazi	ffb07bec-2d10-492d-9c37-361fe0b79427	0d3eae8f-98c7-42cb-884d-8091713dabb8
3087	3087	0	GBIF Norway	4f829580-180d-46a9-9c87-ed8ec959b545	0d8f74b3-42b9-488f-9ec1-1faefaff1d1c
64	64	0	GBIF France	da44cd31-5901-4687-a106-6d1c7734ee3a	11abd2e5-d215-44eb-8b5b-03f7dd19817b
157	157	0	GBIF France	da44cd31-5901-4687-a106-6d1c7734ee3a	1212d423-8001-4e90-98bb-640f8ce660fd
0	60	60	Ocean Biodiversity Information System	ba0670b9-4186-41e6-8e70-f9cb3065551a	1282b0d1-d5d6-4521-a7d3-5b9f3f90ef5a
408	408	0	Scientific Committee on Antarctic Research	51e4e8ff-bff0-4996-8b27-9107d61b3478	13077229-dd4e-49eb-9899-3e34f67ac984
0	3	3	Plazi	ffb07bec-2d10-492d-9c37-361fe0b79427	180198ca-21e3-4365-83ae-d68da494436a
899	896	-3	GBIF Germany	4f6826f2-4ff6-443d-b966-e6913bd24013	1a353b62-3315-4951-9ffb-ce59230781b6
86	86	0	GBIF France	da44cd31-5901-4687-a106-6d1c7734ee3a	1b69d77f-acfb-4980-aaca-7e3a76b2f372
0	8396	8396	Biodiversity Information System of Mexico	b324e8e9-9a4c-44fa-8f1a-7f39ea7ab576	1ba8596f-1822-41a8-8064-b4819375a2f4
220880	239305	18425	GBIF Norway	4f829580-180d-46a9-9c87-ed8ec959b545	1bec5de3-758c-4ed2-ab13-1597601ad07a
451581	451581	0	U.S. Geological Survey	8618c64a-93e0-4300-b546-7249e5148ed2	1ea1cb01-e168-4236-be23-8c86ec51fc3f
0	11	11	Plazi	ffb07bec-2d10-492d-9c37-361fe0b79427	2520ef1f-eadd-49cd-8957-3ddb1199b29d
50	50	0	Plazi	ffb07bec-2d10-492d-9c37-361fe0b79427	25269fa5-bb1c-45f9-9d9b-3b5f45f65da9
5775	5775	0	Ocean Biodiversity Information System	ba0670b9-4186-41e6-8e70-f9cb3065551a	29124ef4-dd2b-4b11-adfe-11473a5dcd1c
91	91	0	GBIF France	da44cd31-5901-4687-a106-6d1c7734ee3a	296001cc-7f7e-4a84-a957-f8d0857faee4
8	8	0	Plazi	ffb07bec-2d10-492d-9c37-361fe0b79427	29fe8217-1f0a-400b-9b6d-b8464baab076
119	119	0	GBIF France	da44cd31-5901-4687-a106-6d1c7734ee3a	3298413e-b9ab-4e80-9c2c-70be6d0ce473
953	953	0	Biodiversity Information System of Mexico	b324e8e9-9a4c-44fa-8f1a-7f39ea7ab576	32af8256-1d91-4f32-8bca-d6339576938f
10	10	0	Plazi	ffb07bec-2d10-492d-9c37-361fe0b79427	33921499-00ae-4834-9271-15e16a0d1d68
3	3	0	Plazi	ffb07bec-2d10-492d-9c37-361fe0b79427	34ad2255-e191-4870-83e8-74819ca0fe06
8	8	0	Plazi	ffb07bec-2d10-492d-9c37-361fe0b79427	39bcbc6b-37c9-416c-b655-46521260f336
1	1	0	Plazi	ffb07bec-2d10-492d-9c37-361fe0b79427	3ab120b5-5595-44d2-b3cd-349601ab662a
0	1000	1000	Korean Biodiversity Information Facility	e0a1e772-0177-4800-94b4-2d023fe6cdf4	3d1fea6e-eaac-4700-9a7b-0300ffe56867
0	1608	1608	Korean Biodiversity Information Facility	e0a1e772-0177-4800-94b4-2d023fe6cdf4	3d612040-b167-488d-8660-00f612c2a8cf
9	9	0	Plazi	ffb07bec-2d10-492d-9c37-361fe0b79427	3e389061-d572-4eb6-9526-a0a22cefa4c1
3	3	0	Plazi	ffb07bec-2d10-492d-9c37-361fe0b79427	406c81a1-0a29-444b-93b6-09b36cf6949d
0	36	36	Ocean Biodiversity Information System	ba0670b9-4186-41e6-8e70-f9cb3065551a	41aad037-bb83-4076-a4b8-69fcbd4840c8
6	6	0	Plazi	ffb07bec-2d10-492d-9c37-361fe0b79427	42f84d0d-d8a1-46a0-b49e-72cc19fa378f
154	154	0	GBIF Norway	4f829580-180d-46a9-9c87-ed8ec959b545	4359b08c-37a2-4ec9-98a5-ce4887fc3a80
3	3	0	Plazi	ffb07bec-2d10-492d-9c37-361fe0b79427	44b592de-b878-417f-80e1-a651f83183ad
0	2	2	Plazi	ffb07bec-2d10-492d-9c37-361fe0b79427	484377d7-cffc-4c15-ad63-4c74fdb0ca92
1489	1489	0	GBIF Norway	4f829580-180d-46a9-9c87-ed8ec959b545	493bfee8-d76a-4b41-a187-89f62396fcd2
0	10	10	Plazi	ffb07bec-2d10-492d-9c37-361fe0b79427	49984055-6941-439f-b636-f5416a9417e3
1	1	0	Colombian Biodiversity Information System	7e865cba-7c46-417b-ade5-97f2cf5b7be0	4b4b0262-b436-4321-aecf-39f109d24b44
302	302	0	Participant Node Managers Committee	7f48e0c8-5c96-49ec-b972-30748e339115	4d2693ea-6151-49aa-98f8-6bf5e1409f78
1781	1781	0	Colombian Biodiversity Information System	7e865cba-7c46-417b-ade5-97f2cf5b7be0	4d3215ae-45aa-4391-9bac-599ead810450
38841	38841	0	GBIF France	da44cd31-5901-4687-a106-6d1c7734ee3a	4d608085-da7f-4c86-bc7d-7f5a142b6496
3	3	0	Plazi	ffb07bec-2d10-492d-9c37-361fe0b79427	4dac8867-93bd-421b-93f1-5cc7f684fa7f
2	2	0	Plazi	ffb07bec-2d10-492d-9c37-361fe0b79427	4ef13a2d-67f5-428f-ac5c-624fb1da7bb9
0	8	8	Plazi	ffb07bec-2d10-492d-9c37-361fe0b79427	51b2c494-8a51-4c80-bfdd-98240d6f4c07
1303	1303	0	GBIF Japan	db5705aa-6a6e-42f1-8942-d77b9f4896ea	53c94997-8758-4261-91d9-ac9f4ebe73d2
8	8	0	Plazi	ffb07bec-2d10-492d-9c37-361fe0b79427	54ab2c2c-a556-4b2b-980d-ada305a6dea9
313	313	0	GBIF Germany	4f6826f2-4ff6-443d-b966-e6913bd24013	574e732b-19eb-450a-956c-da90e68e3508
0	17	17	Ocean Biodiversity Information System	ba0670b9-4186-41e6-8e70-f9cb3065551a	5a8ed410-33dd-45bd-a514-6440fc5dfd63
1	1	0	Plazi	ffb07bec-2d10-492d-9c37-361fe0b79427	5b4fbacd-3b8c-49af-9db9-b333c7d56b42
27493	27493	0	GBIF France	da44cd31-5901-4687-a106-6d1c7734ee3a	601540ae-e975-48b7-87a8-a4a663f10e68
102	102	0	GBIF Germany	4f6826f2-4ff6-443d-b966-e6913bd24013	611decac-f762-11e1-a439-00145eb45e9a
3513	3540	27	GBIF France	da44cd31-5901-4687-a106-6d1c7734ee3a	614122e1-7e55-4f0f-a616-a4c454664f10
271	271	0	GBIF Germany	4f6826f2-4ff6-443d-b966-e6913bd24013	614a2be6-f762-11e1-a439-00145eb45e9a
83	83	0	GBIF Germany	4f6826f2-4ff6-443d-b966-e6913bd24013	626ac04e-f762-11e1-a439-00145eb45e9a
0	57	57	GBIF Switzerland	169eb292-376b-4cc6-8e31-9c2c432de0ad	628649b7-7add-4df8-8f99-ca8bff5addc7
138	138	0	GBIF Germany	4f6826f2-4ff6-443d-b966-e6913bd24013	63a4e0b6-f762-11e1-a439-00145eb45e9a
4515	4515	0	GBIF France	da44cd31-5901-4687-a106-6d1c7734ee3a	640a45f3-ccdf-4df1-9675-62e1993073ad
0	38	38	Ocean Biodiversity Information System	ba0670b9-4186-41e6-8e70-f9cb3065551a	642ab4a1-21e9-4ec8-b03f-9ccd2f8e7721
40	40	0	GBIF Germany	4f6826f2-4ff6-443d-b966-e6913bd24013	647d2728-f762-11e1-a439-00145eb45e9a
15	15	0	Plazi	ffb07bec-2d10-492d-9c37-361fe0b79427	6496901c-5528-4fe3-96d6-0f4cf2be9c10
559	559	0	Belgian Biodiversity Platform	fb11cfe1-ebc3-45af-9159-17d9fddbcdac	64c7444f-e982-492c-aa57-560f9b5bb53d
23	23	0	Plazi	ffb07bec-2d10-492d-9c37-361fe0b79427	654c9653-fbef-4d0d-9e07-619084ac1162
184	176	-8	GBIF Germany	4f6826f2-4ff6-443d-b966-e6913bd24013	65660bc8-f762-11e1-a439-00145eb45e9a
11165	11165	0	GBIF France	da44cd31-5901-4687-a106-6d1c7734ee3a	656fa586-ec8a-4d27-aaa2-a54629c82296
181	181	0	GBIF France	da44cd31-5901-4687-a106-6d1c7734ee3a	657b5a96-a07d-44f0-bb6d-15e408fc2644
191	191	0	Participant Node Managers Committee	7f48e0c8-5c96-49ec-b972-30748e339115	65d3fd1e-8dad-458b-aa30-a5c810fd4479
60	60	0	GBIF Germany	4f6826f2-4ff6-443d-b966-e6913bd24013	671c4b8a-f762-11e1-a439-00145eb45e9a
187	187	0	GBIF Germany	4f6826f2-4ff6-443d-b966-e6913bd24013	682a125a-f762-11e1-a439-00145eb45e9a
8	8	0	GBIF Germany	4f6826f2-4ff6-443d-b966-e6913bd24013	6aeededa-f762-11e1-a439-00145eb45e9a
30	30	0	GBIF Germany	4f6826f2-4ff6-443d-b966-e6913bd24013	6b9f3514-f762-11e1-a439-00145eb45e9a
357	357	0	South African Biodiversity Information Facility	7190b835-4e86-4b6e-85c1-19cc6677c250	6bb80b44-eeca-4e23-9f39-3748d126bf6c
16	16	0	GBIF Germany	4f6826f2-4ff6-443d-b966-e6913bd24013	6bbc8fc4-f762-11e1-a439-00145eb45e9a
13	13	0	GBIF Germany	4f6826f2-4ff6-443d-b966-e6913bd24013	6fbb78f6-f762-11e1-a439-00145eb45e9a
314	314	0	GBIF Germany	4f6826f2-4ff6-443d-b966-e6913bd24013	7054a54e-f762-11e1-a439-00145eb45e9a
0	7	7	Plazi	ffb07bec-2d10-492d-9c37-361fe0b79427	7123fdb0-9d87-4cb8-a05a-67602fb0ba3d
99	99	0	GBIF Germany	4f6826f2-4ff6-443d-b966-e6913bd24013	717b3a8c-f762-11e1-a439-00145eb45e9a
0	4000	4000	Biodiversity Information System of Mexico	b324e8e9-9a4c-44fa-8f1a-7f39ea7ab576	749dd468-22d4-4379-893d-352606a6f2d7
0	99	99	Colombian Biodiversity Information System	7e865cba-7c46-417b-ade5-97f2cf5b7be0	75c2a328-8f20-49af-aa5e-1a743a0d4444
15	15	0	GBIF Germany	4f6826f2-4ff6-443d-b966-e6913bd24013	75f38466-f762-11e1-a439-00145eb45e9a
106	106	0	GBIF Germany	4f6826f2-4ff6-443d-b966-e6913bd24013	7602e212-f762-11e1-a439-00145eb45e9a
50	50	0	Ocean Biodiversity Information System	ba0670b9-4186-41e6-8e70-f9cb3065551a	770fe37c-52e7-4efb-9686-0c082d0c6b23
13	13	0	GBIF Germany	4f6826f2-4ff6-443d-b966-e6913bd24013	7905489c-f762-11e1-a439-00145eb45e9a
54	27	-27	GBIF Germany	4f6826f2-4ff6-443d-b966-e6913bd24013	79ba9c06-f762-11e1-a439-00145eb45e9a
19	19	0	GBIF Germany	4f6826f2-4ff6-443d-b966-e6913bd24013	7a7ebc8a-f762-11e1-a439-00145eb45e9a
3	3	0	GBIF Germany	4f6826f2-4ff6-443d-b966-e6913bd24013	7a98393a-f762-11e1-a439-00145eb45e9a
513	513	0	Participant Node Managers Committee	7f48e0c8-5c96-49ec-b972-30748e339115	7b3aed72-4d4f-469d-87b8-8bfcebe93573
0	2	2	Plazi	ffb07bec-2d10-492d-9c37-361fe0b79427	7babd33a-a68e-4c9c-9bbf-dd2d6bbfcb45
0	3	3	Plazi	ffb07bec-2d10-492d-9c37-361fe0b79427	7c457252-c0e4-4b22-8ba6-2895c3462701
2975	2975	0	GBIF Uruguay	a3ceb6dd-0a65-4f30-a385-30f6937c2096	7d13fdbc-a2d0-4c71-828b-fcc5cb502faa
84	84	0	GBIF Brazil	cdc9736d-5ff7-4ece-9959-3c744360cdb3	7d8548df-4f5b-4342-ba6f-75e652b09909
312	312	0	GBIF Germany	4f6826f2-4ff6-443d-b966-e6913bd24013	7da169c6-f762-11e1-a439-00145eb45e9a
69	66	-3	GBIF Germany	4f6826f2-4ff6-443d-b966-e6913bd24013	7e834986-f762-11e1-a439-00145eb45e9a
115	97	-18	GBIF Germany	4f6826f2-4ff6-443d-b966-e6913bd24013	7e88f5ca-f762-11e1-a439-00145eb45e9a
814	814	0	GBIF Germany	4f6826f2-4ff6-443d-b966-e6913bd24013	7eb47d1c-f762-11e1-a439-00145eb45e9a
199307	199307	0	DanBIF - Danish Biodiversity Information Facility	4ddd294f-02b7-4359-ac33-0806a9ca9c6b	7f513bfc-f762-11e1-a439-00145eb45e9a
0	4	4	Plazi	ffb07bec-2d10-492d-9c37-361fe0b79427	7fc75baa-2e48-490b-9a6e-256378b4531e
11	11	0	Plazi	ffb07bec-2d10-492d-9c37-361fe0b79427	80b0d699-ec84-4a49-af28-752a1a146226
8615	8615	0	Atlas of Living Australia	4a6f1b71-969e-4fc5-a693-282b05e1220c	8102988d-73b9-4ee0-8cd5-c73e2378b5d3
603	603	0	Polish Biodiversity Information Network	2618bfdf-e194-4911-a241-80db3107bc51	81fb06c0-af9d-11db-ad75-b8a03c50a862
0	4	4	Plazi	ffb07bec-2d10-492d-9c37-361fe0b79427	82b6d635-d191-4296-bd88-7f674ef180e0
1009	916	-93	GBIF Germany	4f6826f2-4ff6-443d-b966-e6913bd24013	856aa56e-f762-11e1-a439-00145eb45e9a
0	998	998	Ocean Biodiversity Information System	ba0670b9-4186-41e6-8e70-f9cb3065551a	8753a2c6-eafc-49d5-879d-eed5e5258656
6004	5065	-939	GBIF Germany	4f6826f2-4ff6-443d-b966-e6913bd24013	87558f9c-f762-11e1-a439-00145eb45e9a
2080	1804	-276	GBIF Germany	4f6826f2-4ff6-443d-b966-e6913bd24013	8c27c8c4-4eb5-49e4-9c06-1b702506d904
48	48	0	GBIF Germany	4f6826f2-4ff6-443d-b966-e6913bd24013	8c82c7be-f762-11e1-a439-00145eb45e9a
98	98	0	GBIF Germany	4f6826f2-4ff6-443d-b966-e6913bd24013	8c9590f6-f762-11e1-a439-00145eb45e9a
15	9	-6	GBIF Germany	4f6826f2-4ff6-443d-b966-e6913bd24013	8d2b5d20-f762-11e1-a439-00145eb45e9a
114	114	0	GBIF Sweden	a0b3be64-6525-4387-ac67-a499950f92e1	8db1e9dd-ccac-4d65-92dd-8d619425a3e4
19	19	0	GBIF Germany	4f6826f2-4ff6-443d-b966-e6913bd24013	8e124c6c-f762-11e1-a439-00145eb45e9a
40	39	-1	GBIF Germany	4f6826f2-4ff6-443d-b966-e6913bd24013	8fae4634-f762-11e1-a439-00145eb45e9a
0	9	9	Plazi	ffb07bec-2d10-492d-9c37-361fe0b79427	91cad29c-39ec-4453-acfa-e641f072bb2d
4	4	0	GBIF Germany	4f6826f2-4ff6-443d-b966-e6913bd24013	92b04eb8-f762-11e1-a439-00145eb45e9a
158	158	0	GBIF Germany	4f6826f2-4ff6-443d-b966-e6913bd24013	92bb353a-f762-11e1-a439-00145eb45e9a
0	15	15	Plazi	ffb07bec-2d10-492d-9c37-361fe0b79427	934e4a85-c3d6-4a6c-a314-3621f10a3f7e
0	600	600	Colombian Biodiversity Information System	7e865cba-7c46-417b-ade5-97f2cf5b7be0	936fc8d7-5cd3-460e-98a4-c29c55cd3d02
13	13	0	GBIF Germany	4f6826f2-4ff6-443d-b966-e6913bd24013	93e2f592-f762-11e1-a439-00145eb45e9a
65	65	0	GBIF Germany	4f6826f2-4ff6-443d-b966-e6913bd24013	93e94cd0-f762-11e1-a439-00145eb45e9a
29	29	0	GBIF Germany	4f6826f2-4ff6-443d-b966-e6913bd24013	956ed1a6-f762-11e1-a439-00145eb45e9a
833709	833709	0	U.S. Geological Survey	8618c64a-93e0-4300-b546-7249e5148ed2	96c93a1e-f762-11e1-a439-00145eb45e9a
1291	1291	0	GBIF Germany	4f6826f2-4ff6-443d-b966-e6913bd24013	97c2f1b2-42f5-45ca-9248-adb4b53fe491
849	849	0	Colombian Biodiversity Information System	7e865cba-7c46-417b-ade5-97f2cf5b7be0	9805e163-aae9-4489-9af3-5bfadaa65de2
0	12	12	Plazi	ffb07bec-2d10-492d-9c37-361fe0b79427	9b8d33b9-c9df-4f9d-abeb-de1c7b84f3e0
307	307	0	GBIF Cameroon	cfe0cad9-2bf4-4d16-ae33-c3dfb0da1ed9	9e75dcd2-1f69-432c-958e-c771e7540d27
0	63	63	Plazi	ffb07bec-2d10-492d-9c37-361fe0b79427	9f7f6969-7f7b-4ab8-8861-1b5c1a647233
1382	1382	0	National Biodiversity Network	d897a5b9-35ee-4232-94bd-b0bcaac003c2	9ffd5049-d976-4bd4-ac57-9666a20a66d2
0	13	13	Plazi	ffb07bec-2d10-492d-9c37-361fe0b79427	a03ecce2-b526-4f94-aa65-620016956099
168	168	0	Colombian Biodiversity Information System	7e865cba-7c46-417b-ade5-97f2cf5b7be0	a0b54745-9319-47e2-b137-86c49edbc1a6
0	5665	5665	Ocean Biodiversity Information System	ba0670b9-4186-41e6-8e70-f9cb3065551a	a3e4e91c-0848-4e20-99f2-a0f72abb646c
0	40731	40731	Biodiversity Information System of Mexico	b324e8e9-9a4c-44fa-8f1a-7f39ea7ab576	a47100e5-9384-4a89-b24f-74bf2ae58368
0	2	2	Plazi	ffb07bec-2d10-492d-9c37-361fe0b79427	a4e329f2-f716-4667-9641-09afc812a6ab
135	135	0	GBIF France	da44cd31-5901-4687-a106-6d1c7734ee3a	a8cc99b3-49e3-4bce-9b9e-76819a959451
2	2	0	Plazi	ffb07bec-2d10-492d-9c37-361fe0b79427	a9de1b8d-fc5a-4583-aca7-fb82c9e02703
8793	8793	0	GBIF Germany	4f6826f2-4ff6-443d-b966-e6913bd24013	ab1de8e9-8a18-4ffe-b2c6-e13ffbec3e7e
4268	4268	0	GBIF France	da44cd31-5901-4687-a106-6d1c7734ee3a	ae909e95-2935-4476-8643-63d476103cb5
41	41	0	Plazi	ffb07bec-2d10-492d-9c37-361fe0b79427	b18884c2-241d-4de3-b8a9-df75cf161019
2045	2045	0	GBIF Germany	4f6826f2-4ff6-443d-b966-e6913bd24013	b886b2a4-34c4-4973-bd36-7744f9e8087f
1	1	0	Plazi	ffb07bec-2d10-492d-9c37-361fe0b79427	b8b4f8df-8f3b-41ac-aa3c-a465c8093450
0	4	4	Ocean Biodiversity Information System	ba0670b9-4186-41e6-8e70-f9cb3065551a	bdbe7f95-ba58-4849-a1d3-6db111bc305d
4	4	0	Plazi	ffb07bec-2d10-492d-9c37-361fe0b79427	bfbbc6d9-281a-4202-8af1-af25d360a72d
18	18	0	Plazi	ffb07bec-2d10-492d-9c37-361fe0b79427	c180b7be-a5ae-4454-bdd6-c60ac7e7e3dc
6	6	0	Plazi	ffb07bec-2d10-492d-9c37-361fe0b79427	c3a2c139-567a-4023-b915-76b13ccc8ef5
863	863	0	GBIF France	da44cd31-5901-4687-a106-6d1c7734ee3a	c423d888-a05a-4f39-bf31-c3124d324d26
14	14	0	Plazi	ffb07bec-2d10-492d-9c37-361fe0b79427	c547750e-d359-4f2b-8f77-310ef6648d7c
0	179333	179333	GBIF Austria	1e789bc9-79fc-4e60-a49e-89dfc45a7188	c7730a08-74b4-48cd-80a7-831a19ac660d
1	1	0	Plazi	ffb07bec-2d10-492d-9c37-361fe0b79427	cac24909-bfab-44a9-b4d4-5a86ada211e1
0	122	122	Plazi	ffb07bec-2d10-492d-9c37-361fe0b79427	cf4856a2-ba4a-4a53-bcf4-9ac3dc863677
0	7187	7187	Participant Node Managers Committee	7f48e0c8-5c96-49ec-b972-30748e339115	cf750a05-25f2-459b-8891-1a1fd23d7bf8
230	240	10	GBIF Germany	4f6826f2-4ff6-443d-b966-e6913bd24013	d11c353e-ad65-40d9-b186-e40d21afd6d1
0	152	152	Plazi	ffb07bec-2d10-492d-9c37-361fe0b79427	d1af16b2-9b8e-45e3-99b4-3caf7d467130
9594	9594	0	Participant Node Managers Committee	7f48e0c8-5c96-49ec-b972-30748e339115	d7688dd5-9cd0-4de7-8873-e76b709ee082
0	3	3	Plazi	ffb07bec-2d10-492d-9c37-361fe0b79427	d95cbcd5-5df7-4497-b9cf-67a9a416f370
585	585	0	Colombian Biodiversity Information System	7e865cba-7c46-417b-ade5-97f2cf5b7be0	da2d1fcb-55c1-4058-b1a8-23e098035a0f
172	172	0	Plazi	ffb07bec-2d10-492d-9c37-361fe0b79427	da69a4c8-2962-4d6d-9abf-627b77bb9116
184	184	0	Plazi	ffb07bec-2d10-492d-9c37-361fe0b79427	dc3253d4-edc8-481b-966e-791e40856534
2089	2089	0	Participant Node Managers Committee	7f48e0c8-5c96-49ec-b972-30748e339115	deef3b8f-0114-47f8-849a-bcd74e51743f
3220	3220	0	National Biodiversity Network	d897a5b9-35ee-4232-94bd-b0bcaac003c2	e9212562-134b-4f54-9c48-81e303082c3e
757	757	0	National Biodiversity Network	d897a5b9-35ee-4232-94bd-b0bcaac003c2	eb6a3e51-a4d1-4ce2-90b9-4f659149ccfe
9	9	0	Plazi	ffb07bec-2d10-492d-9c37-361fe0b79427	ec1fb289-7c2d-4883-a488-aaf93a4a5da6
0	1	1	Ocean Biodiversity Information System	ba0670b9-4186-41e6-8e70-f9cb3065551a	ecc90dc8-d2f8-40dc-a0b9-e06e00a4375e
1357	1357	0	Atlas of Living Australia	4a6f1b71-969e-4fc5-a693-282b05e1220c	edd9ef2e-2229-406f-8dcc-4eab3cea3009
0	30	30	Ocean Biodiversity Information System	ba0670b9-4186-41e6-8e70-f9cb3065551a	f0266f96-13b5-4d04-ad70-2a4756af7e77
0	47	47	Ocean Biodiversity Information System	ba0670b9-4186-41e6-8e70-f9cb3065551a	f0a04253-5760-4475-bf52-2e56e408a932
6927	6927	0	Colombian Biodiversity Information System	7e865cba-7c46-417b-ade5-97f2cf5b7be0	f0af2e67-7404-4502-8db2-fd1db960de42
3	3	0	Plazi	ffb07bec-2d10-492d-9c37-361fe0b79427	f128e1f6-f296-4aba-b4f4-627454f78985
0	34	34	Plazi	ffb07bec-2d10-492d-9c37-361fe0b79427	f1355bbf-a881-4136-8a8f-6c7a98ddfdc9
650	650	0	GBIF Argentina	2426a871-9feb-40a1-96c6-0c593a76b835	f14ebfac-2c64-403c-ad74-8abcb20a9da8
20	20	0	Plazi	ffb07bec-2d10-492d-9c37-361fe0b79427	f745ab1d-8331-46e6-bee0-b6ed0c10dfcb
3630	3630	0	Ocean Biodiversity Information System	ba0670b9-4186-41e6-8e70-f9cb3065551a	f7c30fac-cf80-471f-8343-4ec5d8594661
882	882	0	Ocean Biodiversity Information System	ba0670b9-4186-41e6-8e70-f9cb3065551a	f85dc597-d683-4038-8a09-cad4efd9804d
57	57	0	Plazi	ffb07bec-2d10-492d-9c37-361fe0b79427	fc23db36-464b-42fb-b4dc-95d6df92600b
10687	10687	0	Participant Node Managers Committee	7f48e0c8-5c96-49ec-b972-30748e339115	fd61e581-4db6-4fa8-8c27-79e118459f42
0	29	29	Ocean Biodiversity Information System	ba0670b9-4186-41e6-8e70-f9cb3065551a	03983473-6be0-4791-85a9-4e4c9da27bfd
0	42	42	Plazi	ffb07bec-2d10-492d-9c37-361fe0b79427	042a50ef-756e-4ca9-a4c3-4476f580c97a
16580	16580	0	National Biodiversity Network	d897a5b9-35ee-4232-94bd-b0bcaac003c2	04a041d6-bfa9-4efd-97f4-3a016e973f37
0	12	12	Plazi	ffb07bec-2d10-492d-9c37-361fe0b79427	07103a61-bc26-4fcc-8d1f-4e8bdcc5dbfa
57	57	0	Plazi	ffb07bec-2d10-492d-9c37-361fe0b79427	0902a30e-ae54-4064-9088-78904d141ab4
5824	5824	0	Belgian Biodiversity Platform	fb11cfe1-ebc3-45af-9159-17d9fddbcdac	0ac24b3c-feb9-48d5-bf02-da4a103f024e
6	6	0	Plazi	ffb07bec-2d10-492d-9c37-361fe0b79427	0f10cb02-b704-404d-a6fe-7c82cce3a800
343	343	0	GBIF France	da44cd31-5901-4687-a106-6d1c7734ee3a	0f2f6bc5-b352-47c6-8e96-9e0eda5ba3e3
0	18	18	Plazi	ffb07bec-2d10-492d-9c37-361fe0b79427	10d811a7-73f7-4607-8cca-4e92a82d1920
2510	2510	0	Participant Node Managers Committee	7f48e0c8-5c96-49ec-b972-30748e339115	13456803-0361-461e-b957-ce325bc14e62
0	1	1	Ocean Biodiversity Information System	ba0670b9-4186-41e6-8e70-f9cb3065551a	1349d4db-702a-4a7e-bfbf-2e883f80d006
398	398	0	Plazi	ffb07bec-2d10-492d-9c37-361fe0b79427	14c29731-224f-43a4-ae52-f76823177ce5
1618	1618	0	Colombian Biodiversity Information System	7e865cba-7c46-417b-ade5-97f2cf5b7be0	160d7e0a-a763-4258-8ffd-db097ee8f2ab
578	578	0	GBIF Germany	4f6826f2-4ff6-443d-b966-e6913bd24013	16c2d561-696a-4704-bfab-0a064e6fbccc
3	3	0	Plazi	ffb07bec-2d10-492d-9c37-361fe0b79427	177834b8-34fc-4ba0-8105-92eae1988509
22	22	0	Plazi	ffb07bec-2d10-492d-9c37-361fe0b79427	18217220-d11b-442c-bf11-2de479497f5f
283	283	0	U.S. Geological Survey	8618c64a-93e0-4300-b546-7249e5148ed2	1937bcf8-1006-4dfd-baf8-a16de64b321e
0	11	11	Plazi	ffb07bec-2d10-492d-9c37-361fe0b79427	1b7f1868-4ce1-4490-8b6a-b2580f023998
0	16	16	Plazi	ffb07bec-2d10-492d-9c37-361fe0b79427	1c47f462-90bf-4b94-ba14-6ac0f08050fc
0	144	144	Ocean Biodiversity Information System	ba0670b9-4186-41e6-8e70-f9cb3065551a	1df4f7e5-9038-415b-99b7-303fdf810cf8
1	1	0	Plazi	ffb07bec-2d10-492d-9c37-361fe0b79427	1f3f2b2b-5f1f-4d99-8e51-614be7703abd
0	40	40	Plazi	ffb07bec-2d10-492d-9c37-361fe0b79427	1fb56719-70a0-461c-a6e3-642f454d1459
3	3	0	Plazi	ffb07bec-2d10-492d-9c37-361fe0b79427	204d614c-1d8b-40df-a492-ec8683d3188f
1362	2362	1000	GBIF Japan	db5705aa-6a6e-42f1-8942-d77b9f4896ea	2087881f-6373-475e-81f8-100e32176c90
0	36	36	Participant Node Managers Committee	7f48e0c8-5c96-49ec-b972-30748e339115	22914bef-d1f8-410b-86ba-eabe44773988
51110	51110	0	GBIF Norway	4f829580-180d-46a9-9c87-ed8ec959b545	23217c21-b3e3-4a39-b699-14924cdc1ad3
10	10	0	Plazi	ffb07bec-2d10-492d-9c37-361fe0b79427	255c331c-4667-4bdd-8c3b-86eac44e7cd6
23	23	0	GBIF France	da44cd31-5901-4687-a106-6d1c7734ee3a	26662939-892d-422f-8c82-ffa4843bc185
0	3	3	Ocean Biodiversity Information System	ba0670b9-4186-41e6-8e70-f9cb3065551a	26f5eb76-3c83-4d8d-aa98-a5db581ad504
0	2289	2289	Indonesian Biodiversity Information Facility	2ebd91f6-f14f-4375-b525-c011a3774f03	28c04664-55cb-445d-9a1c-d34c80a8d8b3
53	53	0	GBIF France	da44cd31-5901-4687-a106-6d1c7734ee3a	29d08590-2654-41b3-adcc-eb1ada09d7a0
186	208	22	GBIF France	da44cd31-5901-4687-a106-6d1c7734ee3a	2a4fd70a-468d-4af6-8ff3-d81adefb79f6
0	23	23	Plazi	ffb07bec-2d10-492d-9c37-361fe0b79427	2b5b3767-aea0-4d53-9e05-c7b08649db90
446	446	0	Plazi	ffb07bec-2d10-492d-9c37-361fe0b79427	2b7bf048-65d5-4814-bbdb-59d53d15b00e
114795	114795	0	GBIF France	da44cd31-5901-4687-a106-6d1c7734ee3a	2e409ff6-7714-417e-89ef-678207f66071
7187	7187	0	Biodiversity Information System of Mexico	b324e8e9-9a4c-44fa-8f1a-7f39ea7ab576	2e8ffb5b-d515-4245-abd4-dc4f6b20955d
0	184	184	Plazi	ffb07bec-2d10-492d-9c37-361fe0b79427	30055aa0-b2cb-4941-8484-9b395fcb1f28
8	8	0	Participant Node Managers Committee	7f48e0c8-5c96-49ec-b972-30748e339115	33a4d230-7d4e-499a-bec1-bdd16daba6c1
12	650	638	GBIF Germany	4f6826f2-4ff6-443d-b966-e6913bd24013	360aafde-20fe-452b-a376-12d0e4e40102
255	255	0	GBIF France	da44cd31-5901-4687-a106-6d1c7734ee3a	36dff45b-aff4-463d-953a-8c08d965cf7a
0	2	2	Plazi	ffb07bec-2d10-492d-9c37-361fe0b79427	38f78e6b-c573-4b3b-b5f9-1b678e422d19
6	6	0	Plazi	ffb07bec-2d10-492d-9c37-361fe0b79427	39a246c4-5ef1-43f9-97e9-851799f278e7
1058	1058	0	Biodiversity Information System of Mexico	b324e8e9-9a4c-44fa-8f1a-7f39ea7ab576	3a489e55-ec80-4c62-b6aa-4911372d23c2
6	6	0	Plazi	ffb07bec-2d10-492d-9c37-361fe0b79427	3b68a47c-bf17-4ad9-9203-81b310cd5452
0	2	2	Plazi	ffb07bec-2d10-492d-9c37-361fe0b79427	3d9cdace-fdc0-4532-adab-a9f4383ced09
898	898	0	Ocean Biodiversity Information System	ba0670b9-4186-41e6-8e70-f9cb3065551a	43524467-3aab-4074-8b2d-5c600f79c85e
0	12	12	Plazi	ffb07bec-2d10-492d-9c37-361fe0b79427	43f9010f-17d7-41d4-9312-2c27532e927f
0	604	604	Plazi	ffb07bec-2d10-492d-9c37-361fe0b79427	474fa7c8-06db-4648-b5a7-e53bb44a917e
0	1	1	Plazi	ffb07bec-2d10-492d-9c37-361fe0b79427	49b34e74-6bc5-4eb4-8892-6c40a5102937
2	2	0	Plazi	ffb07bec-2d10-492d-9c37-361fe0b79427	49b90977-461c-483f-b143-20d761b9ea39
2659	2659	0	GBIF Germany	4f6826f2-4ff6-443d-b966-e6913bd24013	49ec8f77-ac58-4b95-97c1-272d96e837c0
316	316	0	Plazi	ffb07bec-2d10-492d-9c37-361fe0b79427	4d4cc07e-3729-4179-90e1-cf469370776a
0	2	2	Plazi	ffb07bec-2d10-492d-9c37-361fe0b79427	517299e0-fa50-41bd-8094-5056ef856892
1	1	0	Colombian Biodiversity Information System	7e865cba-7c46-417b-ade5-97f2cf5b7be0	56b1a75f-6bf7-47ff-bcdb-a4d402172b1d
17502	29964	12462	National Biodiversity Network	d897a5b9-35ee-4232-94bd-b0bcaac003c2	5744948f-0530-407d-bdaa-60ef7bba9709
0	167	167	Ocean Biodiversity Information System	ba0670b9-4186-41e6-8e70-f9cb3065551a	5bd38e13-3ff3-47b4-ba27-a345d88f93ab
7	7	0	Plazi	ffb07bec-2d10-492d-9c37-361fe0b79427	5d153d92-2669-4449-9bae-b203a621ed78
0	6	6	Plazi	ffb07bec-2d10-492d-9c37-361fe0b79427	5e2cbcdd-1887-48ab-9c07-8763aa32c869
37	37	0	Plazi	ffb07bec-2d10-492d-9c37-361fe0b79427	5f59c6eb-bc48-43e2-a98c-c5a62f2dbf10
2	2	0	Plazi	ffb07bec-2d10-492d-9c37-361fe0b79427	611cca30-d360-44bb-9be7-18b06bb6313d
0	1244	1244	Participant Node Managers Committee	7f48e0c8-5c96-49ec-b972-30748e339115	6158f384-7465-422b-ad8d-3731b74d666a
0	155	155	Ocean Biodiversity Information System	ba0670b9-4186-41e6-8e70-f9cb3065551a	61651ddb-b412-420a-8bd6-8c65977df1cb
0	253	253	GBIF Switzerland	169eb292-376b-4cc6-8e31-9c2c432de0ad	6167d892-cb27-47cf-97d2-7257572b45b9
2	2	0	Participant Node Managers Committee	7f48e0c8-5c96-49ec-b972-30748e339115	62570119-0259-49bc-abe4-55fca5e64b26
0	21	21	Plazi	ffb07bec-2d10-492d-9c37-361fe0b79427	62e39670-8302-46d2-b881-1f6210c3cbc9
313	313	0	GBIF Germany	4f6826f2-4ff6-443d-b966-e6913bd24013	63925676-f762-11e1-a439-00145eb45e9a
52055	52055	0	Atlas of Living Australia	4a6f1b71-969e-4fc5-a693-282b05e1220c	64823037-f86c-4bc9-9cc5-439cf0b448df
48	48	0	GBIF Germany	4f6826f2-4ff6-443d-b966-e6913bd24013	6721391a-f762-11e1-a439-00145eb45e9a
133	133	0	GBIF Germany	4f6826f2-4ff6-443d-b966-e6913bd24013	67263302-f762-11e1-a439-00145eb45e9a
140	140	0	GBIF Germany	4f6826f2-4ff6-443d-b966-e6913bd24013	6744f22e-f762-11e1-a439-00145eb45e9a
11	11	0	Plazi	ffb07bec-2d10-492d-9c37-361fe0b79427	67477ca5-246c-46b9-9387-63463c0b5970
80	80	0	GBIF Germany	4f6826f2-4ff6-443d-b966-e6913bd24013	67513bba-f762-11e1-a439-00145eb45e9a
0	2	2	Plazi	ffb07bec-2d10-492d-9c37-361fe0b79427	67dd1a44-93ee-406e-a88e-e2121c9be992
2	2	0	Plazi	ffb07bec-2d10-492d-9c37-361fe0b79427	684b3f74-2bf6-42c6-b056-f819a0e43e68
1	1	0	GBIF Germany	4f6826f2-4ff6-443d-b966-e6913bd24013	68c9983e-f762-11e1-a439-00145eb45e9a
69	69	0	Plazi	ffb07bec-2d10-492d-9c37-361fe0b79427	6a4658b7-ce15-45fb-8985-b925e1490704
24	24	0	GBIF Germany	4f6826f2-4ff6-443d-b966-e6913bd24013	6ab4fdd2-f762-11e1-a439-00145eb45e9a
177	177	0	GBIF Sweden	a0b3be64-6525-4387-ac67-a499950f92e1	6ac374fd-3e50-4aa7-adfe-4ed1f1505778
0	8	8	Plazi	ffb07bec-2d10-492d-9c37-361fe0b79427	6ba99b76-0e4e-49d1-8732-5444643fef35
22	22	0	GBIF Germany	4f6826f2-4ff6-443d-b966-e6913bd24013	6bdfac20-f762-11e1-a439-00145eb45e9a
205	205	0	GBIF Germany	4f6826f2-4ff6-443d-b966-e6913bd24013	6c2c32d4-f762-11e1-a439-00145eb45e9a
108	108	0	Plazi	ffb07bec-2d10-492d-9c37-361fe0b79427	6d59feb3-23d2-4911-88b2-0db9163acf76
0	133	133	Colombian Biodiversity Information System	7e865cba-7c46-417b-ade5-97f2cf5b7be0	6dac4efc-29cc-4f91-92c0-308f1075c866
0	32	32	Plazi	ffb07bec-2d10-492d-9c37-361fe0b79427	6e5d2bf3-51e7-49e7-8c50-83ee03de0772
23400	23400	0	U.S. Geological Survey	8618c64a-93e0-4300-b546-7249e5148ed2	6fd297bb-888a-46a7-a870-1f5af1ab1616
0	69	69	Plazi	ffb07bec-2d10-492d-9c37-361fe0b79427	7026c184-1da2-4249-b0f1-083f2bf2cd90
69	69	0	GBIF Germany	4f6826f2-4ff6-443d-b966-e6913bd24013	71aff218-f762-11e1-a439-00145eb45e9a
7032	7032	0	South African Biodiversity Information Facility	7190b835-4e86-4b6e-85c1-19cc6677c250	71c89f07-0299-4d9d-9e80-3652cffdf308
35	35	0	GBIF Germany	4f6826f2-4ff6-443d-b966-e6913bd24013	72d258a2-f762-11e1-a439-00145eb45e9a
66	66	0	Plazi	ffb07bec-2d10-492d-9c37-361fe0b79427	742a5940-b342-45f0-b887-9208a10bd2d6
90	90	0	GBIF Germany	4f6826f2-4ff6-443d-b966-e6913bd24013	758b03aa-f762-11e1-a439-00145eb45e9a
161	161	0	Plazi	ffb07bec-2d10-492d-9c37-361fe0b79427	7753c3e4-2c97-40e8-9098-4d1b2fa88b2a
2	2	0	GBIF Germany	4f6826f2-4ff6-443d-b966-e6913bd24013	7895ab04-f762-11e1-a439-00145eb45e9a
42190	42190	0	Atlas of Living Australia	4a6f1b71-969e-4fc5-a693-282b05e1220c	792e64d5-c1ea-4bf2-b462-b377067cbdd1
72	61	-11	GBIF Germany	4f6826f2-4ff6-443d-b966-e6913bd24013	79681954-f762-11e1-a439-00145eb45e9a
613	613	0	GBIF Germany	4f6826f2-4ff6-443d-b966-e6913bd24013	7a16bf86-f762-11e1-a439-00145eb45e9a
0	2	2	Plazi	ffb07bec-2d10-492d-9c37-361fe0b79427	7ac77300-85a2-4aa2-9de8-3e5ebda4dc2b
1680	1610	-70	GBIF Germany	4f6826f2-4ff6-443d-b966-e6913bd24013	7c70b5a2-f762-11e1-a439-00145eb45e9a
16	8	-8	GBIF Germany	4f6826f2-4ff6-443d-b966-e6913bd24013	7d5d03e4-f762-11e1-a439-00145eb45e9a
153	135	-18	GBIF Germany	4f6826f2-4ff6-443d-b966-e6913bd24013	7d6a0bca-f762-11e1-a439-00145eb45e9a
77	77	0	GBIF Togo	c9659a3e-07e9-4fcb-83c6-de8b9009a02e	7dd753a3-568c-4d63-8480-fefcba8e5394
436	403	-33	GBIF Germany	4f6826f2-4ff6-443d-b966-e6913bd24013	7dd79f96-f762-11e1-a439-00145eb45e9a
1056	1056	0	Plazi	ffb07bec-2d10-492d-9c37-361fe0b79427	7ece7605-14ad-4446-bcf3-84bc929fd4e8
1848	1831	-17	Biodiversity Information System of Mexico	b324e8e9-9a4c-44fa-8f1a-7f39ea7ab576	7fabfa2e-f762-11e1-a439-00145eb45e9a
1031	1031	0	Biodiversity Information System of Mexico	b324e8e9-9a4c-44fa-8f1a-7f39ea7ab576	807a74b2-f762-11e1-a439-00145eb45e9a
6	6	0	GBIF Japan	db5705aa-6a6e-42f1-8942-d77b9f4896ea	810ce586-f762-11e1-a439-00145eb45e9a
0	718	718	Participant Node Managers Committee	7f48e0c8-5c96-49ec-b972-30748e339115	810eac26-0031-4af7-8733-d3711b4f5b03
14293	14293	0	GBIF Japan	db5705aa-6a6e-42f1-8942-d77b9f4896ea	811e481c-f762-11e1-a439-00145eb45e9a
44	44	0	Plazi	ffb07bec-2d10-492d-9c37-361fe0b79427	818f2c7b-6bd3-40d4-9f92-841c3ce9509b
15	15	0	GBIF Germany	4f6826f2-4ff6-443d-b966-e6913bd24013	81d5633a-f762-11e1-a439-00145eb45e9a
114567	114567	0	U.S. Geological Survey	8618c64a-93e0-4300-b546-7249e5148ed2	852628c6-f762-11e1-a439-00145eb45e9a
0	68	68	Plazi	ffb07bec-2d10-492d-9c37-361fe0b79427	8546cc08-7901-4a9e-bdd3-502a77cac879
47689	47689	0	GBIF Germany	4f6826f2-4ff6-443d-b966-e6913bd24013	857cea12-f762-11e1-a439-00145eb45e9a
1716	1477	-239	GBIF Germany	4f6826f2-4ff6-443d-b966-e6913bd24013	87235f9a-f762-11e1-a439-00145eb45e9a
237	237	0	Colombian Biodiversity Information System	7e865cba-7c46-417b-ade5-97f2cf5b7be0	87e727b8-27bf-476a-a8ce-df4f5b0514cd
260	241	-19	GBIF Germany	4f6826f2-4ff6-443d-b966-e6913bd24013	885d4786-f762-11e1-a439-00145eb45e9a
2450	2450	0	Polish Biodiversity Information Network	2618bfdf-e194-4911-a241-80db3107bc51	886dc5e0-13d9-11de-b2e1-b8a03c50a862
23	23	0	GBIF Germany	4f6826f2-4ff6-443d-b966-e6913bd24013	8890acac-f762-11e1-a439-00145eb45e9a
5030	5030	0	Participant Node Managers Committee	7f48e0c8-5c96-49ec-b972-30748e339115	88af45ca-a74e-4a6a-85e6-3d53683844b3
1208	967	-241	GBIF Germany	4f6826f2-4ff6-443d-b966-e6913bd24013	88d2e7a2-f762-11e1-a439-00145eb45e9a
414	414	0	GBIF Germany	4f6826f2-4ff6-443d-b966-e6913bd24013	899ba39a-f762-11e1-a439-00145eb45e9a
4483	5020	537	National Biodiversity Network	d897a5b9-35ee-4232-94bd-b0bcaac003c2	8b0588e2-6852-4553-951d-90c01eaaf90b
4	4	0	GBIF Germany	4f6826f2-4ff6-443d-b966-e6913bd24013	8ba3a7aa-f762-11e1-a439-00145eb45e9a
0	2	2	Plazi	ffb07bec-2d10-492d-9c37-361fe0b79427	8c551ff8-1bf5-428d-8833-39a64d03eb09
590	590	0	Colombian Biodiversity Information System	7e865cba-7c46-417b-ade5-97f2cf5b7be0	8d1da115-5835-43dc-b87a-6b579e1ddc79
59	59	0	GBIF Germany	4f6826f2-4ff6-443d-b966-e6913bd24013	8da063f4-f762-11e1-a439-00145eb45e9a
5	5	0	Plazi	ffb07bec-2d10-492d-9c37-361fe0b79427	8de569a5-ae44-4994-8313-57163e9a4514
20	20	0	GBIF Germany	4f6826f2-4ff6-443d-b966-e6913bd24013	8e27036e-f762-11e1-a439-00145eb45e9a
4026	2648	-1378	GBIF Germany	4f6826f2-4ff6-443d-b966-e6913bd24013	8f17c074-f762-11e1-a439-00145eb45e9a
853	806	-47	GBIF Germany	4f6826f2-4ff6-443d-b966-e6913bd24013	8f793fca-f762-11e1-a439-00145eb45e9a
5454	2963	-2491	GBIF Germany	4f6826f2-4ff6-443d-b966-e6913bd24013	8f93ca7a-f762-11e1-a439-00145eb45e9a
71	36	-35	GBIF Germany	4f6826f2-4ff6-443d-b966-e6913bd24013	8fa07770-f762-11e1-a439-00145eb45e9a
167	141	-26	GBIF Germany	4f6826f2-4ff6-443d-b966-e6913bd24013	9145b130-f762-11e1-a439-00145eb45e9a
9	7	-2	GBIF Germany	4f6826f2-4ff6-443d-b966-e6913bd24013	9194b87a-f762-11e1-a439-00145eb45e9a
1748	1140	-608	GBIF Germany	4f6826f2-4ff6-443d-b966-e6913bd24013	91acc88e-f762-11e1-a439-00145eb45e9a
1	1	0	Plazi	ffb07bec-2d10-492d-9c37-361fe0b79427	9259cefa-5f61-4a0c-900e-2a9164948293
160	160	0	GBIF Germany	4f6826f2-4ff6-443d-b966-e6913bd24013	92a12da2-f762-11e1-a439-00145eb45e9a
1	1	0	Plazi	ffb07bec-2d10-492d-9c37-361fe0b79427	95c435ed-8c38-485f-83c1-cd7bf2289482
7155	7155	0	GBIF Spain	1f94b3ca-9345-4d65-afe2-4bace93aa0fe	95eb1ffe-f762-11e1-a439-00145eb45e9a
11961	11961	0	Biodiversity Information System of Mexico	b324e8e9-9a4c-44fa-8f1a-7f39ea7ab576	96acabd8-f762-11e1-a439-00145eb45e9a
99	99	0	GBIF Germany	4f6826f2-4ff6-443d-b966-e6913bd24013	97594fe6-f762-11e1-a439-00145eb45e9a
14	14	0	Plazi	ffb07bec-2d10-492d-9c37-361fe0b79427	977e2aff-2a28-4097-ac6c-91f84214c448
38	38	0	Plazi	ffb07bec-2d10-492d-9c37-361fe0b79427	97b3cd0d-2b88-4a38-bf97-ced69cbff4b4
6	6	0	Plazi	ffb07bec-2d10-492d-9c37-361fe0b79427	988b529d-e4d1-4bfb-8c82-8053c744f623
1	1	0	GBIF France	da44cd31-5901-4687-a106-6d1c7734ee3a	98ba9f24-4c60-47ea-9ce2-22402252f10c
3	3	0	Plazi	ffb07bec-2d10-492d-9c37-361fe0b79427	9a879074-b769-4180-8336-7178b7db5ae6
0	775	775	Plazi	ffb07bec-2d10-492d-9c37-361fe0b79427	9d719bcd-20aa-4dc8-8ebe-274abb4c41d8
108	108	0	Plazi	ffb07bec-2d10-492d-9c37-361fe0b79427	9de6d04b-eb21-45ec-b287-c368c1106b40
12	12	0	Plazi	ffb07bec-2d10-492d-9c37-361fe0b79427	9f0f8c65-95ab-44cc-be40-b5b500b1aef6
2	2	0	Plazi	ffb07bec-2d10-492d-9c37-361fe0b79427	a3754305-9706-4683-92ea-dd9319bda01b
371	371	0	Atlas of Living Australia	4a6f1b71-969e-4fc5-a693-282b05e1220c	a3fbbbf6-01ce-45f5-8cba-2a285af48200
4	4	0	Plazi	ffb07bec-2d10-492d-9c37-361fe0b79427	a6a9f38a-d8b5-48e5-86d6-070d5d9d6d8b
291	291	0	U.S. Geological Survey	8618c64a-93e0-4300-b546-7249e5148ed2	a8d8aa54-9900-4b6d-b2c5-b70a5a4eb790
0	4840	4840	U.S. Geological Survey	8618c64a-93e0-4300-b546-7249e5148ed2	a983a1df-ed19-4fe8-9d1e-47fa9c29dd56
3486	3486	0	Colombian Biodiversity Information System	7e865cba-7c46-417b-ade5-97f2cf5b7be0	ad40d9c6-1a48-4bcb-bc93-194a4226d51d
0	7	7	Plazi	ffb07bec-2d10-492d-9c37-361fe0b79427	adb128cc-532f-4c06-8a12-4a8e5351c6a0
1	1	0	Plazi	ffb07bec-2d10-492d-9c37-361fe0b79427	b0cbcdc0-2d55-4888-a4a6-a0b085ee3271
1455	1455	0	Scientific Committee on Antarctic Research	51e4e8ff-bff0-4996-8b27-9107d61b3478	b109fc97-b7b8-4432-a89a-5eaaadeee431
114	114	0	Plazi	ffb07bec-2d10-492d-9c37-361fe0b79427	b1aa1869-9519-4d18-ba2c-25e6517ff390
4	4	0	Plazi	ffb07bec-2d10-492d-9c37-361fe0b79427	b1f26264-1177-4a4f-a264-04ef8018cd13
17520	17520	0	Belgian Biodiversity Platform	fb11cfe1-ebc3-45af-9159-17d9fddbcdac	b276cb50-d3ea-11dc-ab69-b8a03c50a862
36	36	0	GBIF Germany	4f6826f2-4ff6-443d-b966-e6913bd24013	b357df3d-6802-4d72-a729-e3a6a5b4a927
4	4	0	Plazi	ffb07bec-2d10-492d-9c37-361fe0b79427	b59f0ee3-dc9d-4454-823f-cf8d1b46356f
5582	5582	0	GBIF France	da44cd31-5901-4687-a106-6d1c7734ee3a	b5e2450a-3b79-4f92-9238-e21bc53a26f5
2962	2962	0	Netherlands Biodiversity Information Facility	0909d601-bda2-42df-9e63-a6d51847ebce	b7b50ad1-8ef9-40cb-8c8b-a2f81b9d9af5
480	480	0	GBIF Japan	db5705aa-6a6e-42f1-8942-d77b9f4896ea	bab19599-89cd-41ce-bbcb-01663cebd277
0	51	51	Participant Node Managers Committee	7f48e0c8-5c96-49ec-b972-30748e339115	bd102ab0-cc0b-4d88-9dbc-251501409965
0	1	1	Plazi	ffb07bec-2d10-492d-9c37-361fe0b79427	becc3a5e-6c8f-43a9-a97d-77dbb8b0885e
2100	2100	0	GBIF Argentina	2426a871-9feb-40a1-96c6-0c593a76b835	c18531ef-5231-498f-9655-220226c3c3a3
97	97	0	Plazi	ffb07bec-2d10-492d-9c37-361fe0b79427	c1ddd833-efa5-4a0c-bb3b-558198c129ae
338	338	0	GBIF Finland	dd514216-5c7c-45f3-910d-797424cb5be6	c24d731e-0479-4ab4-b334-db521d5e56fb
451827	451827	0	U.S. Geological Survey	8618c64a-93e0-4300-b546-7249e5148ed2	c42d2f75-d18d-4cee-88ca-e6be0515be9b
0	16	16	Plazi	ffb07bec-2d10-492d-9c37-361fe0b79427	c601c282-b593-47ff-bd7f-0b901cbf7b6c
2	2	0	Plazi	ffb07bec-2d10-492d-9c37-361fe0b79427	c6cc29e2-db8c-4f62-bf0d-a52db92197a6
0	47	47	Ocean Biodiversity Information System	ba0670b9-4186-41e6-8e70-f9cb3065551a	ca09bb3b-d7d1-40a6-bbf6-6a8d7569168a
25722	16704	-9018	Belgian Biodiversity Platform	fb11cfe1-ebc3-45af-9159-17d9fddbcdac	ce416850-8934-11dc-9962-b8a03c50a862
180	180	0	Belgian Biodiversity Platform	fb11cfe1-ebc3-45af-9159-17d9fddbcdac	d457cee2-bf14-4446-a791-86555a898a63
2775	300	-2475	GBIF Germany	4f6826f2-4ff6-443d-b966-e6913bd24013	d91a830f-60f0-482e-9636-2dd8221c7ea5
1	1	0	GBIF Argentina	2426a871-9feb-40a1-96c6-0c593a76b835	d9813601-cda8-4bb7-9eb8-1b21845219d5
0	1	1	Plazi	ffb07bec-2d10-492d-9c37-361fe0b79427	d98b87b3-2d75-4d2d-bbf1-4a37756d3cc5
12	12	0	Plazi	ffb07bec-2d10-492d-9c37-361fe0b79427	d9fe6901-875e-4271-a772-27b4b0cca075
60	60	0	GBIF France	da44cd31-5901-4687-a106-6d1c7734ee3a	da25f210-39bd-43db-90dd-7e03611e132c
38	38	0	Plazi	ffb07bec-2d10-492d-9c37-361fe0b79427	dc3a4f00-2ae5-4844-a803-7d8dabd65435
31	31	0	Plazi	ffb07bec-2d10-492d-9c37-361fe0b79427	dc6c8365-b07e-469c-ade9-f0596915fb4e
36	36	0	Plazi	ffb07bec-2d10-492d-9c37-361fe0b79427	df5319b7-20d2-4f93-899a-e38ab61acb1d
12662	12662	0	National Biodiversity Network	d897a5b9-35ee-4232-94bd-b0bcaac003c2	e0eb19aa-f73c-4e45-917e-d2d3c157ed92
20565	20565	0	GBIF France	da44cd31-5901-4687-a106-6d1c7734ee3a	e37c5967-cdce-408a-8316-78387638bd6b
0	500	500	Korean Biodiversity Information Facility	e0a1e772-0177-4800-94b4-2d023fe6cdf4	e37d35bf-f79d-443a-a09c-5d9d50da49f9
0	109	109	Participant Node Managers Committee	7f48e0c8-5c96-49ec-b972-30748e339115	e38f8091-ae2a-4bc7-9da4-e640a5c0ac6e
3	3	0	Plazi	ffb07bec-2d10-492d-9c37-361fe0b79427	e4c6d3aa-e56d-4b57-ae6c-6814e37e6252
5539	5539	0	National Biodiversity Network	d897a5b9-35ee-4232-94bd-b0bcaac003c2	e56ae688-8b1a-4421-a6ad-93a4eb0b2294
4	4	0	Plazi	ffb07bec-2d10-492d-9c37-361fe0b79427	e5d6a77b-b0b4-4617-9247-9ee263192e15
292	292	0	GBIF France	da44cd31-5901-4687-a106-6d1c7734ee3a	e672cafb-030a-4427-b832-50a3a4c2863d
0	114	114	Ocean Biodiversity Information System	ba0670b9-4186-41e6-8e70-f9cb3065551a	e6c31c57-4df4-47e5-8eda-76f176ca5ad4
4	4	0	Plazi	ffb07bec-2d10-492d-9c37-361fe0b79427	e6f2f35a-6ccf-44c1-aa29-3e7abd613cdf
7	7	0	Plazi	ffb07bec-2d10-492d-9c37-361fe0b79427	e7ded2a6-58db-4237-83a9-14a8f0cd1799
0	1	1	Plazi	ffb07bec-2d10-492d-9c37-361fe0b79427	eb77ab92-de84-4449-ac40-3cb07a75d304
0	46	46	U.S. Geological Survey	8618c64a-93e0-4300-b546-7249e5148ed2	ed85fbd8-7585-41b2-8cd3-dc791249cfd9
353	353	0	Biodiversity Information System of Mexico	b324e8e9-9a4c-44fa-8f1a-7f39ea7ab576	ed94c3ce-db4e-4232-aa90-869a9e28f688
0	1	1	Chinese Academy of Sciences	e760dc6f-dd68-474d-ab41-bd3588571793	ee6a3e16-6323-416c-b400-f0e36cb81473
0	16	16	Plazi	ffb07bec-2d10-492d-9c37-361fe0b79427	f0947e87-52cd-4990-aa69-a95a17574ee8
4	4	0	Plazi	ffb07bec-2d10-492d-9c37-361fe0b79427	f1d63d04-aee8-456d-b2d0-57ef656d3bd3
1344	1344	0	Participant Node Managers Committee	7f48e0c8-5c96-49ec-b972-30748e339115	f2823a82-923b-43c6-ae62-dbfef95652c5
1761	1761	0	GBIF Spain	1f94b3ca-9345-4d65-afe2-4bace93aa0fe	f351577b-9f46-4130-accf-41d55c3ed508
11744	13517	1773	GBIF Finland	dd514216-5c7c-45f3-910d-797424cb5be6	f49dd893-1e91-4ce6-9aa7-e1047ffee557
1	1	0	GBIF France	da44cd31-5901-4687-a106-6d1c7734ee3a	f4f53b0f-25f2-46d5-81a8-7ac11ade1bb1
0	860	860	GBIF Uganda	71b40829-6a12-4c3d-8fee-5746f5e9cf8c	f5656abf-d557-4abd-9dc1-6c7992159b8c
0	97	97	Ocean Biodiversity Information System	ba0670b9-4186-41e6-8e70-f9cb3065551a	f57c2b8d-6aa4-4c28-a480-cb025e70ba0a
13	13	0	Participant Node Managers Committee	7f48e0c8-5c96-49ec-b972-30748e339115	f687ebd8-01a3-42c2-aad4-d407b5b91d40
101	101	0	U.S. Geological Survey	8618c64a-93e0-4300-b546-7249e5148ed2	f86f5466-8f18-4b83-84d4-d0edab4c0e90
6	6	0	Participant Node Managers Committee	7f48e0c8-5c96-49ec-b972-30748e339115	f8d9c351-ae9d-4aba-b68c-6264e951bba2
1069	1069	0	Participant Node Managers Committee	7f48e0c8-5c96-49ec-b972-30748e339115	fc01c3fa-bb00-4f43-9d7a-38ca108a4e23
168	168	0	Biodiversity Information System of Mexico	b324e8e9-9a4c-44fa-8f1a-7f39ea7ab576	fc93007b-3ed7-43bb-bce2-98921f024689
1	1	0	Plazi	ffb07bec-2d10-492d-9c37-361fe0b79427	fcb2bfd4-caf1-4467-b6c4-a9d5ad013e17
3207	3207	0	Colombian Biodiversity Information System	7e865cba-7c46-417b-ade5-97f2cf5b7be0	fd6c18af-ea6c-4b85-90ca-26dbe0cadec2
391	391	0	GBIF France	da44cd31-5901-4687-a106-6d1c7734ee3a	fdf3ec02-22c6-47c8-9c35-bd5fd32facd7
3484	3484	0	GBIF Brazil	cdc9736d-5ff7-4ece-9959-3c744360cdb3	ff8bd33b-f362-46ad-8670-797ce1e701a1
0	2	2	Plazi	ffb07bec-2d10-492d-9c37-361fe0b79427	03dc32da-46fe-4ff4-b413-0a878c6f8f9d
0	3	3	Plazi	ffb07bec-2d10-492d-9c37-361fe0b79427	0aa851eb-552a-43c4-b4dd-1dcc0a1297df
182	182	0	Colombian Biodiversity Information System	7e865cba-7c46-417b-ade5-97f2cf5b7be0	1350b408-6300-4b89-955f-3a902f19d298
0	125	125	Ocean Biodiversity Information System	ba0670b9-4186-41e6-8e70-f9cb3065551a	15974a7f-379d-4d45-a44b-fb60eece5ef4
0	1	1	Plazi	ffb07bec-2d10-492d-9c37-361fe0b79427	16a1742e-cafe-4c2e-a8c3-2e1b3b57d456
1	1	0	Plazi	ffb07bec-2d10-492d-9c37-361fe0b79427	19f79a6f-4f96-49a2-80e3-3fa00576ffdc
0	5	5	Plazi	ffb07bec-2d10-492d-9c37-361fe0b79427	225c1344-378e-4867-a602-e70803ecaf10
91602	92337	735	GBIF Brazil	cdc9736d-5ff7-4ece-9959-3c744360cdb3	23b714b1-fae6-4074-bdd0-5e17ae3b5f11
456	456	0	GBIF Brazil	cdc9736d-5ff7-4ece-9959-3c744360cdb3	29e918af-f94b-4de1-bc5f-7811b0a001c9
0	14	14	Plazi	ffb07bec-2d10-492d-9c37-361fe0b79427	2ab421bf-d013-4c38-97a7-60ce19394e0d
80437	81576	1139	GBIF Norway	4f829580-180d-46a9-9c87-ed8ec959b545	30bc94f2-50aa-4688-8e87-a8e11d3d69ff
8	8	0	Plazi	ffb07bec-2d10-492d-9c37-361fe0b79427	30f97048-a3c2-4cdf-a525-7ac1070ca9dc
345	345	0	GBIF France	da44cd31-5901-4687-a106-6d1c7734ee3a	31f97742-c165-49b4-92ab-9a46b81e0af2
31	31	0	Plazi	ffb07bec-2d10-492d-9c37-361fe0b79427	32cfba27-8d59-4094-baa1-cd729e17eff9
0	55	55	Plazi	ffb07bec-2d10-492d-9c37-361fe0b79427	341bd77a-070c-44ed-b7d2-2c2d23d9d032
102	102	0	Plazi	ffb07bec-2d10-492d-9c37-361fe0b79427	38b3225e-cc93-4760-a9cd-55d761d4b1db
1652	1652	0	Biodiversity Information System of Mexico	b324e8e9-9a4c-44fa-8f1a-7f39ea7ab576	38f7fda0-b139-4285-ae61-d58f075b54d1
0	5	5	Plazi	ffb07bec-2d10-492d-9c37-361fe0b79427	3ad2aff9-75bb-46eb-b1e5-2e873b8956d2
0	3	3	Plazi	ffb07bec-2d10-492d-9c37-361fe0b79427	3d4e2d68-0b43-468d-a921-75a749c3169c
20	20	0	Plazi	ffb07bec-2d10-492d-9c37-361fe0b79427	3fb13aa4-a6db-4c1c-8c76-eb5fb37c200f
0	17	17	Plazi	ffb07bec-2d10-492d-9c37-361fe0b79427	3ffc2d78-984d-469c-a5c1-5c63ed95610e
0	20	20	Korean Biodiversity Information Facility	e0a1e772-0177-4800-94b4-2d023fe6cdf4	4092554e-3b30-444d-bae3-af9b7386b18f
49	49	0	Plazi	ffb07bec-2d10-492d-9c37-361fe0b79427	42d8c42b-cc7c-4c9e-9828-1a73f9eedc4c
23	23	0	Plazi	ffb07bec-2d10-492d-9c37-361fe0b79427	43f393b8-6c05-4861-9b7c-2f7f1a169d10
623	623	0	U.S. Geological Survey	8618c64a-93e0-4300-b546-7249e5148ed2	4bfd658b-5d1c-496c-8ac9-c2aaa9c01557
43396	43396	0	National Biodiversity Network	d897a5b9-35ee-4232-94bd-b0bcaac003c2	4c7d1e0e-d82c-4c67-8661-d2966adbab24
2	2	0	Plazi	ffb07bec-2d10-492d-9c37-361fe0b79427	4e8e833c-f497-435b-abd1-835cbe5dd94b
22167	22167	0	Netherlands Biodiversity Information Facility	0909d601-bda2-42df-9e63-a6d51847ebce	4f72060d-2c72-4d5f-addc-8d1b1049c78a
8	8	0	Plazi	ffb07bec-2d10-492d-9c37-361fe0b79427	4fe638f6-819b-460f-a296-b7dda5ab2415
0	224	224	GBIF Malawi	2a42e4d7-ad4a-41b3-84c4-de4aa7b74d35	5167e30e-8ff4-476d-92e8-ba97fb77a687
1896	1896	0	GBIF Japan	db5705aa-6a6e-42f1-8942-d77b9f4896ea	5358d8ac-18f5-11e2-98fb-00145eb45e9a
124	124	0	GBIF France	da44cd31-5901-4687-a106-6d1c7734ee3a	574d0235-1dfb-4f76-aa1c-26198d9d6e25
7	7	0	Plazi	ffb07bec-2d10-492d-9c37-361fe0b79427	58501dd4-6606-49d7-996a-9d3df90d07c4
775	775	0	National Biodiversity Network	d897a5b9-35ee-4232-94bd-b0bcaac003c2	5f12c9c4-0f6c-4010-840f-7d9c9316a777
14	14	0	Plazi	ffb07bec-2d10-492d-9c37-361fe0b79427	5fb7c238-0813-4cf2-9c99-b827f92c398d
0	3	3	Plazi	ffb07bec-2d10-492d-9c37-361fe0b79427	60bd5746-f0cc-4a32-9cfd-a3c76e4f2b72
132	132	0	GBIF France	da44cd31-5901-4687-a106-6d1c7734ee3a	613ffc66-7180-45db-9415-491abc575b6f
163	163	0	GBIF Germany	4f6826f2-4ff6-443d-b966-e6913bd24013	61d0a310-f762-11e1-a439-00145eb45e9a
212	212	0	GBIF Germany	4f6826f2-4ff6-443d-b966-e6913bd24013	61d5a220-f762-11e1-a439-00145eb45e9a
70	70	0	GBIF Germany	4f6826f2-4ff6-443d-b966-e6913bd24013	6293778c-f762-11e1-a439-00145eb45e9a
36	36	0	GBIF Germany	4f6826f2-4ff6-443d-b966-e6913bd24013	62c066a2-f762-11e1-a439-00145eb45e9a
11	11	0	GBIF Germany	4f6826f2-4ff6-443d-b966-e6913bd24013	630d87ac-f762-11e1-a439-00145eb45e9a
2	2	0	Plazi	ffb07bec-2d10-492d-9c37-361fe0b79427	6325341c-8d90-4a31-8fa6-75fc63898148
6	6	0	GBIF Germany	4f6826f2-4ff6-443d-b966-e6913bd24013	633c0be0-f762-11e1-a439-00145eb45e9a
5	5	0	GBIF Germany	4f6826f2-4ff6-443d-b966-e6913bd24013	6343f828-f762-11e1-a439-00145eb45e9a
106	106	0	GBIF Germany	4f6826f2-4ff6-443d-b966-e6913bd24013	63d412a0-f762-11e1-a439-00145eb45e9a
269	269	0	GBIF Germany	4f6826f2-4ff6-443d-b966-e6913bd24013	643d1430-f762-11e1-a439-00145eb45e9a
286	286	0	GBIF Germany	4f6826f2-4ff6-443d-b966-e6913bd24013	65580ca8-f762-11e1-a439-00145eb45e9a
87	86	-1	GBIF Germany	4f6826f2-4ff6-443d-b966-e6913bd24013	6593a830-f762-11e1-a439-00145eb45e9a
385	385	0	GBIF Germany	4f6826f2-4ff6-443d-b966-e6913bd24013	65f61358-f762-11e1-a439-00145eb45e9a
121	121	0	GBIF Germany	4f6826f2-4ff6-443d-b966-e6913bd24013	6724f942-f762-11e1-a439-00145eb45e9a
53	53	0	GBIF Germany	4f6826f2-4ff6-443d-b966-e6913bd24013	68171268-f762-11e1-a439-00145eb45e9a
48	48	0	GBIF Germany	4f6826f2-4ff6-443d-b966-e6913bd24013	6933f6c0-f762-11e1-a439-00145eb45e9a
0	4	4	Plazi	ffb07bec-2d10-492d-9c37-361fe0b79427	697ba636-dfcf-4c87-a89f-3a02acd6b25b
64	64	0	GBIF Germany	4f6826f2-4ff6-443d-b966-e6913bd24013	69c4f81e-f762-11e1-a439-00145eb45e9a
24	24	0	GBIF Germany	4f6826f2-4ff6-443d-b966-e6913bd24013	6a0fdbc2-f762-11e1-a439-00145eb45e9a
12	12	0	GBIF Germany	4f6826f2-4ff6-443d-b966-e6913bd24013	6bd8b230-f762-11e1-a439-00145eb45e9a
4	4	0	Plazi	ffb07bec-2d10-492d-9c37-361fe0b79427	6c044ed2-9134-4431-89fc-1bce9bf7e7d7
21	21	0	GBIF Germany	4f6826f2-4ff6-443d-b966-e6913bd24013	6c977788-f762-11e1-a439-00145eb45e9a
4	4	0	Plazi	ffb07bec-2d10-492d-9c37-361fe0b79427	6dad1ad1-ae87-432f-afc7-5a1635ca6d47
4008	4008	0	GBIF France	da44cd31-5901-4687-a106-6d1c7734ee3a	6f6e5a57-cece-487b-a436-44e52f23617b
121	121	0	GBIF Germany	4f6826f2-4ff6-443d-b966-e6913bd24013	6f82b994-f762-11e1-a439-00145eb45e9a
702	702	0	National Biodiversity Network	d897a5b9-35ee-4232-94bd-b0bcaac003c2	70b188b1-ebee-40e3-90af-08c7e4042fd5
97	97	0	GBIF Germany	4f6826f2-4ff6-443d-b966-e6913bd24013	7190c29e-f762-11e1-a439-00145eb45e9a
163	163	0	GBIF Germany	4f6826f2-4ff6-443d-b966-e6913bd24013	72350156-f762-11e1-a439-00145eb45e9a
21	21	0	GBIF Germany	4f6826f2-4ff6-443d-b966-e6913bd24013	7362ae8e-f762-11e1-a439-00145eb45e9a
11	11	0	Plazi	ffb07bec-2d10-492d-9c37-361fe0b79427	73792db7-0c46-4ef2-9d83-ecd3e3f42935
334	334	0	Colombian Biodiversity Information System	7e865cba-7c46-417b-ade5-97f2cf5b7be0	73e5b51c-de49-41ed-a6d2-ff3d5206c424
736	736	0	GBIF Germany	4f6826f2-4ff6-443d-b966-e6913bd24013	749563c8-f762-11e1-a439-00145eb45e9a
0	121	121	GBIF Chile	a8b16421-d80b-4ef3-8f22-098b01a89255	74c18622-118c-4fb3-b3e3-8d821aa732dc
189	269	80	GBIF Japan	db5705aa-6a6e-42f1-8942-d77b9f4896ea	7597bf40-9a2e-4e28-8dab-d952c4067c4d
0	3	3	Plazi	ffb07bec-2d10-492d-9c37-361fe0b79427	76e91ea6-a619-43c0-b2a7-4cbd59d0a72d
0	9	9	Plazi	ffb07bec-2d10-492d-9c37-361fe0b79427	775a3d67-cfe9-4f8c-87e5-0c50808cb29a
334	334	0	GBIF Malawi	2a42e4d7-ad4a-41b3-84c4-de4aa7b74d35	7998a4ff-a9f3-46b0-a291-55fe832b6522
523	389	-134	GBIF Germany	4f6826f2-4ff6-443d-b966-e6913bd24013	79a7f90c-f762-11e1-a439-00145eb45e9a
548	548	0	Colombian Biodiversity Information System	7e865cba-7c46-417b-ade5-97f2cf5b7be0	79ce68df-8f96-45a6-8aa9-c3eb91b011e8
0	62	62	Plazi	ffb07bec-2d10-492d-9c37-361fe0b79427	7a23d441-2224-4f17-9775-825dd8bfc76e
10060	10060	0	Korean Biodiversity Information Facility	e0a1e772-0177-4800-94b4-2d023fe6cdf4	7b1d5912-f762-11e1-a439-00145eb45e9a
343	343	0	GBIF Germany	4f6826f2-4ff6-443d-b966-e6913bd24013	7b83940c-f762-11e1-a439-00145eb45e9a
1009	1009	0	Ocean Biodiversity Information System	ba0670b9-4186-41e6-8e70-f9cb3065551a	7b98b7c4-f762-11e1-a439-00145eb45e9a
280	280	0	GBIF Germany	4f6826f2-4ff6-443d-b966-e6913bd24013	7bcd6d48-f762-11e1-a439-00145eb45e9a
1553	1553	0	GBIF Germany	4f6826f2-4ff6-443d-b966-e6913bd24013	7c2715f0-f762-11e1-a439-00145eb45e9a
59	49	-10	GBIF Germany	4f6826f2-4ff6-443d-b966-e6913bd24013	7d33b5ac-f762-11e1-a439-00145eb45e9a
1579	1711	132	GBIF Germany	4f6826f2-4ff6-443d-b966-e6913bd24013	7d8a6ba4-1387-11e2-bb2e-00145eb45e9a
14	14	0	Plazi	ffb07bec-2d10-492d-9c37-361fe0b79427	7e177b28-9ff6-4c9b-bea4-fbb8b3c8689b
3224	3224	0	Biodiversity Information System of Mexico	b324e8e9-9a4c-44fa-8f1a-7f39ea7ab576	7e3daff4-428b-4951-8313-d7fb63831df9
158272	158272	0	GBIF France	da44cd31-5901-4687-a106-6d1c7734ee3a	7e6df30d-d8af-438d-bb01-5a528f6f4fa3
758	758	0	GBIF Germany	4f6826f2-4ff6-443d-b966-e6913bd24013	7e97a246-f762-11e1-a439-00145eb45e9a
1361	1361	0	GBIF Germany	4f6826f2-4ff6-443d-b966-e6913bd24013	7f33de9a-f762-11e1-a439-00145eb45e9a
3139	3139	0	GBIF Germany	4f6826f2-4ff6-443d-b966-e6913bd24013	7f43d7f0-f762-11e1-a439-00145eb45e9a
1627	1627	0	Biodiversity Information System of Mexico	b324e8e9-9a4c-44fa-8f1a-7f39ea7ab576	7fba982c-f762-11e1-a439-00145eb45e9a
1773	1773	0	Biodiversity Information System of Mexico	b324e8e9-9a4c-44fa-8f1a-7f39ea7ab576	7fd54c8a-f762-11e1-a439-00145eb45e9a
4395	4395	0	Biodiversity Information System of Mexico	b324e8e9-9a4c-44fa-8f1a-7f39ea7ab576	7fef5012-f762-11e1-a439-00145eb45e9a
305	305	0	Biodiversity Information System of Mexico	b324e8e9-9a4c-44fa-8f1a-7f39ea7ab576	8008770e-f762-11e1-a439-00145eb45e9a
0	171	171	Plazi	ffb07bec-2d10-492d-9c37-361fe0b79427	80116c4c-868f-4c71-b68f-66c4489d1375
0	16705	16705	GBIF Germany	4f6826f2-4ff6-443d-b966-e6913bd24013	808f91fc-ac64-441d-8eb5-008b559c30a2
52	52	0	GBIF France	da44cd31-5901-4687-a106-6d1c7734ee3a	80f6aa77-45b6-45c9-8d89-1d4328c97a45
1	1	0	Plazi	ffb07bec-2d10-492d-9c37-361fe0b79427	81115210-f302-4eee-b7f1-27f957059ff8
9404	9404	0	GBIF Switzerland	169eb292-376b-4cc6-8e31-9c2c432de0ad	813a1cea-f762-11e1-a439-00145eb45e9a
0	2	2	Plazi	ffb07bec-2d10-492d-9c37-361fe0b79427	815a5e02-f400-4784-a998-fa60d699a71b
31	31	0	GBIF Germany	4f6826f2-4ff6-443d-b966-e6913bd24013	81864138-f762-11e1-a439-00145eb45e9a
45	15	-30	GBIF Germany	4f6826f2-4ff6-443d-b966-e6913bd24013	81ccad3a-f762-11e1-a439-00145eb45e9a
696	240	-456	GBIF Germany	4f6826f2-4ff6-443d-b966-e6913bd24013	82b4f6b7-26db-4973-bfb6-d231ce593fca
92061	92061	0	GBIF Iceland	4dbdcae6-9ac9-4005-ac15-4a95a3eb7701	83422c44-f762-11e1-a439-00145eb45e9a
10	10	0	Plazi	ffb07bec-2d10-492d-9c37-361fe0b79427	8377a610-1626-46e0-b8c5-5f1f672629e6
39529	39529	0	U.S. Geological Survey	8618c64a-93e0-4300-b546-7249e5148ed2	84e6e5f8-f762-11e1-a439-00145eb45e9a
8503	8503	0	World Federation for Culture Collections	a6bdc523-5368-4e0f-9d2e-de1c262ac092	85574fe6-f762-11e1-a439-00145eb45e9a
5429	5429	0	World Federation for Culture Collections	a6bdc523-5368-4e0f-9d2e-de1c262ac092	85604c9a-f762-11e1-a439-00145eb45e9a
3968	2994	-974	GBIF Germany	4f6826f2-4ff6-443d-b966-e6913bd24013	86f6289a-f762-11e1-a439-00145eb45e9a
4717	4717	0	GBIF France	da44cd31-5901-4687-a106-6d1c7734ee3a	872cebd6-b8ac-4125-b63e-d754f149b042
0	9	9	Plazi	ffb07bec-2d10-492d-9c37-361fe0b79427	87eee164-0413-4185-a317-1c4fde48a1c8
16	16	0	GBIF Germany	4f6826f2-4ff6-443d-b966-e6913bd24013	887e5228-f762-11e1-a439-00145eb45e9a
1	1	0	Plazi	ffb07bec-2d10-492d-9c37-361fe0b79427	88f41873-9773-4ed9-b19f-d36705104f26
5515	5515	0	National Biodiversity Network	d897a5b9-35ee-4232-94bd-b0bcaac003c2	8af0d1d7-831c-452f-9913-40d1d0f6c8b2
123	123	0	GBIF Germany	4f6826f2-4ff6-443d-b966-e6913bd24013	8c7db440-f762-11e1-a439-00145eb45e9a
161	100	-61	GBIF Germany	4f6826f2-4ff6-443d-b966-e6913bd24013	8e87a8fe-f762-11e1-a439-00145eb45e9a
6	6	0	Participant Node Managers Committee	7f48e0c8-5c96-49ec-b972-30748e339115	8fd60078-620a-40a6-b565-0b093778e0fe
1967	1205	-762	GBIF Germany	4f6826f2-4ff6-443d-b966-e6913bd24013	9018b5be-f762-11e1-a439-00145eb45e9a
1377	1377	0	Biodiversity Information System of Mexico	b324e8e9-9a4c-44fa-8f1a-7f39ea7ab576	91bdce11-da40-41b6-a042-ed56fb1f7fc1
1942	1942	0	GBIF Germany	4f6826f2-4ff6-443d-b966-e6913bd24013	91edcb9a-f762-11e1-a439-00145eb45e9a
25	25	0	GBIF Germany	4f6826f2-4ff6-443d-b966-e6913bd24013	9376bbca-f762-11e1-a439-00145eb45e9a
23	23	0	GBIF Germany	4f6826f2-4ff6-443d-b966-e6913bd24013	93a79f74-f762-11e1-a439-00145eb45e9a
138	138	0	GBIF Germany	4f6826f2-4ff6-443d-b966-e6913bd24013	93d80bfa-f762-11e1-a439-00145eb45e9a
281	263	-18	GBIF Germany	4f6826f2-4ff6-443d-b966-e6913bd24013	9514583e-f762-11e1-a439-00145eb45e9a
3187	3187	0	GBIF France	da44cd31-5901-4687-a106-6d1c7734ee3a	9630efe2-42a8-42c4-a83a-65aa5aa7ade2
2	2	0	Plazi	ffb07bec-2d10-492d-9c37-361fe0b79427	9abfbfd4-e21a-4209-a180-aa66b6bc95bb
2080	2080	0	National Biodiversity Network	d897a5b9-35ee-4232-94bd-b0bcaac003c2	9acdc8b1-ea15-4fc3-9454-04bc29ef7532
0	21	21	Plazi	ffb07bec-2d10-492d-9c37-361fe0b79427	9db1f64f-288e-430e-82fa-0e811af468a7
5263	5263	0	National Biodiversity Network	d897a5b9-35ee-4232-94bd-b0bcaac003c2	9df8970d-88ff-4bc7-a0d1-f70a82c148f9
196	196	0	GBIF France	da44cd31-5901-4687-a106-6d1c7734ee3a	9fb3a013-5e15-4fb3-8858-30042d78e052
0	10762	10762	Belgian Biodiversity Platform	fb11cfe1-ebc3-45af-9159-17d9fddbcdac	a178c443-d737-4938-b983-5fa8e50936fe
1	1	0	Plazi	ffb07bec-2d10-492d-9c37-361fe0b79427	a22064c4-f231-462f-b3db-33839188d123
252	45	-207	GBIF Germany	4f6826f2-4ff6-443d-b966-e6913bd24013	a3ac88b0-dd3c-4bcb-ac81-f5ce168a8711
8102	8102	0	GBIF Madagascar	2dbfc5c5-51b5-4494-9dfc-4d3f013a3b64	a5dd8cc3-7971-4b3c-a75c-d345940572bd
0	96	96	Participant Node Managers Committee	7f48e0c8-5c96-49ec-b972-30748e339115	a771e9e3-9d21-42a0-a415-8d89b6b297ac
3230	1528	-1702	GBIF Germany	4f6826f2-4ff6-443d-b966-e6913bd24013	a7c31bbe-92cf-490f-b23f-b6e2097db374
59	59	0	Biodiversity Information System of Mexico	b324e8e9-9a4c-44fa-8f1a-7f39ea7ab576	a85eacac-e1a1-46d9-9217-a56140360c57
11	11	0	Plazi	ffb07bec-2d10-492d-9c37-361fe0b79427	a8801b43-1b7f-446c-bb04-f73f6b1337c6
9	9	0	Plazi	ffb07bec-2d10-492d-9c37-361fe0b79427	ab542bff-5d47-4367-89cd-112b7f3e938a
50	50	0	Plazi	ffb07bec-2d10-492d-9c37-361fe0b79427	abceb121-c58e-4028-94eb-e0fba328e440
1092	1092	0	Netherlands Biodiversity Information Facility	0909d601-bda2-42df-9e63-a6d51847ebce	abe98580-1963-4b75-bf35-2ca50659c61f
29741	29740	-1	National Biodiversity Network	d897a5b9-35ee-4232-94bd-b0bcaac003c2	af2f0d97-7df6-41d4-a0d6-74d5be8a81d4
8147	8147	0	GBIF Norway	4f829580-180d-46a9-9c87-ed8ec959b545	b4926f5d-6426-4774-83fa-099e927862a1
2548	2548	0	GBIF France	da44cd31-5901-4687-a106-6d1c7734ee3a	b7ca8e9d-5609-4356-b5c3-b2ca7071cf58
0	14284	14284	Colombian Biodiversity Information System	7e865cba-7c46-417b-ade5-97f2cf5b7be0	b7d47a4b-07ff-42cd-8776-d638b95c2bec
22	22	0	Plazi	ffb07bec-2d10-492d-9c37-361fe0b79427	bc4dbecf-5cb6-461d-a6cb-8e4a9a7a4ed5
0	711	711	Biodiversity Information System of Mexico	b324e8e9-9a4c-44fa-8f1a-7f39ea7ab576	bc9b0ea4-daf2-4711-a494-bc535aa62033
0	2	2	Plazi	ffb07bec-2d10-492d-9c37-361fe0b79427	bd60737c-f5f7-4bf5-891e-e3aeb6628a00
2036474	2069857	33383	GBIF Norway	4f829580-180d-46a9-9c87-ed8ec959b545	bed78790-cbec-44af-82af-fe78e9692287
191	191	0	GBIF Malawi	2a42e4d7-ad4a-41b3-84c4-de4aa7b74d35	bf9e71b8-7073-4dbb-b7e0-62fe27896780
15	15	0	Plazi	ffb07bec-2d10-492d-9c37-361fe0b79427	c3128d24-5293-4125-bc85-0678753fc483
1170	1170	0	National Biodiversity Network	d897a5b9-35ee-4232-94bd-b0bcaac003c2	c39d6686-e19e-4132-a6c2-d0508949c1f4
79101	79101	0	GBIF France	da44cd31-5901-4687-a106-6d1c7734ee3a	c621bdda-1e6b-4c61-ba7f-9c5848755b4e
2	2	0	Plazi	ffb07bec-2d10-492d-9c37-361fe0b79427	c7b4296a-ad04-4c48-b28f-aaeccce21fa8
4004	4004	0	GBIF Portugal	673f7038-4262-4149-b753-5658a4e912f6	ce0e12f8-0a44-44dd-bb0c-4352182b144e
8600	8600	0	Polish Biodiversity Information Network	2618bfdf-e194-4911-a241-80db3107bc51	cef8bb20-149a-11de-bab0-b8a03c50a862
217	217	0	GBIF Germany	4f6826f2-4ff6-443d-b966-e6913bd24013	d069d4b7-a692-47c6-a302-49bc1110bd58
20531	20531	0	GBIF Germany	4f6826f2-4ff6-443d-b966-e6913bd24013	d150dd98-855c-4828-a2ff-148036b00c92
2	2	0	Plazi	ffb07bec-2d10-492d-9c37-361fe0b79427	d18ba864-ae1e-42dd-97e3-ceb721b9ef0c
718	718	0	GBIF Kenya	2a44d626-9f7a-4120-8a7a-4ab5ac15ff2a	d1913fb2-2dc9-48b2-9dba-0b340c514f76
200	207	7	GBIF Germany	4f6826f2-4ff6-443d-b966-e6913bd24013	d68e05ef-445e-4412-8617-56deb5d3a7e7
0	314	314	DanBIF - Danish Biodiversity Information Facility	4ddd294f-02b7-4359-ac33-0806a9ca9c6b	d6fdde74-810a-42b9-bfe1-66b1544ce840
440	440	0	South African Biodiversity Information Facility	7190b835-4e86-4b6e-85c1-19cc6677c250	d71e908c-f944-4fdd-9872-178754a00805
238	238	0	GBIF France	da44cd31-5901-4687-a106-6d1c7734ee3a	d868c036-c9e1-42c9-992d-88c951ccba04
21	21	0	Plazi	ffb07bec-2d10-492d-9c37-361fe0b79427	d8837133-c1e6-4024-b530-3de27907aa51
6164	6164	0	Scientific Committee on Antarctic Research	51e4e8ff-bff0-4996-8b27-9107d61b3478	d8b06df0-81b3-41c9-bcf8-6ba5242e2b95
0	7	7	Plazi	ffb07bec-2d10-492d-9c37-361fe0b79427	dd52bf72-e43a-42e2-8ae1-64b31267432e
14126	14126	0	GBIF France	da44cd31-5901-4687-a106-6d1c7734ee3a	ded7f34f-fc9b-4e5b-87dc-d3c6177a8fe0
7648	7648	0	GBIF France	da44cd31-5901-4687-a106-6d1c7734ee3a	df2e1edc-0805-4de7-9acf-5d935136c3e6
269	269	0	Participant Node Managers Committee	7f48e0c8-5c96-49ec-b972-30748e339115	df834ac5-6873-4e27-8daa-b71d796874b1
4	4	0	Plazi	ffb07bec-2d10-492d-9c37-361fe0b79427	e0197ff6-27a9-4086-a9dc-61215eeb474b
3	3	0	Plazi	ffb07bec-2d10-492d-9c37-361fe0b79427	e0a3e6fe-1b75-4c25-ade7-bef093ca623e
15	15	0	Plazi	ffb07bec-2d10-492d-9c37-361fe0b79427	e15a5b4c-9199-4679-afdf-1a08dd1cd564
265	265	0	Plazi	ffb07bec-2d10-492d-9c37-361fe0b79427	e3a547e5-844c-4c76-bbe2-90c57f7ec9c4
1127	1127	0	National Biodiversity Network	d897a5b9-35ee-4232-94bd-b0bcaac003c2	e570c170-7e16-4934-b666-1809924592f2
216	216	0	Colombian Biodiversity Information System	7e865cba-7c46-417b-ade5-97f2cf5b7be0	e5e75788-55c5-4721-9fa4-a61212f06e13
75	75	0	U.S. Geological Survey	8618c64a-93e0-4300-b546-7249e5148ed2	e727fcd0-e519-4fcc-9710-082762b4c262
386	386	0	Plazi	ffb07bec-2d10-492d-9c37-361fe0b79427	e8752a37-798f-4948-a9ce-f1b5c10823c3
97	97	0	Ocean Biodiversity Information System	ba0670b9-4186-41e6-8e70-f9cb3065551a	ead7472e-1185-46d7-a261-356048968413
120	120	0	GBIF France	da44cd31-5901-4687-a106-6d1c7734ee3a	eb31790f-7a41-449f-88d2-977f795167c5
140048	140048	0	National Biodiversity Network	d897a5b9-35ee-4232-94bd-b0bcaac003c2	ebc7c4f2-fbb7-4ff9-af57-fbe2fef87d22
0	105	105	Colombian Biodiversity Information System	7e865cba-7c46-417b-ade5-97f2cf5b7be0	ed3eae1d-f2f9-439c-a12d-d4b93f82de58
60	364	304	U.S. Geological Survey	8618c64a-93e0-4300-b546-7249e5148ed2	edc4ab0b-1ad7-4e53-a741-4423d0196a06
0	2	2	Participant Node Managers Committee	7f48e0c8-5c96-49ec-b972-30748e339115	eedf86c2-b175-46a2-9e5d-4b686126988e
0	70	70	Participant Node Managers Committee	7f48e0c8-5c96-49ec-b972-30748e339115	f0fd1f8f-40e8-4ca3-9828-d6aeae9e1b2f
0	6057	6057	Korean Biodiversity Information Facility	e0a1e772-0177-4800-94b4-2d023fe6cdf4	f1fc52ac-895e-47f2-9361-d033c6479f7c
1184	1184	0	Biodiversity Information System of Mexico	b324e8e9-9a4c-44fa-8f1a-7f39ea7ab576	f4b27145-384c-4c5a-8d28-af9310a37412
17	17	0	Plazi	ffb07bec-2d10-492d-9c37-361fe0b79427	f71fb3fd-4836-45d3-be36-f436013c8084
1	1	0	Plazi	ffb07bec-2d10-492d-9c37-361fe0b79427	f9ef7053-b56c-43c4-aa4f-bbcd627c0eed
0	1659	1659	Colombian Biodiversity Information System	7e865cba-7c46-417b-ade5-97f2cf5b7be0	fb2f8d38-6923-4f2f-8722-3c9c5a562dcd
77	77	0	Colombian Biodiversity Information System	7e865cba-7c46-417b-ade5-97f2cf5b7be0	fd3007f0-5201-4cd8-9d56-b1cf9eee4810
721	721	0	GBIF Benin	efb9c00e-f802-45dd-8826-a52ec45b89ff	fdbbecb9-3e8b-4fbe-aca4-bde861e63e8a
9	9	0	Plazi	ffb07bec-2d10-492d-9c37-361fe0b79427	fdd67916-e70f-4bf0-b409-dd401a7b4ba0
0	81	81	Plazi	ffb07bec-2d10-492d-9c37-361fe0b79427	fe3a7b58-5ffc-4e2e-bef5-d417d29551f7
814	814	0	Plazi	ffb07bec-2d10-492d-9c37-361fe0b79427	00215abc-549e-4dae-84b3-a916cfe9b214
50	50	0	Plazi	ffb07bec-2d10-492d-9c37-361fe0b79427	017027f2-09c7-4bc9-af88-f791e15ea4cf
83	83	0	GBIF France	da44cd31-5901-4687-a106-6d1c7734ee3a	03e3f178-f03b-46a8-8d62-91f8f080f561
235	235	0	GBIF Germany	4f6826f2-4ff6-443d-b966-e6913bd24013	08025b66-5dec-487f-bdbb-b65d52b15446
60	60	0	Participant Node Managers Committee	7f48e0c8-5c96-49ec-b972-30748e339115	0b89297c-eb85-4e17-ba52-71c17def2f2c
3204	3204	0	Polish Biodiversity Information Network	2618bfdf-e194-4911-a241-80db3107bc51	0dfc0440-a75d-11dd-b1b1-b8a03c50a862
89	88	-1	Plazi	ffb07bec-2d10-492d-9c37-361fe0b79427	0dff2955-3358-4f45-87b4-2be1b9bc84eb
0	748	748	Ocean Biodiversity Information System	ba0670b9-4186-41e6-8e70-f9cb3065551a	0e142fde-ce49-4097-b596-ceb3f4c1df8f
580	580	0	GBIF Germany	4f6826f2-4ff6-443d-b966-e6913bd24013	10d7b3ff-5719-4b10-88e0-3298c053eec6
478	478	0	VertNet	d205def7-82c3-472a-be4b-31d11dcd51fd	148cdfe1-c323-4108-9c2c-547c11279a2f
0	3	3	Plazi	ffb07bec-2d10-492d-9c37-361fe0b79427	1536b358-20c5-49f8-944f-4648a01090d3
377	377	0	Plazi	ffb07bec-2d10-492d-9c37-361fe0b79427	15799d2a-1968-4874-8100-452597d4e26b
21980	21980	0	GBIF France	da44cd31-5901-4687-a106-6d1c7734ee3a	191cb056-d760-4b06-a7dd-ac247a45f05d
903	903	0	GBIF France	da44cd31-5901-4687-a106-6d1c7734ee3a	1f0ac511-f71d-46f6-9ae8-87e1d6b69e92
0	3	3	Plazi	ffb07bec-2d10-492d-9c37-361fe0b79427	1f4ed428-f918-4c50-a765-aa30b1ed61fa
0	7	7	Plazi	ffb07bec-2d10-492d-9c37-361fe0b79427	22508435-bb1f-472a-b8ac-c29726076ea4
20	20	0	Plazi	ffb07bec-2d10-492d-9c37-361fe0b79427	22815f4d-7c51-45d1-b6b3-8216ea02e14c
2	2	0	Plazi	ffb07bec-2d10-492d-9c37-361fe0b79427	233575e9-a4da-41cd-b84b-66a425887a25
0	2	2	Plazi	ffb07bec-2d10-492d-9c37-361fe0b79427	24968a35-b4a7-4edf-b187-2797a6fc337d
2103	2103	0	Biodiversity Information System of Mexico	b324e8e9-9a4c-44fa-8f1a-7f39ea7ab576	24ee20b4-607c-4838-9056-44d502728e0c
0	143	143	Participant Node Managers Committee	7f48e0c8-5c96-49ec-b972-30748e339115	290af75c-0b95-4a3c-8b3c-83250abab12a
11	11	0	Participant Node Managers Committee	7f48e0c8-5c96-49ec-b972-30748e339115	298835ac-ed34-4238-b628-832974c1cbdd
28	28	0	GBIF France	da44cd31-5901-4687-a106-6d1c7734ee3a	2d942146-b2d9-4bc4-a565-0f7415faa77c
2806	2806	0	National Biodiversity Network	d897a5b9-35ee-4232-94bd-b0bcaac003c2	301f21ba-607a-4c1a-9713-e8c2f46f0860
64	64	0	GBIF France	da44cd31-5901-4687-a106-6d1c7734ee3a	39cade9c-de7d-49e3-968f-d643fa079240
0	64	64	Colombian Biodiversity Information System	7e865cba-7c46-417b-ade5-97f2cf5b7be0	3aa0a4b4-df45-4698-bd46-dae52c5de816
9	9	0	Plazi	ffb07bec-2d10-492d-9c37-361fe0b79427	3abe8dff-79fc-4595-989c-2900adb74a29
10	10	0	Plazi	ffb07bec-2d10-492d-9c37-361fe0b79427	3e329e8f-2f23-4832-b7e1-748e6c1f2925
70	70	0	GBIF France	da44cd31-5901-4687-a106-6d1c7734ee3a	3e340ca0-aa22-4987-851f-ee026c2d9946
1617	1617	0	GBIF France	da44cd31-5901-4687-a106-6d1c7734ee3a	42bf11f4-c7eb-420c-9145-73204598d1a2
10	10	0	Plazi	ffb07bec-2d10-492d-9c37-361fe0b79427	44ef21b3-550b-4f82-950c-3d7db7e04de0
517	517	0	GBIF France	da44cd31-5901-4687-a106-6d1c7734ee3a	44f505ba-3f6d-4bed-bbd4-6a163208f636
26	26	0	Colombian Biodiversity Information System	7e865cba-7c46-417b-ade5-97f2cf5b7be0	49f528ba-aeb4-472e-93d2-01a64e141c6a
3	3	0	Plazi	ffb07bec-2d10-492d-9c37-361fe0b79427	4d20d328-3fa2-4902-af42-ecd5dbaf2430
216706	216706	0	Canada Biodiversity Information Facility	8f83fc96-c966-4126-83f7-bf044dc49efa	4edd9396-59df-4b01-9e29-dc21a59f9963
224	224	0	Participant Node Managers Committee	7f48e0c8-5c96-49ec-b972-30748e339115	4fa0d552-42a3-42f7-bfd3-789289a850c2
17	17	0	Colombian Biodiversity Information System	7e865cba-7c46-417b-ade5-97f2cf5b7be0	4fb06695-018f-4bc4-bde8-9a52814e130a
0	4	4	Plazi	ffb07bec-2d10-492d-9c37-361fe0b79427	4fb52293-f7cd-4343-9562-2b276cfaedc4
0	15	15	Plazi	ffb07bec-2d10-492d-9c37-361fe0b79427	51dee632-1d92-4ca3-b406-45e90789c50c
2	2	0	Plazi	ffb07bec-2d10-492d-9c37-361fe0b79427	5332fb9b-649a-43ab-934e-bd44824a678f
42	42	0	Participant Node Managers Committee	7f48e0c8-5c96-49ec-b972-30748e339115	5617e0b7-fb48-4f20-865f-e0be14c5f349
42	42	0	Plazi	ffb07bec-2d10-492d-9c37-361fe0b79427	56fb35e1-11b8-4ea6-bad5-908fa1c9d8b8
0	19	19	Plazi	ffb07bec-2d10-492d-9c37-361fe0b79427	5794f9f4-83ec-4365-a76c-57ec45f2fc7b
756	756	0	GBIF France	da44cd31-5901-4687-a106-6d1c7734ee3a	592229f9-c3c2-4f2e-96d6-f45a628ee321
0	241	241	Participant Node Managers Committee	7f48e0c8-5c96-49ec-b972-30748e339115	599f4843-f07a-4369-8c53-ae4fb561f5e1
0	9	9	Plazi	ffb07bec-2d10-492d-9c37-361fe0b79427	5a8f8839-a6dd-48ce-845d-97253564f5f5
1000	1000	0	GBIF Norway	4f829580-180d-46a9-9c87-ed8ec959b545	5baf7c1e-d75d-4c31-a298-5a20f2e0133c
73087	73739	652	U.S. Geological Survey	8618c64a-93e0-4300-b546-7249e5148ed2	6080b6cc-1c24-41ff-ad7f-0ebe7b56f311
391	391	0	GBIF Germany	4f6826f2-4ff6-443d-b966-e6913bd24013	6146774b-bd80-4769-ab79-f9d641c086ac
125	125	0	Plazi	ffb07bec-2d10-492d-9c37-361fe0b79427	614f76bb-0cfe-457f-b85f-fbce6770ebdd
0	1225	1225	GBIF Benin	efb9c00e-f802-45dd-8826-a52ec45b89ff	621ee32e-2595-4478-813a-25762266333a
31	31	0	GBIF Germany	4f6826f2-4ff6-443d-b966-e6913bd24013	627d0a06-f762-11e1-a439-00145eb45e9a
32	32	0	GBIF Germany	4f6826f2-4ff6-443d-b966-e6913bd24013	62d4c3ea-f762-11e1-a439-00145eb45e9a
112	112	0	GBIF Germany	4f6826f2-4ff6-443d-b966-e6913bd24013	637e68d2-f762-11e1-a439-00145eb45e9a
131	131	0	GBIF Germany	4f6826f2-4ff6-443d-b966-e6913bd24013	63e198bc-f762-11e1-a439-00145eb45e9a
121	121	0	GBIF Germany	4f6826f2-4ff6-443d-b966-e6913bd24013	640d4de0-f762-11e1-a439-00145eb45e9a
88	88	0	GBIF Germany	4f6826f2-4ff6-443d-b966-e6913bd24013	646ae5e0-f762-11e1-a439-00145eb45e9a
5739	4371	-1368	Colombian Biodiversity Information System	7e865cba-7c46-417b-ade5-97f2cf5b7be0	64a88778-8de7-4dd0-af39-2d094102cbde
8644	8644	0	GBIF Germany	4f6826f2-4ff6-443d-b966-e6913bd24013	64ab1e62-f762-11e1-a439-00145eb45e9a
0	492	492	Ocean Biodiversity Information System	ba0670b9-4186-41e6-8e70-f9cb3065551a	64c71e82-be2e-4cf5-974d-98266733a63a
1856	1856	0	GBIF France	da44cd31-5901-4687-a106-6d1c7734ee3a	658f7928-6974-4b10-a647-b540ea4c97c3
96	96	0	GBIF Portugal	673f7038-4262-4149-b753-5658a4e912f6	6730e69a-ba6d-41a6-b2e1-ed3d3bfa0995
121	121	0	GBIF Germany	4f6826f2-4ff6-443d-b966-e6913bd24013	675c96c2-f762-11e1-a439-00145eb45e9a
33	33	0	Plazi	ffb07bec-2d10-492d-9c37-361fe0b79427	688c9d9e-fd3c-4888-b003-a34991327e6d
81	81	0	GBIF Germany	4f6826f2-4ff6-443d-b966-e6913bd24013	689918ee-f762-11e1-a439-00145eb45e9a
0	4	4	Plazi	ffb07bec-2d10-492d-9c37-361fe0b79427	68e811a0-ec34-4698-ac60-b1117f354c72
2346	2346	0	Atlas of Living Australia	4a6f1b71-969e-4fc5-a693-282b05e1220c	68fc81fa-d63e-4cf1-a0e5-9e5464641166
24	24	0	GBIF Germany	4f6826f2-4ff6-443d-b966-e6913bd24013	6b406160-f762-11e1-a439-00145eb45e9a
16	16	0	GBIF Germany	4f6826f2-4ff6-443d-b966-e6913bd24013	6c016518-f762-11e1-a439-00145eb45e9a
214	308	94	National Biodiversity Network	d897a5b9-35ee-4232-94bd-b0bcaac003c2	6c2e805f-5c57-4d13-b885-90ac70375078
0	4	4	Plazi	ffb07bec-2d10-492d-9c37-361fe0b79427	6c43c04d-6b75-4e0f-8460-96a5694f23a4
87	87	0	GBIF Germany	4f6826f2-4ff6-443d-b966-e6913bd24013	7112367c-f762-11e1-a439-00145eb45e9a
46	46	0	GBIF Germany	4f6826f2-4ff6-443d-b966-e6913bd24013	7197de9e-f762-11e1-a439-00145eb45e9a
372	372	0	GBIF Germany	4f6826f2-4ff6-443d-b966-e6913bd24013	728dc994-f762-11e1-a439-00145eb45e9a
0	13	13	Plazi	ffb07bec-2d10-492d-9c37-361fe0b79427	7376e48a-e557-4a8c-bd3d-5535682e1ac4
5	5	0	GBIF Germany	4f6826f2-4ff6-443d-b966-e6913bd24013	73c458aa-f762-11e1-a439-00145eb45e9a
10269	10269	0	Colombian Biodiversity Information System	7e865cba-7c46-417b-ade5-97f2cf5b7be0	743c758d-037a-4ba8-8d91-34f82b472195
167	167	0	GBIF Germany	4f6826f2-4ff6-443d-b966-e6913bd24013	74899002-f762-11e1-a439-00145eb45e9a
8	8	0	GBIF Germany	4f6826f2-4ff6-443d-b966-e6913bd24013	74cbcf76-f762-11e1-a439-00145eb45e9a
8	8	0	GBIF Germany	4f6826f2-4ff6-443d-b966-e6913bd24013	78ded5cc-f762-11e1-a439-00145eb45e9a
179	141	-38	GBIF Germany	4f6826f2-4ff6-443d-b966-e6913bd24013	797696a0-f762-11e1-a439-00145eb45e9a
0	53	53	Plazi	ffb07bec-2d10-492d-9c37-361fe0b79427	7a5bdc12-35b6-4e41-8681-9cff9df2e91c
2	2	0	Plazi	ffb07bec-2d10-492d-9c37-361fe0b79427	7c160556-e0e1-4fd6-85e1-1f6fa0ab87d7
816	504	-312	GBIF Germany	4f6826f2-4ff6-443d-b966-e6913bd24013	7c36a786-f762-11e1-a439-00145eb45e9a
180	180	0	GBIF Germany	4f6826f2-4ff6-443d-b966-e6913bd24013	7cbfe8b6-f762-11e1-a439-00145eb45e9a
861	861	0	GBIF Germany	4f6826f2-4ff6-443d-b966-e6913bd24013	7cdea2ce-f762-11e1-a439-00145eb45e9a
66	66	0	GBIF Germany	4f6826f2-4ff6-443d-b966-e6913bd24013	7d3262b0-f762-11e1-a439-00145eb45e9a
19270	13120	-6150	GBIF Germany	4f6826f2-4ff6-443d-b966-e6913bd24013	7f25efec-f762-11e1-a439-00145eb45e9a
2045	2045	0	Biodiversity Information System of Mexico	b324e8e9-9a4c-44fa-8f1a-7f39ea7ab576	7f9af04e-f762-11e1-a439-00145eb45e9a
245	76	-169	Biodiversity Information System of Mexico	b324e8e9-9a4c-44fa-8f1a-7f39ea7ab576	7fb331fe-f762-11e1-a439-00145eb45e9a
24	24	0	GBIF France	da44cd31-5901-4687-a106-6d1c7734ee3a	80f37163-0bef-46c8-a2a4-93f172145ce1
4029	3871	-158	GBIF Germany	4f6826f2-4ff6-443d-b966-e6913bd24013	826cc36d-a7cc-4aa0-aa44-d2f7411f98f3
0	25	25	Plazi	ffb07bec-2d10-492d-9c37-361fe0b79427	8305ddf8-87ba-43a3-bfa6-08f4d2f41e6a
1657	1657	0	Canada Biodiversity Information Facility	8f83fc96-c966-4126-83f7-bf044dc49efa	847620ca-f762-11e1-a439-00145eb45e9a
88	88	0	DanBIF - Danish Biodiversity Information Facility	4ddd294f-02b7-4359-ac33-0806a9ca9c6b	84d8287e-f762-11e1-a439-00145eb45e9a
30985	30985	0	Biodiversity Information System of Mexico	b324e8e9-9a4c-44fa-8f1a-7f39ea7ab576	8506ad84-f762-11e1-a439-00145eb45e9a
4681	4681	0	GBIF Spain	1f94b3ca-9345-4d65-afe2-4bace93aa0fe	8670893a-08ad-4735-8c18-eb088443ccd6
0	40	40	Ocean Biodiversity Information System	ba0670b9-4186-41e6-8e70-f9cb3065551a	86ebe20d-bf85-4aca-8d18-c3a84f382fc0
4628	3917	-711	GBIF Germany	4f6826f2-4ff6-443d-b966-e6913bd24013	872c922c-f762-11e1-a439-00145eb45e9a
0	10	10	Plazi	ffb07bec-2d10-492d-9c37-361fe0b79427	87a6a8b8-2167-4ff1-89c5-d3a94e8ba51b
0	54	54	Plazi	ffb07bec-2d10-492d-9c37-361fe0b79427	87c4739e-7fe1-41e7-a25f-aae7e837fb33
818	247	-571	GBIF Germany	4f6826f2-4ff6-443d-b966-e6913bd24013	894cac9a-f762-11e1-a439-00145eb45e9a
156	156	0	GBIF Germany	4f6826f2-4ff6-443d-b966-e6913bd24013	8a65404c-f762-11e1-a439-00145eb45e9a
79	79	0	GBIF Germany	4f6826f2-4ff6-443d-b966-e6913bd24013	8b960e4c-f762-11e1-a439-00145eb45e9a
1050	1050	0	GBIF Germany	4f6826f2-4ff6-443d-b966-e6913bd24013	8bf5e810-aec4-4a32-950a-0cdb682ada68
55	26	-29	GBIF Germany	4f6826f2-4ff6-443d-b966-e6913bd24013	8c7b1384-f762-11e1-a439-00145eb45e9a
3	3	0	GBIF Germany	4f6826f2-4ff6-443d-b966-e6913bd24013	8c7c645a-f762-11e1-a439-00145eb45e9a
3	3	0	GBIF Germany	4f6826f2-4ff6-443d-b966-e6913bd24013	8d263d9a-f762-11e1-a439-00145eb45e9a
1932	1656	-276	GBIF Germany	4f6826f2-4ff6-443d-b966-e6913bd24013	8d9b1ba6-f762-11e1-a439-00145eb45e9a
211	211	0	Plazi	ffb07bec-2d10-492d-9c37-361fe0b79427	8e0aac3a-6556-4b96-a67e-fce9f0db0ba9
0	1	1	Plazi	ffb07bec-2d10-492d-9c37-361fe0b79427	8ecaab8d-d06c-49ad-9d86-8da8c02269fb
11	11	0	GBIF Germany	4f6826f2-4ff6-443d-b966-e6913bd24013	8efe821c-f762-11e1-a439-00145eb45e9a
0	50	50	Plazi	ffb07bec-2d10-492d-9c37-361fe0b79427	8f75cfe0-179d-46ad-990b-e1fa3d6c577f
95	58	-37	GBIF Germany	4f6826f2-4ff6-443d-b966-e6913bd24013	9036662c-f762-11e1-a439-00145eb45e9a
1027	559	-468	GBIF Germany	4f6826f2-4ff6-443d-b966-e6913bd24013	906a1b02-f762-11e1-a439-00145eb45e9a
1	1	0	Plazi	ffb07bec-2d10-492d-9c37-361fe0b79427	916e8f21-c7e4-4fe1-8393-4a1a89971ed7
34	34	0	GBIF Germany	4f6826f2-4ff6-443d-b966-e6913bd24013	91e372da-f762-11e1-a439-00145eb45e9a
4	4	0	Plazi	ffb07bec-2d10-492d-9c37-361fe0b79427	92957f37-f810-4bdf-a6e6-fcf99047b816
6	6	0	Plazi	ffb07bec-2d10-492d-9c37-361fe0b79427	93a001ae-6727-4e2c-ac83-2366ee3fa9a2
96415	96884	469	U.S. Geological Survey	8618c64a-93e0-4300-b546-7249e5148ed2	9642d0e6-f762-11e1-a439-00145eb45e9a
2000	1012	-988	GBIF Germany	4f6826f2-4ff6-443d-b966-e6913bd24013	96d05790-f762-11e1-a439-00145eb45e9a
148	148	0	GBIF Germany	4f6826f2-4ff6-443d-b966-e6913bd24013	978a823c-f762-11e1-a439-00145eb45e9a
0	5	5	Plazi	ffb07bec-2d10-492d-9c37-361fe0b79427	98062a63-8006-49e2-a44f-3def52ff1621
0	2	2	Plazi	ffb07bec-2d10-492d-9c37-361fe0b79427	9842d962-d925-4b1f-9e4d-a6ed391769bf
199	199	0	Biodiversity Information System of Mexico	b324e8e9-9a4c-44fa-8f1a-7f39ea7ab576	992a83fc-4535-4846-9a19-eb8575bf2b93
2	2	0	Biodiversity Information System of Mexico	b324e8e9-9a4c-44fa-8f1a-7f39ea7ab576	9b5720a2-99f7-4e29-86c8-c028e67a86f2
66	66	0	Participant Node Managers Committee	7f48e0c8-5c96-49ec-b972-30748e339115	9cdfd6cb-b1b0-4534-bdb0-a50a0e68076a
3310	3310	0	GBIF Brazil	cdc9736d-5ff7-4ece-9959-3c744360cdb3	a13e37f5-f1c7-4d99-9423-1c4fc8e385f2
12	12	0	Plazi	ffb07bec-2d10-492d-9c37-361fe0b79427	a2998b46-05c6-48ce-b2d7-58f4143cd0bd
1551	1551	0	GBIF Brazil	cdc9736d-5ff7-4ece-9959-3c744360cdb3	a68403f2-b43f-4747-bd54-1e3eeb03dd46
41	41	0	Plazi	ffb07bec-2d10-492d-9c37-361fe0b79427	a6f97fb4-bd2d-4891-85e3-4f04b5a10a65
6	6	0	Plazi	ffb07bec-2d10-492d-9c37-361fe0b79427	a741a81e-10e2-4068-904d-58a7b1ca9fea
2	2	0	Plazi	ffb07bec-2d10-492d-9c37-361fe0b79427	ab59b6ef-83ac-459c-b397-dd5d9df689b7
16	16	0	Plazi	ffb07bec-2d10-492d-9c37-361fe0b79427	ae7b04fa-833d-44a4-abaa-17a6c7d9db13
24108366	26327067	2218701	GBIF Norway	4f829580-180d-46a9-9c87-ed8ec959b545	b124e1e0-4755-430f-9eab-894f25a9b59c
0	2	2	Plazi	ffb07bec-2d10-492d-9c37-361fe0b79427	b239c0a1-24c5-4d67-8193-68690b87104f
5	5	0	Plazi	ffb07bec-2d10-492d-9c37-361fe0b79427	b3042b79-d97f-4f91-93fc-7b7b4f4ac356
0	4066	4066	Colombian Biodiversity Information System	7e865cba-7c46-417b-ade5-97f2cf5b7be0	b33524f0-08f1-4b45-b239-dd320fbc255b
40	40	0	Plazi	ffb07bec-2d10-492d-9c37-361fe0b79427	b7631fff-5be6-4105-a016-02f9de149381
14	14	0	Plazi	ffb07bec-2d10-492d-9c37-361fe0b79427	bc0690ff-ca74-4ba8-bc70-7376f04cf203
2	2	0	Plazi	ffb07bec-2d10-492d-9c37-361fe0b79427	bd936632-1fe4-4af0-87ad-8acf2015fb14
5	5	0	Plazi	ffb07bec-2d10-492d-9c37-361fe0b79427	bdfda4f8-b664-4aa0-bda1-cb776a8c951b
8	8	0	Plazi	ffb07bec-2d10-492d-9c37-361fe0b79427	be859ab2-245b-4477-b770-108671f5bb1b
10	10	0	Plazi	ffb07bec-2d10-492d-9c37-361fe0b79427	bef1682b-7f93-4164-874f-09070b27657d
0	1	1	Plazi	ffb07bec-2d10-492d-9c37-361fe0b79427	bf986f14-c228-4d06-abbb-14a697965008
18	18	0	Plazi	ffb07bec-2d10-492d-9c37-361fe0b79427	c1bbbcd3-24be-4faa-a79d-a963d91f7e4f
175	175	0	Plazi	ffb07bec-2d10-492d-9c37-361fe0b79427	c482a3df-aa6d-430b-be6b-ebb423d5115e
0	247	247	Participant Node Managers Committee	7f48e0c8-5c96-49ec-b972-30748e339115	c63da19d-5bda-4325-8f85-1abe747b141c
19	19	0	Belgian Biodiversity Platform	fb11cfe1-ebc3-45af-9159-17d9fddbcdac	c789ebf2-bc41-46a8-8e3a-ac0ac082649e
464	464	0	Colombian Biodiversity Information System	7e865cba-7c46-417b-ade5-97f2cf5b7be0	c9b7a0c1-2a52-437f-b1ed-e4a5bbfd04bb
96596	96596	0	Atlas of Living Australia	4a6f1b71-969e-4fc5-a693-282b05e1220c	d0e133c0-6c8a-11de-8226-b8a03c50a862
0	2	2	Plazi	ffb07bec-2d10-492d-9c37-361fe0b79427	d1f7f1e8-2e52-45ca-bd7f-f3e4e5c8d7cc
48	48	0	Ocean Biodiversity Information System	ba0670b9-4186-41e6-8e70-f9cb3065551a	d22f7b9a-d2d5-42d2-8b44-adb09b338a25
83	83	0	Plazi	ffb07bec-2d10-492d-9c37-361fe0b79427	d3e2e8f0-829f-4e34-aa82-14c0409aa379
1884	1884	0	Atlas of Living Australia	4a6f1b71-969e-4fc5-a693-282b05e1220c	d3e6fa33-75a8-481b-bae4-7bafd683da67
2691	2691	0	U.S. Geological Survey	8618c64a-93e0-4300-b546-7249e5148ed2	d49eda53-61b4-4d64-9550-16e527771945
0	9	9	Plazi	ffb07bec-2d10-492d-9c37-361fe0b79427	d65d87c4-f7ba-4396-8ab8-2d4faca8d85b
259	259	0	U.S. Geological Survey	8618c64a-93e0-4300-b546-7249e5148ed2	d81371fe-4ba7-4884-af39-19e90cf665c3
1	1	0	Colombian Biodiversity Information System	7e865cba-7c46-417b-ade5-97f2cf5b7be0	d999e701-d3d5-48a5-8444-2a9fc45970ec
9	9	0	Plazi	ffb07bec-2d10-492d-9c37-361fe0b79427	daaa3f35-2ff6-4b7b-8789-cfdbe7aaf40e
0	1	1	Plazi	ffb07bec-2d10-492d-9c37-361fe0b79427	db6dff28-8b2a-40eb-8495-d4dce558297d
153	153	0	Participant Node Managers Committee	7f48e0c8-5c96-49ec-b972-30748e339115	dbdb3583-f8a0-466c-9a55-1cf8273e33c2
1491	1491	0	Biodiversity Information System of Mexico	b324e8e9-9a4c-44fa-8f1a-7f39ea7ab576	dd83b173-0b9f-4262-a49d-c72982965e69
0	6	6	Plazi	ffb07bec-2d10-492d-9c37-361fe0b79427	de928cf2-80ea-4ede-ad12-3ac0300b1ae9
0	17	17	Ocean Biodiversity Information System	ba0670b9-4186-41e6-8e70-f9cb3065551a	e080cae8-4d98-434d-a644-a36e7d3ba9d1
8	8	0	Plazi	ffb07bec-2d10-492d-9c37-361fe0b79427	e4793122-9b59-4473-9912-18d50e3db61c
2018	1506	-512	GBIF Germany	4f6826f2-4ff6-443d-b966-e6913bd24013	e5bf3a54-cbf0-4603-b2ce-2600ba5b4902
124	124	0	Plazi	ffb07bec-2d10-492d-9c37-361fe0b79427	e6d1886d-e154-4da5-b018-8fbeebb1ff37
59	59	0	Plazi	ffb07bec-2d10-492d-9c37-361fe0b79427	e6d54a30-c8bf-488e-ba81-28cf160f0954
27	27	0	Colombian Biodiversity Information System	7e865cba-7c46-417b-ade5-97f2cf5b7be0	e7a08060-8999-4a87-bf9e-b45c5c43d4c9
0	3	3	Plazi	ffb07bec-2d10-492d-9c37-361fe0b79427	e8d4a720-8871-451c-ba1e-610d851dea05
128	128	0	Participant Node Managers Committee	7f48e0c8-5c96-49ec-b972-30748e339115	e8f929c6-25f2-46dd-bab1-7968b4d624f5
11	11	0	Plazi	ffb07bec-2d10-492d-9c37-361fe0b79427	ea3961a2-6410-4963-9e03-af59316cac6d
0	9	9	Plazi	ffb07bec-2d10-492d-9c37-361fe0b79427	ea5dbb48-a394-496d-bb3c-b22600be32c8
19	19	0	Plazi	ffb07bec-2d10-492d-9c37-361fe0b79427	ec6be03d-946c-4cf8-ac6e-ab40440290df
5	5	0	Participant Node Managers Committee	7f48e0c8-5c96-49ec-b972-30748e339115	eef9a1d5-fae2-4308-909f-e35ecaeb4d65
333	333	0	Colombian Biodiversity Information System	7e865cba-7c46-417b-ade5-97f2cf5b7be0	ef734661-05f7-4cdb-86e0-58c2eaca0127
712	712	0	Plazi	ffb07bec-2d10-492d-9c37-361fe0b79427	f0ba3254-67ac-4d33-a341-c71ff16c05f0
17	17	0	Plazi	ffb07bec-2d10-492d-9c37-361fe0b79427	f2295068-0b04-4312-a1af-7e502201d0a8
3680	3680	0	Canada Biodiversity Information Facility	8f83fc96-c966-4126-83f7-bf044dc49efa	f2432903-d59c-4e10-8001-7c3be469687a
1234	1800	566	U.S. Geological Survey	8618c64a-93e0-4300-b546-7249e5148ed2	f28219f3-49cd-4b55-99ad-39f3ced87ddd
424181	427589	3408	Netherlands Biodiversity Information Facility	0909d601-bda2-42df-9e63-a6d51847ebce	f3130a8a-4508-42b4-9737-fbda77748438
57	57	0	Plazi	ffb07bec-2d10-492d-9c37-361fe0b79427	f86cdbb3-2d4c-4475-8aaf-85dd0c3f4d2f
28	28	0	GBIF France	da44cd31-5901-4687-a106-6d1c7734ee3a	f8cb69cc-c3b7-4dd2-be04-da27b19e9f30
45	45	0	Plazi	ffb07bec-2d10-492d-9c37-361fe0b79427	f96d0813-0ad2-4230-a3a9-a0962c77d76a
0	5	5	Participant Node Managers Committee	7f48e0c8-5c96-49ec-b972-30748e339115	fd5a15c2-21cd-47de-b20d-973e32239afb
1	1	0	Plazi	ffb07bec-2d10-492d-9c37-361fe0b79427	fdc2c477-30f9-460a-97d1-09f9ba92502a
1581	1581	0	GBIF Benin	efb9c00e-f802-45dd-8826-a52ec45b89ff	fe903576-72e1-446a-b019-479f537adabe
1	1	0	Plazi	ffb07bec-2d10-492d-9c37-361fe0b79427	0148bd72-b451-4ecd-918d-b1a0733a1a53
11809	14502	2693	U.S. Geological Survey	8618c64a-93e0-4300-b546-7249e5148ed2	042051f6-e602-4281-8ac3-d683811f0631
0	5	5	Plazi	ffb07bec-2d10-492d-9c37-361fe0b79427	053bdfd9-33a5-45ca-9412-033fd3cab722
3	3	0	Plazi	ffb07bec-2d10-492d-9c37-361fe0b79427	066c9740-34e8-4d36-ad8c-fc40f2b5688e
0	2	2	Plazi	ffb07bec-2d10-492d-9c37-361fe0b79427	0afaf229-3c45-4431-bc60-16b8cbec083e
23	23	0	Plazi	ffb07bec-2d10-492d-9c37-361fe0b79427	138be9ad-b476-48af-93ee-6fd78c04484d
0	3	3	Plazi	ffb07bec-2d10-492d-9c37-361fe0b79427	16192c3b-e316-4503-aece-0417856470db
1757	1757	0	Colombian Biodiversity Information System	7e865cba-7c46-417b-ade5-97f2cf5b7be0	19648428-6ecc-489c-8600-29608829b42d
97242	97615	373	Netherlands Biodiversity Information Facility	0909d601-bda2-42df-9e63-a6d51847ebce	19828488-7ebf-43f8-88af-6461d8afef9e
135	135	0	GBIF France	da44cd31-5901-4687-a106-6d1c7734ee3a	1b4d985a-dce1-40da-bdf4-07166e5f811c
0	467	467	Plazi	ffb07bec-2d10-492d-9c37-361fe0b79427	1be5ef5e-087c-4f67-b4bc-257602ef0842
1	1	0	Plazi	ffb07bec-2d10-492d-9c37-361fe0b79427	1ee19d5d-27cf-4c93-989c-3fe3eb467203
71	71	0	Plazi	ffb07bec-2d10-492d-9c37-361fe0b79427	1fd9017d-6a56-470b-aa83-68944cd8ac46
14	14	0	Plazi	ffb07bec-2d10-492d-9c37-361fe0b79427	21c0eabc-181c-4d2c-aa74-9ebff7ee3260
0	24	24	Plazi	ffb07bec-2d10-492d-9c37-361fe0b79427	22a045e8-95c0-4981-993f-9d044342e1cb
0	361	361	Colombian Biodiversity Information System	7e865cba-7c46-417b-ade5-97f2cf5b7be0	22cd0ec0-8b3a-41e1-bd18-1d905631464f
9093	9093	0	Biodiversity Information System of Mexico	b324e8e9-9a4c-44fa-8f1a-7f39ea7ab576	256d6bdb-9044-4bf9-b0f3-c70c7167dc95
27	27	0	Plazi	ffb07bec-2d10-492d-9c37-361fe0b79427	25b07a0d-7a27-460e-8813-713dbfb1888c
0	495	495	Colombian Biodiversity Information System	7e865cba-7c46-417b-ade5-97f2cf5b7be0	2c49ab6f-b6fa-4522-aa46-317731e076b5
26	26	0	Colombian Biodiversity Information System	7e865cba-7c46-417b-ade5-97f2cf5b7be0	2d1ecede-c4ac-47fd-aef1-34cee9dfd85a
3	3	0	Plazi	ffb07bec-2d10-492d-9c37-361fe0b79427	2e947408-696d-4bf5-81e1-b182422c60c1
2099	2099	0	GBIF France	da44cd31-5901-4687-a106-6d1c7734ee3a	2ecc1378-881d-4dc4-8c2a-5763a01bdd02
12051	12051	0	U.S. Geological Survey	8618c64a-93e0-4300-b546-7249e5148ed2	2ffeb29f-0971-474c-895e-45e60da3b2a3
46	46	0	Plazi	ffb07bec-2d10-492d-9c37-361fe0b79427	30b8be8d-e6d5-4c63-b33f-e5a2eafb087e
207	207	0	National Biodiversity Network	d897a5b9-35ee-4232-94bd-b0bcaac003c2	30f55c63-a829-4cb2-9676-3b1b6f981567
7000	10791	3791	Korean Biodiversity Information Facility	e0a1e772-0177-4800-94b4-2d023fe6cdf4	31dc1ba4-2c52-4fad-a425-f4e0cf00951c
1422	1422	0	GBIF Germany	4f6826f2-4ff6-443d-b966-e6913bd24013	326deaca-abe0-40e5-871a-60703ed4d436
2	2	0	Plazi	ffb07bec-2d10-492d-9c37-361fe0b79427	333e0858-f187-417b-8f38-23f615f9210c
0	26	26	Ocean Biodiversity Information System	ba0670b9-4186-41e6-8e70-f9cb3065551a	3474f80b-f82d-4139-b06a-f351323e4d24
111	111	0	GBIF France	da44cd31-5901-4687-a106-6d1c7734ee3a	35707d74-b6c5-4241-9428-8942e38e5f0d
83	83	0	Polish Biodiversity Information Network	2618bfdf-e194-4911-a241-80db3107bc51	3c7d6270-9681-11dc-8149-b8a03c50a862
0	3	3	Plazi	ffb07bec-2d10-492d-9c37-361fe0b79427	3d169542-66a9-4fc8-8504-a7b676642377
3	3	0	Plazi	ffb07bec-2d10-492d-9c37-361fe0b79427	3d4e24f9-009f-4c6f-bfa1-91764c939125
0	3	3	Plazi	ffb07bec-2d10-492d-9c37-361fe0b79427	3f8b5dcb-1a85-4e87-b1df-222993937d0c
0	3	3	Plazi	ffb07bec-2d10-492d-9c37-361fe0b79427	3fe0c819-26ea-433f-b3f8-1041544baa58
9	9	0	Plazi	ffb07bec-2d10-492d-9c37-361fe0b79427	416ec733-6c0b-4fd1-b7e6-4990ec99839b
0	76	76	Plazi	ffb07bec-2d10-492d-9c37-361fe0b79427	452920ba-ddea-4a3c-8a6c-97e325917d11
443	440	-3	Biodiversity Information System of Mexico	b324e8e9-9a4c-44fa-8f1a-7f39ea7ab576	45347233-6a4f-4843-b4f2-9573eef8dea0
1016	1016	0	Biodiversity Information System of Mexico	b324e8e9-9a4c-44fa-8f1a-7f39ea7ab576	4661c970-737e-4037-8059-9a99365ac856
561	561	0	GBIF Spain	1f94b3ca-9345-4d65-afe2-4bace93aa0fe	4a63a8ba-dbeb-4c02-878d-96343f948471
0	2	2	Plazi	ffb07bec-2d10-492d-9c37-361fe0b79427	4b2c6911-3003-495a-a26c-911f695339fb
591	591	0	GBIF Germany	4f6826f2-4ff6-443d-b966-e6913bd24013	4c63fdf6-8e91-49c3-b4fd-bbe9c09c5186
234295	234295	0	National Biodiversity Network	d897a5b9-35ee-4232-94bd-b0bcaac003c2	4e7da2f8-d662-47f8-883c-881e41b82636
165	165	0	GBIF France	da44cd31-5901-4687-a106-6d1c7734ee3a	51be38fe-9159-4f4c-b2c7-b2a4c2db167f
884	884	0	Atlas of Living Australia	4a6f1b71-969e-4fc5-a693-282b05e1220c	522ff2e2-94f4-456f-b540-32f65f4b51ff
1250	450	-800	GBIF Germany	4f6826f2-4ff6-443d-b966-e6913bd24013	54e7d6b6-7344-4c6e-887f-bbd1a6286fe7
0	289	289	U.S. Geological Survey	8618c64a-93e0-4300-b546-7249e5148ed2	59a63b10-7c8d-4019-bd88-3417f0daa76d
2252	2252	0	Ocean Biodiversity Information System	ba0670b9-4186-41e6-8e70-f9cb3065551a	5d763aa6-4c97-4790-a609-a714b6451384
0	1	1	Plazi	ffb07bec-2d10-492d-9c37-361fe0b79427	600feca3-8ebf-4e20-bdd8-8eb2c2d454a5
0	2	2	Plazi	ffb07bec-2d10-492d-9c37-361fe0b79427	60d9cb35-b34d-46ab-8572-c0f67225db15
15	15	0	GBIF Germany	4f6826f2-4ff6-443d-b966-e6913bd24013	617009ce-f762-11e1-a439-00145eb45e9a
30	30	0	GBIF Germany	4f6826f2-4ff6-443d-b966-e6913bd24013	62092370-f762-11e1-a439-00145eb45e9a
7	7	0	Plazi	ffb07bec-2d10-492d-9c37-361fe0b79427	622ed67d-ef4f-48f1-9ba0-dc351fdcbf5a
161	161	0	GBIF Germany	4f6826f2-4ff6-443d-b966-e6913bd24013	638fa728-f762-11e1-a439-00145eb45e9a
120	120	0	GBIF France	da44cd31-5901-4687-a106-6d1c7734ee3a	63e99f54-97aa-4a72-8565-6460b5a55be4
112	112	0	GBIF Germany	4f6826f2-4ff6-443d-b966-e6913bd24013	63f0ad2a-f762-11e1-a439-00145eb45e9a
18	18	0	GBIF Germany	4f6826f2-4ff6-443d-b966-e6913bd24013	6486fbcc-f762-11e1-a439-00145eb45e9a
9	9	0	Plazi	ffb07bec-2d10-492d-9c37-361fe0b79427	6501694a-b95a-4ee9-a24c-6d8c0100ea0a
0	3	3	Plazi	ffb07bec-2d10-492d-9c37-361fe0b79427	6544c31d-cd08-495d-85dd-3511bb6d811d
39	39	0	Plazi	ffb07bec-2d10-492d-9c37-361fe0b79427	65711221-5a3e-4e91-a9ca-d44b09da1960
33	33	0	GBIF Germany	4f6826f2-4ff6-443d-b966-e6913bd24013	659281f8-f762-11e1-a439-00145eb45e9a
51	51	0	GBIF Germany	4f6826f2-4ff6-443d-b966-e6913bd24013	6696dd10-f762-11e1-a439-00145eb45e9a
0	2963	2963	Participant Node Managers Committee	7f48e0c8-5c96-49ec-b972-30748e339115	6766f9d3-c680-46c0-8efa-375e39718b93
5253	5253	0	GBIF Argentina	2426a871-9feb-40a1-96c6-0c593a76b835	6896d821-08cd-49e6-9fa0-559bd37d86a4
55484	55484	0	GBIF France	da44cd31-5901-4687-a106-6d1c7734ee3a	68e364c7-2e11-4fbd-9417-bbc4ce2d188a
17	17	0	GBIF Germany	4f6826f2-4ff6-443d-b966-e6913bd24013	6911ee72-f762-11e1-a439-00145eb45e9a
146	146	0	GBIF Germany	4f6826f2-4ff6-443d-b966-e6913bd24013	69acb420-f762-11e1-a439-00145eb45e9a
907	929	22	GBIF Germany	4f6826f2-4ff6-443d-b966-e6913bd24013	6a8358a6-514f-4d55-ae91-da4cbe05025d
18	18	0	GBIF Germany	4f6826f2-4ff6-443d-b966-e6913bd24013	6a9acf34-f762-11e1-a439-00145eb45e9a
42	42	0	GBIF Germany	4f6826f2-4ff6-443d-b966-e6913bd24013	6abba54c-f762-11e1-a439-00145eb45e9a
1	1	0	Plazi	ffb07bec-2d10-492d-9c37-361fe0b79427	6b3fcdbf-53d5-47e5-9b72-3bbfc98e4168
4	4	0	GBIF Germany	4f6826f2-4ff6-443d-b966-e6913bd24013	6b635f62-f762-11e1-a439-00145eb45e9a
4	4	0	Plazi	ffb07bec-2d10-492d-9c37-361fe0b79427	6b7573cf-c99b-4d3f-813f-f291a4541f92
18	18	0	GBIF Germany	4f6826f2-4ff6-443d-b966-e6913bd24013	6b8e4222-f762-11e1-a439-00145eb45e9a
7	7	0	Plazi	ffb07bec-2d10-492d-9c37-361fe0b79427	6c265599-4dcf-4602-8dec-2800e34a44ff
36	36	0	GBIF Germany	4f6826f2-4ff6-443d-b966-e6913bd24013	6c88a1ae-f762-11e1-a439-00145eb45e9a
178	178	0	National Biodiversity Network	d897a5b9-35ee-4232-94bd-b0bcaac003c2	6e4c81c4-0f5d-4e0b-a1db-2dc297e55dbe
66	66	0	GBIF Germany	4f6826f2-4ff6-443d-b966-e6913bd24013	6fc45f7a-f762-11e1-a439-00145eb45e9a
2	2	0	Plazi	ffb07bec-2d10-492d-9c37-361fe0b79427	6fe1b1fb-f82f-48d9-8683-e08a9b35de1c
160	160	0	GBIF Germany	4f6826f2-4ff6-443d-b966-e6913bd24013	7025c72e-f762-11e1-a439-00145eb45e9a
14	14	0	Plazi	ffb07bec-2d10-492d-9c37-361fe0b79427	704cb2ad-27f5-4fe1-bedf-12c20ff52146
28	28	0	GBIF Germany	4f6826f2-4ff6-443d-b966-e6913bd24013	70d09d98-f762-11e1-a439-00145eb45e9a
75	75	0	GBIF Germany	4f6826f2-4ff6-443d-b966-e6913bd24013	718bc0aa-f762-11e1-a439-00145eb45e9a
6746	6746	0	GBIF Japan	db5705aa-6a6e-42f1-8942-d77b9f4896ea	71dfecde-f762-11e1-a439-00145eb45e9a
31	31	0	GBIF Germany	4f6826f2-4ff6-443d-b966-e6913bd24013	7270c98f-f777-4b83-bb0d-55edf32a4ece
23	23	0	GBIF Germany	4f6826f2-4ff6-443d-b966-e6913bd24013	72a60b4e-f762-11e1-a439-00145eb45e9a
0	2	2	Plazi	ffb07bec-2d10-492d-9c37-361fe0b79427	73010922-2d71-4ccd-b314-a97f05ad6a1a
0	1426	1426	Ocean Biodiversity Information System	ba0670b9-4186-41e6-8e70-f9cb3065551a	730378a0-2049-4d38-a6e6-4dd52b80c5d4
642	642	0	Colombian Biodiversity Information System	7e865cba-7c46-417b-ade5-97f2cf5b7be0	735ff20c-6d61-445e-bbb4-e1787e5f72f3
50	50	0	GBIF Germany	4f6826f2-4ff6-443d-b966-e6913bd24013	73669030-f762-11e1-a439-00145eb45e9a
9	9	0	Plazi	ffb07bec-2d10-492d-9c37-361fe0b79427	77436b0e-9e7a-48e5-b280-dd9491c58b68
262	262	0	GBIF Germany	4f6826f2-4ff6-443d-b966-e6913bd24013	774dba48-f762-11e1-a439-00145eb45e9a
3741	3139	-602	GBIF Germany	4f6826f2-4ff6-443d-b966-e6913bd24013	793b46fe-f762-11e1-a439-00145eb45e9a
0	47	47	Plazi	ffb07bec-2d10-492d-9c37-361fe0b79427	79e89450-a9a3-4f16-b66e-963175710688
1960	1960	0	GBIF Germany	4f6826f2-4ff6-443d-b966-e6913bd24013	7c024766-f762-11e1-a439-00145eb45e9a
980	980	0	GBIF Germany	4f6826f2-4ff6-443d-b966-e6913bd24013	7d1da8a2-f762-11e1-a439-00145eb45e9a
0	3	3	Plazi	ffb07bec-2d10-492d-9c37-361fe0b79427	802d3a24-857e-4f68-8b20-9429ac95d2b0
11719	7309	-4410	Biodiversity Information System of Mexico	b324e8e9-9a4c-44fa-8f1a-7f39ea7ab576	8038283c-f762-11e1-a439-00145eb45e9a
312	52	-260	GBIF Germany	4f6826f2-4ff6-443d-b966-e6913bd24013	8225a4f8-f762-11e1-a439-00145eb45e9a
1	1	0	Plazi	ffb07bec-2d10-492d-9c37-361fe0b79427	831c4757-fd8b-48e7-b259-e4d1004654d0
479	479	0	World Federation for Culture Collections	a6bdc523-5368-4e0f-9d2e-de1c262ac092	85562800-f762-11e1-a439-00145eb45e9a
17	17	0	GBIF Germany	4f6826f2-4ff6-443d-b966-e6913bd24013	85d88d4a-f762-11e1-a439-00145eb45e9a
3	3	0	Plazi	ffb07bec-2d10-492d-9c37-361fe0b79427	8671ee56-581b-443a-9bff-1a7cb262a914
918	460	-458	GBIF Germany	4f6826f2-4ff6-443d-b966-e6913bd24013	86da1876-f762-11e1-a439-00145eb45e9a
8159	8159	0	National Biodiversity Network	d897a5b9-35ee-4232-94bd-b0bcaac003c2	8707c631-1991-4a3c-b68b-c6a31a2e40ca
574	414	-160	GBIF Germany	4f6826f2-4ff6-443d-b966-e6913bd24013	87e03d04-f762-11e1-a439-00145eb45e9a
915	915	0	National Biodiversity Network	d897a5b9-35ee-4232-94bd-b0bcaac003c2	8848da02-884f-4a52-9a58-b8c57f50fa16
6888	6888	0	U.S. Geological Survey	8618c64a-93e0-4300-b546-7249e5148ed2	8855595b-a836-4557-b17b-794aadda747a
584	584	0	GBIF France	da44cd31-5901-4687-a106-6d1c7734ee3a	88771261-dafe-4a94-9349-91b9fe752cd3
63364	63364	0	Ocean Biodiversity Information System	ba0670b9-4186-41e6-8e70-f9cb3065551a	890fb006-f762-11e1-a439-00145eb45e9a
80	80	0	GBIF Germany	4f6826f2-4ff6-443d-b966-e6913bd24013	8a370826-f762-11e1-a439-00145eb45e9a
199	199	0	GBIF Germany	4f6826f2-4ff6-443d-b966-e6913bd24013	8a89040a-f762-11e1-a439-00145eb45e9a
3	3	0	Plazi	ffb07bec-2d10-492d-9c37-361fe0b79427	8af6fb6a-5af5-4e0a-80b0-f7d2e39e7c34
242	242	0	Atlas of Living Australia	4a6f1b71-969e-4fc5-a693-282b05e1220c	8bdcf8fe-a73b-4456-a5c3-8b20279f0521
12	6	-6	GBIF Germany	4f6826f2-4ff6-443d-b966-e6913bd24013	8ce0e9de-f762-11e1-a439-00145eb45e9a
168	168	0	GBIF Germany	4f6826f2-4ff6-443d-b966-e6913bd24013	8d3f7300-f762-11e1-a439-00145eb45e9a
69	61	-8	GBIF Germany	4f6826f2-4ff6-443d-b966-e6913bd24013	8f36e594-f762-11e1-a439-00145eb45e9a
0	2	2	Plazi	ffb07bec-2d10-492d-9c37-361fe0b79427	8fb664c2-5fed-4301-8e4c-56cb7f20d044
784	545	-239	GBIF Germany	4f6826f2-4ff6-443d-b966-e6913bd24013	8fcd9ed0-f762-11e1-a439-00145eb45e9a
266	228	-38	GBIF Germany	4f6826f2-4ff6-443d-b966-e6913bd24013	9098a13e-f762-11e1-a439-00145eb45e9a
456	456	0	GBIF Germany	4f6826f2-4ff6-443d-b966-e6913bd24013	9256ce4c-f762-11e1-a439-00145eb45e9a
1068	1068	0	GBIF Germany	4f6826f2-4ff6-443d-b966-e6913bd24013	93fb595c-f762-11e1-a439-00145eb45e9a
804	804	0	GBIF Germany	4f6826f2-4ff6-443d-b966-e6913bd24013	942baeae-f762-11e1-a439-00145eb45e9a
3311	3311	0	National Biodiversity Data Centre	422b00b2-6c94-4bb6-976b-c359916efdb8	9505d1b0-c7b8-11de-b279-e4d24581262a
2315	2315	0	GBIF France	da44cd31-5901-4687-a106-6d1c7734ee3a	96d5dfa6-93d1-4686-b4df-6b256fb38e32
0	38	38	Ocean Biodiversity Information System	ba0670b9-4186-41e6-8e70-f9cb3065551a	975ae7fc-6054-4a74-8523-2d8fe01449df
115	115	0	Participant Node Managers Committee	7f48e0c8-5c96-49ec-b972-30748e339115	9a343474-037b-43c3-ba7e-1ae3622c2908
3	3	0	Plazi	ffb07bec-2d10-492d-9c37-361fe0b79427	9ac2ddb8-dd20-46e0-9402-e8790cc45152
5	5	0	Plazi	ffb07bec-2d10-492d-9c37-361fe0b79427	9acb944e-e2ab-482e-b425-79daf7f83c84
0	7	7	Plazi	ffb07bec-2d10-492d-9c37-361fe0b79427	9e1d05ca-e6cd-41af-820b-68a243c3d5ea
2	2	0	Plazi	ffb07bec-2d10-492d-9c37-361fe0b79427	9ea84d3c-8921-4bf3-af08-88845bf4f91c
6668	6668	0	Korean Biodiversity Information Facility	e0a1e772-0177-4800-94b4-2d023fe6cdf4	9f9286fe-ca42-4195-874b-13dc6f5d4861
1	1	0	Plazi	ffb07bec-2d10-492d-9c37-361fe0b79427	a1b47413-2f76-404c-86e4-571b06c6a1cd
24	24	0	Plazi	ffb07bec-2d10-492d-9c37-361fe0b79427	a469ea9d-153e-48a6-b317-5fc221ac5660
6	6	0	Plazi	ffb07bec-2d10-492d-9c37-361fe0b79427	a4cfe7ed-fee8-4926-81dd-40ddb649a9f6
2782	2782	0	Participant Node Managers Committee	7f48e0c8-5c96-49ec-b972-30748e339115	a573707e-0b86-44c4-b567-70a6ed029c94
1458	1458	0	GBIF Brazil	cdc9736d-5ff7-4ece-9959-3c744360cdb3	a59636ef-6028-4fa4-8895-553ba8af3b02
400	400	0	GBIF France	da44cd31-5901-4687-a106-6d1c7734ee3a	a5de4acf-39c5-4492-958e-983a13a611f9
14	14	0	Plazi	ffb07bec-2d10-492d-9c37-361fe0b79427	a757de0f-b7ba-4ef8-9c95-24cfc4226b76
3	3	0	Plazi	ffb07bec-2d10-492d-9c37-361fe0b79427	ac373c26-f1c9-42fa-bf96-94e9914d0617
20	20	0	GBIF France	da44cd31-5901-4687-a106-6d1c7734ee3a	ae7a982f-a42b-4524-8c82-7c4f3bb35a46
5	5	0	Plazi	ffb07bec-2d10-492d-9c37-361fe0b79427	b4db3d71-dcaf-46a5-8921-b6ae6a91ab6e
0	6	6	Plazi	ffb07bec-2d10-492d-9c37-361fe0b79427	b578edb5-33dc-4d09-aaa5-e23e25768061
53	53	0	Participant Node Managers Committee	7f48e0c8-5c96-49ec-b972-30748e339115	b6ed8334-ce03-479f-98e8-ed2a20b0bf98
764	764	0	National Biodiversity Network	d897a5b9-35ee-4232-94bd-b0bcaac003c2	b7e64173-6be8-450a-893a-36104eeaf8a6
25	25	0	Plazi	ffb07bec-2d10-492d-9c37-361fe0b79427	bc986dde-40f8-4046-96da-a1c9d7b7f9a7
0	39	39	Ocean Biodiversity Information System	ba0670b9-4186-41e6-8e70-f9cb3065551a	bd6f253c-0b8e-435a-bd4d-5c6b1debd1d8
2	2	0	Plazi	ffb07bec-2d10-492d-9c37-361fe0b79427	ccdea397-919f-4cfc-b0ea-e417a7ad6701
0	2	2	Plazi	ffb07bec-2d10-492d-9c37-361fe0b79427	cd8e2735-09fa-40bd-b115-9c69607d5c30
5	5	0	Plazi	ffb07bec-2d10-492d-9c37-361fe0b79427	cd9f2b3f-c8f3-4a1b-a88b-00e991a820aa
0	1	1	Plazi	ffb07bec-2d10-492d-9c37-361fe0b79427	ce3092f5-928a-4cdf-bb0d-e8f3e046e96f
4511	4511	0	Participant Node Managers Committee	7f48e0c8-5c96-49ec-b972-30748e339115	cf8c1737-4702-4a16-93c9-e3da9ccece7a
19	19	0	Plazi	ffb07bec-2d10-492d-9c37-361fe0b79427	d058da97-304b-4190-867f-befc0d2e3525
576	576	0	GBIF Benin	efb9c00e-f802-45dd-8826-a52ec45b89ff	d0e90485-97ab-4c9b-ba7c-c097b0c23762
3	3	0	Plazi	ffb07bec-2d10-492d-9c37-361fe0b79427	d124712a-1feb-44f1-8fbe-85415a11e10b
10	10	0	Plazi	ffb07bec-2d10-492d-9c37-361fe0b79427	d28aa153-6814-48c1-91c2-f9a39788825e
244381	244381	0	GBIF France	da44cd31-5901-4687-a106-6d1c7734ee3a	d3130e9c-8587-4545-baea-6e72876bb50c
0	58	58	Plazi	ffb07bec-2d10-492d-9c37-361fe0b79427	d3f03e14-86c3-4a47-9519-9b0d99fb2a77
0	87	87	Colombian Biodiversity Information System	7e865cba-7c46-417b-ade5-97f2cf5b7be0	d4c063f8-932e-4fdf-bb31-d86c8251a582
0	10	10	Plazi	ffb07bec-2d10-492d-9c37-361fe0b79427	d6605c27-f272-4f67-9709-4f83fab8d494
12	12	0	GBIF Finland	dd514216-5c7c-45f3-910d-797424cb5be6	d6dd30e2-a04f-4382-a78e-b0ff93cb63b1
148	148	0	Plazi	ffb07bec-2d10-492d-9c37-361fe0b79427	d7147fd1-b46c-435d-8b08-f6e46ef6e3c4
0	6	6	Plazi	ffb07bec-2d10-492d-9c37-361fe0b79427	d822d24b-3124-4553-8cb3-a5b84c154cb9
0	7	7	Plazi	ffb07bec-2d10-492d-9c37-361fe0b79427	d828c12e-55f0-451e-b261-283e58414bca
129	129	0	Plazi	ffb07bec-2d10-492d-9c37-361fe0b79427	d865e117-4969-4011-8162-3c6e2ec13200
13	13	0	Plazi	ffb07bec-2d10-492d-9c37-361fe0b79427	d95eac16-5bac-4a3d-8c9b-20d923f30e3e
11	11	0	Plazi	ffb07bec-2d10-492d-9c37-361fe0b79427	daaed176-f17b-49b3-91c0-52b0e53bb45b
0	4	4	Plazi	ffb07bec-2d10-492d-9c37-361fe0b79427	dbd9ecfc-2df9-4cd2-9064-839a26e49f92
3990	3990	0	GBIF France	da44cd31-5901-4687-a106-6d1c7734ee3a	de64738a-f7da-4ca5-a457-dc20c92a511a
44	44	0	Secretariat of the Pacific Regional Environment Programme	29c6a139-ea7f-41f5-8d9b-c55af8736182	e01b0fe0-a8da-4e4f-85c5-b98b3717a9c0
14852	14852	0	GBIF Argentina	2426a871-9feb-40a1-96c6-0c593a76b835	e2483380-16f7-11df-b5b3-b8a03c50a862
44802	44802	0	GBIF Japan	db5705aa-6a6e-42f1-8942-d77b9f4896ea	e318af38-1f64-11e2-9d9f-00145eb45e9a
0	223	223	Plazi	ffb07bec-2d10-492d-9c37-361fe0b79427	e3701c0f-ee96-4a2e-87a2-538a560a6fc3
1006	1006	0	GBIF France	da44cd31-5901-4687-a106-6d1c7734ee3a	e52c8a64-7105-47dd-8002-699de13d4480
366	366	0	GBIF Sweden	a0b3be64-6525-4387-ac67-a499950f92e1	e67a6a2c-47d6-4be8-bcf6-25baf60289fd
11	11	0	Plazi	ffb07bec-2d10-492d-9c37-361fe0b79427	e7538d6a-3f9b-4eeb-a4bd-68f3b2022a58
0	895	895	Colombian Biodiversity Information System	7e865cba-7c46-417b-ade5-97f2cf5b7be0	e9753023-06db-4f9b-a001-b2a2bbc84365
0	3	3	Plazi	ffb07bec-2d10-492d-9c37-361fe0b79427	eb087c75-d636-4f3c-b0a1-411ca2606465
97	97	0	Plazi	ffb07bec-2d10-492d-9c37-361fe0b79427	eec89202-cf27-43d0-95a8-a9f6f7ddc610
795	795	0	National Biodiversity Network	d897a5b9-35ee-4232-94bd-b0bcaac003c2	ef9587e0-ffdf-4e1c-b6d7-11b3058956b2
0	1	1	Plazi	ffb07bec-2d10-492d-9c37-361fe0b79427	eff7f1e4-788f-4388-a3f5-ae81bd9f51f2
0	2	2	Plazi	ffb07bec-2d10-492d-9c37-361fe0b79427	f771b0f8-e7d7-4434-909c-ab2d89548370
546	546	0	Atlas of Living Australia	4a6f1b71-969e-4fc5-a693-282b05e1220c	f8ceb4e6-82ff-4325-afc8-eb5e64b5f842
0	57	57	Plazi	ffb07bec-2d10-492d-9c37-361fe0b79427	f90cb4d8-6219-4b50-b6a6-561c9c81fdb6
289	289	0	Belgian Biodiversity Platform	fb11cfe1-ebc3-45af-9159-17d9fddbcdac	fca6d6a7-c13d-4f6e-96e1-0513e30b816c
0	1	1	Plazi	ffb07bec-2d10-492d-9c37-361fe0b79427	fe5175bf-b116-4d9c-bb7f-397f61f5a937
2082	2082	0	GBIF Argentina	2426a871-9feb-40a1-96c6-0c593a76b835	feb769dd-6096-4b25-8a69-9ece3a9e4b66
7	7	0	Plazi	ffb07bec-2d10-492d-9c37-361fe0b79427	ffdb0ed8-25ff-4126-a775-21936773c125
184	184	0	Participant Node Managers Committee	7f48e0c8-5c96-49ec-b972-30748e339115	0097a2e6-0eaa-4cb0-ad6b-ff2065a0e35c
2	2	0	Plazi	ffb07bec-2d10-492d-9c37-361fe0b79427	00dc1977-6ad3-45e1-92e7-82175cc9ee1f
0	23	23	Plazi	ffb07bec-2d10-492d-9c37-361fe0b79427	01dac79e-3e44-4d17-8590-83031aae871d
70	70	0	Plazi	ffb07bec-2d10-492d-9c37-361fe0b79427	01ea54a0-5b26-4447-9cd6-fda3b385dadf
0	41	41	Ocean Biodiversity Information System	ba0670b9-4186-41e6-8e70-f9cb3065551a	09ba6cc0-90cc-402f-8d28-060fddd8f63a
120	120	0	Plazi	ffb07bec-2d10-492d-9c37-361fe0b79427	0a1bb2af-3449-4222-bc7d-8076d81c2dcd
6	6	0	Plazi	ffb07bec-2d10-492d-9c37-361fe0b79427	0b9e25fa-4ccc-4978-8dae-e2f3dd8510b4
3	3	0	Plazi	ffb07bec-2d10-492d-9c37-361fe0b79427	0fc0b3f0-dfbc-4f93-98f7-ba3d8c54670f
4	4	0	Plazi	ffb07bec-2d10-492d-9c37-361fe0b79427	1221bec5-8abd-4b4f-b1dc-7d0fe8065ce0
4	4	0	Plazi	ffb07bec-2d10-492d-9c37-361fe0b79427	13655079-c807-4b16-b3fb-a5bb965f798b
0	2	2	Plazi	ffb07bec-2d10-492d-9c37-361fe0b79427	13ae2f6e-362f-4d58-a581-d3842dacfa6e
7	7	0	Plazi	ffb07bec-2d10-492d-9c37-361fe0b79427	13edff6d-715f-48b3-8c10-9f3547dcf061
61	61	0	Plazi	ffb07bec-2d10-492d-9c37-361fe0b79427	15860f7f-9e92-47f7-b2c4-091fa9370965
524	524	0	Colombian Biodiversity Information System	7e865cba-7c46-417b-ade5-97f2cf5b7be0	19b0fc61-2616-4164-a55a-36e80bb83871
2555	2555	0	National Biodiversity Network	d897a5b9-35ee-4232-94bd-b0bcaac003c2	1d6b0607-b2ed-4e7f-bd09-48e57ccfdffa
60	60	0	GBIF Germany	4f6826f2-4ff6-443d-b966-e6913bd24013	206e21fe-3894-4f11-9fbe-f8bfeb770943
0	7	7	Plazi	ffb07bec-2d10-492d-9c37-361fe0b79427	20f7aa55-c982-48fe-a65a-a056a5afab9b
157201	159987	2786	GBIF Brazil	cdc9736d-5ff7-4ece-9959-3c744360cdb3	2273e40d-26c2-4959-aea2-b6abcce16d09
2467	2467	0	Biodiversity Information System of Mexico	b324e8e9-9a4c-44fa-8f1a-7f39ea7ab576	22e105eb-447a-494b-932b-3a60a31488d6
18	18	0	Biodiversity Information System of Mexico	b324e8e9-9a4c-44fa-8f1a-7f39ea7ab576	23595643-440f-42b1-9f74-7a4ed4b05c78
13654	11993	-1661	Biodiversity Information System of Mexico	b324e8e9-9a4c-44fa-8f1a-7f39ea7ab576	24c06e8b-8e97-4380-86e9-ba150fc0c406
7	7	0	Plazi	ffb07bec-2d10-492d-9c37-361fe0b79427	27a1ad86-5c09-4411-b875-1773ddc8145a
0	1	1	Plazi	ffb07bec-2d10-492d-9c37-361fe0b79427	2ad47de9-bad8-4be6-9bbd-a32f9cfccf7e
65707	65706	-1	Biodiversity Information System of Mexico	b324e8e9-9a4c-44fa-8f1a-7f39ea7ab576	2cee1ad6-1597-4bc8-9368-4cf2f8e088d6
31	31	0	Plazi	ffb07bec-2d10-492d-9c37-361fe0b79427	2d33c675-52ef-4bf7-a1d0-884df2d2e8c4
7	7	0	Plazi	ffb07bec-2d10-492d-9c37-361fe0b79427	2e7a720b-f0b8-4005-9406-6d0f4e330e9d
0	35	35	Plazi	ffb07bec-2d10-492d-9c37-361fe0b79427	2f233def-7f1a-4e46-ae22-75dde4c29caa
174	174	0	GBIF Germany	4f6826f2-4ff6-443d-b966-e6913bd24013	30cbd2cc-136f-48f7-b8c7-6bd6474ff58a
1423	1422	-1	Biodiversity Information System of Mexico	b324e8e9-9a4c-44fa-8f1a-7f39ea7ab576	30f25223-4ab7-4471-babe-9544e06a3229
4019	4019	0	Biodiversity Information System of Mexico	b324e8e9-9a4c-44fa-8f1a-7f39ea7ab576	35db6844-23dd-43c0-a247-9f4fa1c9faf0
637	824	187	Atlas of Living Australia	4a6f1b71-969e-4fc5-a693-282b05e1220c	37952dee-f155-4501-938f-3f1085cc404a
971261	992700	21439	Atlas of Living Australia	4a6f1b71-969e-4fc5-a693-282b05e1220c	39905320-6c8a-11de-8226-b8a03c50a862
631	631	0	National Biodiversity Network	d897a5b9-35ee-4232-94bd-b0bcaac003c2	3af3d760-f1e5-4452-9e0b-a4f600611833
1	1	0	Plazi	ffb07bec-2d10-492d-9c37-361fe0b79427	3b51725f-e873-48d2-918c-bb926e54a7b7
0	13	13	Plazi	ffb07bec-2d10-492d-9c37-361fe0b79427	3cb8c66d-67c2-4c28-ba5b-3cbf1cdd227f
1213	1213	0	GBIF Germany	4f6826f2-4ff6-443d-b966-e6913bd24013	4298c58a-6cdd-43dd-9d65-2b829075e5c3
0	211	211	Ocean Biodiversity Information System	ba0670b9-4186-41e6-8e70-f9cb3065551a	44d1c0ad-1477-40f0-9992-fb5c2e1fa794
287	287	0	Participant Node Managers Committee	7f48e0c8-5c96-49ec-b972-30748e339115	45af7bce-7df9-446c-8ccc-0ae1c750a335
428	428	0	GBIF Germany	4f6826f2-4ff6-443d-b966-e6913bd24013	48136c90-58b4-4317-ab26-ac45861c0f37
22	22	0	Plazi	ffb07bec-2d10-492d-9c37-361fe0b79427	48c4fece-8490-48c5-9aae-9e4e9a827f67
0	918	918	Ocean Biodiversity Information System	ba0670b9-4186-41e6-8e70-f9cb3065551a	4bdc7171-c006-41b8-b3bf-e6f5227206b3
2765	2765	0	National Biodiversity Network	d897a5b9-35ee-4232-94bd-b0bcaac003c2	4c7bd198-8b10-4c2d-a380-6e2ad49c5084
6	6	0	Plazi	ffb07bec-2d10-492d-9c37-361fe0b79427	4d361b19-8a22-4747-b7d7-57581cfdce26
2610	2610	0	GBIF France	da44cd31-5901-4687-a106-6d1c7734ee3a	518ace5e-0034-4201-8ff3-a482c16f174e
0	323	323	Plazi	ffb07bec-2d10-492d-9c37-361fe0b79427	5404afb9-168e-4d0f-b386-da1c314df1d9
101	101	0	GBIF France	da44cd31-5901-4687-a106-6d1c7734ee3a	57b656ce-2065-43f8-9c81-72697d8b01d4
7	7	0	Participant Node Managers Committee	7f48e0c8-5c96-49ec-b972-30748e339115	58744932-8838-4eae-adda-2b82dec3b264
56	56	0	Plazi	ffb07bec-2d10-492d-9c37-361fe0b79427	5d85c857-3c52-44f1-a2a3-974c507df1f6
13	13	0	Plazi	ffb07bec-2d10-492d-9c37-361fe0b79427	5d8e0b44-70af-46b4-a04f-34e9a00d8663
0	10	10	Plazi	ffb07bec-2d10-492d-9c37-361fe0b79427	5dc29412-7908-479d-93e6-1ecc88fdc1fd
0	876	876	Ocean Biodiversity Information System	ba0670b9-4186-41e6-8e70-f9cb3065551a	5e1a00b2-5cd5-4f18-a9e3-ea1ef42132b2
8052	8052	0	Colombian Biodiversity Information System	7e865cba-7c46-417b-ade5-97f2cf5b7be0	5ebe1081-cd38-479c-9cdd-4af21989891b
4	4	0	Plazi	ffb07bec-2d10-492d-9c37-361fe0b79427	5fdb1e29-fa5b-4736-8547-5bac4cfbdfe8
171	171	0	GBIF Germany	4f6826f2-4ff6-443d-b966-e6913bd24013	61fb2be4-f762-11e1-a439-00145eb45e9a
27	27	0	Plazi	ffb07bec-2d10-492d-9c37-361fe0b79427	624bbacd-4686-4a56-96cb-d51a659e5964
7	7	0	Plazi	ffb07bec-2d10-492d-9c37-361fe0b79427	656d9dd9-b2c2-431b-a60d-4b3c37c38a1a
878	878	0	GBIF Germany	4f6826f2-4ff6-443d-b966-e6913bd24013	657785f6-f762-11e1-a439-00145eb45e9a
14	12	-2	GBIF Germany	4f6826f2-4ff6-443d-b966-e6913bd24013	65b829bc-f762-11e1-a439-00145eb45e9a
21	21	0	GBIF Germany	4f6826f2-4ff6-443d-b966-e6913bd24013	66994e4c-f762-11e1-a439-00145eb45e9a
2168	2168	0	Polish Biodiversity Information Network	2618bfdf-e194-4911-a241-80db3107bc51	66a19130-30b2-11de-b171-b8a03c50a862
59	59	0	GBIF Germany	4f6826f2-4ff6-443d-b966-e6913bd24013	67bd273a-f762-11e1-a439-00145eb45e9a
2	2	0	Plazi	ffb07bec-2d10-492d-9c37-361fe0b79427	696090f6-38f8-4f3f-9eea-391391790768
122	122	0	GBIF France	da44cd31-5901-4687-a106-6d1c7734ee3a	6a936036-1772-41aa-a270-355ba9926842
8	8	0	GBIF Germany	4f6826f2-4ff6-443d-b966-e6913bd24013	6ae7142a-f762-11e1-a439-00145eb45e9a
8	8	0	GBIF Germany	4f6826f2-4ff6-443d-b966-e6913bd24013	6bf45c06-f762-11e1-a439-00145eb45e9a
7	7	0	Plazi	ffb07bec-2d10-492d-9c37-361fe0b79427	6c47f8cd-05fa-4487-8caf-681f476d60db
33	33	0	GBIF Germany	4f6826f2-4ff6-443d-b966-e6913bd24013	6c8c37b0-f762-11e1-a439-00145eb45e9a
48	48	0	GBIF Germany	4f6826f2-4ff6-443d-b966-e6913bd24013	6cd43c40-f762-11e1-a439-00145eb45e9a
59	59	0	GBIF Germany	4f6826f2-4ff6-443d-b966-e6913bd24013	6d3114a6-f762-11e1-a439-00145eb45e9a
7	7	0	GBIF Germany	4f6826f2-4ff6-443d-b966-e6913bd24013	6f9088d0-f762-11e1-a439-00145eb45e9a
90	90	0	GBIF Germany	4f6826f2-4ff6-443d-b966-e6913bd24013	6ff78d82-f762-11e1-a439-00145eb45e9a
273	273	0	Atlas of Living Australia	4a6f1b71-969e-4fc5-a693-282b05e1220c	701888b9-26b1-4e7f-b226-a0766c6ec7f5
3	3	0	Plazi	ffb07bec-2d10-492d-9c37-361fe0b79427	709f44c9-8fa4-41b0-9845-72c7e87175ea
52	52	0	GBIF Germany	4f6826f2-4ff6-443d-b966-e6913bd24013	70e1be34-f762-11e1-a439-00145eb45e9a
24	24	0	GBIF Benin	efb9c00e-f802-45dd-8826-a52ec45b89ff	710f3a9b-b0c8-4b40-9469-d7060071e23e
79	67	-12	GBIF Germany	4f6826f2-4ff6-443d-b966-e6913bd24013	7110f8a2-f762-11e1-a439-00145eb45e9a
12	12	0	GBIF Germany	4f6826f2-4ff6-443d-b966-e6913bd24013	7439e66a-f762-11e1-a439-00145eb45e9a
1316	1316	0	Colombian Biodiversity Information System	7e865cba-7c46-417b-ade5-97f2cf5b7be0	747e331c-6b6c-44c2-85b8-840f4462c7dc
10	10	0	GBIF Germany	4f6826f2-4ff6-443d-b966-e6913bd24013	74bfea94-f762-11e1-a439-00145eb45e9a
780	780	0	GBIF Germany	4f6826f2-4ff6-443d-b966-e6913bd24013	7533d2f6-f762-11e1-a439-00145eb45e9a
281	281	0	Atlas of Living Australia	4a6f1b71-969e-4fc5-a693-282b05e1220c	75f417f6-f642-421d-9dac-943dd3a78088
321	321	0	Plazi	ffb07bec-2d10-492d-9c37-361fe0b79427	7627b6c6-cb44-48cb-b0ad-23bde60122cc
39	39	0	GBIF Argentina	2426a871-9feb-40a1-96c6-0c593a76b835	768f0dde-f9c7-4618-aae4-8fc6ff5a2be5
4	4	0	Participant Node Managers Committee	7f48e0c8-5c96-49ec-b972-30748e339115	794d2993-2dc9-4fdf-9a23-f1f0b91ebcc8
12	12	0	Plazi	ffb07bec-2d10-492d-9c37-361fe0b79427	7ac1366d-0143-441f-89f5-4a0bbba2a48a
291	291	0	GBIF Japan	db5705aa-6a6e-42f1-8942-d77b9f4896ea	7bb0dd90-f762-11e1-a439-00145eb45e9a
1	1	0	Plazi	ffb07bec-2d10-492d-9c37-361fe0b79427	7cffdbee-0e63-491f-b2c9-d245e59b830d
992	992	0	GBIF Germany	4f6826f2-4ff6-443d-b966-e6913bd24013	7d99caf4-f762-11e1-a439-00145eb45e9a
3	3	0	Plazi	ffb07bec-2d10-492d-9c37-361fe0b79427	7e5b0586-dff3-4da6-87f3-d103bfae50ef
1218	1218	0	Ocean Biodiversity Information System	ba0670b9-4186-41e6-8e70-f9cb3065551a	7e6cb805-dacb-4cff-b881-efc708346a51
107	107	0	GBIF Germany	4f6826f2-4ff6-443d-b966-e6913bd24013	7ee6c3bc-f762-11e1-a439-00145eb45e9a
381	381	0	Biodiversity Information System of Mexico	b324e8e9-9a4c-44fa-8f1a-7f39ea7ab576	80291478-f762-11e1-a439-00145eb45e9a
788	788	0	Biodiversity Information System of Mexico	b324e8e9-9a4c-44fa-8f1a-7f39ea7ab576	806ab8f6-f762-11e1-a439-00145eb45e9a
1	1	0	GBIF Japan	db5705aa-6a6e-42f1-8942-d77b9f4896ea	80e09ff8-f762-11e1-a439-00145eb45e9a
969	988	19	GBIF Germany	4f6826f2-4ff6-443d-b966-e6913bd24013	81a4f0d8-f762-11e1-a439-00145eb45e9a
9	9	0	GBIF Germany	4f6826f2-4ff6-443d-b966-e6913bd24013	824923c4-f762-11e1-a439-00145eb45e9a
585	585	0	GBIF Germany	4f6826f2-4ff6-443d-b966-e6913bd24013	828581dd-2d5e-49e6-b666-6502d210a173
0	278	278	Ocean Biodiversity Information System	ba0670b9-4186-41e6-8e70-f9cb3065551a	82c4c3d2-559a-4aaf-be85-bb57c9266804
0	60	60	National Biodiversity Network	d897a5b9-35ee-4232-94bd-b0bcaac003c2	85c50f0f-6d60-4f81-8f12-c641deecb80a
0	10	10	Plazi	ffb07bec-2d10-492d-9c37-361fe0b79427	865dc8e5-0a98-4461-9108-844213a7b803
31494	41831	10337	GBIF France	da44cd31-5901-4687-a106-6d1c7734ee3a	86b91ba1-4b24-447d-b11c-834edfca6d31
274	274	0	GBIF India	59d15a9b-ba51-43c3-a53f-304fe6732c04	86cf5e96-9668-403d-81cc-59eeff861060
294	203	-91	GBIF Germany	4f6826f2-4ff6-443d-b966-e6913bd24013	87e42356-f762-11e1-a439-00145eb45e9a
204	204	0	Plazi	ffb07bec-2d10-492d-9c37-361fe0b79427	887f4c2c-1812-4aa5-b994-58388f6a45c5
350	350	0	GBIF Germany	4f6826f2-4ff6-443d-b966-e6913bd24013	8a5a3404-f762-11e1-a439-00145eb45e9a
40316	40316	0	National Biodiversity Network	d897a5b9-35ee-4232-94bd-b0bcaac003c2	8a6c67f5-22ce-4b76-b9ac-b39c7a914cba
294	294	0	GBIF Germany	4f6826f2-4ff6-443d-b966-e6913bd24013	8ab32a78-f762-11e1-a439-00145eb45e9a
622	622	0	GBIF Germany	4f6826f2-4ff6-443d-b966-e6913bd24013	8abbafea-f762-11e1-a439-00145eb45e9a
4	4	0	Plazi	ffb07bec-2d10-492d-9c37-361fe0b79427	8af5a092-f062-48c7-8d7c-f96ae6282bfa
53	53	0	GBIF France	da44cd31-5901-4687-a106-6d1c7734ee3a	8e460179-917c-4bb5-9018-9dbff610a0d6
143	85	-58	GBIF Germany	4f6826f2-4ff6-443d-b966-e6913bd24013	8e62778c-f762-11e1-a439-00145eb45e9a
303	220	-83	GBIF Germany	4f6826f2-4ff6-443d-b966-e6913bd24013	8e8d00b0-f762-11e1-a439-00145eb45e9a
10	5	-5	GBIF Germany	4f6826f2-4ff6-443d-b966-e6913bd24013	8eda9a6e-f762-11e1-a439-00145eb45e9a
0	3	3	Plazi	ffb07bec-2d10-492d-9c37-361fe0b79427	8ef7e1c8-416f-4d3e-b707-b4a5de55ae7f
50	41	-9	GBIF Germany	4f6826f2-4ff6-443d-b966-e6913bd24013	8fb8520a-f762-11e1-a439-00145eb45e9a
415	334	-81	GBIF Germany	4f6826f2-4ff6-443d-b966-e6913bd24013	8ff48734-f762-11e1-a439-00145eb45e9a
689	422	-267	GBIF Germany	4f6826f2-4ff6-443d-b966-e6913bd24013	905678ae-f762-11e1-a439-00145eb45e9a
0	30	30	Plazi	ffb07bec-2d10-492d-9c37-361fe0b79427	9064c43d-2f17-4a48-a288-34419e2b7823
248155	248155	0	GBIF Brazil	cdc9736d-5ff7-4ece-9959-3c744360cdb3	9118eee0-42d2-4a27-9ae0-78d49d163a5b
34	28	-6	GBIF Germany	4f6826f2-4ff6-443d-b966-e6913bd24013	911b5f0c-f762-11e1-a439-00145eb45e9a
516	516	0	GBIF Germany	4f6826f2-4ff6-443d-b966-e6913bd24013	925138ce-f762-11e1-a439-00145eb45e9a
184	184	0	GBIF Germany	4f6826f2-4ff6-443d-b966-e6913bd24013	937bad2e-f762-11e1-a439-00145eb45e9a
1	1	0	GBIF Germany	4f6826f2-4ff6-443d-b966-e6913bd24013	93a141ce-f762-11e1-a439-00145eb45e9a
1045806	1045806	0	Belgian Biodiversity Platform	fb11cfe1-ebc3-45af-9159-17d9fddbcdac	940821c0-3269-11df-855a-b8a03c50a862
75	77	2	GBIF Germany	4f6826f2-4ff6-443d-b966-e6913bd24013	94f59f5c-f762-11e1-a439-00145eb45e9a
14466	14466	0	GBIF France	da44cd31-5901-4687-a106-6d1c7734ee3a	9717fb10-494e-46f2-9cec-31d03dda9e1f
25	25	0	Plazi	ffb07bec-2d10-492d-9c37-361fe0b79427	97942778-cef4-4cf6-b4e4-c077e633daa8
0	716	716	Indonesian Biodiversity Information Facility	2ebd91f6-f14f-4375-b525-c011a3774f03	97f4b716-f055-42a5-947b-205f5db0de77
0	1260	1260	Ocean Biodiversity Information System	ba0670b9-4186-41e6-8e70-f9cb3065551a	99bf8c29-6963-43e9-91b3-e3dacf254e22
1807	1807	0	GBIF France	da44cd31-5901-4687-a106-6d1c7734ee3a	99c224fc-4717-418a-80fd-27ddac976e68
0	281	281	Belgian Biodiversity Platform	fb11cfe1-ebc3-45af-9159-17d9fddbcdac	9a299fb1-fe2b-4b0e-a724-5c6a43abc73a
105	105	0	Plazi	ffb07bec-2d10-492d-9c37-361fe0b79427	9c06ff9b-98e5-4011-99c9-357fc94ecbdc
299	299	0	Korean Biodiversity Information Facility	e0a1e772-0177-4800-94b4-2d023fe6cdf4	9d08956c-27fc-11e2-85e3-00145eb45e9a
877	877	0	Colombian Biodiversity Information System	7e865cba-7c46-417b-ade5-97f2cf5b7be0	9e9d3ecc-0062-4b97-80c7-82b51ad61158
74146	74146	0	GBIF Finland	dd514216-5c7c-45f3-910d-797424cb5be6	9f6be6a5-fa23-4471-97c6-67cd21bcf53a
16	16	0	Belgian Biodiversity Platform	fb11cfe1-ebc3-45af-9159-17d9fddbcdac	a011787f-4345-48f4-9d83-d62df608369c
0	9	9	Plazi	ffb07bec-2d10-492d-9c37-361fe0b79427	a1574d82-a9e0-4b63-b026-b2475613765f
2	2	0	Plazi	ffb07bec-2d10-492d-9c37-361fe0b79427	a40b8c40-0523-455c-8b9b-6804ffa1f188
0	14	14	Plazi	ffb07bec-2d10-492d-9c37-361fe0b79427	a4a88ff0-7752-4a32-a026-6c2da3566c7c
3	3	0	Plazi	ffb07bec-2d10-492d-9c37-361fe0b79427	a4c437e0-7983-41af-8f98-a3bd88cc2e69
1781	1781	0	GBIF France	da44cd31-5901-4687-a106-6d1c7734ee3a	a52ca10a-136a-4072-a6de-3ec6e7852365
192	192	0	GBIF France	da44cd31-5901-4687-a106-6d1c7734ee3a	a78c7b35-0efc-4ce8-aa49-34d58046a1c8
0	2	2	Plazi	ffb07bec-2d10-492d-9c37-361fe0b79427	a8980f07-e2f6-440e-a3fb-5b26636382ee
607	607	0	GBIF Benin	efb9c00e-f802-45dd-8826-a52ec45b89ff	aa964e65-9a21-4a05-a10e-18311a30c9f7
0	48	48	Plazi	ffb07bec-2d10-492d-9c37-361fe0b79427	aab2b283-7bd4-44f5-b976-6acbff8b59c8
630	630	0	GBIF Germany	4f6826f2-4ff6-443d-b966-e6913bd24013	abe0b555-8241-45ed-830d-bb9b2b522a9a
12	12	0	GBIF Estonia	2c11b821-d22b-4c64-8cd3-c1578173b129	ade32c37-fdce-450a-be18-87bdb792c0b1
934	934	0	GBIF Finland	dd514216-5c7c-45f3-910d-797424cb5be6	b346c1ab-d671-4510-8df6-db1267697ae1
27	27	0	GBIF Brazil	cdc9736d-5ff7-4ece-9959-3c744360cdb3	b39891a1-2eb2-492d-bb5b-4da1007ecde5
5	5	0	Plazi	ffb07bec-2d10-492d-9c37-361fe0b79427	b39ae435-8d3d-4188-94ab-92e91b16019f
18970	18970	0	Canada Biodiversity Information Facility	8f83fc96-c966-4126-83f7-bf044dc49efa	ba0c046d-52bb-4262-a495-652988c9f3f7
2	2	0	Plazi	ffb07bec-2d10-492d-9c37-361fe0b79427	bc0b1dd4-028e-49d6-9dfb-60ea7631500e
0	4966	4966	Participant Node Managers Committee	7f48e0c8-5c96-49ec-b972-30748e339115	bcaaf133-5433-46ab-b2e3-a1a9f4ce84d1
36	36	0	Plazi	ffb07bec-2d10-492d-9c37-361fe0b79427	c27641c4-c16c-4ac8-a677-6c71331bd299
4599	2079	-2520	GBIF Germany	4f6826f2-4ff6-443d-b966-e6913bd24013	c2b3b3c4-4a5d-4b60-afe4-98afd2abec33
0	1813	1813	U.S. Geological Survey	8618c64a-93e0-4300-b546-7249e5148ed2	c45ad8ca-a406-4430-8c61-f5afbe29e3b4
119	119	0	GBIF Germany	4f6826f2-4ff6-443d-b966-e6913bd24013	c667b807-f512-41b6-a3cb-5590714ebff3
65	65	0	Plazi	ffb07bec-2d10-492d-9c37-361fe0b79427	c7ffebb0-4bea-4c4d-8873-96db1864f598
0	454	454	GBIF Argentina	2426a871-9feb-40a1-96c6-0c593a76b835	c8502202-6c68-4e7e-b9b5-e5181d8c3ee6
8	8	0	Plazi	ffb07bec-2d10-492d-9c37-361fe0b79427	c9973f7f-1bbb-4f66-95b0-77913ab30c09
5	5	0	Plazi	ffb07bec-2d10-492d-9c37-361fe0b79427	cae97719-eea5-453d-91e7-76490db750a4
1	1	0	Plazi	ffb07bec-2d10-492d-9c37-361fe0b79427	cb58d2cd-bc1e-4a6c-a726-d363c7c4607c
1704	1704	0	Taiwan Biodiversity Information Facility	e1b85abc-61f9-430f-ba79-6813dec53a0f	cb6e756a-c56a-4dc4-bbfa-2002a0a754dd
5	5	0	Plazi	ffb07bec-2d10-492d-9c37-361fe0b79427	cc2f43f4-330a-4b5e-9539-235173e27903
11	11	0	GBIF France	da44cd31-5901-4687-a106-6d1c7734ee3a	cfb6dd7a-9455-49a7-ad8c-c64a18ae6d15
425	425	0	Canada Biodiversity Information Facility	8f83fc96-c966-4126-83f7-bf044dc49efa	d35bde1e-a0d7-4664-9612-e1af9291715f
0	1	1	Plazi	ffb07bec-2d10-492d-9c37-361fe0b79427	d380e288-6155-4bf9-9eab-f817ee623503
1	1	0	Colombian Biodiversity Information System	7e865cba-7c46-417b-ade5-97f2cf5b7be0	d50f71ce-068b-4a2c-be21-ec5080260008
161	161	0	Plazi	ffb07bec-2d10-492d-9c37-361fe0b79427	d5f2bb15-439a-45d2-9121-beb168fcb637
1	1	0	Plazi	ffb07bec-2d10-492d-9c37-361fe0b79427	d637480f-9796-4d54-bdd2-86b456019d58
1073	1073	0	GBIF Norway	4f829580-180d-46a9-9c87-ed8ec959b545	d750e2d1-89cf-4d8c-a434-26441e5e7629
3	3	0	Plazi	ffb07bec-2d10-492d-9c37-361fe0b79427	d78d1897-cc4e-4bde-b97d-0c5b8021451d
0	7938	7938	Participant Node Managers Committee	7f48e0c8-5c96-49ec-b972-30748e339115	dd7d031f-b18f-4631-929a-049fcf00ac8f
58	58	0	Plazi	ffb07bec-2d10-492d-9c37-361fe0b79427	dddc215c-61ae-484e-bc8e-1314354620b2
11256	10868	-388	Biodiversity Information System of Mexico	b324e8e9-9a4c-44fa-8f1a-7f39ea7ab576	dedb8f2b-4641-44f2-bafb-057f9fe70ce0
250449	250449	0	U.S. Geological Survey	8618c64a-93e0-4300-b546-7249e5148ed2	dfde3cb2-99a6-40a3-a333-900ddcb17807
1	1	0	Plazi	ffb07bec-2d10-492d-9c37-361fe0b79427	e0694ecc-c114-4621-9209-ad8abdb60b9f
8567	8567	0	GBIF Spain	1f94b3ca-9345-4d65-afe2-4bace93aa0fe	e0cb07ac-7cb7-457e-b5ac-ace04c20d8f7
134	134	0	Secretariat of the Pacific Regional Environment Programme	29c6a139-ea7f-41f5-8d9b-c55af8736182	e1b7a8c8-49f6-48ed-9be9-83f4107e6aeb
0	605	605	Plazi	ffb07bec-2d10-492d-9c37-361fe0b79427	e56413f9-7dc9-4ebc-9085-008cb38b4dc1
127	127	0	GBIF Finland	dd514216-5c7c-45f3-910d-797424cb5be6	e5973baa-4aa6-4f78-acf5-4f617423fce4
13	13	0	GBIF France	da44cd31-5901-4687-a106-6d1c7734ee3a	e7e6f200-1cd2-4fb1-9700-cb39b95cd502
1127	1127	0	Inter American Biodiversity Information Network	69f8ea9e-b2a6-4e5a-896f-3bf8fc23cc8d	e9dbc0af-90ed-4f03-89e9-43f98bf6c63d
85	85	0	Plazi	ffb07bec-2d10-492d-9c37-361fe0b79427	ea2c4da4-3899-41cd-80f4-b7df9302da79
1	1	0	Plazi	ffb07bec-2d10-492d-9c37-361fe0b79427	eb1647dd-99d7-4054-97dd-bc798b4c7003
0	17	17	Ocean Biodiversity Information System	ba0670b9-4186-41e6-8e70-f9cb3065551a	eb727446-d8da-4a5f-af85-86c1ef1c7a4f
618	618	0	Netherlands Biodiversity Information Facility	0909d601-bda2-42df-9e63-a6d51847ebce	ee940eb2-655d-4260-954a-e7efd52f34dd
18	18	0	Participant Node Managers Committee	7f48e0c8-5c96-49ec-b972-30748e339115	eedb339f-0ff5-4100-829d-fd588bda9b5f
1144	1144	0	Belgian Biodiversity Platform	fb11cfe1-ebc3-45af-9159-17d9fddbcdac	ef5c63cc-ed75-47b2-a6fd-60969f4fad07
0	157	157	Plazi	ffb07bec-2d10-492d-9c37-361fe0b79427	f119e326-206d-45aa-a988-93be43f4bfad
4	4	0	GBIF Sweden	a0b3be64-6525-4387-ac67-a499950f92e1	f1f0b448-ecc7-4235-b6cf-6173342f466a
11402	11402	0	GBIF France	da44cd31-5901-4687-a106-6d1c7734ee3a	f7a4924c-bfd2-4192-990c-c63397d5d852
80	80	0	GBIF Brazil	cdc9736d-5ff7-4ece-9959-3c744360cdb3	f99e6041-f15e-4b28-a6ec-235aecaa31f3
0	111	111	Plazi	ffb07bec-2d10-492d-9c37-361fe0b79427	f99f3b15-7592-490f-9903-ce6b24131864
7	7	0	Plazi	ffb07bec-2d10-492d-9c37-361fe0b79427	fa170e25-9f64-47da-8b18-59d050bf22d0
472	472	0	Participant Node Managers Committee	7f48e0c8-5c96-49ec-b972-30748e339115	fa443019-139e-4123-8a77-a75e950908fa
2	2	0	Plazi	ffb07bec-2d10-492d-9c37-361fe0b79427	fcbb5dfc-c082-4447-8ee6-bed4918705fa
3973	3973	0	Participant Node Managers Committee	7f48e0c8-5c96-49ec-b972-30748e339115	fd6fb2fd-a588-40cf-81c9-80f5f579dccb
20755	20755	0	GBIF France	da44cd31-5901-4687-a106-6d1c7734ee3a	ff01c14e-06ce-47b6-8ea0-316cfb8fcff7
245	245	0	Plazi	ffb07bec-2d10-492d-9c37-361fe0b79427	ff054592-9d1a-4c75-b6a1-cf0251b52f4a
729	729	0	GBIF Brazil	cdc9736d-5ff7-4ece-9959-3c744360cdb3	ff9e8c27-2e5a-4db0-bbd2-318c23269b2d
183	183	0	Participant Node Managers Committee	7f48e0c8-5c96-49ec-b972-30748e339115	007f5508-4bed-4101-b7a6-dfd86c52b31d
0	2	2	Plazi	ffb07bec-2d10-492d-9c37-361fe0b79427	03184687-da82-4d91-bf6b-72e04231cc10
0	166	166	Plazi	ffb07bec-2d10-492d-9c37-361fe0b79427	033078bd-ae40-4e66-beef-6e4d52d13223
182049	182049	0	U.S. Geological Survey	8618c64a-93e0-4300-b546-7249e5148ed2	03837eb5-6905-420d-b3c6-95938753ace7
41887	41887	0	National Biodiversity Network	d897a5b9-35ee-4232-94bd-b0bcaac003c2	045d64f1-29e5-4b8e-a0e7-8d7bd6b4d1db
4872	4872	0	Participant Node Managers Committee	7f48e0c8-5c96-49ec-b972-30748e339115	0491f582-2bb3-4787-9324-05f1a77f20b7
1137	1137	0	GBIF Germany	4f6826f2-4ff6-443d-b966-e6913bd24013	06214894-74e6-4f03-9bf8-c9484fcf9efb
26	26	0	Plazi	ffb07bec-2d10-492d-9c37-361fe0b79427	0a68c09f-52e1-4378-90cf-1558f7252663
73486	73486	0	GBIF France	da44cd31-5901-4687-a106-6d1c7734ee3a	0d6cd6f4-b240-4fcf-9118-d2d7659e8342
32	32	0	Ocean Biodiversity Information System	ba0670b9-4186-41e6-8e70-f9cb3065551a	0e0b04c4-df34-4205-a039-748c9e70cc9c
15544	15544	0	National Biodiversity Network	d897a5b9-35ee-4232-94bd-b0bcaac003c2	0e6ca8ff-526a-4d2f-ba9b-4238f45d281b
12	12	0	Colombian Biodiversity Information System	7e865cba-7c46-417b-ade5-97f2cf5b7be0	0e7992d1-d96e-407f-830c-417568cffe84
0	359	359	National Biodiversity Network	d897a5b9-35ee-4232-94bd-b0bcaac003c2	0ffc8493-329b-4cba-a04c-89d868cc746c
0	15	15	Plazi	ffb07bec-2d10-492d-9c37-361fe0b79427	110740d9-aa2f-4def-8642-41a399107286
0	23	23	Plazi	ffb07bec-2d10-492d-9c37-361fe0b79427	13137cdc-83ca-408b-bf82-995abdb2cf88
0	1	1	Plazi	ffb07bec-2d10-492d-9c37-361fe0b79427	156c63d8-c349-4f88-93be-8c088cf04530
0	1	1	Plazi	ffb07bec-2d10-492d-9c37-361fe0b79427	193bf4f6-2b11-4c78-ae2b-5afadaf46628
45	45	0	Colombian Biodiversity Information System	7e865cba-7c46-417b-ade5-97f2cf5b7be0	19c70d0e-9135-4303-a4c0-b7404abce6b3
56	56	0	GBIF Germany	4f6826f2-4ff6-443d-b966-e6913bd24013	1a2bf807-4c73-4cd7-8dd7-d1581da0b02c
0	2	2	Plazi	ffb07bec-2d10-492d-9c37-361fe0b79427	1b8f4b62-3bc6-4c83-912c-dc6ba2343866
0	1330	1330	Ocean Biodiversity Information System	ba0670b9-4186-41e6-8e70-f9cb3065551a	1e7b6980-0842-4c4a-8b14-541b95d2ed3c
105	105	0	GBIF Norway	4f829580-180d-46a9-9c87-ed8ec959b545	292005e8-3ace-44fa-886d-ff382cec56ba
1102	348	-754	GBIF Germany	4f6826f2-4ff6-443d-b966-e6913bd24013	2fd293d3-1df5-4b60-912e-40aac75e3ace
230	230	0	Plazi	ffb07bec-2d10-492d-9c37-361fe0b79427	30a30384-6c1c-4942-8396-9aad30ad290b
3	3	0	Plazi	ffb07bec-2d10-492d-9c37-361fe0b79427	33852167-3335-4c92-b513-5f3f4b83c23f
149	149	0	Plazi	ffb07bec-2d10-492d-9c37-361fe0b79427	33f8c26a-7e4a-45cf-96a9-c12f0f55ca8a
1	1	0	Plazi	ffb07bec-2d10-492d-9c37-361fe0b79427	3652d8e1-9c0c-40db-9efa-2ff2661c3437
2	2	0	Plazi	ffb07bec-2d10-492d-9c37-361fe0b79427	36f26d15-f17e-4029-940a-174efff22e58
1935	1935	0	GBIF Togo	c9659a3e-07e9-4fcb-83c6-de8b9009a02e	38fdd8b7-4e48-452c-8c05-673e6f6829af
1135	1135	0	Atlas of Living Australia	4a6f1b71-969e-4fc5-a693-282b05e1220c	3924362e-fa83-4a62-a5e2-6f764c872555
0	60	60	Plazi	ffb07bec-2d10-492d-9c37-361fe0b79427	39300142-6cea-4253-80bb-00856fdd5f95
64	64	0	Colombian Biodiversity Information System	7e865cba-7c46-417b-ade5-97f2cf5b7be0	3a5d778f-a149-4631-ae43-d60dccfed09c
8279	8279	0	Polish Biodiversity Information Network	2618bfdf-e194-4911-a241-80db3107bc51	3a8512a0-33cf-11de-afc6-b8a03c50a862
0	1734	1734	Ocean Biodiversity Information System	ba0670b9-4186-41e6-8e70-f9cb3065551a	3b175997-747f-4042-8b7d-8f033f6753f6
51	51	0	Plazi	ffb07bec-2d10-492d-9c37-361fe0b79427	3cbf8560-83cd-4890-9580-e2aa577d7301
11	11	0	Plazi	ffb07bec-2d10-492d-9c37-361fe0b79427	3de0a260-04a8-4d36-9384-5cff3934095e
3854	3854	0	GBIF France	da44cd31-5901-4687-a106-6d1c7734ee3a	42d51034-e808-49f0-8b73-249ebfe7e94e
148	148	0	GBIF Sweden	a0b3be64-6525-4387-ac67-a499950f92e1	43ed305a-e9e6-46af-9e62-e750a99acb9a
0	24	24	Plazi	ffb07bec-2d10-492d-9c37-361fe0b79427	4531ad17-7666-4546-9b8d-665e0fd00226
3	3	0	Plazi	ffb07bec-2d10-492d-9c37-361fe0b79427	46a9a555-d7e0-4e1b-b9af-0ffa615c50d4
59	59	0	Colombian Biodiversity Information System	7e865cba-7c46-417b-ade5-97f2cf5b7be0	47276440-ed86-4b0b-b392-16cd2f5341ea
0	48	48	Ocean Biodiversity Information System	ba0670b9-4186-41e6-8e70-f9cb3065551a	4d2f4d55-3cb5-4fce-8cfe-41a35ccbbede
2	2	0	Plazi	ffb07bec-2d10-492d-9c37-361fe0b79427	4d79acf3-914f-4c91-842a-b5816376733f
2815	2815	0	Colombian Biodiversity Information System	7e865cba-7c46-417b-ade5-97f2cf5b7be0	4daff70b-fd6f-424f-aeec-75afbac828a2
1027	1027	0	GBIF France	da44cd31-5901-4687-a106-6d1c7734ee3a	4f7dd3b2-5d9c-4189-8c5a-977b8726e052
0	6178	6178	U.S. Geological Survey	8618c64a-93e0-4300-b546-7249e5148ed2	52d682a4-251e-4b1f-8e0e-d422ee56bfdb
236	236	0	Plazi	ffb07bec-2d10-492d-9c37-361fe0b79427	5346f6df-90b2-4493-9377-8c8275519ce6
513	513	0	GBIF Norway	4f829580-180d-46a9-9c87-ed8ec959b545	554e5dcc-20c7-41e2-b634-5264fbfdd55d
436	436	0	GBIF Finland	dd514216-5c7c-45f3-910d-797424cb5be6	55600309-1695-4595-9ec2-90be6e6fe506
60	60	0	Plazi	ffb07bec-2d10-492d-9c37-361fe0b79427	5580248e-76a7-4521-9548-0a21b0b198ee
0	77	77	Plazi	ffb07bec-2d10-492d-9c37-361fe0b79427	564cead7-264a-4ee4-b5ee-15fd3ba81657
750	750	0	GBIF Germany	4f6826f2-4ff6-443d-b966-e6913bd24013	5b1d418a-9151-48d0-a188-9bc6875de733
0	137	137	Ocean Biodiversity Information System	ba0670b9-4186-41e6-8e70-f9cb3065551a	5ca55759-a283-497e-a7af-98d7b0a54d2c
805	805	0	GBIF France	da44cd31-5901-4687-a106-6d1c7734ee3a	5cd8ad2f-77f4-43bf-8a7c-3a629a66f457
0	2	2	Plazi	ffb07bec-2d10-492d-9c37-361fe0b79427	5e391f36-e0f1-459e-a2c6-ed21cc1f8754
91	91	0	GBIF Germany	4f6826f2-4ff6-443d-b966-e6913bd24013	612d3630-f762-11e1-a439-00145eb45e9a
51	51	0	GBIF Germany	4f6826f2-4ff6-443d-b966-e6913bd24013	6297350c-f762-11e1-a439-00145eb45e9a
36	36	0	GBIF Germany	4f6826f2-4ff6-443d-b966-e6913bd24013	62adc43e-f762-11e1-a439-00145eb45e9a
39	39	0	GBIF Germany	4f6826f2-4ff6-443d-b966-e6913bd24013	62b04a74-f762-11e1-a439-00145eb45e9a
368	368	0	Atlas of Living Australia	4a6f1b71-969e-4fc5-a693-282b05e1220c	62ce31e7-c3b5-477a-b97b-32d040ccaecc
9	9	0	GBIF Germany	4f6826f2-4ff6-443d-b966-e6913bd24013	631028e0-f762-11e1-a439-00145eb45e9a
0	2	2	Plazi	ffb07bec-2d10-492d-9c37-361fe0b79427	6383736e-fbf6-4f36-857b-445076991b8b
118	118	0	GBIF Germany	4f6826f2-4ff6-443d-b966-e6913bd24013	63ae35f8-f762-11e1-a439-00145eb45e9a
123	123	0	GBIF Germany	4f6826f2-4ff6-443d-b966-e6913bd24013	63e7147c-f762-11e1-a439-00145eb45e9a
55	55	0	GBIF France	da44cd31-5901-4687-a106-6d1c7734ee3a	65303936-a347-4d17-982d-d71806551ead
11840	11840	0	U.S. Geological Survey	8618c64a-93e0-4300-b546-7249e5148ed2	65de7b25-4bf4-48bc-a785-e330cf94cf80
210060	214578	4518	GBIF Norway	4f829580-180d-46a9-9c87-ed8ec959b545	6728c42d-c4b6-4fda-a211-5ad1bb59cda4
127	127	0	GBIF Germany	4f6826f2-4ff6-443d-b966-e6913bd24013	6892c6b0-f762-11e1-a439-00145eb45e9a
0	22	22	Plazi	ffb07bec-2d10-492d-9c37-361fe0b79427	6973f0a8-827c-4198-a7ef-98bc3aa3e57a
711	711	0	GBIF France	da44cd31-5901-4687-a106-6d1c7734ee3a	6ae0c37e-0ce6-4566-b904-770d22707ec4
16	16	0	GBIF Germany	4f6826f2-4ff6-443d-b966-e6913bd24013	6af18d24-f762-11e1-a439-00145eb45e9a
21	21	0	Secretariat of the Pacific Regional Environment Programme	29c6a139-ea7f-41f5-8d9b-c55af8736182	6b441a48-12d3-4e86-a831-d358342807ae
30	30	0	Plazi	ffb07bec-2d10-492d-9c37-361fe0b79427	6b621117-f0cf-47a4-8e9c-b692bb221d5e
35	35	0	GBIF Germany	4f6826f2-4ff6-443d-b966-e6913bd24013	6d46c9c2-f762-11e1-a439-00145eb45e9a
45	45	0	Plazi	ffb07bec-2d10-492d-9c37-361fe0b79427	6ec8e54c-fa4b-4009-9cc8-4c8bae675e50
35	35	0	Plazi	ffb07bec-2d10-492d-9c37-361fe0b79427	703c3c7a-1fbe-4613-8cf8-4c50b722d97a
133	133	0	GBIF Germany	4f6826f2-4ff6-443d-b966-e6913bd24013	70fb165e-f762-11e1-a439-00145eb45e9a
212	212	0	GBIF Germany	4f6826f2-4ff6-443d-b966-e6913bd24013	71629374-f762-11e1-a439-00145eb45e9a
2	2	0	GBIF Germany	4f6826f2-4ff6-443d-b966-e6913bd24013	71fb998e-f762-11e1-a439-00145eb45e9a
165	165	0	GBIF Germany	4f6826f2-4ff6-443d-b966-e6913bd24013	732c8f7a-f762-11e1-a439-00145eb45e9a
60	60	0	GBIF Germany	4f6826f2-4ff6-443d-b966-e6913bd24013	74b69ca0-f762-11e1-a439-00145eb45e9a
10	10	0	GBIF Germany	4f6826f2-4ff6-443d-b966-e6913bd24013	78fe475e-f762-11e1-a439-00145eb45e9a
14	14	0	GBIF Germany	4f6826f2-4ff6-443d-b966-e6913bd24013	790ebca6-f762-11e1-a439-00145eb45e9a
443	318	-125	GBIF Germany	4f6826f2-4ff6-443d-b966-e6913bd24013	79b31364-f762-11e1-a439-00145eb45e9a
127	127	0	GBIF Brazil	cdc9736d-5ff7-4ece-9959-3c744360cdb3	7aca1e48-c986-46ad-8c82-9db59c29fa13
1371	1371	0	GBIF Germany	4f6826f2-4ff6-443d-b966-e6913bd24013	7b9c52da-f762-11e1-a439-00145eb45e9a
131	131	0	Belgian Biodiversity Platform	fb11cfe1-ebc3-45af-9159-17d9fddbcdac	7baada30-f762-11e1-a439-00145eb45e9a
0	81	81	GBIF France	da44cd31-5901-4687-a106-6d1c7734ee3a	7bee2193-87d6-4aa6-a3a8-869420891de7
1	1	0	Plazi	ffb07bec-2d10-492d-9c37-361fe0b79427	7d4894a3-fd17-4aad-835d-8983a1233333
469	469	0	Plazi	ffb07bec-2d10-492d-9c37-361fe0b79427	7fa54607-3136-43d2-ae34-6fcf7e947bf1
324	324	0	Biodiversity Information System of Mexico	b324e8e9-9a4c-44fa-8f1a-7f39ea7ab576	7fe30c6c-f762-11e1-a439-00145eb45e9a
0	27	27	Ocean Biodiversity Information System	ba0670b9-4186-41e6-8e70-f9cb3065551a	80456488-f14c-4080-83fe-29b777130f2e
92	92	0	Biodiversity Information System of Mexico	b324e8e9-9a4c-44fa-8f1a-7f39ea7ab576	808273a6-f762-11e1-a439-00145eb45e9a
921	921	0	Biodiversity Information System of Mexico	b324e8e9-9a4c-44fa-8f1a-7f39ea7ab576	80994d06-f762-11e1-a439-00145eb45e9a
28	28	0	GBIF Germany	4f6826f2-4ff6-443d-b966-e6913bd24013	82629390-f762-11e1-a439-00145eb45e9a
80	80	0	Participant Node Managers Committee	7f48e0c8-5c96-49ec-b972-30748e339115	836d7d98-cde9-46e2-9e47-15ce0db59ba3
17787	17787	0	Biodiversity Information System of Mexico	b324e8e9-9a4c-44fa-8f1a-7f39ea7ab576	84065d1e-c691-4c86-aa8b-5ba95b36c41f
0	159	159	Participant Node Managers Committee	7f48e0c8-5c96-49ec-b972-30748e339115	86507019-bffe-401e-b93e-0516543bbea3
5	5	0	Plazi	ffb07bec-2d10-492d-9c37-361fe0b79427	8718a968-18bd-49fa-aaa9-d8b56f49baa7
88	88	0	GBIF Germany	4f6826f2-4ff6-443d-b966-e6913bd24013	874432d8-f762-11e1-a439-00145eb45e9a
1162	1162	0	Colombian Biodiversity Information System	7e865cba-7c46-417b-ade5-97f2cf5b7be0	877ee500-8f24-4d93-b0a8-27bb7af3376a
286	218	-68	GBIF Germany	4f6826f2-4ff6-443d-b966-e6913bd24013	878201a8-f762-11e1-a439-00145eb45e9a
377	328	-49	GBIF Germany	4f6826f2-4ff6-443d-b966-e6913bd24013	88595ab8-f762-11e1-a439-00145eb45e9a
0	6	6	Plazi	ffb07bec-2d10-492d-9c37-361fe0b79427	892155d2-ae57-4abd-9aa3-0813753af331
70	70	0	GBIF Germany	4f6826f2-4ff6-443d-b966-e6913bd24013	89471230-f762-11e1-a439-00145eb45e9a
11	11	0	Plazi	ffb07bec-2d10-492d-9c37-361fe0b79427	89491aea-9b28-452f-8a0e-bff42908558c
575	575	0	GBIF Germany	4f6826f2-4ff6-443d-b966-e6913bd24013	8b70ec52-f762-11e1-a439-00145eb45e9a
76	76	0	GBIF Germany	4f6826f2-4ff6-443d-b966-e6913bd24013	8b9aff06-f762-11e1-a439-00145eb45e9a
540	432	-108	GBIF Germany	4f6826f2-4ff6-443d-b966-e6913bd24013	8c7f5689-2a56-436c-865a-94b1449f6ed6
1	1	0	GBIF Germany	4f6826f2-4ff6-443d-b966-e6913bd24013	8cdbf780-f762-11e1-a439-00145eb45e9a
13	9	-4	GBIF Germany	4f6826f2-4ff6-443d-b966-e6913bd24013	8d1d61b6-f762-11e1-a439-00145eb45e9a
187	187	0	GBIF Germany	4f6826f2-4ff6-443d-b966-e6913bd24013	8d2a1d48-f762-11e1-a439-00145eb45e9a
62	62	0	Plazi	ffb07bec-2d10-492d-9c37-361fe0b79427	8d4c68da-48ac-44d9-982b-bb2a13ed886c
885	458	-427	GBIF Germany	4f6826f2-4ff6-443d-b966-e6913bd24013	8dfd9aec-f762-11e1-a439-00145eb45e9a
96	31	-65	GBIF Germany	4f6826f2-4ff6-443d-b966-e6913bd24013	8e3215ba-f762-11e1-a439-00145eb45e9a
0	19	19	Plazi	ffb07bec-2d10-492d-9c37-361fe0b79427	8e5134e2-7285-4d81-8042-dcd45a53a7f4
6188	6188	0	Participant Node Managers Committee	7f48e0c8-5c96-49ec-b972-30748e339115	8e53c062-f07b-4a84-ad80-aa8b160f1585
92	88	-4	GBIF Germany	4f6826f2-4ff6-443d-b966-e6913bd24013	8e969e54-f762-11e1-a439-00145eb45e9a
204	171	-33	GBIF Germany	4f6826f2-4ff6-443d-b966-e6913bd24013	8ed3b320-f762-11e1-a439-00145eb45e9a
2	2	0	GBIF Germany	4f6826f2-4ff6-443d-b966-e6913bd24013	908b9386-f762-11e1-a439-00145eb45e9a
13	12	-1	GBIF Germany	4f6826f2-4ff6-443d-b966-e6913bd24013	9118c65c-f762-11e1-a439-00145eb45e9a
8	8	0	GBIF Germany	4f6826f2-4ff6-443d-b966-e6913bd24013	9298f5d8-f762-11e1-a439-00145eb45e9a
181	184	3	GBIF Germany	4f6826f2-4ff6-443d-b966-e6913bd24013	933af27a-f762-11e1-a439-00145eb45e9a
235	235	0	GBIF Germany	4f6826f2-4ff6-443d-b966-e6913bd24013	93b809d6-f762-11e1-a439-00145eb45e9a
5	5	0	Plazi	ffb07bec-2d10-492d-9c37-361fe0b79427	93fa0a45-7a77-4529-9acd-f57215cdd258
1478	1478	0	GBIF Spain	1f94b3ca-9345-4d65-afe2-4bace93aa0fe	958764e9-142c-4d50-b3d5-3e458ab98ffe
998	998	0	Korean Biodiversity Information Facility	e0a1e772-0177-4800-94b4-2d023fe6cdf4	984f5236-27fc-11e2-85e3-00145eb45e9a
8	8	0	Plazi	ffb07bec-2d10-492d-9c37-361fe0b79427	a03007d9-93d1-4aae-83dd-190c9594b875
34	34	0	Plazi	ffb07bec-2d10-492d-9c37-361fe0b79427	a1790fd9-6a10-41fa-968e-dd7a111b2e7a
0	3539	3539	GBIF Norway	4f829580-180d-46a9-9c87-ed8ec959b545	a33a6578-bf83-4fa9-b39b-3a3738b72b68
0	156333	156333	Ocean Biodiversity Information System	ba0670b9-4186-41e6-8e70-f9cb3065551a	a4e8b0ab-0e79-4489-8712-1cf37d0114d6
20809	20809	0	GBIF France	da44cd31-5901-4687-a106-6d1c7734ee3a	a809d28c-110c-43c5-98d4-67b92951f9a5
3	3	0	Plazi	ffb07bec-2d10-492d-9c37-361fe0b79427	aa4fcbfa-5157-456a-a315-e69969c302e5
5	5	0	Plazi	ffb07bec-2d10-492d-9c37-361fe0b79427	aa9c7881-e897-4e4b-b67b-2b4f4ee348c9
306	306	0	GBIF France	da44cd31-5901-4687-a106-6d1c7734ee3a	ad0d7e40-962a-4106-9208-6cc6059e1098
122	122	0	Plazi	ffb07bec-2d10-492d-9c37-361fe0b79427	b2af6f58-5672-4dd6-b1f1-b8ad884ae1b6
262	262	0	GBIF Madagascar	2dbfc5c5-51b5-4494-9dfc-4d3f013a3b64	b71ccc3d-8db2-4433-86a3-c70169338b80
2849	2849	0	National Biodiversity Network	d897a5b9-35ee-4232-94bd-b0bcaac003c2	b72218f5-5218-49c2-9286-24952cc80744
0	4	4	Participant Node Managers Committee	7f48e0c8-5c96-49ec-b972-30748e339115	b8fed7b1-294e-4fac-9ea2-829f47a10331
1310925	1310925	0	U.S. Geological Survey	8618c64a-93e0-4300-b546-7249e5148ed2	bb5b30b4-827e-4d5e-a86a-825d65cb6583
1379	1379	0	GBIF Germany	4f6826f2-4ff6-443d-b966-e6913bd24013	bbbec2a0-6b5c-4450-9848-bec4fa88a8fd
7830	7830	0	Polish Biodiversity Information Network	2618bfdf-e194-4911-a241-80db3107bc51	bd04a030-ad1f-11db-9793-b8a03c50a862
1	1	0	Plazi	ffb07bec-2d10-492d-9c37-361fe0b79427	be095252-5fcf-4ee9-abf1-44fa22c8175d
0	129	129	Plazi	ffb07bec-2d10-492d-9c37-361fe0b79427	bef3d48c-ed7d-4f4f-9eb2-60f35395c7be
2	2	0	Plazi	ffb07bec-2d10-492d-9c37-361fe0b79427	c088902a-755d-4218-8dda-9820e2b1e333
1	1	0	Plazi	ffb07bec-2d10-492d-9c37-361fe0b79427	c195b7f3-6512-4f37-9f2b-1446525144db
8	8	0	Plazi	ffb07bec-2d10-492d-9c37-361fe0b79427	c26ebde3-9cab-43ba-b4c3-ff4f3c7e5b0b
0	2	2	Plazi	ffb07bec-2d10-492d-9c37-361fe0b79427	c6c9f2b6-f1ed-4b68-a9a4-4dbff64c6cfa
0	9	9	Plazi	ffb07bec-2d10-492d-9c37-361fe0b79427	c8e21505-7da3-4bd8-9cbe-70d696dae8b9
119	119	0	Colombian Biodiversity Information System	7e865cba-7c46-417b-ade5-97f2cf5b7be0	c9255242-3afd-4dd0-ab5f-97fe8a053fe0
0	298	298	Ocean Biodiversity Information System	ba0670b9-4186-41e6-8e70-f9cb3065551a	c9b33318-2033-4f94-afcf-e88ba2ddb272
20	20	0	Plazi	ffb07bec-2d10-492d-9c37-361fe0b79427	ca29e500-63fd-4f87-b24b-c41cdfa2cf1f
7	7	0	Plazi	ffb07bec-2d10-492d-9c37-361fe0b79427	d25360d8-7a6b-4441-8ce3-4fd2b89121f1
447	447	0	Colombian Biodiversity Information System	7e865cba-7c46-417b-ade5-97f2cf5b7be0	d3299805-ea6d-421d-a0b4-13a3daab3b1d
0	29	29	Plazi	ffb07bec-2d10-492d-9c37-361fe0b79427	d34a52f7-b652-4321-98ce-822545a9f24e
227	227	0	Ocean Biodiversity Information System	ba0670b9-4186-41e6-8e70-f9cb3065551a	d4368fa0-ffbe-4cb8-8e32-7bb902e3656d
251	251	0	GBIF France	da44cd31-5901-4687-a106-6d1c7734ee3a	d4773910-3ace-43ef-a12f-302c214aeebb
54	54	0	Belgian Biodiversity Platform	fb11cfe1-ebc3-45af-9159-17d9fddbcdac	d4d81703-84a5-4bdf-891e-d85890593c73
8	8	0	Plazi	ffb07bec-2d10-492d-9c37-361fe0b79427	d5b94fdb-db02-4530-85aa-12d9757e3313
10336	10336	0	Ocean Biodiversity Information System	ba0670b9-4186-41e6-8e70-f9cb3065551a	da209453-8d41-4a29-b759-1f5e1a2b6980
67	67	0	Plazi	ffb07bec-2d10-492d-9c37-361fe0b79427	db33d89d-f25a-4581-96e1-8a87edc6fe0f
119	119	0	Atlas of Living Australia	4a6f1b71-969e-4fc5-a693-282b05e1220c	dc9b4f81-f75e-44e8-bb19-845e665ccb81
0	12335	12335	Taiwan Biodiversity Information Facility	e1b85abc-61f9-430f-ba79-6813dec53a0f	e34125ac-b4fd-4ad4-9647-3423cdd9b8a2
3	3	0	GBIF Brazil	cdc9736d-5ff7-4ece-9959-3c744360cdb3	e3913909-2457-468a-ab6f-79ea2cac3283
0	4	4	Plazi	ffb07bec-2d10-492d-9c37-361fe0b79427	e3b7fac8-3c2f-4c1d-8329-4e876e7ecde2
3172	3172	0	GBIF Brazil	cdc9736d-5ff7-4ece-9959-3c744360cdb3	e60f9152-243e-4cd0-a1d3-2cab386f2bdb
40	40	0	GBIF Germany	4f6826f2-4ff6-443d-b966-e6913bd24013	ec5b01a5-770d-4f97-8065-20e918dd1654
536	536	0	GBIF Finland	dd514216-5c7c-45f3-910d-797424cb5be6	ed52aaa1-5fa5-417d-815a-851a5731dcf0
0	10	10	Plazi	ffb07bec-2d10-492d-9c37-361fe0b79427	f38c6725-8955-4174-82c9-ecbc8d0374ca
81	81	0	Colombian Biodiversity Information System	7e865cba-7c46-417b-ade5-97f2cf5b7be0	f423c647-0595-4d2d-a1d4-9a09c9e0f562
7	7	0	Plazi	ffb07bec-2d10-492d-9c37-361fe0b79427	f7c81558-8c7a-49f7-93b3-ab430aea191a
8	8	0	Plazi	ffb07bec-2d10-492d-9c37-361fe0b79427	fb8b426e-656f-440f-8708-b695fab3d284
0	2478	2478	Ocean Biodiversity Information System	ba0670b9-4186-41e6-8e70-f9cb3065551a	fd412600-3cc4-466c-b2d2-281f21d2103f
